FIPSCode,csCode,expDeathsMed2020,expDeathsLow2020,expDeathsUp2020,deaths2020,excDeathsMed2020,excDeathsLow2020,excDeathsUp2020,COVIDDeaths2020,nonCovidExcCDRLow2020,nonCovidExcCDRMed2020,nonCovidExcCDRUp2020,COVIDExcRatio2020,expDeathsMed2021,expDeathsLow2021,expDeathsUp2021,deaths2021,excDeathsMed2021,excDeathsLow2021,excDeathsUp2021,COVIDDeaths2021,nonCovidExcCDRLow2021,nonCovidExcCDRMed2021,nonCovidExcCDRUp2021,COVIDExcRatio2021,pop2020,pop2021,csName,countyName,stateFIPS,countyFIPS,state,stateStr
01001,01CS001,475,450,500,565,90,65,115,55,0.6968345235348338,2.4231174014886574,4.154425043087672,0.6034875400538314,587,557,618,706,119,88,149,107,-0.3096788911571506,0.17679652678263244,0.7314074301765071,0.8937353241797977,58446,59063,Autauga,Autauga,1,1,Alabama,AL
01003,01CS002,2020,1920,2121,2277,257,156,357,165,-0.16298346764495314,1.5705877669667037,3.384197901646485,0.6407278832792175,2535,2412,2658,3094,559,436,682,435,0.036281789652549315,0.50901638356496,1.0610620730401747,0.7765242877586959,232385,238397,Baldwin,Baldwin,1,3,Alabama,AL
01005,01CS003,257,246,268,324,67,56,78,38,2.996047931331223,4.6528841218248775,6.334450510471843,0.5579609821189985,314,301,327,372,58,45,71,52,-0.2570447559012282,0.24827722316686116,0.7667909688552416,0.8803431084662878,25081,24996,Barbour+Bullock+Henry,Barbour,1,5,Alabama,AL
01011,01CS003,103,102,104,132,29,28,30,20,3.071657953167986,3.4636541682113284,3.870631663101308,0.668463532664155,127,126,128,141,14,13,15,13,-0.030548744123916557,0.10300649016895853,0.22122063775768386,0.8664505402263935,10286,10318,Barbour+Bullock+Henry,Bullock,1,11,Alabama,AL
01067,01CS003,193,185,200,228,35,28,43,24,0.922819288812811,2.632857465373134,4.30990093413711,0.6582704233269768,239,230,248,269,30,21,39,37,-0.9204445058516821,-0.4076635860156301,0.08593413621572389,1.1868445292267202,17191,17416,Barbour+Bullock+Henry,Henry,1,67,Alabama,AL
01007,01CS004,220,210,229,252,32,23,42,40,-3.166974961715678,-1.3064738195850945,0.2538131461675966,1.2051279310194052,273,261,284,336,63,52,75,46,0.30011185832218407,0.7746329797256052,1.272442363647405,0.7142520355043239,22263,22440,Bibb+Chilton+Coosa+Perry,Bibb,1,7,Alabama,AL
01021,01CS004,445,425,464,529,84,65,104,76,-0.9615046607214232,0.7561479169540485,2.635206456328921,0.8919339037007686,550,527,574,653,103,79,126,107,-0.615726382913919,-0.09526486806098494,0.4248190893953853,1.0309270480496493,44946,45238,Bibb+Chilton+Coosa+Perry,Chilton,1,21,Alabama,AL
01037,01CS004,130,126,135,144,14,9,18,19,-3.622003357115518,-1.9785922419074016,-0.32259543511312105,1.2812340870913568,160,154,165,184,24,19,30,21,-0.16289213898811086,0.33033205151147244,0.8469367774145115,0.829905000494866,10433,10440,Bibb+Chilton+Coosa+Perry,Coosa,1,37,Alabama,AL
01105,01CS004,97,96,98,141,44,43,45,23,9.377706202474801,9.764506637843153,10.148063624507497,0.5134517177478094,117,116,118,160,43,42,44,21,2.4959566208200865,2.6126821673513554,2.7450868135207713,0.47853433042376026,8513,8369,Bibb+Chilton+Coosa+Perry,Perry,1,105,Alabama,AL
01009,01CS005,597,572,622,731,134,109,159,92,1.1986039547779854,2.8324211531069983,4.664411010935913,0.6818529476026042,733,703,764,838,105,74,135,98,-0.44369771659631846,0.1175888040378385,0.6350069731082194,0.9258338864834293,58896,59047,Blount,Blount,1,9,Alabama,AL
01013,01CS006,215,206,223,256,41,33,50,52,-3.856544706228468,-2.2037331017461255,-0.5124576636762248,1.2238881300841618,260,250,270,307,47,37,57,47,-0.48139344627146785,0.02003977293126055,0.5120673689676773,0.9755295226164747,19095,18907,Butler+Crenshaw+Pike,Butler,1,13,Alabama,AL
01041,01CS006,155,150,161,209,54,48,59,29,5.7939884019468515,7.487520274383352,9.21640213328489,0.5291443722091864,188,181,195,240,52,45,59,30,1.1722031514060054,1.6848167640027016,2.1624060146770447,0.5640347899597067,13245,13094,Butler+Crenshaw+Pike,Crenshaw,1,41,Alabama,AL
01109,01CS006,268,254,282,359,91,77,105,45,3.885843206975489,5.581008748649994,7.321883413406508,0.4900861715303467,330,313,347,455,125,108,142,74,1.0618250720260316,1.558548982572822,2.0757067820292883,0.5858730947206373,32990,32990,Butler+Crenshaw+Pike,Pike,1,109,Alabama,AL
01015,01CS007,1265,1215,1315,1535,270,220,320,175,1.5114794367760311,3.3000144630972894,5.074426601667798,0.6448956143832533,1544,1484,1604,1863,319,259,379,302,-0.35397503418175796,0.1335249518287319,0.6817964354414239,0.944248494884529,115915,116015,Calhoun,Calhoun,1,15,Alabama,AL
01017,01CS008,374,359,389,516,142,127,157,73,6.109971637026189,8.0271855041078215,9.648685932854244,0.5105643418440676,455,437,473,576,121,103,139,77,0.7847241755323546,1.2728677393728407,1.793286291015184,0.6312577412979659,34455,34561,Chambers+Cleburne+Randolph,Chambers,1,17,Alabama,AL
01029,01CS008,169,162,175,189,20,14,27,25,-2.8046189138496453,-1.1904999690023481,0.4148379218297973,1.168357141743405,206,198,213,261,55,48,63,41,0.4272691181591251,0.9543182588743827,1.4905092264336821,0.7276408925284974,15030,15093,Chambers+Cleburne+Randolph,Cleburne,1,29,Alabama,AL
01111,01CS008,250,241,260,306,56,46,65,54,-1.4351887850392169,0.2802079406869416,2.001675725891154,0.9551802396264388,304,292,315,355,51,40,63,55,-0.7020080713523374,-0.1608540688719951,0.3326324294952846,1.0485854694038774,22091,21986,Chambers+Cleburne+Randolph,Randolph,1,111,Alabama,AL
01019,01CS009,291,281,302,398,107,96,117,34,9.781641583056727,11.521606513095897,13.198582244771139,0.31595116512763194,354,342,367,468,114,101,126,64,1.4240583049847306,1.9897804864464426,2.5357487750551124,0.5588034778142216,25151,24990,Cherokee+Etowah,Cherokee,1,19,Alabama,AL
01055,01CS009,1201,1156,1245,1446,245,201,290,222,-0.8885375941659193,0.9348847482424554,2.6303991684993266,0.9014915308664233,1464,1411,1518,1818,354,300,407,287,0.15368599189608667,0.6565117188524863,1.1568061221568855,0.8090523888052412,103233,103196,Cherokee+Etowah,Etowah,1,55,Alabama,AL
01023,01CS010,154,149,160,160,6,0,11,31,-9.803354934621137,-8.069318696654125,-6.411668253930616,4.7462581639676165,188,182,195,210,22,15,28,23,-0.6079494261683678,-0.08795767790155135,0.39850695040265033,1.0046411778573652,12604,12546,Choctaw+Clarke+Washington,Choctaw,1,23,Alabama,AL
01025,01CS010,251,242,261,371,120,110,129,43,11.593385880152175,13.244103642582838,15.09823145766332,0.35668894665483525,305,294,317,388,83,71,94,53,0.8209239260348714,1.3294882254825209,1.8209813446937055,0.6334546253637552,23066,22794,Choctaw+Clarke+Washington,Clarke,1,25,Alabama,AL
01129,01CS010,165,158,172,188,23,16,30,24,-1.9647585330926856,-0.24618855647648485,1.446435494937477,1.0019148866080985,200,192,208,243,43,35,51,32,0.20863911376451413,0.7094950089712353,1.1968966200778715,0.7264302008203245,15424,15169,Choctaw+Clarke+Washington,Washington,1,129,Alabama,AL
01027,01CS011,163,157,169,218,55,49,61,40,2.471860150950228,4.191365226902169,5.996629233692999,0.7161601663717377,200,193,207,235,35,28,42,24,0.2121712656446746,0.7890440510086132,1.3039627287071185,0.6668472280376192,14057,14190,Clay+Talladega,Clay,1,27,Alabama,AL
01121,01CS011,872,837,907,1038,166,131,201,130,0.16056054867741587,1.737393634053383,3.4338072430781477,0.7786645775159704,1062,1020,1104,1362,300,258,342,203,0.7267717569058068,1.1846349225957138,1.716356538541664,0.67366007306838,81743,81603,Clay+Talladega,Talladega,1,121,Alabama,AL
01031,01CS012,477,454,500,616,139,116,162,70,3.4878727630810715,5.173746687309065,6.938251879817403,0.4988992570851223,592,564,620,715,123,95,151,128,-0.6386753339454704,-0.09976282821626549,0.4448771007613517,1.032119996807495,53493,54085,Coffee+Geneva,Coffee,1,31,Alabama,AL
01061,01CS012,315,304,327,402,87,75,98,54,2.989708730444116,4.928359742456956,6.477920643460419,0.6151598763395266,386,372,400,527,141,127,155,81,1.7039185789473574,2.251460776243978,2.749366363087324,0.570779527075007,26624,26697,Coffee+Geneva,Geneva,1,61,Alabama,AL
01033,01CS013,649,624,674,675,26,1,51,83,-5.698906093884678,-3.960194616898298,-2.328212407244118,3.0746120378190223,797,768,827,882,85,55,114,117,-1.0997201225847961,-0.5663791541215651,-0.08193294496932746,1.3641578496811586,56970,57439,Colbert,Colbert,1,33,Alabama,AL
01035,01CS014,148,143,153,183,35,30,40,27,0.8855680061076338,2.6761232062352494,4.314014412636895,0.7572421235809194,179,173,185,220,41,35,47,35,-0.012580330770934527,0.5256987105217402,1.0229929915571099,0.8367884651925561,11602,11361,Conecuh+Marengo+Monroe+Wilcox,Conecuh,1,35,Alabama,AL
01091,01CS014,237,229,246,281,44,35,52,35,0.22938753674469203,1.8178372671107152,3.394836791529475,0.7835037713685229,290,280,299,350,60,51,70,60,-0.5032598716532763,0.0324295202519877,0.5459816945369719,0.9768305192688969,19186,19035,Conecuh+Marengo+Monroe+Wilcox,Marengo,1,91,Alabama,AL
01099,01CS014,219,210,227,283,64,56,73,30,5.32840752083343,6.877917982125,8.627356300947019,0.4596851331673997,268,258,278,373,105,95,115,52,2.156323582073486,2.698826008572168,3.2012641745072843,0.49119631788148793,19856,19659,Conecuh+Marengo+Monroe+Wilcox,Monroe,1,99,Alabama,AL
01131,01CS014,139,135,144,150,11,6,15,22,-6.0267872736689085,-4.39989326131692,-2.571345772566457,1.9016379164886252,171,165,176,182,11,6,17,25,-1.816552651887053,-1.3071927704765067,-0.7821249317626685,2.0192301251657936,10493,10456,Conecuh+Marengo+Monroe+Wilcox,Wilcox,1,131,Alabama,AL
01039,01CS015,463,447,479,591,128,112,144,90,2.318509287195764,4.110961183402015,5.79091358846303,0.6977152788840525,566,546,585,723,157,138,177,126,0.32124381040924005,0.8416464204902625,1.3581312484130494,0.7957488630893562,37418,37516,Convington+Escambia,Covington,1,39,Alabama,AL
01053,01CS015,407,391,423,515,108,92,124,58,3.7404884059153236,5.411470134150683,7.289952292890285,0.533174097568574,498,479,517,655,157,138,176,108,0.8074719292146406,1.3511970720865618,1.8781574497393545,0.6829939049247205,36655,36694,Convington+Escambia,Escambia,1,53,Alabama,AL
01043,01CS016,945,907,982,1043,98,61,136,121,-2.8418640979776426,-0.982839308561649,0.6079256982658974,1.2169106761988944,1174,1128,1220,1307,133,87,179,187,-1.1445881359716534,-0.6101063940694424,-0.11253927230330656,1.3982145474097434,87554,89284,Cullman,Cullman,1,43,Alabama,AL
01045,01CS017,454,433,475,555,101,80,122,86,-0.6043997499626349,1.1852664153789971,2.9276327861285223,0.8420342724697651,557,532,583,735,178,152,203,96,1.1528783827607731,1.6412895322022494,2.165259382688591,0.5374186790452782,49239,49323,Dale,Dale,1,45,Alabama,AL
01047,01CS018,436,419,452,560,124,108,141,100,0.8675387170565144,2.557701709860691,4.283177032529336,0.797708216803946,527,508,547,678,151,131,170,101,0.7732448065844303,1.316748639575584,1.8432822410680982,0.6655393299553857,37984,37702,Dallas+Lowndes,Dallas,1,47,Alabama,AL
01085,01CS018,134,129,138,156,22,18,27,39,-8.331012244137826,-6.6181103385684334,-4.786180952805903,1.6782380309326392,160,155,165,184,24,19,29,33,-1.4038373172730094,-0.9145378743667226,-0.40169389013110773,1.3136989111698305,10179,10013,Dallas+Lowndes,Lowndes,1,85,Alabama,AL
01049,01CS019,701,670,731,868,167,137,198,123,0.8393513806845335,2.4605946707013953,4.362594901767506,0.730453293462556,859,822,896,1119,260,223,297,172,0.7010609726785005,1.2095998454132906,1.73267596340872,0.6595523100461835,71631,71786,DeKalb,DeKalb,1,49,Alabama,AL
01051,01CS020,728,691,766,850,122,84,159,93,-0.25191091400472965,1.3139163717325226,2.9456230744825485,0.7584836431126196,909,863,955,1085,176,130,222,157,-0.2884677896065755,0.2199008767455747,0.7399430513123036,0.884948943854436,87286,89131,Elmore,Elmore,1,51,Alabama,AL
01057,01CS021,193,186,200,236,43,36,50,41,-1.2652915630268977,0.37262149855173565,2.0492043085959066,0.9396839430005702,233,225,242,314,81,72,89,51,1.3129746393919155,1.8417757905096284,2.3079318446684325,0.6253045681606437,16286,16171,Fayette+Lamar+Marion,Fayette,1,57,Alabama,AL
01075,01CS021,168,162,174,220,52,46,58,45,0.2920605276591417,1.9092051303258357,3.761911483865279,0.8504209288325577,202,195,209,242,40,33,47,34,-0.06963846764460188,0.45667147361033084,0.9488772806800271,0.8240556674376812,13898,13726,Fayette+Lamar+Marion,Lamar,1,75,Alabama,AL
01093,01CS021,346,333,359,444,98,85,111,61,3.334163389105335,5.104471017852205,6.7573782266922064,0.6165716066635195,420,405,435,508,88,73,103,72,0.0698532841858443,0.5793042729578154,1.0808803791675268,0.8057292546345359,29361,29252,Fayette+Lamar+Marion,Marion,1,93,Alabama,AL
01059,01CS022,320,306,334,385,65,51,79,49,0.22802470070981554,1.9996009700650705,3.540393415544514,0.7444932755865179,391,375,408,490,99,82,115,57,0.8013348019962818,1.3014415661552132,1.8162683965967916,0.5726057544397595,31988,32020,Franklin+Lawrence,Franklin,1,59,Alabama,AL
01079,01CS022,349,335,363,461,112,98,126,59,4.72034954221649,6.363528200773361,8.171136679167375,0.5225735705973462,427,410,444,582,155,138,172,96,1.2651241555822819,1.7828892683627378,2.281104856024865,0.61464576762199985,33035,33086,Franklin+Lawrence,Lawrence,1,79,Alabama,AL
01063,01CS023,86,85,87,133,47,46,48,21,13.076880876324319,13.48840973877556,13.907353824590572,0.4361156203531146,104,103,105,136,32,31,33,23,1.0706472081486864,1.1918847455482533,1.3103533539873116,0.6944220877285888,7755,7640,Greene+Hale+Pickens+Sumter,Greene,1,63,Alabama,AL
01065,01CS023,169,163,176,216,47,40,53,37,0.7113451809048994,2.6424939199273334,4.356145506542389,0.7747386667240116,208,200,215,262,54,47,62,40,0.45494295780227384,0.9734542173282581,1.4889868521029117,0.7211719846187257,14770,14760,Greene+Hale+Pickens+Sumter,Hale,1,65,Alabama,AL
01107,01CS023,208,200,216,277,69,61,77,37,4.902976800128505,6.619652713150213,8.41167723426338,0.5294253042759259,252,243,262,339,87,77,96,48,1.4987028879916893,2.04056275973626,2.5372867604983567,0.5471084020877485,19163,18839,Greene+Hale+Pickens+Sumter,Pickens,1,107,Alabama,AL
01119,01CS023,143,138,148,171,28,23,33,27,-1.3636859266498313,0.3423882243097773,1.9709380571005186,0.9301287850505886,174,168,180,163,-11,-17,-5,14,-2.586162087626554,-2.0468156945899865,-1.4939322358303748,-1.395714700364708,12291,12183,Greene+Hale+Pickens+Sumter,Sumter,1,119,Alabama,AL
01069,01CS024,983,937,1029,1210,227,181,273,171,0.3753996686311134,2.1199416375785907,3.7076958918169907,0.7492556668589027,1208,1152,1263,1602,394,339,450,244,0.8720667101438074,1.4154972707706912,1.8895797548410802,0.6172087216173497,107079,107419,Houston,Houston,1,69,Alabama,AL
01071,01CS025,613,591,636,747,134,111,156,69,3.2827308853723247,4.955049504999113,6.720594350874569,0.5118512011537595,751,724,779,985,234,206,261,159,0.8909043075178144,1.4248532302670702,1.9623436812933457,0.6774812327271432,52422,52736,Jackson,Jackson,1,71,Alabama,AL
01073,01CS026,6243,5954,6532,7235,992,703,1281,748,-0.45200345316469914,1.4106467573825299,3.1134530810003205,0.753329629329712,7614,7269,7959,8972,1358,1013,1703,1033,-8.291975819164608e-4,0.472748265577742,1.0074721391779036,0.7600750444797366,670607,668625,Jefferson,Jefferson,1,73,Alabama,AL
01077,01CS027,962,922,1002,1121,159,119,199,130,-0.3788985393829585,1.2207401323103673,2.8677802530290664,0.8114724348778899,1180,1131,1228,1303,123,75,172,174,-1.081567329393621,-0.5443794350042136,-0.02718415399330855,1.4016069265716662,93570,93980,Lauderdale,Lauderdale,1,77,Alabama,AL
01081,01CS028,1013,938,1088,1123,110,35,185,130,-2.1411979397259944,-0.4035757792618683,1.3642054338113816,1.169397909717234,1277,1186,1369,1442,165,73,256,189,-0.6853189684972029,-0.13035069368467897,0.3864245550169857,1.1416184939994507,173476,176836,Lee,Lee,1,81,Alabama,AL
01083,01CS029,768,723,813,925,157,112,202,91,0.7409550355379417,2.514648895224834,4.419965221422025,0.5751175806087722,971,916,1026,1147,176,121,231,122,0.012713413604425999,0.5009211553186357,1.0519798054778013,0.6900010110023879,103899,107051,Limestone,Limestone,1,83,Alabama,AL
01087,01CS030,221,213,229,289,68,60,76,38,4.58016109050128,6.2986048936929295,7.932086332797817,0.5507539436859453,268,258,278,244,-24,-34,-14,30,-3.3562172050994676,-2.8460294270559228,-2.336718934567666,-1.3115978783824096,19210,18980,Macon+Tallapoosa,Macon,1,87,Alabama,AL
01123,01CS030,481,464,499,534,53,35,70,79,-4.262848396428014,-2.558496963780041,-0.8685449826829785,1.4765626816576776,591,570,613,726,135,113,156,99,0.34349812392997187,0.8661124788965314,1.4182235765769757,0.7304181823471463,41077,41053,Macon+Tallapoosa,Tallapoosa,1,123,Alabama,AL
01089,01CS031,2949,2781,3116,3158,209,42,377,217,-1.8201280793703278,-0.0749535414538159,1.625978853745281,1.0314090491905572,3677,3474,3881,4086,409,205,612,466,-0.6480033493062933,-0.1516209542431651,0.35331487224940256,1.1378504058226209,387770,394407,Madison,Madison,1,89,Alabama,AL
01095,01CS032,988,946,1030,1227,239,197,281,147,2.1364505056067418,3.7671868212917983,5.451203445162825,0.6131424494293509,1213,1163,1264,1420,207,156,257,152,0.0686037683997177,0.5716656970141264,1.0327029109589017,0.7322010386863441,97548,98138,Marshall,Marshall,1,95,Alabama,AL
01097,01CS033,3742,3564,3921,4423,681,502,859,473,0.3211475341255116,1.950634541701286,3.708501335480395,0.6940509342648129,4582,4369,4796,5813,1231,1017,1444,844,0.43114149346795694,0.9369646935284289,1.4243315073333933,0.6852624758736929,414020,413245,Mobile,Mobile,1,97,Alabama,AL
01101,01CS034,1812,1713,1910,2377,565,467,664,337,2.1985131358801255,3.9439762164637617,5.695656731017114,0.5949178096428036,2217,2099,2334,2776,559,442,677,384,0.23528748886179313,0.7749539255441751,1.2733666008054936,0.685121611671716,227996,227582,Montgomery,Montgomery,1,101,Alabama,AL
01103,01CS035,1203,1150,1256,1492,289,236,342,169,2.2522107803510094,3.888390064968161,5.711504407204303,0.5823722851116303,1481,1417,1545,1690,209,145,273,214,-0.5636210093540894,-0.013908313713344582,0.4401340758210398,1.0198910708198539,122830,123620,Morgan,Morgan,1,103,Alabama,AL
01113,01CS036,546,521,572,637,91,65,116,70,-0.22008719012879535,1.3372718028383257,3.1992722560523146,0.7620361860128801,664,634,695,850,186,155,216,124,0.5292549676601052,1.046197132563969,1.5899972593416682,0.6638701726436081,59009,58796,Russell,Russell,1,113,Alabama,AL
01115,01CS037,835,795,874,1035,200,161,240,136,1.2113899966087076,2.7821105983082632,4.4292818711981505,0.6758960553114453,1035,987,1083,1311,276,228,324,219,0.125264986934385,0.6289179540728181,1.10940523530083,0.7912696322740401,91247,92542,St. Clair,St. Clair,1,115,Alabama,AL
01117,01CS038,1347,1251,1444,1592,245,148,341,148,0.05486493236690101,1.675909633440818,3.4602754909749924,0.6028445041715498,1692,1575,1809,1931,239,122,356,225,-0.4647065625807279,0.05825889074764718,0.5548561124936955,0.9383674950249428,223234,226436,Shelby,Shelby,1,117,Alabama,AL
01125,01CS039,1620,1523,1717,1887,267,170,364,252,-1.338534683123395,0.2634255868986912,2.043793791970559,0.9412586819788755,2003,1886,2120,2339,336,219,453,362,-0.609959448323689,-0.10901587046649457,0.4269208117228651,1.0749779558372166,224683,227028,Tuscaloosa,Tuscaloosa,1,125,Alabama,AL
01127,01CS040,877,849,905,1111,234,206,262,165,2.5117081994353065,4.266287685942006,5.981442639942072,0.702635825453851,1065,1032,1099,1291,226,192,259,201,-0.1328273563327329,0.3945736695239311,0.9005422298711773,0.885952655191153,64864,64859,Walker+Winston,Walker,1,127,Alabama,AL
01133,01CS040,264,254,274,327,63,53,73,37,2.7607877391660494,4.398896268152097,6.0572950429622425,0.5772802721938758,323,311,335,424,101,89,113,71,0.7911107355973184,1.2643009367880684,1.7807608271010058,0.696552001162435,23538,23629,Walker+Winston,Winston,1,133,Alabama,AL
02020,02CS001,1470,1345,1595,1748,278,153,403,117,0.3994689736718172,2.255922394367198,3.859034307982241,0.4193085090096149,1823,1674,1972,2351,528,379,677,278,0.393328321960227,0.8663698036225351,1.39506606421964,0.5251711408579192,290106,288488,Anchorage,Anchorage,2,20,Alaska,AK
02090,02CS002,396,355,437,473,77,36,118,19,0.9001714021626941,2.452800360608155,4.131458624072124,0.24260554723250496,495,446,545,680,185,135,234,90,0.47529283785997184,0.9616253904842678,1.5550320941793505,0.4848619866144496,95581,95548,Fairbanks North Star,Fairbanks North Star,2,90,Alaska,AK
02122,02CS003,392,366,417,393,1,-24,27,18,-2.8515135662693223,-1.2219321332955397,0.6607057839410335,7.699986038295857,488,457,519,586,98,67,129,66,-0.01158203158159762,0.5381733866724816,1.0295184631669083,0.6665795710225099,58987,59640,Kenai Peninsula,Kenai Peninsula,2,122,Alaska,AK
02170,02CS004,535,488,581,639,104,58,151,33,0.9218249697922464,2.624214005306644,4.318829581292128,0.31346718972679205,679,622,736,989,310,253,367,165,0.8425766533189087,1.3146456269995273,1.8360165195267946,0.5307211953347901,107959,110216,Matanuska-Susitna,Matanuska-Susitna,2,170,Alaska,AK
02140,02CS005,48,47,49,52,4,3,5,4,-0.3249335030888361,0.09556946200695257,0.4746126833306176,0.7729551860918993,58,57,59,69,11,10,12,7,0.4452883069225084,0.5657475470580638,0.681882169382536,0.5702955130873446,7744,7593,Northern Alaska,Northern Alaska,2,140,Alaska,AK
02180,02CS005,63,62,64,66,3,2,4,8,-2.584988921559388,-2.179269707902538,-1.7859794828619688,2.252369947575741,77,76,78,91,14,13,15,2,1.0720767357495624,1.2037344875239124,1.3257064743848659,0.1342730042877047,10016,9889,Northern Alaska,Nome,2,180,Alaska,AK
02185,02CS005,55,54,56,45,-10,-11,-9,8,-6.986452016128752,-6.584515468898625,-6.17168367814019,-0.9166207646677272,69,67,70,59,-10,-11,-8,6,-1.5711371203238853,-1.4465460021004215,-1.3223462382465097,-0.6755894792228626,10763,10975,Northern Alaska,North Slope,2,185,Alaska,AK
02240,02CS005,91,90,92,108,17,16,18,6,2.7738198591578627,3.1496431303924033,3.586319921079488,0.3350745858089746,112,110,114,145,33,31,35,10,1.5393593935366563,1.6590230135956487,1.7839550674427986,0.29445507227470946,13827,13824,Northern Alaska,Southeast Fairbanks,2,240,Alaska,AK
02261,02CS005,53,52,54,3,-50,-51,-49,3,-22.5434172426463,-22.14256049148892,-21.76825415090551,-0.06080242115228873,65,64,67,4,-61,-63,-60,4,-6.946190569947064,-6.827872193969086,-6.7030431236503505,-0.06617087098366915,9634,9588,Northern Alaska,Valdez-Cordova,2,261,Alaska,AK
02100,02CS006,10,10,10,19,9,9,9,7,3.3293881558909018,3.7416186821474287,4.132408538343856,0.699670122464755,12,12,12,21,9,9,9,5,1.8871677802098004,1.999069911244364,2.12540434696234,0.49255611428746926,2153,2073,Southeast Alaska,Haines,2,100,Alaska,AK
02110,02CS006,166,152,180,171,5,-9,19,4,-1.5833953680317177,0.11582488421184352,1.7436664716409447,0.6923868259802357,205,188,221,218,13,-3,30,13,-0.48242805357456037,0.014956076171919977,0.5143379370496974,0.9010225063715359,32149,32005,Southeast Alaska,Juneau,2,110,Alaska,AK
02195,02CS006,192,181,203,231,39,28,50,8,3.1477561789965054,4.879462234117445,6.576290232395157,0.20061097165468686,233,220,246,348,115,102,128,16,3.4414430484341874,3.972894640003049,4.493777567144077,0.13779379472513953,25242,24932,Southeast Alaska,Petersburg,2,195,Alaska,AK
02220,02CS006,51,50,52,56,5,4,6,3,0.5243931405317229,0.9043855931488004,1.3109736349111853,0.505638338797453,62,61,64,76,14,12,15,1,1.3574149959705966,1.4833754792378888,1.6041769983886232,0.06895716566000429,8436,8410,Southeast Alaska,Sitka,2,220,Alaska,AK
02232,02CS006,32,30,34,20,-12,-14,-10,2,-15.282058250507793,-13.655814567725969,-11.75546842185074,-0.17680744069769264,39,37,41,44,5,3,7,6,-0.7709214751481863,-0.24410660107652124,0.24862064665178163,1.0157283103671055,4217,4185,Southeast Alaska,Southeast Alaska,2,232,Alaska,AK
02010,02CS007,35,34,36,18,-17,-18,-16,7,-11.505129332412212,-11.109818343830169,-10.699329688855713,-0.43513447099838143,43,42,44,27,-16,-17,-15,7,-2.7904687730024675,-2.6657639970875606,-2.5469571067790007,-0.4786776353963119,8670,8481,Southwest Alaska,Southwest Alaska,2,10,Alaska,AK
02050,02CS007,108,106,110,115,7,5,9,15,-2.1033624242243154,-1.7038216187611541,-1.3042219187693194,1.8469825733751408,133,130,135,144,11,9,14,22,-0.7030206078795532,-0.5814473911152173,-0.4628982150526529,1.804308858865574,18616,18570,Southwest Alaska,Bethel,2,50,Alaska,AK
02060,02CS007,7,7,7,5,-2,-2,-2,5,-35.883306547828035,-35.48228300075387,-35.09094818197232,-3.60304182723741,9,9,9,15,6,6,6,4,2.1333277245919993,2.2499214256876763,2.3762267743885186,0.5809360484865159,833,837,Southwest Alaska,Bristol Bay,2,60,Alaska,AK
02070,02CS007,44,43,45,53,9,8,10,3,3.4024089213723925,3.786827720399439,4.191233097555114,0.2999051623581022,53,52,54,62,9,8,10,11,-0.4788689842941476,-0.35537884762550614,-0.22376181601394016,1.1237970909450468,6314,6203,Southwest Alaska,Dillingham,2,70,Alaska,AK
02150,02CS007,54,53,55,66,12,11,13,1,2.9446106590165644,3.374899923981877,3.7641265688993073,0.07699599286029113,66,64,68,104,38,36,40,6,2.367597183850395,2.498159581603243,2.620018877185164,0.1537987215436858,13026,12821,Southwest Alaska,Kodiak Island,2,150,Alaska,AK
02158,02CS007,53,52,54,52,-1,-2,-0,4,-2.912223517622374,-2.5256144521601556,-2.0771775570167956,-15.303465220216207,66,65,67,82,16,15,17,10,0.6286368446939175,0.7552376959389558,0.890273486950143,0.5757485395631751,8361,8360,Southwest Alaska,Southwest Alaska,2,158,Alaska,AK
04001,04CS001,564,557,571,1042,478,471,485,300,10.238594070847377,10.653472436827547,11.066678496243942,0.6266199524673407,682,674,690,1190,508,500,516,270,3.5010012628991785,3.626769458261945,3.7545851509441777,0.5303614817693749,66747,65663,Apache,Apache,4,1,Arizona,AZ
04003,04CS002,1150,1096,1204,1387,237,183,291,171,0.34727837724983845,2.0194837598603828,3.8056149276502578,0.7191911586410206,1417,1352,1482,1832,415,350,480,311,0.3139054253705235,0.828533315237833,1.3287907819580227,0.7476317545034326,125736,125955,Cochise+Graham+Greenee,Cochise,4,3,Arizona,AZ
04009,04CS002,256,240,273,322,66,49,82,50,-0.027153357793515215,1.6222080809131358,3.296500649055329,0.7507304326785392,320,300,340,489,169,149,189,88,1.5709892717631722,2.058576511215067,2.5842421074872926,0.5185248583507244,38700,38986,Cochise+Graham+Greenee,Graham,4,9,Arizona,AZ
04011,04CS002,56,55,57,62,6,5,7,5,0.12608335048268418,0.5358318020561706,0.980632332000567,0.6865896417880715,68,67,69,96,28,27,29,25,0.1749410391545824,0.2950207113807888,0.4258330963243465,0.8686297496866247,9502,9421,Cochise+Graham+Greenee,Greenlee,4,11,Arizona,AZ
04005,04CS003,747,685,810,1027,280,217,342,207,0.29384890392632607,1.988194849945505,3.7861818351205585,0.7370452530643131,929,854,1004,1194,265,190,340,184,0.03787430239587376,0.5619717829192064,1.0869740936362202,0.6910325548373516,144942,145061,Coconino,Coconino,4,5,Arizona,AZ
04007,04CS004,659,636,682,834,175,152,198,118,2.486992579769319,4.311966420852944,5.8105299229218,0.6708836622529601,804,776,831,1054,250,223,278,157,1.2284429009987567,1.7387165623358318,2.2597854327415634,0.6249573057802864,53448,53548,Gila,Gila,4,7,Arizona,AZ
04025,04CS005,2665,2563,2768,3143,478,375,580,252,2.076559258161185,3.755243444300223,5.586083367120448,0.5264739013564554,3304,3179,3428,4117,813,689,938,595,0.39054226841685025,0.9078941858747734,1.4464073175208318,0.7306439099602499,237461,241497,La Paz+Yavapai,Yavapai,4,25,Arizona,AZ
04013,04CS006,27383,25469,29296,34979,7596,5683,9510,4403,1.1805420828237885,2.8480439722912525,4.5792743149738655,0.5795545121292061,34149,31832,36466,44145,9996,7679,12313,6755,0.20159013247462018,0.7455022066786388,1.2269367424022128,0.6756873999193596,4452272,4488094,Maricopa,Maricopa,4,13,Arizona,AZ
04015,04CS007,2859,2767,2951,3445,586,494,678,326,3.285096393688986,4.828580477163085,6.495496842963062,0.5554567264994196,3529,3417,3641,4616,1087,975,1199,767,0.9564346091668453,1.4746014383415487,2.0024144272586253,0.7048244592338638,214415,217164,Mohave,Mohave,4,15,Arizona,AZ
04017,04CS008,901,890,912,1519,618,607,629,365,8.991266240508955,9.410648114988314,9.777814677779206,0.5898024621610566,1113,1100,1127,1843,730,716,743,366,3.2405455429767924,3.372104872785513,3.5008666133010147,0.5009190139402019,107560,107951,Navajo,Navajo,4,17,Arizona,AZ
04019,04CS009,8313,7863,8763,10505,2192,1742,2642,1182,2.2559599015303666,3.8443968008809613,5.756448847244938,0.5389205674100641,10256,9713,10799,12818,2562,2019,3105,1745,0.2778362711636466,0.7829557662731085,1.3082608057147198,0.6808591189631402,1046803,1051092,Pima+Santa Cruz,Pima,4,19,Arizona,AZ
04023,04CS009,264,243,284,413,149,129,170,103,2.1828095325273025,3.9009968991267256,5.489135650447011,0.68524502463939585,329,304,354,427,98,73,123,79,-0.07164354381870314,0.38434765852826785,0.9223103664757758,0.7976992603511586,47542,47849,Pima+Santa Cruz,Santa Cruz,4,23,Arizona,AZ
04021,04CS010,2671,2485,2858,3650,979,792,1165,389,3.7372158867095644,5.377445246002522,7.0039207433469945,0.3971239600260413,3386,3155,3616,4936,1550,1320,1781,880,1.0167954735033689,1.4921851676863769,2.031431340622707,0.5671973046424831,436339,446644,Pinal,Pinal,4,21,Arizona,AZ
04027,04CS011,1530,1434,1626,2445,915,819,1011,576,4.416422967833688,6.075386020447966,7.841101628727273,0.6287506332963693,1895,1779,2010,2633,738,623,854,468,0.7018651331548142,1.1909723859973012,1.7094684198687582,0.6329258240755644,223368,223051,Yuma,Yuma,4,27,Arizona,AZ
05001,05CS001,205,197,212,259,54,47,62,22,5.775847628529322,7.523727713706333,9.279846102050149,0.3979291990832768,247,239,256,336,89,80,97,30,3.0135503193375723,3.4970714846853905,4.031326599312083,0.3341896294384417,17125,16778,Arkansas (county)+Monroe+Phillips+Prairie,Arkansas (county),5,1,Arkansas,AR
05095,05CS001,98,97,99,116,18,17,19,11,3.657720371673167,4.041381595471465,4.457829099400935,0.5844137052394481,119,119,120,136,17,16,17,20,-0.6478001993517624,-0.5112032994154596,-0.38819027445916976,1.138342893769696,6750,6695,Arkansas (county)+Monroe+Phillips+Prairie,Monroe,5,95,Arkansas,AR
05107,05CS001,197,190,204,266,69,62,76,38,5.757827605601753,7.420258013066711,9.150749718319156,0.5437589920485332,235,227,243,311,76,68,84,52,0.9569732994741683,1.492633672980932,1.9632071630078878,0.6762468903122782,16582,15985,Arkansas (county)+Monroe+Phillips+Prairie,Phillips,5,107,Arkansas,AR
05117,05CS001,93,93,94,127,34,33,34,14,9.14023712678696,9.530646104044926,9.926382878700503,0.4046385498425678,114,113,115,145,31,30,32,20,1.233852454891545,1.3569237028329157,1.4830109421595314,0.6241657146398661,8214,8151,Arkansas (county)+Monroe+Phillips+Prairie,Prairie,5,117,Arkansas,AR
05005,05CS002,581,563,599,708,127,109,145,75,3.2949133696053323,4.966259802841218,6.649605324203291,0.5869668868635485,711,689,732,928,217,196,239,125,1.6989117022919038,2.184538169587173,2.7135658541936802,0.5725571687178318,41753,42073,Baxter+Marion,Baxter,5,5,Arkansas,AR
05089,05CS002,224,217,231,268,44,37,51,23,3.2453273158325597,4.963729034255081,6.662703413984184,0.5097937342130018,273,265,282,305,32,23,40,43,-1.1798575324252722,-0.6775551813747449,-0.1515951505033929,1.3197410719897433,16842,16961,Baxter+Marion,Marion,5,89,Arkansas,AR
05007,05CS003,1706,1583,1830,1959,253,129,376,282,-2.136903304058458,-0.3292895849818204,1.2361552349053535,1.1112363665739555,2150,1999,2301,2519,369,218,520,372,-0.560693784353349,-0.02176955908675292,0.4894226928111043,1.0051542797072648,286167,292622,Benton,Benton,5,7,Arkansas,AR
05009,05CS004,385,369,401,478,93,77,109,63,1.5213139820300179,3.177127445677234,4.89444483258367,0.6691858868771638,473,454,493,582,109,89,128,68,0.5380095001044348,1.0558503192658693,1.5666895226556423,0.6203354895572113,37440,37760,Boone+Carroll+Madison,Boone,5,9,Arkansas,AR
05015,05CS004,280,268,292,314,34,22,46,38,-2.221908269917592,-0.4844853744154109,1.0319091195136096,1.0776348415006867,343,329,358,394,51,36,65,40,-0.09939464003161064,0.38573578515104207,0.8987391892750108,0.7726420105902637,28248,28401,Boone+Carroll+Madison,Carroll,5,15,Arkansas,AR
05087,05CS004,169,162,176,154,-15,-22,-8,10,-7.779730719240037,-6.045956325970974,-4.319125571146987,-0.7094105666899645,210,201,219,259,49,40,58,32,0.5181052550822407,1.0220078697234558,1.5294944889544508,0.6393295565575903,16589,16900,Boone+Carroll+Madison,Madison,5,87,Arkansas,AR
05011,05CS005,132,128,137,167,35,30,39,27,1.0526601554543438,2.8314521590171795,4.5588913806211,0.7603897924894973,160,155,166,165,5,-1,10,18,-1.743579609663507,-1.275797459565207,-0.7964843827971204,3.134894008415737,10532,10421,Bradley+Calhoun+Cleveland+Union,Bradley,5,11,Arkansas,AR
05013,05CS005,59,59,60,69,10,9,10,4,4.34377292324383,4.719265703601686,5.144699452403521,0.3755808266041666,72,72,73,89,17,16,17,5,2.3819371688447672,2.5067658450870334,2.6442610539755504,0.2795312519535756,4787,4739,Bradley+Calhoun+Cleveland+Union,Calhoun,5,13,Arkansas,AR
05025,05CS005,87,86,87,110,23,23,24,20,1.362254392863805,1.7656237772676318,2.1826416393811234,0.8212415579925513,105,104,106,135,30,29,31,11,2.36392202424405,2.4870453968632877,2.612139490478348,0.3584666285727832,7598,7518,Bradley+Calhoun+Cleveland+Union,Cleveland,5,25,Arkansas,AR
05139,05CS005,439,422,456,539,100,83,117,70,1.4270671944700097,3.058397536169072,4.754545092263815,0.6935762695009516,531,511,551,617,86,66,106,70,-0.12993224772675283,0.3943376944600405,0.9519317648907974,0.8058601687059327,38828,38425,Bradley+Calhoun+Cleveland+Union,Union,5,139,Arkansas,AR
05019,05CS006,202,193,211,243,41,32,50,18,2.5542288122979153,4.326646996603782,5.89994580067886,0.4296840531322767,247,236,258,291,44,33,55,35,-0.08383297799205662,0.42278737498962626,0.9585344557615529,0.7738524037600483,21504,21327,Clark+Dallas+Ouachita,Clark,5,19,Arkansas,AR
05039,05CS006,83,82,83,105,22,22,23,14,4.647280301112365,5.056357889002952,5.4522373512897495,0.6030227088891988,99,98,99,119,20,20,21,5,2.3042932914131073,2.4284305728789635,2.556997649852,0.23403472737211195,6505,6328,Clark+Dallas+Ouachita,Dallas,5,39,Arkansas,AR
05103,05CS006,280,271,290,341,61,51,70,38,2.3706286762154134,3.995936834577285,5.615826792162004,0.6157018121145087,338,327,350,392,54,42,65,46,-0.20456332863206178,0.34355362320152627,0.871673699452818,0.8377204768982681,22676,22348,Clark+Dallas+Ouachita,Ouachita,5,103,Arkansas,AR
05021,05CS007,198,192,204,216,18,12,24,27,-4.1558688045851655,-2.503728178999067,-0.7055786824006736,1.4414605193626586,239,232,246,280,41,34,48,41,-0.5050132629249082,-0.008867665859834022,0.5652864020125955,0.9755426447324376,14490,14373,Clay+Greene,Clay,5,21,Arkansas,AR
05055,05CS007,432,412,452,495,63,43,83,56,-1.1559550476475982,0.588276788785785,2.2180432791672886,0.8770952162909746,532,509,556,612,80,56,103,73,-0.33936978950841296,0.13087118771231937,0.6892661142166409,0.9067501000673381,45797,46244,Clay+Greene,Greene,5,55,Arkansas,AR
05027,05CS008,235,226,245,319,84,74,93,30,7.596653852311548,9.399149561474191,11.048157936261834,0.3549418043935525,285,274,297,304,19,7,30,24,-0.7712385918285911,-0.25073813971276887,0.27961647222374675,1.2137676457450761,22844,22682,Columbia+Lafayette+Miller,Columbia,5,27,Arkansas,AR
05073,05CS008,77,76,77,105,28,28,29,5,14.449803689091262,14.837100674509054,15.241810027448649,0.1695047369273826,92,91,92,105,13,13,14,13,-0.057947037985326404,0.06011422704758773,0.20218238590987067,0.9042278759004573,6333,6182,Columbia+Lafayette+Miller,Lafayette,5,73,Arkansas,AR
05091,05CS008,415,396,433,503,88,70,107,61,0.7585831182080569,2.54021168776369,4.305477277248412,0.6825661888731155,505,483,527,654,149,127,171,102,0.6064728552267566,1.1061549979489975,1.6151915167571946,0.6803187920379641,42695,42637,Columbia+Lafayette+Miller,Miller,5,91,Arkansas,AR
05029,05CS009,234,225,243,229,-5,-14,4,11,-4.608115210008361,-3.178428485685611,-1.4024198546250954,-2.594127309632951,287,276,298,301,14,3,25,27,-1.1753126286449296,-0.6208098947102253,-0.12775964719584718,1.8178063005775507,20770,20852,Conway+Pope,Conway,5,29,Arkansas,AR
05115,05CS009,515,488,543,642,127,99,154,56,2.7421857779329213,4.414494990631246,6.147670931054191,0.43823314124643353,636,603,668,752,116,84,149,93,-0.13464326410626265,0.3487505002105399,0.8874204945749002,0.7916657272949026,63509,63724,Conway+Pope,Pope,5,115,Arkansas,AR
05031,05CS010,834,786,882,1005,171,123,219,99,0.9028953309289953,2.6518010664381393,4.245251554650545,0.57507200641783,1030,973,1088,1189,159,101,216,104,-0.008175076669462041,0.4976609732216683,1.0076947629490995,0.6516260243749927,111526,112124,Craighead,Craighead,5,31,Arkansas,AR
05033,05CS011,521,495,547,663,142,116,168,56,3.953983070738231,5.698236139110126,7.291063873873184,0.3925314969891423,637,606,668,874,237,206,268,123,1.3700843871862671,1.8938318213823586,2.379191463914136,0.5166992421152086,60616,60338,Crawford,Crawford,5,33,Arkansas,AR
05035,05CS012,435,414,456,555,120,99,141,68,2.6524066974078226,4.346680329425742,5.996760049707227,0.5621094521141192,531,506,555,685,154,130,179,87,0.8754977858115413,1.426349879245441,1.924216971330608,0.5600354978572187,47990,47604,Crittenden,Crittenden,5,35,Arkansas,AR
05037,05CS013,200,193,208,223,23,15,30,29,-3.2089697104637875,-1.5061494211679634,0.1069193022490003,1.2304658440948433,245,236,254,266,21,12,30,29,-1.0070004483745674,-0.4608136343572588,0.023408013476210195,1.3196472146823512,16691,16693,Cross+Lee+St. Francis,Cross,5,37,Arkansas,AR
05077,05CS013,93,93,94,144,51,50,51,17,15.198932115632712,15.630288371942413,16.056902671868393,0.3295263106344774,115,114,116,155,40,39,41,27,1.3950430412132588,1.5167609368314638,1.6347455746832118,0.6579467639002669,8591,8606,Cross+Lee+St. Francis,Lee,5,77,Arkansas,AR
05123,05CS013,211,201,221,271,60,50,70,32,2.9545802553882585,4.804014504380658,6.559279531889475,0.522884545326457,255,244,267,336,81,69,92,46,1.069550753930019,1.5181730129092286,2.0568656016056797,0.5632402962045017,23296,22784,Cross+Lee+St. Francis,St. Francis,5,123,Arkansas,AR
05045,05CS014,852,799,906,954,102,48,155,70,-0.7937878967351744,1.0191087781246435,2.748587906163648,0.6828230168211072,1060,996,1125,1189,129,64,193,117,-0.3858321201192728,0.0837490556182399,0.6276350675147233,0.9010112414010251,124131,124896,Faulkner,Faulkner,5,45,Arkansas,AR
05047,05CS015,190,182,197,242,52,45,60,22,5.454050689630623,7.029610575173743,8.759355103648696,0.4115450109512299,231,222,240,275,44,35,53,31,0.24586260151818343,0.7554046440295391,1.2831626828264937,0.6894976415000567,17217,17166,Franklin+Johnson+Logan,Franklin,5,47,Arkansas,AR
05071,05CS015,229,218,240,272,43,32,54,20,1.9224256903237316,3.4919598146819046,5.292120936633107,0.45399045682480044,281,267,294,354,73,60,87,46,0.5484682485743774,1.0462105057144766,1.5728368749200343,0.6198860703695818,25840,25823,Franklin+Johnson+Logan,Johnson,5,71,Arkansas,AR
05083,05CS015,240,231,249,285,45,36,54,12,4.657137882055517,6.316136041451695,8.055283438498524,0.2595341198641344,293,282,304,375,82,71,93,37,1.5956304414579832,2.1223821471583784,2.643141470894497,0.4463189531496056,21167,21198,Franklin+Johnson+Logan,Logan,5,83,Arkansas,AR
05051,05CS016,1217,1174,1260,1365,148,105,191,137,-1.3273102108644619,0.42505835798404307,2.209002365493786,0.9211381913660526,1487,1435,1539,1705,218,166,270,229,-0.6099965808542757,-0.11623132096910987,0.3662568958721738,1.044960987618593,100079,100306,Garland,Garland,5,51,Arkansas,AR
05053,05CS017,177,169,184,201,24,17,32,14,0.5870489206576743,2.303812627794054,4.001272553480162,0.5521411580306015,217,208,226,306,89,80,98,39,2.2545382492988635,2.7632121952131437,3.2597059802115504,0.4332240924048976,18032,18073,Grant+Hot Spring,Grant,5,53,Arkansas,AR
05059,05CS017,361,346,375,441,80,66,95,51,1.9178645536071621,3.5272828509936076,5.2771460001429515,0.6261799514786295,441,424,458,526,85,68,102,53,0.450058308778028,0.9793561613020401,1.491894855340247,0.6153118125163307,33155,33131,Grant+Hot Spring,Hot Spring,5,59,Arkansas,AR
05057,05CS018,192,183,200,226,34,26,43,20,1.1409526783041628,2.8201441046150695,4.586008437151568,0.5687774540904761,231,221,242,280,49,38,59,29,0.49725740999195744,0.9928821162999545,1.4862108801124119,0.5851559935709966,20192,19738,Hempstead+Howard+Nevada+Pike,Hempstead,5,57,Arkansas,AR
05061,05CS018,154,149,160,171,17,11,22,18,-1.9749985856615102,-0.4069133206307295,1.375656819576317,1.0030332862366556,187,181,194,164,-23,-30,-17,14,-3.462402517622475,-2.9051304919736367,-2.3810646587060584,-0.634115860650499,12817,12706,Hempstead+Howard+Nevada+Pike,Howard,5,61,Arkansas,AR
05099,05CS018,99,98,100,118,19,18,20,22,-1.750982535558512,-1.3702549586803694,-0.9742318126297377,1.0900509714247277,120,119,121,115,-5,-6,-4,18,-2.9681349165163087,-2.845120930308061,-2.718462922966344,-4.16936251847372,8262,8201,Hempstead+Howard+Nevada+Pike,Nevada,5,99,Arkansas,AR
05109,05CS018,127,122,131,129,2,-2,7,18,-7.864801145662208,-6.031316653182654,-4.420586628045005,5.171390972948116,153,148,158,177,24,19,29,27,-0.7948875601034614,-0.27306623164581284,0.24627038433615647,1.0695266002382111,10233,10080,Hempstead+Howard+Nevada+Pike,Pike,5,109,Arkansas,AR
05063,05CS019,351,335,368,452,101,84,117,72,1.378359178507762,2.9819512707281595,4.680161239375222,0.7079802009331939,427,407,446,545,118,99,138,76,0.609583729181549,1.1088560526387645,1.5960535281070223,0.6362065089388292,37864,37748,Independence+Jackson+Woodruff,Independence,5,63,Arkansas,AR
05067,05CS019,188,181,195,239,51,44,58,22,5.164887754346076,6.928068553224925,8.678715591515552,0.42269181537341854,229,220,238,254,25,16,34,22,-0.3196420783710885,0.17761540714271115,0.6820723798153019,0.8461608075614757,16751,16800,Independence+Jackson+Woodruff,Jackson,5,67,Arkansas,AR
05147,05CS019,83,82,83,95,12,12,13,6,3.542126231992525,3.969445122166817,4.387538068128352,0.45541954495927406,100,99,101,105,5,4,6,16,-1.895025116782632,-1.7675588708131067,-1.6460734896826794,2.5944147515068314,6225,6128,Independence+Jackson+Woodruff,Woodruff,5,147,Arkansas,AR
05069,05CS020,684,655,713,901,217,188,246,132,3.3586454951096445,5.072527551868517,6.648724679388469,0.6055598913033118,826,792,860,998,172,138,206,102,0.598725139694624,1.055949345905284,1.5268225131771545,0.5899028854822269,66760,66000,Jefferson,Jefferson,5,69,Arkansas,AR
05081,05CS021,148,142,153,192,44,39,50,28,3.8234114221547646,5.46101300416451,7.2517075736460095,0.6154039094502677,179,173,185,200,21,15,27,35,-1.7433891834743758,-1.2077751183440384,-0.6972319210669237,1.6145381092013116,12026,11948,Little River+Polk+Sevier,Little River,5,81,Arkansas,AR
05113,05CS021,227,219,236,258,31,22,39,51,-5.855877376762108,-4.224845873134982,-2.438503214220541,1.6108789657831037,279,269,289,374,95,85,105,72,0.6648344066824227,1.2108953689546889,1.7489824199492998,0.7473884331792653,19311,19328,Little River+Polk+Sevier,Polk,5,113,Arkansas,AR
05133,05CS021,135,129,142,175,40,33,46,29,0.9246090545618704,2.6783565846775477,4.385085484601137,0.7149896343521035,166,157,174,229,63,55,72,35,1.299583753565073,1.792736012148213,2.300204155715309,0.5436537198431123,15953,15782,Little River+Polk+Sevier,Sevier,5,133,Arkansas,AR
05085,05CS022,598,566,630,674,76,44,108,75,-1.6746732430050697,0.07305848598048902,1.773775935697586,0.9698454808642503,738,699,776,836,98,60,137,85,-0.31584396238163936,0.1730017375045659,0.6938077367767537,0.8562921395950983,74055,74623,Lonoke,Lonoke,5,85,Arkansas,AR
05093,05CS023,426,409,444,571,145,127,162,82,4.51164787323821,6.209583380259025,8.036853239076736,0.5628315048156686,514,493,535,594,80,59,101,61,-0.03499005435890063,0.47615036719797615,0.982657870907507,0.7534294388454235,40446,39784,Mississippi+Poinsett,Mississippi,5,93,Arkansas,AR
05111,05CS023,283,273,293,352,69,59,79,49,1.7102454348808205,3.4359419713139068,5.15189993600174,0.7006827857878325,342,331,354,423,81,69,92,40,1.286110610134153,1.7880965985621788,2.2899477755923856,0.4898742139984851,22958,22694,Mississippi+Poinsett,Poinsett,5,111,Arkansas,AR
05097,05CS024,125,121,129,135,10,6,14,21,-6.635514466440635,-5.113786765239503,-3.1802346224174998,1.8885230530798527,153,148,157,173,20,16,25,34,-2.1255540779473274,-1.6146563125604279,-1.083725482361639,1.5950391168736746,8561,8589,Montgomery+Perry+Scott+Yell,Montgomery,5,97,Arkansas,AR
05105,05CS024,105,104,107,111,6,4,7,3,0.5893887716748253,0.9985718732110054,1.3771327222963363,0.46145196985863446,128,127,130,152,24,22,25,20,0.23959794856646158,0.37365545029359265,0.5005879814281512,0.8091085556394122,10055,9969,Montgomery+Perry+Scott+Yell,Perry,5,105,Arkansas,AR
05127,05CS024,126,122,130,141,15,11,19,14,-1.335214191904268,0.40565817329908294,2.1235035295722646,0.878179226743553,153,148,158,181,28,23,33,19,0.41496511668465214,0.9198116107080312,1.4118756044749063,0.6525824245346281,9871,9820,Montgomery+Perry+Scott+Yell,Scott,5,127,Arkansas,AR
05149,05CS024,213,204,221,252,39,31,48,37,-1.1403066326731586,0.4650181268373262,2.255456719465117,0.9146691199253302,257,247,268,297,40,29,50,40,-0.5528711979799847,-0.019780921781980553,0.5149291491781588,0.9856178029515504,20379,20164,Montgomery+Perry+Scott+Yell,Yell,5,149,Arkansas,AR
05119,05CS025,3240,3069,3412,3803,563,391,734,342,0.4615559034149826,2.211823140590109,3.9474496506727044,0.6066314483742823,3979,3773,4184,4722,743,538,949,479,0.17531929337990568,0.6668945262749675,1.1874059876418508,0.6436332821721855,397957,398004,Pulaski,Pulaski,5,119,Arkansas,AR
05125,05CS026,1024,970,1077,1101,77,24,131,98,-2.328999159292743,-0.6698544521886404,1.1760167529117487,1.250589578915856,1269,1205,1334,1580,311,246,375,165,0.6232173350704571,1.1775318753248882,1.6677829157467483,0.528934536270651,123678,125007,Saline,Saline,5,125,Arkansas,AR
05131,05CS027,1111,1056,1165,1345,234,180,289,111,2.080583143933518,3.819596166937927,5.581992750081525,0.4713623529243107,1367,1301,1433,1711,344,278,410,217,0.45705050031006633,0.9841204320157181,1.52546500092203,0.6294523188540524,127800,128304,Sebastian,Sebastian,5,131,Arkansas,AR
05049,05CS028,164,159,169,183,19,14,24,35,-6.987698190252513,-5.1794021699142405,-3.498696218157851,1.7333842128301844,200,194,206,256,56,50,62,43,0.5160080519112907,1.0781875763195161,1.5969242231700678,0.7545311206697705,12115,12129,Sharp and Nearby Counties,Fulton,5,49,Arkansas,AR
05065,05CS028,175,169,181,191,16,10,22,10,0.20801766560579457,1.85415789182364,3.4985452010390046,0.5805405723952068,217,209,224,262,45,38,53,35,0.2380054554516205,0.746447848343204,1.2689835393747044,0.7541415465996123,13617,13862,Sharp and Nearby Counties,Izard,5,65,Arkansas,AR
05075,05CS028,201,194,208,230,29,22,36,32,-2.4488206089213036,-0.7177007614938723,1.0550075115471367,1.0608250360664768,245,237,254,250,5,-4,13,18,-1.375706825638945,-0.7991050500314777,-0.32423027370681734,3.2537646479846813,16242,16278,Sharp and Nearby Counties,Lawrence,5,75,Arkansas,AR
05121,05CS028,222,214,230,258,36,28,44,44,-3.4503147495680855,-1.6576575309288264,-0.041748433290571,1.1824741642281478,274,264,284,283,9,-1,19,24,-1.2721245822573355,-0.7815167323678035,-0.30852223819512603,2.3826482814676595,18549,18824,Sharp and Nearby Counties,Randolph,5,121,Arkansas,AR
05135,05CS028,246,239,253,240,-6,-13,1,26,-9.138868161659591,-7.411408113108175,-5.736867868588241,-5.177475838465273,303,294,313,347,44,34,53,42,-0.44547898931060664,0.09072126526714093,0.5874744721598804,0.9431596320177345,17317,17572,Sharp and Nearby Counties,Sharp,5,135,Arkansas,AR
05003,05CS029,211,203,219,248,37,29,45,21,1.6178464154260652,3.3235360872665054,5.075461674916271,0.5563639261032566,255,246,265,321,66,56,75,37,1.0268220580064364,1.5342287992231272,2.0400417202049055,0.5549066436137544,19044,18716,Southeast Arkansas,Ashley,5,3,Arkansas,AR
05017,05CS029,134,129,138,149,15,11,20,25,-5.381198564136916,-3.782631318809942,-1.9252231490235607,1.517643760179456,162,156,167,171,9,4,15,13,-0.8619916919980329,-0.37463743665182075,0.1341735791066412,1.2598451261986678,10137,10037,Southeast Arkansas,Chicot,5,17,Arkansas,AR
05041,05CS029,143,138,147,151,8,4,13,13,-3.3186252006995876,-1.6139447967103584,-0.022172468966913998,1.3850874757960434,172,166,177,191,19,14,25,24,-0.908179751887806,-0.4263209451448107,0.08205306162670215,1.1803379298806,11315,11125,Southeast Arkansas,Desha,5,41,Arkansas,AR
05043,05CS029,171,164,179,238,67,59,74,23,8.330863151451252,10.08004616700716,11.738251796070529,0.3405524611143999,208,199,217,223,15,6,24,24,-1.0100296592559384,-0.5542978573827733,-0.03978915682371662,1.525023389241581,17402,17139,Southeast Arkansas,Drew,5,43,Arkansas,AR
05079,05CS029,129,123,135,151,22,16,28,27,-3.260501298576817,-1.5724357115157592,0.07899546018394835,1.1764291870838026,160,153,167,176,16,9,23,28,-1.4451459664361463,-0.9100814818014907,-0.4136971035494142,1.6362826479163974,12915,13014,Southeast Arkansas,Lincoln,5,79,Arkansas,AR
05023,05CS030,320,309,331,368,48,37,59,38,-0.03310634255892977,1.6253638298054973,3.379706435215712,0.7742011001178688,394,381,407,457,63,50,76,61,-0.4367015703491401,0.06827418273605068,0.5924485045535344,0.9570922912108077,24753,24964,Van Buren and Nearby Counties,Cleburne,5,23,Arkansas,AR
05101,05CS030,78,77,78,124,46,46,47,17,15.71325587078298,16.116509581750975,16.53863075263183,0.3593264580121261,94,94,95,139,45,44,45,15,3.9829071505132365,4.100340889438828,4.2337458416044615,0.3290932613048928,7274,7203,Van Buren and Nearby Counties,Newton,5,101,Arkansas,AR
05129,05CS030,100,99,101,91,-9,-10,-8,15,-12.528092789988886,-12.124712295636193,-11.757747032231483,-1.9283448844812485,123,122,124,158,35,34,36,15,2.446394623710742,2.5609653452673107,2.6937240264334217,0.41457073052712257,7838,7872,Van Buren and Nearby Counties,Searcy,5,129,Arkansas,AR
05137,05CS030,151,146,156,197,46,41,51,19,7.036328834421774,8.716976088815365,10.462150523295708,0.40415473840369626,186,179,192,243,57,51,64,25,2.102335407556445,2.610198283510167,3.0940418937692957,0.4277739359489245,12413,12464,Van Buren and Nearby Counties,Stone,5,137,Arkansas,AR
05141,05CS030,201,194,208,201,0,-7,7,13,-4.9960729600574485,-3.300890181265528,-1.6054575231386157,11.939954276623661,244,236,252,323,79,71,87,35,2.3300708071638074,2.825204035411307,3.3080212036344796,0.43567925484053566,15869,15704,Van Buren and Nearby Counties,Van Buren,5,141,Arkansas,AR
05143,05CS031,1481,1375,1587,1646,165,59,271,217,-2.579353869984886,-0.8690658445344509,0.799901624799973,1.3039910651216808,1854,1725,1983,2044,190,61,319,237,-0.6738605143618508,-0.19899534177435751,0.3154236246527462,1.2403376437661093,245955,249562,Washington,Washington,5,143,Arkansas,AR
05145,05CS032,711,678,744,841,130,97,163,55,2.1691234019612704,3.802872814860062,5.5215635999449875,0.4209841154808119,873,833,912,1094,221,182,261,111,0.9329337629841494,1.4358478049722312,1.9718586569146623,0.4990953666703277,77115,77149,White,White,5,145,Arkansas,AR
06001,06CS001,8592,7872,9312,9396,804,84,1524,635,-1.4243886656115328,0.4070350548106064,2.0636855180276497,0.7888445197072179,10539,9685,11392,11264,725,-128,1579,805,-0.5746002799852511,-0.0428820308185778,0.4533926424924806,1.1084350571432975,1674918,1653119,Alameda,Alameda,6,1,California,CA
06003,06CS002,18,18,19,19,1,0,1,4,-12.135618032147084,-11.772787851989673,-11.32731031785169,2.660582742857238,24,23,24,27,3,3,4,4,-0.5435977191983664,-0.41334605662394663,-0.28465833898655596,0.8916409151508271,1189,1230,Alpine and Nearby Counties,Alpine,6,3,California,CA
06005,06CS002,396,378,413,426,30,13,48,19,-0.6350434146455486,1.1336255317904667,2.895165264146402,0.6042728975696215,491,470,513,549,58,36,79,43,-0.153214745209509,0.3590088862189339,0.8795714821152393,0.7334496513144619,40492,41154,Alpine and Nearby Counties,Amador,6,5,California,CA
06009,06CS002,431,411,450,466,35,16,55,17,-0.1073080182940941,1.568910989160234,3.3317224278637947,0.4704076554003277,535,511,558,619,84,61,108,59,0.023600100256224454,0.5348324770056462,1.0576671250727694,0.6905523874907993,45536,46091,Alpine and Nearby Counties,Calaveras,6,9,California,CA
06027,06CS002,191,183,199,204,13,5,21,28,-4.763951044038893,-3.0924940602257203,-1.3839455941198195,1.9519260805875824,234,224,244,245,11,1,21,22,-1.1220393846790069,-0.5800908822398014,-0.03388588977472539,1.8186254775765627,18867,18978,Alpine and Nearby Counties,Inyo,6,27,California,CA
06051,06CS002,54,53,55,39,-15,-16,-14,2,-5.486814969628969,-5.080474232859807,-4.656183485109787,-0.14293831304513802,68,66,69,64,-4,-5,-2,4,-0.7078555873961591,-0.5805044131708169,-0.44548414951321497,-1.4826495776703958,13392,13241,Alpine and Nearby Counties,Mono,6,51,California,CA
06007,06CS003,1877,1786,1968,1992,115,24,206,132,-2.0726195822257667,-0.3102011542883696,1.4166234067659187,1.1374458194411317,2273,2165,2381,2569,296,188,404,293,-0.5305081304466084,0.007261195334186678,0.5342723700124075,0.9866719717789245,211159,208568,Butte,Butte,6,7,California,CA
06011,06CS004,148,139,157,155,7,-2,16,15,-3.1500651365630694,-1.5032257298605145,0.16338383957838043,1.8888626456923872,183,171,194,183,0,-11,12,23,-1.5406392783505451,-1.0263163976552727,-0.5327625047970801,18.70754907295726,21804,21908,Colusa+Lake,Colusa,6,11,California,CA
06033,06CS004,777,747,806,719,-58,-87,-28,39,-7.46544971475718,-5.726974225927885,-4.029263388312622,-0.6901895426183989,956,921,991,956,0,-35,35,89,-1.8209496143986397,-1.2954923972543368,-0.8024839632703215,87.58871869190837,67694,68680,Colusa+Lake,Lake,6,33,California,CA
06013,06CS005,6794,6293,7294,7277,483,-17,984,422,-1.451385102089643,0.23541557665718943,2.0134713353602884,0.8714293227775489,8388,7788,8988,9111,723,123,1323,650,-0.43106241908248744,0.05899333318608103,0.5667962031253604,0.89815219911675,1163281,1162018,Contra Costa,Contra Costa,6,13,California,CA
06015,06CS006,260,248,272,283,23,11,35,6,0.7535253168353553,2.341340895675983,4.076094583911228,0.25211687308541886,322,307,336,380,58,44,73,45,-0.07377606415886123,0.4460675696856469,0.9954012769600988,0.7624334467757279,27778,28043,Del Norte+Humboldt+Trinity,Del Norte,6,15,California,CA
06023,06CS006,1148,1089,1207,1200,52,-7,111,23,-0.902016590505337,0.8832669773537268,2.4462730849296332,0.43390698566887964,1411,1340,1481,1602,191,121,262,93,0.2000655251909632,0.735866851624659,1.260274443715807,0.48328514687177093,136272,136316,Del Norte+Humboldt+Trinity,Humboldt,6,23,California,CA
06105,06CS006,165,163,166,147,-18,-19,-16,4,-6.028652322938973,-5.606298822658592,-5.230492797306519,-0.2378510829726666,209,207,211,198,-11,-13,-9,19,-1.989322054938497,-1.8636676485733572,-1.7386772012697513,-1.9088072090856367,15538,16064,Del Norte+Humboldt+Trinity,Trinity,6,105,California,CA
06017,06CS007,1353,1270,1435,1514,161,79,244,72,0.11989857377415197,1.8845613169451367,3.586642168853643,0.44319489633850484,1676,1576,1775,1902,226,127,326,159,-0.17683284662080184,0.3418375613701909,0.8602590819462681,0.6994115664595788,191617,192914,El Dorado,El Dorado,6,17,California,CA
06019,06CS008,6034,5601,6468,7507,1473,1039,1906,937,0.37841336229875566,2.1349047327818216,3.892467916936494,0.6358953385905118,7503,6980,8026,9345,1842,1319,2365,1402,-0.07973990830278507,0.43142774480107277,0.949410719000093,0.7608434570782251,1007825,1012908,Fresno,Fresno,6,19,California,CA
06021,06CS009,233,220,245,223,-10,-22,3,22,-6.169246591219412,-4.360381039853071,-2.757993407217373,-2.4765874263580923,287,272,302,330,43,28,58,59,-1.0358216779895257,-0.5377490209374381,-0.014877080387471747,1.3310390927083093,28818,28818,Glenn+Tehama,Glenn,6,21,California,CA
06103,06CS009,612,584,640,679,67,39,95,44,-0.3345117872035444,1.4389872041777574,3.0357377191958097,0.648742101625862,751,717,785,940,189,155,223,129,0.41007827515898804,0.9031696363927338,1.404708020147363,0.6790419770242712,65540,65515,Glenn+Tehama,Tehama,6,103,California,CA
06025,06CS010,969,951,987,1660,691,673,709,529,3.2308415054458846,3.6054276110202887,4.016189029837189,0.7642393289368794,1196,1173,1218,1585,389,367,412,344,0.13004434881989901,0.2535871656631446,0.37734877283147517,0.8811409409052161,179665,179798,Imperial,Imperial,6,25,California,CA
06029,06CS011,5345,4954,5736,6535,1190,799,1581,678,0.5830089933454654,2.2729925245672913,3.964298440567237,0.5692899772825795,6672,6199,7145,8582,1910,1437,2383,1345,0.07685030563283053,0.634182211293751,1.109378161332403,0.7038561627298426,909178,916554,Kern,Kern,6,29,California,CA
06031,06CS012,749,683,814,920,171,106,237,113,-0.19160307727881692,1.4701492489959693,3.1545790243949434,0.6557680702689436,938,859,1017,1301,363,284,442,225,0.4076192505814213,0.9088225200567769,1.4223083069216893,0.6181271924070978,152727,153324,Kings,Kings,6,31,California,CA
06035,06CS013,223,209,237,247,24,10,38,16,-0.7265974932474905,1.0466514642850058,2.670703019253802,0.6341199927462425,278,261,296,364,86,68,103,65,0.10483660837391387,0.5979926739548578,1.1683135957051318,0.7510922721797665,32470,33095,Lassen+Plumas+Sierra,Lassen,6,35,California,CA
06063,06CS013,203,194,211,232,29,21,38,7,2.8238333513445184,4.552137370974381,6.271943935780305,0.2304455337875594,249,239,260,278,29,18,39,30,-0.5745435370675039,-0.07128225130576996,0.4625967363176322,1.0162180200201485,19680,19894,Lassen+Plumas+Sierra,Plumas,6,63,California,CA
06091,06CS013,32,31,32,36,4,4,5,1,3.759441087889112,4.174257705567473,4.549633239778805,0.1873972223649038,40,39,40,37,-3,-3,-2,3,-1.8920815386902883,-1.7757523331643257,-1.6493989720388054,-1.6570807662010616,3194,3275,Lassen+Plumas+Sierra,Sierra,6,91,California,CA
06037,06CS014,53793,49505,58081,69724,15931,11643,20219,11176,0.17324066445435315,1.917020179614629,3.620185388866387,0.7014837755590095,66022,60935,71108,82176,16154,11068,21241,13943,-0.30927559014711686,0.22989923125416722,0.7143893726628663,0.8630508098428714,9975810,9852822,Los Angeles,Los Angeles,6,37,California,CA
06039,06CS015,949,882,1017,1137,188,120,255,170,-1.2940197325996954,0.45017718031380033,1.9770213035337627,0.9012352195677493,1188,1106,1270,1494,306,224,388,269,-0.2905216135756261,0.2346739493233462,0.7680698772530578,0.8753441181274545,156925,159003,Madera,Madera,6,39,California,CA
06041,06CS016,1665,1552,1777,1754,89,-23,202,114,-2.097186044032606,-0.38722476725841354,1.3174318190389076,1.2644057464614553,2048,1914,2183,2165,117,-18,251,76,-0.3891369261383269,0.14007886819147092,0.6525597445964733,0.6460557304058087,261220,260435,Marin,Marin,6,41,California,CA
06043,06CS017,173,166,180,175,2,-5,9,5,-2.384480559441768,-0.672330765828193,1.010512546645223,1.7037755666682626,212,203,220,243,31,23,40,22,0.01799410415913727,0.5436212371186676,1.0956536707967097,0.6783780924456176,17125,17144,Mariposa+Tuolumne,Mariposa,6,43,California,CA
06109,06CS017,583,559,607,647,64,40,88,33,0.6083522873678334,2.208892332067689,4.022306029862834,0.5100991650919414,716,687,745,847,131,102,160,115,-0.22699799027666723,0.2814291167237479,0.8414470019245216,0.8708486418446073,55368,55767,Mariposa+Tuolumne,Tuolumne,6,109,California,CA
06045,06CS018,753,714,793,870,117,77,156,35,1.8782217883209977,3.6000948004892006,5.380229411911365,0.29758426290599466,928,881,975,1056,128,81,175,65,0.19442607459968284,0.6958454315955306,1.2052905405954228,0.5039629449147802,90704,91312,Mendocino,Mendocino,6,45,California,CA
06047,06CS019,1566,1445,1687,1948,382,261,503,260,0.11543485791352101,1.7602960866605735,3.537729041226899,0.6789652968557184,1964,1817,2112,2341,377,229,524,384,-0.5328302035479059,-0.019016099959472704,0.4516685412206021,1.0171171676316133,281547,285770,Merced,Merced,6,47,California,CA
06049,06CS020,94,93,95,101,7,6,8,2,2.048496562254663,2.4702925644578753,2.849564176318464,0.24075128192197814,114,113,116,141,27,25,28,12,1.5502740218438662,1.6721572047805269,1.8035060279693182,0.43625478490937813,8689,8661,Modoc+Siskiyou,Modoc,6,49,California,CA
06093,06CS020,492,473,511,542,50,31,69,14,1.571459486999291,3.31345702639886,4.999252263332908,0.27340334860235055,600,577,623,742,142,119,165,75,1.019410234667291,1.5249886909618755,2.048608537786161,0.5238670076145315,43935,44095,Modoc+Siskiyou,Siskiyou,6,93,California,CA
06053,06CS021,2246,2058,2434,2539,293,105,481,256,-1.391842696988487,0.3156099522620945,2.07433775804193,0.8707508104153188,2788,2562,3014,3156,368,142,594,367,-0.479524400082098,0.021628802969584422,0.5091863395027754,0.9938555173980569,437631,437496,Monterey,Monterey,6,53,California,CA
06055,06CS022,1032,973,1091,1043,11,-48,70,38,-2.468944289081703,-0.7560161966404072,0.8564275197387373,3.127573076716649,1259,1189,1329,1344,85,15,155,73,-0.4280684540773895,0.09096176955655708,0.6150973518875963,0.8483035357130165,137472,136411,Napa,Napa,6,55,California,CA
06057,06CS023,910,866,954,988,78,34,122,63,-1.1275821004087905,0.558297797511677,2.2546164870603067,0.8001839856557141,1129,1075,1182,1207,78,25,132,67,-0.39660856294671426,0.09574823825704087,0.5857608576900352,0.8429256253778695,101961,103299,Nevada,Nevada,6,57,California,CA
06059,06CS024,17174,15806,18542,19959,2785,1417,4153,2459,-1.3315540795197665,0.3994423555768894,2.0909508819911404,0.8826554610231877,21266,19630,22903,25158,3892,2255,5528,3517,-0.3941586854820676,0.11377641454226667,0.63463085693575,0.9035011807234007,3180472,3170185,Orange,Orange,6,59,California,CA
06061,06CS025,2880,2706,3055,2988,108,-67,282,157,-2.1567243189649545,-0.5061599637135933,1.2186116130089566,1.4460858903183373,3588,3376,3800,3892,304,92,516,306,-0.48935994208185457,-0.008536397565013835,0.5700590942595113,1.0035430756830555,405429,411343,Placer,Placer,6,61,California,CA
06065,06CS026,14474,13429,15520,18545,4071,3025,5116,2657,0.6517489744830539,2.280375569837458,4.113606379865207,0.6525436028795237,18083,16817,19350,23058,4975,3708,6241,3945,-0.0906435205709119,0.4346066339977562,0.9383025210010503,0.7928592532014301,2432718,2453199,Riverside,Riverside,6,65,California,CA
06067,06CS027,10289,9608,10970,11312,1023,342,1704,948,-1.437886045618623,0.1492979890393939,1.968703784285982,0.925494466938014,12737,11917,13557,13863,1126,306,1946,1326,-0.666134013196612,-0.11865384833290973,0.402117292747112,1.1768554989481603,1581477,1588530,Sacramento,Sacramento,6,67,California,CA
06069,06CS028,321,293,349,352,31,3,59,32,-1.845221503598965,-0.12778261827023982,1.662514499814861,1.0087040810558159,411,376,445,475,64,30,99,60,-0.43229519744059114,0.04850050772663247,0.6077834630862051,0.9179322874024511,64485,66361,San Benito,San Benito,6,69,California,CA
06071,06CS029,12427,11488,13366,16663,4236,3297,5175,2747,1.049600825435295,2.753187219147906,4.472100699789005,0.6483113434323671,15478,14346,16610,19890,4412,3280,5544,3626,-0.11104995852842674,0.35878355630732506,0.8605252949523052,0.8216248967750235,2183190,2192964,San Bernardino,San Bernardino,6,71,California,CA
06073,06CS030,18345,16927,19764,20772,2427,1008,3845,1748,-0.7866656488053345,0.874297720291496,2.628862579681258,0.7200794978483493,22684,20986,24381,26416,3732,2035,5430,2869,-0.19844717263400996,0.2636813841461065,0.7578757635872513,0.7685143704689232,3300930,3287700,San Diego,San Diego,6,73,California,CA
06075,06CS031,4876,4505,5248,5343,467,95,838,222,-0.686620554868879,1.0916874111478883,2.926142077510509,0.4748040448295668,5759,5334,6184,6568,809,384,1234,342,0.0543814288602446,0.5555350309703628,1.0715202006369926,0.42214860933446013,865589,823195,San Francisco,San Francisco,6,75,California,CA
06077,06CS032,4956,4620,5291,5976,1020,685,1356,793,-0.5987360060530564,1.1544695948548411,2.817489902093138,0.776407216058266,6177,5770,6584,7226,1049,642,1456,1092,-0.5559744443263552,-0.045128108862096665,0.4559108925199744,1.0399491625767443,778680,788113,San Joaquin,San Joaquin,6,77,California,CA
06079,06CS033,2064,1943,2186,2068,4,-118,125,116,-3.4646494734514954,-1.6288635424180644,0.18674135104498402,24.704420403969834,2546,2400,2692,2670,124,-22,270,248,-0.9270518758256976,-0.43132483060366916,0.04919757414854294,1.988516781968411,282400,283024,San Luis Obispo,San Luis Obispo,6,79,California,CA
06081,06CS034,4001,3674,4327,4151,150,-176,477,248,-2.2401913480828,-0.5505768237910839,1.2513042546448887,1.6385861459601194,4847,4464,5230,5115,268,-115,651,357,-0.6456774983815208,-0.11727950380535429,0.3748229866774734,1.3268469639280978,760238,741470,San Mateo,San Mateo,6,81,California,CA
06083,06CS035,2738,2546,2931,2900,162,-31,354,177,-1.819467687961544,-0.19803851214018117,1.5832384332256944,1.0870822557017645,3380,3149,3611,3659,279,48,510,378,-0.7288140821933308,-0.21370539815890788,0.26653081322674455,1.3502545071382592,447543,446711,Santa Barbara,Santa Barbara,6,83,California,CA
06085,06CS036,8680,7852,9507,9579,899,72,1727,852,-1.7289181544414292,0.11835345134391566,1.7782994426601737,0.9463219078999126,10655,9678,11632,11347,692,-285,1669,1085,-0.7582666326638346,-0.20996630913045736,0.3155739514704638,1.5658309361399507,1924707,1892084,Santa Clara,Santa Clara,6,85,California,CA
06087,06CS037,1478,1362,1594,1583,105,-11,221,122,-2.023272376695242,-0.26179628177734765,1.3846923872178525,1.1494185248322761,1819,1681,1957,2003,184,46,322,147,-0.4461878196877175,0.12256565155277917,0.6747168500338673,0.794772287325166,270453,268165,Santa Cruz,Santa Cruz,6,87,California,CA
06089,06CS038,1926,1848,2004,2068,142,64,220,102,-0.8723081783724207,0.8994461285766115,2.4387291669533355,0.7143509692783934,2356,2262,2450,2775,419,325,513,346,-0.11428474980942693,0.39560158972090254,0.9218296345423544,0.8242229105816785,181591,182103,Shasta,Shasta,6,89,California,CA
06095,06CS039,2950,2756,3145,3118,168,-27,362,171,-1.7174388053415286,-0.0016415918444952712,1.6601142648115081,1.0127566896372848,3642,3409,3875,4077,435,202,668,358,-0.3490916879790899,0.17318127099064848,0.6548535536009892,0.8208233658950901,452260,451943,Solano,Solano,6,95,California,CA
06097,06CS040,3429,3219,3639,3693,264,54,474,196,-1.2044190796166891,0.6139772432492733,2.3772981979151417,0.7388033785665068,4205,3954,4456,4555,350,99,601,232,-0.3192549005171587,0.24025626064227049,0.7525746649483626,0.661645806337674,488668,486245,Sonoma,Sonoma,6,97,California,CA
06099,06CS041,3728,3491,3966,4541,813,575,1050,634,-0.4279123102118936,1.2808012187633697,3.015525788917906,0.7793061331175907,4597,4312,4883,5580,983,697,1268,860,-0.3225432658348137,0.22238810518587385,0.7357788940633664,0.8744137715185365,552310,552957,Stanislaus,Stanislaus,6,99,California,CA
06101,06CS042,736,693,778,799,63,21,106,62,-1.6354316353201825,0.1005566134009985,1.7474726368872018,0.9657787655410642,904,853,955,1012,108,57,159,146,-0.9033966953600789,-0.38580146083720457,0.10823824428352853,1.3419895648630495,99062,99124,Sutter,Sutter,6,101,California,CA
06107,06CS043,2700,2496,2904,3323,623,419,827,451,-0.26561387096389383,1.4337017810505202,3.0789850538878727,0.722766008510811,3364,3118,3610,4330,966,720,1212,783,-0.1680254480824435,0.4003092212529222,0.8886176559824313,0.8096587750902775,472917,476570,Tulare,Tulare,6,107,California,CA
06111,06CS044,4888,4525,5250,5547,659,297,1022,376,-0.3014099748712087,1.3185983795615186,3.003689883600625,0.569369215027429,6039,5606,6473,7127,1088,654,1521,818,-0.18783844037885528,0.31315021347143507,0.8289795638842149,0.7513938366125946,842781,840241,Ventura,Ventura,6,111,California,CA
06113,06CS045,1125,1032,1218,1253,128,35,221,110,-1.392649799599022,0.3255839169521768,2.0383840233207997,0.8545869471307324,1398,1286,1510,1540,142,30,254,131,-0.46838456090887265,0.05079114101278914,0.5485858813885022,0.9145043893995619,216880,216879,Yolo,Yolo,6,113,California,CA
06115,06CS046,587,552,622,561,-26,-61,9,29,-4.403928846886537,-2.625421769798384,-1.0692881352827783,-1.162390129807599,733,690,776,805,72,29,115,85,-0.6927768243158376,-0.17264164859540987,0.31310055272919707,1.1714345215519086,81594,83204,Yuba,Yuba,6,115,California,CA
08005,08CS002,3365,3084,3647,4174,809,527,1090,492,0.12160687098024608,1.894673466285652,3.7079773973114327,0.6076196895536361,4177,3839,4516,4869,692,353,1030,392,-0.07971591869811365,0.469835861932027,1.0041189585952455,0.5660328029592566,655227,654931,Arapahoe,Arapahoe,8,5,Colorado,CO
08015,08CS005,156,148,165,182,26,17,34,15,0.34944363056812283,2.164828642750185,3.9410189428982587,0.5630290005314309,194,183,204,167,-27,-37,-16,12,-2.4536033787663216,-1.934496394346161,-1.4397465147205593,-0.4667587997641602,19732,20001,Central Colorado,Chaffee,8,15,Colorado,CO
08051,08CS005,66,64,67,70,4,3,6,5,-0.5227941094063169,-0.11378970438044046,0.27831581203412353,0.9109185259941631,81,79,83,89,8,6,10,7,-0.07071687156476057,0.06631140153626756,0.19931965408206997,0.7648590105697685,17058,17232,Central Colorado,Gunnison,8,51,Colorado,CO
08065,08CS005,32,31,33,31,-1,-2,-0,6,-4.136076619845569,-3.74671176942227,-3.375926240641167,-115.08822913219949,39,38,40,58,19,18,20,4,1.9472729586545858,2.075927009193836,2.2034795861124534,0.19634159091297684,7505,7407,Central Colorado,Lake,8,65,Colorado,CO
08097,08CS005,50,48,52,60,10,8,12,6,0.5241092863453745,0.9339472489359052,1.3069293059382636,0.5425190922451122,61,59,63,72,11,9,13,8,0.05418305814342024,0.17953808439391886,0.3045779611308991,0.6573440410151941,17424,17347,Central Colorado,Pitkin,8,97,Colorado,CO
08109,08CS005,40,39,41,53,13,12,14,3,5.806811656785112,6.236699327777309,6.629579694653431,0.21344978583280538,49,48,50,68,19,18,20,2,2.5578818835721044,2.6746586783048767,2.7968564467258803,0.09864666103998558,6457,6458,Central Colorado,Saguache,8,109,Colorado,CO
08027,08CS006,38,37,38,46,8,8,9,6,1.41162502275951,1.7848184199645234,2.1650271843503166,0.6562297799556723,48,48,49,61,13,12,13,17,-0.9767619820138554,-0.8522495923437438,-0.722593321453457,1.237339335472235,4806,4996,Custer+Fremont,Custer,8,27,Colorado,CO
08043,08CS006,490,469,511,533,43,22,64,26,-0.39196157475610527,1.4406100415493042,3.1130695572809373,0.5897158684557707,606,581,632,755,149,123,174,137,-0.2839478206438291,0.24282469973566095,0.7331377139622682,0.915994472133221,48910,49562,Custer+Fremont,Fremont,8,43,Colorado,CO
08029,08CS007,342,329,356,371,29,15,42,23,-0.9193949043514098,0.7119603729913727,2.4427451649710124,0.7688109550057239,422,406,439,504,82,65,98,93,-0.8898533825259038,-0.36784683537772417,0.15634146621474604,1.125000545102591,31246,31598,Delta+Montrose,Delta,8,29,Colorado,CO
08085,08CS007,384,365,402,417,33,15,52,27,-1.128710420657526,0.5781660053387923,2.248718091983552,0.7889167523400334,474,451,496,613,139,117,162,114,0.03285803381959582,0.5993518838624465,1.0578918793189553,0.8124158130918521,42836,43114,Delta+Montrose,Montrose,8,85,Colorado,CO
08031,08CS008,3944,3635,4253,4938,994,685,1303,647,0.20792950457406428,1.9479284589218564,3.5577101901140136,0.650248827865789,4844,4476,5212,5229,385,17,753,408,-0.5753416847278475,-0.029358432942779986,0.487606565011749,1.0563902516643044,718136,712362,Denver,Denver,8,31,Colorado,CO
08035,08CS009,1298,1143,1453,1611,313,158,468,166,-0.06929695075155068,1.613004833447557,3.3801588425401334,0.5288475175357508,1670,1480,1859,1994,324,135,514,165,-0.0867181442140985,0.42904594227295745,0.9796723286348318,0.5069715444539913,359823,367694,Douglas,Douglas,8,35,Colorado,CO
08037,08CS010,135,130,141,130,-5,-11,0,13,-1.7302869265483973,-1.3306304771679525,-0.9309727121769779,-2.9325928533350254,170,163,177,189,19,12,26,16,-0.06920972010403612,0.047738142822813204,0.1755437250402479,0.8078476180700565,55601,55718,Eagle,Eagle,8,37,Colorado,CO
08039,08CS011,140,128,151,150,10,-1,22,13,-2.2205604095270606,-0.4640645692552516,1.2726811775046483,1.1587174614398819,178,164,192,210,32,18,46,25,-0.26477836202322774,0.2626943610363772,0.772092876147201,0.7583019554248583,26375,26994,East Central Colorado,Elbert,8,39,Colorado,CO
08063,08CS011,57,56,58,81,24,23,25,5,10.44972165233038,10.823171871704586,11.237817301417772,0.19885566149141531,69,68,70,103,34,33,35,15,2.6551521007681225,2.7798637456642425,2.904051218967113,0.4240417641132471,7066,6967,East Central Colorado,Kit Carson,8,63,Colorado,CO
08073,08CS011,49,48,50,50,1,0,2,4,-2.536776150946642,-2.1545185862293166,-1.7389533289731605,2.0662201497545554,60,59,61,67,7,6,8,6,0.031179495033364167,0.1528700481687724,0.27461353655916204,0.7646425699484473,5675,5685,East Central Colorado,Lincoln,8,73,Colorado,CO
08121,08CS011,45,44,45,65,20,20,21,14,4.744964746248229,5.143875234257826,5.5656085421689685,0.6592258024781198,55,54,56,67,12,11,13,14,-0.5546393252891089,-0.4237149851856518,-0.2959257106280532,1.0816826216628397,4828,4854,East Central Colorado,Washington,8,121,Colorado,CO
08125,08CS011,84,83,85,101,17,16,18,12,1.7503906523456945,2.1445508824342188,2.5319474653324643,0.6550397385774489,102,101,103,103,1,-0,2,7,-0.734607535807798,-0.6130838672151354,-0.4897161370240633,3.6223405036674263,9981,9947,East Central Colorado,Yuma,8,125,Colorado,CO
08041,08CS012,4265,3950,4579,5200,935,621,1250,530,0.39716234322298827,2.2068449475158896,3.884364105880184,0.5661185926581662,5324,4944,5705,6483,1159,778,1539,828,-0.06188712590502268,0.447762758481595,0.9198700264413505,0.713908305875705,731028,736989,El Paso,El Paso,8,41,Colorado,CO
08045,08CS013,314,288,341,338,24,-3,50,36,-2.4056036606142337,-0.8105396339256931,0.8169079933912247,1.4672560340271912,394,362,426,423,29,-3,61,40,-0.7059629591282724,-0.1499232216135439,0.33242069423422993,1.326218380908378,61562,62105,Garfield,Garfield,8,45,Colorado,CO
08059,08CS014,10102,9311,10892,11827,1725,935,2516,1405,-1.049763740369317,0.6616742074957588,2.4795876814877533,0.8138646491731543,12564,11611,13517,14154,1590,637,2543,1420,-0.4180075844679568,0.08431775262688786,0.5942953257387652,0.8925062932102045,1837707,1845626,Jefferson,Jefferson,8,59,Colorado,CO
08067,08CS015,295,271,319,362,67,43,91,24,1.4638075328507152,3.084891542397134,4.70942582236564,0.3542001240473578,369,340,398,440,71,42,100,36,0.07787164283080357,0.6234980617273478,1.101346420248024,0.5027877035734952,55822,56161,La Plata+Montezuma,La Plata,8,67,Colorado,CO
08083,08CS015,230,219,242,251,21,9,32,16,-1.0114802643257124,0.6714190026371075,2.3543738984517812,0.741535334190811,284,271,298,370,86,72,99,47,0.9609610135057208,1.4660980278611278,1.9546872309220642,0.5428965800676557,25966,26129,La Plata+Montezuma,Montezuma,8,83,Colorado,CO
08069,08CS016,2055,1901,2210,2213,158,3,312,114,-1.2212075438163763,0.5771899376838803,2.241441517649733,0.7189694880615641,2557,2370,2744,2778,221,34,408,241,-0.537149697874284,-0.06119219095612214,0.4610330555790359,1.085146910080791,359626,362118,Larimer,Larimer,8,69,Colorado,CO
08075,08CS017,180,171,189,264,84,75,93,55,3.705121601715608,5.347350138134895,6.905414516227736,0.6483338759940867,220,209,231,272,52,41,63,46,-0.24096978063395352,0.2659686565797302,0.8233482892278468,0.8678730951434638,21627,21488,Logan+Morgan+Phillips+Sedgwick,Logan,8,75,Colorado,CO
08087,08CS017,236,224,249,296,60,47,72,71,-3.2754866177912776,-1.5177195053063337,0.10843128666379859,1.1665976277849164,289,274,304,330,41,26,56,44,-0.6151619459448344,-0.12502875638191063,0.38583026757159355,1.0560773343947207,29041,29016,Logan+Morgan+Phillips+Sedgwick,Morgan,8,87,Colorado,CO
08095,08CS017,45,45,46,67,22,21,22,2,17.043416589512322,17.448952050066158,17.84725245734313,0.08826533440382324,55,55,56,71,16,15,16,1,3.110919509343206,3.234611469463856,3.356401059025676,0.060313181904447795,4506,4515,Logan+Morgan+Phillips+Sedgwick,Phillips,8,95,Colorado,CO
08115,08CS017,31,30,31,41,10,10,11,5,8.826249065257823,9.235131029358877,9.611535539520958,0.4361016718667486,37,37,37,34,-3,-3,-3,3,-2.607490060553051,-2.495336882463719,-2.3702551876882696,-1.6187320792300148,2367,2344,Logan+Morgan+Phillips+Sedgwick,Sedgwick,8,115,Colorado,CO
08077,08CS018,1336,1269,1403,1536,200,133,267,108,0.6930435717627508,2.411168639337514,3.9741897244213678,0.5366637097478603,1652,1571,1733,1995,343,262,424,319,-0.3253142846323817,0.141284330165961,0.6819548949749464,0.9273377283050831,155882,157131,Mesa,Mesa,8,77,Colorado,CO
08049,08CS019,67,66,69,64,-3,-5,-2,4,-2.256773549196226,-1.845760822466801,-1.413822101695663,-1.787338815122379,84,82,86,100,16,14,18,13,0.09655793465841199,0.21905782425929932,0.34615093595458507,0.7447177088686319,15748,15841,Northwest Colorado,Grand,8,49,Colorado,CO
08057,08CS019,11,11,11,11,-0,-0,0,8,-23.735527737724308,-23.335679219496722,-22.973585254814815,8.36087835149794,13,13,14,14,1,0,1,7,-4.833430600277207,-4.696450903193918,-4.574512401625019,4.422514213740079,1378,1365,Northwest Colorado,Jackson,8,57,Colorado,CO
08081,08CS019,87,86,88,139,52,51,53,21,8.989841809407425,9.39977864727675,9.794699674711895,0.39556977040998076,106,105,108,157,51,49,52,32,1.2821565209104016,1.4154393288816045,1.531622553719698,0.619602734421738,13250,13197,Northwest Colorado,Moffat,8,81,Colorado,CO
08103,08CS019,46,45,46,56,10,10,11,3,4.117729798865256,4.538337201684869,4.935875291657362,0.2637022704590461,56,55,57,70,14,13,15,10,0.4970391789096999,0.6249098094599833,0.7501531993064161,0.6647061336430266,6489,6482,Northwest Colorado,Rio Blanco,8,103,Colorado,CO
08107,08CS019,105,103,108,115,10,7,12,21,-2.1889736077296917,-1.7671867977828932,-1.3867950232735375,1.935822263270531,130,127,134,133,3,-1,6,3,-0.13233843298117887,-0.01883704873996478,0.12316891375882646,0.8183642226144552,24973,25054,Northwest Colorado,Routt,8,107,Colorado,CO
08019,08CS020,53,52,54,57,4,3,5,4,-0.5751590197547691,-0.1576052153049726,0.25994972128194854,0.8620646379259074,66,65,67,68,2,1,3,1,-0.001052873967727611,0.1285610389109063,0.2615302448700539,0.30829157248832184,9437,9440,Park and Nearby Counties,Clear Creek,8,19,Colorado,CO
08047,08CS020,27,26,27,27,0,-0,1,6,-4.259452373046276,-3.849645252678416,-3.424774694501414,4.419033887025633,33,32,34,40,7,6,8,1,0.9082468291712632,1.0484969541305404,1.172395124703958,0.1225964036231465,5878,5864,Park and Nearby Counties,Gilpin,8,47,Colorado,CO
08093,08CS020,86,84,87,113,27,26,29,8,3.975621742963315,4.366957483651519,4.769261277568633,0.28267997713746523,106,104,108,118,12,10,14,10,-0.004347288040665034,0.12093056938253417,0.23811889198193503,0.7611330143108145,17665,17676,Park and Nearby Counties,Park,8,93,Colorado,CO
08117,08CS020,71,68,74,72,1,-2,4,6,-1.0312039636386976,-0.6341226204975745,-0.23821078404039267,2.8152057695841974,89,85,93,88,-1,-5,3,7,-0.3843712074604046,-0.2537920713454499,-0.1348067925345976,78.18484800136655,30950,30945,Park and Nearby Counties,Summit,8,117,Colorado,CO
08119,08CS020,150,139,161,183,33,22,44,3,3.0549789668929175,4.781742290732129,6.584784997413191,0.08865562159199297,186,173,199,288,102,89,115,42,1.8889945253598999,2.40765453863813,2.957548264922646,0.4083379919988172,24846,24897,Park and Nearby Counties,Teller,8,119,Colorado,CO
08101,08CS021,1560,1488,1633,1998,438,365,510,262,2.396520155517828,4.199667722619546,5.931005638143503,0.5971804065849279,1924,1837,2012,2470,546,458,633,365,0.5190558889775634,1.0635040864732832,1.5711681969231244,0.6677564019138519,168579,169454,Pueblo,Pueblo,8,101,Colorado,CO
08009,08CS022,44,43,44,60,16,16,17,2,15.949171786793347,16.38682764701897,16.785123016201297,0.1151142235930357,53,53,54,78,25,24,25,3,6.086902431133017,6.217424124953928,6.3396120411818435,0.11617943552862016,3508,3510,Southeast Colorado,Baca,8,9,Colorado,CO
08011,08CS022,54,53,55,67,13,12,14,5,5.246550908853035,5.62887964410073,6.048315981914267,0.35839051824062534,67,66,68,85,18,17,19,22,-0.8318322494073395,-0.7093954246047849,-0.5797055244382098,1.162369134156919,5640,5741,Southeast Colorado,Bent,8,11,Colorado,CO
08017,08CS022,15,15,16,23,8,7,8,2,12.572721344592127,12.965978201062123,13.373127405191019,0.23085667611925725,18,18,19,24,6,5,6,7,-0.9034188818787721,-0.7828222780657227,-0.6536245807520185,1.0494572420470565,1746,1711,Southeast Colorado,Cheyenne,8,17,Colorado,CO
08021,08CS022,68,67,69,79,11,10,12,4,3.161599814403902,3.548560430008671,3.96038530807964,0.34086597140611835,83,82,84,139,56,55,57,48,0.8798748798959964,1.0098751130193813,1.1267637690692769,0.8468950274924275,7582,7590,Southeast Colorado,Conejos,8,21,Colorado,CO
08023,08CS022,33,32,33,35,2,2,3,8,-6.760411611292268,-6.36202477717846,-5.946203202061069,2.408806022311859,40,40,41,58,18,17,18,10,2.0217575642151213,2.1493902118751484,2.2677202002325907,0.5331179261713108,3572,3608,Southeast Colorado,Costilla,8,23,Colorado,CO
08025,08CS022,41,40,42,63,22,21,23,0,14.432900986895595,14.829218495345177,15.21058575728705,0,51,50,51,69,18,18,19,13,0.7490360011482713,0.8833563107051297,1.002491459653379,0.6746467061198239,5919,5995,Southeast Colorado,Crowley,8,25,Colorado,CO
08055,08CS022,91,91,92,113,22,21,22,10,6.446533957118326,6.835641500706203,7.232962431058631,0.440688748218172,112,112,113,138,26,25,26,7,2.562483567600261,2.6902615286526843,2.8067261615865897,0.26361753830408036,6830,6904,Southeast Colorado,Huerfano,8,55,Colorado,CO
08061,08CS022,18,18,18,17,-1,-1,-1,3,-11.558524142320627,-11.151446892437573,-10.748873554457527,-84.37692695096487,22,22,22,20,-2,-2,-2,3,-3.6033974555318764,-3.4785122745101007,-3.3437297216525335,-2.8497041121836353,1447,1452,Southeast Colorado,Kiowa,8,61,Colorado,CO
08071,08CS022,159,152,165,164,5,-1,12,5,-1.6508583096325191,0.09162308973325055,1.7802289800775708,0.7882146575649901,193,186,201,239,46,38,53,27,0.7529703752010148,1.2726335308778542,1.822960809689243,0.5780510777121618,14549,14623,Southeast Colorado,Las Animas,8,71,Colorado,CO
08089,08CS022,206,198,214,264,58,50,66,36,3.0648398308156506,4.7769793929521125,6.412691431097868,0.60924357520857,250,240,259,313,63,54,73,62,-0.42951360353122964,0.08558931392031414,0.5875884441923263,0.9616225111307285,18598,18605,Southeast Colorado,Otero,8,89,Colorado,CO
08099,08CS022,110,108,111,148,38,37,40,18,6.413081167848947,6.805517332211605,7.225295052631809,0.45647418431881964,133,132,135,181,48,46,49,22,1.9989136146498854,2.130155495439695,2.2538757611975,0.45337079702190386,12005,11995,Southeast Colorado,Prowers,8,99,Colorado,CO
08003,08CS023,135,128,142,140,5,-2,12,21,-5.709538055716553,-3.9689992001272585,-2.324453677974105,3.5951681100337294,167,159,176,187,20,11,28,26,-0.9230213080275513,-0.39713644584439034,0.1056015802422805,1.2628288045893445,16358,16520,Southwest Colorado,Alamosa,8,3,Colorado,CO
08007,08CS023,92,91,94,90,-2,-4,-1,4,-2.282981083256069,-1.8804089419238137,-1.468815727020039,-3.082249432249265,116,114,118,135,19,17,21,11,0.44690254678997204,0.5675074429178726,0.6956028989039319,0.5557751202439576,13536,13737,Southwest Colorado,Archuleta,8,7,Colorado,CO
08033,08CS023,23,22,24,21,-2,-3,-1,8,-18.922495698374522,-17.17530979616573,-15.425746319517309,-9.280539759611141,29,28,30,47,18,17,19,7,4.211440695551972,4.677987671820981,5.2017424405777435,0.3642091123031534,2301,2388,Southwest Colorado,Dolores,8,33,Colorado,CO
08053,08CS023,9,9,9,2,-7,-7,-7,2,-47.50583736202681,-47.123555662024515,-46.73010164488456,-0.315982235046551,11,11,11,2,-9,-9,-9,2,-14.62604941208301,-14.491178261568226,-14.366181009565452,-0.23957406016205196,792,783,Southwest Colorado,Hinsdale,8,53,Colorado,CO
08079,08CS023,11,10,11,7,-4,-4,-3,7,-49.49970205896544,-49.09799008963225,-48.701102226939526,-2.7764154672394765,14,14,14,7,-7,-7,-7,7,-15.222455451257957,-15.098654176720936,-14.974835640141745,-1.200821926531599,857,916,Southwest Colorado,Mineral,8,79,Colorado,CO
08091,08CS023,26,25,26,24,-2,-2,-1,5,-5.910469355647149,-5.509442378051412,-5.083778844699364,-6.727207873666879,33,32,33,32,-1,-1,-0,8,-1.8755963420758208,-1.7548689659325138,-1.6307303930927604,42.25287983851195,4906,5011,Southwest Colorado,Ouray,8,91,Colorado,CO
08105,08CS023,114,113,115,142,28,27,29,6,7.290971297563888,7.697907385930193,8.065136387178484,0.2061118156155336,140,138,141,174,34,33,36,28,0.41927812541528425,0.548762974920698,0.6771466351273147,0.7932845275734172,11486,11427,Southwest Colorado,Rio Grande,8,105,Colorado,CO
08111,08CS023,7,7,7,3,-4,-4,-4,3,-41.101408137860396,-39.40820126973925,-37.7681439989185,-0.9882970984110406,9,8,9,5,-4,-4,-3,5,-12.520896377512573,-12.045967184648585,-11.547216671866796,-1.7908716142025605,714,730,Southwest Colorado,San Juan,8,111,Colorado,CO
08113,08CS023,24,23,25,24,0,-1,1,2,-1.2689157105356323,-0.8767428427492172,-0.45766303535570746,1.6267016119448388,30,29,31,31,1,-0,2,1,-0.15540398949199294,-0.023673962107482422,0.09570319952613729,0.5688135930640837,8074,8071,Southwest Colorado,San Miguel,8,113,Colorado,CO
09001,09CS001,5892,5481,6303,7546,1654,1243,2065,1629,-1.7669599273751706,0.1537597421078745,1.9656964245388011,0.9843472876912238,7307,6812,7802,7400,93,-402,588,517,-0.9350479518168879,-0.42566049364728864,0.06637150453394763,5.509734820291109,954620,959203,Fairfield,Fairfield,9,1,Connecticut,CT
09003,09CS002,6958,6573,7344,8610,1652,1266,2037,1731,-2.1534731537509715,-0.38747732636441057,1.3006549300565702,1.0474277897229831,8559,8096,9022,8822,263,-200,726,731,-1.0205572588226695,-0.5306762759672674,-7.099376885960536e-4,2.765869691322714,896860,897011,Hartford,Hartford,9,3,Connecticut,CT
09005,09CS003,1595,1516,1674,1890,295,216,374,249,-0.7044694904928901,1.0145385919350012,2.567215115614925,0.8416210557160738,1966,1871,2062,2040,74,-22,169,143,-0.9186046273883828,-0.38939912213026706,0.14439322094126725,1.9147348884429327,184234,184982,Litchfield,Litchfield,9,5,Connecticut,CT
09007,09CS004,1350,1280,1421,1526,176,105,246,214,-2.6160467047134692,-0.8196907562621146,0.7955611960697216,1.2109970336406068,1668,1583,1753,1694,26,-59,111,134,-1.1630931107128417,-0.666673746926312,-0.1317016722687739,4.940490407144721,163808,164637,Middlesex,Middlesex,9,7,Connecticut,CT
09009,09CS005,6757,6386,7128,8319,1562,1191,1933,1488,-1.3402384793576416,0.31969431487168304,2.105575634734818,0.9518526913325108,8314,7868,8760,8563,249,-197,695,717,-1.0476444400620484,-0.5339447482908323,-0.05103802825171577,2.8713489383668658,862107,863671,New Haven,New Haven,9,9,Connecticut,CT
09011,09CS006,2135,2020,2250,2348,213,98,328,274,-2.531825451721697,-0.9176605934785396,0.9755722380684996,1.2800489481081392,2634,2495,2773,2949,315,176,454,243,-0.25322737862802525,0.27229407567681957,0.7784176893402485,0.768722428122332,267947,268724,New London,New London,9,11,Connecticut,CT
09013,09CS007,925,861,990,1042,117,52,181,113,-1.6073696709243894,0.16386967242174963,1.8620485047108906,0.9614796741225365,1150,1073,1228,1276,126,48,203,87,-0.24051768242804542,0.26202309780807076,0.7574204740244983,0.6872190640047643,149894,150199,Tolland,Tolland,9,13,Connecticut,CT
09015,09CS008,927,877,977,1084,157,107,207,84,0.7430299569204846,2.5041711209381905,4.138313966802704,0.5325444950776808,1142,1082,1203,1239,97,36,157,147,-0.9524199586962189,-0.43442053622837346,0.07339975175843957,1.5074760420974078,116352,116392,Windham,Windham,9,15,Connecticut,CT
10001,10CS001,1441,1363,1520,1740,299,220,377,191,0.6056966306665288,2.344125185547091,4.104227065965134,0.6368405113391317,1785,1690,1880,2232,447,352,542,250,0.5351746784962126,1.0565841291247628,1.6000957164257252,0.5582323325710212,182342,183873,Kent,Kent,10,1,Delaware,DE
10003,10CS002,4182,3937,4427,4893,711,466,956,499,-0.2702161051728475,1.497611555305045,3.143291193913002,0.7011191558677489,5169,4874,5465,5700,531,235,826,523,-0.49442338678408243,0.005353250593943078,0.5469784335568747,0.9839904977258711,569249,571564,New Castle,New Castle,10,3,Delaware,DE
10005,10CS003,2364,2261,2467,2784,420,317,523,318,0.13971596247866871,1.6897754314159388,3.3075360891637433,0.7557299839160205,2970,2843,3097,3308,338,211,465,338,-0.485506311710491,-0.014857182735804053,0.48160814444093536,0.996324768397643,239273,246271,Sussex,Sussex,10,5,Delaware,DE
11001,11CS001,4163,3867,4459,5284,1121,825,1417,831,-0.05974158579428697,1.7067896902446944,3.3789655853693823,0.7407013176465145,5018,4671,5366,5813,795,447,1142,463,-0.02527121949290468,0.4786970154953211,1.015841930159346,0.5818537913678489,690654,672973,District of Columbia,District of Columbia,11,1,District of Columbia,DC
12001,12CS001,1746,1626,1865,1931,185,66,305,133,-0.9453660551293309,0.7799079358079914,2.3795015487047793,0.7140725428550252,2165,2021,2309,2440,275,131,419,290,-0.5961978919532194,-0.06039814007577871,0.47455775132983746,1.0517698660279124,277401,279157,Alachua,Alachua,12,1,Florida,FL
12003,12CS002,223,210,235,257,34,22,47,36,-1.7992243706819282,-0.22271346103316736,1.5011368114705868,1.016842991337317,275,261,290,368,93,78,107,80,-0.0854143626611684,0.43848154419178453,0.9316846148466985,0.8545640912649479,28494,28656,Baker+Bradford+Union,Baker,12,3,Florida,FL
12007,12CS002,281,268,293,294,13,1,26,20,-2.6231237917851513,-0.9473395725268955,0.8149821840224338,1.392622548863125,345,330,359,408,63,49,78,87,-1.3349679068934899,-0.8089784604516916,-0.3278669113107455,1.350369651906621,28380,28514,Baker+Bradford+Union,Bradford,12,7,Florida,FL
12125,12CS002,217,210,224,259,42,35,49,58,-5.561659943896346,-3.908151766696599,-2.138981761185765,1.3363374192743347,267,259,276,249,-18,-27,-10,27,-3.27694186267195,-2.7882092357224146,-2.2239251784445613,-1.5691582606359429,16015,16305,Baker+Bradford+Union,Union,12,125,Florida,FL
12005,12CS003,1584,1508,1659,1811,227,152,303,179,-0.5656012778579959,1.11780127874809,2.8647693154367,0.7836049413209272,1980,1887,2072,2546,566,474,659,420,0.30171286088951055,0.7911851548335035,1.3348255030415914,0.7402008484461736,174869,178482,Bay,Bay,12,5,Florida,FL
12009,12CS004,6515,6253,6777,7028,513,251,775,478,-1.4884474181314256,0.18962999793889312,2.0101593157468804,0.9298638083536965,8050,7732,8368,9270,1220,902,1538,1073,-0.29092867319194576,0.24549257793639323,0.7329849200094252,0.8786923006385841,607887,615371,Brevard,Brevard,12,9,Florida,FL
12011,12CS005,12919,12084,13753,15293,2374,1540,3209,1736,-0.4317284763911065,1.4007643752488,3.263093463905314,0.7308438745925308,15845,14847,16843,18739,2894,1896,3892,2673,-0.4063910517245487,0.12487714380355117,0.6325695606224478,0.9232420579881456,1942454,1932519,Broward,Broward,12,11,Florida,FL
12015,12CS006,2341,2260,2422,2695,354,273,435,245,0.5116470641772124,2.307382171113283,3.98218895045127,0.690106334264676,2923,2823,3023,3342,419,319,519,388,-0.32795943020819013,0.16550648859250072,0.6678945332133591,0.9233397141233577,188926,193839,Charlotte,Charlotte,12,15,Florida,FL
12017,12CS007,2327,2261,2394,2726,399,332,465,204,3.291536586558055,5.03446166459358,6.772113310881856,0.5102291772177548,2884,2802,2965,3561,677,596,759,478,0.756593136249191,1.2879207658474057,1.7700998673590298,0.7047602978230877,154167,157546,Citrus,Citrus,12,17,Florida,FL
12019,12CS008,1600,1506,1694,1861,261,167,355,148,0.3317387818108753,2.074652300682416,3.698614639014417,0.565141227561432,1993,1879,2108,2768,775,660,889,476,0.819822024213149,1.356639956997936,1.8690369028227491,0.613616521107881,219200,221841,Clay,Clay,12,19,Florida,FL
12021,12CS009,2963,2800,3126,3412,449,286,612,318,-0.21834562505156016,1.4147135157633468,3.125949944849696,0.7062944282141179,3700,3501,3898,4461,761,563,960,498,0.13493300312351075,0.6858222673580209,1.1973570402626585,0.6532490792696753,379295,384682,Collier,Collier,12,21,Florida,FL
12023,12CS010,688,657,718,813,125,95,156,96,-0.05173450387974332,1.6918880760755937,3.44061148965939,0.7591757555689945,845,808,881,1137,292,256,329,178,1.0987234642321773,1.6244154967195408,2.160494399363961,0.6070358993154907,70214,70313,Columbia,Columbia,12,23,Florida,FL
12027,12CS011,288,273,303,374,86,71,101,55,1.8584261244502525,3.5716310590947735,5.282898233379491,0.6340123998199876,354,336,371,469,115,98,133,78,0.5943810525165563,1.0879463450887568,1.5952156280287582,0.6703410136941158,34660,34360,DeSoto+Hardee,DeSoto,12,27,Florida,FL
12049,12CS011,182,171,193,217,35,24,46,21,0.4044842973843272,2.166332353393107,3.922589289263289,0.5885399521406626,225,212,238,352,127,114,140,74,1.5888681949470678,2.083265776434068,2.5735460444072396,0.576857921531153,25542,25409,DeSoto+Hardee,Hardee,12,49,Florida,FL
12029,12CS012,193,186,201,212,19,11,26,14,-0.6445237134665439,1.0368002981433708,2.8105980895886047,0.7152070664768622,239,230,247,313,74,66,83,50,0.942974360822314,1.45437140146327,1.9331961300736842,0.6626598898249351,16848,17059,Dixie+Gilchrist+Levy,Dixie,12,29,Florida,FL
12041,12CS012,173,166,181,191,18,10,25,13,-0.5073731398364864,0.9858955900456318,2.737745948632432,0.6959664157725757,215,205,224,301,86,77,96,42,1.9447230877037294,2.408230242472288,2.8963595216280376,0.48153964931135274,18067,18297,Dixie+Gilchrist+Levy,Gilchrist,12,41,Florida,FL
12075,12CS012,496,478,515,552,56,37,74,30,0.6913392619737576,2.391786699014174,4.046621946777845,0.5274412447256425,617,595,640,757,140,117,162,111,0.132916263155679,0.6581490347660329,1.1511432049264694,0.7889495471885793,42958,43997,Dixie+Gilchrist+Levy,Levy,12,75,Florida,FL
12031,12CS013,7557,7130,7985,8614,1057,629,1484,709,-0.1769274503962565,1.3854617272130065,3.0984573764362,0.6702833359892095,9358,8842,9874,11527,2169,1653,2685,1831,-0.17969945704287235,0.3311689206207683,0.8524166895188167,0.8439012586008827,991418,999416,Duval,Duval,12,31,Florida,FL
12033,12CS014,3012,2874,3151,3586,574,435,712,327,1.4388438630249227,3.023283898659043,4.742846440551216,0.5691449956724821,3700,3533,3866,4581,881,715,1048,557,0.4859110714783609,1.0072172333346,1.5258249579156933,0.6314224446675084,321976,322395,Escambia,Escambia,12,33,Florida,FL
12035,12CS015,1225,1174,1275,1360,135,85,186,53,0.9877125465580917,2.8599113836507932,4.563352850453455,0.3884565342048794,1548,1486,1610,1844,296,234,358,221,0.11468502228309845,0.6279723256593264,1.1407723788128263,0.7444269119166996,116414,120208,Flagler,Flagler,12,35,Florida,FL
12039,12CS016,386,367,405,481,95,76,114,54,2.0847579491667934,3.7369029137058343,5.489365016318872,0.5634192899907191,473,450,495,663,190,168,213,96,1.6377740562598466,2.173233653104025,2.6885264755623735,0.5018810520604354,43990,43712,Gadsden+Leon,Gadsden,12,39,Florida,FL
12073,12CS016,1665,1539,1791,2057,392,266,518,158,1.4811211385551348,3.2213260258803555,4.889630639784537,0.4022491736410517,2073,1922,2224,2572,499,348,650,309,0.08784396787035396,0.6459184339833552,1.1876205794478516,0.6183209272396959,292641,292753,Gadsden+Leon,Leon,12,73,Florida,FL
12043,12CS017,100,99,101,129,29,28,30,16,3.8506978056062278,4.240314473893841,4.618842429025246,0.5304991503677114,121,119,122,167,46,45,48,16,2.356274471151388,2.486566243581807,2.6083069318271734,0.3378401235919453,12438,12226,Glades+Hendry+Okeechobee,Glades,12,43,Florida,FL
12051,12CS017,261,244,279,315,54,36,71,51,-1.4739271677860348,0.2644316912698482,1.8464634263503017,0.9346407871356017,325,304,346,479,154,133,175,79,1.3463747132257202,1.8569026237098751,2.3661470386100145,0.5089540196141421,40115,40225,Glades+Hendry+Okeechobee,Hendry,12,51,Florida,FL
12093,12CS017,384,367,401,467,83,66,100,55,0.9896587564808346,2.8126553881638046,4.478717556954267,0.6560069694286788,473,452,494,657,184,163,205,103,1.5404890651490435,2.0160747652399524,2.5137379471849557,0.556659960659301,40071,40175,Glades+Hendry+Okeechobee,Okeechobee,12,93,Florida,FL
12047,12CS018,138,132,144,176,38,32,44,19,3.714131448144772,5.29901292409617,6.9136873320101575,0.4921221456063207,169,162,177,226,57,49,64,33,1.1879984264489802,1.6950646683180028,2.22307893412139,0.5720914219934171,14059,13992,Hamilton+Lafayette+Suwannee,Hamilton,12,47,Florida,FL
12067,12CS018,67,66,68,97,30,29,31,16,6.225822915863137,6.636199990630456,7.035535935502564,0.520425089462365,84,83,85,118,34,33,35,22,1.3514402191941117,1.4794204556046069,1.6008587641029217,0.6222246570212698,8285,8363,Hamilton+Lafayette+Suwannee,Lafayette,12,67,Florida,FL
12121,12CS018,486,467,505,587,101,82,120,71,0.9997327314530879,2.7448408386139405,4.479635793055711,0.6966524272718371,603,580,626,783,180,157,203,161,-0.09580248266117328,0.41750249656456373,0.959184244760096,0.8912811410352676,43744,44343,Hamilton+Lafayette+Suwannee,Suwannee,12,121,Florida,FL
12053,12CS019,2450,2365,2534,2676,226,142,311,203,-1.3925375506023479,0.5037393075278473,2.0553292399659147,0.893383342266388,3043,2940,3146,3685,642,539,745,557,-0.11068758985453406,0.42856661552382475,0.8983028233399003,0.8659967124916839,195865,199890,Hernando,Hernando,12,53,Florida,FL
12055,12CS020,1332,1289,1376,1582,250,206,293,185,0.8584036835715559,2.4643170871837876,4.220041900338387,0.7383924207480327,1644,1591,1697,2129,485,432,538,284,1.4287109755564076,1.942314893353865,2.475418467709915,0.5845182229123251,102119,102994,Highlands,Highlands,12,55,Florida,FL
12057,12CS021,9337,8707,9968,10901,1564,933,2194,945,-0.05393992562345288,1.6674141554360962,3.3753216521927816,0.6040018793192099,11589,10827,12351,14306,2717,1955,3479,1769,0.13100457406252386,0.640127729701997,1.1636276507036285,0.6507801388866316,1466826,1476034,Hillsborough,Hillsborough,12,57,Florida,FL
12059,12CS022,239,230,247,286,47,39,56,28,2.2139453380295397,3.9149047839268976,5.615869829133764,0.579445594069406,294,284,304,362,68,58,78,47,0.5782073425479713,1.054511416219584,1.5750366992357705,0.6806878994218118,19645,19760,Holmes+Walton,Holmes,12,59,Florida,FL
12131,12CS022,637,604,670,665,28,-5,61,49,-2.711548015356513,-1.149006134457703,0.6119299319484033,1.6845650678418145,820,779,861,891,71,30,112,127,-1.2103602759000989,-0.6885511228538245,-0.17790613722538584,1.7597865652729205,76042,79454,Holmes+Walton,Walton,12,131,Florida,FL
12061,12CS023,1823,1754,1892,2023,200,131,269,141,-0.18959727989750913,1.4007877592314335,3.1666078170267977,0.7027642818625894,2259,2175,2344,2717,458,373,542,358,0.09945148611921338,0.6073970272108847,1.1132076383705536,0.7803985648114037,160602,163178,Indian River,Indian River,12,61,Florida,FL
12063,12CS024,539,519,559,666,127,107,147,102,0.5288986194134496,2.1582953202014328,3.929668136946114,0.7958438263593118,668,643,692,761,93,69,118,99,-0.5998575164036144,-0.10426675431465451,0.3915395892034434,1.0501206804816416,47124,47624,Jackson+Washington,Jackson,12,63,Florida,FL
12133,12CS024,294,283,305,299,5,-6,16,22,-4.450854572407591,-2.754120083566448,-0.9603105194301441,3.5824841764471476,361,348,374,417,56,43,69,62,-0.7777129381027736,-0.24451946055056936,0.27590636432964655,1.0920702777125384,25408,25424,Jackson+Washington,Washington,12,133,Florida,FL
12065,12CS025,154,148,160,184,30,24,36,13,3.007754921534406,4.687242160127084,6.337910004282461,0.42184388724876365,188,181,196,225,37,29,44,32,-0.17363274669542103,0.32130936295110885,0.8237619744480577,0.8452073794075561,14519,14556,Jefferson+Madison+Taylor,Jefferson,12,65,Florida,FL
12079,12CS025,193,185,201,273,80,72,88,38,7.447526024106426,9.277930626861737,10.987208710495562,0.47051395158050996,238,228,247,303,65,56,75,51,0.23544963320963172,0.7885084533787372,1.285547651122743,0.7690270660675183,18099,18242,Jefferson+Madison+Taylor,Madison,12,79,Florida,FL
12123,12CS025,221,211,230,284,63,54,73,31,4.2095920217168485,5.977248229441038,7.765434380981786,0.480851074824753,270,258,281,330,60,49,72,49,0.02386085576673635,0.5425755948530104,1.024251182756966,0.7985636689058854,21733,21807,Jefferson+Madison+Taylor,Taylor,12,123,Florida,FL
12069,12CS026,4023,3857,4189,4366,343,177,509,292,-1.2080780370185065,0.49523333812984344,2.3397863734141255,0.8481592561101182,5027,4823,5230,5749,722,519,926,778,-0.66212249427296,-0.16481199830120408,0.3767243003903256,1.075558225802758,384148,394356,Lake,Lake,12,69,Florida,FL
12071,12CS027,6371,6041,6702,7250,879,548,1209,599,-0.19149321159943902,1.4513859175829176,3.238394064759911,0.6810236887843554,7978,7573,8383,9402,1424,1019,1829,1019,-0.0027272054784828487,0.5166665409853546,1.0348982664509683,0.7152880896294154,768212,784579,Lee,Lee,12,71,Florida,FL
12013,12CS028,149,143,155,180,31,25,37,20,1.7171439357181777,3.328019733550466,5.056977342469151,0.618762535050674,182,175,189,239,57,50,64,42,0.5730625644542733,1.0774317795489425,1.587652554924924,0.7296722509363258,13694,13637,Liberty and Nearby Counties,Calhoun,12,13,Florida,FL
12037,12CS028,138,133,143,143,5,-0,10,5,-1.7981669520679484,8.569835606641353e-4,1.6573353864401648,0.8537575592044959,171,165,178,205,34,27,40,38,-0.8408702231044708,-0.3351827322151312,0.14740508558780568,1.0949764250071614,12418,12555,Liberty and Nearby Counties,Franklin,12,37,Florida,FL
12045,12CS028,154,148,160,197,43,37,49,22,4.124437843456704,5.813944073835626,7.6777026455556125,0.5044773047490241,192,185,200,242,50,42,57,32,0.7240127768628333,1.2415776915042605,1.7256913943992114,0.6316619824600169,14100,14336,Liberty and Nearby Counties,Gulf,12,45,Florida,FL
12077,12CS028,60,59,61,78,18,17,19,15,1.2719214323161014,1.6401439343744122,2.0652309786865266,0.7772259184881986,73,72,74,117,44,43,45,17,3.322167999186148,3.433502384144671,3.552995295774214,0.37640662982624423,8020,7911,Liberty and Nearby Counties,Liberty,12,77,Florida,FL
12129,12CS028,263,248,277,321,58,44,73,30,1.613265339387241,3.3408232034390024,5.037560154399233,0.5046995197952947,332,314,349,414,82,65,100,60,0.1666282724096727,0.6703673280426554,1.1663589250062605,0.7192043539219075,33949,34576,Liberty and Nearby Counties,Wakulla,12,129,Florida,FL
12081,12CS029,3636,3462,3809,4106,470,297,644,379,-0.8346588443275385,0.9057859758928833,2.50798743630576,0.8038875549608866,4541,4329,4753,5298,757,545,969,694,-0.29625448407784877,0.1605414439463075,0.6699947632118148,0.9156046742070764,402840,411061,Manatee,Manatee,12,81,Florida,FL
12083,12CS030,4620,4458,4782,5251,631,469,793,441,0.3372492949315658,2.0225146728389776,3.7243182305924933,0.6977126825619303,5742,5544,5941,7065,1323,1124,1521,1110,0.05151120786362433,0.5701042034668095,1.0673709840441998,0.8386769664241874,376602,384669,Marion,Marion,12,83,Florida,FL
12085,12CS031,1646,1578,1715,1995,349,280,417,167,2.787380211390774,4.535077801734668,6.371756357834221,0.477713227435164,2020,1938,2103,2464,444,361,526,225,0.8733368670080571,1.3722282116236544,1.889825848581706,0.5060423004745345,159067,159736,Martin,Martin,12,85,Florida,FL
12086,12CS032,17029,15872,18186,22009,4980,3823,6137,3655,0.3168489313783005,2.017803382871365,3.558150071698898,0.7338411102517697,20833,19456,22210,26064,5231,3854,6608,4101,-0.11470192567497382,0.4432137540334409,0.9398669328185665,0.7838160503122228,2692160,2667106,Miami-Dade,Miami-Dade,12,86,Florida,FL
12087,12CS033,657,622,693,662,5,-31,40,40,-3.4263928998829636,-1.6701210752430133,0.02181926621833266,7.004837034727021,806,764,849,853,47,4,89,56,-0.6436800991747764,-0.10085927407667963,0.37232008738153655,1.1702972266166924,81443,82263,Monroe,Monroe,12,87,Florida,FL
12089,12CS034,832,793,871,901,69,30,108,67,-1.7479741668781195,0.046348452681056314,1.7422567562253766,0.958507429131022,1047,999,1095,1208,161,113,209,169,-0.6032791076128682,-0.08250299578918971,0.42757320634695456,1.0439230595014712,90974,93723,Nassau,Nassau,12,89,Florida,FL
12091,12CS035,1619,1528,1710,1896,277,186,368,200,-0.2596309725297305,1.5359250607511992,3.155261487646257,0.7192401743596559,1998,1888,2108,2359,361,251,471,305,-0.2231355307133297,0.23911797683579022,0.8174611811657965,0.8432061661974167,211902,213044,Okaloosa,Okaloosa,12,91,Florida,FL
12095,12CS036,7361,6748,7974,8379,1018,405,1631,745,-1.0340953217388542,0.7455554903434021,2.5252111276930407,0.7310631291132728,9130,8395,9865,10765,1635,900,2370,1451,-0.41162827134244373,0.11625513793043968,0.6578037742697241,0.8869238250061976,1424119,1423789,Orange,Orange,12,95,Florida,FL
12097,12CS037,2216,2048,2384,2531,315,147,483,276,-1.3906024647331918,0.35929579492937724,2.173515737395042,0.8728638705349232,2820,2613,3028,3532,712,504,919,605,-0.3116617793734848,0.2595605593904127,0.7641833023937804,0.8490455966841824,389716,401470,Osceola,Osceola,12,97,Florida,FL
12099,12CS038,12653,12011,13296,14606,1953,1310,2595,1572,-0.6602616222601703,1.0049985413407985,2.716931319311818,0.8046224582398646,15533,14760,16306,17795,2262,1489,3035,1994,-0.3315847331464355,0.17862297878771444,0.6558851795361227,0.8812534675605427,1493819,1497182,Palm Beach,Palm Beach,12,99,Florida,FL
12101,12CS039,5677,5433,5921,6147,470,226,714,352,-0.8801403498981789,0.8131175643129166,2.5013883984646945,0.7473572663114414,7113,6812,7413,8129,1016,716,1317,1049,-0.5803075148559773,-0.048496886911149895,0.4360953513533425,1.031006518765337,565945,581395,Pasco,Pasco,12,101,Florida,FL
12103,12CS040,10071,9658,10484,11173,1102,689,1515,747,-0.2781804453107307,1.513293368593674,3.293397381336236,0.6773398896906239,12269,11775,12763,13920,1651,1157,2145,1235,-0.06543222780976712,0.4212430605857045,0.9303130763731042,0.7474628262775241,960952,956927,Pinellas,Pinellas,12,103,Florida,FL
12105,12CS041,6284,5969,6599,7210,926,611,1241,718,-0.5039629833376676,1.1650297428122962,3.0177509632027073,0.7745460488199034,7888,7501,8276,9799,1911,1523,2298,1555,-8.061063192100827e-4,0.4544976221381631,0.96052437153774,0.8134797370691769,731141,749978,Polk,Polk,12,105,Florida,FL
12107,12CS042,854,823,886,994,140,108,171,71,1.8622824810341632,3.723592022386795,5.417505067566753,0.5044810518608037,1050,1012,1089,1488,438,399,476,265,1.8018215833168176,2.3334149016055834,2.831066119122804,0.6040662163433159,73573,74047,Putnam,Putnam,12,107,Florida,FL
12109,12CS043,1920,1801,2040,1984,64,-56,183,101,-2.2160259144090335,-0.5824985855690948,1.2095736741397354,1.560104553563597,2465,2315,2615,2676,211,61,361,300,-0.8060279488186644,-0.30735937753911474,0.22084998536902928,1.4170850519805016,276808,290198,St. Johns,St. Johns,12,109,Florida,FL
12111,12CS044,2952,2809,3095,3405,453,310,596,362,-0.6220577807879505,1.0541058341407752,2.7894822696184187,0.798163169066189,3718,3541,3894,4438,720,544,897,522,0.0669584615527557,0.5580539078003661,1.0841748665198665,0.7235114183466834,332088,341785,St. Lucie,St. Lucie,12,111,Florida,FL
12113,12CS045,1426,1344,1507,1572,146,65,228,130,-1.3252083524644391,0.32497686415676336,2.08119519290693,0.8827982460204716,1796,1696,1896,2093,297,197,397,332,-0.7173235477222487,-0.18789628376735945,0.2881339499717263,1.1141082007843992,188977,193289,Santa Rosa,Santa Rosa,12,113,Florida,FL
12115,12CS046,5035,4847,5223,5783,748,560,936,387,1.5977355013877952,3.294440146413745,5.065398264477803,0.5166998680445322,6258,6028,6488,7117,859,629,1089,682,-0.12636252911475923,0.3935031193282216,0.8754777336255792,0.7934291857926667,436755,445396,Sarasota,Sarasota,12,115,Florida,FL
12117,12CS047,3033,2830,3235,3358,325,123,528,248,-1.0303946532203228,0.6559691576723985,2.2787184318943767,0.7600110180726649,3736,3493,3978,4398,662,420,905,530,-0.24751935646576362,0.29955747950579353,0.7847862625143629,0.7988717466563122,471064,470234,Seminole,Seminole,12,117,Florida,FL
12119,12CS048,1704,1647,1760,2017,313,257,370,117,4.248285286384971,5.903322100297181,7.5932938767569995,0.37241899424230596,2130,2060,2199,2742,612,543,682,320,1.6572779633673937,2.1776890403478193,2.652023460431406,0.5217804136603547,131810,134947,Sumter,Sumter,12,119,Florida,FL
12127,12CS049,6297,6058,6536,6918,621,382,860,402,-0.13863526395424378,1.5947714501334653,3.308999713117427,0.6462009704239194,7779,7488,8069,9311,1532,1242,1823,1137,0.1988347096219588,0.7074579501011286,1.2563904834376276,0.7415614912044642,555770,563025,Volusia,Volusia,12,127,Florida,FL
13001,13CS001,177,169,185,232,55,47,63,48,-0.04795486748532909,1.5311024039874872,3.467607100662045,0.8525217389816452,216,207,226,269,53,43,62,58,-0.7736963464899785,-0.29290431284097135,0.2509811398666803,1.0758289325975976,18429,18479,Appling+Jeff Davis+Long+Wayne,Appling,13,1,Georgia,GA
13161,13CS001,146,140,152,186,40,34,46,26,2.0935658092530707,3.8076292815595405,5.466564584895484,0.6325994635349422,178,171,186,214,36,28,43,35,-0.45342398291229025,0.03862861816753025,0.5764822497565478,0.9560294176771479,14834,14858,Appling+Jeff Davis+Long+Wayne,Jeff Davis,13,161,Georgia,GA
13183,13CS001,80,78,82,105,25,23,27,4,4.589999871905476,4.985098333975908,5.353097475887928,0.15394263745453482,99,97,102,149,50,47,52,29,1.0851475865648261,1.2049158828388908,1.3293744406921126,0.5733095023976843,16867,17026,Appling+Jeff Davis+Long+Wayne,Long,13,183,Georgia,GA
13305,13CS001,299,286,312,336,37,24,50,40,-2.2181788240841165,-0.43504291396736344,1.2745516995254689,1.0592760915779387,367,351,383,511,144,128,160,103,0.8135455317806567,1.352913712881747,1.8952591581128926,0.71001414480913,30158,30347,Appling+Jeff Davis+Long+Wayne,Wayne,13,305,Georgia,GA
13005,13CS002,127,122,132,146,19,14,24,25,-3.9340480534052817,-2.2206070339441473,-0.46877021927009543,1.2463491120833008,155,149,160,185,30,25,36,40,-1.3525415909888507,-0.861323965244037,-0.3395976690624777,1.2722583389305637,11115,11085,Bacon+Ben Hill+Coffee+Irwin,Bacon,13,5,Georgia,GA
13017,13CS002,195,188,202,267,72,65,79,50,3.36973905401138,5.152693886962717,6.778370276609403,0.6857438934725993,239,230,248,286,47,38,56,39,-0.017702903513040564,0.4833969644617427,0.9858190604480703,0.8082556199487312,17089,17157,Bacon+Ben Hill+Coffee+Irwin,Ben Hill,13,17,Georgia,GA
13069,13CS002,362,343,380,479,117,99,136,94,0.5244602893359638,2.15132951150253,3.825744558885025,0.7937879907934687,446,424,469,549,103,80,125,113,-0.7826622457647964,-0.23330378605958058,0.27583621582764145,1.0913826727665636,43116,43337,Bacon+Ben Hill+Coffee+Irwin,Coffee,13,69,Georgia,GA
13155,13CS002,99,99,100,121,22,21,22,18,1.0706935613171884,1.4758746198698043,1.8873321726464858,0.7995061993083525,122,121,123,154,32,31,33,27,0.37350083696370634,0.5026053402460708,0.6267443352636769,0.8222856328812512,9611,9622,Bacon+Ben Hill+Coffee+Irwin,Irwin,13,155,Georgia,GA
13011,13CS003,153,145,161,168,15,7,23,18,-2.347888887064006,-0.6466834000889814,1.1590333696034172,1.1065400105327767,190,180,199,268,78,69,88,41,1.5312995957570035,2.0230148422900904,2.5286236851072132,0.5180049316150429,18282,18490,Banks+Habersham,Banks,13,11,Georgia,GA
13137,13CS003,409,389,429,508,99,79,119,74,0.3975670614975571,2.1312344963569188,3.6957380604325696,0.7425310593054503,507,483,531,603,96,72,120,94,-0.4900451836015058,0.03731746758984184,0.5601952225922148,0.9674037299142251,46093,46676,Banks+Habersham,Habersham,13,137,Georgia,GA
13013,13CS004,567,530,603,619,52,16,89,55,-1.839429647157889,-0.10947228000894849,1.6461369158969867,1.0322992646453586,716,672,761,887,171,126,215,114,0.1416138206998344,0.6480465362176036,1.1622530641866906,0.6631359902189653,84188,86265,Barrow,Barrow,13,13,Georgia,GA
13015,13CS005,816,769,863,1038,222,175,269,119,2.096114457942098,3.767232118825699,5.553004988346103,0.5340154012160924,1018,961,1075,1334,316,259,373,182,0.6976301418409081,1.2341125302664593,1.7202867615199633,0.5747174274129788,109244,110620,Bartow,Bartow,13,15,Georgia,GA
13021,13CS006,1498,1430,1565,1827,329,262,397,199,1.6356859599628597,3.313402309343248,5.1610181432800175,0.6024654361669743,1835,1754,1916,2309,474,393,555,332,0.4148312316096123,0.9191492950100822,1.4195360754407782,0.6996117291798263,156498,156812,Bibb,Bibb,13,21,Georgia,GA
13023,13CS007,134,129,139,175,41,36,46,30,1.816026166627621,3.517746070744871,5.22231308655621,0.7132213667177376,163,157,170,197,34,27,40,43,-1.2471711907907301,-0.7503152988820193,-0.23076993633071152,1.2454777194414666,12631,12603,Bleckley+Dodge+Pulaski+Twiggs,Bleckley,13,23,Georgia,GA
13091,13CS007,187,178,196,289,102,93,111,67,5.310027758956822,7.043065352034592,8.68203543356474,0.650293626676415,227,217,238,319,92,81,102,64,0.8835876308734399,1.3996137769511878,1.9085795972256199,0.690483274072315,19960,19772,Bleckley+Dodge+Pulaski+Twiggs,Dodge,13,91,Georgia,GA
13235,13CS007,90,89,91,111,21,20,22,22,-0.8071745292369886,-0.37879123036096896,-0.023909255533295804,0.9996645410723713,108,107,110,172,64,62,65,34,2.8710421491221023,2.9805690668530427,3.1071933289564906,0.5265362067628704,10058,9909,Bleckley+Dodge+Pulaski+Twiggs,Pulaski,13,235,Georgia,GA
13289,13CS007,93,92,94,131,38,37,39,19,9.223649827268002,9.65761848122119,10.066116216221431,0.48348295677345826,111,110,112,161,50,49,51,26,2.8617231832686074,2.9843820673727524,3.1088971887218526,0.5146560992241906,7998,7875,Bleckley+Dodge+Pulaski+Twiggs,Twiggs,13,289,Georgia,GA
13025,13CS008,170,162,178,207,37,29,45,29,0.03935656729506558,1.6964330621185593,3.463166287119524,0.7676714207431367,209,200,219,294,85,75,94,67,0.46901096333519077,0.9654537381073621,1.4914192572002951,0.7828220531293593,18204,18092,Brantley+Pierce+Ware,Brantley,13,25,Georgia,GA
13229,13CS008,192,184,201,252,60,51,68,37,2.8770174136743902,4.6346968073538894,6.279242994729756,0.6111462527188882,240,229,250,346,106,96,117,78,0.8905673112418142,1.433404226511122,1.9612123795318768,0.7265582959502549,19708,19939,Brantley+Pierce+Ware,Pierce,13,229,Georgia,GA
13299,13CS008,411,395,426,505,94,79,110,72,0.7993534240713918,2.470017143629775,4.284817709642964,0.7541430786199711,503,484,521,650,147,129,166,144,-0.41783790823792516,0.08713374543110046,0.6368243218819709,0.970485886379622,36140,36060,Brantley+Pierce+Ware,Ware,13,299,Georgia,GA
13027,13CS009,183,176,190,200,17,10,24,28,-4.665740666377631,-2.8574502403954423,-1.2690354613693848,1.5900400662298595,226,218,235,230,4,-5,12,35,-2.498723775183396,-1.9173681153688538,-1.3574187672954063,7.5074746705556015,16132,16264,Brooks+Thomas,Brooks,13,27,Georgia,GA
13275,13CS009,473,453,492,539,66,47,86,76,-2.691640750271471,-0.8665824966279747,0.793875056653424,1.1309129454566966,584,560,607,691,107,84,131,85,-0.003427477496017349,0.4888215919643129,0.9869556140849193,0.7851690411466762,45579,45831,Brooks+Thomas,Thomas,13,275,Georgia,GA
13029,13CS010,283,264,302,295,12,-7,31,19,-2.4141046051822954,-0.6610292589419652,1.0440583118097573,1.4820060227065937,363,339,387,368,5,-19,29,54,-1.5474005922933105,-1.0655712940690774,-0.5431996585715464,8.768345576325355,44427,46655,Bryan+Liberty,Bryan,13,29,Georgia,GA
13179,13CS010,333,305,361,384,51,23,79,35,-0.7749521032110653,0.9977620697525812,2.5819203569098566,0.6768472006945286,416,382,450,599,183,149,217,102,0.7279528818966873,1.2410349476616744,1.7424126868244119,0.5545124168112655,64920,65639,Bryan+Liberty,Liberty,13,179,Georgia,GA
13031,13CS011,486,451,521,559,73,38,108,53,-0.6673815669418205,0.9317352255213162,2.7275624846765902,0.7182580947493763,606,564,649,748,142,99,184,146,-0.592123535251398,-0.05055102525519847,0.4730565372001086,1.0239198555869131,81247,82287,Bulloch,Bulloch,13,31,Georgia,GA
13033,13CS012,224,213,234,248,24,14,35,25,-1.9464610209871316,-0.03626283650677056,1.6545548627715465,0.9818885672995095,275,262,287,286,11,-1,24,52,-2.1655621689989117,-1.6792812182775414,-1.1330961639492354,4.206616998765809,24279,24355,Burke+Emanuel+Jenkins+Screven,Burke,13,33,Georgia,GA
13107,13CS012,255,245,265,304,49,39,59,47,-1.3427427088908057,0.3800788256975064,2.047301411555391,0.9429704834195726,313,301,324,407,94,83,106,82,0.018993910800329066,0.5467084635679068,1.103748375129954,0.859556695596132,22710,22718,Burke+Emanuel+Jenkins+Screven,Emanuel,13,107,Georgia,GA
13165,13CS012,86,85,87,110,24,23,25,26,-1.3265113930447832,-0.9207044323509734,-0.5342397410632508,1.0401501586010098,105,104,106,133,28,27,29,20,0.764789784196795,0.9034752255688405,1.0226604807337538,0.6951198786847054,8670,8642,Burke+Emanuel+Jenkins+Screven,Jenkins,13,165,Georgia,GA
13251,13CS012,154,148,160,181,27,21,33,17,1.279738494487316,2.8970081966677643,4.524261787286368,0.5993043317982714,189,182,196,251,62,55,69,43,0.820247514838263,1.3521818432379782,1.8768918775237653,0.6813175775968153,14048,14098,Burke+Emanuel+Jenkins+Screven,Screven,13,251,Georgia,GA
13035,13CS013,242,231,253,290,48,37,59,41,-0.5623702348205719,1.0775966380660276,2.8476529292113195,0.8354549490216885,298,285,311,360,62,49,75,55,-0.2940692836293593,0.25378329247146375,0.8187843943833646,0.8742098348530198,25476,25746,Butts+Lamar+Monroe,Butts,13,35,Georgia,GA
13171,13CS013,180,172,188,236,56,48,64,28,4.220335326893171,5.880942010781769,7.635478635632353,0.4952547028069969,224,215,234,306,82,72,91,55,0.9023869961383453,1.3956812203761189,1.9470472766366305,0.6657870954036448,18671,19003,Butts+Lamar+Monroe,Lamar,13,171,Georgia,GA
13207,13CS013,247,235,259,303,56,44,68,43,0.25571063596049415,1.8813221005727778,3.4652190974777985,0.7514925276621861,307,293,322,372,65,50,79,65,-0.530824057568617,-0.009600534923987524,0.4993190144431201,0.9895682860814006,28062,28615,Butts+Lamar+Monroe,Monroe,13,207,Georgia,GA
13007,13CS014,28,28,28,38,10,10,10,5,6.813607496851487,7.240871748070624,7.6201822909033226,0.44678373279072386,34,34,34,45,11,11,11,3,2.6794421298835025,2.804902056405185,2.925008507129176,0.2515979302263637,2871,2823,Calhoun and Nearby Counties,Baker,13,7,Georgia,GA
13037,13CS014,52,51,52,70,18,18,19,2,11.1311435919903,11.51007826862278,11.935441063093009,0.10384079073668549,63,62,64,67,4,3,5,2,0.21739736475447777,0.34597652843116644,0.4816514959658721,0.4078790083391735,5646,5516,Calhoun and Nearby Counties,Calhoun,13,37,Georgia,GA
13061,13CS014,36,35,37,37,1,-0,2,5,-7.393402814659384,-5.687999587964917,-3.9184619578114375,2.5710759849885996,45,43,46,57,12,11,14,2,3.0963866585205566,3.6299748207420057,4.133062075631214,0.14927661547029605,2850,2875,Calhoun and Nearby Counties,Clay,13,61,Georgia,GA
13099,13CS014,141,137,146,172,31,26,35,35,-3.3262593387313157,-1.7090437026379428,0.15253922024601038,1.1070298698031429,172,166,177,194,22,17,28,23,-0.5975115055449072,-0.06939920812537913,0.46908930438767044,0.9848031414953976,10700,10647,Calhoun and Nearby Counties,Early,13,99,Georgia,GA
13177,13CS014,224,210,238,267,43,29,57,32,-0.29580972811778417,1.3151100573812047,3.0881665681771766,0.7286283481743552,283,266,300,310,27,10,44,43,-0.9812322697026342,-0.4716525696033384,0.028028255307944682,1.533483914527941,32746,33377,Calhoun and Nearby Counties,Lee,13,177,Georgia,GA
13201,13CS014,81,81,82,95,14,13,14,3,6.835483691665566,7.239658071135146,7.6205213860799255,0.20365213263182677,101,100,101,128,27,27,28,20,1.142840465510701,1.2653052795172943,1.3941854483944243,0.7018096297891435,5933,5929,Calhoun and Nearby Counties,Miller,13,201,Georgia,GA
13239,13CS014,28,27,29,33,5,4,6,5,-2.33848230039417,-0.5382464822324643,1.201025815346948,0.8744292449897201,35,34,36,51,16,15,17,5,4.522567807721621,5.008675035360887,5.5077428069749175,0.28991840559677157,2237,2240,Calhoun and Nearby Counties,Quitman,13,239,Georgia,GA
13243,13CS014,74,74,75,104,30,29,30,25,2.6227680447650563,3.023702104725919,3.4220013442512585,0.8109791079577415,90,89,91,115,25,24,26,6,2.8489401115401076,2.978731927430335,3.1024187624989605,0.23279881112309306,6430,6300,Calhoun and Nearby Counties,Randolph,13,243,Georgia,GA
13273,13CS014,104,103,105,136,32,31,33,31,0.19914502451193378,0.6102843013305442,0.9929992107156431,0.9287081383541148,128,127,129,135,7,6,8,15,-0.992942825714014,-0.8749142971925916,-0.7464864259560827,1.8417822157225916,9049,8992,Calhoun and Nearby Counties,Terrell,13,273,Georgia,GA
13039,13CS015,331,307,354,357,26,3,50,22,-1.4814145448756508,0.2945548039163305,2.099140444141211,0.8103511368762619,416,387,445,529,113,84,142,82,0.07110370598733341,0.5573328420394726,1.0680322734127088,0.7196726550645268,54971,55554,Camden+Charlton,Camden,13,39,Georgia,GA
13049,13CS015,96,94,97,141,45,44,47,17,8.478196541292208,8.931626361782765,9.300001819128182,0.3676313273317827,119,117,120,178,59,58,61,45,0.9987969799894073,1.121269332042152,1.2432730428460939,0.7465001560076282,12664,12732,Camden+Charlton,Charlton,13,49,Georgia,GA
13043,13CS016,133,129,138,174,41,36,45,35,0.40699095131215196,2.0350062095066423,3.7292954241847336,0.8392820646334622,162,156,168,232,70,64,76,42,2.028884263277462,2.53980492206173,3.0288166484159857,0.5899738342294351,10981,11032,Candler+Evans+Tattnall+Toombs,Candler,13,43,Georgia,GA
13109,13CS016,98,97,99,126,28,27,29,11,5.79099084138861,6.206550250147643,6.6120431574489595,0.38398422309692654,119,118,121,179,60,58,61,33,2.365516494091948,2.4948032963758053,2.617542747367644,0.5441603791789792,10734,10684,Candler+Evans+Tattnall+Toombs,Evans,13,109,Georgia,GA
13267,13CS016,189,179,199,242,53,43,63,34,1.6047382516813034,3.3360779120647854,4.98983444149278,0.6248153059999159,228,216,240,346,118,106,130,74,1.3817520324015828,1.8940295735148729,2.4078916031064725,0.6233717148354171,23232,23023,Candler+Evans+Tattnall+Toombs,Tattnall,13,267,Georgia,GA
13279,13CS016,262,250,274,364,102,90,114,47,6.524691709311178,8.183530960523074,9.795158698147032,0.4562123870467912,316,303,330,455,139,125,152,96,1.0612754036212193,1.5919047044609023,2.087708661091236,0.68814915415033,27007,26932,Candler+Evans+Tattnall+Toombs,Toombs,13,279,Georgia,GA
13045,13CS017,957,905,1008,1159,202,151,254,126,0.9076100608792222,2.534276236219426,4.232668220091981,0.6201261262395311,1192,1129,1255,1487,295,232,358,207,0.24066290774490504,0.7360830863436983,1.2388136268941683,0.6992562043406719,119819,121603,Carroll+Heard,Carroll,13,45,Georgia,GA
13149,13CS017,111,110,112,135,24,23,25,4,6.515912789761338,6.926156568148299,7.318096672971513,0.16034400523734424,136,135,138,178,42,40,43,28,1.0610779495916005,1.1857598877987914,1.316332309753858,0.6558394432893292,11528,11550,Carroll+Heard,Heard,13,149,Georgia,GA
13047,13CS018,569,540,598,645,76,47,105,60,-0.8564970391501944,0.927160080499675,2.6477216513707114,0.7785140268536039,700,664,735,898,198,163,234,151,0.1755664940096067,0.6904200899166756,1.1968247390170905,0.757065526765501,67963,68336,Catoosa,Catoosa,13,47,Georgia,GA
13051,13CS019,2133,2006,2260,2425,292,165,419,193,-0.40088574917039055,1.3476264595946026,3.0490952256154285,0.6586987027106557,2639,2486,2792,3192,553,400,706,396,0.01602485129660291,0.5372480419716988,1.0318280208885664,0.7149676013368675,294364,296121,Chatham,Chatham,13,51,Georgia,GA
13055,13CS020,276,266,287,336,60,49,70,36,2.0156483223563706,3.740059142746944,5.599619989816368,0.5938179228264128,337,324,350,380,43,30,56,48,-0.7288666899329697,-0.19623615047891077,0.33452582231304245,1.0846815959328115,24911,24930,Chattooga+Dade+Walker,Chattooga,13,55,Georgia,GA
13083,13CS020,163,156,170,207,44,37,51,2,8.794124842778704,10.37723270714801,12.185142079812584,0.04425403527312229,200,191,208,245,45,37,54,31,0.3830912937116088,0.8934951990044234,1.4059090579922575,0.6679293863067314,16217,16311,Chattooga+Dade+Walker,Dade,13,83,Georgia,GA
13295,13CS020,705,675,734,830,125,96,155,63,2.023890811098719,3.6206958332731993,5.292613881797167,0.4981571201371373,864,829,899,996,132,97,167,156,-0.8326392289688256,-0.34937376489615635,0.14969323320932937,1.1719766214315217,68094,68393,Chattooga+Dade+Walker,Walker,13,295,Georgia,GA
13057,13CS021,1449,1333,1564,1630,181,66,297,116,-0.6470995098099539,0.9998603187003402,2.7065634851449287,0.6366347430440918,1832,1691,1974,2235,403,261,544,260,-5.086976972656286e-4,0.5070664167679787,1.0764285214947076,0.6443340449126767,267478,273657,Cherokee+Pickens,Cherokee,13,57,Georgia,GA
13227,13CS021,303,289,317,334,31,17,45,23,-0.6587571515651487,0.9782176035742509,2.524034065238444,0.7170656142017783,377,359,394,468,91,74,109,86,-0.36986558284015836,0.14334928295748214,0.6708394434096303,0.9331916456395516,33305,33923,Cherokee+Pickens,Pickens,13,227,Georgia,GA
13059,13CS022,680,625,735,698,18,-37,73,50,-2.6690698794448555,-0.9741521157006084,0.6264145672805783,2.6619849859094527,851,785,918,961,110,43,176,86,-0.3333791332292925,0.1755210496252886,0.6736242695504875,0.7755546108881013,128476,128679,Clarke+Madison+Oconee,Clarke,13,59,Georgia,GA
13195,13CS022,261,248,274,282,21,8,34,26,-2.3987787524940507,-0.6946489290369008,1.1799017653276302,1.1756905209356745,326,310,342,399,73,57,89,50,0.22741243719095328,0.7480663362616848,1.274287939947964,0.6761644635296603,30278,30794,Clarke+Madison+Oconee,Madison,13,195,Georgia,GA
13219,13CS022,249,231,268,292,43,24,61,27,-0.1451698285039323,1.5443297906203257,3.2003480748125264,0.6203372461469491,317,295,339,350,33,11,55,29,-0.40777997205905137,0.10006485698591584,0.6025214889746988,0.8474685957115237,41874,42877,Clarke+Madison+Oconee,Oconee,13,219,Georgia,GA
13063,13CS023,1537,1409,1665,1920,383,255,511,204,0.6987638146335853,2.439399307383741,4.124869761615253,0.5314729109072013,1912,1758,2065,2613,701,548,855,432,0.39151455999736223,0.9154377207552468,1.4338829246936213,0.6152361543267573,296653,297146,Clayton,Clayton,13,63,Georgia,GA
13067,13CS024,3842,3513,4172,4574,732,402,1061,451,-0.15862522133339232,1.448682051066588,3.2719619955172488,0.6155120847568007,4786,4391,5182,5622,836,440,1231,629,-0.21994079523609425,0.2805099245371571,0.7724989088781472,0.7519417464487237,765520,766716,Cobb,Cobb,13,67,Georgia,GA
13071,13CS025,423,404,443,525,102,82,121,55,2.2211081810555027,4.050280941188237,5.746416882947183,0.5357229419237868,520,497,544,640,120,96,143,108,-0.2516117609764792,0.25313641321585817,0.7729973982674311,0.8945712622763371,45817,45820,Colquitt+Mitchell,Colquitt,13,71,Georgia,GA
13205,13CS025,220,211,230,288,68,58,77,50,1.5944555291748144,3.2725289340923913,4.929520920722951,0.7267933117700086,269,257,280,287,18,7,30,35,-1.2896421019135365,-0.7636034744408178,-0.23903336017414564,1.7982957893874454,21685,21544,Colquitt+Mitchell,Mitchell,13,205,Georgia,GA
13073,13CS026,846,778,913,1012,166,99,234,101,-0.07618014605090154,1.6588687389596612,3.3510883369965097,0.6044005358814271,1065,983,1147,1352,287,205,369,175,0.18146679229343185,0.6960156080691221,1.2645908892029323,0.6080249132632739,157123,159221,Columbia,Columbia,13,73,Georgia,GA
13077,13CS027,924,860,987,1100,176,113,240,95,0.514972070883884,2.262267864321108,3.8006040068823737,0.535237878001013,1158,1081,1235,1574,416,339,493,247,0.6263846057988541,1.1256902007450413,1.6156621730051564,0.5927326644850568,147267,149474,Coweta,Coweta,13,77,Georgia,GA
13079,13CS028,130,125,135,140,10,5,15,5,-0.1891113775264325,1.7076613880085494,3.427107605534586,0.45003076900206873,160,153,166,213,53,47,60,30,1.3961235387592463,1.932700335323768,2.427553364299937,0.5510654921554485,12141,12145,Crawford+Peach+Pike+Upson,Crawford,13,79,Georgia,GA
13225,13CS028,276,263,288,319,43,31,56,36,-0.6468294608873976,1.0413021387256765,2.7323432714724736,0.8097293850341079,342,328,357,407,65,50,79,68,-0.6541182339605036,-0.11605040223062961,0.3973368419083279,1.035575943347089,28026,28361,Crawford+Peach+Pike+Upson,Peach,13,225,Georgia,GA
13231,13CS028,174,166,182,190,16,8,24,32,-5.279417721099568,-3.2866396744631463,-1.65871178520363,1.8532489970855688,218,208,228,262,44,34,54,55,-1.0555609508063757,-0.5823534668565631,-0.030594901757651168,1.2300921804927398,18994,19398,Crawford+Peach+Pike+Upson,Pike,13,231,Georgia,GA
13293,13CS028,340,328,352,421,81,69,93,55,2.152618785549678,3.7244372380223116,5.5389913633729275,0.6724872021284921,418,404,432,548,130,116,144,97,0.7397914814848031,1.193231533665608,1.6798994404827312,0.7399136205805319,27522,27719,Crawford+Peach+Pike+Upson,Upson,13,293,Georgia,GA
13081,13CS029,198,190,207,318,120,111,128,45,12.976160960454127,14.622390522326604,16.357309388474782,0.37344208932701994,240,230,251,346,106,95,116,66,1.474871107600405,1.994255728077366,2.5260414501110398,0.6183191116729532,20366,19903,Crisp+Dooly+Turner+Wilcox,Crisp,13,81,Georgia,GA
13093,13CS029,109,104,114,170,61,56,66,20,12.601050825533362,14.372725444861047,15.96980713874653,0.3216115903418527,129,124,135,173,44,38,49,25,1.1706384399132927,1.672336838028826,2.242117851576038,0.5604031479399965,11445,10922,Crisp+Dooly+Turner+Wilcox,Dooly,13,93,Georgia,GA
13287,13CS029,114,113,115,117,3,2,4,25,-10.408465232881218,-10.01391928420834,-9.604538405791738,6.369892727493252,142,141,143,134,-8,-9,-7,15,-2.718431648457351,-2.5937374575717325,-2.4700710824185355,-2.070825062929319,8819,8967,Crisp+Dooly+Turner+Wilcox,Turner,13,287,Georgia,GA
13315,13CS029,84,83,85,117,33,32,34,25,3.131023046869801,3.5231272604246238,3.9327164040212637,0.7427310088148251,104,103,105,171,67,66,68,17,5.59436659382241,5.720327046938547,5.849886981806895,0.24999384315186565,8714,8738,Crisp+Dooly+Turner+Wilcox,Wilcox,13,315,Georgia,GA
13085,13CS030,224,213,236,230,6,-6,17,18,-3.689417472025757,-1.90932085575682,-0.14375265835999376,2.7529797903860875,287,272,301,315,28,14,43,56,-1.480580704856279,-0.9766337870269399,-0.45693523295438393,1.9061211464791052,27059,28286,Dawson+Lumpkin+White,Dawson,13,85,Georgia,GA
13187,13CS030,256,242,271,287,31,16,45,20,-0.3564796374914827,1.24786098145279,2.959300531883416,0.6346579759137397,320,302,337,422,102,85,120,67,0.5082563695986312,1.0384846701052335,1.5522217242688716,0.6477132685541832,33681,34179,Dawson+Lumpkin+White,Lumpkin,13,187,Georgia,GA
13311,13CS030,242,230,254,336,94,82,106,33,6.8215830182558435,8.576490504453103,10.19032167588841,0.3484985149579222,297,283,312,447,150,135,164,67,2.3866406766228017,2.9241224935681878,3.4503070467139585,0.4445562147026495,28493,28391,Dawson+Lumpkin+White,White,13,311,Georgia,GA
13087,13CS031,298,285,310,367,69,57,82,39,2.36026052351956,4.209343203022058,5.97377243044585,0.554964594924291,365,350,380,395,30,15,45,51,-1.2278772251398595,-0.7295150676247865,-0.20424289950535063,1.6655829937259565,28892,29082,Decatur+Grady+Seminole,Decatur,13,87,Georgia,GA
13131,13CS031,234,223,246,273,39,27,50,38,-1.66637972352652,0.09857234220784836,1.8701687255943198,0.9617796464582367,287,274,301,347,60,46,73,49,-0.10307373746055606,0.4237065095369319,0.9137319960945682,0.8098494408201521,25951,25962,Decatur+Grady+Seminole,Grady,13,131,Georgia,GA
13253,13CS031,119,118,120,125,6,5,7,14,-3.8738103602520417,-3.458706350761539,-3.066546581900141,1.945362125420064,149,148,150,163,14,13,15,28,-1.634461040217687,-1.4994284484713012,-1.376108163327327,1.8451758020989755,8991,9188,Decatur+Grady+Seminole,Seminole,13,253,Georgia,GA
13089,13CS032,3969,3641,4297,4797,828,500,1156,479,0.07321470903711166,1.8873372872506673,3.5868838816317163,0.5780777939160027,4910,4518,5301,5842,932,541,1324,564,-0.04458991388047533,0.5038943593564981,1.0615684673400305,0.6042414837168952,762626,758609,DeKalb,DeKalb,13,89,Georgia,GA
13095,13CS033,781,745,818,1089,308,271,344,173,4.4139662321488125,6.289810875466577,8.034904855509327,0.5607602362917133,953,909,996,1203,250,207,294,149,0.7104760896960056,1.2118826125235098,1.6996923598547715,0.5924651487487252,85674,84920,Dougherty,Dougherty,13,95,Georgia,GA
13097,13CS034,847,785,909,1034,187,125,249,108,0.38923377841665724,2.172102017967084,3.892806609705569,0.5744819900709773,1053,978,1128,1295,242,167,317,164,0.008922894858393473,0.5487753155569803,1.035463284704833,0.6754451923072516,144953,145622,Douglas,Douglas,13,97,Georgia,GA
13103,13CS035,422,394,450,470,48,20,76,31,-0.560393452284379,1.1006663741936427,2.83752682671201,0.6337782702330624,531,497,565,655,124,90,158,143,-0.8544602785997717,-0.27956245293122955,0.21922336842096743,1.14409795029538,65198,66509,Effingham,Effingham,13,103,Georgia,GA
13105,13CS036,224,216,233,296,72,63,80,27,7.554385638062951,9.193759636636758,10.8513497137472,0.3706303995349805,273,263,284,331,58,47,68,39,0.388436059578272,0.943825926513143,1.499477618552412,0.6666421602488694,19560,19586,Elbert+Franklin+Hart+Stephens,Elbert,13,105,Georgia,GA
13119,13CS036,264,254,274,323,59,49,69,33,2.8121754387152342,4.3988396414554645,6.175154783202245,0.5502966014607964,326,314,338,368,42,30,54,43,-0.5597912348684256,-0.053456638005453264,0.4939642182272859,0.9973720946489066,23450,23733,Elbert+Franklin+Hart+Stephens,Franklin,13,119,Georgia,GA
13147,13CS036,257,246,268,324,67,56,78,36,3.02655624977674,4.719895165815623,6.5034115053252455,0.5306490704023057,319,305,332,407,88,75,102,52,0.8550111445336239,1.3647938995792084,1.8819742705253006,0.5836174034707857,25979,26330,Elbert+Franklin+Hart+Stephens,Hart,13,147,Georgia,GA
13257,13CS036,326,314,337,330,4,-7,16,42,-7.310521412222587,-5.719933791206298,-3.882355973970414,8.37372801875355,399,385,413,488,89,75,103,69,0.2482467691794169,0.7541165021095011,1.2197106731413074,0.7667624630827596,26693,26856,Elbert+Franklin+Hart+Stephens,Stephens,13,257,Georgia,GA
13111,13CS037,284,273,295,352,68,57,79,26,4.826337871909068,6.604468988854133,8.412957282252478,0.3780622688749642,347,334,361,468,121,107,134,79,1.1361679681981016,1.614646192677132,2.1554579110491456,0.6487336887731238,25538,25756,Fannin+Rabun+Towns+Union,Fannin,13,111,Georgia,GA
13241,13CS037,181,174,188,234,53,46,60,24,5.355841510855909,6.854513389381292,8.48949154056717,0.4432265162597654,221,212,230,285,64,55,73,46,0.5455709852953993,1.0515693897846845,1.5785885002930982,0.7049861341731319,16950,17086,Fannin+Rabun+Towns+Union,Rabun,13,241,Georgia,GA
13281,13CS037,169,164,175,181,12,6,17,26,-6.278028697868496,-4.533819889784891,-2.73614574473362,2.0426967659179933,209,203,216,248,39,32,45,41,-0.680830778332182,-0.17809061262687306,0.3640197143358073,1.0304365059373364,12497,12826,Fannin+Rabun+Towns+Union,Towns,13,281,Georgia,GA
13291,13CS037,279,268,290,361,82,71,93,31,6.50465310703099,8.213012901206532,9.924445536191609,0.3730813491779059,345,332,358,435,90,77,103,64,0.4930591316833139,1.0371774163278877,1.5537168114809774,0.7035209947733976,24821,25411,Fannin+Rabun+Towns+Union,Union,13,291,Georgia,GA
13113,13CS038,793,742,844,868,75,24,126,70,-1.6534522045930962,0.17763884652052567,1.8449084099722861,0.9226104729772913,987,925,1050,1186,199,136,261,145,-0.06870562809959019,0.45525041639497527,0.9699539606975567,0.7262112485799438,118860,120409,Fayette,Fayette,13,113,Georgia,GA
13115,13CS039,965,923,1007,1143,178,136,220,107,1.2700708719437528,2.902955514126182,4.6001149177317044,0.5979319120182585,1185,1134,1236,1448,263,212,314,207,0.02619544122532132,0.5778141904129516,1.095238165818117,0.7827510690813568,98572,98745,Floyd,Floyd,13,115,Georgia,GA
13117,13CS040,1091,982,1200,1196,105,-4,214,71,-1.1109371292687313,0.5749869102575303,2.1452754824360674,0.670433726712572,1392,1258,1525,1692,300,167,434,201,-0.12087492385168709,0.3669155175304233,0.8738083828182656,0.667045456610163,252369,259124,Forsyth,Forsyth,13,117,Georgia,GA
13121,13CS041,5852,5393,6312,7006,1154,694,1613,687,0.08955806910925218,1.7565001241733107,3.549810606306459,0.5949006730892701,7237,6687,7787,8332,1095,545,1645,877,-0.3113249162995188,0.1896845673194753,0.7290878721022154,0.800045207893404,1068055,1065872,Fulton,Fulton,13,121,Georgia,GA
13123,13CS042,308,294,321,363,55,42,69,33,1.108562784781661,2.869864392642212,4.451524474313783,0.5841424149050766,382,365,398,503,121,105,138,93,0.40781929444305143,0.8776068254292559,1.4180835298615773,0.7617285232130261,31512,31939,Gilmer+Murray,Gilmer,13,123,Georgia,GA
13213,13CS042,326,309,343,406,80,63,97,41,1.9799227364394933,3.8587105104184083,5.642381834841622,0.5080331211196578,402,381,422,544,142,122,163,92,0.733524043303035,1.279787962938511,1.788617213005821,0.6416150438756147,39948,39949,Gilmer+Murray,Murray,13,213,Georgia,GA
13127,13CS043,751,715,787,945,194,158,230,107,2.4167438776275034,4.108473015817903,5.858762931742907,0.5486630576891092,922,878,966,1141,219,175,263,189,-0.12615927101423371,0.3262784187766306,0.8746664140419035,0.8595848197300404,84623,84700,Glynn+McIntosh,Glynn,13,127,Georgia,GA
13191,13CS043,105,100,110,148,43,38,48,12,9.151420526439246,10.845254803467629,12.565327575193354,0.27294569395788915,127,121,132,226,99,94,105,25,6.176325608899437,6.702172000659627,7.207793733032313,0.24899424345166887,11480,11102,Glynn+McIntosh,McIntosh,13,191,Georgia,GA
13129,13CS044,483,459,508,593,110,85,134,61,1.5726542740536036,3.2684357736341205,5.052196762978096,0.5519596404371768,599,569,629,773,174,144,204,122,0.33837003376441205,0.8978840479915775,1.3767579349880694,0.6980003808316836,57803,58158,Gordon,Gordon,13,129,Georgia,GA
13135,13CS045,3863,3451,4274,4746,883,472,1295,531,-0.20205645749500073,1.4456536721418298,3.1862347530907966,0.6006518495310286,4873,4376,5371,5974,1101,603,1598,761,-0.16967984670896896,0.3521715866317697,0.8870108094495527,0.6908374556506425,955528,963562,Gwinnett,Gwinnett,13,135,Georgia,GA
13139,13CS046,1338,1251,1426,1728,390,302,477,183,2.3004228893660184,4.035221409123349,5.938966199165502,0.46844208174723706,1672,1565,1779,2026,354,247,461,332,-0.4023990818187694,0.10320906740202118,0.6004270045674202,0.9352891435320149,204088,206818,Hall,Hall,13,139,Georgia,GA
13141,13CS047,94,93,94,159,65,65,66,40,11.334191127651655,11.700958995065086,12.116929880026996,0.6026167927959294,114,113,115,167,53,52,54,30,2.5327938975289688,2.650431866664336,2.7739473123214884,0.5563655049302818,8676,8643,Hancock+Jasper+Morgan+Putnam,Hancock,13,141,Georgia,GA
13159,13CS047,141,134,147,144,3,-3,10,16,-5.147575785215423,-3.4075718014831002,-1.7382996072995722,3.5604525127154405,177,169,185,225,48,40,56,53,-0.824162869451175,-0.3441617513004182,0.18812577468078484,1.082448947763994,14642,15185,Hancock+Jasper+Morgan+Putnam,Jasper,13,159,Georgia,GA
13211,13CS047,176,167,185,209,33,24,42,12,2.526496218185339,4.217945096447879,5.845751166899688,0.35133252676596805,219,208,230,293,74,63,85,38,1.265303428690441,1.7438281368330062,2.269221063166809,0.5066312192173159,20086,20568,Hancock+Jasper+Morgan+Putnam,Morgan,13,211,Georgia,GA
13237,13CS047,210,200,219,258,48,39,58,30,1.5017268294574837,3.292484111603376,4.940057363279776,0.6091043452534638,259,248,271,366,107,95,118,51,1.9743917285050643,2.4590973574119452,2.9552805383410723,0.474005794092205,22178,22520,Hancock+Jasper+Morgan+Putnam,Putnam,13,237,Georgia,GA
13143,13CS048,311,298,324,392,81,68,94,50,2.4137866288621534,4.238131281444246,5.749457784539347,0.6074718287886945,383,367,398,444,61,46,77,68,-0.6805590306537593,-0.234485099862157,0.2812217555870805,1.0908995476383434,30031,30486,Haralson+Polk,Haralson,13,143,Georgia,GA
13233,13CS048,422,403,440,504,82,64,101,46,1.5711449453548734,3.4193572726820904,5.159092487737801,0.5513846041832883,517,495,540,660,143,120,165,88,0.7488520759519315,1.2484068371092831,1.7555215248086706,0.6128883459397052,42939,43413,Haralson+Polk,Polk,13,233,Georgia,GA
13145,13CS049,253,238,268,284,31,16,46,29,-1.4338294573148584,0.20950932264356134,1.8622759785589826,0.9002031371495418,317,299,335,345,28,10,46,58,-1.3397279428750095,-0.8321865875562976,-0.34203037569013445,1.9987814710141418,35038,35524,Harris+Meriwether+Talbot,Harris,13,145,Georgia,GA
13199,13CS049,233,224,242,284,51,42,60,19,4.524226054419849,6.117694100456431,7.837867591924721,0.3661091983465737,286,276,297,400,114,103,124,68,1.6889985006091288,2.180315371351043,2.6626462232446144,0.5933802692943416,20709,20768,Harris+Meriwether+Talbot,Meriwether,13,199,Georgia,GA
13263,13CS049,67,66,68,80,13,12,14,2,7.235152156668904,7.647266753365628,8.039275587005202,0.1419927143243072,81,81,82,97,16,15,16,20,-0.8868100627245703,-0.747201152867106,-0.6243979154075258,1.1976225106864644,5799,5740,Harris+Meriwether+Talbot,Talbot,13,263,Georgia,GA
13151,13CS050,1426,1322,1530,1751,325,221,429,151,1.2302683402619758,2.850064347916489,4.519696478345793,0.4637750941655314,1788,1661,1914,2208,420,294,547,326,-0.11360832074416828,0.37432233333853154,0.8868722887638263,0.7735426243823031,241132,244737,Henry,Henry,13,151,Georgia,GA
13153,13CS051,1097,1027,1168,1304,207,136,277,106,0.670753396664573,2.4185346701415655,4.167431261405193,0.5103634099085352,1375,1290,1461,1701,326,240,411,247,0.003158035986069418,0.4673854783512506,0.9963020045568423,0.7563688635885654,163518,166452,Houston,Houston,13,153,Georgia,GA
13157,13CS052,580,547,613,680,100,67,133,77,-0.429043769893488,1.2143044300536123,2.8490805218350013,0.7632245511596965,736,695,777,858,122,81,163,139,-0.7291030564042177,-0.21355660766865503,0.2836648380007975,1.1313665382978821,76545,79765,Jackson,Jackson,13,157,Georgia,GA
13003,13CS053,72,71,73,80,8,7,9,11,-1.8348181666626606,-1.4419859698616493,-1.054463256287449,1.2216861522340345,89,88,90,139,50,49,51,28,2.4800262126566146,2.6066767101642854,2.737940998076377,0.5506165256068402,8306,8378,Lanier and Nearby Counties,Atkinson,13,3,Georgia,GA
13019,13CS053,184,176,192,227,43,35,51,30,1.2380797826014374,2.897560712213353,4.5873158735656805,0.6800200540895844,223,214,233,286,63,53,72,37,0.8915434934606713,1.3817711511262578,1.918600044460738,0.5819408482434248,18335,18149,Lanier and Nearby Counties,Berrien,13,19,Georgia,GA
13065,13CS053,71,70,72,92,21,20,22,13,4.445094185693291,4.8527807949012,5.278659085860332,0.5867632537118785,87,86,88,116,29,28,30,19,1.358269981698521,1.486475735111933,1.6055822023547064,0.6334517231483054,6711,6725,Lanier and Nearby Counties,Clinch,13,65,Georgia,GA
13075,13CS053,167,159,174,213,46,39,54,32,1.5757449499042318,3.2297572446694223,4.944575732327251,0.6782891116734627,204,195,213,229,25,16,34,29,-0.7093793855411298,-0.2248810341892206,0.2911813447516056,1.1166022818907484,17233,17226,Lanier and Nearby Counties,Cook,13,75,Georgia,GA
13101,13CS053,21,21,21,36,15,15,15,4,11.485128027061396,11.865580740734437,12.262362662949489,0.24893497159566386,26,25,26,42,16,16,17,4,3.228777141614724,3.361404244023813,3.4874503121061875,0.2294888389819761,3735,3699,Lanier and Nearby Counties,Echols,13,101,Georgia,GA
13173,13CS053,78,77,79,84,6,5,7,10,-1.8903516326177807,-1.4979922483233508,-1.1021847901518542,1.3767602894531332,95,93,96,114,19,18,21,3,1.5386134062642016,1.6606862990328686,1.7807335916329217,0.14661984769824385,10012,9908,Lanier and Nearby Counties,Lanier,13,173,Georgia,GA
13185,13CS054,802,751,853,989,187,136,238,107,1.110695633955956,2.688972601134845,4.356766718891256,0.5689681941328846,998,937,1060,1237,239,177,300,156,0.1662053291936981,0.6774295839432598,1.2255341507039141,0.6503663231143115,118312,119136,Lowndes,Lowndes,13,185,Georgia,GA
13053,13CS055,35,34,36,35,-0,-1,1,4,-2.1212826296505836,-1.7353921255643008,-1.2971827900526625,4.803326568195671,42,41,43,39,-3,-4,-2,9,-1.4279644901176547,-1.2986785871202204,-1.1783409268591876,-4.881441989652706,9657,9111,Marion and Nearby Counties,Chattahoochee,13,53,Georgia,GA
13193,13CS055,135,130,140,147,12,7,17,11,-1.3553950477232481,0.3768059409411526,2.0822925184070638,0.8339720306662272,164,158,170,174,10,4,16,23,-1.5795074368330475,-1.0353047153788573,-0.5681341404291749,2.0382374568565824,12152,12006,Marion and Nearby Counties,Macon,13,193,Georgia,GA
13197,13CS055,67,66,68,87,20,19,21,3,8.583007568570093,9.031663792230333,9.409110768240197,0.14135169879573445,80,79,81,126,46,45,47,30,1.963447050883781,2.092874317031988,2.2255135592248343,0.6439797525993657,7642,7452,Marion and Nearby Counties,Marion,13,197,Georgia,GA
13249,13CS055,31,30,31,40,9,9,10,6,2.412686584397572,2.8029560338558857,3.2218205911620186,0.5855372946657531,37,36,38,58,21,20,22,2,4.127877985905638,4.248381386089533,4.377384717018475,0.09062726704974372,4636,4487,Marion and Nearby Counties,Schley,13,249,Georgia,GA
13259,13CS055,49,49,50,59,10,9,10,12,-1.945524275611655,-1.5392311701528874,-1.1390503104668914,1.1037919048421743,59,58,60,78,19,18,20,12,1.2208513033262043,1.335873871775224,1.4689976033766625,0.595660884698336,5497,5334,Marion and Nearby Counties,Stewart,13,259,Georgia,GA
13261,13CS055,311,298,323,342,31,19,44,69,-6.939597420044377,-5.137388738659021,-3.3808698837830646,2.1424357764037527,378,363,393,431,53,38,68,58,-0.71836174879749,-0.1730010371139763,0.38095658865183746,1.0808055196153739,29503,29322,Marion and Nearby Counties,Sumter,13,261,Georgia,GA
13269,13CS055,82,82,83,98,16,15,16,17,-1.0589749572640157,-0.6728764953310054,-0.25936012589800816,1.0198671535619581,101,100,102,138,37,36,38,15,2.7106827293453213,2.8442011340109707,2.9628928726347885,0.3929637872253885,7847,7801,Marion and Nearby Counties,Taylor,13,269,Georgia,GA
13307,13CS055,21,21,21,27,6,6,6,8,-3.690496829344235,-3.2712616671767507,-2.879290741430737,1.1343950899352333,26,25,26,25,-1,-1,-0,3,-1.6595743342473444,-1.5419207239536747,-1.4233009963377192,8.658182363287255,2384,2365,Marion and Nearby Counties,Webster,13,307,Georgia,GA
13215,13CS056,1781,1692,1869,1981,200,112,289,190,-1.5052692717054903,0.16549210778466186,1.8678846307814938,0.9438253522742683,2186,2080,2292,2562,376,270,482,369,-0.4636765556120728,0.03716450303317775,0.5322355041370295,0.9788341539698635,205233,205813,Muscogee,Muscogee,13,215,Georgia,GA
13217,13CS057,786,738,835,999,213,164,261,104,2.224878248635927,3.932830191528833,5.6295579778048985,0.4871097821724447,988,928,1047,1249,261,202,321,199,0.007360920289185642,0.5359607193662994,1.0396969196599741,0.7590551347043295,112919,114979,Newton,Newton,13,217,Georgia,GA
13223,13CS058,849,776,922,1046,197,124,270,106,0.38432781434511737,2.1352824197323197,3.7651836987430163,0.5361765930833021,1076,987,1166,1288,212,122,301,188,-0.34954993596519873,0.13117354262041972,0.6542529521629586,0.8842076449575742,170037,173179,Paulding,Paulding,13,223,Georgia,GA
13245,13CS059,1775,1686,1863,2116,341,253,430,236,0.23317091249379363,2.044736665111422,3.8786861993181634,0.6896927933407544,2175,2068,2281,2656,481,375,588,391,-0.06629564689495686,0.4467822910400335,0.9477114159242008,0.8103734525017144,205722,205769,Richmond,Richmond,13,245,Georgia,GA
13247,13CS060,655,615,695,777,122,82,162,71,0.2958234989326389,2.229708584528111,3.8008355167818944,0.5779303800160878,816,768,865,1008,192,143,240,151,-0.0648412298504688,0.43396729057096145,0.9308671169565046,0.7825522362355816,93229,94014,Rockdale,Rockdale,13,247,Georgia,GA
13255,13CS061,662,633,691,839,177,148,206,94,3.238775879941815,4.897681434335397,6.568417541009436,0.5284437481621618,814,779,849,1101,287,252,322,205,0.6988405395905156,1.2197181800076133,1.7145894840005178,0.7126242349396625,67380,67837,Spalding,Spalding,13,255,Georgia,GA
13133,13CS062,196,188,204,212,16,8,24,23,-3.2821080242389744,-1.5086880744308562,0.2217725917379055,1.3708010808983093,246,236,256,275,29,19,39,33,-0.7447456241679997,-0.21819986470845204,0.2816805275395606,1.1120459376372858,18981,19461,Taliaferro and Nearby Counties,Greene,13,133,Georgia,GA
13181,13CS062,79,78,80,96,17,16,18,17,-0.3535185166929875,0.06768314727164412,0.48068213703475077,0.9385067045278916,97,96,98,122,25,24,26,17,0.9210793725854735,1.0566699108431687,1.1833539217624631,0.649480075753177,7747,7742,Taliaferro and Nearby Counties,Lincoln,13,181,Georgia,GA
13189,13CS062,220,211,229,238,18,9,27,23,-2.6421730984104146,-0.9652511842480689,0.8237975604592809,1.2236709941211619,271,260,282,309,38,27,49,37,-0.49824958114902124,0.06176133435296924,0.537912191516676,0.9523090447708078,21552,21626,Taliaferro and Nearby Counties,McDuffie,13,189,Georgia,GA
13221,13CS062,141,135,148,151,10,3,16,2,0.36685613536796624,2.0714056572358808,3.755497617843044,0.18826211479383703,176,168,184,194,18,10,26,20,-0.6609954268181989,-0.12078538673528652,0.38852103194840953,1.0469634016765783,14946,15100,Taliaferro and Nearby Counties,Ogelthorpe,13,221,Georgia,GA
13265,13CS062,21,21,21,23,2,2,2,5,-8.037081891189484,-7.63795014182133,-7.221550875138853,1.6508162198855516,26,26,26,37,11,11,11,2,5.818357466294794,5.946127890256774,6.074567811318598,0.1629628864682647,1556,1558,Taliaferro and Nearby Counties,Taliaferro,13,265,Georgia,GA
13301,13CS062,66,66,67,89,23,22,23,6,12.406623666016156,12.854518102931909,13.268396727157311,0.25259425500701116,82,81,82,86,4,4,5,13,-1.76417488441276,-1.644968864334321,-1.5162549108916357,2.3990958885944624,5211,5235,Taliaferro and Nearby Counties,Warren,13,301,Georgia,GA
13317,13CS062,134,130,138,135,1,-3,5,11,-5.894128222728987,-4.255305026173355,-2.4234075122321066,5.576504428124683,163,158,168,179,16,11,21,21,-1.0267695008322035,-0.5112597708561919,0.02304705428292212,1.2168068294386893,9583,9519,Taliaferro and Nearby Counties,Wilkes,13,317,Georgia,GA
13277,13CS063,391,373,408,450,59,42,77,69,-2.4501713332395467,-0.9682913943617079,0.6389989002971106,1.1447002978896923,484,462,505,545,61,40,83,79,-0.9221883269167109,-0.4315981567279328,0.06646667665359891,1.2681051276904667,41232,41232,Tift+Worth,Tift,13,277,Georgia,GA
13321,13CS063,214,205,222,240,26,18,35,40,-4.291806287737656,-2.6457130748493327,-0.9217737831267357,1.4558696215591977,263,252,274,314,51,40,62,41,-0.013513798853824716,0.4949114407384152,0.9954457009625659,0.7875648784949753,20624,20578,Tift+Worth,Worth,13,321,Georgia,GA
13285,13CS064,600,570,630,789,189,159,219,100,3.3383521581433326,5.1111525479563635,6.810284218079727,0.5262983070510742,737,701,773,941,204,168,240,161,0.10358704362617573,0.6094930844445742,1.1543219268365115,0.7870954191440585,69520,69672,Troup,Troup,13,285,Georgia,GA
13297,13CS065,783,741,825,904,121,79,163,91,-0.475837964992687,1.2178771923327523,3.0455090327903003,0.7469204819899117,983,931,1034,1239,256,205,308,213,-0.07297322308369107,0.44896610795143543,0.9645270069943745,0.8280890484651577,97080,99457,Walton,Walton,13,297,Georgia,GA
13009,13CS066,390,371,409,498,108,89,127,45,4.080111471648129,5.754651357214921,7.390210185635406,0.4126736572470616,480,457,502,620,140,118,163,88,0.6705839104731574,1.1982378265440428,1.7467050227699426,0.6223377378995317,43954,43780,Washington and Nearby Counties,Baldwin,13,9,Georgia,GA
13125,13CS066,32,32,33,38,6,5,6,10,-6.58220574315113,-6.1952172650228094,-5.794250211867214,1.5353263413901153,40,40,40,51,11,11,11,4,2.2338843637750463,2.361354581379288,2.4918523435933517,0.33659868607646604,2898,2914,Washington and Nearby Counties,Glascock,13,125,Georgia,GA
13163,13CS066,192,186,199,257,65,58,71,33,6.315603356415237,8.088125844191675,9.839566057541521,0.5025571106468398,234,226,242,278,44,36,52,47,-0.7251233877196657,-0.20614742411612197,0.2919610748176931,1.0509639505568846,15598,15544,Washington and Nearby Counties,Jefferson,13,163,Georgia,GA
13167,13CS066,87,86,88,124,37,36,38,24,5.165567717623821,5.572438979350334,5.991806460067132,0.6338399238047158,106,105,107,142,36,35,37,25,1.0484859215103992,1.1840445198819878,1.3067544320247755,0.6793028549658103,9248,9161,Washington and Nearby Counties,Johnson,13,167,Georgia,GA
13169,13CS066,219,207,232,263,44,31,56,18,1.8382636532676035,3.628487052295995,5.350949275197987,0.40419708604006227,272,257,286,384,112,98,127,60,1.3695049089298326,1.846152846622872,2.341424268132344,0.5292644059290366,28409,28394,Washington and Nearby Counties,Jones,13,169,Georgia,GA
13303,13CS066,198,189,207,271,73,64,82,53,2.178973324885338,3.978665333932781,5.7795615270980125,0.7166736488796519,242,232,252,312,70,60,80,58,0.09163449099365018,0.6243316118930258,1.1416548784476883,0.8141052458756266,19974,19806,Washington and Nearby Counties,Washington,13,303,Georgia,GA
13319,13CS066,102,101,103,130,28,27,29,13,6.26300511690754,6.659769953096081,7.031942967802475,0.4523634994403487,125,124,126,190,65,64,66,26,4.269748146113579,4.391245625034191,4.511385725320667,0.39528985700846414,8856,8833,Washington and Nearby Counties,Wilkinson,13,319,Georgia,GA
13175,13CS067,502,481,523,642,140,119,161,103,1.1759413822026732,3.0195959911245938,4.766587199943472,0.7291852723968418,617,592,643,809,192,166,217,116,1.002591908071406,1.53171672075802,2.066790260443466,0.6024539471327061,49221,49540,Wheeler and Nearby Counties,Laurens,13,175,Georgia,GA
13209,13CS067,76,75,77,101,25,24,26,14,4.533151538928406,4.938175363615422,5.336857265399763,0.5454416839078808,94,93,95,151,57,56,58,30,3.0274763381257497,3.157243692805893,3.291535686139554,0.5148426386210737,8668,8642,Wheeler and Nearby Counties,Montgomery,13,209,Georgia,GA
13271,13CS067,116,110,121,192,76,71,82,33,11.509672277051685,13.277242875773034,15.06096979504997,0.4283433374958601,139,132,145,184,45,39,52,32,0.5347869513863568,1.0538929554731145,1.5681572348963753,0.6939984367039608,12945,12421,Wheeler and Nearby Counties,Telfair,13,271,Georgia,GA
13283,13CS067,63,62,63,93,30,30,31,13,10.302715607031244,10.681540702346183,11.087617522281361,0.4164792996308944,76,75,76,132,56,56,57,33,3.5672866087223616,3.6919377219685816,3.8281468052376733,0.5755437372612555,6450,6318,Wheeler and Nearby Counties,Treutlen,13,283,Georgia,GA
13309,13CS067,53,53,54,68,15,14,15,12,0.9675275794355152,1.3294810036939653,1.7370682956266434,0.7712696222458514,66,65,67,78,12,11,13,12,-0.09666162314530105,0.037923572619388654,0.1503207582837898,0.9035641657957172,7498,7465,Wheeler and Nearby Counties,Wheeler,13,309,Georgia,GA
13313,13CS068,733,689,778,916,183,138,227,138,0.09892831433642653,1.740199447155145,3.356165874694234,0.7517647272943795,905,852,958,1136,231,178,284,199,-0.23149440889134373,0.3285085784024454,0.8378609228594616,0.8566099923221927,102964,102830,Whitfield,Whitfield,13,313,Georgia,GA
15001,15CS001,1505,1418,1591,1531,26,-60,113,47,-2.092377875715809,-0.3058620864463229,1.4161270957323318,1.7332011624369092,1865,1760,1969,2054,189,85,294,107,-0.12445797417757246,0.41456268111734856,0.9150498285804637,0.5620548492842674,201178,202591,Hawaii (county),Hawaii (county),15,1,Hawaii,HI
15003,15CS002,6754,6321,7188,6909,155,-279,588,275,-2.257944784520651,-0.5143799045919791,1.248530256268957,1.7656277904211224,8295,7778,8813,8764,469,-49,986,470,-0.5182351210766001,0.0043279390171472925,0.5510327462703299,1.000777402613837,1006147,1002689,Honolulu,Honolulu,15,3,Hawaii,HI
15005,15CS003,1,1,1,1,0,0,0,1,-34.920139650570995,-33.23683348635356,-31.578065920367138,0.7637333655248306,1,1,1,3,2,2,2,3,-10.757018914780783,-10.278885170519745,-9.752624461329145,0.9504629123300607,83,82,Kalawao+Maui,Kalawao,15,5,Hawaii,HI
15009,15CS003,990,919,1061,1026,36,-35,107,16,-1.1969803433452366,0.48027457874026264,2.2205942947113724,0.43186879068317646,1222,1137,1307,1389,167,82,252,84,-0.01066925461118863,0.4971874826050931,1.0008581134709502,0.5006975667474998,165051,164284,Kalawao+Maui,Maui,15,9,Hawaii,HI
15007,15CS004,505,474,537,487,-18,-50,13,3,-2.8146505255346317,-1.144267891230868,0.6006013782433611,-0.17180074233351686,626,588,664,590,-36,-74,2,18,-1.2570042388475633,-0.7439945923772727,-0.2163250362647443,-0.5139262715734797,73080,73417,Kauai,Kauai,15,7,Hawaii,HI
16001,16CS001,2881,2667,3095,3261,380,166,594,315,-1.1169657111700106,0.5272716924099812,2.407186717247293,0.8268245725817144,3647,3383,3910,4152,505,242,769,451,-0.43117942628784434,0.09691866173358255,0.6120445892654923,0.8906529839423595,497088,509897,Ada,Ada,16,1,Idaho,ID
16005,16CS002,638,601,676,704,66,28,103,59,-1.4178715365103072,0.328157553973549,1.8794298198502868,0.8830834631514777,794,749,840,939,145,99,190,126,-0.3257129807692197,0.20449256555082562,0.733593826838205,0.8640123750436588,87384,88105,Bannock+Bear Lake+Caribou+Franklin,Bannock,16,5,Idaho,ID
16007,16CS002,53,52,54,69,16,15,17,6,5.876671836980466,6.293014330582874,6.686510975814625,0.3530819325082967,67,66,68,79,12,11,13,11,0.030696048413085823,0.16172198973997132,0.28823133474575324,0.8407032020174884,6353,6519,Bannock+Bear Lake+Caribou+Franklin,Bear Lake,16,7,Idaho,ID
16029,16CS002,58,57,59,74,16,15,17,7,4.6565097270933355,5.038919498744628,5.446412829183416,0.4146535959406701,72,71,73,78,6,5,7,15,-1.3988596376489972,-1.2712630304296997,-1.1472432410146602,2.1554779801231545,7045,7097,Bannock+Bear Lake+Caribou+Franklin,Caribou,16,29,Idaho,ID
16041,16CS002,97,95,98,91,-6,-7,-4,5,-3.4344100031791953,-3.00565466137583,-2.6021910227722014,-1.0407974276047638,122,120,124,134,12,10,14,16,-0.42162726574247855,-0.29813041297659437,-0.17060652253205288,1.264483654574076,14256,14608,Bannock+Bear Lake+Caribou+Franklin,Franklin,16,41,Idaho,ID
16009,16CS003,112,111,113,102,-10,-11,-9,4,-6.105258601027772,-5.696395542911342,-5.312233011738774,-0.46206516806455106,141,139,142,158,17,16,19,23,-0.7093141925095132,-0.5805727150325812,-0.45864312342732605,1.2595507840364895,9573,9879,Benewah+Latah+Nez Perce,Benewah,16,9,Idaho,ID
16057,16CS003,182,165,199,213,31,14,48,2,1.2360890824718063,2.9551305681534075,4.638641213381746,0.06173952626452721,227,206,247,303,76,56,97,29,0.6604024888798045,1.182683735780856,1.7045015141919666,0.37492244872690794,39795,40211,Benewah+Latah+Nez Perce,Latah,16,57,Idaho,ID
16069,16CS003,443,425,461,463,20,2,38,37,-3.2890867799536094,-1.6308163157685833,-0.03136306391343328,1.7799645027832733,543,522,565,609,66,44,87,58,-0.35838518646596457,0.17912820246736727,0.7171337067886526,0.8721546356090505,41909,42401,Benewah+Latah+Nez Perce,Nez Perce,16,69,Idaho,ID
16011,16CS004,350,329,371,406,56,35,77,43,-0.6713708557275834,1.112227342709893,2.751719972081858,0.7555334292864815,438,413,463,504,66,41,91,75,-0.7107562663973696,-0.1737167759520476,0.32017639486573846,1.1190638473623513,47963,48758,Bingham+Oneida+Power,Bingham,16,11,Idaho,ID
16071,16CS004,38,38,38,39,1,1,1,4,-3.0572134240030193,-2.6571606720455456,-2.2819479253159662,2.031549600211653,47,47,48,63,16,15,16,6,1.9894227080938087,2.121883372174615,2.241198001780081,0.358285783176297,4552,4603,Bingham+Oneida+Power,Oneida,16,71,Idaho,ID
16077,16CS004,55,55,56,63,8,7,8,3,1.9688352229006227,2.3569797642058803,2.748264113065711,0.3480103429306187,69,68,70,88,19,18,20,12,0.7615719118960362,0.8849907478561824,1.0128976505764675,0.5985110051737846,7851,7940,Bingham+Oneida+Power,Power,16,77,Idaho,ID
16015,16CS005,51,50,52,57,6,5,7,3,1.0675324594816942,1.469221993019726,1.8472807557228934,0.43860155884079116,66,65,67,93,27,26,28,3,2.9010063871553564,3.0378997081086556,3.1694100214677547,0.10559579423481305,7731,8029,Boise+Gem+Payette+Washington,Boise,16,15,Idaho,ID
16045,16CS005,200,192,209,227,27,18,35,17,0.1947008579143186,1.9557447095541365,3.4867705876878965,0.6158161536779316,251,241,261,304,53,43,63,37,0.30889995399426645,0.8106123736417844,1.3317203848456438,0.6832188507290421,19156,19714,Boise+Gem+Payette+Washington,Gem,16,45,Idaho,ID
16075,16CS005,219,208,230,220,1,-10,12,25,-5.368196331026663,-3.8294624562572537,-2.0734430896810885,13.523893542295983,276,262,289,338,62,49,76,47,0.039990139108188244,0.5852604512796801,1.0515098745189493,0.74402278865608,25444,26239,Boise+Gem+Payette+Washington,Payette,16,75,Idaho,ID
16087,16CS005,107,106,108,138,31,30,32,13,6.312409901578405,6.733350456131217,7.1442413716430035,0.4101985347537739,136,134,137,163,27,26,29,28,-0.20746963442783903,-0.07576023231050308,0.04578056911007581,0.9955457220307815,10520,10846,Boise+Gem+Payette+Washington,Washington,16,87,Idaho,ID
16017,16CS006,417,396,437,414,-3,-23,18,18,-3.4181198722396884,-1.7829351331990801,-0.05486178777570154,-10.678331822365497,528,502,553,618,90,65,116,120,-1.1165070877735186,-0.6089606947052646,-0.11785105242950714,1.3138317661734784,47373,49185,Bonner+Boundary+Shoshone,Bonner,16,17,Idaho,ID
16021,16CS006,99,98,100,113,14,13,15,1,3.877290292588903,4.244986338567133,4.656172989532395,0.06698122922809213,125,123,126,179,54,53,56,41,0.9380799994908238,1.0634818839731612,1.1937054030325396,0.7410303442953311,12193,12496,Bonner+Boundary+Shoshone,Boundary,16,21,Idaho,ID
16079,16CS006,167,161,172,158,-9,-14,-3,24,-11.596064582937482,-9.89379706349012,-8.288881630603523,-3.1795611075730963,208,201,215,246,38,31,45,42,-0.7907501008675588,-0.27782843656198697,0.23651677856813735,1.069305461992096,13186,13550,Bonner+Boundary+Shoshone,Shoshone,16,79,Idaho,ID
16019,16CS007,835,781,888,942,107,54,161,111,-1.8082398150986956,-0.06797815339308963,1.596263093925159,1.0238983171079339,1054,988,1120,1104,50,-16,116,115,-1.0329182843215732,-0.4954838960647295,0.028448614212321505,2.25672033323178,124191,127448,Bonneville,Bonneville,16,19,Idaho,ID
16027,16CS008,1425,1324,1526,1649,224,123,325,209,-1.4292024671131744,0.2202383155338757,2.1582161715234958,0.9289107417853832,1818,1693,1943,2131,313,188,438,334,-0.5760248557764651,-0.09554476517446224,0.42225780023924175,1.064221831299278,233441,241598,Canyon,Canyon,16,27,Idaho,ID
16003,16CS009,38,38,39,41,3,2,3,3,-0.7716306954223056,-0.35009339768658637,0.047721144856512944,0.8332437708440102,49,48,50,55,6,5,7,4,0.31472851340817865,0.4461464961256508,0.568659737230282,0.5664618522196115,4422,4596,Central Idaho,Adams,16,3,Idaho,ID
16035,16CS009,92,91,92,104,12,12,13,4,3.4705418057913824,3.8607907929015415,4.290735667856893,0.296735580875512,113,112,115,132,19,17,20,16,0.16366878247466726,0.28853693581881296,0.41366784299019665,0.818042134590163,8767,8874,Central Idaho,Clearwater,16,35,Idaho,ID
16037,16CS009,45,43,47,40,-5,-7,-3,2,-8.183843889290017,-6.253023453482641,-4.626665917812792,-0.5404215956480465,56,53,58,69,13,11,16,4,1.5741894025477772,2.0968963755123293,2.6161354758704225,0.28084815182496287,4284,4404,Central Idaho,Custer,16,37,Idaho,ID
16049,16CS009,168,161,176,181,13,5,20,16,-2.6442657487883112,-0.850214497927585,0.872969349913255,1.180687016452871,209,200,218,257,48,39,57,30,0.5533538553785735,1.0650259006543117,1.5586834686433528,0.610033742122557,16620,16970,Central Idaho,Idaho (county),16,49,Idaho,ID
16059,16CS009,90,89,91,109,19,18,20,11,3.5588269465105866,3.950524044106718,4.350736887545106,0.552811316824588,112,111,113,148,36,35,37,13,2.6722916501712026,2.793681243182428,2.921796965512413,0.35379577529954964,7988,8131,Central Idaho,Lemhi,16,59,Idaho,ID
16061,16CS009,37,36,39,47,10,8,11,8,0.007525091941319886,1.8283541798137746,3.454900606557553,0.750402160547552,47,45,49,67,20,18,22,12,1.743140243929684,2.2507316219897113,2.7601121376725026,0.5630464802531746,3596,3688,Central Idaho,Lewis,16,61,Idaho,ID
16085,16CS009,77,76,79,83,6,4,7,4,0.09589918087418536,0.5103585587947035,0.9209332222047036,0.6139809147155917,98,97,100,101,3,1,4,1,0.022116463282795602,0.15033021577360967,0.27370460033608257,0.26060677561578555,11822,12182,Central Idaho,Valley,16,85,Idaho,ID
16039,16CS010,194,181,206,209,15,3,28,11,-1.08095148524439,0.5798914733827776,2.1933347614566645,0.6769761901423985,241,226,256,239,-2,-17,13,43,-2.0862156757542936,-1.569419945597503,-1.0689941931372868,-35.7033452498834,28496,28804,Elmore+Gooding+Owyhee,Elmore,16,39,Idaho,ID
16047,16CS010,120,119,122,169,49,47,50,20,7.01418046641654,7.389800493819635,7.796743330570276,0.40100423567554955,149,147,151,170,21,19,23,26,-0.43127566028445796,-0.3077400204105697,-0.17793077511013267,1.175363577277867,15605,15753,Elmore+Gooding+Owyhee,Gooding,16,47,Idaho,ID
16073,16CS010,89,88,90,118,29,28,30,17,3.592721041036257,4.007305143753887,4.437460675274064,0.5659113389265167,112,110,113,140,28,27,30,19,0.6097616370026337,0.7377529738244221,0.8618017983730817,0.6530734410573265,11993,12284,Elmore+Gooding+Owyhee,Owyhee,16,73,Idaho,ID
16023,16CS011,25,25,25,31,6,6,6,1,7.413930310989415,7.779459100642141,8.182657256010687,0.14189317834400264,31,31,32,45,14,13,14,4,3.5707391675298283,3.702476445302396,3.820727075803415,0.27077655242281123,2591,2643,Jefferson and Nearby Counties,Butte,16,23,Idaho,ID
16033,16CS011,5,5,5,6,1,1,1,6,-26.583137637663057,-26.191450593060807,-25.759547615073128,3.3856327722001067,6,6,6,10,4,4,4,4,-0.6253970647197358,-0.48384339165656387,-0.3619776501094356,0.8672194174477335,799,792,Jefferson and Nearby Counties,Clark,16,33,Idaho,ID
16043,16CS011,95,94,96,111,16,15,17,13,0.43495186600472946,0.8797448120590192,1.256206493773179,0.7690229769001545,119,117,120,164,45,44,47,5,2.8422792325022717,2.9785205127635663,3.097558950139039,0.1079250411571508,13380,13565,Jefferson and Nearby Counties,Fremont,16,43,Idaho,ID
16051,16CS011,163,150,176,176,13,-0,26,16,-1.978261725417874,-0.42061888249350454,1.3246271335189814,1.1520781207424298,207,190,223,251,44,28,61,37,-0.2667793079949475,0.20248639505249788,0.7705434343602587,0.8182049073716896,31009,32035,Jefferson and Nearby Counties,Jefferson,16,51,Idaho,ID
16065,16CS011,174,152,196,164,-10,-32,12,15,-3.6241558291019498,-1.9555112030527926,-0.2533422313350917,-1.6657339005194507,225,197,253,234,9,-19,37,20,-0.7228575557755308,-0.20925187487774707,0.3020658827263004,2.007042448146201,51133,53734,Jefferson and Nearby Counties,Madison,16,65,Idaho,ID
16081,16CS011,45,44,46,37,-8,-9,-7,7,-5.36802154231618,-4.969076820963505,-4.563337856774589,-1.0440780418878237,57,56,59,70,13,11,14,7,0.33482387670026337,0.4709131996784082,0.5985383925576839,0.5088266899409298,11840,12189,Jefferson and Nearby Counties,Teton,16,81,Idaho,ID
16055,16CS012,1381,1307,1455,1387,6,-68,80,115,-4.271898625620116,-2.544717677146841,-0.9117566911887768,16.36239787181791,1757,1665,1849,2018,261,169,353,310,-0.7720352479119789,-0.26716771572755355,0.2595815769391744,1.1838060706777471,172371,178747,Kootenai,Kootenai,16,55,Idaho,ID
16013,16CS013,112,110,115,121,9,6,11,15,-1.405503702024423,-1.0132070681187115,-0.6221827238279449,1.5181462533838272,142,139,145,156,14,11,17,11,-0.008887853787574052,0.11650070946109199,0.22640907118749162,0.7474001922467146,24181,24702,Lincoln and Nearby Counties,Blaine,16,13,Idaho,ID
16025,16CS013,10,10,11,12,2,1,2,0,3.884992263849149,5.58254335548951,7.3359524205517275,0,13,13,14,7,-6,-7,-6,7,-12.243658742746453,-11.751727418975445,-11.200712523747608,-1.3257575370855996,1094,1132,Lincoln and Nearby Counties,Camas,16,25,Idaho,ID
16031,16CS013,185,175,196,192,7,-4,17,18,-3.5114604733707537,-1.8146874227924725,-0.2045746768457018,2.36301998628141,232,219,245,234,2,-11,15,25,-1.460427692021235,-0.9269011610572508,-0.42430254016905816,9.784284657997029,24653,25096,Lincoln and Nearby Counties,Cassia,16,31,Idaho,ID
16053,16CS013,154,143,164,158,4,-6,15,17,-3.788219925907785,-2.0813201115919475,-0.2137886170252852,3.0948714689962085,193,180,205,243,50,38,63,39,-0.06803568158972402,0.4548466209714787,0.9764134282291046,0.7613213671914658,24306,24598,Lincoln and Nearby Counties,Jerome,16,53,Idaho,ID
16063,16CS013,33,33,34,39,6,5,6,4,0.8200017034092275,1.2443793271324055,1.6472160740035384,0.6073344228291244,42,41,43,38,-4,-5,-3,2,-1.2502879388578816,-1.123225650215386,-1.0042354052853635,-0.6821065190299438,5177,5260,Lincoln and Nearby Counties,Lincoln,16,63,Idaho,ID
16067,16CS013,175,166,185,178,3,-7,12,23,-5.493259567617287,-3.7213858613946376,-2.075739846655173,6.258860120655911,219,207,230,228,9,-2,21,29,-1.376492061976754,-0.882262888337818,-0.4421896988331091,2.8009140297078097,21592,21914,Lincoln and Nearby Counties,Minidoka,16,67,Idaho,ID
16083,16CS014,693,655,732,838,145,106,183,98,0.29604720058038675,2.0357991004650198,3.8531817396821983,0.6730705111511187,868,820,915,986,118,71,166,130,-0.6495797717014385,-0.12741129207239288,0.35769675696809,1.0909375733754376,90024,91957,Twin Falls,Twin Falls,16,83,Idaho,ID
17001,17CS001,681,653,710,745,64,35,92,71,-2.1498490495590508,-0.490301853714726,1.3247325663635914,1.0989180403441485,828,794,861,936,108,75,142,103,-0.44566014358960937,0.06939073020201719,0.5903092860077946,0.9419197593185712,65451,65038,Adams,Adams,17,1,Illinois,IL
17005,17CS002,151,143,158,165,14,7,22,11,-0.7469921974842196,0.8732096038646683,2.562951224864075,0.7133429414826626,183,174,192,219,36,27,45,28,-0.058331806476396394,0.4818730274099322,0.9952725817516839,0.7581371548035172,16626,16606,Bond+Effingham+Fayette,Bond,17,5,Illinois,IL
17049,17CS002,308,294,323,379,71,56,85,44,1.3918666765560137,3.0630696614332735,4.7489592616588405,0.6143144670236765,375,357,392,430,55,38,73,53,-0.4334938554603638,0.06365216355325162,0.5525488567984687,0.9415131319849716,34521,34457,Bond+Effingham+Fayette,Effingham,17,49,Illinois,IL
17051,17CS002,192,182,201,226,34,25,44,34,-1.582454968390047,0.028354364932415714,1.711339639993632,0.963380327102095,233,222,244,244,11,-0,22,30,-1.3951768139728822,-0.9061857831730311,-0.351241622983365,2.513679195118272,21433,21395,Bond+Effingham+Fayette,Fayette,17,51,Illinois,IL
17007,17CS003,359,336,382,401,42,19,65,57,-2.812371930101793,-1.1700328851679849,0.6949736230106814,1.327571231990051,442,415,470,501,59,31,86,37,-0.11420886968718749,0.41231875737602625,0.9024039192891402,0.6202227303151212,53302,53183,Boone,Boone,17,7,Illinois,IL
17009,17CS004,47,46,48,60,13,12,14,2,6.493261378498748,6.9259833965072,7.31673458403213,0.14402430213824774,59,58,60,67,8,7,9,8,-0.09731154533603327,0.023759246126274225,0.1542209535271669,0.8717290835819724,6297,6391,Brown and Nearby Counties,Brown,17,9,Illinois,IL
17013,17CS004,41,41,42,59,18,17,18,5,11.093579723752116,11.499415936857222,11.88101583976741,0.26588357860740575,50,49,50,68,18,18,19,2,3.6094025393959956,3.732184505173067,3.8618495187765234,0.10342935470152069,4455,4375,Brown and Nearby Counties,Calhoun,17,13,Illinois,IL
17017,17CS004,125,124,127,140,15,13,16,27,-4.240620743780353,-3.827361070761626,-3.4324427768741295,1.7154583892579114,153,152,155,149,-4,-6,-3,16,-1.7170658884926537,-1.597235428845024,-1.4755716681975446,-4.626640535307261,12818,12800,Brown and Nearby Counties,Cass,17,17,Illinois,IL
17149,17CS004,171,164,177,217,46,40,53,39,0.3069990114572183,2.0291512239363465,3.7253954959671347,0.8237757739832935,208,200,215,236,28,21,36,32,-0.7371122081861077,-0.26868044076180975,0.2734686845884814,1.0922732728283309,14769,14620,Brown and Nearby Counties,Pike,17,149,Illinois,IL
17169,17CS004,78,78,79,80,2,1,2,4,-1.699207896486493,-1.2841663003854074,-0.8870364713475027,1.437672675601564,96,95,96,108,12,12,13,3,1.2489575810058273,1.3742011479612903,1.4902234689599405,0.22395084504402413,6865,6848,Brown and Nearby Counties,Schuyler,17,169,Illinois,IL
17171,17CS004,50,50,51,59,9,8,9,4,3.39235109432052,3.7750462533700104,4.1753790978119305,0.4140083543668475,61,60,61,69,8,8,9,6,0.32732148550892837,0.45251147186767376,0.5893339267602988,0.651729723403241,4924,4849,Brown and Nearby Counties,Scott,17,171,Illinois,IL
17011,17CS005,345,330,359,417,72,58,87,57,0.055528287588090704,1.8409672614497925,3.5102932879914195,0.7775301431835263,420,403,437,447,27,10,44,51,-1.2073149081145589,-0.7280485190094784,-0.24484661479909695,1.844775983056555,33021,32917,Bureau+Marshall+Putnam+Stark,Bureau,17,11,Illinois,IL
17123,17CS005,148,143,153,148,0,-5,5,6,-3.682716971851639,-2.0130511786614362,-0.5138647636741077,5.2480751628697275,180,174,186,184,4,-2,10,17,-1.6093021156860217,-1.13237456010954,-0.640282420485083,3.6659541327853225,11655,11667,Bureau+Marshall+Putnam+Stark,Marshall,17,123,Illinois,IL
17155,17CS005,49,48,50,42,-7,-8,-6,6,-9.680901994399179,-9.263517823871425,-8.862885256957483,-0.9889290964096425,59,59,60,71,12,11,12,8,0.5186812069195529,0.6464397541239809,0.7676704956713567,0.6356112558107144,5644,5576,Bureau+Marshall+Putnam+Stark,Putnam,17,155,Illinois,IL
17175,17CS005,63,63,64,77,14,13,14,12,0.8532504253641887,1.252414869521312,1.6671846456385113,0.817999370368265,77,76,77,97,20,20,21,4,2.968988985679627,3.0911430118152774,3.220760684049204,0.18673140698628807,5369,5308,Bureau+Marshall+Putnam+Stark,Stark,17,175,Illinois,IL
17015,17CS006,171,164,178,216,45,38,52,26,3.177238119189252,4.907448149081045,6.629064332793487,0.5647654946204044,210,202,218,214,4,-4,12,13,-1.0883669679489458,-0.5858354117943229,-0.07396042383837652,2.6501200212369067,15474,15693,Carroll+Jo Daviess+Stephenson,Carroll,17,15,Illinois,IL
17085,17CS006,207,198,216,247,40,31,49,23,1.3996620224778082,3.0533308550808282,4.8789128190695905,0.5604454013889985,253,241,264,259,6,-5,18,18,-1.0560318975897218,-0.5261855267949079,-0.024602101618529222,2.475289460186042,21907,21953,Carroll+Jo Daviess+Stephenson,Jo Daviess,17,85,Illinois,IL
17177,17CS006,462,443,481,573,111,92,130,64,2.557657969312041,4.274554205092051,5.914421363776352,0.5721772501817065,560,537,582,653,93,71,116,93,-0.5303774493271671,-0.008504942571964576,0.5513891622985182,0.9843438606764738,44399,44085,Carroll+Jo Daviess+Stephenson,Stephenson,17,177,Illinois,IL
17019,17CS007,1126,1037,1214,1277,151,63,240,66,-0.15494728196173949,1.6877990696723306,3.3342760736885615,0.43348138998859065,1399,1293,1505,1643,244,138,350,128,0.017712572749135704,0.5580118291948255,1.162759221921874,0.5222781383748174,206123,205874,Champaign,Champaign,17,19,Illinois,IL
17021,17CS008,371,357,386,418,47,32,61,61,-3.471563127384915,-1.6743818890851474,0.08780021829925991,1.281750844978704,453,436,471,501,48,30,65,40,-0.31906214288666884,0.2331185812668232,0.7490282441898899,0.8205156086760885,33660,33697,Christian+Shelby,Christian,17,21,Illinois,IL
17173,17CS008,201,192,210,234,33,24,42,30,-1.1137478258009677,0.5878581924181953,2.2980498217701366,0.8784976277294863,244,234,255,321,77,66,87,48,0.8989436529935364,1.3668039632985436,1.8556363621184844,0.6188386086692101,20994,20805,Christian+Shelby,Shelby,17,173,Illinois,IL
17023,17CS009,163,157,170,191,28,21,34,18,0.8326227530357834,2.6131761635373105,4.280177178300498,0.6233055855523342,197,189,205,234,37,29,45,30,-0.0097325825880573,0.4879627792257478,1.009724822447635,0.7825619081316271,15404,15316,Clark+Crawford+Cumberland+Jasper,Clark,17,23,Illinois,IL
17033,17CS009,186,178,194,195,9,1,17,29,-5.944280845088055,-4.2457591738157365,-2.47375486826569,2.841854083964217,225,216,235,240,15,5,24,27,-1.2115083951158783,-0.6910873676783595,-0.16793941520011088,1.738601138953854,18648,18656,Clark+Crawford+Cumberland+Jasper,Crawford,17,33,Illinois,IL
17035,17CS009,94,93,95,103,9,8,10,20,-4.740767203882881,-4.32554972504534,-3.9131827532135985,2.064214718214047,114,113,115,157,43,42,44,19,2.1748077538946164,2.3031127223547396,2.4233274171175694,0.43326453131628223,10464,10357,Clark+Crawford+Cumberland+Jasper,Cumberland,17,35,Illinois,IL
17079,17CS009,82,81,83,87,5,4,6,13,-3.879453500152184,-3.480089541447605,-3.064563619469788,2.190976058113598,99,98,101,124,25,23,26,13,1.140897207426244,1.267222738987136,1.4001555861550137,0.5066308874073803,9295,9201,Clark+Crawford+Cumberland+Jasper,Jasper,17,79,Illinois,IL
17025,17CS010,157,151,163,176,19,13,25,29,-4.608626300395085,-3.032651472474735,-1.2320522535737957,1.447612357603917,190,184,197,182,-8,-15,-2,19,-2.602556057222881,-2.097418485939494,-1.603557445390046,-2.538321804166961,13241,13161,Clay+Hamilton+Wayne+White,Clay,17,25,Illinois,IL
17065,17CS010,86,85,87,107,21,20,22,11,4.567803240553661,4.942976792038901,5.312921547468838,0.50258629017232,105,104,106,103,-2,-3,-1,18,-2.6163058973101223,-2.4986820984534,-2.3657854732855554,-24.090650628845616,7993,7921,Clay+Hamilton+Wayne+White,Hamilton,17,65,Illinois,IL
17191,17CS010,172,165,179,215,43,36,50,32,0.9543717738870223,2.676410034887047,4.372936183824764,0.7330409684741815,209,201,218,242,33,24,41,29,-0.26897412050203096,0.23344029192589763,0.7361327493723341,0.8596613396584508,16115,15986,Clay+Hamilton+Wayne+White,Wayne,17,191,Illinois,IL
17193,17CS010,192,186,198,215,23,17,29,31,-4.120343891629491,-2.4590791118442814,-0.7633075061595977,1.3142804978665794,234,227,242,253,19,11,26,22,-0.7664985066429393,-0.24538061814799136,0.3028610436581088,1.121526285324643,13771,13788,Clay+Hamilton+Wayne+White,White,17,193,Illinois,IL
17027,17CS011,292,276,308,347,55,39,71,41,-0.19643481412541824,1.5099231456340245,3.1436868584777318,0.7333891723121005,355,336,374,364,9,-10,28,35,-1.2448180031316822,-0.7292899341358131,-0.20152394920685415,3.5543085981597655,36965,36808,Clinton+Marion,Clinton,17,27,Illinois,IL
17121,17CS011,439,423,456,567,128,111,144,51,6.507856914981487,8.155604356998694,9.862870783549075,0.3964405281194525,531,512,551,593,62,42,81,67,-0.6619896882896226,-0.14280625950185227,0.38870829275050073,1.0670186003654551,37545,37423,Clinton+Marion,Marion,17,121,Illinois,IL
17029,17CS012,401,381,421,524,123,103,143,50,4.536628763862107,6.216834684149302,7.950974459670435,0.40281480782749934,488,464,512,597,109,85,133,64,0.4883842626718188,0.9613798185166103,1.4512821609527236,0.5802039830720026,47329,46761,Coles,Coles,17,29,Illinois,IL
17031,17CS013,34998,32744,37252,44691,9693,7439,11947,7636,-0.12687884822556483,1.6065026999574783,3.3931215186420074,0.7876936082587671,42715,40037,45392,47065,4350,1673,7028,4196,-0.502494826629046,0.049578957794226275,0.5493253877271764,0.9643075499625289,5236285,5186212,Cook,Cook,17,31,Illinois,IL
17037,17CS014,602,559,646,753,151,107,194,56,2.0714090191062047,3.744268449899659,5.527461018669023,0.3696035194116799,744,692,796,892,148,96,200,69,0.27777514180827706,0.7766048163464817,1.2971875283313898,0.46321552524667614,100966,100388,DeKalb,DeKalb,17,37,Illinois,IL
17039,17CS015,171,164,177,205,34,28,41,21,1.8427893804755493,3.471900422181788,5.266721935264984,0.5934620457419933,208,200,216,230,22,14,30,21,-0.4278112923044272,0.08221973114000383,0.5742596440158665,0.9071496533206378,15457,15356,De Witt+Logan+Mason+Menard,De Witt,17,39,Illinois,IL
17107,17CS015,291,278,303,351,60,48,73,47,0.2537555179121328,1.9396520671346162,3.521055316562389,0.7643896821751821,357,342,371,332,-25,-39,-10,30,-2.4411917378129724,-1.946371453625048,-1.4570793374901625,-1.2698980625529097,28001,27976,De Witt+Logan+Mason+Menard,Logan,17,107,Illinois,IL
17125,17CS015,156,150,161,193,37,32,43,33,-0.34805925569283314,1.4248701867571483,3.105179109574929,0.8587031871713374,188,182,195,222,34,27,40,20,0.5505699272642796,1.050391711970687,1.5611573435084414,0.5770032377185758,13064,12902,De Witt+Logan+Mason+Menard,Mason,17,125,Illinois,IL
17129,17CS015,106,105,108,111,5,3,6,12,-2.849510771658678,-2.4097622592598196,-2.0370045325745503,2.1547622742080197,130,129,132,162,32,30,33,14,1.3377985832180976,1.4553185927248848,1.581757423972446,0.42749671721817395,12245,12179,De Witt+Logan+Mason+Menard,Menard,17,129,Illinois,IL
17041,17CS016,169,161,178,200,31,22,39,29,-1.2964415854065026,0.36968174127399717,2.112522366331165,0.9127922851319721,208,198,218,247,39,29,49,17,0.6077430233006932,1.1227849854566248,1.6644411023772545,0.4218427718706226,19697,19725,Douglas+Edgar+Moultrie+Piatt,Douglas,17,41,Illinois,IL
17045,17CS016,193,186,201,242,49,41,56,36,1.4048545966241084,3.0142155509619233,4.739349884847672,0.7266429096182876,233,225,242,278,45,36,53,42,-0.33981997568165523,0.16783039311879458,0.7225514024606227,0.9150297613448413,16791,16554,Douglas+Edgar+Moultrie+Piatt,Edgar,17,45,Illinois,IL
17139,17CS016,165,159,172,183,18,11,24,20,-2.377828351640429,-0.8372299973974293,0.8976018043690852,1.0801345575144863,202,195,210,216,14,6,21,19,-0.9029410697018322,-0.3547990699698433,0.10297503931667516,1.2807891221563772,14485,14506,Douglas+Edgar+Moultrie+Piatt,Moultrie,17,139,Illinois,IL
17147,17CS016,152,144,159,162,10,3,18,2,0.3054471619315983,2.0211855419287854,3.7568675789193784,0.1739933129927624,187,178,195,210,23,15,32,10,0.28399996948493944,0.7959795404294469,1.3048621090946093,0.41091051647014687,16626,16739,Douglas+Edgar+Moultrie+Piatt,Piatt,17,147,Illinois,IL
17043,17CS017,5387,4987,5787,6490,1103,703,1503,821,-0.5128245160009819,1.2266767548457667,2.9424860472157217,0.7435192392616844,6647,6169,7125,6991,344,-134,822,393,-0.5787311652412194,-0.05393621482443529,0.44695171448239596,1.138501413476688,929276,925799,DuPage,DuPage,17,43,Illinois,IL
17047,17CS018,61,60,61,81,20,20,21,10,6.2792917768394485,6.6842064268043435,7.088883294603657,0.4671281892903012,73,72,73,90,17,17,18,18,-0.21881012397940977,-0.09647626220944598,0.017659403861352733,0.9782715060468364,6221,6094,Edwards+Lawrence+Richland+Wabash,Edwards,17,47,Illinois,IL
17101,17CS018,163,156,170,180,17,10,24,30,-5.095599107157343,-3.446377797231286,-1.6640558209293819,1.663201744335399,196,188,204,197,1,-7,9,20,-1.7848962912151014,-1.2569475674953108,-0.73923143483723,11.135086415414749,15288,15164,Edwards+Lawrence+Richland+Wabash,Lawrence,17,101,Illinois,IL
17159,17CS018,174,167,181,222,48,41,55,29,3.1015617750004,4.753046828755629,6.677814745261283,0.59291605857543,211,203,219,265,54,46,62,41,0.30865246935698765,0.8154598322730956,1.3374500726412613,0.7470305733203444,15761,15797,Edwards+Lawrence+Richland+Wabash,Richland,17,159,Illinois,IL
17185,17CS018,123,118,128,139,16,11,21,15,-1.4489415095341232,0.2825871359858551,2.1299712046906305,0.8937497733086767,148,142,154,161,13,7,19,15,-0.7100386432514291,-0.18221248794923117,0.3200309084907053,1.080116813261199,11312,11219,Edwards+Lawrence+Richland+Wabash,Wabash,17,185,Illinois,IL
17053,17CS019,173,167,178,203,30,25,36,24,0.31589374481849647,1.8784085495793443,3.6036957357800454,0.7648462317872716,211,204,218,237,26,19,33,20,-0.08755879363609986,0.4830802217599676,0.9466004510322806,0.7324593734798257,13449,13514,Ford+Iroquois+Livingston,Ford,17,53,Illinois,IL
17075,17CS019,319,307,331,381,62,50,74,44,0.9520037104602613,2.661685859730853,4.545863108047819,0.6974898590281087,387,373,401,418,31,17,45,43,-0.9815754855941202,-0.4479729670259248,0.06628925873894453,1.3455873199726935,26984,26850,Ford+Iroquois+Livingston,Iroquois,17,75,Illinois,IL
17105,17CS019,375,359,390,420,45,30,61,54,-2.7524800439139985,-0.9801173803405094,0.694990909029031,1.1685942406303336,457,439,476,482,25,6,43,64,-1.6523009249302862,-1.118714853002036,-0.6035220310291578,2.48479537249604,35714,35677,Ford+Iroquois+Livingston,Livingston,17,105,Illinois,IL
17055,17CS020,428,412,444,518,90,74,106,60,1.5505984141141849,3.175656909208636,4.907308523298987,0.6584644445832056,519,500,539,643,124,104,143,88,0.44319390136081166,0.962858425881244,1.4679555934471793,0.7058445339156268,37746,37470,Franklin+Gallatin+Saline,Franklin,17,55,Illinois,IL
17059,17CS020,63,63,64,68,5,4,5,1,2.7328968627798047,3.1683105926452617,3.5680132199376864,0.1694245047118611,77,76,78,91,14,13,15,1,2.5027642830182186,2.6281694611443673,2.760455682325938,0.06708928426336107,4926,4909,Franklin+Gallatin+Saline,Gallatin,17,59,Illinois,IL
17165,17CS020,309,299,320,330,21,10,31,41,-5.170240870992338,-3.430248056886065,-1.7953729308021655,1.9050870497821386,373,361,385,423,50,38,62,53,-0.669083920724684,-0.14477973011839873,0.3517828159266631,1.0478838110188373,23588,23366,Franklin+Gallatin+Saline,Saline,17,165,Illinois,IL
17057,17CS021,390,376,404,450,60,46,74,31,1.8040200449068506,3.451226249780356,5.289446453038422,0.5087918355849944,474,457,491,515,41,24,58,55,-0.9198080963097746,-0.4199795302988335,0.1455502751417284,1.3091508298047496,33531,33232,Fulton+McDonough,Fulton,17,57,Illinois,IL
17109,17CS021,248,236,260,318,70,58,82,31,3.8979733070353735,5.723150020759007,7.439733109294885,0.4360299505639879,301,287,314,323,22,9,36,32,-0.8933701298010323,-0.35699242068624926,0.12053631625033377,1.3622033900231443,27448,26865,Fulton+McDonough,McDonough,17,109,Illinois,IL
17061,17CS022,136,131,141,163,27,22,32,26,-1.4619684378456819,0.2980057406492638,2.0964366822198115,0.9310929161458912,165,159,171,181,16,10,22,19,-0.7866333452862976,-0.2543084585470205,0.24576879343952696,1.1220266472100386,12054,11854,Greene+Jersey+Morgan,Greene,17,61,Illinois,IL
17083,17CS022,233,224,242,271,38,29,47,36,-1.3171410390239915,0.3841553339438316,1.979815111257863,0.9250486648449109,285,274,296,317,32,21,43,29,-0.37981096573828893,0.15970063323374137,0.6456685018526915,0.8782581698774943,21465,21349,Greene+Jersey+Morgan,Jersey,17,83,Illinois,IL
17137,17CS022,339,325,353,414,75,61,89,54,0.9178860547138841,2.5668911965483616,4.229235592838021,0.7103905531218602,414,397,431,437,23,6,40,31,-0.7652293402997505,-0.2625613510645251,0.25838591844685577,1.3016777841486429,32906,32634,Greene+Jersey+Morgan,Morgan,17,137,Illinois,IL
17063,17CS023,369,347,392,466,97,74,119,44,2.3262306080558273,4.039172572344802,5.651344823629287,0.4495861253880081,460,433,487,527,67,40,94,55,-0.33844010551093645,0.2190970118557857,0.7547102945464714,0.8076043165152104,52347,52920,Grundy,Grundy,17,63,Illinois,IL
17067,17CS024,176,169,184,235,59,51,66,32,4.268351260028697,6.051558407662338,7.905326803627269,0.5372601626389731,216,207,225,238,22,13,31,24,-0.6370609167510334,-0.10266663144130743,0.4129296712565023,1.0383031106019123,17558,17422,Hancock+Henderson+Mercer+Warren,Hancock,17,67,Illinois,IL
17071,17CS024,70,69,70,95,25,25,26,15,6.022349863069387,6.444316778029625,6.82531594179977,0.57076778454033394,85,84,86,109,24,23,25,10,2.123570583952635,2.251452837307928,2.3829787047780897,0.396332191466019,6390,6316,Hancock+Henderson+Mercer+Warren,Henderson,17,71,Illinois,IL
17131,17CS024,173,166,180,192,19,12,26,16,-1.0416440431966676,0.7507565413212346,2.500364910414646,0.8071224292994232,213,204,221,206,-7,-15,2,16,-1.9614558121032506,-1.4250482103349502,-0.9300538609647399,-2.8956779090268605,15607,15589,Hancock+Henderson+Mercer+Warren,Mercer,17,131,Illinois,IL
17187,17CS024,163,156,170,218,55,48,62,31,3.92535807702605,5.701523844927333,7.486145273029248,0.5557292046156697,199,191,208,215,16,7,24,28,-1.2457560063872706,-0.7374249180221685,-0.17829393155620724,1.6573256136508003,16757,16567,Hancock+Henderson+Mercer+Warren,Warren,17,187,Illinois,IL
17073,17CS025,454,433,475,583,129,108,150,64,3.7429839040651105,5.308167238832915,7.058478401025609,0.4924541907724881,553,528,578,601,48,23,73,41,-0.38474949891143784,0.12598304999719784,0.6563529889466917,0.840346324166981,49084,48941,Henry,Henry,17,73,Illinois,IL
17077,17CS026,382,359,405,535,153,130,176,68,4.492767957299527,6.333930256697126,7.9555432528670975,0.44058001155975235,466,439,493,611,145,118,172,64,1.033904813996011,1.5318531273244895,2.047061837330572,0.4393551139730831,53437,52613,Jackson,Jackson,17,77,Illinois,IL
17081,17CS027,373,357,388,486,113,98,129,65,3.4989750473966565,5.22938935943642,6.8888421604494186,0.5679133738511868,454,435,473,549,95,76,114,67,0.24922036251506244,0.7644088836922577,1.2836777331939422,0.6990890880825387,37102,36899,Jefferson+Washington,Jefferson,17,81,Illinois,IL
17189,17CS027,138,132,144,149,11,5,17,17,-3.40842424056379,-1.6533797572484796,0.14808219870785855,1.3718893992520818,168,161,175,167,-1,-8,6,21,-2.1164021418921704,-1.5874503281251238,-1.1099642853272966,93.33568499506391,13737,13663,Jefferson+Washington,Washington,17,189,Illinois,IL
17089,17CS028,2735,2512,2957,3584,849,627,1072,513,0.852005380316073,2.6426348160855215,4.332493420961403,0.6033518020097696,3387,3121,3653,3905,518,252,784,326,-0.17254428885654075,0.3627165908600767,0.861708767231997,0.6281099623576736,518449,515671,Kane,Kane,17,89,Illinois,IL
17091,17CS029,955,909,1001,1149,194,148,240,124,0.9167277861056381,2.57521915930853,4.402411258759046,0.635375678271756,1163,1108,1218,1378,215,160,270,132,0.26629199241590273,0.7748466211533159,1.2844713760316366,0.6122618871599252,107510,106694,Kankakee,Kankakee,17,91,Illinois,IL
17093,17CS030,532,476,589,630,98,41,154,74,-1.184889961141519,0.7169395188168457,2.3543988923912864,0.750913612915564,679,609,748,781,102,33,172,61,-0.1743540075516458,0.3037455589343961,0.8157199932198222,0.5895422161457585,132065,134491,Kendall,Kendall,17,93,Illinois,IL
17095,17CS031,570,549,591,694,124,103,145,106,-0.3461363769310866,1.4587434884075408,3.1773458104312695,0.8482758066889597,691,666,717,729,38,12,63,73,-1.2161676165497504,-0.7055127943684716,-0.1925996471816679,1.8786709316982544,49677,49336,Knox,Knox,17,95,Illinois,IL
17097,17CS032,4052,3746,4358,4865,813,507,1119,699,-1.0463073713557287,0.623064417724456,2.3287294189813035,0.8585686906733653,5026,4659,5394,5213,187,-181,554,373,-0.7707107688862148,-0.27631591527109217,0.2454730801106786,1.9871297363659515,710666,711527,Lake,Lake,17,97,Illinois,IL
17099,17CS033,1121,1074,1168,1295,174,127,221,180,-1.9155669303376364,-0.19918416908938272,1.5688907827168614,1.02938087617977,1368,1311,1424,1434,66,10,123,129,-1.076625576946162,-0.5792276990530937,-0.06755815838999372,1.9161948937713207,109195,109022,La Salle,La Salle,17,99,Illinois,IL
17103,17CS034,323,308,337,387,64,50,79,64,-1.7146100685761132,0.04914368148339379,1.7963658239817129,0.977134125274759,397,379,414,420,23,6,41,39,-0.9800588497232751,-0.45789448324361126,0.04456103422903726,1.593276393238586,34030,34045,Lee+Whiteside,Lee,17,103,Illinois,IL
17195,17CS034,573,549,597,706,133,109,157,148,-2.7399136960813077,-1.196929947333468,0.6312797435496544,1.105357231941252,701,673,730,757,56,27,84,79,-0.92622823269326,-0.42869429747713167,0.06780815271217426,1.395140039938531,55445,55335,Lee+Whiteside,Whiteside,17,195,Illinois,IL
17111,17CS035,1837,1704,1970,2165,328,195,461,234,-0.43558956150959954,1.163931858107886,2.8968367525639698,0.7114432791634472,2284,2123,2444,2536,252,92,413,183,-0.2720286809528883,0.23108888252516258,0.7597566522404581,0.7223758264711522,309571,310925,McHenry,McHenry,17,111,Illinois,IL
17113,17CS036,1025,952,1099,1220,195,121,268,110,0.18752215328473248,1.9517621219004144,3.782265453924943,0.5614282994404427,1270,1181,1358,1411,141,53,230,145,-0.5530939949309345,-0.03181500228070059,0.4734070534136425,1.0189760787229296,170931,170886,McLean,McLean,17,113,Illinois,IL
17115,17CS037,1044,1000,1089,1242,198,153,242,142,0.5401814149445975,2.0949554944549,3.809955950284816,0.7147323064860455,1268,1215,1321,1433,165,112,218,136,-0.23267181361439898,0.30389803725891323,0.785536372636898,0.8188980919290355,103574,102609,Macon,Macon,17,115,Illinois,IL
17117,17CS038,470,451,489,568,98,79,117,66,1.094646426708919,2.7613279416969116,4.599133709338065,0.6675356641173016,570,547,593,646,76,53,99,70,-0.4267308185585406,0.14977016376567764,0.6460887558112235,0.9130731815620567,44807,44465,Macoupin+Montgomery,Macoupin,17,117,Illinois,IL
17135,17CS038,300,288,312,360,60,48,72,29,2.5290012405217785,4.420900319415798,6.022156623482681,0.4769055908766202,366,351,380,459,93,79,108,69,0.3326491638807459,0.8875274103539347,1.3723425799349278,0.7317001500774135,28185,28095,Macoupin+Montgomery,Montgomery,17,135,Illinois,IL
17119,17CS039,2468,2354,2582,2909,441,327,555,294,0.5713520013595258,2.2460432484371524,3.8825361693021563,0.6656726992912834,3022,2885,3159,3374,352,215,489,319,-0.42539944832466264,0.1036780111839849,0.663569376582534,0.9036435408277032,265118,264637,Madison,Madison,17,119,Illinois,IL
17133,17CS040,264,249,279,302,38,23,53,45,-2.589257703501194,-0.8223102320961745,0.9110617939854174,1.1510093604696339,326,308,344,358,32,14,50,35,-0.5899586261975253,-0.09334956909073765,0.38892199471760414,1.0650764224220381,34878,34927,Monroe+St. Clair,Monroe,17,133,Illinois,IL
17163,17CS040,2176,2065,2286,2685,509,399,620,324,1.1838510824272954,2.880188209280111,4.605414868328995,0.6347415804933172,2660,2528,2792,3066,406,274,538,295,-0.12443457501077408,0.4298201258026485,0.9496027328990053,0.7246274712852027,257033,255087,Monroe+St. Clair,St. Clair,17,163,Illinois,IL
17141,17CS041,449,427,471,518,69,47,91,52,-0.3166167681151207,1.3970655104149672,3.087227241176196,0.7409791985794877,550,524,577,592,42,15,68,49,-0.691482846543853,-0.13178241294403067,0.33994803713264043,1.1482039409692164,51506,51482,Ogle,Ogle,17,141,Illinois,IL
17143,17CS042,1539,1461,1617,1770,231,153,309,146,0.2115342700304042,1.881864683149844,3.546777909746472,0.628710652025025,1872,1779,1964,2148,276,184,369,211,-0.12045437318363841,0.3902140226523667,0.8378363999857393,0.7607028965451113,180766,179693,Peoria+Woodford,Peoria,17,143,Illinois,IL
17203,17CS042,326,310,343,383,57,40,73,46,-0.5158077112814422,1.155501189315106,2.7162622984377833,0.7982057966061313,398,378,418,421,23,3,43,58,-1.4296873521164357,-0.9164542770310534,-0.42946243427550995,2.440271197535985,38371,38250,Peoria+Woodford,Woodford,17,203,Illinois,IL
17145,17CS043,197,188,206,232,35,26,44,29,-0.7041862379508717,1.100488079370067,2.9229020488108315,0.8147284414549835,242,231,253,301,59,48,70,40,0.426971920480769,0.9054067005446393,1.4370232640963252,0.6639736982927713,20899,20970,Perry+Randolph,Perry,17,145,Illinois,IL
17157,17CS043,295,282,308,362,67,54,80,51,0.4226033615059849,2.0548497638071286,3.8086750567603804,0.7526282571255563,359,344,375,444,85,69,100,50,0.6459056105352056,1.1463123077472406,1.7267254900310158,0.5826927945239523,30308,30129,Perry+Randolph,Randolph,17,157,Illinois,IL
17161,17CS044,1363,1301,1425,1652,289,227,351,192,0.9661521923297709,2.7740488845762927,4.4901790042423855,0.6624882749274007,1661,1587,1735,1776,115,41,189,160,-0.8153019477823871,-0.29784517588241305,0.1867384774336183,1.3825848753545489,143762,143107,Rock Island,Rock Island,17,161,Illinois,IL
17167,17CS045,1682,1598,1766,1899,217,133,301,190,-1.1658472811096843,0.5396262253603817,2.3445909525036934,0.8703204227488873,2055,1954,2155,2118,63,-37,164,141,-0.9233856360398388,-0.4181612596285857,0.10039906901378766,2.194924163419706,195714,194920,Sangamon,Sangamon,17,167,Illinois,IL
17003,17CS046,69,69,70,99,30,29,30,11,13.924597983618993,14.294495809243362,14.694345368227713,0.3577676278099609,82,81,82,103,21,21,22,12,1.6925265635423838,1.8167902136631302,1.9467406209642755,0.5414201411479098,5244,5050,Southern Illinois,Alexander,17,3,Illinois,IL
17069,17CS046,51,51,52,62,11,10,11,10,0.35425637597669735,0.6989314207635028,1.1070479207920674,0.8588469728028202,63,62,63,83,20,20,21,11,2.4336482286673795,2.558225947781102,2.6866593768120093,0.5154851993315097,3667,3648,Southern Illinois,Hardin,17,69,Illinois,IL
17087,17CS046,122,120,123,140,18,17,20,16,0.31011297746942496,0.7141689884896756,1.10801502573891,0.8270198501687166,153,151,154,175,22,21,24,32,-0.8425136455885334,-0.7248539425730189,-0.6009016737798215,1.374742687322298,13188,13440,Southern Illinois,Johnson,17,87,Illinois,IL
17127,17CS046,181,175,187,200,19,13,25,23,-2.840087863730278,-1.1859064088782514,0.6115048594723999,1.1626607586750686,221,213,228,239,18,11,26,29,-1.240014198676822,-0.7447441010424221,-0.29279584233300066,1.4960183345964704,14056,13984,Southern Illinois,Massac,17,127,Illinois,IL
17151,17CS046,40,40,41,42,2,1,2,6,-4.877944264247824,-4.504889831279174,-4.097729142122261,2.2114417800528843,49,49,50,71,22,21,22,12,2.502672398256921,2.6329951531993663,2.7608442350120534,0.5233166891030421,3811,3774,Southern Illinois,Pope,17,151,Illinois,IL
17153,17CS046,66,66,67,68,2,1,2,7,-4.534064042902589,-4.11559059796434,-3.7351557931020385,2.6191335546407384,80,79,81,107,27,26,28,16,2.0532268841113557,2.1748641011056407,2.3017669466184008,0.5702630612696244,5173,5079,Southern Illinois,Pulaski,17,153,Illinois,IL
17181,17CS046,200,193,207,231,31,24,38,22,0.2801074913025196,2.1245287881468893,3.790054881215107,0.6901014831093509,244,235,252,278,34,26,43,32,-0.36932456364930477,0.1237463219339592,0.6550624951076477,0.9046611366074692,17081,16960,Southern Illinois,Union,17,181,Illinois,IL
17179,17CS047,1182,1126,1239,1421,239,182,295,112,2.1485058774608103,3.8750344549889326,5.4984557177577225,0.4672523075083578,1441,1374,1509,1718,277,209,344,165,0.34846757809681955,0.848506276608902,1.376576699935939,0.5940141907494083,131076,130501,Tazewell,Tazewell,17,179,Illinois,IL
17183,17CS048,798,766,829,928,130,99,162,84,0.7414428858933565,2.4971216940120606,4.174879590038982,0.639563544077212,965,927,1003,1186,221,183,259,157,0.3898030984931299,0.8778445337530355,1.3733525751985554,0.7073673332048347,74071,73210,Vermilion,Vermilion,17,183,Illinois,IL
17197,17CS049,4024,3725,4323,4966,942,643,1241,644,-0.0514934966043184,1.6736619906570316,3.4900030828527124,0.6830864220468397,5005,4645,5364,5524,519,160,879,461,-0.39116491827169364,0.07702902854424129,0.5846741525964787,0.8857283056754328,695208,697055,Will,Will,17,197,Illinois,IL
17199,17CS050,638,609,667,744,106,77,135,76,0.07593738468222548,1.8429963114686334,3.5337950557074476,0.7082970650919019,778,743,813,889,111,76,146,97,-0.29277746410038313,0.21732785518611913,0.6898759032501243,0.8664186625255031,67004,66910,Williamson,Williamson,17,199,Illinois,IL
17201,17CS051,2538,2416,2661,2933,395,272,517,323,-0.6720430049190267,0.957212953059734,2.661558191190206,0.8164407682239068,3101,2954,3247,3540,439,293,586,303,-0.038892703428982586,0.4709369430615618,1.0281392069070223,0.6881409760488578,284328,283373,Winnebago,Winnebago,17,201,Illinois,IL
18001,18CS001,271,256,287,336,65,49,80,43,0.7930934898489297,2.3611682625233144,4.099276824046405,0.6541031428257071,334,316,353,382,48,29,66,55,-0.6961256313720053,-0.22742507747247262,0.31706995242560615,1.1323773382099134,35820,35941,Adams+Wells,Adams,18,1,Indiana,IN
18179,18CS001,261,249,273,315,54,42,66,46,-0.49056687584976383,1.165913582798387,2.9138247738854717,0.8323975294414107,319,305,334,363,44,29,58,54,-0.8624407684239493,-0.35767632059168525,0.144827100391102,1.2078746917258656,28174,28194,Adams+Wells,Wells,18,179,Indiana,IN
18003,18CS002,2958,2792,3124,3470,512,346,678,428,-0.9180429503106659,0.8606090204052939,2.5678752633331383,0.8344165880839571,3664,3464,3864,3911,247,47,447,387,-0.8675426556372638,-0.34722545350118783,0.14650621169910527,1.5602861042163325,385171,388212,Allen,Allen,18,3,Indiana,IN
18005,18CS003,631,596,667,726,95,59,130,101,-1.964560694951185,-0.26815904390433754,1.4945634212573748,1.0548772552908803,773,731,816,892,119,76,161,87,-0.12365160741177657,0.3738292613486081,0.9017063541431267,0.7270661339805039,82468,82429,Bartholomew+Brown,Bartholomew,18,5,Indiana,IN
18013,18CS003,147,140,154,172,25,18,32,18,0.11143626543484204,1.790139892599227,3.384306179020521,0.6908426225057661,180,172,188,204,24,16,32,23,-0.4794783338449941,0.042543912405720065,0.5754689969047083,0.9302366627916412,15420,15540,Bartholomew+Brown,Brown,18,13,Indiana,IN
18007,18CS004,74,73,75,95,21,20,22,11,4.279164716864463,4.688318962478482,5.0828084842817685,0.49497431824887106,91,90,92,106,15,14,16,11,0.37954019663576233,0.49824252911933004,0.6276207499272556,0.6732215029700052,8720,8714,Benton+Jasper+Newton,Benton,18,7,Indiana,IN
18073,18CS004,277,262,291,350,73,59,88,34,2.9774903224872995,4.816527031469633,6.408847727333302,0.4571485494336027,341,324,358,425,84,67,101,75,-0.2662296291399462,0.2632502570718443,0.7489038068866876,0.8819038798663518,33014,33064,Benton+Jasper+Newton,Jasper,18,73,Indiana,IN
18111,18CS004,147,141,153,163,16,10,22,23,-3.6251939821410177,-1.8634865297454202,-0.11198315529743924,1.3202294769708232,179,172,186,223,44,37,51,31,0.41345189209224187,0.9090494987919033,1.4632491506017715,0.6924920433307611,13823,13806,Benton+Jasper+Newton,Newton,18,111,Indiana,IN
18009,18CS005,147,142,152,173,26,21,31,22,-0.28050942802082524,1.3834513441863097,3.0107977923981797,0.8081780415442706,180,174,186,204,24,18,30,35,-1.4109630086226752,-0.912472440700429,-0.3802260708007755,1.400156082516897,12052,12092,Blackford+Jay+Randolph,Blackford,18,9,Indiana,IN
18075,18CS005,199,190,208,226,27,18,36,34,-3.03979700171492,-1.3683720055693156,0.21062871055020488,1.2077630441271348,243,232,253,297,54,44,65,38,0.24513216188708414,0.8040027351980862,1.3774063687221498,0.688928578061735,20433,20278,Blackford+Jay+Randolph,Jay,18,75,Indiana,IN
18135,18CS005,261,251,272,327,66,55,76,56,-0.046128542706215955,1.601622865999556,3.2549926697926077,0.839754024426892,321,308,333,415,94,82,107,54,1.118432169544935,1.6524182877954379,2.1766162080572755,0.5665662372581646,24399,24385,Blackford+Jay+Randolph,Randolph,18,135,Indiana,IN
18011,18CS006,490,460,521,511,21,-10,51,76,-4.768967926984442,-3.145298988798134,-1.451097732062501,3.474610897339544,616,579,654,640,24,-14,61,54,-0.9300467140670015,-0.42173826266245124,0.1300732316441365,2.1818705666833305,70891,72777,Boone,Boone,18,11,Indiana,IN
18015,18CS007,162,154,171,165,3,-6,11,18,-4.779589044010324,-3.011621136944927,-1.255790495678716,4.802085394953943,199,188,209,235,36,26,47,34,-0.4040309627477695,0.11851279979394148,0.6081075494602083,0.9086360235306086,20307,20424,Carroll+Clinton,Carroll,18,15,Indiana,IN
18023,18CS007,318,303,332,387,69,55,84,35,2.428534812329971,4.130747012697684,5.901846478593408,0.4971279796797745,386,369,403,433,47,30,64,49,-0.5708248753362667,-0.05634056620782874,0.4850532691521683,1.0179443836850066,33018,33078,Carroll+Clinton,Clinton,18,23,Indiana,IN
18017,18CS008,358,342,374,450,92,76,108,75,0.09903687882523433,1.8571205031049816,3.4015113239418517,0.8049925832058206,437,417,456,495,58,39,78,63,-0.6599083854816725,-0.13112854815181874,0.39762762259818973,1.0633522443813985,37726,37593,Cass+White,Cass,18,17,Indiana,IN
18181,18CS008,257,246,267,279,22,12,33,31,-3.002609645261697,-1.4040952564798128,0.17214062760119275,1.3192503094534367,314,302,327,515,201,188,213,52,5.532790563919766,6.011855369031379,6.553124197745007,0.2577382474296151,24574,24649,Cass+White,White,18,181,Indiana,IN
18019,18CS009,1117,1065,1169,1253,136,84,188,129,-1.4230395740965078,0.2219991658509758,1.9439565060856319,0.9435559865413804,1384,1320,1447,1536,152,89,216,181,-0.7301315533951096,-0.23429595269492978,0.27017699323126265,1.1798667086301924,120983,122526,Clark+Scott,Clark,18,19,Indiana,IN
18143,18CS009,280,270,291,333,53,42,63,38,0.8383031005968591,2.431534031555091,4.066911079725817,0.7085441612166069,343,330,355,437,94,82,107,55,1.0783944709108393,1.614452046977378,2.1549857475646634,0.5779018417160888,24268,24352,Clark+Scott,Scott,18,143,Indiana,IN
18021,18CS010,257,246,269,317,60,48,71,32,2.557082072987049,4.155397608372944,5.8779887366132515,0.5282472811903033,312,299,326,350,38,24,51,36,-0.49105744164682785,0.07116657683346914,0.6262376561666457,0.9282538093184548,26411,26413,Clay+Sullivan+Vermillion+Vigo,Clay,18,21,Indiana,IN
18153,18CS010,196,187,205,225,29,20,38,28,-1.2969371433539816,0.18438701029087035,1.9121290385403042,0.9231430337193056,237,227,248,274,37,26,47,30,-0.2328018790281248,0.3215048466748459,0.8535805817807746,0.7952645530603009,20769,20765,Clay+Sullivan+Vermillion+Vigo,Sullivan,18,153,Indiana,IN
18165,18CS010,174,167,181,195,21,14,28,26,-3.079317258859923,-1.290107660655589,0.314509168508156,1.187287586049001,210,202,218,233,23,15,31,27,-0.787114066696395,-0.2939021514641704,0.1967628801213264,1.1390107274927863,15398,15348,Clay+Sullivan+Vermillion+Vigo,Vermillion,18,165,Indiana,IN
18167,18CS010,953,908,999,1144,191,145,236,138,0.2578106135765233,2.0415512065254298,3.72699452959652,0.7199346968513273,1157,1102,1211,1348,191,137,246,128,0.11179062084574586,0.5975565577277392,1.1253323075007948,0.6649622830233186,106144,105996,Clay+Sullivan+Vermillion+Vigo,Vigo,18,167,Indiana,IN
18025,18CS011,105,104,106,124,19,18,20,11,2.5592141808398234,2.964611801948968,3.3910332723475554,0.5550935622038776,129,128,130,166,37,36,38,26,0.9291701377431518,1.0526893435365143,1.1761881398558476,0.6830470636612042,10545,10518,Crawford+Harrison+Perry,Crawford,18,25,Indiana,IN
18061,18CS011,352,335,369,403,51,34,68,41,-0.9344653248581609,1.0845243709405217,2.6718070859911793,0.7882551643614898,433,413,454,542,109,88,129,72,0.3908867667170291,0.9254761744087716,1.4388384239810774,0.6550164356539736,39795,39745,Crawford+Harrison+Perry,Harrison,18,61,Indiana,IN
18123,18CS011,191,182,199,210,19,11,28,25,-2.761471244224428,-1.1045241870667337,0.5748971887746007,1.222059824181236,235,225,245,244,9,-1,19,32,-1.7238173056826476,-1.1914681775178262,-0.6527858508697201,3.2746802776168558,19172,19292,Crawford+Harrison+Perry,Perry,18,123,Indiana,IN
18027,18CS012,292,278,306,336,44,30,58,70,-4.862498888377456,-3.131236708784408,-1.332463235229793,1.5528874582523995,359,342,376,343,-16,-33,1,38,-2.1016902536299926,-1.6250700531063924,-1.1014208410971034,-2.5251864973483213,33399,33396,Daviess+Knox+Martin,Daviess,18,27,Indiana,IN
18083,18CS012,373,358,389,477,104,88,119,68,2.1255747899066977,3.995725923651704,5.580980371403821,0.6504289194263533,455,436,473,503,48,30,67,43,-0.33723351783248823,0.14139815235311856,0.6563541094732652,0.870717595026627,36266,35998,Daviess+Knox+Martin,Knox,18,83,Indiana,IN
18101,18CS012,90,89,91,95,5,4,6,10,-2.5162882345121984,-2.0962670301920863,-1.7073018187330258,1.7075637827291004,110,109,111,128,18,17,19,5,1.1935727296252296,1.3163903689751328,1.438399216899572,0.2648357121843042,9843,9781,Daviess+Knox+Martin,Martin,18,101,Indiana,IN
18029,18CS013,436,414,457,474,38,17,60,58,-3.2036808708137916,-1.5571742853817678,0.20996212996366193,1.4687422176328215,536,510,562,616,80,54,106,84,-0.6218569315938625,-0.06600789446835559,0.46361446810609513,1.0359731493489635,50567,50803,Dearborn+Ohio+Ripley+Switzerland,Dearborn,18,29,Indiana,IN
18115,18CS013,57,56,58,66,9,8,10,16,-5.0895871879533665,-4.668668099663676,-4.274908875827,1.585982862173749,70,70,71,89,19,18,19,2,2.6666086047506288,2.8021979115253495,2.9233817920846303,0.10141107723439273,5932,5971,Dearborn+Ohio+Ripley+Switzerland,Ohio,18,115,Indiana,IN
18137,18CS013,265,252,277,332,67,55,80,43,1.6590205491773198,3.374196209930348,5.093223402130024,0.6305792804429978,326,311,341,420,94,79,109,74,0.19232029446331608,0.7022117887389332,1.220731425040984,0.7764883413323422,28915,29066,Dearborn+Ohio+Ripley+Switzerland,Ripley,18,137,Indiana,IN
18155,18CS013,85,84,86,90,5,4,6,6,-0.8829691108073038,-0.45569683996678007,-0.03442291507793974,1.0260692008872776,103,102,105,116,13,11,14,12,-0.07360104979882491,0.059838632155174785,0.18904647958471527,0.8826301613091376,9890,9780,Dearborn+Ohio+Ripley+Switzerland,Switzerland,18,155,Indiana,IN
18031,18CS014,247,235,258,332,85,74,97,61,1.9352440676406868,3.6584497190818053,5.3806434348679035,0.7059039805164401,302,288,315,331,29,16,43,38,-0.8184780366382995,-0.32024980545137366,0.1445896935969419,1.2521592984567576,26460,26343,Decatur+Shelby,Decatur,18,31,Indiana,IN
18145,18CS014,408,389,427,492,84,65,103,62,0.19236359823456453,1.941541603349767,3.738736292401803,0.7285873388089661,502,479,525,541,39,16,62,69,-1.1930557729858537,-0.6562784165916619,-0.14454342229461745,1.7167894383200055,44990,45037,Decatur+Shelby,Shelby,18,145,Indiana,IN
18033,18CS015,364,346,383,458,94,75,112,63,1.2434483777290322,2.8167369258076373,4.484628796377838,0.664249212337095,446,424,469,489,43,20,65,55,-0.7694726235120865,-0.3017810797162777,0.2432671364369829,1.26199509623092,43322,43324,DeKalb+Steuben,DeKalb,18,33,Indiana,IN
18151,18CS015,277,262,292,306,29,14,44,32,-1.9913620751536654,-0.2994273698090019,1.2928199900668227,1.0624916329218819,341,323,359,395,54,36,72,60,-0.6534461911664822,-0.14034452052190996,0.3697529254273629,1.0852717890272179,34507,34604,DeKalb+Steuben,Steuben,18,151,Indiana,IN
18035,18CS016,1100,1052,1148,1343,243,195,291,120,2.7211502568877015,4.367972531521925,6.000622655808974,0.49227381942639176,1351,1293,1409,1554,203,145,261,183,-0.322751145909703,0.17155035747928354,0.6646099129206823,0.8977847236115248,111996,111842,Delaware,Delaware,18,35,Indiana,IN
18037,18CS017,358,339,377,412,54,35,73,55,-1.8682370462707596,-0.10748385626096264,1.7653091181462144,0.9972955675944037,438,416,461,534,96,73,118,62,0.2824137416227721,0.7688285088055689,1.300227331522987,0.6416888551948466,43449,43557,Dubois+Pike+Spencer,Dubois,18,37,Indiana,IN
18125,18CS017,139,134,144,154,15,10,20,25,-4.771565047546275,-3.296334390970584,-1.5761687067798849,1.5577937316888628,168,162,174,189,21,15,27,16,-0.13002175857755294,0.4114485294491484,0.8878483075770527,0.729241447311901,12246,12157,Dubois+Pike+Spencer,Pike,18,125,Indiana,IN
18147,18CS017,170,161,178,195,25,17,34,12,0.9677950446178664,2.6537730904940195,4.322298841311115,0.45455395875962123,207,197,217,280,73,63,83,43,0.981588020467628,1.5175295369316153,2.0543537108743886,0.5796471363118821,19884,19801,Dubois+Pike+Spencer,Spencer,18,147,Indiana,IN
18039,18CS018,1489,1400,1578,1781,292,203,381,331,-2.606448748983265,-0.7529371970733262,0.9485558570023621,1.1290018814310463,1833,1726,1939,2089,256,150,363,219,-0.3331639320127306,0.17753079420079126,0.7162475881770726,0.8508506889129437,206767,206909,Elkhart,Elkhart,18,39,Indiana,IN
18041,18CS019,282,272,292,344,62,52,72,44,1.454129979030579,3.1280123227707626,4.921280386887941,0.6970534432324332,345,333,357,390,45,33,57,61,-1.1844564141019747,-0.677139454333126,-0.179440328476104,1.3210304470375183,23293,23356,Fayette+Franklin+Union,Fayette,18,41,Indiana,IN
18047,18CS019,187,177,197,249,62,52,72,30,3.988515410434814,5.641025735799978,7.366200744743201,0.47585119883720084,231,219,242,262,31,20,43,36,-0.7291304375634944,-0.2050806310244307,0.29852336554318754,1.1136108495760835,22774,22831,Fayette+Franklin+Union,Franklin,18,47,Indiana,IN
18161,18CS019,64,63,65,94,30,29,31,1,15.902632096646396,16.28903236877986,16.677553766658434,0.03238904807526467,78,78,79,89,11,10,11,19,-1.3128400283083705,-1.1886187936311419,-1.0594179118260147,1.6371880226556248,7092,7053,Fayette+Franklin+Union,Union,18,161,Indiana,IN
18043,18CS020,722,687,756,830,108,74,143,87,-0.621600016806599,1.1027543840168468,2.754312230909188,0.7973121117820041,889,848,931,955,66,24,107,95,-0.8900370690277314,-0.3761706664958066,0.14693008165181454,1.4282698060820918,80171,80452,Floyd,Floyd,18,43,Indiana,IN
18045,18CS021,189,182,196,227,38,31,45,26,1.1416515324739447,2.966023989944709,4.6518888712924,0.6639734359218376,231,222,239,258,27,19,36,34,-0.9586571851624627,-0.398189957412989,0.07737064018749466,1.2074436959010453,16459,16433,Fountain+Montgomery+Warren,Fountain,18,45,Indiana,IN
18107,18CS021,354,337,370,405,51,35,68,63,-2.9602899833295924,-1.17920301341511,0.542938214281375,1.2002072074532069,436,416,455,487,51,32,71,63,-0.8149215320822142,-0.3251502146427562,0.21661612722190685,1.2023392004056455,37996,38044,Fountain+Montgomery+Warren,Montgomery,18,107,Indiana,IN
18171,18CS021,73,72,74,105,32,31,33,8,11.070195418679411,11.463470198825442,11.88381356230026,0.2418108343325972,90,89,91,98,8,7,9,11,-0.5306684728439082,-0.39758718073688504,-0.2664507545845497,1.275406611877718,8397,8466,Fountain+Montgomery+Warren,Warren,18,171,Indiana,IN
18049,18CS022,212,204,221,237,25,16,33,31,-2.9073202042183706,-1.2425708274274028,0.5263989340621401,1.20779000821389,260,249,271,293,33,22,44,41,-0.8964268938477468,-0.4025594483119607,0.10536066161723519,1.2064737045297134,20372,20393,Fulton+Miami+Wabash,Fulton,18,49,Indiana,IN
18103,18CS022,334,318,349,387,53,38,69,37,0.03189635353292775,1.8292396152361037,3.4520831497377182,0.6843944611638026,412,393,430,519,107,89,126,77,0.31350202897147106,0.8343349709850978,1.370007456478906,0.7106961154003126,35877,36058,Fulton+Miami+Wabash,Miami,18,103,Indiana,IN
18169,18CS022,379,366,392,434,55,42,68,54,-1.5869549916461914,0.15248731822614406,1.8950962166611092,0.9610209295018913,462,446,477,530,68,53,84,62,-0.3345126406045387,0.21765525711602646,0.7311959522337043,0.8926047795026834,30901,30826,Fulton+Miami+Wabash,Wabash,18,169,Indiana,IN
18051,18CS023,306,292,321,382,76,61,90,71,-1.2024132316083147,0.5685568911699788,2.228220435505198,0.9279371957992428,374,357,391,400,26,9,43,48,-1.1732863029504674,-0.6487211662034882,-0.1595435924144479,1.7557417450404273,33111,32938,Gibson+Posey,Gibson,18,51,Indiana,IN
18129,18CS023,209,199,220,233,24,13,34,23,-1.6840641684448496,0.12406191823452159,1.8498913162432697,0.9332094035605947,256,243,269,255,-1,-14,12,20,-1.4061565044602897,-0.8459992065887156,-0.36066377561530216,-75.49207838508937,25192,25123,Gibson+Posey,Posey,18,129,Indiana,IN
18053,18CS024,725,696,753,892,167,139,196,120,1.2503507786332297,2.8079483873030453,4.630426000371535,0.7130806780712655,886,851,920,1121,235,201,270,144,0.8542710975965255,1.3627946876299764,1.9283340908079694,0.6093037619309001,66338,66290,Grant,Grant,18,53,Indiana,IN
18055,18CS025,323,309,336,367,44,31,58,55,-3.1418230897258432,-1.4319375576897557,0.3628561147457185,1.2120868908453355,394,378,410,447,53,37,69,40,-0.056728194039427846,0.4270586185701856,0.9660262611521772,0.7399028046723521,30983,30787,Greene+Owen+Parke+Putnam,Greene,18,55,Indiana,IN
18119,18CS025,207,205,209,259,52,50,54,23,5.090584484427833,5.465805365921059,5.84660617761403,0.4340213123383622,256,254,259,74,-182,-185,-180,21,-9.61252001989807,-9.487376210603735,-9.35949411086091,-0.1158333199445783,21253,21424,Greene+Owen+Parke+Putnam,Owen,18,119,Indiana,IN
18121,18CS025,142,135,149,150,8,1,15,13,-2.8439378641242747,-1.1474055863967279,0.4478343413511198,1.4468422739639393,176,168,185,194,18,9,26,31,-1.3091611034410036,-0.7865268114329846,-0.28266028177917213,1.6358122903215646,16288,16370,Greene+Owen+Parke+Putnam,Parke,18,121,Indiana,IN
18133,18CS025,310,295,326,363,53,37,68,38,-0.08580881287870706,1.6472806092762156,3.274777061628006,0.7084895693212787,384,365,403,441,57,38,76,51,-0.37247235710145626,0.17991870589212558,0.6949278595434997,0.8767061604683,36830,36933,Greene+Owen+Parke+Putnam,Putnam,18,133,Indiana,IN
18057,18CS026,1638,1488,1788,1971,333,183,483,274,-1.0570384309585064,0.656408573537032,2.3067917243809752,0.8213561698657075,2086,1902,2270,2310,224,40,408,168,-0.368248081517388,0.16515845502225593,0.6758105766545531,0.746801219936576,348087,355515,Hamilton,Hamilton,18,57,Indiana,IN
18059,18CS027,603,569,638,659,56,21,90,81,-2.924535428805452,-1.2131698128544304,0.6016199585013343,1.4255077100544133,752,710,794,917,165,123,207,104,0.25169948385954677,0.7349603898661784,1.2640780718623619,0.627791297706354,80035,81551,Hancock,Hancock,18,59,Indiana,IN
18063,18CS028,1104,1029,1180,1288,184,108,259,189,-1.8502498619857672,-0.13565519353854769,1.6082584132038376,1.0234135582716368,1391,1299,1483,1457,66,-26,158,157,-1.0259044929307741,-0.5124373410898858,0.04203355905126826,2.347489077983803,175109,178797,Hendricks,Hendricks,18,63,Indiana,IN
18065,18CS029,514,493,535,622,108,87,129,63,1.9835364009464467,3.7383334081143667,5.402424101288068,0.5769774722508351,628,603,653,734,106,81,131,109,-0.5659009339091211,-0.08461901136488673,0.4161688039361104,1.019462060751958,48765,48928,Henry+Rush,Henry,18,65,Indiana,IN
18139,18CS029,170,162,177,183,13,6,21,17,-2.5960184044251524,-0.8688559837926749,0.826237901421515,1.1763110237186944,206,198,215,220,14,5,22,21,-0.9422768080160796,-0.4521096449866285,0.058804274560835326,1.4406128766609798,16716,16682,Henry+Rush,Rush,18,139,Indiana,IN
18067,18CS030,922,886,958,1064,142,106,178,137,-1.517615793340199,0.23150666658014274,1.9114680405186033,0.9562213351212643,1129,1085,1172,1332,203,160,247,184,-0.26114345377138765,0.21293026211826174,0.798966812526364,0.8999907778560743,83486,83677,Howard+Tipton,Howard,18,67,Indiana,IN
18159,18CS030,163,157,170,186,23,16,29,36,-5.0646824974265225,-3.483995748942654,-1.7180513223127636,1.5097274689327158,200,192,208,230,30,22,38,36,-0.901651195246911,-0.38735884766267253,0.16858487468937916,1.1580651143662832,15332,15371,Howard+Tipton,Tipton,18,159,Indiana,IN
18069,18CS031,357,341,372,426,69,54,85,44,0.9859023028606559,2.782198569251801,4.398516208736274,0.6260579302008898,438,419,457,521,83,64,102,71,-0.21453753383459112,0.31696351173393894,0.82896383384848,0.8448330559404468,36603,36700,Huntington+Whitley,Huntington,18,69,Indiana,IN
18183,18CS031,277,262,291,305,28,14,43,27,-1.6301610673908742,0.19280538040814274,1.9296750289367062,0.9173286733189112,341,324,359,384,43,25,60,40,-0.4400942506148372,0.07759328050926936,0.5919830974871055,0.9161996251999532,34263,34413,Huntington+Whitley,Whitley,18,183,Indiana,IN
18071,18CS032,430,410,450,474,44,24,64,50,-2.2227241762451433,-0.5562030995830279,1.130863611075514,1.1191394841859736,525,502,549,567,42,18,65,48,-0.6568736374694559,-0.1254347356295474,0.37095157887580454,1.1248509322698244,46021,46112,Jackson+Washington,Jackson,18,71,Indiana,IN
18175,18CS032,272,260,284,293,21,9,33,19,-1.334483615995797,0.2885652477990217,2.003468762846895,0.8714230214241883,331,317,346,397,66,51,80,44,0.24756675175225853,0.7642608395146467,1.252706321389809,0.661494294292118,28185,28119,Jackson+Washington,Washington,18,175,Indiana,IN
18077,18CS033,331,316,345,382,51,37,66,45,-1.1465505302050352,0.6990793823230949,2.4124619696922407,0.860226135910802,406,389,423,427,21,4,38,75,-2.1753456209915534,-1.6301048091815389,-1.1206583057591342,3.444856096826527,32964,33131,Jennings+Jefferson,Jefferson,18,77,Indiana,IN
18079,18CS033,262,250,274,300,38,26,50,30,-0.5459308736855045,1.1799788215687579,2.7582343981604707,0.7716634761748826,320,306,334,345,25,11,39,32,-0.7589006525476942,-0.25566513317664286,0.2237222504733613,1.2213774634839967,27562,27432,Jennings+Jefferson,Jennings,18,79,Indiana,IN
18081,18CS034,1213,1143,1282,1462,249,180,319,223,-1.1180182839715076,0.6718404923695698,2.321712146920724,0.8906289694033099,1508,1423,1592,1742,234,150,319,199,-0.3189199048942496,0.21129302970224725,0.7256200870900809,0.8452340246051055,161839,163989,Johnson,Johnson,18,81,Indiana,IN
18085,18CS035,626,592,661,679,53,18,87,67,-2.558621677447006,-0.6759132536364034,1.0214451890861798,1.245626259128063,772,730,813,922,150,109,192,97,0.19070952507638092,0.6474548712688617,1.1752417382855238,0.6405208296509651,79967,80098,Kosciusko,Kosciusko,18,85,Indiana,IN
18087,18CS036,252,234,269,308,56,39,74,72,-3.2812468239490906,-1.5404976862322997,0.12903517076428178,1.2589520165640393,314,293,335,313,-1,-22,20,32,-1.3526033517895464,-0.823603854630522,-0.2991049678124229,-347.8278991980435,40407,40523,LaGrange+Noble,LaGrange,18,87,Indiana,IN
18113,18CS036,395,375,415,437,42,22,62,47,-2.312900935428455,-0.39650973704028475,1.357504719180336,1.0956289794169753,486,461,510,552,66,42,91,59,-0.3651046740034244,0.13636882073979717,0.6851965932129965,0.878749922018842,47440,47249,LaGrange+Noble,Noble,18,113,Indiana,IN
18089,18CS037,4383,4170,4597,5247,864,650,1077,627,0.16379499691299637,1.879588439264108,3.67620055261696,0.7252456209523018,5395,5138,5652,6026,631,374,888,617,-0.4784119572587959,0.0198642765795339,0.5781216218357724,0.9763051268082009,496791,498564,Lake,Lake,18,89,Indiana,IN
18091,18CS038,1061,1013,1109,1271,210,162,258,130,0.927543667176149,2.91713200213004,4.572361724175785,0.6157798060606727,1301,1243,1359,1366,65,7,123,107,-0.9138816985814587,-0.38326692846078875,0.13700983054427027,1.6309252202891913,111922,112366,LaPorte,LaPorte,18,91,Indiana,IN
18093,18CS039,463,443,482,545,82,63,102,82,-1.6652512410345184,-0.035018762020756246,1.7321927551296554,0.9852542411658377,565,542,588,733,168,145,191,108,0.8221177203311002,1.3404364521578216,1.8724708226721194,0.6396094051913318,45085,45063,Lawrence+Orange,Lawrence,18,93,Indiana,IN
18117,18CS039,203,195,212,264,61,52,69,35,3.5876509267933647,5.221832150622777,6.9042304622496244,0.5670267644464319,248,238,259,309,61,50,71,39,0.5829063237785536,1.0895115605415018,1.6102941015873833,0.6326784243873441,19812,19831,Lawrence+Orange,Orange,18,117,Indiana,IN
18095,18CS040,1303,1247,1359,1558,255,199,311,227,-0.7263285932374045,0.8484672476232975,2.5507790181660512,0.8859162015835598,1602,1534,1669,1948,346,279,414,261,0.15600578567139622,0.66208402878448,1.1913222553687612,0.7513494627118186,130045,130677,Madison,Madison,18,95,Indiana,IN
18097,18CS041,7153,6733,7572,8757,1604,1185,2024,1268,-0.10024598088308415,1.3677627260083147,3.1059755282683432,0.7898897351959403,8768,8266,9270,10193,1425,923,1927,1003,-0.08081432189470202,0.42659716707041295,0.9497131618172588,0.7034131857304068,974292,971929,Marion,Marion,18,97,Indiana,IN
18099,18CS042,392,372,412,515,123,103,143,74,2.5216899995679456,4.240984731362683,5.916835104856836,0.5981724863108535,483,459,507,540,57,33,81,71,-0.7939166947406094,-0.31473344333697323,0.19007703686073696,1.229308833823152,46055,46106,Marshall+Pulaski+Starke,Marshall,18,99,Indiana,IN
18131,18CS042,145,140,151,163,18,12,23,28,-5.134675557592061,-3.3573076085449673,-1.5688935978970795,1.511931637219254,176,170,183,211,35,28,41,33,-0.40334781689456173,0.1323614336062518,0.6610520823212834,0.9266248066135856,12457,12361,Marshall+Pulaski+Starke,Pulaski,18,131,Indiana,IN
18149,18CS042,236,226,246,296,60,50,70,49,0.23506558413140957,1.824427358049743,3.5590954868764637,0.8063738048835778,290,278,302,374,84,72,96,42,1.2728385552611128,1.8036103890945654,2.324307573846467,0.4941609849408625,23307,23370,Marshall+Pulaski+Starke,Starke,18,149,Indiana,IN
18105,18CS043,801,741,861,1017,216,156,276,113,1.164657267558076,2.939083282894204,4.552216500909052,0.5209635576294934,988,916,1060,1159,171,99,243,116,-0.1111270522591778,0.38426388232698155,0.9011001006627163,0.6745262342407785,140817,139823,Monroe,Monroe,18,105,Indiana,IN
18109,18CS044,626,595,656,720,94,64,125,93,-1.833453153030423,0.0684744023779922,1.79504058743526,0.9749259100345613,774,737,811,901,127,90,164,112,-0.3501963646645546,0.20413361242968311,0.7133411995614222,0.8747555059802741,71640,72147,Morgan,Morgan,18,109,Indiana,IN
18127,18CS045,1337,1262,1411,1602,265,191,340,180,0.21812038329391625,1.9861436578401697,3.62686239643623,0.6764236732083606,1656,1566,1746,1904,248,158,338,192,-0.24806941032264063,0.32634045338200457,0.822765677773619,0.769983820510253,172971,174099,Porter,Porter,18,127,Indiana,IN
18141,18CS046,2343,2226,2461,2802,459,341,576,372,-0.5066272880839466,1.291255192291995,2.97616670170415,0.8093807359279258,2874,2734,3015,3110,236,95,376,250,-0.5564833852108937,-0.052906622590894875,0.46283483071668785,1.056348538693044,272389,272261,St. Joseph,St. Joseph,18,141,Indiana,IN
18157,18CS047,1032,951,1112,1164,132,52,213,83,-0.6119869352452412,0.9887864877430415,2.6219426479493646,0.6223675538472354,1277,1181,1374,1491,214,117,310,167,-0.2673827572479048,0.2493019239606768,0.7653637212951936,0.7780194788519471,187592,186955,Tippecanoe,Tippecanoe,18,157,Indiana,IN
18163,18CS048,1697,1619,1774,2038,341,264,419,247,0.39347995578497025,2.1136161620628253,3.8233834237625133,0.7213525773857902,2076,1983,2169,2334,258,165,351,219,-0.2769980688543923,0.21858553780011325,0.7200546442883972,0.8453477846914401,180345,180012,Vanderburgh,Vanderburgh,18,163,Indiana,IN
18173,18CS049,529,502,557,661,132,104,159,85,1.1555288132021224,2.9462695228364,4.56991362441139,0.6411042554899962,657,624,691,722,65,31,98,73,-0.635115836999687,-0.13036841190227932,0.39175089117363443,1.112358541344571,63860,64434,Warrick,Warrick,18,173,Indiana,IN
18177,18CS050,764,736,793,935,171,142,199,131,0.734859647499572,2.448966082802773,4.024703670289944,0.7630236032400006,934,900,969,1027,93,58,127,113,-0.8585881833072657,-0.292256174497659,0.19461064879828352,1.2068813725732603,66380,66456,Wayne,Wayne,18,177,Indiana,IN
19005,19CS001,158,152,164,169,11,5,17,27,-6.36339813828136,-4.623369557548983,-2.7972448066867814,2.2964401922473123,192,185,199,169,-23,-30,-16,20,-3.6084440779399434,-3.1008728621488517,-2.5750081448693547,-0.905521993779557,13995,13947,Allamakee+Clayton+Winneshiek,Allamakee,19,5,Iowa,IA
19043,19CS001,165,158,172,197,32,25,39,43,-4.327410766771817,-2.560694530838982,-0.7717973940148898,1.3055063824053355,201,193,210,223,22,13,30,16,-0.18693200330861523,0.33845801898670885,0.8573713872776094,0.7078612207892518,17069,16998,Allamakee+Clayton+Winneshiek,Clayton,19,43,Iowa,IA
19191,19CS001,166,157,175,161,-5,-14,4,22,-7.125137460812085,-5.360289115285742,-3.6115232237208263,-5.595284253370821,203,192,213,202,-1,-11,10,16,-1.3376561333283843,-0.841902183127664,-0.2989437196309107,40.951200806169325,20011,19912,Allamakee+Clayton+Winneshiek,Winneshiek,19,191,Iowa,IA
19001,19CS002,90,89,91,98,8,7,9,16,-4.833418594392416,-4.41526205572639,-4.006690557772583,1.817035769826627,112,111,113,130,18,17,19,19,-0.23090522764784874,-0.10515531006652204,0.028619337852224307,0.9896668027346419,7429,7532,Audubon and Nearby Counties,Adair,19,1,Iowa,IA
19009,19CS002,73,72,73,68,-5,-5,-4,4,-6.740629971965555,-6.323748743649403,-5.93211919856018,-1.019238940459467,89,88,90,82,-7,-8,-6,4,-2.0873776287827783,-1.9719563590674603,-1.8482931092115225,-0.653380100786636,5641,5640,Audubon and Nearby Counties,Audubon,19,9,Iowa,IA
19029,19CS002,172,166,177,205,33,28,39,41,-4.082178772552018,-2.369713744072357,-0.6405416264632946,1.1935270602851613,209,202,215,203,-6,-12,1,25,-2.898800187772759,-2.331965045981132,-1.8496975440535912,-5.29254581911821,13057,13058,Audubon and Nearby Counties,Cass,19,29,Iowa,IA
19077,19CS002,104,103,105,133,29,28,30,20,2.8641009456219444,3.293475412622626,3.6916178508034543,0.6727793219679882,127,126,128,127,-0,-1,1,14,-1.4679291194234028,-1.3257206329490696,-1.1921395984286425,14.220400752523174,10626,10574,Audubon and Nearby Counties,Guthrie,19,77,Iowa,IA
19165,19CS002,128,127,129,162,34,33,35,28,1.54741139876955,1.9830986804645314,2.4135144240939876,0.8046117285349865,158,156,159,150,-8,-9,-6,13,-1.9039842587765217,-1.7857370728431772,-1.6572343548138764,-1.862957718759174,11674,11760,Audubon and Nearby Counties,Shelby,19,165,Iowa,IA
19011,19CS003,212,201,223,267,55,44,66,41,0.3372732506203898,2.179472693010009,3.7817723107836696,0.7339448974948161,263,250,276,235,-28,-41,-15,14,-2.138603208329662,-1.631482381786757,-1.1157702177689444,-0.5212864356672628,25553,25668,Benton+Iowa (county)+Keokuk+Washington,Benton,19,11,Iowa,IA
19095,19CS003,171,164,179,195,24,16,31,22,-1.295878906368688,0.317756101297532,2.088038039820542,0.8956947583701579,210,201,219,214,4,-5,13,14,-1.1135459420181426,-0.6009264368803203,-0.08931917739947716,2.7665600380442426,16590,16584,Benton+Iowa (county)+Keokuk+Washington,Iowa (county),19,95,Iowa,IA
19107,19CS003,100,99,101,128,28,27,29,26,0.46270045324505976,0.8700624135034106,1.290207307232394,0.8907903397535132,122,120,123,156,34,33,36,18,1.5341730502158344,1.6578591571318224,1.7936222541036733,0.5075315452058322,10015,9926,Benton+Iowa (county)+Keokuk+Washington,Keokuk,19,107,Iowa,IA
19183,19CS003,217,207,226,263,46,37,56,32,0.9362680458856673,2.548680019123852,4.333790592121931,0.6770085185538964,267,255,278,265,-2,-13,10,34,-2.09556181921195,-1.5967318418909784,-1.093489538080893,-49.55355828743099,22439,22494,Benton+Iowa (county)+Keokuk+Washington,Washington,19,183,Iowa,IA
19013,19CS004,1050,994,1106,1302,252,196,308,239,-1.3951597868472652,0.3911781133055308,2.050389919391858,0.945118252892768,1289,1222,1357,1449,160,92,227,141,-0.3677085934666351,0.14586253592927087,0.6510133826111855,0.8782724204489127,130932,130457,Black Hawk,Black Hawk,19,13,Iowa,IA
19015,19CS005,252,241,264,284,32,20,43,15,0.8098293783435937,2.5697278048498715,4.31945263714602,0.4559006436827839,308,294,322,334,26,12,40,27,-0.5757564410900755,-0.04010208420612099,0.4630668822233251,1.007924336949255,26643,26718,Boone+Carroll+Greene,Boone,19,15,Iowa,IA
19027,19CS005,204,195,213,239,35,26,44,36,-1.84192508437623,-0.271849637591335,1.369441545145301,1.007637168032139,250,239,260,281,31,21,42,10,0.5250333309139474,1.0366847539388602,1.5296470705205776,0.3084120763464237,20616,20693,Boone+Carroll+Greene,Carroll,19,27,Iowa,IA
19073,19CS005,99,98,100,85,-14,-15,-13,4,-8.56727785421268,-8.152754829582621,-7.761651441628957,-0.31101588101764277,120,119,121,130,10,9,11,10,-0.15451765621458963,-0.03013691846321807,0.09232960857336718,0.9305005366043297,8763,8721,Boone+Carroll+Greene,Greene,19,73,Iowa,IA
19017,19CS006,203,192,213,272,69,59,80,44,2.3156449938207864,4.027505906591462,5.80890777943774,0.6247681040839214,251,238,264,254,3,-10,16,23,-1.3302498840139843,-0.8043080002605374,-0.2609649640686855,5.784609040471777,25014,25065,Bremer+Butler+Grundy,Bremer,19,17,Iowa,IA
19023,19CS006,164,158,170,153,-11,-17,-5,22,-11.051591252203934,-9.298309239851083,-7.677052631613003,-2.136830168315954,201,194,209,199,-2,-10,5,21,-2.1866388277498885,-1.6335049475932866,-1.1411913204958806,-14.418378963921066,14327,14329,Bremer+Butler+Grundy,Butler,19,23,Iowa,IA
19075,19CS006,124,123,126,142,18,16,19,26,-3.138074138886542,-2.7181550223792277,-2.3524308895895336,1.3992099436295304,154,152,155,147,-7,-8,-5,3,-0.9055732570046489,-0.7776703039763657,-0.6623421620899975,-0.5334343718422443,12303,12342,Bremer+Butler+Grundy,Grundy,19,75,Iowa,IA
19019,19CS007,173,164,182,191,18,9,27,22,-2.4285515272028237,-0.8207905870891313,0.8598837225235642,1.1704385251292853,212,202,223,223,11,-0,21,20,-0.9826434332654707,-0.45755930229442154,0.05412696122425578,1.727608148226216,20675,20647,Buchanan+Delaware+Fayette,Buchanan,19,19,Iowa,IA
19055,19CS007,151,143,158,187,36,29,44,32,-0.7836208267163997,0.932197235780788,2.6126273197791012,0.8616566767719777,186,177,195,188,2,-7,11,23,-1.6823572023996405,-1.1754662768683755,-0.6540295385254881,6.8370209465258815,17405,17502,Buchanan+Delaware+Fayette,Delaware,19,55,Iowa,IA
19065,19CS007,210,201,218,250,40,32,49,26,1.2124298895104264,2.9365449019245333,4.750072215475208,0.6301872440462905,254,244,264,273,19,9,29,30,-1.092660100129596,-0.5896075662710102,-0.08663815339397059,1.5323893216266515,19410,19279,Buchanan+Delaware+Fayette,Fayette,19,65,Iowa,IA
19031,19CS008,155,147,163,181,26,18,34,18,0.05458677221861871,1.7248252913197935,3.5746975382204758,0.6672097901095054,189,179,198,213,24,15,34,5,0.5212333032620673,1.0244933827449332,1.5421688751165359,0.19912369201384003,18493,18422,Cedar+Clinton+Jackson+Jones,Cedar,19,31,Iowa,IA
19045,19CS008,471,451,491,531,60,40,80,71,-2.689072124592525,-0.9606252167972602,0.7529342207105822,1.1589714625811354,574,550,598,609,35,11,59,47,-0.7817443331778778,-0.2627986798360842,0.2274012231955055,1.3058962552595086,46443,46456,Cedar+Clinton+Jackson+Jones,Clinton,19,45,Iowa,IA
19097,19CS008,191,182,199,223,32,24,41,32,-1.6451371198993097,0.15691263505090022,1.7798151278288379,0.9573501548994158,232,222,242,269,37,27,47,27,-0.02071406568076775,0.5221399270415349,1.0426980004952215,0.7080497786640478,19421,19378,Cedar+Clinton+Jackson+Jones,Jackson,19,97,Iowa,IA
19105,19CS008,173,164,182,210,37,28,46,48,-3.784781306249962,-2.0771655022377677,-0.26410194448615665,1.2534122711051567,212,202,223,241,29,18,39,14,0.1366160082698979,0.6828402454787007,1.2366748123679994,0.4724476676139829,20662,20782,Cedar+Clinton+Jackson+Jones,Jones,19,105,Iowa,IA
19033,19CS009,449,430,467,533,84,66,103,67,-0.18730122028766955,1.6013844429333701,3.2578162851179813,0.7842310747567881,548,526,570,601,53,31,75,63,-0.7266303240877763,-0.2264295714626341,0.2704772074151276,1.158238315056008,42867,42744,Cerro Gordo+Hancock+Winnebago,Cerro Gordo,19,33,Iowa,IA
19081,19CS009,101,100,102,120,19,18,20,20,-0.6397081635415406,-0.23230515861670759,0.14902698577599083,0.9822963352905145,123,122,124,154,31,30,32,16,1.2732381167150877,1.4062802241289114,1.5288502738208092,0.49986912203525885,10734,10677,Cerro Gordo+Hancock+Winnebago,Hancock,19,81,Iowa,IA
19189,19CS009,111,110,112,137,26,25,27,24,0.4770578953695236,0.8787303207696499,1.2752327453833452,0.8785119386392031,136,135,138,126,-10,-12,-9,11,-2.1361960227312964,-2.0124551049909036,-1.8809406207055333,-1.1638254789337383,10608,10655,Cerro Gordo+Hancock+Winnebago,Winnebago,19,189,Iowa,IA
19049,19CS010,481,438,524,557,76,33,119,63,-1.148275170768544,0.5225864370148243,2.187996945613015,0.8206753196320797,617,564,670,585,-32,-85,21,46,-1.2814780362720273,-0.7598415621940782,-0.22616759688375984,-1.4767561954351685,99831,103313,Dallas,Dallas,19,49,Iowa,IA
19051,19CS011,81,80,82,91,10,9,11,20,-4.680683519687228,-4.264392270132838,-3.8936571352818157,1.7712896201128354,100,99,101,82,-18,-19,-17,2,-2.2960133656658614,-2.172008710948435,-2.0421348165102,-0.11886907931428108,9097,9134,Davis+Jefferson+Van Buren+Wapello,Davis,19,51,Iowa,IA
19101,19CS011,137,130,143,178,41,35,48,25,2.3519450302381397,4.155395743467824,5.81032120162125,0.5890394506751355,166,158,174,183,17,9,25,15,-0.3503454615116287,0.13823548397272037,0.6457715498974157,0.8238997085760631,16025,15649,Davis+Jefferson+Van Buren+Wapello,Jefferson,19,101,Iowa,IA
19177,19CS011,81,81,82,80,-1,-2,-1,13,-8.457155448920624,-8.05047832039954,-7.669599626249238,-29.137404596569272,101,100,102,91,-10,-11,-9,4,-2.037571191674318,-1.905869814745345,-1.774081584615593,-0.45513411119551445,7185,7237,Davis+Jefferson+Van Buren+Wapello,Van Buren,19,177,Iowa,IA
19179,19CS011,358,343,373,456,98,83,113,95,-1.4783324990003088,0.3599312848482203,1.9184674236950139,0.9601018431955379,439,420,457,468,29,11,48,60,-1.3639877754568606,-0.871249535834551,-0.34637945567827766,1.9782244547530083,35304,35268,Davis+Jefferson+Van Buren+Wapello,Wapello,19,179,Iowa,IA
19057,19CS012,391,374,407,434,43,27,60,42,-1.6788907946362,0.07598907695410695,1.8084051279362863,0.9500825625383491,475,456,495,548,73,53,92,63,-0.2668926456184597,0.22988323554891957,0.7725239844175006,0.8568031474288434,38828,38541,Des Moines+Henry+Lee,Des Moines,19,57,Iowa,IA
19087,19CS012,190,181,199,246,56,47,65,35,2.3566089936458776,4.11318208029278,5.68547255780568,0.6165529543047537,234,223,244,250,16,6,27,23,-0.847622303410906,-0.33664273412684415,0.17042301311281377,1.3346395368051556,20325,20391,Des Moines+Henry+Lee,Henry,19,87,Iowa,IA
19111,19CS012,365,350,379,439,74,60,89,33,3.1980212030709687,4.965060060130662,6.793598949850191,0.43776556797532024,443,426,460,509,66,49,83,75,-0.7596284363862561,-0.26892578188948124,0.2515587458864364,1.1189694522996767,33500,33258,Des Moines+Henry+Lee,Lee,19,111,Iowa,IA
19061,19CS013,794,751,837,867,73,30,116,151,-4.980263182485166,-3.143669907453176,-1.3837492502177817,2.0418319019208586,974,923,1025,1050,76,25,127,100,-0.7245184741600195,-0.23224700502881623,0.2795143886713956,1.2965459843692013,98914,98793,Dubuque,Dubuque,19,61,Iowa,IA
19069,19CS014,103,102,104,135,32,31,33,18,5.048485678540326,5.428954664848586,5.826591207553699,0.5528005024724273,127,125,128,168,41,40,43,16,2.4170829964340785,2.5506522927920163,2.677821340139209,0.3776432804530628,9994,9957,Franklin+Hamilton+Hardin+Wright,Franklin,19,69,Iowa,IA
19079,19CS014,161,155,168,176,15,8,21,33,-6.68584215891306,-4.8311949568386225,-3.140643022080282,2.1081925702312927,197,189,205,193,-4,-12,4,22,-2.2830063952636666,-1.749344569376417,-1.2192681339994456,-6.934388196168863,14974,14906,Franklin+Hamilton+Hardin+Wright,Hamilton,19,79,Iowa,IA
19083,19CS014,188,181,195,215,27,20,34,28,-1.8878974367394274,-0.19648333598376877,1.6390959524154531,0.9917885768764874,229,221,238,280,51,42,59,15,1.6258591727432574,2.144402852303296,2.65753887994773,0.2904075030890927,16807,16724,Franklin+Hamilton+Hardin+Wright,Hardin,19,83,Iowa,IA
19197,19CS014,159,153,164,161,2,-3,8,23,-8.06369035124652,-6.415982990195019,-4.666976707316672,6.712257258492758,193,187,200,189,-4,-11,2,25,-2.8100273288242303,-2.2728896690831677,-1.73043838956184,-7.634506824929306,12848,12804,Franklin+Hamilton+Hardin+Wright,Wright,19,197,Iowa,IA
19071,19CS015,77,76,77,70,-7,-7,-6,5,-7.430226304540618,-7.018301735917104,-6.682188867912563,-0.8879536161695175,93,92,94,97,4,3,5,12,-1.3707312787068393,-1.2482741402796291,-1.125378848742067,2.500022972574766,6613,6566,Fremont+Harrison+Mills+Pottawattamie,Fremont,19,71,Iowa,IA
19085,19CS015,169,162,175,235,66,60,73,61,-0.3244737176923685,1.4459261100837926,3.219077133781251,0.9059418330736484,208,200,215,193,-15,-22,-7,20,-2.861077720975815,-2.3603240918642476,-1.8448110845205101,-1.4810812119284629,14484,14651,Fremont+Harrison+Mills+Pottawattamie,Harrison,19,85,Iowa,IA
19129,19CS015,112,110,113,136,24,23,26,16,1.8042444358038356,2.212097963112382,2.6348679714440184,0.6387029142030606,137,135,139,156,19,17,21,15,0.14511474108496092,0.27581045459837455,0.399076526818287,0.7515149477205216,14516,14456,Fremont+Harrison+Mills+Pottawattamie,Mills,19,129,Iowa,IA
19155,19CS015,807,767,847,994,187,147,227,111,1.618338965668934,3.245909715723111,4.958199211341245,0.5905184232781068,987,939,1036,1137,150,101,198,117,-0.2037387277380737,0.3499537717431292,0.874377926124418,0.7769940579821955,93511,93341,Fremont+Harrison+Mills+Pottawattamie,Pottawattamie,19,155,Iowa,IA
19099,19CS016,337,321,354,388,51,34,67,58,-2.4935126868516506,-0.8181292177614014,0.9725686811631418,1.1229039607007356,413,393,432,448,35,16,55,29,-0.37520925544063505,0.16678581450734836,0.7008601035366818,0.8026561502001899,37706,37770,Jasper+Poweshiek,Jasper,19,99,Iowa,IA
19157,19CS016,185,177,193,194,9,1,17,25,-5.251027801163383,-3.4871935604794513,-1.8147352306520288,2.6231476468715687,226,216,236,245,19,9,29,25,-0.8346435641279953,-0.34728245212555636,0.1758604341513031,1.255289412031321,18610,18594,Jasper+Poweshiek,Poweshiek,19,157,Iowa,IA
19103,19CS017,651,585,717,727,76,10,142,53,-1.1150911561300503,0.6216546639300233,2.195394120643015,0.6889975286935344,821,741,901,902,81,1,161,59,-0.3832036843818613,0.1314494230185346,0.6673931124833389,0.7192526777427588,153094,154491,Johnson,Johnson,19,103,Iowa,IA
19113,19CS018,1565,1466,1664,1921,356,257,455,266,-0.2799232817413364,1.5881989334841422,3.140484043052166,0.7454430557741062,1922,1804,2040,2074,152,34,270,177,-0.6246163564480506,-0.1033726770819045,0.4113288188141572,1.157148854792764,229684,229132,Linn,Linn,19,113,Iowa,IA
19115,19CS019,93,92,94,111,18,17,19,30,-4.750901624482273,-4.3173378645945215,-3.906024696814062,1.5549872288276723,113,112,114,122,9,8,10,20,-1.154116360267462,-1.0310592845831421,-0.9031501112208595,2.016733703014588,10837,10757,Louisa+Muscatine,Louisa,19,115,Iowa,IA
19139,19CS019,357,338,375,431,74,56,93,79,-2.1343795239290366,-0.4760555349672635,1.2810757252164189,1.0493404253369962,436,414,458,484,48,26,70,45,-0.4088462967058203,0.07741602747404078,0.5606459346497651,0.9108186849536529,42990,42750,Louisa+Muscatine,Muscatine,19,139,Iowa,IA
19007,19CS020,147,142,153,180,33,27,38,40,-3.940811661797201,-2.335143285039473,-0.6812609707330967,1.1839489593124157,178,172,184,187,9,3,15,16,-1.0903238188748379,-0.5590067703633329,-0.06471278445464969,1.5924853075721852,12315,12261,Lucas and Nearby Counties,Appanoose,19,7,Iowa,IA
19039,19CS020,97,96,98,100,3,2,4,4,-0.9678612475614264,-0.5093430732594016,-0.13897760709783377,1.0847016249518358,120,119,121,158,38,37,39,22,1.4829988257083597,1.6087830982231592,1.7409631188404013,0.5676473057878879,9682,9776,Lucas and Nearby Counties,Clarke,19,39,Iowa,IA
19053,19CS020,70,70,71,76,6,5,6,2,1.4327384336609927,1.8662693571254436,2.274468578498921,0.30467442847583376,86,85,87,99,13,12,14,15,-0.4367075141950855,-0.2934578601136122,-0.1660102656505136,1.0914690176844075,7650,7652,Lucas and Nearby Counties,Decatur,19,53,Iowa,IA
19117,19CS020,95,94,96,98,3,2,4,11,-4.177123622512402,-3.785815717809711,-3.370571289890722,2.8529715156922477,117,116,119,125,8,6,9,12,-0.6402517552529768,-0.507757686374671,-0.3851859183870088,1.401008268767955,8617,8696,Lucas and Nearby Counties,Lucas,19,117,Iowa,IA
19135,19CS020,84,84,85,101,17,16,17,16,-0.03753851510418283,0.36491813684218916,0.7705622912794664,0.9045756351892824,103,102,104,109,6,5,7,17,-1.6107355477666303,-1.4739590187354445,-1.3507652458117303,2.501547407030945,7599,7606,Lucas and Nearby Counties,Monroe,19,135,Iowa,IA
19185,19CS020,74,73,75,94,20,19,21,17,1.4306093818336274,1.8869299596983757,2.2761398651826896,0.8076483911825456,91,90,91,86,-5,-5,-4,7,-1.9127064632314876,-1.7822614106497063,-1.660757610607278,-1.9361577672319572,6495,6508,Lucas and Nearby Counties,Wayne,19,185,Iowa,IA
19119,19CS021,95,93,96,112,17,16,19,35,-6.305724970565647,-5.909426733507939,-5.537322571092323,1.9024434505708405,117,115,118,94,-23,-24,-21,3,-2.2647482181944176,-2.13474859361126,-2.00271534903677,-0.13881604215146268,11911,11997,Lyon+O'Brien+Osceola+Sioux,Lyon,19,119,Iowa,IA
19141,19CS021,172,166,178,220,48,42,54,50,-2.023602479045667,-0.47656620715721093,1.2659954275074599,1.0117932631893645,207,200,214,183,-24,-31,-17,11,-2.982635023602951,-2.5024486194713993,-2.0337717373889492,-0.473186124761814,14087,14035,Lyon+O'Brien+Osceola+Sioux,O'Brien,19,141,Iowa,IA
19143,19CS021,61,61,62,71,10,9,10,10,-0.6459378795999483,-0.21205541621095084,0.17407314191569465,0.9365714357538121,75,74,76,91,16,15,17,4,1.811540412362786,1.9314508189969226,2.0716285716254332,0.23642842252574975,6153,6163,Lyon+O'Brien+Osceola+Sioux,Osceola,19,143,Iowa,IA
19167,19CS021,213,198,229,279,66,50,81,63,-1.3722168189037391,0.3264805871270169,1.9823637557101985,0.9421045739222957,263,244,281,257,-6,-24,13,13,-1.0527112975061763,-0.5175472330083342,-0.02266348286727163,-2.8849436182812913,35737,35890,Lyon+O'Brien+Osceola+Sioux,Sioux,19,167,Iowa,IA
19121,19CS022,143,136,150,122,-21,-28,-14,10,-9.283164408021904,-7.562471136425868,-5.920514951669397,-0.4928096174390045,177,168,186,180,3,-6,12,15,-1.2044047115346022,-0.6918166865919239,-0.21636494844424206,3.6225329183162436,16590,16752,Madison+Warren,Madison,19,121,Iowa,IA
19181,19CS022,381,359,404,423,42,19,64,48,-2.066340710907719,-0.4691332992912945,1.2252295720260842,1.1204061925018358,475,447,502,534,59,32,87,62,-0.6089801517414171,-0.04239958858611428,0.47543154103526375,1.0266773303677927,52491,53277,Madison+Warren,Warren,19,181,Iowa,IA
19123,19CS023,205,195,214,250,45,36,55,38,-0.3023485073104057,1.3749092851305813,3.0809876019862465,0.8184451668857279,250,239,261,274,24,13,35,34,-0.9507985486445837,-0.4538118642768132,0.0842683321184756,1.3557190526936014,22172,22008,Mahaska+Marion,Mahaska,19,123,Iowa,IA
19125,19CS023,297,283,311,329,32,18,46,51,-4.057736920306543,-2.265900421509263,-0.6199124918786749,1.549186115975723,366,348,383,370,4,-13,22,45,-1.738256405130349,-1.2263145144815486,-0.6975232546024812,8.532912167617798,33363,33380,Mahaska+Marion,Marion,19,125,Iowa,IA
19127,19CS024,409,392,426,467,58,41,75,60,-1.9065700585002578,-0.23980322796197123,1.4776445127025748,1.019235935390108,499,479,520,531,32,11,52,26,-0.33975501667022157,0.1356347022977381,0.6359015447084123,0.7977679103861287,39952,39883,Marshall+Tama,Marshall,19,127,Iowa,IA
19171,19CS024,178,171,185,222,44,37,51,56,-4.480810929225945,-2.8492195053882177,-1.1124875372089371,1.2464241881870128,216,207,225,216,-0,-9,9,20,-1.6664487761145712,-1.1809250878535305,-0.6977146107720092,22.271468661031747,17026,16897,Marshall+Tama,Tama,19,171,Iowa,IA
19037,19CS025,115,114,116,133,18,17,19,11,1.937038093866597,2.297252453687108,2.7043592587965617,0.5820661768200489,141,139,142,146,5,4,7,13,-0.773557140429451,-0.6447926669159909,-0.5216057109935667,2.0530383671309886,11957,11899,Mitchell and Nearby Counties,Chickasaw,19,37,Iowa,IA
19067,19CS025,154,147,161,202,48,41,55,30,2.850659939938091,4.617743353772515,6.427507316900534,0.6142748368254118,188,180,196,199,11,3,19,17,-0.9264702598344356,-0.37647608722713133,0.1585144573579569,1.4025033202179742,15553,15433,Mitchell and Nearby Counties,Floyd,19,67,Iowa,IA
19089,19CS025,102,101,103,99,-3,-4,-2,15,-8.004814447376372,-7.5773959263029544,-7.155258754468984,-8.027536706612127,126,124,127,133,7,6,9,7,-0.09126383142592305,0.04920620516933129,0.17202392503285374,0.8278768973606381,9436,9479,Mitchell and Nearby Counties,Howard,19,89,Iowa,IA
19131,19CS025,117,116,118,129,12,11,13,37,-9.769682226568174,-9.388065253630822,-9.00804349610255,2.8056199187127278,143,142,144,150,7,6,8,2,0.3380518963578344,0.4671067627985514,0.5959443403765411,0.25126543434279436,10577,10559,Mitchell and Nearby Counties,Mitchell,19,131,Iowa,IA
19195,19CS025,72,71,73,59,-13,-14,-12,5,-10.10174356701262,-9.722536489250647,-9.313327579847657,-0.4160207560688371,88,87,89,99,11,10,12,6,0.5404907287605992,0.6672470475128406,0.7913504252538421,0.5047524515985677,7418,7391,Mitchell and Nearby Counties,Worth,19,195,Iowa,IA
19041,19CS026,165,158,172,187,22,15,29,16,-0.21189462732242798,1.4270534252994396,3.241905479935032,0.6987953431927046,203,194,211,198,-5,-13,4,20,-2.0279340398968144,-1.4891354338948743,-0.9410914541587564,-5.6739470416456905,16309,16424,Palo Alto and Nearby Counties,Clay,19,41,Iowa,IA
19059,19CS026,179,172,187,197,18,10,25,28,-4.018606857463885,-2.3881357622795787,-0.697243245827084,1.5034054214788735,220,211,229,216,-4,-13,5,27,-2.2617917418370603,-1.740458806513017,-1.220117657752697,-8.630707901828519,17691,17836,Palo Alto and Nearby Counties,Dickinson,19,59,Iowa,IA
19063,19CS026,104,103,105,132,28,27,29,32,-2.251041679400927,-1.860353624974939,-1.4613052655492587,1.1159788912393387,128,127,129,131,3,2,4,14,-1.3026993718793416,-1.1748858403842775,-1.062608566549262,3.5062145062193055,9315,9323,Palo Alto and Nearby Counties,Emmet,19,63,Iowa,IA
19109,19CS026,152,146,159,175,23,16,29,44,-7.425087550032317,-5.782551916861903,-4.120482414040325,1.8682432155706612,184,176,191,219,35,28,43,30,-0.14205680459846107,0.36950933441442324,0.8911648513430405,0.8221143804700042,14757,14566,Palo Alto and Nearby Counties,Kossuth,19,109,Iowa,IA
19147,19CS026,109,108,110,119,10,9,11,11,-0.747180253341387,-0.34769950958441226,0.051536882452888504,0.9810254513367629,133,132,134,139,6,5,7,22,-1.898932418497409,-1.782315636442792,-1.6612761797701152,3.0842080799164515,8942,8914,Palo Alto and Nearby Counties,Palo Alto,19,147,Iowa,IA
19021,19CS027,166,157,175,175,9,-0,18,31,-6.011862432239297,-4.260281959573509,-2.525792531660438,3.14739030827727,205,195,216,184,-21,-32,-11,14,-2.261822319565815,-1.6890793625786724,-1.1686311013296484,-0.6885731756849681,20617,20772,Pocahontas and Nearby Counties,Buena Vista,19,21,Iowa,IA
19025,19CS027,116,115,117,111,-5,-6,-4,4,-4.239450874177918,-3.850870325263567,-3.437706394511365,-0.8941865965291237,143,142,145,145,2,0,3,10,-0.9747574117655621,-0.8465115631098735,-0.7162488677881088,3.836660014213546,9850,9911,Pocahontas and Nearby Counties,Calhoun,19,25,Iowa,IA
19091,19CS027,98,97,99,106,8,7,9,20,-5.347726148768883,-4.943719113383434,-4.552907910724115,2.190590373455017,120,119,122,129,9,7,10,10,-0.2743562586132832,-0.14820348894284446,-0.011049303161305592,1.041649261128747,9585,9628,Pocahontas and Nearby Counties,Humboldt,19,91,Iowa,IA
19151,19CS027,84,84,85,95,11,10,11,15,-2.944174795232633,-2.5357119457393678,-2.1290083831433613,1.2983703224123746,104,103,105,111,7,6,8,10,-0.5832900146171984,-0.46119640718203103,-0.343210853561631,1.2909509652270936,7010,7074,Pocahontas and Nearby Counties,Pocahontas,19,151,Iowa,IA
19161,19CS027,115,114,116,128,13,12,14,15,-1.3539949782296292,-0.9643906310702824,-0.5443794221804806,1.0996475933314847,141,140,142,151,10,9,11,12,-0.33102449583314575,-0.20315023904779098,-0.08193960075155855,1.0878571048810406,9770,9758,Pocahontas and Nearby Counties,Sac,19,161,Iowa,IA
19187,19CS027,374,358,390,469,95,79,111,68,1.2581214047597762,2.9195542431603854,4.518982857158571,0.7081425930887868,461,441,480,510,49,30,69,47,-0.43190691800654624,0.0738525197477241,0.5701815896624745,0.9318653980353887,36832,37119,Pocahontas and Nearby Counties,Webster,19,187,Iowa,IA
19153,19CS028,3158,2946,3370,3754,596,384,808,437,-0.5117550144791253,1.2885739648529981,3.044080053678427,0.7316845819848339,3925,3669,4181,4340,415,159,671,380,-0.44763610505904866,0.06375021795159466,0.5711602637566459,0.9137261228983887,492940,496250,Polk,Polk,19,153,Iowa,IA
19163,19CS029,1322,1247,1397,1594,272,197,347,178,0.4024550942095787,2.139076719252138,3.8783276694486193,0.6530430706788527,1625,1535,1715,1820,195,105,285,133,-0.14127058694238623,0.36135049439761396,0.8687234405447183,0.6797067330849101,174296,174216,Scott,Scott,19,163,Iowa,IA
19169,19CS030,481,438,523,477,-4,-46,39,35,-3.282377504949254,-1.5769520165287076,0.03328449158906183,-12.72023706142491,604,553,655,627,23,-28,74,26,-0.5849916180832287,-0.02642275293492421,0.5158213456126773,1.0784939385030594,98533,99347,Story,Story,19,169,Iowa,IA
19003,19CS031,37,37,38,40,3,2,3,5,-2.967120658892186,-2.56774627969247,-2.1567483651919326,1.3709750790076662,45,45,46,62,17,16,17,6,2.7856587451987926,2.9088843132284845,3.037668253721871,0.34048037243128043,3677,3649,Taylor and Nearby Counties,Adams,19,3,Iowa,IA
19137,19CS031,141,136,145,169,28,24,33,30,-2.42164914423995,-0.6891318937928738,0.9451690570580751,1.0244532896745373,172,167,178,159,-13,-19,-8,15,-3.2209652910640387,-2.745402040008781,-2.206493634774578,-1.2294827110390028,10273,10324,Taylor and Nearby Counties,Montgomery,19,137,Iowa,IA
19145,19CS031,177,170,183,189,12,6,19,15,-2.4762127131392666,-0.7206401676216209,1.0725247181819153,1.1379443627295125,217,209,225,219,2,-6,10,18,-1.5404894645768472,-1.0161203922725581,-0.5189340276771496,5.46063035974783,15174,15195,Taylor and Nearby Counties,Page,19,145,Iowa,IA
19159,19CS031,64,64,65,93,29,28,29,8,17.300261412106106,17.70610204422702,18.071925700018436,0.2696732288510004,78,77,79,87,9,8,10,16,-1.6459874445792966,-1.521991052656888,-1.3844286934289618,1.6110579397068894,4672,4639,Taylor and Nearby Counties,Ringgold,19,159,Iowa,IA
19173,19CS031,62,62,63,79,17,16,17,5,7.63046112825568,8.033549756742884,8.43636313647546,0.27978454323896823,75,75,76,105,30,29,30,11,3.0336675383335345,3.1549316523507462,3.2738968416884346,0.36061253094287066,5909,5867,Taylor and Nearby Counties,Taylor,19,173,Iowa,IA
19175,19CS031,129,124,135,151,22,16,27,23,-2.2353028509560287,-0.45809367374760496,1.276187523887112,1.0184252588168576,158,152,164,172,14,8,20,13,-0.4273679292487949,0.09750898310903053,0.6339135034179764,0.8566322412491808,12107,12030,Taylor and Nearby Counties,Union,19,175,Iowa,IA
19035,19CS032,151,146,156,152,1,-4,6,25,-9.997842819861416,-8.244966526744433,-6.647935436905238,12.051383060856784,182,176,188,172,-10,-16,-4,17,-2.877547187409267,-2.383112737304811,-1.8594482708009406,-1.7998031947139297,11560,11522,West Central Iowa,Cherokee,19,35,Iowa,IA
19047,19CS032,149,142,156,169,20,13,27,23,-2.513379166775865,-0.7373743706608744,0.9979206034095712,1.0944848750998208,180,171,188,158,-22,-30,-13,20,-3.064803760414322,-2.5526469744125335,-2.007806905771727,-0.9748404671789739,16492,16231,West Central Iowa,Crawford,19,47,Iowa,IA
19093,19CS032,88,87,88,117,29,29,30,31,-1.28979551608835,-0.8845251341334348,-0.5018316734571041,1.0173630039425006,107,106,108,96,-11,-12,-10,6,-2.5811145243277527,-2.4590832837792056,-2.336907547538336,-0.5924818779631827,6975,6963,West Central Iowa,Ida,19,93,Iowa,IA
19133,19CS032,118,117,119,154,36,35,37,17,8.163562599873455,8.551157265694712,8.97550840534846,0.464220829274888,143,142,144,157,14,13,15,22,-1.0889041158000503,-0.9564540694980956,-0.8265937465627654,1.488031068809452,8708,8598,West Central Iowa,Monona,19,133,Iowa,IA
19149,19CS032,210,199,221,262,52,41,63,64,-3.7169013262329957,-1.8874587771348534,-0.1910870247629893,1.2145641885599323,258,244,271,250,-8,-21,6,19,-1.6166631402915275,-1.0374788300731548,-0.49343225975167093,-2.883101505631603,25608,25655,West Central Iowa,Plymouth,19,149,Iowa,IA
19193,19CS032,851,806,896,1064,213,168,258,175,-0.43049547247103637,1.4265865784435905,3.261199121678037,0.8175802353406435,1043,988,1097,1084,41,-13,96,91,-0.9585475262654624,-0.4769473250137691,0.046421872957556155,2.1449650063631087,105413,105639,West Central Iowa,Woodbury,19,193,Iowa,IA
20001,20CS001,143,137,148,129,-14,-19,-8,4,-7.417822401766798,-5.704275803938235,-3.949489395384835,-0.31238527285703876,173,166,179,199,26,20,33,27,-0.5960772709151153,-0.049223147640632535,0.4713581739682036,0.9882124498355571,12510,12475,Allen+Anderson+Franklin+Osage,Allen,20,1,Kansas,KS
20003,20CS001,88,87,89,90,2,1,3,5,-1.7938949432248747,-1.434204155839102,-1.0012324542025235,1.563651085328178,106,106,107,103,-3,-4,-3,21,-3.268996145173899,-3.1502582224848297,-3.0156302470056295,-8.40154833741198,7850,7788,Allen+Anderson+Franklin+Osage,Anderson,20,3,Kansas,KS
20059,20CS001,232,220,243,269,37,26,49,21,0.7744291857413588,2.509729153467459,4.299482472765623,0.5469939637731599,282,268,295,338,56,43,70,40,0.11172714432696379,0.615474223885473,1.1684083028749706,0.7004932025106696,25964,25992,Allen+Anderson+Franklin+Osage,Franklin,20,59,Kansas,KS
20139,20CS001,164,157,170,230,66,60,73,23,9.276581142789148,11.044203676187252,12.72475902268967,0.34133338389615075,199,191,207,232,33,25,41,23,0.12378039407817892,0.625346612639605,1.153861246633234,0.6748451976613137,15755,15762,Allen+Anderson+Franklin+Osage,Osage,20,139,Kansas,KS
20011,20CS002,163,157,169,181,18,12,24,17,-1.4607090873126363,0.3498877603964506,2.090359179731398,0.8918740960051428,197,190,204,213,16,9,23,34,-1.7272594545190632,-1.251144451170811,-0.73801526888222,1.989538752174609,14356,14324,Bourbon+Linn+Miami,Bourbon,20,11,Kansas,KS
20107,20CS002,93,92,94,122,29,28,30,5,9.394713248917036,9.80624244102561,10.195707303982877,0.16922996142382715,115,114,117,166,51,49,52,24,2.604648046852376,2.728102432053927,2.858198332544548,0.4658527387172397,9618,9723,Bourbon+Linn+Miami,Linn,20,107,Kansas,KS
20121,20CS002,254,240,269,292,38,23,52,23,0.12301942051017307,1.7563882897217309,3.3536559591785764,0.5971245642872263,312,294,330,419,107,89,125,61,0.8036696486506657,1.3310280459964414,1.849974941165078,0.5648005767199342,34235,34533,Bourbon+Linn+Miami,Miami,20,121,Kansas,KS
20005,20CS003,155,148,162,146,-9,-16,-2,3,-4.776639962992899,-3.011426761936083,-1.3459442136265434,-0.3633982468542072,189,181,198,218,29,20,37,26,-0.3540882167600615,0.15245032571327416,0.6511932760154735,0.879835424084864,16274,16249,Brown and Nearby Counties,Atchison,20,5,Kansas,KS
20013,20CS003,111,110,111,147,36,36,37,31,1.9297507520672061,2.314646815962885,2.737864793414051,0.8269391395965993,136,134,137,157,21,20,23,11,0.9613877533670623,1.0943449890517958,1.2173179175219704,0.49234003258053594,9481,9458,Brown and Nearby Counties,Brown,20,13,Kansas,KS
20043,20CS003,76,75,77,92,16,15,17,10,2.9413510140108086,3.3294132220123926,3.7390743409850593,0.5797858337487777,93,92,94,111,18,17,19,17,-0.016758378815588552,0.10833289563648356,0.22813221718442853,0.9038804526070239,7486,7471,Brown and Nearby Counties,Doniphan,20,43,Kansas,KS
20085,20CS003,130,125,136,125,-5,-11,0,12,-6.963165757775907,-5.1754550534856465,-3.618467240109876,-2.7433720141208457,160,153,166,159,-1,-7,6,14,-1.6179240021106867,-1.0969907087698716,-0.6272731037787064,40.594941601508765,13224,13256,Brown and Nearby Counties,Jackson,20,85,Kansas,KS
20087,20CS003,158,151,166,180,22,14,29,23,-2.152869381630829,-0.3396639836102279,1.470061316594061,1.0221252213208498,194,185,204,204,10,0,19,27,-1.4711314866495144,-0.9322666911023831,-0.40829610949148404,2.5112519449908146,18438,18395,Brown and Nearby Counties,Jefferson,20,87,Kansas,KS
20117,20CS003,118,117,119,123,5,4,6,24,-7.8468191684049895,-7.477068331950559,-7.05621153454136,3.7403516002978785,145,144,146,132,-13,-14,-12,14,-2.836029222043246,-2.6996862177686767,-2.575628297059724,-1.16887764133717,9963,9984,Brown and Nearby Counties,Marshall,20,117,Kansas,KS
20131,20CS003,114,112,115,158,44,43,46,42,0.5521089640764315,0.9763725881409714,1.3669700578904793,0.9233087505706131,140,139,141,123,-17,-18,-16,7,-2.4640932433164573,-2.3337661804886034,-2.2035919852787322,-0.441976687567175,10211,10216,Brown and Nearby Counties,Nemaha,20,131,Kansas,KS
20015,20CS004,562,533,591,638,76,47,105,38,0.5566210259917477,2.181593605451594,4.108056258613888,0.49558795546583007,695,660,730,790,95,60,130,101,-0.6628944755881638,-0.08966694170914714,0.4162598870753667,1.0539540901024969,67383,67818,Butler+Harvey,Butler,20,15,Kansas,KS
20079,20CS004,344,330,359,380,36,21,50,40,-2.331910654824461,-0.5007894752302822,1.1676860883968117,1.0877404770691588,420,402,437,512,92,75,110,61,0.44136263915992907,0.9379698476740933,1.4595991721433001,0.6536021878219295,34002,33835,Butler+Harvey,Harvey,20,79,Kansas,KS
20009,20CS005,241,230,252,306,65,54,76,36,2.9036914673787466,4.562797918143286,6.2764506012191434,0.5437147666458105,291,278,304,368,77,64,90,50,0.539633223428809,1.0473487753873008,1.593033763195851,0.6426260572112116,25474,25246,Central Kansas,Barton,20,9,Kansas,KS
20051,20CS005,207,194,219,259,52,40,65,57,-2.489628816504025,-0.583964414832614,1.098820151408229,1.0689524489993651,252,238,267,235,-17,-32,-3,18,-1.7376648932650063,-1.2278703031039142,-0.6712581986138242,-1.098548944098246,28876,28811,Central Kansas,Ellis,20,51,Kansas,KS
20053,20CS005,72,71,73,92,20,19,21,17,1.4216258034907039,1.8318063162723994,2.231092360934506,0.8137679562347273,89,88,89,83,-6,-6,-5,8,-2.2579749417539716,-2.131357830853081,-2.0103345975857474,-1.769543218917252,6314,6339,Central Kansas,Ellsworth,20,53,Kansas,KS
20113,20CS005,324,311,337,356,32,19,45,48,-3.840897104676434,-2.1012983373573166,-0.4730213725197993,1.4507984243208283,396,380,411,422,26,11,42,46,-1.1886445590616177,-0.6467894704837822,-0.14758507253922512,1.6772331718582671,29929,30148,Central Kansas,McPherson,20,113,Kansas,KS
20159,20CS005,100,99,101,107,7,6,8,10,-1.7156634461064593,-1.3305572211604277,-0.9222735696464505,1.26573793115493,122,121,124,144,22,20,23,15,0.5797284561680882,0.7076113407733515,0.8368116256064848,0.6621338839174431,9396,9388,Central Kansas,Rice,20,159,Kansas,KS
20167,20CS005,75,74,76,120,45,44,46,19,15.178697534033077,15.577079091762984,15.946112430081293,0.41196002317680774,92,91,92,85,-7,-7,-6,13,-3.04625479890504,-2.9086331392664913,-2.783300631435968,-2.3625009225248754,6704,6698,Central Kansas,Russell,20,167,Kansas,KS
20017,20CS006,28,28,28,21,-7,-7,-7,1,-13.169093948640594,-12.775760335544826,-12.336053450490175,-0.16113546927515193,35,35,35,32,-3,-3,-3,5,-3.147020363839444,-3.024742362151331,-2.89662497526529,-2.719744322801356,2571,2593,Chase+Coffey+Lyon+Marion,Chase,20,17,Kansas,KS
20031,20CS006,86,85,87,89,3,2,4,8,-2.9084487164393096,-2.473110835896038,-2.100533527969793,2.080276586715121,106,105,107,111,5,4,6,15,-1.2829273148372673,-1.1527960711370124,-1.0284501925856036,2.3630733138277193,8333,8343,Chase+Coffey+Lyon+Marion,Coffey,20,31,Kansas,KS
20111,20CS006,240,226,253,323,83,70,97,68,0.14800121791569806,1.875012959140089,3.492468012911775,0.8057321052316374,294,277,310,320,26,10,43,30,-0.648216907720177,-0.11186372989505669,0.4248431571419823,1.0911521259315646,32253,32013,Chase+Coffey+Lyon+Marion,Lyon,20,111,Kansas,KS
20115,20CS006,148,143,153,133,-15,-20,-10,10,-10.01001186085505,-8.416877352472106,-6.572990979475604,-0.7285446799635694,179,173,186,222,43,36,49,29,0.6686447705952437,1.1671324911742231,1.6614420571195447,0.6660444068879747,11761,11718,Chase+Coffey+Lyon+Marion,Marion,20,115,Kansas,KS
20021,20CS007,228,220,236,271,43,35,51,26,1.7630233678699525,3.529431346511447,5.185651145844372,0.5911796880678921,278,268,288,310,32,22,42,43,-1.079252179073604,-0.5519575800299629,-0.08847296682990062,1.2911196589268008,19358,19151,Cherokee+Crawford,Cherokee,20,21,Kansas,KS
20037,20CS007,379,362,396,484,105,88,122,53,3.666319309283573,5.31807652060816,7.106970945966009,0.5001385857567033,470,449,490,518,48,28,69,63,-0.9221684180854249,-0.3625581607264598,0.1480080925851509,1.2737231732314687,38920,39084,Cherokee+Crawford,Crawford,20,37,Kansas,KS
20027,20CS008,84,83,85,90,6,5,7,17,-5.741571786314567,-5.344625121396253,-4.9249738208940075,2.3624716428252217,102,101,103,113,11,10,12,10,0.0011377820784056333,0.13246306687397097,0.25480483738123094,0.8307961159608063,8093,8082,Cloud and Nearby Counties,Clay,20,27,Kansas,KS
20029,20CS008,117,116,118,128,11,10,12,21,-4.9313888704133895,-4.544640892568085,-4.151160677470348,1.7744520586169164,142,141,144,157,15,13,16,17,-0.39923512093664043,-0.27293346805544627,-0.15682830260642294,1.0946392440048358,8951,8937,Cloud and Nearby Counties,Cloud,20,29,Kansas,KS
20089,20CS008,32,32,32,31,-1,-1,-1,1,-3.0233981723920933,-2.5900376511153107,-2.1963060665260787,8.456737704086962,39,39,39,59,20,20,20,11,2.9174954275225162,3.0365101056377592,3.172766242881948,0.5258733682372274,2917,2935,Cloud and Nearby Counties,Jewell,20,89,Kansas,KS
20105,20CS008,30,29,30,39,9,9,10,5,5.536729342569847,5.9364925234310775,6.322748616978985,0.4823994207482468,36,35,36,40,4,4,5,4,-0.01586159110167181,0.1132893082520327,0.23804202025009602,0.7509635076509692,2945,2909,Cloud and Nearby Counties,Lincoln,20,105,Kansas,KS
20123,20CS008,68,67,68,76,8,8,9,4,2.4953154289502466,2.9216110942259492,3.3455261393133644,0.4331041679713745,82,81,83,97,15,14,16,12,0.40749319876688966,0.5312041473867843,0.6514010808724426,0.7478292085638206,5792,5750,Cloud and Nearby Counties,Mitchell,20,123,Kansas,KS
20141,20CS008,49,49,50,48,-1,-2,-1,4,-6.628663024906334,-6.245624429621519,-5.8204754857583865,-9.144434907442092,60,60,61,59,-1,-2,-1,7,-2.5340170083961095,-2.3972116891082047,-2.2672437717350826,-17.55053256550058,3486,3497,Cloud and Nearby Counties,Osborne,20,141,Kansas,KS
20143,20CS008,61,60,61,64,3,3,4,11,-5.831419335155167,-5.446231339640304,-5.006940891790644,2.6211556730892807,75,74,76,75,-0,-1,1,10,-1.8598197214680285,-1.7371724619906013,-1.613247258651381,11.526158121081524,5741,5823,Cloud and Nearby Counties,Ottawa,20,143,Kansas,KS
20157,20CS008,69,69,70,65,-4,-5,-4,10,-12.82026591436453,-12.408759208531285,-11.992610505433936,-2.8995189949807534,85,84,85,86,1,1,2,7,-1.3295248662259576,-1.2061325301714139,-1.0872060940442636,2.961053137448572,4661,4665,Cloud and Nearby Counties,Republic,20,157,Kansas,KS
20183,20CS008,47,47,47,43,-4,-4,-4,5,-10.406097519263017,-10.013887572176326,-9.615985831134429,-1.7112668839386986,57,57,58,55,-2,-3,-2,2,-1.3305696155128879,-1.21214478871362,-1.0916825266887689,-1.5102468419927622,3563,3574,Cloud and Nearby Counties,Smith,20,183,Kansas,KS
20201,20CS008,60,60,61,66,6,5,6,10,-3.3578377805931368,-2.944761433624866,-2.538409194482591,1.440310929640493,73,72,74,83,10,9,11,10,-0.14718558258020792,-0.02903385263706333,0.08716149792910041,0.9229979174005868,5513,5513,Cloud and Nearby Counties,Washington,20,201,Kansas,KS
20041,20CS009,198,190,206,203,5,-3,13,23,-5.661945598017854,-3.916406243673986,-2.1806698717659376,3.7513372733300736,242,233,252,285,43,33,52,47,-0.7459486890518713,-0.22439429099689095,0.29212551156335226,1.0723989653106367,18368,18444,Dickinson+Geary+Morris,Dickinson,20,41,Kansas,KS
20061,20CS009,195,179,211,214,19,3,35,26,-2.637971570381187,-0.7585099465897385,0.8947251154793585,1.2947852566751867,240,222,259,273,33,14,51,40,-0.7141757046532148,-0.19400423065264857,0.3057145177891522,1.1831416063616451,35969,36053,Dickinson+Geary+Morris,Geary,20,61,Kansas,KS
20127,20CS009,64,63,64,77,13,13,14,14,-1.044793035311237,-0.624635710349852,-0.21635829936538972,0.9880196593256104,77,77,78,75,-2,-3,-2,2,-0.9463966593839389,-0.8214850741817281,-0.6907907658284286,-1.4268102201997497,5398,5357,Dickinson+Geary+Morris,Morris,20,127,Kansas,KS
20045,20CS010,622,571,673,729,107,56,158,53,0.04388596203781133,1.7839658246949324,3.4282188037340426,0.49069245993090355,773,711,834,848,75,14,137,40,-0.22043261565369782,0.312468553119766,0.8344396654526813,0.5239811164440559,119375,119283,Douglas,Douglas,20,45,Kansas,KS
20019,20CS011,45,43,46,41,-4,-5,-2,5,-12.192219468527028,-10.340485437883782,-8.583782824575096,-1.8519218452545885,55,53,57,65,10,8,12,10,-0.4520689806252329,0.049044667692631834,0.5699170528070389,0.8947021504626981,3360,3394,Elk and Nearby Counties,Chautauqua,20,19,Kansas,KS
20035,20CS011,370,355,384,429,59,45,74,63,-2.0576562082035847,-0.4214454105820389,1.2144592815244046,1.041873411134453,452,434,469,504,52,35,70,64,-0.8531789463915133,-0.3457850989944474,0.11541786459338918,1.1978897500698562,34540,34496,Elk and Nearby Counties,Cowley,20,35,Kansas,KS
20049,20CS011,33,32,34,36,3,2,4,2,0.3363687364457555,1.9283038764875904,3.6596956983611113,0.475239333951866,40,38,41,50,10,9,12,5,1.7638506186892933,2.241856281510474,2.7051303338637407,0.43537811786850655,2476,2446,Elk and Nearby Counties,Elk,20,49,Kansas,KS
20073,20CS011,82,81,82,87,5,5,6,5,-0.16121822955646933,0.24943090628649683,0.634620807223953,0.7853954977293777,99,98,100,124,25,24,26,13,1.8949848363195483,2.0223538604418283,2.146207896213021,0.49971066860139746,5973,5944,Elk and Nearby Counties,Greenwood,20,73,Kansas,KS
20205,20CS011,92,92,93,112,20,19,20,6,5.899529750792123,6.289633919946761,6.715925462247083,0.29268165127430695,112,111,113,155,43,42,44,26,1.8386998277980153,1.96085112675009,2.0906820960959456,0.594951799769354,8568,8533,Elk and Nearby Counties,Wilson,20,205,Kansas,KS
20207,20CS011,41,40,42,51,10,9,11,2,8.461869369242244,10.127410954793785,11.894834649935106,0.1839756684756969,50,49,52,55,5,3,6,1,0.722141857651901,1.2617657599156076,1.7609779609509253,0.16989501696455697,3102,3102,Elk and Nearby Counties,Woodson,20,207,Kansas,KS
20091,20CS012,3547,3285,3810,3992,445,182,707,479,-1.9268792906116337,-0.2126368905788324,1.5151825043767675,1.0746116000071213,4416,4100,4733,4819,403,86,719,420,-0.5886874619874246,-0.03163158223129201,0.4701051999680139,1.0400612083379608,609709,612828,Johnson,Johnson,20,91,Kansas,KS
20099,20CS013,227,219,236,241,14,5,22,28,-4.76060749821723,-2.8164160273412655,-1.1581551131307906,1.9056844914101823,276,266,287,303,27,16,37,39,-1.14054263505403,-0.6092896197314948,-0.11445092046217467,1.4107815119097444,20037,19942,Labette+Montgomery+Neosho,Labette,20,99,Kansas,KS
20125,20CS013,365,351,378,412,47,34,61,41,-0.8731803589802334,0.8118359885986733,2.393981802134469,0.8487176472748699,443,427,459,542,99,83,115,79,0.10904680980068356,0.6384765430934225,1.1761882917618351,0.7907628961898966,31402,31186,Labette+Montgomery+Neosho,Montgomery,20,125,Kansas,KS
20133,20CS013,174,167,181,192,18,11,25,17,-1.3642780254400326,0.32452138652220475,2.103125936984743,0.8796427255114597,211,203,219,241,30,22,38,39,-1.1022798129256923,-0.6056557569313594,-0.06326127630509794,1.270766362236503,15895,15802,Labette+Montgomery+Neosho,Neosho,20,133,Kansas,KS
20103,20CS014,549,514,584,669,120,85,155,63,0.9277880985177414,2.774568694968595,4.418089208136947,0.5206170665498634,679,636,721,793,114,72,157,88,-0.17763709802993455,0.3106936277369999,0.8815623754872962,0.7630350025476055,81909,82138,Leavenworth,Leavenworth,20,103,Kansas,KS
20023,20CS015,31,31,31,48,17,17,17,12,7.398752617162265,7.831581039356355,8.2409517700461,0.6618170508756417,38,38,38,41,3,3,3,6,-1.2265792000094877,-1.1067245068016358,-0.9839895540162736,1.4666886457324277,2622,2631,Northwest Kansas,Cheyenne,20,23,Kansas,KS
20039,20CS015,39,38,39,35,-4,-4,-3,5,-13.019450120931845,-12.601981124263,-12.177414667863381,-1.8615080542576004,47,47,48,58,11,10,11,10,0.1795708700461123,0.3071633800214614,0.4472196495404073,0.8443426832610221,2759,2751,Northwest Kansas,Decatur,20,39,Kansas,KS
20063,20CS015,29,29,29,47,18,18,18,20,-3.26402949130963,-2.8366554839894853,-2.4264528687104576,1.048016215939145,36,36,36,44,8,8,8,4,1.3021150733796059,1.4313893908482187,1.551005017427706,0.4477299934944133,2696,2746,Northwest Kansas,Gove,20,63,Kansas,KS
20065,20CS015,30,30,30,28,-2,-2,-2,5,-11.72816780347051,-11.324464609940897,-10.916128600283278,-6.0882420744868435,36,36,37,40,4,3,4,2,0.5606511799828905,0.6867703667143101,0.8205287145582919,0.42999395567667775,2410,2401,Northwest Kansas,Graham,20,65,Kansas,KS
20109,20CS015,28,28,28,39,11,11,11,4,9.841775877251575,10.22893771049169,10.620226233196167,0.33276031714118093,34,34,34,50,16,16,16,3,4.641798823427031,4.764804919265704,4.8902864701781255,0.1766539273360309,2746,2725,Northwest Kansas,Logan,20,109,Kansas,KS
20137,20CS015,57,57,58,76,19,18,19,22,-2.7337887313789193,-2.324182822845543,-1.8910097461476487,1.1068725439628835,69,68,70,56,-13,-14,-12,2,-2.9614957415034895,-2.829376992726493,-2.7076114621626677,-0.16423895490034335,5416,5356,Northwest Kansas,Norton,20,137,Kansas,KS
20147,20CS015,58,58,59,65,7,6,7,15,-7.1287479322699925,-6.699600354767245,-6.321592339631919,1.9562045606518215,69,69,70,77,8,7,8,16,-1.8385463118146894,-1.7134136330093555,-1.5926730636661461,1.8371287779700443,4982,4835,Northwest Kansas,Phillips,20,147,Kansas,KS
20153,20CS015,35,35,36,32,-3,-4,-3,4,-12.155515045494608,-11.73550219308669,-11.349376916691641,-1.6231805698954256,43,43,44,37,-6,-7,-6,3,-3.83048539816227,-3.69659061298969,-3.5750006373618666,-0.5516591952373042,2545,2550,Northwest Kansas,Rawlins,20,153,Kansas,KS
20163,20CS015,55,55,56,59,4,3,4,10,-5.551866691399611,-5.171220172049632,-4.763447529892078,2.1436701879394593,67,66,68,73,6,5,7,3,0.5006922844384658,0.6217989255708374,0.7404968242578517,0.4283643420788436,4894,4840,Northwest Kansas,Rooks,20,163,Kansas,KS
20179,20CS015,25,24,25,44,19,19,20,10,14.980792102695515,15.383986492138735,15.78652959946721,0.48896212425569746,30,30,31,40,10,9,10,2,3.008146441214258,3.1254968467215587,3.2446655914508082,0.18643639536080941,2457,2473,Northwest Kansas,Sheridan,20,179,Kansas,KS
20181,20CS015,59,58,59,51,-8,-8,-7,11,-13.201040449929176,-12.741642588416802,-12.378082627015782,-1.6196111975920797,72,71,73,62,-10,-11,-9,4,-2.5086446920970658,-2.3880849758119846,-2.263763963746358,-0.4415046255937606,5891,5893,Northwest Kansas,Sherman,20,181,Kansas,KS
20193,20CS015,70,70,71,69,-1,-2,-1,10,-6.213577936065018,-5.8055148913309145,-5.4279816454713785,-22.670696787228117,86,85,87,72,-14,-15,-13,14,-3.7290039564083264,-3.601264491756801,-3.476946775094417,-1.0453032949281122,7881,7883,Northwest Kansas,Thomas,20,193,Kansas,KS
20195,20CS015,37,37,37,45,8,8,8,2,8.348303963777115,8.754824579748584,9.200009456840649,0.2191186878073566,45,45,45,45,0,-0,0,4,-1.5493573403566467,-1.4221567756309357,-1.3055944936287778,3.9343985406089432,2802,2795,Northwest Kansas,Trego,20,195,Kansas,KS
20199,20CS015,14,14,14,15,1,1,1,5,-11.093885009058909,-10.694593132930715,-10.298237168713177,2.561402929960662,17,17,17,19,2,2,2,3,-0.9002744213551209,-0.7678741182226589,-0.646437368193129,1.0573399998895205,1514,1509,Northwest Kansas,Wallace,20,199,Kansas,KS
20025,20CS016,27,27,27,33,6,6,6,7,-2.4040944507041377,-1.9891409128942206,-1.5617328967224307,0.996940913572932,33,33,34,31,-2,-3,-2,3,-2.8316403786334226,-2.692002101927808,-2.570699330844023,-2.2583491447961292,1978,1976,Pawnee and Nearby Counties,Clark,20,25,Kansas,KS
20033,20CS016,25,25,25,29,4,4,4,2,4.2873775331812265,4.706651507118664,5.137220574083728,0.4014538681397107,31,30,31,32,1,1,2,4,-1.740512364937418,-1.6059625725401478,-1.4720731748775486,1.7243655764815276,1683,1672,Pawnee and Nearby Counties,Comanche,20,33,Kansas,KS
20047,20CS016,38,37,38,69,31,31,32,11,27.86320298822364,28.279490470803548,28.687198858907536,0.34035694863129956,46,46,46,60,14,14,14,2,4.075137275275423,4.186575151613144,4.316161548621636,0.13415925476654303,2874,2842,Pawnee and Nearby Counties,Edwards,20,47,Kansas,KS
20057,20CS016,220,205,235,253,33,18,48,41,-2.6669487071356417,-0.898661488881758,0.7529772059468094,1.2024747572380472,274,257,292,276,2,-16,19,56,-2.1067225265275193,-1.5797053541354777,-1.1172787832148268,20.68363509961591,34076,34166,Pawnee and Nearby Counties,Ford,20,57,Kansas,KS
20083,20CS016,22,22,22,20,-2,-2,-2,2,-9.324612353800644,-8.926473149322087,-8.514435309410697,-2.360098960051165,27,27,27,41,14,14,14,5,5.217783913284711,5.3501595308062075,5.471023645497432,0.33004908101908126,1724,1711,Pawnee and Nearby Counties,Hodgman,20,83,Kansas,KS
20097,20CS016,25,25,25,29,4,4,4,3,1.5257846835288587,1.9337290013654949,2.362769925535807,0.5792203170462675,30,30,31,37,7,6,7,4,1.013323957517642,1.1373544163466291,1.2622491535414746,0.5170162778489299,2448,2401,Pawnee and Nearby Counties,Kiowa,20,97,Kansas,KS
20135,20CS016,38,38,39,55,17,16,17,14,3.739064278119308,4.115691238948498,4.492677938911773,0.7877878383762345,47,47,47,53,6,6,6,3,1.032619151944367,1.1609732116816331,1.2843469005999444,0.42220007416898064,2693,2673,Pawnee and Nearby Counties,Ness,20,135,Kansas,KS
20145,20CS016,72,72,73,82,10,9,10,3,3.8532543498251695,4.26681879961492,4.69297276017788,0.2811201255886676,89,88,90,85,-4,-5,-3,13,-2.8878189208606697,-2.760127639008471,-2.6433973970106184,-4.060616570131255,6262,6228,Pawnee and Nearby Counties,Pawnee,20,145,Kansas,KS
20165,20CS016,50,50,50,58,8,8,8,13,-7.277543449084717,-6.877949385212802,-6.515399255017045,1.4574910086649462,62,61,62,60,-2,-2,-1,1,-1.043793930048013,-0.9213196176916914,-0.7862319911414778,-1.398193062158755,2952,2952,Pawnee and Nearby Counties,Rush,20,165,Kansas,KS
20149,20CS017,167,156,178,180,13,2,24,16,-2.2383569106420538,-0.39486374054790657,1.2200130135232712,1.1108798182518507,208,195,221,225,17,4,30,34,-1.1727796377751887,-0.6692448794505036,-0.16315836453789404,1.8730885156750554,25299,25732,Pottawatomie+Riley+Wabaunsee,Pottawatomie,20,149,Kansas,KS
20161,20CS017,308,277,339,348,40,9,71,22,-0.7465005400831506,1.00554282141745,2.7988802053928623,0.5354215363923258,384,347,421,431,47,10,84,32,-0.3259329735723327,0.2264361153454674,0.7714263621450254,0.6679790972684768,72130,72177,Pottawatomie+Riley+Wabaunsee,Riley,20,161,Kansas,KS
20197,20CS017,54,54,55,57,3,2,3,6,-2.4156254512725455,-1.9993059925998147,-1.5873697350171097,1.687112227972922,67,66,68,92,25,24,26,10,1.9859178196083098,2.1102360416584376,2.2367100400345916,0.3895611581170009,6894,6954,Pottawatomie+Riley+Wabaunsee,Wabaunsee,20,197,Kansas,KS
20155,20CS018,612,585,638,746,134,108,161,94,0.882876073443227,2.58194916635695,4.330472692505105,0.694154371377801,744,712,776,825,81,49,113,75,-0.41500392850784545,0.08683521025081949,0.6113109567742642,0.9161742848493254,61790,61471,Reno,Reno,20,155,Kansas,KS
20169,20CS019,479,455,502,545,66,43,90,77,-2.479745638632545,-0.7950383705513865,0.7851907297347838,1.1413905783698086,586,558,614,736,150,122,178,130,-0.1659354517230827,0.3649095578443403,0.8790599690963885,0.8600930983121651,54183,53938,Saline,Saline,20,169,Kansas,KS
20055,20CS020,204,187,220,275,71,55,88,59,-0.4289644147455499,1.2927842886387249,3.051381072957924,0.8140156657732879,253,234,273,324,71,51,90,45,0.12035993456146378,0.6737665090874246,1.1375702313346365,0.6289370790497533,37993,38135,Scott and Nearby Counties,Finney,20,55,Kansas,KS
20071,20CS020,21,21,21,24,3,3,3,3,0.7608637344019965,1.138790865139796,1.5584139322527608,0.6875526410615862,26,26,26,27,1,1,1,3,-1.4909951367304175,-1.3670580470378253,-1.2275721934633026,1.348424422645825,1270,1300,Scott and Nearby Counties,Greeley,20,71,Kansas,KS
20075,20CS020,20,20,21,20,-0,-1,-0,3,-5.736183301435145,-5.34651674834789,-4.929637188759666,4.515389214852404,25,24,25,27,2,2,3,7,-2.058134571647482,-1.9297772606244628,-1.806000702776865,2.1809802310004094,2496,2485,Scott and Nearby Counties,Hamilton,20,75,Kansas,KS
20093,20CS020,29,28,29,29,0,-0,1,7,-7.184941670303619,-6.7931631654961375,-6.379692558545995,5.329569182170088,35,34,35,48,13,13,14,2,2.7347505977875435,2.8607547510996514,2.9908330674839383,0.14108762774955472,3939,3903,Scott and Nearby Counties,Kearny,20,93,Kansas,KS
20101,20CS020,24,24,25,26,2,1,2,6,-11.904660463958658,-11.518480323072604,-11.137348941783742,2.3983992058481234,30,30,30,33,3,3,3,5,-1.3831099247765926,-1.257538529556447,-1.1352861552321745,1.2407199054126705,1562,1565,Scott and Nearby Counties,Lane,20,101,Kansas,KS
20171,20CS020,45,44,45,55,10,10,11,16,-5.074403854140113,-4.639686232985522,-4.253213945153664,1.443929176567468,55,55,56,72,17,16,17,12,0.7734157735757035,0.9028345748012039,1.029391188331335,0.6805821599972133,5095,5132,Scott and Nearby Counties,Scott,20,171,Kansas,KS
20203,20CS020,19,19,20,31,12,11,12,5,12.015321756375211,12.450563538464753,12.849527115176246,0.3953488306842045,23,23,23,30,7,7,7,7,-0.22087223109930415,-0.0963627559663954,0.02691553834541611,0.8978099293253345,2134,2091,Scott and Nearby Counties,Wichita,20,203,Kansas,KS
20173,20CS021,3917,3692,4142,4833,916,691,1141,497,1.5432343496790193,3.1943790734205715,5.00210556462083,0.5420333705072733,4821,4550,5091,5621,800,530,1071,611,-0.18184650243692976,0.35755025311633204,0.8864004787080029,0.7624550171101132,523084,523889,Sedgwick,Sedgwick,20,173,Kansas,KS
20177,20CS022,1646,1570,1723,1914,268,191,344,239,-1.0301638718797634,0.6442567598297696,2.388843575507136,0.8898232814465065,2018,1926,2110,2153,135,43,227,238,-1.1032860532837334,-0.5797361521585718,-0.0891766324546908,1.7505640226959596,178299,178314,Shawnee,Shawnee,20,177,Kansas,KS
20007,20CS023,49,49,49,66,17,17,17,3,12.902275773623458,13.286448285210513,13.703220032531247,0.16625667970929023,59,58,59,66,7,7,8,5,0.3688156669358029,0.4963312172226288,0.6230101518765893,0.6220684956742245,4227,4123,South Central Kansas,Barber,20,7,Kansas,KS
20077,20CS023,77,77,78,94,17,16,17,14,1.5670568271131826,1.9514639455456326,2.3329783718474864,0.7924493653275364,94,93,94,78,-16,-16,-15,7,-4.348494266695948,-4.222455287813967,-4.096860297810312,-0.48050032194154396,5445,5350,South Central Kansas,Harper,20,77,Kansas,KS
20095,20CS023,158,155,161,212,54,51,57,31,10.978904704137122,12.5145007661621,14.36294855331185,0.5620927355206614,193,189,196,265,72,69,76,35,4.553079460186073,5.036621609233643,5.584873583925877,0.4768057111450205,7384,7400,South Central Kansas,Kingman,20,95,Kansas,KS
20151,20CS023,101,101,102,124,23,22,23,25,-1.487736579865759,-1.0754051001685543,-0.6626901218314134,1.06185422610589,126,125,127,129,3,2,4,6,-0.42443120484300445,-0.2988780439125562,-0.1704566776779392,1.408298673060805,9149,9177,South Central Kansas,Pratt,20,151,Kansas,KS
20185,20CS023,51,50,51,59,8,8,9,8,-0.012909839078488377,0.3815120090109342,0.7548706399397159,0.8525207515709058,62,62,63,81,19,18,19,16,0.5971558814234292,0.7259768749599308,0.8524392780347726,0.8019809462019792,4063,4038,South Central Kansas,Stafford,20,185,Kansas,KS
20191,20CS023,230,221,240,270,40,30,49,42,-2.079556197759878,-0.35034790709214214,1.386612420612627,1.028401829828462,286,275,298,322,36,24,47,30,-0.2856709905512203,0.26610800377485566,0.7897487101424601,0.8164475811311103,22407,22377,South Central Kansas,Sumner,20,191,Kansas,KS
20067,20CS024,51,50,52,60,9,8,10,16,-4.246447605567824,-3.8493744794944242,-3.433517048823231,1.599868602883973,63,63,64,59,-4,-5,-4,16,-2.92357910912457,-2.800737989040604,-2.6749598570433544,-4.571923301197702,7299,7324,Southwest Kansas,Grant,20,67,Kansas,KS
20069,20CS024,45,45,46,55,10,9,10,10,-0.48368801540197054,-0.09213394119092767,0.3053618701105856,0.9192465149774522,55,55,56,66,11,10,11,11,-0.19616584456116895,-0.07399045670875704,0.059340827989868734,0.9494588621287835,5687,5642,Southwest Kansas,Gray,20,69,Kansas,KS
20081,20CS024,25,25,26,25,-0,-1,-0,5,-6.116162636545043,-5.750348323547982,-5.358118820700211,8.654582383267122,31,30,31,35,4,4,5,3,0.22058229288088738,0.34136327588773663,0.462164527892374,0.5697765065568837,3781,3681,Southwest Kansas,Haskell,20,81,Kansas,KS
20119,20CS024,42,42,43,56,14,13,14,5,8.081535555742793,8.491853137281826,8.903573609317315,0.3431518688745196,52,52,53,58,6,5,6,7,-0.4050349442588293,-0.27740103860534543,-0.14669658384391415,1.0167719714539751,4039,4025,Southwest Kansas,Meade,20,119,Kansas,KS
20129,20CS024,32,32,32,36,4,4,4,1,4.235845145027119,4.6355749707445435,5.04643850438098,0.19607925768472237,40,39,40,44,4,4,5,5,-0.33398196961517185,-0.2066068967385542,-0.07620185616901023,0.9198805479370822,2672,2692,Southwest Kansas,Morton,20,129,Kansas,KS
20175,20CS024,117,115,119,141,24,22,26,38,-2.9199776973437594,-2.5224833363117445,-2.0810697606975723,1.5019759279340885,146,143,148,163,17,15,20,14,0.026851561167931814,0.1525134750935842,0.2851181315505881,0.7623256657051668,21763,21759,Southwest Kansas,Seward,20,175,Kansas,KS
20187,20CS024,18,18,18,16,-2,-2,-2,2,-8.106959878785396,-7.7095895222646424,-7.279514585094677,-2.0816195553598904,22,22,22,19,-3,-3,-3,4,-3.5939516283296036,-3.466651122426757,-3.348176376686794,-1.9007725670040188,2057,2048,Southwest Kansas,Stanton,20,187,Kansas,KS
20189,20CS024,40,39,41,46,6,5,7,5,0.37434925890825055,0.7768245400398871,1.156463084664754,0.7117060728149358,50,49,50,53,3,3,4,10,-1.3884740780179365,-1.2668398260681752,-1.1390438862760093,2.3209839322070893,5267,5285,Southwest Kansas,Stevens,20,189,Kansas,KS
20209,20CS025,1213,1141,1286,1474,261,188,333,213,-0.6675274532187521,1.1396635641164383,2.8034504142890704,0.8140009127941167,1486,1399,1572,1648,162,76,249,174,-0.6025466731239087,-0.07178118920096557,0.4583617313535239,1.0658847989372482,168265,167312,Wyandotte,Wyandotte,20,209,Kansas,KS
21001,21CS001,175,167,183,268,93,85,101,44,8.7348491899081,10.406968679188045,12.118691221092005,0.4675924524379518,214,205,224,270,56,46,65,40,0.3008012715695006,0.8298378721321568,1.3356334366338098,0.7077984218683958,18964,18923,Adair and Nearby Counties,Adair,21,1,Kentucky,KY
21045,21CS001,169,162,175,210,41,35,48,25,2.3186892205173644,4.107194766912792,5.864712259210047,0.5901239493885848,206,198,214,242,36,28,44,39,-0.682897345471798,-0.18792790990714622,0.3537931092165018,1.0472611589850451,15930,15869,Adair and Nearby Counties,Casey,21,45,Kentucky,KY
21087,21CS001,129,128,130,141,12,11,13,16,-1.7758297530279337,-1.391291022399656,-1.0030166167952885,1.2192628377466188,160,159,162,164,4,2,5,28,-2.282767190178957,-2.156723143410272,-2.021043892080558,5.895923137903621,11107,11265,Adair and Nearby Counties,Green,21,87,Kentucky,KY
21207,21CS001,218,210,226,272,54,46,62,33,3.0161361601568344,4.6795321893095405,6.355014438902714,0.5990846070926588,268,259,277,310,42,33,51,35,-0.1346005877523035,0.40607498927704067,0.9077996948625666,0.8124878236063482,17989,18130,Adair and Nearby Counties,Russell,21,207,Kentucky,KY
21217,21CS001,269,258,280,311,42,31,53,28,0.41455255019454645,2.1617266992172377,3.8624955889144315,0.6506529631793567,331,318,345,445,114,100,127,66,1.3048932990134647,1.820591555555495,2.3135065332625415,0.5762481940535359,26001,26204,Adair and Nearby Counties,Taylor,21,217,Kentucky,KY
21005,21CS002,213,202,223,246,33,23,44,13,1.710869740218396,3.482168288565412,5.122832269040867,0.3777155459663226,262,250,275,290,28,15,40,47,-1.3192964387958495,-0.8079875646742827,-0.3022108719000794,1.6301650326379786,23716,24011,Anderson+Franklin,Anderson,21,5,Kentucky,KY
21073,21CS002,487,465,509,528,41,19,63,40,-1.6127381111245216,0.027730829071434208,1.7669305763420224,0.9531996056782895,596,569,623,754,158,131,185,79,1.0000746327579628,1.5209165912071103,2.047124062929306,0.4974008032617534,51481,51666,Anderson+Franklin,Franklin,21,73,Kentucky,KY
21003,21CS003,204,195,213,231,27,18,36,30,-2.2639354903182007,-0.5717617911464934,0.9957518075706957,1.0631092245797367,250,239,261,288,38,27,49,47,-0.9735704062621554,-0.41312939713457786,0.09726611291457801,1.200210962464977,20722,20768,Barren and Nearby Counties,Allen,21,3,Kentucky,KY
21009,21CS003,447,428,466,507,60,41,79,45,-0.36223160848636193,1.3127401657680948,3.1851878714579973,0.7377833230485046,547,524,570,653,106,83,129,111,-0.6128317265143007,-0.11484330918798133,0.4069265418609151,1.0352724021590654,44417,44530,Barren and Nearby Counties,Barren,21,9,Kentucky,KY
21099,21CS003,195,187,203,227,32,24,40,31,-1.6734958807175244,0.18112933165447556,1.768382129355859,0.9436925970877882,240,230,250,269,29,19,39,45,-1.3436205149522573,-0.8136002461422989,-0.3071435790021883,1.5069167326123374,19253,19432,Barren and Nearby Counties,Hart,21,99,Kentucky,KY
21169,21CS003,118,117,119,148,30,29,31,14,5.91126416727394,6.3152835586152705,6.714779199648422,0.44890737935870206,145,144,147,160,15,13,16,34,-2.0061626438667455,-1.8736426429939528,-1.7589541779650437,2.178331659276184,10252,10338,Barren and Nearby Counties,Metcalfe,21,169,Kentucky,KY
21171,21CS003,150,145,155,152,2,-3,7,37,-14.152696416116898,-12.48706317240092,-10.6898143963241,11.835959523357882,182,176,188,185,3,-3,9,37,-3.523516526801582,-3.0433570021727845,-2.54363343674124,9.92814773369536,11200,11243,Barren and Nearby Counties,Monroe,21,171,Kentucky,KY
21011,21CS004,147,142,153,150,3,-3,8,10,-3.9528451730951075,-2.37813537026505,-0.6929146267793056,2.736424019814014,180,174,187,220,40,33,46,19,1.107704926117653,1.6465895179953691,2.137334694573666,0.4652573896356528,12690,12768,Bath+Clark+Montgomery+Rowan,Bath,21,11,Kentucky,KY
21049,21CS004,366,351,382,396,30,14,45,17,-0.41994570353306515,1.3388041316377812,3.069448465030466,0.5565677319532149,446,427,465,518,72,53,91,31,0.5835072371887449,1.1058448904703735,1.6115844726518247,0.4270778938237048,36881,36890,Bath+Clark+Montgomery+Rowan,Clark,21,49,Kentucky,KY
21173,21CS004,269,257,281,306,37,25,49,20,0.7550353267964922,2.444104865444457,4.229786145014369,0.5219133330336655,329,314,343,428,99,85,114,67,0.6258895154717562,1.1607377168678474,1.6589987791856131,0.6683238819558877,28120,28200,Bath+Clark+Montgomery+Rowan,Montgomery,21,173,Kentucky,KY
21205,21CS004,198,188,209,230,32,21,42,11,1.683776582697257,3.3307967807120433,5.006487149917789,0.33710094804959284,244,231,257,327,83,70,96,45,1.035210482979249,1.549617937985861,2.0224966478783943,0.5347619015711615,24714,24842,Bath+Clark+Montgomery+Rowan,Rowan,21,205,Kentucky,KY
21013,21CS005,318,307,328,362,44,34,55,40,-1.1573643873515689,0.6768605475807123,2.3433535820551468,0.8820552518306028,385,372,397,541,156,144,169,80,2.703848826710907,3.188497944641342,3.743357376887686,0.5086174006490696,24237,23870,Bell+Harlan,Bell,21,13,Kentucky,KY
21095,21CS005,365,353,376,471,106,95,118,31,9.665475311391495,11.369121660960586,13.015205680889714,0.2892492666990843,441,427,454,587,146,133,160,87,1.743742732060002,2.269645391394232,2.7776386251018765,0.5900502557215381,26528,26241,Bell+Harlan,Harlan,21,95,Kentucky,KY
21015,21CS006,828,769,886,911,83,25,142,91,-2.0597897260353832,-0.2429317803952927,1.5637800411882845,1.0801123450034773,1032,961,1103,1167,135,64,206,160,-0.6793671436174156,-0.17555833443334834,0.3139397625624714,1.1753794036970824,136110,137265,Boone,Boone,21,15,Kentucky,KY
21017,21CS007,205,196,213,202,-3,-11,6,1,-2.3852544945016936,-0.7527308668841061,1.0592685103513544,-0.6013312097226197,251,240,261,333,82,72,93,37,1.6891734841483543,2.2462769997048757,2.77553700256887,0.44532391196284526,20205,20237,Bourbon+Fleming+Lewis+Nicholas,Bourbon,21,17,Kentucky,KY
21069,21CS007,164,157,170,179,15,9,22,17,-2.155017641424861,-0.5118165683371773,1.3621840332103357,1.047714555588417,202,194,210,208,6,-2,14,29,-2.0216645878397572,-1.5221439829529417,-1.0174185386463606,4.343547481383378,15029,15205,Bourbon+Fleming+Lewis+Nicholas,Fleming,21,69,Kentucky,KY
21135,21CS007,157,151,162,174,17,12,23,29,-5.344620635481291,-3.5954998230271085,-1.8266480708071653,1.5795667392310762,190,184,197,228,38,31,44,39,-0.5935151399019969,-0.09094510591713435,0.39343556923031314,1.007450372132527,13089,12998,Bourbon+Fleming+Lewis+Nicholas,Lewis,21,135,Kentucky,KY
21181,21CS007,87,86,88,77,-10,-11,-9,4,-7.964236994370631,-7.591256406760225,-7.195143189333418,-0.4327426742427143,109,108,110,116,7,6,8,21,-1.990290865379568,-1.867313725028384,-1.7273675077421866,2.727093368884688,7512,7686,Bourbon+Fleming+Lewis+Nicholas,Nicholas,21,181,Kentucky,KY
21019,21CS008,569,549,590,641,72,51,92,50,0.031406841711855295,1.7922305226038804,3.5243912980069223,0.6892487329865618,698,673,723,788,90,65,115,78,-0.23030565463468655,0.2508748437497854,0.7240878616403378,0.8587878478243528,47951,47939,Boyd+Carter+Greenup,Boyd,21,19,Kentucky,KY
21043,21CS008,292,280,303,304,12,1,24,22,-3.1497906091627725,-1.4528826361111467,0.2908123750268654,1.6782483714987702,357,344,371,430,73,59,86,56,0.13962927182490553,0.6230998562145793,1.1748347865909052,0.7603877702027076,26586,26436,Boyd+Carter+Greenup,Carter,21,43,Kentucky,KY
21089,21CS008,425,410,441,498,73,57,88,37,2.251285050151281,3.9833627565967036,5.730968083370953,0.5019917979496094,521,503,539,575,54,36,72,66,-0.866812221905243,-0.3295984817109457,0.14157486845003256,1.200812033596744,35731,35679,Boyd+Carter+Greenup,Greenup,21,89,Kentucky,KY
21021,21CS009,302,289,315,339,37,24,50,45,-2.9092689794545543,-1.1184957087489433,0.6216435942872724,1.1920724728432406,373,357,389,441,68,52,84,55,-0.0831725388131141,0.4255987783948227,0.957923424702423,0.796423072018251,30604,30740,Boyle+Lincoln+Mercer,Boyle,21,21,Kentucky,KY
21137,21CS009,262,251,272,309,47,37,58,37,0.006712724938527793,1.7312329771638704,3.4085256680809293,0.7658436412926025,321,308,333,433,112,100,125,64,1.4385731917381563,1.993482582040176,2.497416697626575,0.5662219834530289,24280,24242,Boyle+Lincoln+Mercer,Lincoln,21,137,Kentucky,KY
21167,21CS009,256,247,266,260,4,-6,13,25,-5.63122263985094,-3.8713075529125947,-2.0745079193336124,5.476274982643544,318,306,329,350,32,21,44,51,-1.3275650396138658,-0.8148249172655293,-0.283312398335573,1.5275826917945865,22539,22816,Boyle+Lincoln+Mercer,Mercer,21,167,Kentucky,KY
21023,21CS010,83,82,83,90,7,7,8,8,-0.685422386407834,-0.2957236082820404,0.14101835336825286,0.9531203690229286,102,101,103,139,37,36,38,22,1.6791984705263225,1.8008573568768391,1.9206989977375912,0.5760608021276108,8386,8432,Bracken and Nearby Counties,Bracken,21,23,Kentucky,KY
21097,21CS010,198,190,206,209,11,3,19,11,-1.723979928154757,0.021716155425598536,1.7237258955660768,0.9194690557966643,245,236,255,296,51,41,60,43,-0.10583592406096595,0.3919602198633484,0.9548001447608444,0.8329437434903214,18750,18914,Bracken and Nearby Counties,Harrison,21,97,Kentucky,KY
21161,21CS010,203,195,210,197,-6,-13,2,21,-7.96072192518447,-6.213083987467213,-4.573795297081964,-4.584227624634973,247,238,255,272,25,17,34,44,-1.612200842820394,-1.0934378520727597,-0.5889911040852359,1.666958977664378,17064,16953,Bracken and Nearby Counties,Mason,21,161,Kentucky,KY
21191,21CS010,147,141,154,153,6,-1,12,8,-2.3571233502225484,-0.6965302665550076,1.1181050097198033,1.2022168756222211,181,173,188,209,28,21,36,23,-0.13745358520923756,0.35999871234541125,0.8887259100822273,0.791884194608714,14626,14612,Bracken and Nearby Counties,Pendleton,21,191,Kentucky,KY
21201,21CS010,27,27,27,39,12,12,12,1,19.763008776031736,20.158014033793194,20.510071668913195,0.076822038356067393,34,34,34,39,5,5,5,7,-0.9791875239238328,-0.8608196132356819,-0.7298228576472079,1.1528985463184884,2186,2246,Bracken and Nearby Counties,Robertson,21,201,Kentucky,KY
21027,21CS011,204,195,213,249,45,36,54,15,4.110000859201102,5.8804303664866096,7.605255662189759,0.32498751406991633,250,239,261,353,103,92,114,44,2.3478881580494404,2.8854476348202485,3.374861518562619,0.42249497401605945,20460,20619,Breckinridge+Grayson+Hancock+Meade,Breckinridge,21,27,Kentucky,KY
21085,21CS011,280,269,291,314,34,23,45,40,-2.600604456500906,-0.8412263178166646,0.7274318136599294,1.1409995640106458,341,328,355,447,106,92,119,65,1.0425660968135628,1.5125154246761088,2.036091240247879,0.6092686673095224,26426,26507,Breckinridge+Grayson+Hancock+Meade,Grayson,21,85,Kentucky,KY
21091,21CS011,77,76,78,102,25,24,26,4,8.940080740428984,9.363664614586767,9.75539817878798,0.1530270059328189,95,94,96,114,19,18,20,8,1.1182074769446344,1.2432727045934202,1.3788237239208339,0.3939175707656139,9034,9068,Breckinridge+Grayson+Hancock+Meade,Hancock,21,91,Kentucky,KY
21163,21CS011,235,222,248,243,8,-5,21,13,-2.303801973560612,-0.7052647049815154,0.920289702348667,1.4681677558566257,289,274,305,356,67,51,82,63,-0.3848167395331943,0.1169564541372669,0.6539246662206682,0.9300369390237702,29797,30109,Breckinridge+Grayson+Hancock+Meade,Meade,21,163,Kentucky,KY
21029,21CS012,569,534,605,699,130,94,165,63,1.6352443685449223,3.2620606659493667,5.078738484741988,0.48200660204712253,704,661,747,850,146,103,189,103,-0.0011887589828342136,0.5296744338118851,1.0091876918370717,0.7014511237865761,82287,82827,Bullitt+Spencer,Bullitt,21,29,Kentucky,KY
21215,21CS012,148,139,156,157,9,1,18,12,-2.4071147609621644,-0.5627024866197677,1.1817494987955988,1.1771647940365124,184,174,194,213,29,19,39,26,-0.3373273800311456,0.1507807591490899,0.6506187530818333,0.8644641385845253,19562,19865,Bullitt+Spencer,Spencer,21,215,Kentucky,KY
21031,21CS013,145,140,150,170,25,20,30,20,-0.20196872260176446,1.569812116467657,3.371715295776471,0.7697312909684133,176,170,183,189,13,6,19,30,-1.9315040045768135,-1.4118254116894327,-0.8413824830040135,2.2041751598885218,12395,12298,Butler+McLean+Muhlenberg+Ohio,Butler,21,31,Kentucky,KY
21149,21CS013,101,100,102,128,27,26,28,16,4.58309931973698,4.957825474011456,5.389183360794873,0.5646215290051632,123,122,124,145,22,21,23,21,-0.04852050206149801,0.0743028976019043,0.20132269742720518,0.925828546509132,9120,9102,Butler+McLean+Muhlenberg+Ohio,McLean,21,149,Kentucky,KY
21177,21CS013,333,319,346,364,31,18,45,42,-3.1135636924649646,-1.394771536095959,0.34374513112740546,1.2985015147494827,406,390,422,481,75,59,91,61,-0.05727179433296097,0.4564360035189684,1.0012595795032735,0.8011432540783447,30828,30720,Butler+McLean+Muhlenberg+Ohio,Muhlenberg,21,177,Kentucky,KY
21183,21CS013,247,236,257,260,13,3,24,29,-4.256252029678235,-2.609687224463472,-0.9455719763829886,2.008593760054084,301,289,314,371,70,57,82,46,0.49418834976482345,0.9951328397793328,1.5061586641457545,0.6523233226414427,23768,23694,Butler+McLean+Muhlenberg+Ohio,Ohio,21,183,Kentucky,KY
21035,21CS014,329,313,345,404,75,59,91,40,1.9500650164936701,3.6881057648407825,5.526146776220571,0.5248136157875855,406,386,425,509,103,84,123,40,1.1671096839260462,1.7052323919548307,2.2011862036440912,0.3835694460740642,37471,37500,Calloway+Marshall,Calloway,21,35,Kentucky,KY
21157,21CS014,380,366,393,385,5,-8,19,35,-5.643197666230969,-3.8145384416631143,-2.203792208723303,5.642283958385622,466,449,482,510,44,28,61,48,-0.6166611186865577,-0.10704831898491833,0.38467726515513584,1.0565342069189305,31593,31736,Calloway+Marshall,Marshall,21,157,Kentucky,KY
21037,21CS015,745,705,785,817,72,32,112,58,-1.1971455113553624,0.589268111601151,2.231549889326488,0.793379471824832,914,866,962,956,42,-6,90,84,-0.9823477708100947,-0.4370073208158,0.05821683551117824,1.9729702973691192,93192,93055,Campbell,Campbell,21,37,Kentucky,KY
21047,21CS016,534,503,566,668,134,102,165,72,1.8014895388156513,3.422989892323743,5.160043693678673,0.5352051046609302,660,622,697,834,174,137,212,102,0.5104274107609403,1.0036403127733793,1.4870434897322038,0.5818711149697929,72498,72406,Christian,Christian,21,47,Kentucky,KY
21051,21CS017,240,232,249,236,-4,-13,4,21,-6.742150353209367,-5.024080528356785,-3.308785911141254,-6.2827377374197715,296,286,306,389,93,83,103,43,1.9979266652717003,2.4759021925544387,2.961283928998815,0.45745082900350653,20229,20219,Clay+Jackson+Leslie+Owsley,Clay,21,51,Kentucky,KY
21109,21CS017,154,149,160,173,19,13,24,23,-3.180740920917883,-1.2288087286469207,0.31591851527893383,1.164244772533262,190,183,197,224,34,27,41,42,-1.1278547035861592,-0.6368529562742591,-0.13053263608153298,1.205116399963356,13008,12979,Clay+Jackson+Leslie+Owsley,Jackson,21,109,Kentucky,KY
21131,21CS017,140,139,141,132,-8,-9,-7,3,-4.613141054853251,-4.239144275832071,-3.8296696895815585,-0.4319313959764695,171,170,173,206,35,33,36,29,0.4413213200470798,0.5556188091574584,0.6747877418452078,0.8116512449684722,10353,10304,Clay+Jackson+Leslie+Owsley,Leslie,21,131,Kentucky,KY
21189,21CS017,58,57,58,91,33,33,34,12,20.47522451295885,20.86435665753349,21.27728790720014,0.35048623376073157,69,69,70,83,14,13,14,7,1.6050330504651589,1.7387635342829686,1.8600324140577846,0.47087713969277806,4069,3962,Clay+Jackson+Leslie+Owsley,Owsley,21,189,Kentucky,KY
21053,21CS018,104,103,105,145,41,40,42,21,8.194893312093617,8.59307491921665,8.974576719433898,0.4986031566487185,126,125,127,157,31,30,32,21,0.9722895255192271,1.0902426329032588,1.215773226503579,0.6543424883568255,9365,9258,Clinton+Cumberland+McCreary+Wayne,Clinton,21,53,Kentucky,KY
21057,21CS018,78,78,79,97,19,18,19,4,9.55029277844274,9.941352872427991,10.36418311940847,0.20145476028540063,94,93,95,111,17,16,18,11,0.8661331902808449,0.9946417055021594,1.1221678055458681,0.6167934286995356,5971,5876,Clinton+Cumberland+McCreary+Wayne,Cumberland,21,57,Kentucky,KY
21147,21CS018,189,181,196,198,9,2,17,11,-2.1719966947403857,-0.39041038952825635,1.439171222583412,1.056062291828892,230,221,239,286,56,47,65,57,-0.6305244132089388,-0.08241331678924155,0.4630075511608227,1.0033719665947936,16915,16886,Clinton+Cumberland+McCreary+Wayne,McCreary,21,147,Kentucky,KY
21231,21CS018,197,188,205,258,61,53,70,26,5.421514749708123,7.188774555763932,8.919613644228866,0.41733007180622933,240,230,250,334,94,84,104,46,1.991635646769077,2.4455537474564695,2.973395924085487,0.48398272471961656,19639,19538,Clinton+Cumberland+McCreary+Wayne,Wayne,21,231,Kentucky,KY
21059,21CS019,947,902,991,1034,87,43,132,92,-1.9456580126324352,-0.1450981218715229,1.5227434069516825,1.0411054318790587,1160,1107,1214,1308,148,94,201,191,-0.9545015888315417,-0.4120325303824602,0.05962915015825571,1.285305037126386,103014,103096,Daviess,Daviess,21,59,Kentucky,KY
21061,21CS020,135,130,140,140,5,-0,10,19,-6.379349608416071,-4.684300330718748,-2.9300786035706095,3.2946638495328213,166,160,173,187,21,14,27,29,-1.1979461397423503,-0.6588781763170876,-0.16668804812210125,1.3318055730579117,12151,12268,Edmonson+Warren,Edmonson,21,61,Kentucky,KY
21227,21CS020,922,864,980,1081,159,101,217,95,0.18692214006820693,1.9252073113792783,3.7533869029614615,0.5939332873322128,1149,1078,1219,1334,185,115,256,158,-0.31451087613067485,0.19068256754477436,0.6993963381468871,0.8473052556386325,134853,136880,Edmonson+Warren,Warren,21,227,Kentucky,KY
21063,21CS021,67,66,68,65,-2,-3,-1,3,-3.0591958975695257,-2.656093113087997,-2.2529757666093073,-3.3710004252084236,83,82,84,114,31,30,32,15,2.064640645246784,2.1898581210436903,2.3237066301415803,0.46650339254149276,7361,7374,Elliott+Johnson+Lawrence+Magoffin,Elliott,21,63,Kentucky,KY
21115,21CS021,273,264,283,302,29,19,38,17,0.30241981332505796,2.064436515961485,3.880091601374031,0.5758916021420347,335,324,347,435,100,88,111,68,0.8966523380417951,1.416726618890455,1.8921576411163297,0.6745838324382137,22561,22567,Elliott+Johnson+Lawrence+Magoffin,Johnson,21,115,Kentucky,KY
21127,21CS021,191,184,198,182,-9,-16,-2,14,-7.425952997337847,-5.7195753789779875,-4.171385644363224,-1.7047015808856147,236,227,244,272,36,28,45,37,-0.5548705814330782,-0.05602639697167796,0.49419246607621264,0.9949158887306317,16158,16290,Elliott+Johnson+Lawrence+Magoffin,Lawrence,21,127,Kentucky,KY
21153,21CS021,142,137,147,152,10,5,15,10,-1.6191797828528895,0.045491827460485953,1.667776741860292,0.9029271384158463,172,166,178,214,42,36,48,24,1.0153961366042386,1.5404990157926473,2.0400221735875967,0.5616395448755312,11670,11511,Elliott+Johnson+Lawrence+Magoffin,Magoffin,21,153,Kentucky,KY
21065,21CS022,172,166,178,195,23,17,29,11,1.5061293126502089,3.334033385114287,4.952636529282989,0.4622203911497563,210,203,217,271,61,54,68,27,1.9127841956735283,2.4134716478208884,2.9076638407614808,0.43513373345510503,14131,14098,Estill+Madison+Rockcastle,Estill,21,65,Kentucky,KY
21151,21CS022,710,669,750,833,123,83,164,63,0.8190911197190085,2.5912898001070346,4.344829964718777,0.5062047258256056,888,839,937,1070,182,133,231,142,-0.07976253987471311,0.4265404112719141,0.9416230561583667,0.7759061183045903,93128,94411,Estill+Madison+Rockcastle,Madison,21,151,Kentucky,KY
21203,21CS022,168,161,175,192,24,17,31,13,1.1147463658762833,2.732383211328628,4.420140247050277,0.5179071906307905,206,197,214,316,110,102,119,39,3.9307976940630853,4.427721337700826,4.957433064518597,0.3501213520293474,16159,16106,Estill+Madison+Rockcastle,Rockcastle,21,203,Kentucky,KY
21067,21CS023,2089,1950,2228,2478,389,250,528,142,1.3592690087789683,3.106665934851699,4.758022194444827,0.3640083148067771,2571,2405,2737,2828,257,91,423,229,-0.41322671056822624,0.0827920089289516,0.6082697598982503,0.8879857984977916,322561,321882,Fayette,Fayette,21,67,Kentucky,KY
21071,21CS024,457,442,472,541,84,69,99,46,2.581201939134404,4.186978751385678,5.937442476968994,0.5419377662768041,552,534,571,675,123,104,141,110,-0.18475340091569323,0.35972115714823344,0.8668919003277253,0.8903016596387012,35671,35344,Floyd+Martin,Floyd,21,71,Kentucky,KY
21159,21CS024,131,126,136,140,9,4,14,6,-0.5322768070431899,1.0754275195901177,2.8605066146940357,0.5950817625410528,159,153,165,184,25,19,31,29,-0.8694752724332063,-0.36475133273772947,0.20329371110298708,1.1153158004821628,11223,11153,Floyd+Martin,Martin,21,159,Kentucky,KY
21079,21CS025,155,148,162,203,48,41,55,22,4.422996279327192,6.07769443494318,7.847951165728525,0.4491309688478537,193,184,202,241,48,39,57,33,0.35050692863488175,0.8731686584516225,1.3771778911145371,0.670059897134109,17089,17300,Garrard+Jessamine,Garrard,21,79,Kentucky,KY
21113,21CS025,414,391,437,454,40,17,63,49,-2.361537697986112,-0.6956492921648801,1.0624764901686372,1.1974234568059794,513,485,541,595,82,54,110,51,0.054284390754409974,0.5675039670654141,1.0973177602396247,0.6148939744664998,53192,53531,Garrard+Jessamine,Jessamine,21,113,Kentucky,KY
21093,21CS026,828,781,876,1003,175,127,222,84,1.6297432883923582,3.273660260583319,4.896085341525584,0.4783341331780044,1030,972,1088,1394,364,306,422,223,0.758599694950676,1.269870236053473,1.7676272089874243,0.6110045246841179,110848,111478,Hardin+Larue,Hardin,21,93,Kentucky,KY
21123,21CS026,161,154,167,162,1,-5,8,6,-3.1118459267887864,-1.2574256696993262,0.3911894415437586,2.6947952988351225,199,191,207,223,24,16,32,34,-1.1946683760998122,-0.6675712047107836,-0.15213115751026454,1.3618181802778688,14817,15005,Hardin+Larue,Larue,21,123,Kentucky,KY
21101,21CS027,429,410,448,543,114,95,133,60,2.9302740543269152,4.780965369536521,6.477398149864166,0.5224240010110603,521,498,544,631,110,87,133,71,0.382432671916063,0.8895106022116629,1.3915744191482968,0.6377989200248323,44704,44375,Henderson+Union,Henderson,21,101,Kentucky,KY
21225,21CS027,145,139,151,142,-3,-9,3,13,-6.33556494747364,-4.582856910506752,-2.907464341856638,-7.187340272566491,175,168,182,245,70,63,77,40,1.7242095638327177,2.2378920017413177,2.721361127866668,0.5606334482539965,13759,13559,Henderson+Union,Union,21,225,Kentucky,KY
21103,21CS028,161,155,168,164,3,-4,9,3,-1.7200585751305333,-0.02202325625235178,1.8043334184273458,0.8017329634619803,197,189,205,230,33,25,41,29,-0.22614547805047558,0.2575017666662906,0.7792383294056591,0.8447492651696645,15723,15658,Henry+Shelby,Henry,21,103,Kentucky,KY
21211,21CS028,332,311,352,416,84,64,105,39,2.097645216720734,3.731197021570579,5.5033650437793575,0.457347299428371,410,385,435,507,97,72,122,77,-0.1070565814862254,0.41229626120216323,0.9282416864721357,0.7893507737903512,48331,48420,Henry+Shelby,Shelby,21,211,Kentucky,KY
21107,21CS029,504,484,523,613,109,90,129,95,-0.4102702078884052,1.227265460897913,2.852478552095162,0.8617138973627955,608,585,632,755,147,123,170,103,0.4384586854089942,0.9517839625608426,1.463300983917221,0.6971277071726413,45240,45171,Hopkins+Webster,Hopkins,21,107,Kentucky,KY
21233,21CS029,147,141,153,174,27,21,33,23,-0.4689191831214819,1.240061279008245,2.8705182388883634,0.8226610816100264,176,170,183,205,29,22,35,28,-0.4172148476304546,0.057369743074153344,0.5972929429927946,0.9406895903268556,12964,12839,Hopkins+Webster,Webster,21,233,Kentucky,KY
21111,21CS030,6914,6579,7250,8138,1224,888,1559,753,0.6526910831432076,2.409420130291622,4.167783064818252,0.6147747753158466,8450,8048,8852,9544,1094,692,1496,907,-0.27245077882125923,0.2389079845670951,0.7619485081486168,0.8282227258491734,779589,778494,Jefferson,Jefferson,21,111,Kentucky,KY
21117,21CS031,1334,1262,1407,1390,56,-17,128,109,-2.9273762720527383,-1.247673847069965,0.3423278244833294,1.9234915143225737,1641,1553,1728,1751,110,23,198,197,-1.05483680681791,-0.5302382336295943,-0.01524456378004661,1.7681511289954837,168946,169450,Kenton,Kenton,21,117,Kentucky,KY
21119,21CS032,169,163,175,197,28,22,34,11,3.288953443603771,4.913472549523252,6.513489197805233,0.37689852875222646,206,199,213,268,62,55,69,34,1.4708626867805004,1.9779028756300656,2.485602043161811,0.5404849293438685,14251,14069,Knott+Letcher+Perry,Knott,21,119,Kentucky,KY
21133,21CS032,286,277,295,324,38,29,47,24,0.8433374874148651,2.5323688730260283,4.301303122717417,0.6173103857033071,349,338,360,421,72,61,83,61,-0.009674741279967447,0.49057624556942825,1.0027877478146803,0.8403061298846712,21429,21279,Knott+Letcher+Perry,Letcher,21,133,Kentucky,KY
21193,21CS032,404,392,416,436,32,20,44,33,-1.8766912564414298,-0.20124471923010792,1.4996263084639325,1.006322772913908,494,480,509,594,100,85,114,87,-0.03839890406345784,0.45915360326764193,1.0021378832734966,0.8621186620790813,27955,27994,Knott+Letcher+Perry,Perry,21,193,Kentucky,KY
21121,21CS033,337,324,350,411,74,61,87,30,4.169359922724132,5.722930951628883,7.388684233160275,0.4013691292695999,407,392,423,520,113,97,128,84,0.45685552588687767,0.948779142582471,1.4407853119982896,0.7388162800468218,30260,29942,Knox+Whitley,Knox,21,121,Kentucky,KY
21235,21CS033,430,414,446,474,44,28,60,25,0.3709309817253462,2.118260518640524,3.8715642377789496,0.5522596725749712,526,507,545,635,109,90,128,108,-0.49242041370073364,0.027352846486209254,0.5596305373119421,0.9813774627335912,36666,36902,Knox+Whitley,Whitley,21,235,Kentucky,KY
21125,21CS034,585,559,612,687,102,75,128,27,3.055942353074213,4.760529311198337,6.51259427094581,0.2631898310346154,719,687,752,936,217,184,249,142,0.6875089831552029,1.2061815997012155,1.7371922760877307,0.6523039246929755,62386,62576,Laurel,Laurel,21,125,Kentucky,KY
21141,21CS035,282,270,293,317,35,24,47,40,-2.3739003046052423,-0.6803507073247517,1.2003194518056661,1.097151711270665,347,333,362,386,39,24,53,41,-0.6066380756571004,-0.09486171320918498,0.4451899747300307,1.0350979314604116,27469,27731,Logan+Simpson+Todd,Logan,21,141,Kentucky,KY
21213,21CS035,195,187,204,222,27,18,35,24,-1.1733509379831588,0.5241922279488734,2.361447469693076,0.8661768203893357,241,231,251,264,23,13,33,55,-2.137066839201481,-1.618638449850069,-1.1361527662530007,2.2991427243320177,19471,19704,Logan+Simpson+Todd,Simpson,21,213,Kentucky,KY
21219,21CS035,119,118,120,121,2,1,3,13,-3.8986213035421406,-3.5209675714334714,-3.1022631572152792,4.022737697906235,146,144,148,183,37,35,39,20,1.2542163867980636,1.382379816004974,1.5122596496831426,0.5266394156127754,12286,12284,Logan+Simpson+Todd,Todd,21,219,Kentucky,KY
21033,21CS036,146,141,152,145,-1,-7,4,14,-6.385587893921195,-4.691341245476814,-3.0486416144341266,-116.24778849314455,178,172,185,209,31,24,37,30,-0.4550224047902389,0.06030136496846371,0.5389479910918809,0.9451702079413821,12646,12625,Lyon and Nearby Counties,Caldwell,21,33,Kentucky,KY
21055,21CS036,110,109,110,112,2,2,3,12,-4.68949889353587,-4.269216532472534,-3.8721683437547734,3.4989132330895054,134,133,135,157,23,22,24,23,-0.15668498738821465,-0.030884134122124495,0.08837501731966775,0.9697614948506805,8955,8953,Lyon and Nearby Counties,Crittenden,21,55,Kentucky,KY
21139,21CS036,125,122,129,154,29,25,32,19,2.6284523802661486,4.3613003936228925,5.92638969284901,0.6416497287717601,154,149,158,174,20,16,25,27,-1.2220020922145547,-0.7490345554208944,-0.21469821976239029,1.2636591556786512,8901,8942,Lyon and Nearby Counties,Livingston,21,139,Kentucky,KY
21143,21CS036,105,104,106,112,7,6,8,12,-2.876487999972507,-2.484383898351727,-2.120257223182734,1.5682254428568214,132,130,133,139,7,6,9,13,-0.7639538432790386,-0.6345032456055418,-0.515676669331381,1.5475307543996975,8619,8783,Lyon and Nearby Counties,Lyon,21,143,Kentucky,KY
21221,21CS036,152,146,158,196,44,38,50,6,8.882061247601813,10.576840903498969,12.382613602908021,0.13446489678018866,187,180,194,258,71,64,78,25,2.7430440113776475,3.2695647223782154,3.754772882774776,0.3464911749743224,14168,14174,Lyon and Nearby Counties,Trigg,21,221,Kentucky,KY
21145,21CS037,703,674,732,795,92,63,121,76,-0.8323551870366861,0.9991508689124662,2.701702400778143,0.8157693250837222,856,821,891,1006,150,115,185,109,0.09695781098879848,0.6178708441396304,1.1142923858118647,0.7234230210790559,67473,67510,McCracken,McCracken,21,145,Kentucky,KY
21155,21CS038,189,180,197,232,43,35,52,27,1.6589780590458565,3.381738368141299,5.015442354473724,0.6080765864457142,233,223,243,256,23,13,33,30,-0.8783909862955697,-0.34459910809343886,0.17768608397130678,1.242490877080633,19545,19704,Marion+Nelson+Washington,Marion,21,155,Kentucky,KY
21179,21CS038,388,368,408,441,53,33,73,36,-0.29854360179414746,1.4489113109602905,3.1574310825826006,0.6650670051585186,480,456,505,615,135,110,159,87,0.5039078552126569,1.012128595068427,1.532261793571113,0.6409594032550286,46714,47048,Marion+Nelson+Washington,Nelson,21,179,Kentucky,KY
21229,21CS038,130,125,136,150,20,14,25,27,-4.231468430948851,-2.4590790071212627,-0.8514694300539106,1.3108402451682148,160,154,166,151,-9,-15,-3,18,-2.765369575009603,-2.2200101784866835,-1.7235404335898676,-2.2764176574468675,12040,12065,Marion+Nelson+Washington,Washington,21,229,Kentucky,KY
21185,21CS039,376,347,405,424,48,19,77,50,-1.7347350835765716,-0.1921025004145692,1.5415209966747585,1.0251344305147074,473,437,508,484,11,-24,47,37,-0.8936343329109591,-0.39365175035155286,0.10542138015246745,2.9800100561703515,67630,68533,Oldham,Oldham,21,185,Kentucky,KY
21041,21CS040,120,119,121,122,2,1,3,13,-4.3139439161364965,-3.921960281163521,-3.5198962329498733,3.8223443238171413,147,145,148,151,4,3,6,23,-1.842611071703048,-1.7273498300650236,-1.6076683396948936,4.3598158616209615,10811,10859,Owen and Nearby Counties,Carroll,21,41,Kentucky,KY
21077,21CS040,86,85,87,100,14,13,15,11,1.1008470948453333,1.4867899861955238,1.8711091756300118,0.7219893528207953,105,104,107,119,14,12,15,23,-1.19985123487161,-1.078964364922482,-0.9532891003993396,1.5831532902740124,8704,8759,Owen and Nearby Counties,Gallatin,21,77,Kentucky,KY
21081,21CS040,208,197,219,227,19,8,30,13,-0.8826266037442219,0.9158406271234225,2.6377049733379674,0.6533960240622132,254,241,267,321,67,54,80,36,0.7040864543357858,1.2156101714909506,1.7293955066331077,0.5326452439891738,25049,25210,Owen and Nearby Counties,Grant,21,81,Kentucky,KY
21187,21CS040,105,104,106,133,28,27,29,11,5.560638839136066,5.925699890563404,6.331604291011648,0.38363406540182593,129,128,131,160,31,29,32,18,0.993675401699715,1.1125975827533436,1.2320624482499016,0.5700728530977718,11234,11294,Owen and Nearby Counties,Owen,21,187,Kentucky,KY
21223,21CS040,87,86,87,98,11,11,12,11,-0.16733603690111043,0.23372245925481105,0.6552675729723545,0.8802496291829505,106,105,107,147,41,40,42,25,1.7244152837555387,1.8539203113875127,1.9789666084372641,0.5982580858326709,8478,8520,Owen and Nearby Counties,Trimble,21,223,Kentucky,KY
21195,21CS041,682,657,707,781,99,74,124,47,1.9065323278824895,3.6518128968009576,5.283397912000261,0.46934642250667974,824,794,854,1068,244,214,274,160,0.9377751927017688,1.4638818783727159,1.9562269017025313,0.6528712068532072,58231,57539,Pike,Pike,21,195,Kentucky,KY
21199,21CS042,710,682,738,814,104,76,132,66,0.5605276422755899,2.2963177023578845,4.057196611725074,0.6311263619825853,870,836,903,1040,170,137,204,165,-0.4146945481707701,0.08849464203206868,0.6189298668650701,0.9631549094474314,65092,65364,Pulaski,Pulaski,21,199,Kentucky,KY
21209,21CS043,377,352,402,389,12,-13,37,23,-2.3907720144030096,-0.748103380831377,0.9928201266640894,1.7527387854644307,470,440,500,557,87,57,117,51,0.11961148691501575,0.6180638091932283,1.1081127358746043,0.5805795117342777,57500,58139,Scott+Woodford,Scott,21,209,Kentucky,KY
21239,21CS043,220,209,232,237,17,5,28,6,-0.1035498268597735,1.5439665307847814,3.1715094514606044,0.3381786832465639,272,258,286,301,29,15,43,31,-0.6268864498230811,-0.08480664839156983,0.4569656057292625,1.0324771062152183,26876,27048,Scott+Woodford,Woodford,21,239,Kentucky,KY
21007,21CS044,91,90,91,96,5,5,6,6,-0.6824599475653553,-0.269227444704264,0.1322462545280339,0.9290055493935305,111,110,112,134,23,22,24,24,-0.2758966436986557,-0.1471866614215215,-0.014409372809982411,1.005567580490541,7735,7699,Southwest Kentucky,Ballard,21,7,Kentucky,KY
21039,21CS044,63,62,63,69,6,6,7,4,1.660542615263428,2.015245216520108,2.4217505727278525,0.5379923318414461,77,76,78,107,30,29,31,10,4.047633092382521,4.1678997078779725,4.288760296366478,0.3226678683770872,4796,4794,Southwest Kentucky,Carlisle,21,39,Kentucky,KY
21075,21CS044,86,86,87,111,25,24,25,19,3.1315337374172136,3.53739808340985,3.974207519678496,0.7399438107742407,108,107,108,125,17,17,18,14,0.38907669677476,0.5218459969438993,0.6482100924990031,0.7619258313302324,6427,6510,Southwest Kentucky,Fulton,21,75,Kentucky,KY
21083,21CS044,394,379,410,471,77,61,92,66,-0.5933219724294019,1.1257741387361,2.8648062589392604,0.8514488124355851,485,466,504,577,92,73,111,52,0.5999210976438973,1.0889154788591484,1.6120916442576976,0.5572076407576851,36619,36600,Southwest Kentucky,Graves,21,83,Kentucky,KY
21105,21CS044,57,56,57,76,19,19,20,7,10.526227584632759,10.925238502890663,11.336422192260601,0.3457304807305453,69,69,70,72,3,2,3,11,-1.9471469799068628,-1.8354468300304327,-1.709438341169115,2.8425500043033662,4488,4438,Southwest Kentucky,Hickman,21,105,Kentucky,KY
21025,21CS045,176,171,182,183,7,1,12,7,-1.760261211770014,-0.11020083455660527,1.6208757562170306,0.9245469061963665,216,209,223,276,60,53,67,47,0.3915394888988554,0.9442160615791343,1.4789227206964044,0.7736524901440147,13510,13571,Wolfe and Nearby Counties,Breathitt,21,25,Kentucky,KY
21129,21CS045,94,94,95,124,30,29,30,16,6.933012734832554,7.347983335336565,7.7344211924057324,0.5243588505887458,117,116,118,148,31,30,32,22,1.0848596960173558,1.209401799254211,1.3321554638419522,0.6885414802936466,7374,7438,Wolfe and Nearby Counties,Lee,21,129,Kentucky,KY
21165,21CS045,73,72,74,80,7,6,8,5,0.8635578042464315,1.269455563037065,1.7144929265835684,0.6271289224824081,90,89,91,127,37,36,38,22,2.32202472573789,2.449511583351059,2.579249625977687,0.5765420345158697,6177,6182,Wolfe and Nearby Counties,Menifee,21,165,Kentucky,KY
21175,21CS045,132,130,133,138,6,5,8,7,-0.6453923902068038,-0.25364498828916515,0.16830090537978157,0.9778117529520923,164,162,166,182,18,16,20,19,-0.20363809883231637,-0.07894549704450775,0.05439502461862319,1.0033564504466415,13668,13805,Wolfe and Nearby Counties,Morgan,21,175,Kentucky,KY
21197,21CS045,169,163,174,163,-6,-11,-0,5,-5.108808463905908,-3.3101772455387164,-1.56871280264302,-1.071010996486956,208,202,215,217,9,2,15,19,-1.2961059220446576,-0.8061892368729948,-0.2829758478614017,1.9725660121940414,12976,13126,Wolfe and Nearby Counties,Powell,21,197,Kentucky,KY
21237,21CS045,86,85,87,102,16,15,17,4,6.854770701714239,7.268383983517427,7.711677443346821,0.23457544711813919,104,103,104,164,60,60,61,11,7.468193364147204,7.5758530985652,7.699564698346892,0.17920837509399368,6635,6514,Wolfe and Nearby Counties,Wolfe,21,237,Kentucky,KY
22001,22CS001,529,504,554,770,241,216,266,134,5.699130527739083,7.349049774029261,9.198141966863238,0.5532682367939532,646,617,676,880,234,204,263,83,2.129283885134809,2.6247740990798483,3.11286306693819,0.3538153656876131,58131,57312,Acadia +Jefferson Davis,Acadia,22,1,Louisiana,LA
22053,22CS001,342,329,356,365,23,9,36,56,-5.881473835645431,-4.1193676528614,-2.5982868882260215,2.3735370569848024,423,407,440,514,91,74,107,66,0.2638180435207428,0.7608585950029745,1.2666527431917283,0.71946848120952,32079,32319,Acadia +Jefferson Davis,Jefferson Davis,22,53,Louisiana,LA
22003,22CS002,206,196,215,320,114,105,124,53,8.760440720253182,10.606455558338057,12.260662575803595,0.45925512095524934,250,238,261,337,87,76,99,39,1.6120730905248897,2.1352637261471776,2.6554313326064185,0.44196388308315215,23118,22688,Allen+Evangeline,Allen,22,3,Louisiana,LA
22039,22CS002,315,301,329,416,101,87,115,57,3.639068674990103,5.4227932766383065,7.099835846184051,0.5592319278257892,384,368,401,486,102,85,118,78,0.23893635544028918,0.7331451949151057,1.2577026151860886,0.7605635991563623,32456,32228,Allen+Evangeline,Evangeline,22,39,Louisiana,LA
22005,22CS003,655,601,710,841,186,131,240,116,0.5043875590984321,2.1856648150028457,3.684142324009084,0.621537349205298,821,755,887,992,171,105,237,115,-0.05450927544802016,0.4274935400635152,0.9609219384312988,0.6687409264329466,127101,128167,Ascension,Ascension,22,5,Louisiana,LA
22007,22CS004,180,171,189,226,46,37,55,24,2.363977829019552,4.10987649927147,5.780491699206311,0.5138820160920218,219,208,230,323,104,93,115,31,3.009528724146072,3.5357571382785333,4.056329419986707,0.29474318567275104,21078,20730,Assumption+St.James+St.John the Baptist,Assumption,22,7,Louisiana,LA
22093,22CS004,167,158,176,210,43,34,52,38,-0.5938997175341068,1.0647160524230304,2.7759967835951387,0.8632360545290397,202,192,212,251,49,39,59,21,0.8781261146822056,1.4134588216365287,1.941514734573503,0.41977510633770226,20221,19798,Assumption+St.James+St.John the Baptist,St. James,22,93,Louisiana,LA
22095,22CS004,349,331,367,440,91,73,109,91,-1.794102882438619,0.007218889560529238,1.6730948614007912,0.9901676451831652,427,406,449,472,45,23,66,43,-0.48572202345557464,0.02362075806537892,0.5756681538140364,0.9418607092188208,42425,42138,Assumption+St.James+St.John the Baptist,St. John the Baptist,22,95,Louisiana,LA
22009,22CS005,410,393,427,526,116,99,133,71,2.6938072909100628,4.60793801651212,6.26717726533704,0.6071427784729463,500,480,520,623,123,103,143,75,0.7301501459946208,1.223213698566922,1.7373680746112563,0.6040524048934203,39653,39291,Avoyelles+East Feliciana+Pointe Coupee+West Feliciana,Avoyelles,22,9,Louisiana,LA
22037,22CS005,219,210,227,278,59,51,68,67,-3.265189196407785,-1.6329277502241213,-0.10594289641044585,1.1130591038909954,268,258,278,293,25,15,35,38,-1.1937357967146476,-0.6474152603811496,-0.16134269635598358,1.44154301138457,19388,19354,Avoyelles+East Feliciana+Pointe Coupee+West Feliciana,East Feliciana,22,37,Louisiana,LA
22077,22CS005,211,202,220,281,70,61,79,45,3.1873586125781483,4.831109987395618,6.457925652691061,0.6336688814779305,255,245,266,325,70,59,80,27,1.5883007708849344,2.0983215697570956,2.648064012187123,0.381624584783846,20807,20405,Avoyelles+East Feliciana+Pointe Coupee+West Feliciana,Pointe Coupee,22,77,Louisiana,LA
22125,22CS005,120,118,121,149,29,28,31,26,0.5008634376145008,0.8899661939762629,1.3049705889811096,0.8540147101604586,149,147,151,166,17,15,19,14,0.08253015423645288,0.2069549568003691,0.3301842326274381,0.7691972809423857,15327,15459,Avoyelles+East Feliciana+Pointe Coupee+West Feliciana,West Feliciana,22,125,Louisiana,LA
22011,22CS006,323,307,339,423,100,84,116,54,3.3670028612212306,4.959005124407742,6.791604008070253,0.5340488339076624,396,377,415,467,71,52,90,75,-0.60222140195085,-0.10199620219983137,0.41531975643730723,1.0363652917388482,36731,36582,Beauregard +Vernon,Beauregard,22,11,Louisiana,LA
22115,22CS006,348,327,369,463,115,94,136,63,2.689106148084488,4.2305948111472,6.0339600713432056,0.5447225369087576,427,402,451,489,62,38,87,75,-0.7849892276354843,-0.27310276804660616,0.25516251698512776,1.1834706539959834,48497,48108,Beauregard +Vernon,Vernon,22,115,Louisiana,LA
22013,22CS007,163,157,168,223,60,55,66,44,3.2336447083504987,4.976471865443769,6.614629828923129,0.7193344890164407,197,190,204,262,65,58,72,30,2.2247099532155414,2.7399151165455744,3.2601590744510047,0.4540574015168188,12935,12794,Bienville+Natchitoches+Red River,Bienville,22,13,Louisiana,LA
22069,22CS007,340,324,356,424,84,68,100,51,1.8070192055895005,3.4514030484898983,5.128418846399504,0.6026143389739057,415,396,434,529,114,95,133,72,0.6144597310280523,1.1388484313111318,1.6411844611265014,0.6244831091883042,37436,37073,Bienville+Natchitoches+Red River,Natchitoches,22,69,Louisiana,LA
22081,22CS007,83,82,84,139,56,55,57,27,14.641948693276381,15.059066619912395,15.492256154812226,0.47291941841614044,100,99,101,135,35,34,36,19,2.0344442943687207,2.162595594761802,2.2794334401832526,0.5222659545517956,7724,7572,Bienville+Natchitoches+Red River,Red River,22,81,Louisiana,LA
22015,22CS008,934,879,989,1132,198,143,253,169,-0.9464232556309781,0.8866681295246152,2.6554803223402415,0.8487710150626879,1155,1089,1222,1375,220,153,286,142,0.09661085799970318,0.5935313696507976,1.105676252720685,0.6433739943163862,128490,129067,Bossier,Bossier,22,15,Louisiana,LA
22017,22CS009,2263,2161,2365,3042,779,677,881,463,3.6776552773378306,5.306037243133346,7.05171727560278,0.5934529631590857,2735,2615,2856,3375,640,519,760,409,0.49571436770533295,0.9732079539818751,1.4775149893691526,0.638210618383948,237135,233670,Caddo,Caddo,22,17,Louisiana,LA
22019,22CS010,1840,1748,1932,2226,386,294,478,269,0.49074142801242276,2.1621800084406275,3.8969626866967184,0.6949414259460696,2181,2074,2288,2448,267,160,374,327,-0.8345331124651981,-0.28876590056390106,0.2142048992438097,1.2194633889296769,213451,206906,Calcasieu,Calcasieu,22,19,Louisiana,LA
22023,22CS011,37,36,38,61,24,23,25,3,14.21422517440085,14.627732002179892,15.042319552985623,0.11968078919826369,41,40,41,52,11,11,12,3,1.4801638138342252,1.6039990767378387,1.7224683562378067,0.24467106080808773,5761,5159,Cameron +Vermilion,Cameron,22,23,Louisiana,LA
22113,22CS011,479,454,504,639,160,135,185,65,4.963435413768938,6.551222927198452,8.289629971282812,0.40376926520640216,587,557,616,775,188,159,218,84,1.3539561400521898,1.8194660750230058,2.3048163879458357,0.4439625657007925,57613,57216,Cameron +Vermilion,Vermilion,22,113,Louisiana,LA
22021,22CS012,104,103,105,125,21,20,22,23,-1.260002027948549,-0.8375058689332742,-0.42997260817927496,1.0466205010678264,126,125,128,158,32,30,33,16,1.5153472882667984,1.636125287471414,1.761884565883003,0.4898211816590517,9660,9578,Catahoula and Nearby Parishes,Caldwell,22,21,Louisiana,LA
22025,22CS012,97,97,98,140,43,42,43,22,8.781142784860663,9.197778339557015,9.632597644846106,0.5048624004027712,118,117,119,145,27,26,28,25,0.13697999164569338,0.27036072549863077,0.3958678674464404,0.8808809222588035,8941,8813,Catahoula and Nearby Parishes,Catahoula,22,25,Louisiana,LA
22029,22CS012,198,190,206,258,60,52,68,43,1.8644958799250706,3.524458539337407,5.319278394528665,0.7088643978558562,239,229,248,295,56,47,66,30,0.9125786783067821,1.4359847371684678,1.9553894887596521,0.5235582937341179,18673,18407,Catahoula and Nearby Parishes,Concordia,22,29,Louisiana,LA
22059,22CS012,143,137,149,175,32,26,38,25,0.08442380405744022,1.9166155065469754,3.5319778430070325,0.7559044392907786,174,167,182,197,23,15,30,19,-0.262650726593428,0.2225656225308869,0.764583542889064,0.8042651271401636,14829,14831,Catahoula and Nearby Parishes,La Salle,22,59,Louisiana,LA
22107,22CS012,45,45,46,71,26,25,26,6,18.61516393195736,18.979767891002403,19.371923943199068,0.22521273522354052,54,54,55,85,31,30,31,6,5.933221760739077,6.06586886049649,6.186539274714498,0.19000416733066564,4138,4054,Catahoula and Nearby Parishes,Tensas,22,107,Louisiana,LA
22027,22CS013,150,144,156,202,52,46,58,40,1.5349288381502502,3.4585619656963003,4.958235602881665,0.7533881111813582,180,173,188,202,22,14,29,23,-0.6029465918789796,-0.10173160814836614,0.40691297253037334,1.0163772936758813,14336,14048,Claiborne+Webster,Claiborne,22,27,Louisiana,LA
22119,22CS013,416,401,432,564,148,132,163,77,6.014325078694198,7.750207272286527,9.364523006121958,0.5181828264606929,499,480,517,696,197,179,216,74,2.8736645697195353,3.3884487305379936,3.909504481465916,0.37325465786859885,37006,36283,Claiborne+Webster,Webster,22,119,Louisiana,LA
22031,22CS014,256,245,268,310,54,42,65,53,-1.6565925934184267,0.08718582332171253,1.7198181201095384,0.9696141604920137,314,300,328,373,59,45,73,57,-0.4357788100571967,0.08912997255670317,0.5972250944029174,0.9484564079304412,26946,26910,De Soto+Sabine,De Soto,22,31,Louisiana,LA
22085,22CS014,222,212,231,339,117,108,127,48,10.665153002630849,12.372299024785205,14.079506717204527,0.40611441967108075,270,258,281,372,102,91,114,51,1.8039709147874128,2.3139223226924495,2.859023836886573,0.49376250102608527,22379,22133,De Soto+Sabine,Sabine,22,85,Louisiana,LA
22033,22CS015,3381,3185,3576,4176,795,600,991,523,0.5901321354919874,2.3969569247215583,4.21468692034935,0.656728311654611,4155,3921,4389,5048,893,659,1127,538,0.2583558203178598,0.77325849850249,1.2670921012431713,0.6019564217046549,453513,453678,East Baton Rouge,East Baton Rouge,22,33,Louisiana,LA
22043,22CS016,186,177,196,235,49,39,58,38,0.14061511948409,1.9477402778123394,3.6113118972022646,0.7645282804337307,229,218,241,282,53,41,64,33,0.35030522814114534,0.8842411816597257,1.369105194088093,0.61409454113689,22173,22220,Grant+Jackson+Winn,Grant,22,43,Louisiana,LA
22049,22CS016,156,150,163,200,44,37,50,17,5.430640999410502,7.130612510586783,8.881299542736619,0.3790980566654024,189,181,197,223,34,26,42,16,0.6492969042665078,1.215230056273131,1.7556737372875963,0.45695743467952926,15090,14892,Grant+Jackson+Winn,Jackson,22,49,Louisiana,LA
22127,22CS016,148,142,154,210,62,56,68,29,7.904919106393784,9.602836678778043,11.25529274797509,0.4627858669756646,179,172,186,210,31,24,38,21,0.24368451533864646,0.7819633003035882,1.28815664264556,0.6495766683675636,13732,13522,Grant+Jackson+Winn,Winn,22,127,Louisiana,LA
22045,22CS017,621,591,651,802,181,151,211,81,4.00546754324753,5.762732064591842,7.38775815198201,0.44535228714561625,757,721,792,924,167,132,203,100,0.47936895845457855,0.9568066384348672,1.4900954303792409,0.5942081903615934,69634,69084,Iberia,Iberia,22,45,Louisiana,LA
22047,22CS018,260,247,273,393,133,120,146,56,8.489329716697345,10.04563593102155,11.693907518972308,0.419007422324179,313,298,329,430,117,101,132,54,1.6278721574765165,2.103233883706636,2.638056640739194,0.4581459781186028,30425,29864,Iberville+West Baton Rouge,Iberville,22,47,Louisiana,LA
22121,22CS018,185,174,197,249,64,52,75,40,1.633449197040627,3.4562072523753353,5.21562899942807,0.6197521463253215,231,217,245,283,52,38,66,26,0.4643625386864364,0.9521800140774189,1.4207469948582352,0.4890301116278654,27194,27711,Iberville+West Baton Rouge,West Baton Rouge,22,121,Louisiana,LA
22051,22CS019,3648,3459,3836,4495,847,659,1036,592,0.6355792384880479,2.3060780241740737,3.997671491638319,0.697984491348228,4445,4220,4669,5070,625,401,850,415,-0.012362980193117021,0.47255196915633846,0.9693356832111055,0.6625930068612412,438365,434586,Jefferson,Jefferson,22,51,Louisiana,LA
22055,22CS020,1537,1433,1642,1930,393,288,497,134,2.6221265742251805,4.260423313813517,5.989144140764726,0.34031381976963015,1911,1785,2037,2411,500,374,626,184,0.7909947749407034,1.2904963979511719,1.795111440345694,0.367320368748328,242641,243884,Lafayette,Lafayette,22,55,Louisiana,LA
22057,22CS021,767,725,809,953,186,144,228,132,0.5834349884167331,2.197041769724493,3.9024447533115922,0.7069603189510069,944,894,995,1211,267,216,317,150,0.6673353294525131,1.201077891884957,1.7140249685049136,0.560175043441243,97514,97503,Lafourche,Lafourche,22,57,Louisiana,LA
22061,22CS022,344,323,364,437,93,73,114,68,0.2364462831892084,2.0929902589454237,3.7260537189628176,0.7218723409867243,426,401,451,490,64,39,89,33,0.12247306079531194,0.6565757032790804,1.1975486225465244,0.5068154132943469,48043,48168,Lincoln+Union,Lincoln,22,61,Louisiana,LA
22111,22CS022,225,216,234,351,126,117,135,52,12.262504469865156,13.957854732263769,15.737550834944546,0.4088954914902936,274,263,285,348,74,63,85,34,1.3669360458677267,1.9017690071677615,2.3959423926244954,0.454171799434058,21258,21096,Lincoln+Union,Union,22,111,Louisiana,LA
22063,22CS023,957,895,1018,1142,185,124,247,119,0.14328980737420655,1.8415189229670357,3.606441522381014,0.6394651637996916,1199,1124,1274,1585,386,311,461,250,0.39399275177476634,0.9279197550884389,1.4487576889825087,0.6457901629043655,142879,145377,Livingston,Livingston,22,63,Louisiana,LA
22035,22CS024,76,75,77,82,6,5,7,19,-7.440414608116255,-7.043145419723622,-6.6249763203627685,2.6478807352638154,93,92,93,116,23,23,24,19,0.47717269989518407,0.610046172434389,0.731110199950377,0.7780404813172961,7285,7244,Northeast Louisiana,East Carroll,22,35,Louisiana,LA
22041,22CS024,228,220,236,286,58,50,66,55,-1.1114948164227203,0.6521432577152432,2.3441429095138835,0.932155027031636,278,268,288,313,35,25,45,46,-1.0664707519380938,-0.5757057896822584,-0.06690421469891487,1.2856785399638595,19756,19676,Northeast Louisiana,Franklin,22,41,Louisiana,LA
22065,22CS024,101,100,102,118,17,16,18,18,-0.8306187846816346,-0.4303982779830536,-0.035354063759042965,1.0044893889641326,121,120,122,146,25,24,26,32,-0.8387311162997849,-0.7226460830714485,-0.592459917343094,1.2337902037703194,10069,9818,Northeast Louisiana,Madison,22,65,Louisiana,LA
22067,22CS024,314,304,325,405,91,80,101,44,5.5693368431991415,7.350827981033257,9.103240164345378,0.4807327813232335,381,368,394,501,120,107,133,62,1.7966927283029495,2.3207599228413396,2.829855610057709,0.5112916383015982,25302,25084,Northeast Louisiana,Morehouse,22,67,Louisiana,LA
22083,22CS024,197,189,206,250,53,44,61,45,-0.16281585946145205,1.5174291654883958,3.269589856949818,0.8357344197880014,240,230,251,302,62,51,72,42,0.5094263237705847,1.006380053683413,1.5147151433616293,0.6700557745381825,19999,19833,Northeast Louisiana,Richland,22,83,Louisiana,LA
22123,22CS024,121,116,125,156,35,31,40,35,-1.6530224375230305,0.09651241153643288,1.8710783217054483,0.9621091645787962,145,140,150,159,14,9,19,17,-0.7821367312624886,-0.28168040198266187,0.23038718186975138,1.12066280442609,9860,9609,Northeast Louisiana,West Carroll,22,123,Louisiana,LA
22071,22CS025,2785,2621,2950,3765,980,815,1144,548,2.833714967941859,4.4955416897800005,6.35644148684262,0.558840907513511,3386,3191,3582,3997,611,415,806,261,0.4385896611388933,0.939212418971407,1.4158074944647432,0.4268026909789957,383775,377891,Orleans,Orleans,22,71,Louisiana,LA
22073,22CS026,1396,1328,1465,1726,330,261,398,274,-0.29823390253216764,1.3967999506557642,3.127475797303527,0.828372330268992,1712,1630,1794,2049,337,255,419,282,-0.17554821550168673,0.3335543901276408,0.842622928427136,0.8340002878485158,158912,158948,Ouachita,Ouachita,22,73,Louisiana,LA
22075,22CS027,162,151,172,209,47,37,58,20,2.9414645543029816,4.704980362318858,6.455927205752654,0.41256961292217975,198,186,210,222,24,12,36,20,-0.38027578975613485,0.15082599669292013,0.6616142752079713,0.809305178205834,23420,23327,Plaquemines+St. Bernard,Plaquemines,22,75,Louisiana,LA
22087,22CS027,305,286,324,379,74,55,93,42,1.1292334317006922,2.949587133424397,4.622054534141411,0.5572617167194437,376,353,398,488,112,90,135,47,0.9811013924848604,1.4678519131988623,1.978944979706709,0.4147341892438942,44371,44197,Plaquemines+St. Bernard,St. Bernard,22,87,Louisiana,LA
22079,22CS028,1261,1205,1317,1626,365,309,421,211,2.9643082282050814,4.70735621026219,6.59344930201263,0.5767527442881969,1537,1471,1604,1967,430,363,496,241,0.9863909565389433,1.4664250872042108,1.9746138464502263,0.5597362264901447,129536,128793,Rapides,Rapides,22,79,Louisiana,LA
22089,22CS029,364,341,386,463,99,77,122,57,1.3839748084219512,3.2785724203700117,4.9490717438099265,0.5688128093427369,449,422,476,495,46,19,73,43,-0.4246333789462392,0.06881896926977536,0.5394078740440874,0.9076581893780908,52548,52311,St. Charles,St. Charles,22,89,Louisiana,LA
22091,22CS030,111,110,112,136,25,24,26,3,7.910174148779608,8.292495321531932,8.704682252679747,0.11376343537155488,137,136,139,170,33,31,34,19,1.1291966278583465,1.2503554092335654,1.3703794753708198,0.5646123716116576,10783,10909,St. Helena +Tangipahoa +Washington,St. Helena,22,91,Louisiana,LA
22105,22CS030,1102,1044,1159,1323,221,164,279,155,0.18237383681213523,1.9890020026560526,3.6217754636805464,0.6972080649635183,1369,1300,1439,1767,398,328,467,286,0.27833653288135335,0.8563061236523043,1.3413319062678843,0.7176271009808844,133912,134974,St. Helena +Tangipahoa +Washington,Tangipahoa,22,105,Louisiana,LA
22117,22CS030,510,490,529,630,120,101,140,79,1.8915027975454084,3.649754041440287,5.418424632957534,0.6525745070200045,621,598,644,754,133,110,156,110,0.011073351908297339,0.5032562671004472,1.0228728123108146,0.8208618924181389,45460,45168,St. Helena +Tangipahoa +Washington,Washington,22,117,Louisiana,LA
22097,22CS031,857,822,892,1109,252,217,287,168,2.3701958354786505,4.10436239949504,5.686525617986647,0.6637853318850205,1048,1006,1090,1249,201,159,243,122,0.4651161966448484,0.9692412378168334,1.4561871588236048,0.6040599591951128,82241,82100,St. Landry,St. Landry,22,97,Louisiana,LA
22099,22CS032,412,389,434,580,168,146,191,82,5.000668604626991,6.604257519503361,8.382155366563152,0.48384602774313124,504,478,531,629,125,98,151,62,0.6942784360343608,1.2162402859767891,1.7451924112154655,0.4935560058554834,51873,51549,St. Martin,St. Martin,22,99,Louisiana,LA
22101,22CS033,465,444,486,589,124,103,145,87,1.277224003590159,3.068236593620641,4.633658172552266,0.6963186670130843,562,537,587,716,154,129,179,112,0.37414802158496174,0.8670731129709364,1.3326755037461522,0.7244440802658175,49068,48364,St. Mary,St. Mary,22,101,Louisiana,LA
22103,22CS034,2000,1886,2114,2355,355,241,469,259,-0.32145468923622994,1.4693826802953027,3.161218454848356,0.728135208661451,2499,2360,2637,2939,440,302,579,307,-0.013390555789744598,0.49898873285193845,0.9847240644756995,0.6956336202385393,264868,268738,St. Tammany,St. Tammany,22,103,Louisiana,LA
22109,22CS035,872,825,919,1054,182,135,229,117,0.7425268900582938,2.381043559619649,4.0608857824331785,0.6405058506947948,1068,1012,1125,1388,320,263,376,171,0.8793628490113977,1.357455791896417,1.8651334909440533,0.5335071333736704,109444,108797,Terrebonne,Terrebonne,22,109,Louisiana,LA
23001,23CS001,1042,994,1089,1032,-10,-57,38,23,-2.8625621578858316,-1.191267242308368,0.3607773762522187,-2.6531339561489973,1282,1225,1339,1480,198,141,255,150,-0.08181353178364197,0.44541397377135705,0.9293718737625227,0.7534550058858251,110648,111035,Androscoggin,Androscoggin,23,1,Maine,ME
23003,23CS002,733,704,762,796,63,34,92,21,0.848591253347705,2.3979022568460353,4.255823398444405,0.32824534551534773,892,857,926,1107,215,181,250,94,1.2983544340927355,1.805945912284239,2.3626481025800476,0.43502947567034145,66994,66879,Aroostook,Aroostook,23,3,Maine,ME
23005,23CS003,2397,2267,2527,2469,72,-58,202,106,-2.2189410901104534,-0.4927264790107488,1.193429521053822,1.4490963993830939,2965,2807,3122,3101,136,-21,294,171,-0.6366704936612124,-0.09382881042483676,0.38422206556834676,1.2437672238798463,302453,304951,Cumberland,Cumberland,23,5,Maine,ME
23007,23CS004,295,283,308,285,-10,-23,2,4,-3.633975258106117,-1.8921686323531095,-0.2621535124657154,-0.4294068228553786,364,349,379,410,46,31,61,40,-0.3061170682518971,0.21066869018281623,0.770837160859212,0.8487197394444302,29538,29648,Franklin+Oxford,Franklin,23,7,Maine,ME
23017,23CS004,583,558,608,608,25,0,50,32,-2.0426314535501877,-0.407217885362351,1.2491749249341977,1.2196851255208836,721,691,752,849,128,97,158,91,0.11074528178301477,0.6342465917067535,1.1151378198745878,0.7079666593442061,57937,58515,Franklin+Oxford,Oxford,23,17,Maine,ME
23009,23CS005,534,510,558,575,41,17,65,27,-0.7070149872098245,1.036551905334675,2.8145101149892646,0.6447978659742982,660,631,689,753,93,64,122,44,0.38000459360851907,0.8883587407680067,1.3749511164547488,0.4675055773666296,55483,56085,Hancock+Washington,Hancock,23,9,Maine,ME
23029,23CS005,362,349,376,429,67,53,80,2,6.492453601120801,8.298653106681746,9.898639476547917,0.029554163335135133,442,426,458,530,88,72,104,38,1.0617371131784874,1.5981548311107514,2.085753461092021,0.42719158386762635,31101,31112,Hancock+Washington,Washington,23,29,Maine,ME
23011,23CS006,1153,1100,1206,1193,40,-13,93,34,-1.4717781497819842,0.19802037626134567,1.9107601316555978,0.8257543186501357,1418,1354,1483,1629,211,146,275,124,0.2143165449613398,0.6837587222600036,1.1712039260705458,0.5860868258446749,123610,124379,Kennebec,Kennebec,23,11,Maine,ME
23013,23CS007,436,419,454,390,-46,-64,-29,5,-6.72366836266497,-5.0785933720359075,-3.440439383123997,-0.10998244083266308,538,517,560,539,1,-21,22,19,-0.9333219844138037,-0.44100135260629214,0.07082036681325289,12.628417953745366,40539,41015,Knox+Waldo,Knox,23,13,Maine,ME
23027,23CS007,357,340,374,388,31,14,48,20,-0.6306593555720595,1.0503935254323082,2.772973882124945,0.6312843485118032,440,419,461,529,89,68,110,32,0.905860859884466,1.420373975594779,1.9082089837518939,0.3554997679816386,39681,39872,Knox+Waldo,Waldo,23,27,Maine,ME
23015,23CS008,355,340,371,384,29,13,44,3,1.3022725749177633,2.857920152058468,4.5876149377366495,0.10152380436901022,439,420,457,453,14,-4,33,18,-0.5939013759261187,-0.10956018270757521,0.37699123259318057,1.1839092175461032,35184,35735,Lincoln+Sagadahoc,Lincoln,23,15,Maine,ME
23023,23CS008,317,302,333,302,-15,-31,0,3,-3.712144905778361,-2.003082015187946,-0.20671785018524633,-0.20940459469078088,391,372,410,437,46,27,65,21,0.16194993999002985,0.6893928114896977,1.1986763442784862,0.44316271984254,36636,37015,Lincoln+Sagadahoc,Sagadahoc,23,23,Maine,ME
23019,23CS009,1433,1368,1499,1529,96,30,161,34,0.04453810795603123,1.5672617365018369,3.3191976568280577,0.350987269414229,1765,1687,1844,1999,234,155,312,211,-0.3272970204697021,0.14946624813254106,0.6355139791624366,0.8996343720359353,152059,152654,Penobscot+Piscataquis,Penobscot,23,19,Maine,ME
23021,23CS009,209,202,217,203,-6,-14,1,4,-4.131505104585618,-2.4921402127062575,-0.7442532012046759,-0.7374245939413253,260,251,269,302,42,33,51,36,-0.14809432685317897,0.35397741178426967,0.8635052701532775,0.8345494076526745,16826,17107,Penobscot+Piscataquis,Piscataquis,23,21,Maine,ME
23025,23CS010,523,501,545,559,36,14,58,19,-0.45624556221694346,1.3449077478755311,2.9977074314532626,0.5118495227377516,640,614,666,774,134,108,160,65,0.8198924951637394,1.4018615585463348,1.8894061522120071,0.48074186191328816,50471,50565,Somerset,Somerset,23,25,Maine,ME
23031,23CS011,1860,1769,1951,1901,41,-50,132,82,-2.419085247004403,-0.7518490790219666,0.9173434124421931,1.949640029900811,2306,2195,2417,2365,59,-52,170,176,-1.0468878465357796,-0.5586799979124555,-0.06060657908365443,2.9314693378190224,211750,214226,York,York,23,31,Maine,ME
24001,24CS001,741,712,770,995,254,225,283,161,3.7323324971872083,5.486871339649808,7.191483621242281,0.6316015800760817,900,865,935,1055,155,120,190,140,-0.3077103582264337,0.2164678390118542,0.7572103560042545,0.8992856744062883,68301,67761,Allegany+Garrett,Allegany,24,1,Maryland,MD
24023,24CS001,284,271,296,376,92,80,105,49,4.416922889805726,5.925575621162153,7.6545604489617,0.5260949210442427,347,332,361,396,49,35,64,56,-0.7283721482938307,-0.23856187976067764,0.25366746467337703,1.1108498604994084,28797,28711,Allegany+Garrett,Garrett,24,23,Maryland,MD
24003,24CS002,3871,3618,4124,4228,357,104,610,356,-1.7089711176993418,0.019961803299488386,1.8807170581636383,0.995634375519585,4800,4496,5105,4996,196,-109,500,412,-0.8931670049738442,-0.3524701292886715,0.16214184485283548,2.095458206097949,587638,590107,Anne Arundel,Anne Arundel,24,3,Maryland,MD
24510,24CS003,5384,5133,5634,6749,1365,1115,1616,684,2.7888815500994117,4.710520185975912,6.39937344058571,0.5005890920108931,6540,6242,6839,7522,982,683,1280,604,0.14934939407003783,0.6588942902769894,1.1410657753011908,0.6147542578822057,584114,577465,Baltimore (city),Baltimore (city),24,510,Maryland,MD
24005,24CS004,7313,6948,7679,8384,1071,705,1436,889,-0.8027009862260794,0.8983198404018569,2.651234327658773,0.8295139198395466,8968,8530,9407,9456,488,49,926,863,-0.9107341835756775,-0.4558297625315474,0.057346081328255215,1.7659905702390224,849099,849864,Baltimore (county),Baltimore (county),24,5,Maryland,MD
24009,24CS005,614,574,654,711,97,57,137,52,0.3021416245061856,1.9371368849979793,3.6170366725962886,0.5296828352416949,765,717,814,858,93,44,141,61,-0.18058099788549134,0.33050783516840226,0.8428039493935815,0.6522153283890721,92940,93772,Calvert,Calvert,24,9,Maryland,MD
24011,24CS006,292,278,307,347,55,40,69,15,3.0623615587229445,4.8278737446975715,6.4719920146397865,0.2697616700979596,360,343,378,436,76,58,93,58,0.042080916928103694,0.5493218637101535,1.049278773286627,0.7578811752720946,33332,33372,Caroline+Dorchester+Talbot,Caroline,24,11,Maryland,MD
24019,24CS006,354,340,368,379,25,11,39,27,-2.009208410978038,-0.2795738314511809,1.6168446544871555,1.0379111950605948,434,417,451,493,59,42,76,57,-0.4724671487787366,0.04670363314517808,0.5750420226607762,0.9523398808508241,32412,32492,Caroline+Dorchester+Talbot,Dorchester,24,19,Maryland,MD
24041,24CS006,391,375,407,458,67,51,83,1,5.355891040524286,7.0240750717452,8.820853808278489,0.014698802172190502,481,462,501,555,74,54,93,52,0.06418993829898043,0.5720186150305522,1.1150671977052133,0.6951869157658986,37434,37601,Caroline+Dorchester+Talbot,Talbot,24,41,Maryland,MD
24013,24CS007,1411,1337,1485,1557,146,72,220,178,-2.466961904519845,-0.6205121576176981,0.9408039897401331,1.2123898090911085,1746,1656,1836,1885,139,49,229,132,-0.5000710070054217,0.047885890085660375,0.5467590160227148,0.9433217486429358,172392,173730,Carroll,Carroll,24,13,Maryland,MD
24015,24CS008,868,823,913,1040,172,127,217,93,1.299682284134275,3.060829532798952,4.948353680297377,0.5374654370313644,1071,1018,1125,1248,177,123,230,144,-0.14426446407188814,0.2942301165337338,0.7981034202863382,0.8106266483499063,103663,103881,Cecil,Cecil,24,15,Maryland,MD
24017,24CS009,992,920,1063,1223,231,160,303,153,0.19033344624940957,1.8794816845341766,3.570836948005372,0.658597765356317,1244,1157,1331,1473,229,142,316,160,-0.10459079211519172,0.4296163119976021,0.9467557848604863,0.6967157105660462,166462,168404,Charles,Charles,24,17,Maryland,MD
24021,24CS010,1720,1603,1838,1873,153,35,270,189,-2.308616766065124,-0.585882628501631,1.2019456613640644,1.2311222026751263,2172,2028,2316,2208,36,-108,180,205,-1.0981666314087881,-0.6021521352899936,-0.11140091033259257,5.505296984059388,271708,278800,Frederick,Frederick,24,21,Maryland,MD
24025,24CS011,1913,1801,2025,2163,250,138,362,158,-0.39303368861201804,1.4075706167263222,3.2276465422205107,0.6301189744519992,2372,2236,2508,2605,233,97,369,231,-0.5357158961295024,0.005371021776448154,0.5380916313828981,0.9877001333515011,260509,262706,Harford,Harford,24,25,Maryland,MD
24027,24CS012,1522,1379,1665,1734,212,69,355,178,-1.2350736162628237,0.42488982329240615,2.014967914255152,0.8370505712820431,1913,1741,2086,1993,80,-93,252,93,-0.5530189340721319,-0.03619931767098251,0.4598793759453967,1.1539468596742477,331923,334265,Howard,Howard,24,27,Maryland,MD
24029,24CS013,221,213,229,285,64,56,72,34,4.673735005654018,6.263435105272081,7.934818332692202,0.5222269957553977,272,262,282,315,43,33,53,23,0.5215654701550697,1.05887427908067,1.5544224558691924,0.5186409287635851,19197,19251,Kent+Queen Anne's,Kent,24,29,Maryland,MD
24035,24CS013,380,359,402,392,12,-10,33,27,-2.949829781325841,-1.221960621367446,0.5230560392377694,2.1388165749404826,476,450,502,522,46,20,72,48,-0.5664859036880168,-0.03921070529117908,0.46955373441792797,1.0245961414040445,50156,50679,Kent+Queen Anne's,Queen Anne's,24,35,Maryland,MD
24031,24CS014,5402,4946,5857,6588,1186,731,1642,1118,-1.6139861168312,0.21378812842794825,1.9105316862467505,0.9417167478362778,6689,6143,7234,7006,317,-228,863,565,-0.7617525075828708,-0.249205628103363,0.2775384736989721,1.7740177419950225,1059100,1055763,Montgomery,Montgomery,24,31,Maryland,MD
24033,24CS015,5499,5087,5912,7260,1761,1348,2173,1249,0.3700227628110328,2.193270793849111,3.796834756050289,0.7089975996237945,6813,6319,7307,7618,805,311,1299,734,-0.5050861859850702,0.07412813826437571,0.5627710517879445,0.9103634798613979,956648,956807,Prince George's,Prince George's,24,33,Maryland,MD
24037,24CS016,719,670,768,855,136,87,185,88,0.051467072805251986,1.676702913150531,3.3903736707476617,0.6436678095528235,894,835,953,1050,156,97,215,89,0.06208007548001371,0.5851126758898545,1.081552802568718,0.5679797389892635,113979,114393,St. Mary's,St. Mary's,24,37,Maryland,MD
24039,24CS017,220,210,231,300,80,69,90,17,8.392179435547792,10.149392003240974,11.967006369298389,0.2102126755373313,269,256,282,312,43,30,56,31,-0.029175463428984003,0.4940139330132773,1.0067564953627168,0.7053473289489622,24721,24582,Somerset+Worcester,Somerset,24,39,Maryland,MD
24047,24CS017,550,528,573,614,64,41,86,53,-0.8231937131561625,0.8641575428933707,2.6281007529515295,0.8193812338635069,679,652,707,743,64,36,91,70,-0.6604411879001747,-0.11071611549204942,0.40483801270406944,1.0793815283633603,52490,53032,Somerset+Worcester,Worcester,24,47,Maryland,MD
24043,24CS018,1406,1340,1473,1660,254,187,320,143,1.1721790575572115,2.8306651646292,4.599552720001431,0.5618236569547929,1735,1655,1815,2018,283,203,363,272,-0.4373016362216609,0.06943278329388261,0.571298281705852,0.9583728621257066,154109,154886,Washington,Washington,24,43,Maryland,MD
24045,24CS019,862,817,906,1033,171,127,216,83,1.754366398461955,3.457294898038801,5.073127845483656,0.4817435039748744,1064,1010,1118,1253,189,135,243,151,-0.17735757497937524,0.3739044385584692,0.8855524507443626,0.7942164385804679,103603,103906,Wicomico,Wicomico,24,45,Maryland,MD
25001,25CS001,2675,2577,2773,2625,-50,-148,48,197,-6.195223392989558,-4.348167520516264,-2.57535855444327,-4.028686184029793,3313,3193,3432,3313,0,-119,120,199,-1.4156116489730972,-0.8653595132299108,-0.36996498397923444,140.72121952557083,226988,231909,Barnstable+Dukes+Nantucket,Barnstable,25,1,Massachusetts,MA
25007,25CS001,151,149,153,143,-8,-10,-6,7,-3.354726868125697,-2.953466816053288,-2.5576382476507398,-1.0181740787947067,193,190,195,171,-22,-24,-19,6,-1.4507118711012965,-1.325292024331345,-1.198452835069985,-0.28806227855691413,20180,21022,Barnstable+Dukes+Nantucket,Dukes,25,7,Massachusetts,MA
25019,25CS001,77,76,78,64,-13,-14,-12,8,-6.476466967003047,-6.068486259811535,-5.702109610814038,-0.6639547422211666,99,97,101,91,-8,-10,-6,3,-0.8810401492950011,-0.7628170723418952,-0.6261871172301059,-0.42931995430938097,13845,14455,Barnstable+Dukes+Nantucket,Nantucket,25,19,Massachusetts,MA
25003,25CS002,1339,1284,1394,1386,47,-8,102,121,-4.109444981817804,-2.331241774688385,-0.48452416543548343,2.5106718765142104,1642,1575,1708,1759,117,51,184,128,-0.6072705696127192,-0.08535240033023035,0.39048978151442626,1.0815666221737403,128231,128672,Berkshire,Berkshire,25,3,Massachusetts,MA
25005,25CS003,4766,4517,5014,5477,711,463,960,777,-2.0709170847588,-0.4239531280046733,1.3125385791287247,1.0906533463177694,5869,5570,6169,6242,373,73,672,669,-0.9980488710098601,-0.5101632630126381,-0.012012604435115983,1.78923383736024,577223,580019,Bristol,Bristol,25,5,Massachusetts,MA
25009,25CS004,6102,5755,6449,7072,970,623,1317,1242,-2.981820779061006,-1.3701445312641087,0.3005344676893608,1.2793221457363166,7509,7092,7925,7483,-26,-442,391,631,-1.3241161642807602,-0.8113913517861092,-0.2905718146804103,-25.601951720641097,806152,807387,Essex,Essex,25,9,Massachusetts,MA
25011,25CS005,607,577,638,705,98,67,128,70,-0.07345362360938347,1.5179338938921962,3.2199769902493474,0.7093994935467861,745,708,782,717,-28,-65,9,26,-1.2818120178818284,-0.7572741904444708,-0.2590118202074807,-0.9592396097254414,70887,71011,Franklin,Franklin,25,11,Massachusetts,MA
25013,25CS006,3896,3696,4096,4817,921,721,1121,751,-0.29491085592032773,1.4644378075687212,3.228384626359873,0.8146609333393082,4769,4530,5008,5143,374,135,613,448,-0.6535733798596497,-0.149192442062871,0.33333284914445943,1.194919297312492,464803,463037,Hampden,Hampden,25,13,Massachusetts,MA
25015,25CS007,1109,1039,1179,1246,137,67,207,149,-2.007195623814376,-0.2694697176750068,1.4212749888916383,1.0804452480357716,1368,1285,1452,1404,36,-48,119,93,-0.8976498352823932,-0.3474524371738917,0.15920041507775873,2.5174422270921486,161944,161644,Hampshire,Hampshire,25,15,Massachusetts,MA
25017,25CS008,10013,9313,10712,11522,1509,810,2209,2117,-3.2909251432113775,-1.4919215219959965,0.24336954803631575,1.4015861361827329,12299,11465,13134,12198,-101,-936,733,823,-1.061191470194091,-0.5692870384477297,-0.05709486113667444,-8.190990554823887,1625245,1616883,Middlesex,Middlesex,25,17,Massachusetts,MA
25021,25CS009,5146,4835,5458,5757,611,299,922,926,-3.552492651640764,-1.7764819567900536,0.07704141109390242,1.513877587066012,6333,5959,6707,6181,-152,-526,222,374,-1.2676501787389227,-0.7244245039884794,-0.21326595881379937,-2.482036607515686,723116,724727,Norfolk,Norfolk,25,21,Massachusetts,MA
25023,25CS010,4129,3901,4357,4799,670,442,898,741,-2.306447070806588,-0.5205940170707739,1.2040684916784044,1.104733097487656,5097,4822,5372,5436,339,64,614,412,-0.6382886236331603,-0.1346069369497411,0.37210012839544804,1.21100478230433,529857,532708,Plymouth,Plymouth,25,23,Massachusetts,MA
25025,25CS011,4048,3706,4389,5128,1080,739,1422,1089,-1.653364223320913,-0.048177445316957786,1.621591876111465,1.0070215500147572,4904,4504,5304,5137,233,-167,633,393,-0.7137667641381864,-0.17960333655331853,0.3199228038183341,1.6787722674897965,794441,774772,Suffolk,Suffolk,25,25,Massachusetts,MA
25027,25CS012,6446,6077,6816,6985,539,169,908,1135,-4.367672718943339,-2.8122887295935266,-1.1393687577125462,2.1030767926627387,7953,7508,8398,7791,-162,-607,283,665,-1.4868000293399237,-0.9465216312953523,-0.45502488387825024,-4.132593527372886,856834,861946,Worcester,Worcester,25,27,Massachusetts,MA
26001,26CS001,157,153,162,176,19,14,23,20,-2.114066758161114,-0.44245516459083056,1.2863670249867303,1.0101800251268993,191,186,196,226,35,30,40,35,-0.5063675298752068,4.857465446680154e-4,0.5349586448885458,0.9689149284306022,10209,10224,Alcona+Alpena+Presque Isle,Alcona,26,1,Michigan,MI
26007,26CS001,326,314,339,343,17,4,29,20,-2.1857736042312426,-0.43950559362043207,1.1382469539301063,1.131965841206694,397,382,412,477,80,65,95,72,-0.23709714535282472,0.2820711173563955,0.7474861684762084,0.8891197798083614,28808,28891,Alcona+Alpena+Presque Isle,Alpena,26,7,Michigan,MI
26141,26CS001,171,165,176,170,-1,-6,5,11,-5.222700218639374,-3.534944648196076,-1.9320689236829032,26.20805433521256,209,202,215,211,2,-4,9,33,-2.8308889550743217,-2.3457797331231025,-1.846396243601853,9.80085536635055,12936,13076,Alcona+Alpena+Presque Isle,Presque Isle,26,141,Michigan,MI
26003,26CS002,94,93,94,78,-16,-16,-15,6,-10.111175120112101,-9.713577003868517,-9.311268860118645,-0.41210593415620733,114,113,115,113,-1,-2,-0,3,-0.6154062948335893,-0.49274740431389963,-0.37478899880443844,-8.821307897899421,8868,8823,Alger+Delta+Schoolcraft,Alger,26,3,Michigan,MI
26041,26CS002,403,388,419,502,99,83,114,63,2.288401795693632,3.8920652407060743,5.7288769673284685,0.6329280968837196,497,478,516,555,58,39,77,51,-0.30118827486992944,0.2096602100233093,0.7115799758322647,0.8589289172637783,36680,36828,Alger+Delta+Schoolcraft,Delta,26,41,Michigan,MI
26153,26CS002,93,93,94,110,17,16,17,2,6.919491877916652,7.292661697403058,7.677749197118502,0.11320135470669065,114,113,115,131,17,16,18,5,1.3312714504820558,1.4540555346458715,1.5796927825869425,0.2832257497391497,8046,8032,Alger+Delta+Schoolcraft,Schoolcraft,26,153,Michigan,MI
26005,26CS003,903,852,955,1042,139,87,190,73,0.39868422657966757,2.1889177789824776,3.8270491722612228,0.5231233060048274,1115,1053,1178,1279,164,101,226,168,-0.5948626115040859,-0.03585679697446712,0.4581619917949243,1.0190254665435734,120261,120898,Allegan,Allegan,26,5,Michigan,MI
26009,26CS004,233,223,243,259,26,16,36,5,1.866483909514516,3.6147157836594666,5.443377043975836,0.18332765660167055,288,276,301,332,44,31,56,36,-0.2133103269374716,0.319178989480901,0.7953328863191838,0.807274505265101,23453,23756,Antrim+Charlevoix+Kalkaska+Otsego,Antrim,26,9,Michigan,MI
26029,26CS004,246,235,257,242,-4,-15,7,12,-4.187259837549447,-2.413284155859101,-0.6991309605662227,-4.305492840548784,302,288,315,376,74,61,88,36,0.9473369745339436,1.4892224135208887,2.0015441949588983,0.47762812823553663,26047,26075,Antrim+Charlevoix+Kalkaska+Otsego,Charlevoix,26,29,Michigan,MI
26079,26CS004,180,172,188,209,29,21,37,13,1.9293740364042442,3.5559665743736395,5.266202039790369,0.4354584170746177,221,212,230,251,30,21,39,26,-0.2929045062579343,0.2100060101825923,0.681613495456757,0.8360302775605117,17939,17971,Antrim+Charlevoix+Kalkaska+Otsego,Kalkaska,26,79,Michigan,MI
26137,26CS004,237,226,248,276,39,28,50,19,1.4690155564851317,3.183499656703923,4.805896778832594,0.4780592262653716,293,280,306,366,73,60,86,59,0.07184483161102262,0.5623696737911007,1.0801038486624635,0.7943825189141345,25058,25262,Antrim+Charlevoix+Kalkaska+Otsego,Otsego,26,137,Michigan,MI
26011,26CS005,172,166,179,204,32,25,38,15,2.7581203266496495,4.540230767962091,6.3653589762327965,0.45614291205819635,210,202,218,254,44,36,52,20,1.1141863413944515,1.5995997048320298,2.157457519516552,0.44277592905359636,14982,14977,Arenac+Iosco+Ogemaw,Arenac,26,11,Michigan,MI
26069,26CS005,351,340,362,405,54,43,65,43,0.035050040900144255,1.7014289619926137,3.3838550306840744,0.786257521570343,429,416,442,499,70,57,83,56,-0.00808842366998885,0.535604957171211,1.0241782971616251,0.793003974637598,25217,25343,Arenac+Iosco+Ogemaw,Iosco,26,69,Michigan,MI
26129,26CS005,276,267,285,294,18,9,27,28,-3.6031808237927327,-1.9317687958405216,-0.2346259147870498,1.4806353449595924,336,325,346,385,49,39,60,52,-0.6197808694867029,-0.1165421011413022,0.3771061616138069,1.0311738652697595,20767,20728,Arenac+Iosco+Ogemaw,Ogemaw,26,129,Michigan,MI
26015,26CS006,497,470,524,534,37,10,64,39,-1.7881049704904575,-0.047236326999971594,1.5274454170125868,1.0199541915062529,614,581,646,769,155,123,188,78,0.7303779564867424,1.250049320900843,1.7199858916570707,0.49887055960137633,62439,62927,Barry,Barry,26,15,Michigan,MI
26017,26CS007,1086,1042,1131,1312,226,181,270,148,1.3872336155458187,2.9334327778220173,4.645074653303308,0.6533122660936301,1326,1273,1379,1559,233,180,286,219,-0.3761873089968876,0.13413272216975033,0.6547490539941511,0.935590795127519,103439,103074,Bay,Bay,26,17,Michigan,MI
26019,26CS008,181,173,189,226,45,37,53,24,2.920817867811121,4.694366871479911,6.442351177101084,0.52088758445465555,224,215,234,241,17,7,26,24,-0.9038587218122347,-0.4055841891195279,0.08366789759780456,1.3603517361477235,17970,18187,Benzie+Manistee+Mason,Benzie,26,19,Michigan,MI
26101,26CS008,282,271,292,343,61,51,72,21,4.771503193488105,6.4644915800575715,8.246546291384552,0.33605126543934716,348,335,361,373,25,12,38,43,-1.2485790388198093,-0.7074028974103672,-0.2143250691383788,1.6466646308786426,25028,25308,Benzie+Manistee+Mason,Manistee,26,101,Michigan,MI
26105,26CS008,295,282,307,349,54,42,67,21,2.884465037588666,4.525762502343931,6.272286132904634,0.37972815157712986,364,349,379,441,77,62,92,46,0.5110494168133413,1.0584593785345033,1.5409741401322887,0.5911796248747155,29110,29336,Benzie+Manistee+Mason,Mason,26,105,Michigan,MI
26021,26CS009,1485,1419,1551,1652,167,101,233,170,-1.7907001480851497,-0.08714003393419248,1.5943869128721024,1.0128633191932896,1807,1728,1886,2005,198,119,277,204,-0.5236874830934539,-0.05089437349763156,0.47933006982053833,1.024152998459858,153883,153246,Berrien,Berrien,26,21,Michigan,MI
26023,26CS010,419,400,438,468,49,30,68,71,-3.6351528092613368,-1.9874234428440252,-0.4028701692347158,1.4261875710213445,518,495,542,565,47,23,70,75,-1.1719483620925586,-0.6283910413812314,-0.10882786279274781,1.57441238472715,44629,44959,Branch+Hillsdale,Branch,26,23,Michigan,MI
26059,26CS010,427,408,447,545,118,98,137,63,3.153307206166311,4.7939394386378495,6.523196821970444,0.530657458392594,525,501,548,651,126,103,150,108,-0.1207753223624224,0.4012866066715052,0.928652750688373,0.8473174698016608,45645,45565,Branch+Hillsdale,Hillsdale,26,59,Michigan,MI
26025,26CS011,1327,1269,1384,1625,298,241,356,158,2.544132884812847,4.260968413838293,5.919645592925206,0.5278611561343446,1622,1552,1691,1841,219,150,289,229,-0.6188317466915726,-0.08922837013923082,0.44093132425037596,1.0388143085733315,134038,133862,Calhoun,Calhoun,26,25,Michigan,MI
26027,26CS012,452,429,474,560,108,86,131,66,1.680016273179074,3.240212540457503,4.962923931470092,0.6033823096666616,552,526,579,633,81,54,107,65,-0.2354221225540905,0.3028059202099956,0.7892714045321118,0.7943150615113775,51596,51495,Cass,Cass,26,27,Michigan,MI
26031,26CS013,283,272,294,343,60,49,71,39,1.5356314981505008,3.177199807358175,5.04042269227966,0.6429901522775728,349,335,362,443,94,81,108,52,1.0891701584603575,1.663122074318905,2.176263292977828,0.5454562282448195,25576,25730,Cheboygan+Emmet,Cheboygan,26,31,Michigan,MI
26047,26CS013,325,311,340,374,49,34,63,32,0.2826006080299585,1.9803715035325125,3.520939859106393,0.6437483443378136,401,384,419,387,-14,-32,3,28,-1.7818483252725739,-1.2227160216755255,-0.7228755977710906,-2.0973230992286003,33994,34205,Cheboygan+Emmet,Emmet,26,47,Michigan,MI
26033,26CS014,309,293,325,308,-1,-17,15,22,-4.326823170799242,-2.4274185424370924,-0.7829562304419851,92.37749361582864,382,363,401,451,69,50,88,50,0.027404686835630684,0.5021057216767417,1.0614917718498567,0.7160610281780826,36831,36806,Chippewa+Luce+Mackinac,Chippewa,26,33,Michigan,MI
26095,26CS014,55,55,56,65,10,9,10,4,3.9303652790933454,4.3801357895054105,4.757875951071984,0.3655611956918561,66,65,67,82,16,15,17,6,1.7552140135581409,1.8903514577790315,2.00301984816476,0.3514988693737193,5461,5311,Chippewa+Luce+Mackinac,Luce,26,95,Michigan,MI
26097,26CS014,146,141,150,140,-6,-10,-1,8,-6.679562949774068,-5.055189416944087,-3.379938665309827,-1.698966352133036,179,174,185,195,16,10,21,14,-0.3375658207618703,0.19725604500641655,0.6938009038216404,0.8335498057290417,10835,10895,Chippewa+Luce+Mackinac,Mackinac,26,97,Michigan,MI
26035,26CS015,392,378,405,434,42,29,56,42,-1.5898459715479996,0.037394110248534715,1.7917492005718967,0.9658827358339307,481,465,497,557,76,60,92,65,-0.14857599380603187,0.34487750585103083,0.8337095558786733,0.8459993653656968,30856,31030,Clare+Gladwin,Clare,26,35,Michigan,MI
26051,26CS015,314,303,325,390,76,65,87,36,4.566865734223503,6.29839631056723,7.882641402358467,0.4681894076902032,385,372,398,480,95,82,108,59,0.911441080714709,1.3947142650835462,1.9530191692622425,0.6163932336463716,25390,25468,Clare+Gladwin,Gladwin,26,51,Michigan,MI
26037,26CS016,526,492,560,638,112,78,146,48,1.4627843990886291,3.1889806915187244,4.907650683900504,0.4247404867881973,650,609,691,771,121,80,162,90,-0.16055708682777523,0.3750392403727145,0.8974134296595562,0.7391281986857983,79230,79383,Clinton,Clinton,26,37,Michigan,MI
26039,26CS017,156,150,161,155,-1,-6,5,2,-2.643879528665617,-0.9283707927433635,0.8419313074903023,13.200194814022778,192,185,198,219,27,21,34,12,0.6893805446272744,1.1737701703110803,1.692392426799125,0.4221907207157875,13143,13169,Crawford+Montmorency+Oscoda+Roscommon,Crawford,26,39,Michigan,MI
26119,26CS017,143,139,147,159,16,12,20,16,-1.638071204306891,0.13787487548590494,1.8121665473678759,0.9305598841377741,175,171,180,200,25,20,29,26,-0.6451831240485637,-0.1580254866898184,0.3556952788704884,1.0163474667733416,9192,9276,Crawford+Montmorency+Oscoda+Roscommon,Montmorency,26,119,Michigan,MI
26135,26CS017,106,105,107,148,42,41,43,13,13.674942365735108,14.074772903762351,14.461516605665308,0.3020788816727363,131,130,132,172,41,40,42,33,0.8594739497374239,0.9911421293773541,1.1189539994742463,0.7811379156342039,8254,8300,Crawford+Montmorency+Oscoda+Roscommon,Oscoda,26,135,Michigan,MI
26143,26CS017,345,335,355,389,44,34,54,29,0.8992570687615636,2.6972140160520426,4.512475184367891,0.6389085964135877,421,409,433,468,47,35,59,61,-1.0906381687533826,-0.5922037252948291,-0.10273949724453188,1.2785888539897445,23534,23604,Crawford+Montmorency+Oscoda+Roscommon,Roscommon,26,143,Michigan,MI
26043,26CS018,271,260,282,339,68,57,79,68,-1.6820170387573685,0.005962427406043974,1.7510919738680901,0.989289845624068,332,319,346,360,28,14,41,30,-0.6148642736535601,-0.06831119540111834,0.423944184285922,1.0410909372013706,25795,25801,Dickinson+Iron+Menominee,Dickinson,26,43,Michigan,MI
26071,26CS018,174,169,179,204,30,25,35,28,-0.9623267496147956,0.6782436118345401,2.3604564119773617,0.9025218725553863,213,207,219,197,-16,-22,-10,25,-4.0318344112286875,-3.5157760804678437,-3.02144267787038,-1.6912633363255634,11552,11635,Dickinson+Iron+Menominee,Iron,26,71,Michigan,MI
26109,26CS018,251,240,261,248,-3,-13,8,22,-5.749333164670122,-4.258713482937886,-2.427945204398426,-14.65602242924547,306,294,319,326,20,7,32,33,-1.085714857801101,-0.5829367245804423,-0.02299533295872182,1.607258284015911,23315,23317,Dickinson+Iron+Menominee,Menominee,26,109,Michigan,MI
26045,26CS019,888,841,935,1071,183,136,230,80,2.1216275797743998,3.7722982568140644,5.55260797059348,0.4353777551756193,1092,1035,1148,1330,238,182,295,183,0.006231337285530499,0.4974339750177892,1.0120795447082844,0.7644018967945888,109237,108968,Eaton,Eaton,26,45,Michigan,MI
26049,26CS020,3916,3742,4090,4701,785,611,959,497,1.2461272588884276,2.809269332660169,4.573441191863548,0.6322781328077213,4789,4580,4998,5635,846,637,1055,670,-0.10636621411289865,0.4485255344322144,0.9340833129308527,0.7907926651925584,405506,404418,Genesee,Genesee,26,49,Michigan,MI
26055,26CS021,789,748,830,899,110,69,151,37,1.2044611392594144,3.0745672084636597,4.825305952140781,0.33445770636523553,978,929,1027,1121,143,94,192,113,-0.18360647171149014,0.33338143521448055,0.816169337274742,0.7849516893996011,95039,95781,Grand Traverse+Leelanau,Grand Traverse,26,55,Michigan,MI
26089,26CS021,214,204,223,243,29,20,39,10,1.7016364089294038,3.464128604724974,5.1482216927162,0.33225249114965194,266,254,277,316,50,39,62,28,0.4405490958682014,0.9829200422308694,1.518043984243105,0.5471684689620017,22246,22576,Grand Traverse+Leelanau,Leelanau,26,89,Michigan,MI
26057,26CS022,408,390,426,484,76,58,94,54,0.5780665125412343,2.169141596026215,3.8322949891850633,0.6993443628289051,500,478,521,528,28,7,50,48,-0.9691541045139144,-0.4797595304168264,0.07029211053687372,1.6362895093709493,41507,41561,Gratiot+Isabella,Gratiot,26,57,Michigan,MI
26073,26CS022,395,367,423,512,117,89,145,33,3.4804978001763427,5.10393236931554,6.841621851511183,0.2800176423868274,489,455,522,685,196,163,230,101,0.9651185994042362,1.4710957386891446,2.010890220283638,0.5120286583045739,65272,64766,Gratiot+Isabella,Isabella,26,73,Michigan,MI
26063,26CS023,382,369,396,424,42,28,55,46,-2.190493483642354,-0.5444645774807431,1.1254452737130167,1.0722415296016379,464,448,480,529,65,49,81,71,-0.6946286839185929,-0.18276596311999477,0.3211395613322226,1.0791281529954184,31276,31266,Huron+Sanilac,Huron,26,63,Michigan,MI
26151,26CS023,419,401,436,492,73,56,91,64,-0.7732832266172166,0.904450625290879,2.6531254743086516,0.8623910275298241,510,489,531,644,134,113,155,99,0.3488811928068586,0.8736917079297094,1.362178844172764,0.7322341914955873,40610,40506,Huron+Sanilac,Sanilac,26,151,Michigan,MI
26065,26CS024,1849,1727,1972,2244,395,272,517,157,1.6396546014804212,3.3860978357022873,5.078749245889737,0.3967499028071923,2277,2130,2424,2847,570,423,717,345,0.26647150728351837,0.7992517116109502,1.3046808238069127,0.6042970711773508,285476,284105,Ingham,Ingham,26,65,Michigan,MI
26067,26CS025,473,444,502,520,47,18,76,31,-0.8446754982291811,0.916485191110944,2.8055700743150136,0.6468005023826215,587,552,621,628,41,7,76,82,-1.1368594950531588,-0.6199221373089417,-0.06226031904989693,1.9396109911405877,66574,67148,Ionia,Ionia,26,67,Michigan,MI
26075,26CS026,1489,1420,1558,1706,217,148,286,175,-0.5556648012868423,1.1077269258972826,2.757355553302995,0.8019038858715556,1824,1742,1907,2158,334,251,416,229,0.12679964764180743,0.673363326406369,1.1680460803348445,0.6845205002945541,159916,160072,Jackson,Jackson,26,75,Michigan,MI
26077,26CS027,1841,1728,1954,2161,320,207,433,185,0.266855816599591,2.045545211477283,3.824647482581668,0.5765112714218622,2261,2127,2396,2657,396,261,530,249,-0.0035183908944115077,0.56707029579035,1.0722619561154527,0.6279726280599364,262144,261184,Kalamazoo,Kalamazoo,26,77,Michigan,MI
26081,26CS028,4184,3901,4467,4822,638,355,921,442,-0.5542560770715802,1.1348007753054548,3.0066258201620406,0.6917014688984522,5166,4827,5506,5808,642,302,981,542,-0.3655865392687453,0.15516953767491753,0.6584537562665388,0.8434913774168001,657860,658045,Kent,Kent,26,81,Michigan,MI
26085,26CS029,154,149,159,175,21,16,26,3,4.16514300544571,5.91354177764987,7.617048076454998,0.13704735759221892,190,184,197,194,4,-3,10,20,-1.8223758346922159,-1.3374395958490168,-0.8333133812802923,4.3921533058457944,12070,12278,Lake+Missaukee+Wexford,Lake,26,85,Michigan,MI
26113,26CS029,149,143,156,167,18,11,24,7,1.1599714528951575,2.7999665897625694,4.539479695971303,0.37606367701894006,183,175,191,204,21,13,29,30,-1.1380489330283035,-0.6017713700715193,-0.05101494514436213,1.3751018058084095,15075,15121,Lake+Missaukee+Wexford,Missaukee,26,113,Michigan,MI
26165,26CS029,308,293,322,329,21,7,36,12,-0.5589593656803696,1.0647295317970686,2.75101340932584,0.5404129989863925,379,361,396,507,128,111,146,66,1.3322724664208914,1.8442139554125432,2.3524913638649276,0.5106330758432945,33696,33868,Lake+Missaukee+Wexford,Wexford,26,165,Michigan,MI
26087,26CS030,768,730,806,874,106,68,144,96,-1.2201659309533897,0.4190419943065171,2.1932484971183066,0.8970738759210363,946,900,991,1206,260,215,306,210,0.03830157521231915,0.5720942552445882,1.0751356871994135,0.8031606892637216,88421,88515,Lapeer,Lapeer,26,87,Michigan,MI
26091,26CS031,908,865,950,1037,129,87,172,75,0.4437189464615611,2.1500268589264775,3.822960345111095,0.5748156254016226,1110,1059,1161,1308,198,147,249,188,-0.4081431849630287,0.09959637106675759,0.6052727488996984,0.9445063865256653,99086,98994,Lenawee,Lenawee,26,91,Michigan,MI
26093,26CS032,1277,1193,1360,1499,222,139,306,80,1.2085878411535473,2.9605810960985792,4.683645149823131,0.35803160093633146,1584,1483,1685,1911,327,226,428,226,-0.021100894861521044,0.5232084077313891,1.0934305592806686,0.6891684610259605,193802,194862,Livingston,Livingston,26,93,Michigan,MI
26099,26CS033,7541,7163,7919,9309,1768,1390,2146,1407,-0.029456510792953004,1.6989230893966274,3.4291893166651266,0.7954402300826288,9230,8777,9683,10657,1427,974,1880,1448,-0.5426858287023313,-0.008231915918773185,0.5140247566856082,1.013833198105884,878818,877311,Macomb,Macomb,26,99,Michigan,MI
26103,26CS034,585,557,613,600,15,-13,43,44,-3.5050813508429197,-1.7269488425160837,0.0017669922936718527,2.7512660605211696,717,683,752,793,76,41,110,41,0.01480037181221483,0.5278931976287291,1.0211451808899425,0.5356510598984933,66059,66078,Marquette,Marquette,26,103,Michigan,MI
26107,26CS035,323,306,341,412,89,71,106,13,5.829133336220122,7.482337071104966,9.160929143160109,0.1450673711339609,397,376,418,474,77,56,98,59,-0.06329062214502201,0.44769410323980746,0.95773877685126,0.7567889162298147,40362,39995,Mecosta+Osceola,Mecosta,26,107,Michigan,MI
26133,26CS035,211,202,221,223,12,2,21,17,-2.525145008674741,-0.916706045046167,0.8206264366309551,1.3504755573583778,261,249,273,285,24,12,36,47,-1.489170485462278,-1.0033005287328591,-0.4833707160843642,1.8758068094305538,22984,23073,Mecosta+Osceola,Osceola,26,133,Michigan,MI
26111,26CS036,648,612,684,767,119,83,155,37,2.268254199559451,3.9629942580354367,5.6181483879793905,0.30886941092519654,797,754,840,938,141,98,184,103,-0.028215403089043706,0.4532579763998827,0.964406983722314,0.7246308419339169,83465,83460,Midland,Midland,26,111,Michigan,MI
26115,26CS037,1330,1264,1397,1530,200,133,266,123,0.18211890806929545,1.9697473647260992,3.709745695474863,0.6133563849834219,1642,1562,1722,1929,287,207,367,207,8.186536412116268e-4,0.49924635011241913,1.0132226519188845,0.7182555605770948,154206,155204,Monroe,Monroe,26,115,Michigan,MI
26117,26CS038,570,541,598,620,50,22,79,70,-2.876284501479162,-1.1325940451106793,0.48925383791349025,1.3667701875676908,710,675,745,819,109,74,144,90,-0.27102863782184117,0.285560839628429,0.7769902341791227,0.8185783640710391,66179,67117,Montcalm,Montcalm,26,117,Michigan,MI
26121,26CS039,1517,1442,1593,1878,361,285,436,247,0.8180655335810956,2.609301384001782,4.311191795476976,0.6827514258053754,1869,1778,1960,2150,281,190,372,230,-0.2560777617248887,0.3005679292154781,0.8244099571775898,0.8154461392789233,175573,176410,Muskegon,Muskegon,26,121,Michigan,MI
26123,26CS040,441,420,463,488,47,25,68,30,-0.3866486631015192,1.3674897696976072,3.155656154541304,0.627500545440489,541,515,567,641,100,74,126,82,-0.17489459545036762,0.38914121045746264,0.8511537289101826,0.810300840616259,49920,50259,Newaygo+Oceana,Newaygo,26,123,Michigan,MI
26127,26CS040,231,219,242,284,53,42,65,41,0.19610487350096403,1.853624560990256,3.659403602643896,0.7527627955181219,282,268,296,330,48,34,62,37,-0.12759486773731724,0.4171863607245435,0.9264880499516998,0.7588348654762611,26683,26796,Newaygo+Oceana,Oceana,26,127,Michigan,MI
26013,26CS041,89,88,90,105,16,15,17,27,-5.93471290850316,-5.514836794766243,-5.1270826781202965,1.6117612536992276,110,109,111,114,4,3,5,18,-1.876870316971488,-1.7567721971958172,-1.6280656259812434,3.9134176915668184,8154,8202,Northwest Upper Peninsula,Baraga,26,13,Michigan,MI
26053,26CS041,169,163,175,207,38,32,44,38,-1.6111677802938555,0.05784772564425071,1.74998675572374,0.9698944606582351,208,201,215,211,3,-4,10,20,-1.7299620286676105,-1.1787486272222583,-0.6771575820672366,5.06927053536423,14270,14354,Northwest Upper Peninsula,Gogebic,26,53,Michigan,MI
26061,26CS041,322,306,338,333,11,-5,27,27,-3.4157098174712517,-1.7645675063278268,0.042980421171354304,2.276918858676165,401,382,420,381,-20,-39,-1,46,-2.2737965406930263,-1.764059089755559,-1.2584277745348873,-2.4306471821366036,36964,37291,Northwest Upper Peninsula,Houghton,26,61,Michigan,MI
26083,26CS041,24,23,25,26,2,1,3,4,-6.142144240033849,-4.387633641218599,-2.659635925886692,1.479132563750994,30,29,31,35,5,4,6,2,0.7577257667770385,1.2855517339491396,1.7690042641973522,0.35212108134131653,2065,2099,Northwest Upper Peninsula,Keweenaw,26,83,Michigan,MI
26131,26CS041,82,81,83,115,33,32,34,20,8.534662295266296,8.928982780474938,9.32867667761212,0.5892385861225501,102,101,102,101,-1,-1,0,13,-2.4704847228429276,-2.3441224449822626,-2.2240772416979167,47.09771699869749,5797,5859,Northwest Upper Peninsula,Ontonagon,26,131,Michigan,MI
26125,26CS042,9157,8610,9703,10946,1789,1243,2336,1401,-0.6504547408505332,1.3313984038033375,2.970520058260004,0.7825826987213773,11265,10609,11920,12421,1156,501,1812,1189,-0.5201569278930068,-0.02216029743677476,0.5103426061539836,1.0272160661216048,1270018,1270366,Oakland,Oakland,26,125,Michigan,MI
26139,26CS043,1761,1633,1888,2147,386,259,514,221,0.4468436398725825,2.237499073171111,3.9153179051572398,0.5703529185810768,2198,2044,2352,2544,346,192,500,290,-0.3314866514734579,0.1918528624625747,0.6935740069703509,0.8361973378098558,296257,298811,Ottawa,Ottawa,26,139,Michigan,MI
26145,26CS044,1813,1732,1895,2310,497,415,578,328,1.7048840393909928,3.566689973086957,5.1655758120962325,0.6589520578418386,2218,2120,2316,2583,365,267,463,337,-0.3589460545610494,0.1447604047614153,0.683232379561908,0.9217601123745857,189901,189626,Saginaw,Saginaw,26,145,Michigan,MI
26147,26CS045,1531,1462,1600,1776,245,176,314,154,0.5683000155774555,2.304405842976579,4.1021161986044765,0.6268463892309782,1874,1791,1957,2356,482,399,565,411,-0.08401549453511417,0.45302590841236867,0.9738737350791552,0.8508821791326331,160108,160084,St. Clair,St. Clair,26,147,Michigan,MI
26149,26CS046,569,542,595,639,70,44,97,59,-0.8548446682522819,0.7483700702529259,2.343867804273468,0.8268218767228951,696,664,727,792,96,65,128,89,-0.36747859651324644,0.12116540337746469,0.6257150479215121,0.9159047656828314,60876,60779,St. Joseph,St. Joseph,26,149,Michigan,MI
26155,26CS047,633,604,663,728,95,65,124,49,0.9549777458126827,2.662558961166475,4.347026239714818,0.5124774901336975,777,742,812,879,102,67,137,118,-0.7475345014876978,-0.23672883879550294,0.2798574734556176,1.14184187913053,67984,67892,Shiawassee,Shiawassee,26,155,Michigan,MI
26157,26CS048,534,511,557,647,113,90,136,90,0.03993111763049932,1.7779299764090721,3.3386954406001643,0.7903277437232824,654,626,681,794,140,113,168,118,-0.07316189369131976,0.4083240619593237,0.964775528144718,0.8356558509743139,53103,52969,Tuscola,Tuscola,26,157,Michigan,MI
26159,26CS049,660,627,692,767,107,75,140,90,-0.632135237329175,0.8637181929894087,2.560894825428391,0.830278321733339,809,770,848,979,170,131,209,117,0.19830606674414297,0.7016389829818472,1.193581193290627,0.6835265147830796,75572,75643,Van Buren,Van Buren,26,159,Michigan,MI
26161,26CS050,2004,1845,2164,2311,307,147,466,179,-0.31189993435098434,1.3527542585697627,3.1464769276465203,0.5819346996338353,2485,2294,2676,2630,145,-46,336,172,-0.615756648324329,-0.06708377087188437,0.45695932318390353,1.1798271729272451,370922,369720,Washtenaw,Washtenaw,26,161,Michigan,MI
26163,26CS051,15695,14927,16463,19800,4105,3337,4873,3079,0.6073179437296207,2.255314872429696,4.087813931808106,0.7498776912769727,19152,18234,20069,21672,2520,1603,3438,2477,-0.4990503040688349,0.01614370400484144,0.5275827226026832,0.982510297849765,1782767,1777063,Wayne,Wayne,26,163,Michigan,MI
27001,27CS001,192,185,198,225,33,27,40,29,-0.5679688484441469,1.1294909813885687,2.806932568541669,0.8434306799045134,236,228,244,248,12,4,20,20,-1.0366517781425908,-0.4932558161538669,0.07606816483590789,1.5153761281643512,15735,15859,Aitkin+Itasca,Aitkin,27,1,Minnesota,MN
27061,27CS001,445,426,465,469,24,4,43,36,-2.872429095204789,-1.1086321040392577,0.6690195923848203,1.4494210433783603,546,523,569,684,138,115,161,64,1.1257124144664035,1.6265802705618444,2.1258605591561723,0.46056480324609494,45028,45057,Aitkin+Itasca,Itasca,27,61,Minnesota,MN
27003,27CS002,1948,1792,2105,2359,411,254,567,331,-0.9054239488215343,0.9064019994319097,2.662463809538353,0.8042649685344031,2440,2251,2629,2762,322,133,511,307,-0.4477263157159794,0.04468025356899089,0.5385988918454538,0.9498874753568471,363596,366621,Anoka,Anoka,27,3,Minnesota,MN
27005,27CS003,328,312,343,386,58,43,74,40,0.4712620021414441,2.098215308949061,3.879524180354563,0.6733110111304847,406,388,424,410,4,-14,22,43,-1.638794979045928,-1.0948365536516376,-0.6082911110291559,8.46394657672333,35054,35208,Becker+Hubbard+Mahnomen+Norman,Becker,27,5,Minnesota,MN
27057,27CS003,191,182,200,229,38,29,47,37,-1.5371865388576185,0.15295084529021447,1.719787720132907,0.954157370375089,239,228,250,236,-3,-14,8,15,-1.3373833798602748,-0.8266971728491952,-0.3047045421980696,-7.630023717518187,21448,21666,Becker+Hubbard+Mahnomen+Norman,Hubbard,27,57,Minnesota,MN
27087,27CS003,55,55,56,68,13,12,13,3,6.750080254645741,7.15560774158366,7.554589184152058,0.21962669029960322,68,67,69,88,20,19,21,10,1.705539929705871,1.8394939012829208,1.9664134451867423,0.47715728073173647,5402,5408,Becker+Hubbard+Mahnomen+Norman,Mahnomen,27,87,Minnesota,MN
27107,27CS003,83,83,84,66,-17,-18,-17,5,-14.271049246835691,-13.844999556890606,-13.450036780199799,-0.30809778592695797,102,101,103,85,-17,-18,-16,3,-3.2495204488597857,-3.119466391671528,-2.9979009958637537,-0.18724912483714795,6416,6417,Becker+Hubbard+Mahnomen+Norman,Norman,27,107,Minnesota,MN
27007,27CS004,345,325,364,461,116,97,136,40,4.858210866538295,6.550001163279943,8.380912359917156,0.3406074395587666,424,400,448,507,83,59,107,56,0.08474389083478122,0.5862122475952385,1.1385173904654016,0.6649520099195885,46388,46358,Beltrami+Clearwater,Beltrami,27,7,Minnesota,MN
27029,27CS004,82,81,83,92,10,9,11,10,-0.2961941125539251,0.10695348740957672,0.5056033107391396,0.8915355157699195,100,99,101,125,25,24,26,15,1.0658642705044932,1.1858782709639335,1.3064701631438422,0.5722704753966726,8618,8577,Beltrami+Clearwater,Clearwater,27,29,Minnesota,MN
27009,27CS005,327,309,345,397,70,52,88,72,-1.9219666281551695,-0.20067941528864375,1.5731741260789156,1.0116382898130083,403,382,425,407,4,-18,25,51,-1.65916795367616,-1.1516674586481588,-0.6117002182131472,10.544806040765158,41292,41441,Benton+Stearns,Benton,27,9,Minnesota,MN
27145,27CS005,919,851,987,1187,268,200,336,185,0.30395828683314796,2.0739647209443226,3.850891182178709,0.688218081483458,1142,1060,1224,1277,135,53,217,121,-0.4017015840393471,0.08242826042213118,0.590800999215195,0.8896807467159241,158809,158860,Benton+Stearns,Stearns,27,145,Minnesota,MN
27013,27CS006,434,404,463,456,22,-7,52,27,-1.9197987280949738,-0.22565054579593663,1.4885668576899433,1.158791008977212,535,499,571,593,58,22,94,41,-0.25936162727609713,0.2401995149613974,0.7206166746401794,0.6963957614017843,68995,69264,Blue Earth+Faribault+Martin+Watonwan,Blue Earth,27,13,Minnesota,MN
27043,27CS006,162,156,168,159,-3,-9,3,11,-5.603566796573178,-3.9256147462022,-2.112705172855751,-7.012289097797511,197,190,204,184,-13,-20,-6,17,-2.6884526079140465,-2.1671115139685457,-1.6364946584077305,-1.4149210922090047,13859,13906,Blue Earth+Faribault+Martin+Watonwan,Faribault,27,43,Minnesota,MN
27091,27CS006,214,206,223,215,1,-8,9,23,-6.098654817717136,-4.508832439485148,-2.8682369447379576,14.992352474088298,261,251,271,302,41,31,51,25,0.31465528640690793,0.8147416536608234,1.3264486500725403,0.5955586906393414,19916,19923,Blue Earth+Faribault+Martin+Watonwan,Martin,27,91,Minnesota,MN
27165,27CS006,103,102,104,134,31,30,32,10,7.212702748629878,7.61094994237411,8.006128208262943,0.3105015960544685,126,124,127,128,2,1,4,15,-1.264268757774001,-1.1341253761530272,-1.0102858966933796,4.485918328824377,11157,11148,Blue Earth+Faribault+Martin+Watonwan,Watonwan,27,165,Minnesota,MN
27015,27CS007,257,246,268,268,11,0,22,30,-4.640050177469517,-2.903182478498613,-1.2293401351472422,2.4474240683301085,316,303,330,342,26,12,39,30,-0.6965371923826791,-0.15206203444043223,0.3590526779949447,1.1183601946325457,25744,25829,Brown+Le Sueur+Nicollet,Brown,27,15,Minnesota,MN
27079,27CS007,210,198,223,216,6,-7,18,19,-3.5886897596493927,-1.8356724400418498,-0.1357772514766905,2.8711373869652776,262,247,277,284,22,7,37,32,-0.843059205213005,-0.3609841030570141,0.12204566055509639,1.4063835258202748,28683,28810,Brown+Le Sueur+Nicollet,Le Sueur,27,79,Minnesota,MN
27103,27CS007,224,209,239,238,14,-1,29,30,-3.4558461455788647,-1.8177392339124412,-0.18551024729050336,1.9731825328110462,278,260,296,297,19,1,37,20,-0.5573276757762164,-0.03310302122758315,0.46958130080978894,1.0028016383439653,34447,34355,Brown+Le Sueur+Nicollet,Nicollet,27,103,Minnesota,MN
27019,27CS008,476,430,522,510,34,-12,80,36,-1.7069856383862099,-0.11829653875000978,1.657266141705152,1.0375110610060074,602,546,658,674,72,16,128,53,-0.34213946202844875,0.16948767672061044,0.7110573371571957,0.723979329142812,107111,108431,Carver,Carver,27,19,Minnesota,MN
27021,27CS009,291,278,303,310,19,7,32,24,-2.2881998543165314,-0.6030301259522999,1.211316176973945,1.1717881703028687,361,345,377,428,67,51,83,40,0.3573959464430248,0.8669621907095066,1.401052047553646,0.5873721613889362,30105,30564,Cass+Crow Wing,Cass,27,21,Minnesota,MN
27035,27CS009,609,581,638,619,10,-19,38,68,-5.198638848384617,-3.543520751853082,-1.8225916999087803,6.3954475420369175,757,722,792,815,58,23,93,67,-0.6876727474996838,-0.14322058532474513,0.3648685744420186,1.1338212844525033,66191,67119,Cass+Crow Wing,Crow Wing,27,35,Minnesota,MN
27025,27CS010,389,364,413,412,23,-1,48,27,-2.0511943577861773,-0.2784005589044088,1.524103822265509,1.1112059064945838,486,456,515,544,58,29,88,64,-0.6139357202693447,-0.09515792192090702,0.40826657865650523,1.0803840313913402,56735,57352,Chisago+Isanti,Chisago,27,25,Minnesota,MN
27059,27CS010,294,276,312,314,20,2,38,31,-2.743969239380378,-1.1142387014120076,0.6335948083943561,1.4827463152574003,367,346,389,435,68,46,89,57,-0.27548909953141404,0.24323971989180806,0.7469611505815197,0.8307842459312508,41301,41830,Chisago+Isanti,Isanti,27,59,Minnesota,MN
27027,27CS011,423,395,451,489,66,38,94,83,-2.6674202899375907,-1.0917643111992625,0.6515426378773388,1.2446543282130036,523,490,557,537,14,-20,47,32,-0.8074877383669283,-0.2698520126314367,0.27125480207025476,2.1983501151983655,65242,65541,Clay,Clay,27,27,Minnesota,MN
27037,27CS012,2337,2148,2526,2746,409,220,598,285,-0.5692357545053357,1.0791645621557062,2.6751322183469104,0.6957149718981863,2922,2694,3150,3236,314,86,542,333,-0.5811302793467928,-0.048499638547281496,0.4935224004252363,1.057725076622611,438912,441787,Dakota,Dakota,27,37,Minnesota,MN
27039,27CS013,139,137,141,133,-6,-8,-4,7,-2.829672886387552,-2.464387651662819,-2.0550531306231132,-1.448565398886749,171,169,174,163,-8,-11,-6,11,-1.056755164193781,-0.9264891551050215,-0.7992071931937109,-1.478380053986938,20885,20924,Dodge+Steele+Waseca,Dodge,27,39,Minnesota,MN
27147,27CS013,278,262,294,299,21,5,37,4,0.0819373557863009,1.83047901136909,3.5808482658714444,0.17809799819027486,344,325,363,382,38,19,57,33,-0.373415838299641,0.12742102824050838,0.6387994262090748,0.8503855472644053,37255,37349,Dodge+Steele+Waseca,Steele,27,147,Minnesota,MN
27161,27CS013,162,154,170,162,0,-8,8,18,-5.491804887937482,-3.8189855923484464,-2.1768135719488675,16.943679724577603,200,191,210,188,-12,-22,-3,14,-1.8910837017068303,-1.3840472687069891,-0.8964168347936176,-1.224691332660578,18901,18993,Dodge+Steele+Waseca,Waseca,27,161,Minnesota,MN
27041,27CS014,386,369,403,433,47,30,64,52,-2.2202720049122235,-0.5180102212746568,1.2015000435362535,1.0801041041332926,473,453,494,447,-26,-47,-6,46,-2.370701374347958,-1.8403333864929141,-1.299409897793097,-1.8091592343004912,38948,39215,Douglas+Morrison+Todd,Douglas,27,41,Minnesota,MN
27097,27CS014,281,266,295,323,42,28,57,43,-1.7359536153458188,-0.1152476466113675,1.6195194736265701,0.9901039870484853,344,327,362,415,71,53,88,34,0.5424149596621257,1.0942931545539651,1.5917738971857072,0.4740084487148606,33886,33990,Douglas+Morrison+Todd,Morrison,27,97,Minnesota,MN
27153,27CS014,188,178,199,214,26,15,36,31,-2.7216840300903544,-0.8097725051124142,0.7722930098028499,1.1656205147849572,232,219,245,252,20,7,33,28,-0.8214446868387125,-0.2915272022247309,0.17262718607153008,1.3063035002412036,25172,25239,Douglas+Morrison+Todd,Todd,27,153,Minnesota,MN
27045,27CS015,199,189,208,206,7,-2,17,5,-1.2159493390719647,0.42683206240979565,2.0942862505643687,0.5933328321022436,242,231,253,248,6,-5,17,14,-0.8815601460703876,-0.39654908235838493,0.1425853230793087,2.0607884861648875,21225,21267,Fillmore+Houston+Winona,Fillmore,27,45,Minnesota,MN
27055,27CS015,165,157,173,179,14,6,22,12,-1.3447076200889387,0.3986841030688829,2.165681905311077,0.804987520016215,201,191,211,201,-0,-10,10,6,-0.8623322562803778,-0.3127541294914773,0.1821163815948475,6.571054804671856,18792,18784,Fillmore+Houston+Winona,Houston,27,55,Minnesota,MN
27169,27CS015,356,335,377,389,33,12,54,41,-2.3882449773686187,-0.6389112969406395,0.9999805705573875,1.2103959227145826,435,409,461,430,-5,-31,21,20,-1.0016730829554787,-0.5036270781071738,-0.009096015160201254,-4.968509998332607,49762,49626,Fillmore+Houston+Winona,Winona,27,169,Minnesota,MN
27047,27CS016,311,297,324,326,15,2,29,17,-1.9350627348872613,-0.2847473410893664,1.5526843561984702,1.0430872353477687,379,363,394,391,12,-3,28,24,-0.896879230046599,-0.37705024393496767,0.11438557800532825,1.7910498724127022,30796,30769,Freeborn+Mower,Freeborn,27,47,Minnesota,MN
27099,27CS016,354,336,371,354,0,-17,18,30,-4.745986408098518,-2.8314916676547397,-1.223601564074948,20.549028062725096,433,413,454,446,13,-8,33,21,-0.7840517099385546,-0.23371075684858317,0.22512602007493338,1.5504024646991132,40059,40142,Freeborn+Mower,Mower,27,99,Minnesota,MN
27049,27CS017,427,407,448,482,55,34,75,42,-0.616717500024224,1.0262564423619154,2.858710283350816,0.7542915896267075,529,504,554,566,37,12,62,43,-0.6555413143824743,-0.10461288278490957,0.37838985216004795,1.1270171956107558,47414,47905,Goodhue+Wabasha,Goodhue,27,49,Minnesota,MN
27157,27CS017,168,159,177,194,26,17,35,6,2.1716699643240123,3.70625544199718,5.527825856639539,0.22099462127426578,207,196,218,219,12,1,23,10,-0.4343402879728393,0.07876772581832837,0.5782523184819879,0.7789364594657695,21446,21496,Goodhue+Wabasha,Wabasha,27,157,Minnesota,MN
27053,27CS018,7636,7086,8185,9067,1431,882,1981,1286,-1.1217127917889633,0.5124745980046794,2.1794193197999965,0.8977366411899065,9379,8723,10034,9900,521,-134,1177,683,-0.6107713809118337,-0.12339271757048476,0.36826156816457595,1.3077526039204854,1277475,1269436,Hennepin,Hennepin,27,53,Minnesota,MN
27065,27CS019,142,135,149,181,39,32,46,19,3.3175831964235853,4.926434114995399,6.589212254471873,0.47542986056265685,174,166,182,213,39,31,47,29,0.12155825855844585,0.6264664550843267,1.0843198247763755,0.7271955490856681,16099,16142,Kanabec+Mille Lacs+Pine,Kanabec,27,65,Minnesota,MN
27095,27CS019,261,249,272,306,45,34,57,42,-1.0841836155457363,0.4887326446538459,2.178542245424246,0.9058346287098792,322,308,336,377,55,41,69,47,-0.22533675341544346,0.2920180962134912,0.8279410883430735,0.8389738681680159,26422,26800,Kanabec+Mille Lacs+Pine,Mille Lacs,27,95,Minnesota,MN
27115,27CS019,250,237,262,302,52,40,65,18,3.0036511974454694,4.737362475650328,6.455571030373448,0.33815642998233425,308,293,323,392,84,69,99,38,1.0706146576139646,1.5573464194634157,2.04432329840973,0.44752666839155825,28985,29237,Kanabec+Mille Lacs+Pine,Pine,27,115,Minnesota,MN
27067,27CS020,337,318,356,406,69,50,88,69,-1.6649162208646662,0.03807299802374972,1.6853217501159514,0.9824707411626535,415,392,437,438,23,1,46,48,-1.1125752426818554,-0.5763153518291663,-0.05576148911705629,1.9831642912157832,43614,43755,Kandiyohi+Renville,Kandiyohi,27,67,Minnesota,MN
27129,27CS020,159,152,165,174,15,9,22,34,-6.8417418491853805,-5.127473428386193,-3.3569829402573976,2.0896215615010028,193,186,201,203,10,2,17,10,-0.5017104473805934,-0.006359661356996428,0.4774381092477751,0.9214367217852117,14657,14619,Kandiyohi+Renville,Renville,27,129,Minnesota,MN
27085,27CS021,294,279,310,376,82,66,97,39,3.0371823204385877,4.638861453475445,6.459532562687241,0.4719793792273399,361,342,380,417,56,37,75,43,-0.12250734632196941,0.3404176108364902,0.8979735021726293,0.7530095722827461,36577,36730,McLeod+Meeker+Sibley,McLeod,27,85,Minnesota,MN
27093,27CS021,194,184,204,226,32,22,42,29,-1.1606616448733351,0.451031400582277,2.32609749368284,0.8744062045099026,237,225,249,244,7,-5,19,27,-1.3469053793354484,-0.8443121524191614,-0.32972248812467636,3.258431552420333,23384,23384,McLeod+Meeker+Sibley,Meeker,27,93,Minnesota,MN
27143,27CS021,122,121,123,93,-29,-30,-28,3,-9.062658570562407,-8.636630518215044,-8.2750628243161,-0.10714871086824465,150,148,152,169,19,17,21,12,0.3200190275117602,0.4483984964923064,0.570242374600623,0.6109483327293053,14824,14900,McLeod+Meeker+Sibley,Sibley,27,143,Minnesota,MN
27069,27CS022,50,49,50,74,24,24,25,19,4.431563468259985,4.848698715544826,5.237291185707009,0.7574552223063137,61,60,61,61,0,-0,1,5,-1.2529571488296252,-1.1260298826897104,-1.0018681223515193,3.7935936001892494,4192,4151,Northwest Minnesota,Kittson,27,69,Minnesota,MN
27077,27CS022,39,38,39,45,6,6,7,7,-1.13778524904723,-0.7602446173836616,-0.375307118844863,0.9614280959211379,48,48,49,50,2,1,2,3,-0.4659823903559313,-0.3274506291062204,-0.1959017077430992,1.089242789067232,3763,3814,Northwest Minnesota,Lake of the Woods,27,77,Minnesota,MN
27089,27CS022,72,71,73,87,15,14,16,15,-0.35819229010864634,0.04454103472603091,0.4659662919198132,0.931221546288455,88,87,89,97,9,8,10,12,-0.44210324830470804,-0.322434376490387,-0.2052268210169699,1.1863514089927594,9075,8995,Northwest Minnesota,Marshall,27,89,Minnesota,MN
27113,27CS022,116,114,117,121,5,4,7,13,-2.57441232387448,-2.172736175911014,-1.7706918445911524,2.025548620683556,141,139,143,155,14,12,16,13,-0.0542385292217113,0.07014497940227517,0.1912393246832997,0.870007433134137,13941,13803,Northwest Minnesota,Pennington,27,113,Minnesota,MN
27119,27CS022,301,288,315,349,48,34,61,60,-3.272186678228298,-1.5450347791382875,0.10477410333957606,1.233599860997856,368,352,384,378,10,-6,26,35,-1.3290586332331396,-0.8220986026588559,-0.28444821432163886,3.2193204742187027,31061,30800,Northwest Minnesota,Polk,27,119,Minnesota,MN
27125,27CS022,28,28,29,27,-1,-2,-1,0,-1.7471909464990596,-1.3395576860983136,-0.9668259406841652,-0,35,34,35,43,8,8,9,8,-0.09811702531563742,0.038351842995723376,0.16151592560274006,0.8743029456900394,3950,3933,Northwest Minnesota,Red Lake,27,125,Minnesota,MN
27135,27CS022,120,118,121,174,54,53,56,17,9.391252025784107,9.789162640265442,10.188547877040577,0.3068919715644257,147,146,149,169,22,20,23,15,0.3086586778098985,0.4279365964435242,0.5601470400224463,0.6651835669055327,15273,15263,Northwest Minnesota,Roseau,27,135,Minnesota,MN
27109,27CS023,970,900,1040,1055,85,15,155,57,-1.1208542719441916,0.7084206348183437,2.2874086689242663,0.6638205487378438,1206,1122,1290,1261,55,-29,139,51,-0.5164006696010625,0.007225936562987185,0.5425784481086079,0.9107839824570173,162337,163371,Olmsted,Olmsted,27,109,Minnesota,MN
27111,27CS024,582,556,608,675,93,67,119,53,0.912198947239155,2.713906424644933,4.453399142881161,0.5634225841795338,712,681,743,779,67,36,98,82,-0.7719731988787872,-0.23228021491904505,0.2526979561423489,1.2057719079842186,59831,60043,Otter Tail+Wadena+Wilkin,Otter Tail,27,111,Minnesota,MN
27159,27CS024,182,176,189,170,-12,-19,-6,11,-8.300306530762317,-6.658401116983632,-4.930653480309806,-0.957110775246578,223,216,231,221,-2,-10,5,29,-2.7437849253272457,-2.20372553020311,-1.7052141153150746,-23.48732325865576,14049,14167,Otter Tail+Wadena+Wilkin,Wadena,27,159,Minnesota,MN
27167,27CS024,71,70,72,76,5,4,6,12,-4.732863121164036,-4.332301675534424,-3.92615415915829,1.9842953597389197,87,86,87,88,1,1,2,11,-1.6061626015530397,-1.4833459254086092,-1.3536195245139997,4.4212718159138245,6434,6408,Otter Tail+Wadena+Wilkin,Wilkin,27,167,Minnesota,MN
27123,27CS025,3669,3432,3905,4354,685,449,922,630,-1.1585742353426716,0.45134853868418157,2.0908339096110904,0.9180032284501014,4478,4197,4760,4968,490,208,771,357,-0.31069098869905626,0.22403785148181699,0.7530477123759127,0.727705791168427,550354,544456,Ramsey,Ramsey,27,123,Minnesota,MN
27131,27CS026,446,417,474,508,62,34,91,52,-0.9463249403968735,0.5753139400889224,2.275167995107992,0.8189393250842963,553,518,587,614,61,27,96,73,-0.6864512824899731,-0.17277850931106056,0.3139004356232032,1.1703706952562436,67052,67228,Rice,Rice,27,131,Minnesota,MN
27017,27CS027,326,310,341,367,41,26,57,41,-1.616740172210198,0.0705667408391998,1.6151705024193908,0.9650068270121751,401,382,419,470,69,51,88,34,0.44590652841976924,0.9574788222841648,1.4492962170185077,0.48330199415864955,36147,36372,St. Louis and Nearby Counties,Carlton,27,17,Minnesota,MN
27031,27CS027,45,45,46,48,3,2,3,1,0.9029836919669729,1.3192559541573696,1.7575734521544235,0.26050439524918134,56,55,57,49,-7,-8,-6,4,-2.0679445711614806,-1.9493801719116652,-1.8194776452760857,-0.6740269104939338,5569,5613,St. Louis and Nearby Counties,Cook,27,31,Minnesota,MN
27071,27CS027,124,123,125,147,23,22,24,3,6.305571666092308,6.692567518642134,7.0863480007373765,0.1241818462362397,151,149,152,186,35,34,37,22,0.9869161743223933,1.1067117771522004,1.2329402423534628,0.6057344128367307,12047,11954,St. Louis and Nearby Counties,Koochiching,27,71,Minnesota,MN
27075,27CS027,121,120,122,135,14,13,15,12,0.35698284218111687,0.734086386360145,1.1416858229290685,0.7997605941111399,150,148,151,168,18,17,20,6,0.9883492221922903,1.1111464853908446,1.241793587105835,0.31275818465037347,10858,10971,St. Louis and Nearby Counties,Lake,27,75,Minnesota,MN
27137,27CS027,1766,1680,1852,2079,313,227,399,220,0.19787367983891455,1.8685951863407166,3.614135999026671,0.6998199189975459,2156,2054,2259,2368,212,109,314,185,-0.3924539500065152,0.1268973071574444,0.6763362063865006,0.8703694959751818,199771,199296,St. Louis and Nearby Counties,St. Louis,27,137,Minnesota,MN
27139,27CS028,629,564,694,740,111,46,176,64,-0.48502110431499806,1.2092634784288625,2.9820480459153225,0.5721668464485303,795,716,874,911,116,37,195,109,-0.45277307733423433,0.0433729747065371,0.5513983866078529,0.93132951704194,151144,152976,Scott,Scott,27,139,Minnesota,MN
27141,27CS029,486,444,528,595,109,67,151,57,0.43552536398010794,2.156472877969646,4.00243465493181,0.5188785727971015,612,561,663,727,115,64,166,87,-0.19078105119983027,0.2745331155748714,0.7708991920197937,0.749361256736907,97637,98841,Sherburne,Sherburne,27,141,Minnesota,MN
27033,27CS030,136,131,141,150,14,9,19,16,-2.505360101019645,-0.5322444754991551,1.1224733536031857,1.0376068814727792,167,161,173,166,-1,-7,5,16,-1.9617168831278249,-1.470939674126412,-0.9573379513196479,619.6811063808541,11460,11557,Southwest Minnesota,Cottonwood,27,33,Minnesota,MN
27063,27CS030,91,90,92,96,5,4,6,11,-2.971124967550775,-2.553855515028509,-2.1422512886586502,1.9502557683526658,113,112,114,106,-7,-8,-6,8,-1.6244886136845025,-1.5021583110170886,-1.3727255706560098,-1.335980220095267,9946,9987,Southwest Minnesota,Jackson,27,63,Minnesota,MN
27101,27CS030,82,81,83,58,-24,-25,-23,5,-14.532238015235688,-14.115837771633707,-13.694782078097068,-0.21891138607670674,100,99,101,109,9,8,10,1,0.8079457080806088,0.9269242055617686,1.0624145093139228,0.10444421805664597,8170,8148,Southwest Minnesota,Murray,27,101,Minnesota,MN
27105,27CS030,161,152,171,201,40,30,49,43,-2.3563448138333674,-0.5712741476291969,1.194504763357451,1.0558787288631257,199,187,210,185,-14,-25,-2,18,-1.945868590941721,-1.433112404089461,-0.8899954107710155,-1.4142099760445215,22085,22019,Southwest Minnesota,Nobles,27,105,Minnesota,MN
27117,27CS030,103,102,104,106,3,2,4,17,-6.329702146308409,-5.958999004099958,-5.549278553014376,4.169554970476859,126,125,127,128,2,1,3,11,-1.1033101427977525,-0.9705568215369886,-0.8531763363063258,3.762981712254242,9359,9326,Southwest Minnesota,Pipestone,27,117,Minnesota,MN
27133,27CS030,102,101,103,119,17,16,18,13,1.2945636119818724,1.6864509815601951,2.1139077755190607,0.7189389037520844,126,125,127,122,-4,-5,-3,16,-2.1760669268101074,-2.048788275719377,-1.9147465925292733,-5.737731096952191,9648,9684,Southwest Minnesota,Rock,27,133,Minnesota,MN
27011,27CS031,68,67,68,67,-1,-1,-0,3,-3.235233385804473,-2.8563699458272276,-2.4533752941429903,8.551351880332165,84,83,84,76,-8,-8,-7,1,-1.7764550850429188,-1.6519822744087207,-1.5214422925483722,-0.1537215973198193,5121,5145,Stevens and Nearby Counties,Big Stone,27,11,Minnesota,MN
27023,27CS031,151,145,156,155,4,-1,10,28,-9.312913850571764,-7.6290995943845505,-5.828925595854755,5.372960821644015,183,177,190,172,-11,-18,-5,4,-1.713302749683559,-1.250268065495878,-0.730042994784566,-0.385088927058768,12446,12391,Stevens and Nearby Counties,Chippewa,27,23,Minnesota,MN
27051,27CS031,60,59,61,73,13,12,14,6,4.286424035890819,4.66929472216185,5.089364036098179,0.4255929765971548,75,74,75,78,3,3,4,1,0.25297769305890605,0.379144790358456,0.49855264026531276,0.23155560183055168,6073,6142,Stevens and Nearby Counties,Grant,27,51,Minnesota,MN
27121,27CS031,113,112,114,109,-4,-5,-3,8,-4.656665006388,-4.236304732153121,-3.8259545424520836,-2.683185199444444,140,139,142,148,8,6,9,8,-0.14613625221334173,-0.023768713504817504,0.10288447944849022,0.9162239594295967,11305,11389,Stevens and Nearby Counties,Pope,27,121,Minnesota,MN
27149,27CS031,74,73,75,80,6,5,7,7,-0.84746288970041594,-0.44983784691123346,-0.016343850726387586,1.0111154553371353,92,91,93,74,-18,-19,-17,4,-2.370065564072621,-2.251752151215224,-2.124492068714688,-0.23820343707663222,9677,9692,Stevens and Nearby Counties,Stevens,27,149,Minnesota,MN
27151,27CS031,106,105,107,123,17,16,18,17,-0.19667728239816973,0.18532160573645334,0.5601903493033344,0.920732807763456,130,129,132,94,-36,-38,-35,15,-5.41271584786505,-5.275738703527077,-5.150656858832757,-0.42288358840861173,9714,9755,Stevens and Nearby Counties,Swift,27,151,Minnesota,MN
27155,27CS031,48,48,48,56,8,8,8,9,-1.694999775302431,-1.300650617286867,-0.94439922243728,1.0104893856336417,58,58,59,61,3,2,3,6,-1.1847166974969172,-1.05121847105427,-0.9132493844223922,1.6921937756914418,3327,3295,Stevens and Nearby Counties,Traverse,27,155,Minnesota,MN
27163,27CS032,1492,1376,1607,1715,223,108,339,172,-0.9217023416597636,0.7591318211221162,2.4628707394999876,0.7672662473484044,1875,1735,2015,2017,142,2,282,182,-0.6689441081449518,-0.1542758921790573,0.33466314608158176,1.272532566964508,267790,271663,Washington,Washington,27,163,Minnesota,MN
27171,27CS033,751,690,812,824,73,12,134,92,-2.1553338225387946,-0.5381820732928638,1.0977505695809233,1.2375656785201228,951,877,1026,1097,146,71,220,146,-0.5209968567982732,-0.0010251230081878174,0.5262667198974221,0.9954681984166367,141611,144395,Wright,Wright,27,171,Minnesota,MN
27073,27CS034,71,70,72,94,23,22,24,16,3.695596857708919,4.085531849444275,4.471804233174296,0.6712999058836158,87,86,88,102,15,14,16,2,1.8156691134190959,1.9414543884431734,2.06758177756566,0.12522966073461364,6689,6686,Yellow Medicine and Nearby Counties,Lac Qui Parle,27,73,Minnesota,MN
27081,27CS034,68,67,69,65,-3,-4,-2,5,-6.08739432254594,-5.702183919119308,-5.269165703247474,-2.5068119250921197,82,82,83,101,19,18,19,6,2.116754945065581,2.2531376027840753,2.3748093914145265,0.30711277042702084,5620,5576,Yellow Medicine and Nearby Counties,Lincoln,27,81,Minnesota,MN
27083,27CS034,188,177,199,226,38,27,49,25,0.2669255049374484,2.0787669719052135,3.879295436734575,0.6424698499022332,231,218,244,247,16,3,29,37,-1.3415336740635884,-0.8287024412286836,-0.32035580449613565,2.156403270777441,25239,25223,Yellow Medicine and Nearby Counties,Lyon,27,83,Minnesota,MN
27127,27CS034,157,150,163,178,21,15,28,21,-1.6049052766381975,0.04611368838117996,1.742714369191974,0.9484624933380842,191,183,199,187,-4,-12,4,18,-1.9654951715842544,-1.4452847516214125,-0.9403523596806379,-5.374450917732289,15354,15370,Yellow Medicine and Nearby Counties,Redwood,27,127,Minnesota,MN
27173,27CS034,89,89,90,91,2,1,2,14,-5.648089150684673,-5.2386946909968195,-4.818324812419884,5.5312174005404655,108,107,110,109,1,-1,2,16,-1.7643392527175041,-1.6358303551155788,-1.5071517613417147,10.133163978600829,9519,9423,Yellow Medicine and Nearby Counties,Yellow Medicine,27,173,Minnesota,MN
28001,28CS001,329,317,342,414,85,72,97,61,1.4492945816593887,3.166333620956331,4.927164882074898,0.7127007968888487,394,379,409,467,73,58,88,60,-0.05497694645351175,0.4455249188933685,0.9811114870769513,0.8102950105098753,29530,28839,Adams+Amite+Wilkinson,Adams,28,1,Mississippi,MS
28005,28CS001,151,146,157,167,16,10,21,23,-3.9973809268564415,-2.216858726063097,-0.5684588727412668,1.3579039049869879,184,178,191,224,40,33,46,31,0.17348485658317433,0.705740462013294,1.2201048420454672,0.7569057992967753,12632,12646,Adams+Amite+Wilkinson,Amite,28,5,Mississippi,MS
28157,28CS001,104,103,105,119,15,14,16,19,-2.2639520763417704,-1.8761273956848645,-1.4833845331372855,1.1880205686741176,125,124,126,123,-2,-3,-1,15,-2.1709089381772797,-2.038853692466458,-1.904303737435328,-15.049302978842164,8518,8346,Adams+Amite+Wilkinson,Wilkinson,28,157,Mississippi,MS
28003,28CS002,378,363,393,463,85,70,100,41,3.1343466781936544,5.028179581541845,6.760833762024792,0.4783439924704624,456,438,474,541,85,67,103,67,0.008166069061325342,0.5272289000607873,1.0347748408148751,0.7797631836913935,34990,34397,Alcorn+Prentiss+Tishomingo,Alcorn,28,3,Mississippi,MS
28117,28CS002,267,256,278,342,75,64,86,45,3.176853308558662,4.832780528810707,6.623689195543146,0.5909921554688623,326,313,339,367,41,28,54,40,-0.5364497658943541,-0.0018623398934372979,0.5329826503497123,0.9605065931698749,24962,24987,Alcorn+Prentiss+Tishomingo,Prentiss,28,117,Mississippi,MS
28141,28CS002,240,232,249,308,68,59,76,44,3.2368573269434506,4.963771588079709,6.573717244846472,0.6414276008439728,291,282,301,392,101,91,110,39,2.765407275303452,3.303832614184263,3.810042950906464,0.38336244858897106,18894,18760,Alcorn+Prentiss+Tishomingo,Tishomingo,28,141,Mississippi,MS
28007,28CS003,221,213,229,272,51,43,59,33,2.2526701975131274,4.005514713535975,5.623334262996958,0.6344883595316528,268,258,277,305,37,28,47,33,-0.26580399380512487,0.260118574916897,0.7585934343070493,0.857883525307691,17869,17755,Attala+Choctaw+Leake+Webster,Attala,28,7,Mississippi,MS
28019,28CS003,92,92,93,108,16,15,16,10,2.3028570188311317,2.714476686097059,3.0869519188421006,0.6051008337170511,112,111,113,115,3,2,4,13,-1.3847074003090716,-1.2616567285166969,-1.141304067514545,3.478920906405886,8191,8120,Attala+Choctaw+Leake+Webster,Choctaw,28,19,Mississippi,MS
28079,28CS003,188,179,198,270,82,72,91,62,2.000558810534886,3.6565429161946703,5.3910257547256695,0.7500688270196714,229,218,240,316,87,76,98,38,1.8249577522664486,2.3250891964401434,2.8169845783727356,0.429931848666227,21473,21203,Attala+Choctaw+Leake+Webster,Leake,28,79,Mississippi,MS
28155,28CS003,135,131,139,152,17,13,21,20,-2.936160826238134,-1.207853365844839,0.49255567166881536,1.1123648930348486,165,160,170,203,38,33,43,23,0.9369738073319586,1.4825097998843384,1.9993976423477522,0.5919038566167014,9896,9974,Attala+Choctaw+Leake+Webster,Webster,28,155,Mississippi,MS
28009,28CS004,88,87,89,119,31,30,32,18,6.405035540140907,6.800947927427267,7.227723209077782,0.5592810498864568,106,105,107,131,25,24,26,24,-0.020630905790633147,0.10913735658900003,0.24031506585714565,0.9290902017282789,7749,7648,Benton+Marshall+Tippah,Benton,28,9,Mississippi,MS
28093,28CS004,339,324,353,437,98,84,113,46,4.438706898842705,6.131093588891842,7.956907482121311,0.4632132368734866,413,395,430,580,167,150,185,72,2.3245639998932757,2.827046553855736,3.340487692685836,0.42789349160298945,33977,33729,Benton+Marshall+Tippah,Marshall,28,93,Mississippi,MS
28139,28CS004,231,221,240,285,54,45,64,43,0.41414600498493087,2.1283631187608165,3.823455312332449,0.7757261551986132,281,270,292,334,53,42,64,45,-0.12442613455541485,0.36438000163893,0.8555398383843719,0.8287179093646093,21764,21649,Benton+Marshall+Tippah,Tippah,28,139,Mississippi,MS
28011,28CS005,337,324,350,473,136,123,149,87,4.826860573700622,6.358583798088917,8.031366462925398,0.6362419711625715,409,393,425,491,82,66,98,50,0.5440644837091506,1.0429216733642963,1.585962827812876,0.6018277341402808,30773,30387,Bolivar+Sunflower,Bolivar,28,11,Mississippi,MS
28133,28CS005,267,256,278,367,100,89,111,55,5.33415115216464,7.039309069783828,8.72690111874245,0.5440355305763909,325,312,338,396,71,58,84,43,0.5919760576704787,1.1007531281948257,1.602212641839469,0.5965260220563766,25680,25464,Bolivar+Sunflower,Sunflower,28,133,Mississippi,MS
28013,28CS006,143,137,149,209,66,60,72,19,12.389057314599595,14.076250184129456,15.901140368381125,0.2827877809289135,171,164,178,231,60,53,67,32,1.624454499589025,2.119482045501147,2.6366627197497836,0.5246612628100666,13381,13050,Calhoun+Chickasaw+Grenada,Calhoun,28,13,Mississippi,MS
28017,28CS006,171,164,179,210,39,31,46,34,-0.5631202120582135,1.127777315456424,2.6811271019460317,0.8556718636473191,209,200,218,248,39,30,48,33,-0.15679470311040236,0.3622326452039998,0.8628578374991793,0.8228658032514252,17055,17019,Calhoun+Chickasaw+Grenada,Chickasaw,28,17,Mississippi,MS
28043,28CS006,262,252,271,329,67,58,77,48,1.9059000331462972,3.640313824500598,5.2933320230890875,0.7020886141805882,318,306,329,350,32,21,44,39,-0.8278229672706467,-0.3167865521959495,0.22886674979834634,1.1654555932391382,21435,21396,Calhoun+Chickasaw+Grenada,Grenada,28,43,Mississippi,MS
28015,28CS007,96,95,97,141,45,44,46,20,9.809497250639527,10.197755595498188,10.625499133221714,0.43148633379556706,117,116,119,155,38,36,39,24,1.2609205302124422,1.3861374491585814,1.520226744638058,0.6197812768070866,9933,9888,Carroll+Leflore+Montgomery,Carroll,28,15,Mississippi,MS
28083,28CS007,306,294,318,477,171,159,183,91,9.652908626964072,11.362211481634487,13.034245580242812,0.5287658258604785,369,354,383,442,73,59,88,39,0.7383011280026078,1.2378964784183644,1.7502487645915554,0.5240418893902445,28130,27650,Carroll+Leflore+Montgomery,Leflore,28,83,Mississippi,MS
28097,28CS007,133,129,137,184,51,47,55,35,4.8337979473770485,6.45828123948212,8.271489057430765,0.6744563180451033,162,157,167,169,7,2,12,26,-2.4454777673665236,-1.9080369122185448,-1.4331288257546642,3.117628326681396,9782,9738,Carroll+Leflore+Montgomery,Montgomery,28,97,Mississippi,MS
28021,28CS008,91,90,92,113,22,21,23,20,0.5276114160931743,0.9591942107013129,1.355798828598879,0.8640179859852729,110,109,111,130,20,19,21,20,-0.07936225981145437,0.03742318570540601,0.16403794520670298,0.9367797551665092,9060,8935,Claiborne+Jefferson+Warren,Claiborne,28,21,Mississippi,MS
28063,28CS008,73,73,74,97,24,23,24,17,3.2224394642024623,3.6036899692179585,4.02733674382542,0.6932282048240805,90,89,91,103,13,12,14,20,-1.0820799899460731,-0.9565338096364622,-0.8273157063034147,1.415908163705054,7215,7212,Claiborne+Jefferson+Warren,Jefferson,28,63,Mississippi,MS
28149,28CS008,427,408,446,581,154,135,173,87,4.250197496030058,6.0085442822675885,7.689015022885254,0.5611341500744881,511,489,534,653,142,119,164,98,0.47900831863657817,0.9984833298225246,1.5054905427509202,0.6876817057031659,44583,43720,Claiborne+Jefferson+Warren,Warren,28,149,Mississippi,MS
28023,28CS009,183,176,189,237,54,48,61,45,0.8621909936956846,2.396771947025173,4.2062998783348124,0.8108176357440348,220,212,228,254,34,26,42,35,-0.6035450216114501,-0.08263907229001617,0.42787894321704584,1.0120268298283364,15517,15437,Clarke+Jasper+Wayne,Clarke,28,23,Mississippi,MS
28061,28CS009,166,159,173,209,43,36,50,22,3.442221936042276,5.097367140922778,6.84492211634622,0.5035769386221461,202,193,210,317,115,107,124,37,4.270723378116922,4.810770611412249,5.312746018589007,0.3181926300372716,16345,16299,Clarke+Jasper+Wayne,Jasper,28,61,Mississippi,MS
28153,28CS009,185,176,193,224,39,31,48,29,0.37373102047472295,2.142982445966392,3.765247682562391,0.7214059529101684,224,214,234,301,77,67,87,39,1.4463887442460097,1.9457236468348782,2.4078851714932323,0.5002532102818008,19830,19719,Clarke+Jasper+Wayne,Wayne,28,153,Mississippi,MS
28025,28CS010,185,177,193,241,56,48,64,29,3.9121860759190623,5.716166885690578,7.336955798689877,0.5126517846575803,224,215,234,287,63,53,72,41,0.681375254780979,1.145695988574389,1.6919776955362418,0.6427521676868477,18736,18551,Clay+Oktibbeha,Clay,28,25,Mississippi,MS
28105,28CS010,284,262,306,397,113,91,135,73,1.3303271674176245,3.0643077594669745,4.887741676535398,0.6412506678561941,352,325,379,428,76,49,103,61,-0.20031480669780838,0.2818693157734267,0.8150004363805207,0.7945715678807996,51408,51823,Clay+Oktibbeha,Oktibbeha,28,105,Mississippi,MS
28027,28CS011,234,225,243,333,99,90,108,58,6.18344371042691,7.733479271385282,9.47043166809941,0.5779274423002657,282,271,293,389,107,96,118,53,2.057986899943095,2.588498122590012,3.1068567466609953,0.49162909451240333,21314,20872,Coahoma+Quitman+Tallahatchie+Tunica,Coahoma,28,27,Mississippi,MS
28119,28CS011,72,72,73,123,51,50,51,13,23.87638596596069,24.275907584594304,24.703916018067268,0.25095423417641854,85,84,86,130,45,44,46,19,4.2022962823149275,4.336983099920076,4.462622122454347,0.4142713430006808,6226,5967,Coahoma+Quitman+Tallahatchie+Tunica,Quitman,28,119,Mississippi,MS
28135,28CS011,131,125,136,181,50,45,56,31,4.505450294048741,6.063914094033819,7.6257189783498935,0.603213712126378,157,150,163,192,35,29,42,24,0.3942527172301532,0.9126870113907474,1.417600303924113,0.6622757021540344,12822,12410,Coahoma+Quitman+Tallahatchie+Tunica,Tallahatchie,28,135,Mississippi,MS
28143,28CS011,94,93,95,117,23,22,24,15,2.9620687326114705,3.4117805277419224,3.8092123509548474,0.6175321526921393,116,114,117,163,47,46,49,21,2.5910443047045737,2.7294648302320237,2.843911636070327,0.4334860568080662,9700,9700,Coahoma+Quitman+Tallahatchie+Tunica,Tunica,28,143,Mississippi,MS
28029,28CS012,273,261,285,364,91,79,103,42,5.205579662236008,6.858033524660171,8.585119888575477,0.45777631211707676,331,316,345,399,68,54,83,46,0.2835901021044942,0.7993902216260629,1.294022384883613,0.6641353473382944,28234,28038,Copiah+Franklin+Lincoln,Copiah,28,29,Mississippi,MS
28037,28CS012,84,83,84,103,19,19,20,14,2.4878653964709048,2.8606480302926065,3.291396876490893,0.6830895558780308,103,102,104,141,38,37,39,16,2.7916855516216788,2.924863832567864,3.046367002538417,0.4056532821852253,7661,7673,Copiah+Franklin+Lincoln,Franklin,28,37,Mississippi,MS
28085,28CS012,362,347,377,474,112,97,127,74,2.6664323960611647,4.435354315157015,6.222891256606744,0.6541530244223834,443,425,461,536,93,75,111,54,0.6195030275753837,1.1107629874115807,1.6315069531781903,0.5717570640334558,34726,34924,Copiah+Franklin+Lincoln,Lincoln,28,85,Mississippi,MS
28031,28CS013,218,210,226,298,80,72,88,50,4.795037091600318,6.526099820700619,8.260774771130889,0.6179754776812527,264,255,273,302,38,29,47,30,-0.07609980083437187,0.42055604623535836,0.9336612253689965,0.768993790464264,18346,18284,Covington+Simpson+Smith,Covington,28,31,Mississippi,MS
28127,28CS013,252,241,263,350,98,87,109,58,4.385972049447633,6.183915445681539,7.746142505829557,0.585583668947621,304,291,318,400,96,82,109,58,0.9414164802178143,1.464852687108751,1.958996205033276,0.6002336412190702,26011,25771,Covington+Simpson+Smith,Simpson,28,127,Mississippi,MS
28129,28CS013,140,134,146,164,24,18,30,16,0.6448267881482991,2.343062636568409,4.038171576354299,0.6345473989215291,168,161,176,221,53,45,60,32,0.9491954908654214,1.4601632726885359,1.9499807240831877,0.5956414716487047,14441,14193,Covington+Simpson+Smith,Smith,28,129,Mississippi,MS
28033,28CS014,1250,1170,1330,1497,247,167,327,152,0.3702832300635839,2.0884217687243223,3.6782544437675564,0.6118409170991369,1558,1461,1655,2081,523,426,620,275,0.8018490979668468,1.3129148242350441,1.8408856784103773,0.5246964478296033,186111,188235,De Soto,De Soto,28,33,Mississippi,MS
28035,28CS015,682,649,716,780,98,64,131,92,-1.3709038281547523,0.2823007865919426,2.1038913656704668,0.9301411322141968,839,798,879,1029,190,150,231,141,0.14826901755892066,0.629174992065289,1.1383610215577538,0.7369792444575921,77657,77913,Forrest,Forrest,28,35,Mississippi,MS
28039,28CS016,245,235,256,269,24,13,34,37,-3.803320101607237,-2.1970803417283356,-0.5843450250646935,1.496419383354104,303,290,316,382,79,66,92,42,1.0025347675564946,1.5157414582796431,2.01360661057609,0.5235321533123829,24394,24700,George+Greene+Perry+Stone,George,28,39,Mississippi,MS
28041,28CS016,118,117,119,141,23,22,24,22,-0.12971639383199393,0.2639304977405259,0.6586588071377389,0.9205847218047072,146,144,147,143,-3,-4,-1,17,-1.5766698949677347,-1.451896665028925,-1.3332408692816924,-9.713345169563771,13524,13611,George+Greene+Perry+Stone,Greene,28,41,Mississippi,MS
28111,28CS016,126,121,131,177,51,46,56,25,7.210190389151777,8.877285157453272,10.54460124750733,0.48493050876305566,154,148,160,195,41,35,47,26,0.7644925904564083,1.2664194530616384,1.7776741938653948,0.6244792248718909,11558,11556,George+Greene+Perry+Stone,Perry,28,111,Mississippi,MS
28131,28CS016,168,160,176,217,49,41,57,14,5.936523042934042,7.656620058979323,9.470745921907088,0.27925996055607327,208,198,217,282,74,65,84,47,0.9430158693188827,1.485390480463079,1.998598114127682,0.6231713916831215,18359,18599,George+Greene+Perry+Stone,Stone,28,131,Mississippi,MS
28045,28CS017,428,408,448,522,94,74,114,54,1.6849388659078222,3.4980747696668097,5.214344643477015,0.5680111100662151,522,498,546,654,132,108,156,78,0.6435715282441248,1.1768833620767853,1.6575497701500674,0.5865747783394871,46306,46058,Hancock+Harrison,Hancock,28,45,Mississippi,MS
28047,28CS017,1808,1719,1898,2084,276,186,365,145,0.7867799375490996,2.4988434054559923,4.234291744059463,0.5240813487666266,2223,2115,2331,2850,627,519,735,348,0.8176630665035854,1.3282425627139478,1.8514871541986588,0.5539639790667682,208585,209282,Hancock+Harrison,Harrison,28,47,Mississippi,MS
28049,28CS018,1812,1715,1910,2460,648,550,745,268,5.145599842960663,6.70321449315167,8.49330055509512,0.4132171785661274,2200,2084,2315,2873,673,558,789,329,0.9888550717629169,1.5453595100688935,2.046632186236493,0.4877946317590757,226994,223256,Hinds,Hinds,28,49,Mississippi,MS
28057,28CS019,259,248,269,301,42,32,53,43,-1.8082749266691562,-0.1503485994429776,1.5822192326798843,0.992942440872623,318,305,330,357,39,27,52,56,-1.2139615802831696,-0.7075270679033221,-0.14966772116316185,1.384474247206124,23756,23836,Itawamba+Monroe,Itawamba,28,57,Mississippi,MS
28095,28CS019,368,353,382,495,127,113,142,76,4.259405182919665,5.935511820401296,7.634612210917317,0.5926739485069039,447,430,465,550,103,85,120,84,0.05350844336657138,0.5707279132919063,1.0643423233207738,0.8095478170188976,34246,33914,Itawamba+Monroe,Monroe,28,95,Mississippi,MS
28059,28CS020,1217,1155,1279,1424,207,145,269,142,-0.007667771322005691,1.8056391653007267,3.3445829127680184,0.6824039418706795,1502,1428,1576,1820,318,244,392,207,0.26004048636221,0.7828820475511291,1.279106591532675,0.648718504890562,143378,143886,Jackson,Jackson,28,59,Mississippi,MS
28065,28CS021,143,138,148,145,2,-3,7,21,-8.597272665152357,-6.820601215455432,-5.1654997782160255,7.248032991167023,173,168,179,197,24,18,29,17,0.0851039293827349,0.6020459260520429,1.1077247313329244,0.6902642366479198,11220,11152,Jefferson Davis+Lawrence+Marion,Jefferson Davis,28,65,Mississippi,MS
28077,28CS021,142,136,147,176,34,29,40,17,4.1690096501957035,5.770125151891868,7.4026100936552615,0.4810585541671443,170,164,177,202,32,25,38,27,-0.18389852167855575,0.38032646608933424,0.9161110968296802,0.8297185432599276,12057,11837,Jefferson Davis+Lawrence+Marion,Lawrence,28,77,Mississippi,MS
28091,28CS021,275,264,285,397,122,112,133,66,7.495158045434819,9.208634083674827,11.001637134532615,0.535373703582783,335,323,348,407,72,59,84,39,0.8401758375653857,1.3275593598957334,1.8049185123994782,0.5376595265268971,24412,24381,Jefferson Davis+Lawrence+Marion,Marion,28,91,Mississippi,MS
28067,28CS022,658,629,687,763,105,76,134,86,-0.5455623473917934,1.161886178532333,2.8708997815274713,0.8086873247971301,800,765,834,1047,247,213,282,138,1.1400241345540885,1.6465919223465346,2.1397641706758748,0.5553612415299961,67267,66802,Jones,Jones,28,67,Mississippi,MS
28069,28CS023,83,82,84,106,23,22,24,20,0.8449234540535133,1.2469463261020275,1.6636023947948044,0.8389310104696686,100,98,101,133,33,32,35,19,1.5176455258123966,1.643062655692246,1.7676359253016536,0.5507269871731183,9083,8851,Kemper+Neshoba+Noxubee+Winston,Kemper,28,69,Mississippi,MS
28099,28CS023,336,324,349,497,161,148,173,121,3.8062285586563616,5.540642403091493,7.126555924650608,0.747234204760466,410,395,425,470,60,45,75,65,-0.721578278674902,-0.1658470758874248,0.3357041175411752,1.0625977630525676,29015,28993,Kemper+Neshoba+Noxubee+Winston,Neshoba,28,99,Mississippi,MS
28103,28CS023,103,102,104,143,40,39,41,18,8.10771543877706,8.53855276982883,8.940152429163513,0.44069005445054693,125,124,126,149,24,23,25,19,0.3391487618003626,0.4782479773266466,0.5992639083188267,0.7660717954275778,10248,10139,Kemper+Neshoba+Noxubee+Winston,Noxubee,28,103,Mississippi,MS
28159,28CS023,191,184,199,258,67,59,74,49,2.123409838182089,3.8973930779618042,5.690281925152499,0.7256304641501277,233,224,242,298,65,56,74,39,0.9923825777750893,1.4984589185239117,1.9844230296591618,0.5888705731440191,17712,17607,Kemper+Neshoba+Noxubee+Winston,Winston,28,159,Mississippi,MS
28071,28CS024,342,318,366,409,67,43,91,56,-0.817333287937604,0.8047814519115816,2.5424932491387757,0.8202491367421767,428,398,457,523,95,66,125,46,0.37521958941902234,0.8853194252240427,1.4170785985228793,0.4769889109005242,55764,56741,Lafayette+Yalobusha,Lafayette,28,71,Mississippi,MS
28161,28CS024,165,160,171,212,47,41,52,25,5.382685707178869,7.010667483971895,8.719185398871401,0.5239948222311354,201,195,207,196,-5,-11,1,16,-2.2284057580751933,-1.6880013958618247,-1.1424413039721861,-4.079344810793135,12393,12420,Lafayette+Yalobusha,Yalobusha,28,161,Mississippi,MS
28073,28CS025,387,359,415,484,97,69,125,53,0.9919847420781279,2.69871700234691,4.429250672499874,0.5403333111210983,482,448,516,577,95,61,129,86,-0.3559570041744495,0.14427985282158157,0.6726602738697176,0.8946341692175874,64336,65209,Lamar,Lamar,28,73,Mississippi,MS
28075,28CS026,702,671,733,1032,330,299,361,151,8.135695886288213,9.850904411238437,11.596315350661177,0.4563798560544073,852,815,889,1068,216,179,253,140,0.5478872744437663,1.05664353069036,1.5581363013383767,0.6446598306248987,72921,72178,Lauderdale+Newton,Lauderdale,28,75,Mississippi,MS
28101,28CS026,224,215,233,276,52,43,61,39,0.7957752839811313,2.5550503386304895,4.231080472398723,0.7307152948805753,272,261,283,324,52,41,63,45,-0.14316475165748252,0.3547349586927899,0.8359727268300029,0.8440624961099744,21186,21083,Lauderdale+Newton,Newton,28,101,Mississippi,MS
28081,28CS027,762,726,797,969,207,172,243,116,2.7134013022918526,4.387023633330737,6.182519745569822,0.5564815471289657,927,884,970,1167,240,197,283,141,0.6971122285126986,1.181089998749959,1.6868257068835708,0.5845223088668605,83549,82933,Lee,Lee,28,81,Mississippi,MS
28087,28CS028,550,524,575,694,144,119,170,88,2.0627389262750553,3.834222089453156,5.699520689322358,0.6056074243839541,671,641,701,747,76,46,106,87,-0.6748616285914532,-0.1920180584217417,0.33699908442762894,1.1279622292801268,58651,58234,Lowndes,Lowndes,28,87,Mississippi,MS
28089,28CS029,900,853,947,1018,118,71,165,121,-1.7627955553744488,-0.11278496842473594,1.5661528292552873,1.0168145006501257,1112,1056,1169,1174,62,5,118,131,-1.1488047011322307,-0.6609186198737707,-0.14683371378746685,2.084635773286878,108862,109727,Madison,Madison,28,89,Mississippi,MS
28107,28CS030,327,313,342,403,76,61,90,67,-0.575369223519695,1.0263754035972295,2.757651117172099,0.873756191908917,397,380,414,499,102,85,119,61,0.7602490345822137,1.2603556509146079,1.7924316782660639,0.5900807659752404,33231,32889,Panola+Tate,Panola,28,107,Mississippi,MS
28137,28CS030,254,242,266,377,123,111,135,55,7.935160759446431,9.720160247487915,11.465162601088275,0.44228791121827105,311,297,326,413,102,87,116,62,0.8931565724329859,1.409669959895713,1.9026176770711596,0.602794977499737,28162,28218,Panola+Tate,Tate,28,137,Mississippi,MS
28109,28CS031,592,568,616,712,120,96,144,84,0.8041471223288467,2.5609419909989817,4.3805490409312045,0.6958219769652961,729,700,758,932,203,174,232,154,0.360759360845747,0.8668439023180587,1.3763524830426912,0.7547039352843847,56121,56450,Pearl River,Pearl River,28,109,Mississippi,MS
28113,28CS032,448,431,465,543,95,78,112,59,2.026994606026057,3.5855255717612025,5.298287238184961,0.6134559785630745,545,524,565,639,94,74,115,78,-0.14345903797406434,0.3979608704457422,1.0018128396864412,0.8189844132242494,40050,40007,Pike+Walthall,Pike,28,113,Mississippi,MS
28147,28CS032,153,147,159,200,47,41,53,33,2.187752013492011,3.882504469827209,5.514686893299502,0.6940844927754379,186,179,193,229,43,36,50,30,0.41956065550533284,0.9241048140749842,1.4472037987366033,0.6873350493708877,13926,13840,Pike+Walthall,Walthall,28,147,Mississippi,MS
28115,28CS033,257,243,270,386,129,116,143,38,9.87270351425353,11.64498458571054,13.393203572069439,0.2917462953059012,316,300,332,458,142,126,158,63,2.014210265099012,2.5124313430852405,3.039578893800704,0.44026984890944704,31388,31410,Pontotoc+Union,Pontotoc,28,115,Mississippi,MS
28145,28CS033,260,248,272,294,34,22,46,40,-2.605085484878201,-0.8363077331312379,0.9522453583166895,1.1417680548838707,319,304,333,379,60,46,75,46,0.01624073021453835,0.5008308733220714,1.0526723158931246,0.7504925434690702,27934,27928,Pontotoc+Union,Union,28,145,Mississippi,MS
28121,28CS034,1054,986,1122,1391,337,269,405,140,3.3388974917966014,5.0595300100125336,6.70993511604834,0.4141733665171296,1312,1230,1393,1608,296,215,378,209,0.035083623396663835,0.5565253068112914,1.0408691461447868,0.7033119712332297,156911,157944,Rankin+Scott,Rankin,28,121,Mississippi,MS
28123,28CS034,257,245,269,302,45,33,57,43,-1.2692163920340862,0.3072906090327579,2.049728387597542,0.9267553475538426,312,298,326,398,86,72,100,51,0.743294761700087,1.28394042314969,1.7619793111873896,0.5848987116835933,27956,27650,Rankin+Scott,Scott,28,123,Mississippi,MS
28151,28CS035,492,473,511,687,195,176,214,97,7.106700873785714,8.775287365121544,10.595322118466505,0.49555505652126053,596,573,618,713,117,95,140,45,1.1072180851872346,1.6255989868880276,2.1715243875905075,0.3807310939325735,44423,43822,Washington,Washington,28,151,Mississippi,MS
28051,28CS036,179,172,187,260,81,73,88,62,2.7920693273121566,4.403052963875957,6.116646097921904,0.7589072956973263,215,207,224,299,84,75,92,27,2.9232768149589794,3.4301711140348483,3.961772933495155,0.31870780016638917,16887,16557,Yazoo and Nearby Counties,Holmes,28,51,Mississippi,MS
28053,28CS036,82,81,83,117,35,34,36,25,4.80110416102843,5.194681260522353,5.5997804036749095,0.6933376246755841,99,98,100,143,44,43,45,14,3.8235072822719838,3.9598994677859554,4.0747051232819125,0.31120283746201144,7748,7575,Yazoo and Nearby Counties,Humphreys,28,53,Mississippi,MS
28055,28CS036,13,13,13,13,-0,-0,-0,1,-3.9246028090638645,-3.518146099849779,-3.1533841114476755,1.1948159607985371,16,16,16,13,-3,-3,-3,1,-3.1260304687859,-2.9959394303426294,-2.871668407700308,-0.5370503866362598,1321,1287,Yazoo and Nearby Counties,Issaquena,28,55,Mississippi,MS
28125,28CS036,46,46,47,75,29,28,29,14,14.940606694262884,15.336518569119832,15.694277385992251,0.4715818425755356,55,54,55,76,21,21,22,7,3.736916660334353,3.8701569818579107,3.9942358387944052,0.315019625214902,3836,3678,Yazoo and Nearby Counties,Sharkey,28,125,Mississippi,MS
28163,28CS036,244,232,256,307,63,51,75,38,1.9949929885315654,3.674874946444403,5.506295668706494,0.5939578362857247,295,281,308,360,65,52,79,33,0.7338164494690423,1.215657290866437,1.7339341603053062,0.49657585472341703,27042,26409,Yazoo and Nearby Counties,Yazoo,28,163,Mississippi,MS
29003,29CS001,159,151,167,175,16,8,24,18,-2.057350625440041,-0.4296381035802427,1.167692587452095,1.04826096924166,194,185,204,191,-3,-13,6,16,-1.632504930374715,-1.074653267558031,-0.565246275697119,-6.657366066811085,18019,18014,Andrew+Atchison+Holt+Nodaway,Andrew,29,3,Missouri,MO
29005,29CS001,64,64,65,87,23,22,23,11,8.318819700239255,8.737991380817677,9.132977253268042,0.4679490851197159,79,78,79,95,16,16,17,3,2.442312902437415,2.5647988005299385,2.6896813156695263,0.1718712833221038,5270,5244,Andrew+Atchison+Holt+Nodaway,Atchison,29,5,Missouri,MO
29087,29CS001,47,46,47,64,17,17,18,18,-0.9524258885875531,-0.5503195002586249,-0.1472528059346939,0.9768724309304602,57,57,58,83,26,25,26,5,4.843225205230888,4.963405319377143,5.08778793032554,0.18547157248627627,4219,4220,Andrew+Atchison+Holt+Nodaway,Holt,29,87,Missouri,MO
29147,29CS001,162,153,171,156,-6,-15,3,20,-6.585618767167356,-4.939549028994922,-3.1425852964105623,-3.9914414941802647,198,187,209,168,-30,-41,-19,15,-2.6521279948460785,-2.1270644301816097,-1.5968692723852453,-0.5147250608405717,21339,21168,Andrew+Atchison+Holt+Nodaway,Nodaway,29,147,Missouri,MO
29007,29CS002,258,247,269,325,67,56,78,42,2.33357034361816,3.993168303026276,5.637177877445607,0.6182809424429782,317,304,330,330,13,0,26,38,-1.5015929253559057,-0.9893506559390322,-0.47571517652889955,2.6871716692103953,24936,24974,Audrain+Callaway,Audrain,29,7,Missouri,MO
29027,29CS002,353,333,372,452,99,80,119,38,3.847407510207498,5.485913003808121,7.327770646342627,0.37827239576671906,437,414,460,501,64,41,87,57,-0.37970156163176033,0.17575515300428446,0.6712977176319612,0.8773694495653198,44394,44587,Audrain+Callaway,Callaway,29,27,Missouri,MO
29009,29CS003,362,348,377,437,75,60,89,52,0.8275401422282022,2.662514649773089,4.325154324865329,0.6878964272196004,444,426,462,501,57,39,75,51,-0.3434922954392246,0.17755371839155057,0.6770230718182588,0.8806942619431667,34739,34687,Barry+Lawrence+McDonald,Barry,29,9,Missouri,MO
29109,29CS003,412,395,428,453,41,25,58,56,-3.219000254035791,-1.563461442615011,0.1895709820416065,1.3227660391202443,507,487,527,578,71,51,91,59,-0.24804964431633686,0.3121849103106159,0.8213378057573779,0.8182316195100332,38048,38269,Barry+Lawrence+McDonald,Lawrence,29,109,Missouri,MO
29119,29CS003,210,200,220,260,50,40,60,29,1.8484500505548922,3.592668800146621,5.383648151788412,0.5702804959701914,259,247,271,304,45,33,57,39,-0.27800809854551267,0.24537416062084233,0.7694475467636065,0.8539986657270783,23241,23369,Barry+Lawrence+McDonald,McDonald,29,119,Missouri,MO
29015,29CS004,262,254,271,308,46,37,54,24,2.8473045041723486,4.488468446967027,6.239644401038461,0.5126083204885767,323,313,333,365,42,32,52,42,-0.575184421366431,-0.0030476987330845073,0.5027823098694035,0.9807725954430665,19471,19835,Benton+Henry+St. Clair,Benton,29,15,Missouri,MO
29083,29CS004,254,244,263,301,47,38,57,33,0.829472419254176,2.6642387399119816,4.339907052608365,0.6862402737482061,310,299,322,340,30,18,41,34,-0.7434648521235704,-0.19914022753460128,0.3295834335666376,1.1109590747687461,21979,22169,Benton+Henry+St. Clair,Henry,29,83,Missouri,MO
29185,29CS004,130,126,134,140,10,6,14,16,-4.024300887660444,-2.3748762318616814,-0.7045344687286441,1.4050303520284655,157,152,162,152,-5,-10,-0,12,-2.377077702040163,-1.8392463838319035,-1.2912546755909273,-2.8942297367162273,9360,9371,Benton+Henry+St. Clair,St. Clair,29,185,Missouri,MO
29017,29CS005,113,109,118,166,53,48,57,15,12.344866780871078,13.96719131761685,15.594152283484231,0.27956838834338915,136,131,142,160,24,18,29,15,0.3185933408322873,0.8373665490448452,1.3224047549445708,0.6058175145923116,10764,10551,Bollinger+Madison+Stoddard+Wayne,Bollinger,29,17,Missouri,MO
29123,29CS005,153,148,159,174,21,15,26,22,-2.098532009178597,-0.4325604063960419,1.2522725406648305,1.0216830965158168,187,181,194,215,28,21,34,26,-0.3631070176311884,0.14837506938857753,0.6494915977467252,0.9072572988302353,12535,12644,Bollinger+Madison+Stoddard+Wayne,Madison,29,123,Missouri,MO
29207,29CS005,325,313,338,380,55,42,67,49,-0.9295926128061753,0.7646756226978317,2.523844938335527,0.8821671687224729,393,378,408,447,54,39,69,65,-0.8527949244858805,-0.3983313106745884,0.1498503706206365,1.1798505551550815,28699,28504,Bollinger+Madison+Stoddard+Wayne,Stoddard,29,207,Missouri,MO
29223,29CS005,138,134,143,188,50,45,54,21,8.61301617885322,10.184874180888402,11.905030641942513,0.4154007793501458,165,160,171,242,77,71,82,17,4.911951678234278,5.464394431016406,5.990261064867861,0.21897837155861585,11203,10914,Bollinger+Madison+Stoddard+Wayne,Wayne,29,223,Missouri,MO
29019,29CS006,1002,923,1081,1164,162,83,241,83,0.038794105877379026,1.7927820810677582,3.37996833878601,0.5084795697537727,1258,1162,1354,1365,107,11,203,94,-0.4215374909845523,0.07961328616506001,0.5697758242048557,0.8700022440070736,183687,185556,Boone,Boone,29,19,Missouri,MO
29021,29CS007,766,729,802,954,188,152,225,105,2.1175245302488066,3.930045070140088,5.7359407726499185,0.5542642795764092,929,886,973,1116,187,143,230,89,0.6443477498911597,1.1724146714609325,1.683919240161103,0.4745814942209166,84914,83964,Buchanan,Buchanan,29,21,Missouri,MO
29023,29CS008,484,466,502,575,91,73,109,53,1.8253319341312946,3.624836046912697,5.176729953027932,0.5767765328846027,592,570,614,704,112,90,134,76,0.34815415786088855,0.8831229951419507,1.3654197017714347,0.6713649383219328,42099,42087,Butler+Carter+Ripley,Butler,29,23,Missouri,MO
29035,29CS008,63,62,63,79,16,16,17,2,10.245596521408785,10.673610232337905,11.08926803915056,0.11597187191066961,77,76,77,102,25,25,26,13,2.2099999396150474,2.333698576097164,2.465175148202358,0.49278597447217404,5332,5304,Butler+Carter+Ripley,Carter,29,35,Missouri,MO
29181,29CS008,133,128,137,185,52,48,57,18,10.743359049433941,12.385217161476016,14.034616985465506,0.3373455809544027,158,152,163,236,78,73,84,38,3.2637051754367694,3.773311730816318,4.303268147364983,0.4802704082236021,11062,10626,Butler+Carter+Ripley,Ripley,29,181,Missouri,MO
29029,29CS009,401,383,420,549,148,129,166,73,5.093964159657998,6.925610515495246,8.55729003712119,0.4909853354792944,492,470,515,663,171,148,193,74,1.7113550967161157,2.2365992695310024,2.769441085702423,0.4307347303158665,43352,43341,Camden+Miller+Moniteau+Morgan,Camden,29,29,Missouri,MO
29131,29CS009,240,229,251,298,58,47,69,38,1.5259144445287784,3.1445624460719728,4.9199861289086355,0.645598640179874,294,281,307,364,70,57,83,36,0.8706923851277223,1.3650513105014912,1.8706304120884873,0.5051568078758509,24879,24883,Camden+Miller+Moniteau+Morgan,Miller,29,131,Missouri,MO
29135,29CS009,137,130,144,165,28,21,35,21,-0.010783664751946842,1.793526846825971,3.5217483369471525,0.7246608374990825,167,159,175,172,5,-3,13,14,-1.1081651567596729,-0.6165069932448635,-0.12329504260275129,2.4752961199136414,15517,15481,Camden+Miller+Moniteau+Morgan,Moniteau,29,135,Missouri,MO
29141,29CS009,257,248,266,305,48,39,57,31,1.444471111080079,3.185087625826249,4.949410313785013,0.637611128917402,318,307,329,324,6,-5,17,36,-1.9206039605915926,-1.3724533120931945,-0.8348038076024635,4.806167297127331,20996,21323,Camden+Miller+Moniteau+Morgan,Morgan,29,141,Missouri,MO
29031,29CS010,711,676,746,943,232,197,267,113,4.1069104975785,5.879406867026326,7.495678951435873,0.4856943737334561,876,834,919,920,44,1,86,70,-0.8569581630306637,-0.31713239530334836,0.15209128258256605,1.5687264600414261,81411,82066,Cape Girardeau+Perry,Cape Girardeau,29,31,Missouri,MO
29157,29CS010,174,166,182,213,39,31,47,22,1.92137839589061,3.543325094020616,5.3010747065514865,0.5518664716581199,213,203,222,223,10,1,20,11,-0.5679398618840479,-0.03229529619058523,0.4996718491620797,0.9626430734175583,18986,18928,Cape Girardeau+Perry,Perry,29,157,Missouri,MO
29033,29CS011,92,91,93,123,31,30,32,30,0.1420182801867371,0.5860420226357265,0.9706286906898518,0.9306847972819916,111,110,112,109,-2,-3,-1,10,-1.578837661713089,-1.4513795541861412,-1.318865886101478,-8.56552646797669,8487,8388,Carroll+Lafayette+Ray,Carroll,29,33,Missouri,MO
29107,29CS011,339,325,353,383,44,30,58,42,-1.4090676113767324,0.26337154977956634,2.0170874405044747,0.9316143522886546,412,395,429,469,57,40,74,40,-4.035386582181021e-4,0.497341851228486,0.9898228385931123,0.6931361098788932,32949,32844,Carroll+Lafayette+Ray,Lafayette,29,107,Missouri,MO
29177,29CS011,225,215,235,284,59,49,69,23,4.4356619992391595,6.2242632046016,7.903416101058333,0.3841618785597038,274,262,286,353,79,67,91,53,0.6139097729852985,1.1184979442627379,1.6478894938570927,0.6654500309147084,23079,23021,Carroll+Lafayette+Ray,Ray,29,177,Missouri,MO
29037,29CS012,868,821,914,956,88,42,135,69,-1.0717932194374498,0.7681026065662624,2.458881734372035,0.771300977803861,1081,1025,1138,1244,163,106,219,151,-0.37321251733531763,0.10242142219412337,0.6180873649633382,0.9208857456062892,107924,109416,Cass,Cass,29,37,Missouri,MO
29043,29CS013,603,565,642,708,105,66,143,82,-0.6548237038615627,0.9689515429699869,2.773295765359043,0.7745856938443342,758,711,805,950,192,145,239,135,0.10103640273233466,0.6123447188217729,1.1386075701530904,0.6993101019903698,89416,91167,Christian,Christian,29,43,Missouri,MO
29047,29CS014,1610,1501,1719,1878,268,159,377,209,-0.8642718405360642,0.8879158915208841,2.660526924982888,0.7770583279711324,1998,1866,2130,2206,208,76,340,265,-0.7462393253503186,-0.22153065550501116,0.28724901651569495,1.2678410770434667,253593,255285,Clay,Clay,29,47,Missouri,MO
29051,29CS015,580,547,613,751,171,138,204,125,0.7007510088124345,2.421006973522703,4.070109233856826,0.7264564698134335,715,675,755,772,57,17,97,88,-0.9050961786339995,-0.4089260239318381,0.11418701543182484,1.5242851421461872,77137,77204,Cole,Cole,29,51,Missouri,MO
29055,29CS016,253,243,263,306,53,43,63,27,2.704132191391768,4.4840999406070505,6.220420237527059,0.5013735266875443,306,295,318,377,71,59,82,55,0.19679835044631824,0.6695896659250187,1.2088876844578444,0.7670364862179758,23124,22839,Crawford+Iron+Reynolds+Washington,Crawford,29,55,Missouri,MO
29093,29CS016,129,125,134,155,26,21,30,12,3.9304948249508818,5.713202384923082,7.412702113179096,0.4510184324216026,155,151,160,189,34,29,38,19,1.032790231733348,1.557625646683238,2.085593764430088,0.5494350358396407,9597,9424,Crawford+Iron+Reynolds+Washington,Iron,29,93,Missouri,MO
29179,29CS016,72,71,73,79,7,6,8,6,0.17633254311417418,0.5784536374874116,0.9830042233872395,0.7601896606089309,88,87,89,111,23,22,24,13,1.5010723026138308,1.6150001044685407,1.7442971407462982,0.5451995429928297,6110,6086,Crawford+Iron+Reynolds+Washington,Reynolds,29,179,Missouri,MO
29221,29CS016,240,229,250,322,82,72,93,44,4.947497690831275,6.567644829821379,8.151027869475687,0.527095134525761,292,280,304,400,108,96,120,55,1.7672042317641097,2.252707340960092,2.7741147839560205,0.5039153391638774,23681,23502,Crawford+Iron+Reynolds+Washington,Washington,29,221,Missouri,MO
29059,29CS017,185,177,192,265,80,73,88,27,10.757985071090618,12.438531987605561,14.20501806563466,0.3322847010794542,228,219,237,301,73,64,82,31,1.9158742244011417,2.4367038371139462,2.934865535153584,0.41781322980362856,17107,17306,Dallas+Hickory+Polk,Dallas,29,59,Missouri,MO
29085,29CS017,130,126,133,149,19,16,23,27,-5.308755019220037,-3.6220086057671868,-1.8149932743886676,1.3240384873960953,160,155,164,197,37,33,42,12,2.431825258238828,2.9803707615667117,3.49206687317675,0.31223529620165424,8509,8563,Dallas+Hickory+Polk,Hickory,29,85,Missouri,MO
29167,29CS017,309,295,323,364,55,41,69,41,0.11808472113091337,1.7673986441292302,3.510032701945538,0.7322326167391074,381,364,397,429,48,32,65,44,-0.3614748582180706,0.14060466837074645,0.6296499046143452,0.8973596992279012,31720,31975,Dallas+Hickory+Polk,Polk,29,167,Missouri,MO
29025,29CS018,85,84,86,92,7,6,8,5,0.38413509145294766,0.8141481768768472,1.209290804215962,0.6411786904008769,105,104,106,136,31,30,32,17,1.4815338150681945,1.6103377137939154,1.7432755279205654,0.5266743184551218,8849,8884,DeKalb and Nearby Counties,Caldwell,29,25,Missouri,MO
29049,29CS018,220,211,230,270,50,40,59,43,-0.392744363131498,1.2283036205067364,3.0410956177791064,0.8508686314614211,271,260,282,245,-26,-37,-15,26,-2.9435990804144736,-2.4667955463188105,-1.9056651889649592,-1.0333469731073632,21100,21275,DeKalb and Nearby Counties,Clinton,29,49,Missouri,MO
29061,29CS018,78,77,79,99,21,20,22,14,3.0273551639743514,3.420726038080621,3.852434532159982,0.6302941459650271,95,94,96,106,11,10,12,11,-0.16508603271207273,-0.03283895791071452,0.09840204897699463,0.9387590390952363,8402,8403,DeKalb and Nearby Counties,Daviess,29,61,Missouri,MO
29063,29CS018,95,94,96,139,44,43,45,22,7.601548239995051,7.994934555841465,8.396776854832757,0.48935184759453326,117,116,119,130,13,11,14,12,-0.07707078282700204,0.05002853926261915,0.16658416780336835,0.8854997560199563,10992,11086,DeKalb and Nearby Counties,DeKalb,29,63,Missouri,MO
29075,29CS018,71,70,72,92,21,20,22,13,4.764349415543577,5.134855936113031,5.582244086036782,0.5923342964049421,87,86,87,105,18,18,19,2,2.540406796627811,2.659279703122794,2.7930186044061576,0.10305800678558735,6187,6165,DeKalb and Nearby Counties,Gentry,29,75,Missouri,MO
29081,29CS018,92,92,93,105,13,12,13,15,-1.5971382646852645,-1.2005326875485505,-0.7783011748743317,1.105837481149053,113,112,114,111,-2,-3,-1,2,-0.5857389328552239,-0.4629578498554798,-0.3361127621504711,-2.5857110072593223,8184,8163,DeKalb and Nearby Counties,Harrison,29,81,Missouri,MO
29227,29CS018,25,25,26,25,-0,-1,-0,6,-13.460988259037832,-13.075050012763548,-12.677429761611393,10.5846053167499,31,31,32,32,1,0,1,5,-2.2882615675719102,-2.1585061863286836,-2.032000463461881,2.896600964480179,1968,1980,DeKalb and Nearby Counties,Worth,29,227,Missouri,MO
29065,29CS019,159,153,165,232,73,67,79,28,10.498122585473627,12.25953843936451,14.01543679531892,0.3795486194481985,193,186,200,266,73,66,80,45,1.435070610034976,1.942911894668285,2.432509535069867,0.607723496140652,14584,14430,Dent+Phelps,Dent,29,65,Missouri,MO
29161,29CS019,397,378,416,509,112,93,131,73,1.7618978345118186,3.5350717019591515,5.196960176224798,0.6457025471182442,489,466,512,599,110,87,133,80,0.14507091140619433,0.6501550226403352,1.2122152238410626,0.7198410984577307,44572,44876,Dent+Phelps,Phelps,29,161,Missouri,MO
29067,29CS020,149,144,154,177,28,23,33,24,-0.2740976351128853,1.4223953370774232,3.155443271661099,0.8226329186233359,182,176,188,228,46,40,52,40,-0.02350963545044201,0.4598183974056292,1.0279268441286584,0.8553926345702221,11848,11712,Douglas+Ozark+Texas+Wright,Douglas,29,67,Missouri,MO
29153,29CS020,122,118,125,140,18,15,22,11,1.687009609625465,3.3557248631011336,5.029024373325883,0.5711593620305678,152,147,156,188,36,32,41,39,-0.8123939806868745,-0.30423504905550175,0.17900965358106768,1.0436064533332274,8635,8743,Douglas+Ozark+Texas+Wright,Ozark,29,153,Missouri,MO
29215,29CS020,265,255,276,346,81,70,91,19,8.231647917785883,10.040487310056152,11.819844934938786,0.23284198787768184,332,319,345,441,109,96,122,47,2.0118844049875033,2.498680056675674,3.017398591842859,0.42652351718982606,24614,24903,Douglas+Ozark+Texas+Wright,Texas,29,215,Missouri,MO
29229,29CS020,220,212,228,204,-16,-24,-8,27,-11.0911611956897,-9.418655474219236,-7.741279832122073,-1.7697650251910702,275,266,285,290,15,5,24,43,-1.9939892121819807,-1.5285413073590841,-1.0004218717588798,2.747181501373758,18247,18547,Douglas+Ozark+Texas+Wright,Wright,29,229,Missouri,MO
29069,29CS021,354,342,366,455,101,89,113,55,4.853498631648265,6.527670146517593,8.125142149992532,0.5399975913452429,426,412,441,518,92,77,106,47,1.1017370154319595,1.5916781525093473,2.0877678422254893,0.5069795702494604,28275,27784,Dunklin+Pemiscot,Dunklin,29,69,Missouri,MO
29155,29CS021,188,182,195,261,73,66,79,32,8.829057051323051,10.429036594876331,12.058663387758983,0.4353389877833916,226,218,234,292,66,58,74,27,2.033326617596797,2.5182224469739576,3.0237582654280284,0.40522553613391726,15589,15287,Dunklin+Pemiscot,Pemiscot,29,155,Missouri,MO
29071,29CS022,918,873,963,1087,169,124,214,134,-0.30403497755469205,1.3410680342478332,3.0362558262099655,0.7876966389234846,1132,1078,1186,1325,193,139,247,144,-0.03606886301177746,0.4691308787633296,0.9883289734730916,0.7420275994417062,104685,105164,Franklin,Franklin,29,71,Missouri,MO
29073,29CS023,182,176,189,240,58,51,64,37,3.7410973617509424,5.551840123258345,7.32641000905571,0.6318460450009972,223,215,231,247,24,16,32,42,-1.722917717177773,-1.2062782014391216,-0.674997327254907,1.6772634544090865,14739,14784,Gasconade+Montgomery+Warren,Gasconade,29,73,Missouri,MO
29139,29CS023,150,145,155,162,12,7,17,15,-2.8555530251977195,-1.1659496283350732,0.543390074530797,1.181176974164694,184,179,190,185,1,-5,6,17,-1.9555061453011384,-1.452253690692786,-0.8989091971989503,11.304616849142539,11309,11393,Gasconade+Montgomery+Warren,Montgomery,29,139,Missouri,MO
29219,29CS023,271,256,287,315,44,28,59,18,1.2100594505961404,2.81894342012031,4.502603956297399,0.404289994574184,340,321,358,461,121,103,140,65,1.0679840755879753,1.5255691699010454,2.056169237896627,0.5308116603650784,35793,36400,Gasconade+Montgomery+Warren,Warren,29,219,Missouri,MO
29077,29CS024,2556,2428,2685,2927,371,242,499,359,-1.6371256850431706,0.198337915958057,1.9618657307335805,0.9652468870600452,3153,2998,3309,3554,401,245,556,388,-0.5115220473495207,0.034576195910196825,0.5672338255637093,0.9660665864770185,298437,300602,Greene,Greene,29,77,Missouri,MO
29079,29CS025,108,107,109,137,29,28,30,31,-1.0875040683393045,-0.6755909212683681,-0.2589203532312186,1.020931800714114,132,130,133,152,20,19,22,26,-0.7041507240818257,-0.576604207986838,-0.453434337611254,1.2151241186167068,9736,9721,Grundy and Nearby Counties,Grundy,29,79,Missouri,MO
29115,29CS025,145,140,150,162,17,12,22,14,-0.5809452328947381,1.1588931304797947,2.871309382232013,0.7651852976187633,175,169,181,186,11,5,17,38,-2.8210810884341875,-2.3072105306835464,-1.793003550878831,3.2278407777334057,11857,11844,Grundy and Nearby Counties,Linn,29,115,Missouri,MO
29117,29CS025,156,149,162,169,13,7,20,30,-6.138861604239381,-4.528496412783887,-2.916042674488767,2.0690685817991694,190,182,198,220,30,22,38,40,-1.224824383484145,-0.6725667016972225,-0.13432267265489709,1.2927409217331234,14643,14727,Grundy and Nearby Counties,Livingston,29,117,Missouri,MO
29129,29CS025,37,37,37,59,22,22,22,10,13.097045640590661,13.492485771273287,13.880832767127595,0.4367795298994293,45,45,45,52,7,7,7,5,0.4423895118194769,0.5800202191825037,0.6979877785722177,0.6244307625528086,3527,3492,Grundy and Nearby Counties,Mercer,29,129,Missouri,MO
29171,29CS025,59,59,60,59,-0,-1,0,5,-4.899606081616067,-4.4598001726468945,-4.050825423675612,6.415676728018063,73,72,73,88,15,15,16,6,1.8242389826729788,1.9487713918382252,2.083484562753423,0.371360523205714,4682,4707,Grundy and Nearby Counties,Putnam,29,171,Missouri,MO
29211,29CS025,57,57,58,72,15,14,15,12,1.3213753125345375,1.7022968709085498,2.0963479388480497,0.7703213656008102,70,69,71,86,16,15,17,11,0.7395125943719603,0.8621252239190182,0.9998577249943628,0.6419841125893965,5984,5940,Grundy and Nearby Counties,Sullivan,29,211,Missouri,MO
29091,29CS026,437,419,454,539,102,85,120,80,0.5052628730011717,2.2226797976013617,3.9895215269487756,0.7737816606699066,535,514,555,637,102,82,123,83,-0.009173725842401333,0.48870861912189667,1.012616774871595,0.8048610492114527,39822,39942,Howell+Oregon+Shannon,Howell,29,91,Missouri,MO
29149,29CS026,115,111,119,140,25,21,29,10,5.088081785749531,6.70372905744111,8.432127665977172,0.38551943175241515,138,133,142,178,40,36,45,14,2.54362528839878,3.051053628646259,3.5395389922223752,0.338832132018522,8896,8629,Howell+Oregon+Shannon,Oregon,29,149,Missouri,MO
29203,29CS026,74,73,74,121,47,47,48,13,18.668168419756892,19.073261449885997,19.49780157084267,0.26855728128393164,89,88,90,119,30,29,31,15,1.9783219086374064,2.0988279280570845,2.224495813333394,0.4850652636504734,7213,7097,Howell+Oregon+Shannon,Shannon,29,203,Missouri,MO
29095,29CS027,5534,5226,5842,6353,819,511,1127,518,-0.18794769998960717,1.7011168556329208,3.228814528064857,0.631557816228782,6804,6434,7174,7785,981,611,1351,862,-0.3278973265297729,0.1547549471928446,0.7030057158632137,0.8777566087261475,715323,716918,Jackson,Jackson,29,95,Missouri,MO
29097,29CS028,1064,1011,1116,1291,227,175,280,175,0.06475994893617491,1.6180154515741123,3.4009302408305384,0.7664992049100653,1311,1248,1375,1531,220,156,283,214,-0.4286515494074879,0.059600598209461675,0.5785155734229257,0.9690116190258666,122582,123098,Jasper,Jasper,29,97,Missouri,MO
29099,29CS029,1817,1720,1915,2088,271,173,368,200,-0.37435214569604364,1.2766029600008881,2.9575061562984857,0.7364062834266096,2243,2126,2361,2487,244,126,361,265,-0.6037473276409757,-0.09133765437189129,0.4113168505660988,1.0822419454730337,226794,227648,Jefferson,Jefferson,29,99,Missouri,MO
29101,29CS030,355,332,378,420,65,42,88,46,-0.3120130890328841,1.4284171169714572,2.967099670341465,0.6994971948760811,437,409,465,565,128,100,156,57,0.8220129954492653,1.3064019888897531,1.8526074513899158,0.4417689026222624,54044,54128,Johnson,Johnson,29,101,Missouri,MO
29105,29CS031,380,364,395,408,28,13,44,52,-4.209307395930957,-2.666390793468294,-0.9897116856406624,1.773107382515306,466,448,485,566,100,81,118,74,0.1940800382973199,0.7189839760437658,1.1994303809728797,0.7345889943650564,36013,36117,Laclede+Webster,Laclede,29,105,Missouri,MO
29225,29CS031,314,297,331,362,48,31,65,50,-1.8560845717132601,-0.1548353094649657,1.5006355145159895,1.012943687789963,390,370,411,507,117,96,137,63,0.8405219146159952,1.3584958117741335,1.8603944249238937,0.5352941627039227,39296,39652,Laclede+Webster,Webster,29,225,Missouri,MO
29113,29CS032,447,421,473,480,33,7,59,51,-2.8844387634348334,-1.229325006672277,0.4601798970330134,1.4984885298913235,559,528,591,602,43,11,74,54,-0.697999186168055,-0.19622048322515714,0.3075075286288702,1.240778951381155,59897,61330,Lincoln+Pike,Lincoln,29,113,Missouri,MO
29163,29CS032,167,160,175,204,37,29,44,23,1.3885311351409146,3.1080010968217904,4.707858829241741,0.6104885142461097,205,196,214,210,5,-4,14,27,-1.7715617249164084,-1.2575387883087346,-0.6987785651872919,4.645339591741257,17638,17739,Lincoln+Pike,Pike,29,163,Missouri,MO
29125,29CS033,84,84,85,125,41,40,41,13,12.61163075682842,13.003115195632766,13.394875796866154,0.31292376380959097,103,102,104,133,30,29,31,11,2.139974160206,2.26241314434028,2.4010125057732785,0.35438096756432214,8472,8409,Maries+Osage+Pulaski,Maries,29,125,Missouri,MO
29151,29CS033,111,110,113,119,8,6,9,10,-1.0677567638760126,-0.6465077151519856,-0.2762091968707215,1.1351644944745,137,136,139,165,28,26,29,21,0.3739686197181744,0.5009327051171873,0.6231056846312187,0.7308956673991348,13317,13360,Maries+Osage+Pulaski,Osage,29,151,Missouri,MO
29169,29CS033,293,270,316,342,49,26,72,39,-0.963694307012775,0.7078200430081355,2.616498013595724,0.7764024397078816,365,337,393,455,90,62,118,50,0.23685721639315377,0.7452277075201076,1.2484933873888873,0.5487321011758088,53755,53838,Maries+Osage+Pulaski,Pulaski,29,169,Missouri,MO
29127,29CS034,295,283,308,310,15,2,27,39,-5.274750846762069,-3.3793670860909706,-1.7752421447569262,2.504041527497859,363,348,377,395,32,18,47,50,-1.1125352165372637,-0.6119949731047516,-0.11430972196060296,1.4949750127662895,28486,28511,Marion+Monroe+Ralls+Shelby,Marion,29,127,Missouri,MO
29137,29CS034,88,87,89,114,26,25,27,16,4.112753030424187,4.505482882964596,4.913534180233374,0.5976176892961017,108,107,110,120,12,10,13,17,-0.7517164598590617,-0.6272252756679426,-0.4963024626954555,1.3545014877369541,8665,8705,Marion+Monroe+Ralls+Shelby,Monroe,29,137,Missouri,MO
29173,29CS034,84,83,85,128,44,43,45,14,11.090951492686166,11.498144255434623,11.902292459805686,0.3128254112494851,103,102,105,136,33,31,34,12,1.8564526337494627,1.988475456362512,2.1191589174605885,0.3570477643396945,10343,10360,Marion+Monroe+Ralls+Shelby,Ralls,29,173,Missouri,MO
29205,29CS034,69,68,70,84,15,14,16,7,4.858694140575943,5.281811477118858,5.691416613456586,0.43741261903060336,83,83,84,87,4,3,4,6,-0.5243243948544352,-0.4041067365909956,-0.2880671865468108,1.311154661666287,6062,5994,Marion+Monroe+Ralls+Shelby,Shelby,29,205,Missouri,MO
29133,29CS035,149,144,155,185,36,30,41,24,2.02527925782798,3.762268183001445,5.516223686820284,0.6523020953116455,183,176,189,221,38,32,45,26,0.4957684420036838,1.0004413893863295,1.485148427662288,0.6602122810924724,12635,12538,Mississippi+New Madrid+Scott,Mississippi,29,133,Missouri,MO
29143,29CS035,200,193,207,289,89,82,96,37,10.998719072204992,12.762755304340725,14.439766417973468,0.4096123611118415,241,233,249,296,55,47,63,24,1.4157506387293706,1.910647315982774,2.403248672089836,0.4300738875327115,16404,16078,Mississippi+New Madrid+Scott,New Madrid,29,143,Missouri,MO
29201,29CS035,383,367,399,469,86,70,102,60,1.080813015170689,2.754655639285991,4.4775003212383355,0.6888026493828535,471,451,490,584,113,94,133,49,1.145756628043421,1.7012398177265318,2.1688077466972233,0.4289816470152428,38051,37865,Mississippi+New Madrid+Scott,Scott,29,201,Missouri,MO
29145,29CS036,565,540,590,642,77,52,102,80,-1.9025358865445186,-0.17156529103372672,1.381840673170759,1.022225738719362,698,668,729,815,117,86,147,115,-0.48357022039355774,0.04637658529367547,0.5526146188804651,0.9780861606527199,58652,59273,Newton,Newton,29,145,Missouri,MO
29159,29CS037,396,378,415,492,96,77,114,51,2.5821628454085293,4.268795064355561,5.792890666103841,0.5268124423219674,488,466,511,512,24,1,46,47,-1.0708199205353175,-0.5281906048059614,-0.022871910989788434,1.9139011137812787,42898,43153,Pettis+Saline,Pettis,29,159,Missouri,MO
29195,29CS037,219,209,229,255,36,26,46,42,-2.7301572842753483,-1.156934719718834,0.6883638032819058,1.1479562919490487,269,257,281,325,56,44,68,36,0.34619952702471046,0.8457898380804209,1.3680650571423951,0.6344384952354535,23244,23293,Pettis+Saline,Saline,29,195,Missouri,MO
29165,29CS038,648,602,694,740,92,46,138,67,-0.7134952257779623,0.93830118512227,2.69246436985054,0.720529147109217,811,755,867,893,82,26,138,96,-0.6539697240817315,-0.12957828506547042,0.36883431772080527,1.151188678831466,106907,108355,Platte,Platte,29,165,Missouri,MO
29041,29CS039,80,79,81,115,35,34,36,17,9.467930245470178,9.855206388173631,10.24958110241229,0.46964934765665334,98,97,98,117,19,19,20,12,0.8895448834439016,1.0124969027087842,1.1348793731923439,0.5866998240404697,7390,7360,Randolph and Nearby Counties,Chariton,29,41,Missouri,MO
29053,29CS039,166,159,173,173,7,-0,14,18,-4.309671918830176,-2.6014241444049286,-0.8890967516837746,2.2632070922059677,203,194,212,227,24,15,33,36,-1.2203913955521541,-0.7309476862114447,-0.22438895216015814,1.4573062288523826,17161,17111,Randolph and Nearby Counties,Cooper,29,53,Missouri,MO
29089,29CS039,92,91,93,92,0,-1,1,1,-0.7634452998330026,-0.37939239746284603,0.03627595633092895,0.9612601183065145,114,112,115,145,31,30,33,14,1.5867311331831009,1.7218618164324446,1.8414690190277554,0.4310694944117031,10123,10164,Randolph and Nearby Counties,Howard,29,89,Missouri,MO
29121,29CS039,175,168,181,235,60,54,67,15,10.216877781129972,11.902449282922708,13.677495313402451,0.24578652088742914,214,206,222,225,11,3,19,17,-0.8501545318471455,-0.405267996979267,0.12648853599585586,1.4013045764614804,15172,15183,Randolph and Nearby Counties,Macon,29,121,Missouri,MO
29175,29CS039,246,235,256,280,34,24,45,41,-2.7442403843767025,-1.0733530259449366,0.7846093038972828,1.1583685366741132,302,289,315,353,51,38,64,38,0.008175873326980292,0.5362342269512664,1.0752310607198647,0.7279136572400198,24679,24742,Randolph and Nearby Counties,Randolph,29,175,Missouri,MO
29183,29CS040,2589,2415,2764,3221,632,457,806,396,0.5498591576394852,2.3344956388770015,4.017678431713596,0.625886115623727,3215,3004,3427,3634,419,207,630,298,-0.24359751127669121,0.29685192248055947,0.8111999131503647,0.7103581382602501,405970,409438,St. Charles,St. Charles,29,183,Missouri,MO
29186,29CS040,172,164,180,176,4,-4,12,10,-3.0255947834700554,-1.377832605942923,0.3379721745348717,2.1092765618963356,212,202,222,246,34,24,44,26,-0.07579528827411117,0.43526110315483973,0.9145847369730824,0.7420427792941472,18412,18572,St. Charles,Ste. Genevieve,29,186,Missouri,MO
29187,29CS040,661,632,690,827,166,137,195,103,2.194958382541497,3.730879164277113,5.457519784350376,0.6176451809565786,813,778,848,1021,208,173,243,123,0.78742923244420715,1.262118640373958,1.792825931195349,0.5882348059039422,66973,67448,St. Charles,St. Francois,29,187,Missouri,MO
29510,29CS042,2506,2377,2635,3132,626,497,755,330,2.1526855355580126,3.992139629726963,5.728562963259403,0.5263338879680807,3025,2873,3177,3359,334,182,486,265,-0.2670931230357336,0.22548844959087969,0.7353383847051257,0.7915709475505117,299828,294363,St. Louis (city),St. Louis (city),29,510,Missouri,MO
29189,29CS043,8783,8352,9213,10649,1866,1436,2297,1364,0.2516257783088739,2.000559427752592,3.7212841081982133,0.7304255843898954,10743,10228,11258,11350,607,92,1122,933,-0.826244951522751,-0.32555759786248606,0.17222117497948478,1.5345596628477405,1001174,998011,St. Louis (county),St. Louis (county),29,189,Missouri,MO
29001,29CS044,193,182,204,196,3,-8,14,11,-2.879995527028903,-1.2745458491010822,0.326688892304367,2.8651525161049904,238,225,251,290,52,39,65,35,0.19586518253629917,0.6634260852399979,1.1816120008352775,0.662170721491993,25278,25194,Scotland and Nearby Counties,Adair,29,1,Missouri,MO
29045,29CS044,66,65,67,82,16,15,17,17,-0.8993687112531077,-0.5173776918839567,-0.12680532852929877,0.9923264785907248,81,80,82,102,21,20,22,12,1.2619815174225817,1.3890425474963346,1.5223530786240311,0.5374404038378123,6668,6721,Scotland and Nearby Counties,Clark,29,45,Missouri,MO
29103,29CS044,36,36,37,45,9,8,9,3,5.789627440114883,6.145627294101714,6.582624248982114,0.30588413934844266,44,44,45,67,23,22,23,6,4.28408627493811,4.406739679172902,4.5369713220498875,0.2527157444213247,3773,3797,Scotland and Nearby Counties,Knox,29,103,Missouri,MO
29111,29CS044,101,100,102,109,8,7,9,7,0.05884633791865029,0.45302589287205064,0.8716239179635915,0.7668617206015172,123,121,124,155,32,31,34,14,1.7018726964600333,1.8318406260849898,1.9560663294968865,0.42071385217262086,9992,10005,Scotland and Nearby Counties,Lewis,29,111,Missouri,MO
29197,29CS044,39,39,40,51,12,11,12,5,6.289906331745875,6.7162331709407805,7.140152138059656,0.3878412121262881,47,46,47,64,17,17,18,23,-1.520965636738727,-1.3939173947968868,-1.2543296745943364,1.2512662808354176,4100,4022,Scotland and Nearby Counties,Schuyler,29,197,Missouri,MO
29199,29CS044,45,45,45,51,6,6,6,6,-0.44170671948927265,-0.012843268204753663,0.37373661995483987,0.8588970279838515,54,54,55,69,15,14,15,11,0.673331214633153,0.7967828964031455,0.9246365941812172,0.698420908936727,4732,4694,Scotland and Nearby Counties,Scotland,29,199,Missouri,MO
29209,29CS045,342,329,356,386,44,30,57,47,-1.9357411142527194,-0.38310710825083855,1.3926190320295244,1.0508709198715989,421,405,437,498,77,61,93,66,-0.1700887967610454,0.3333577228674494,0.8495451199312152,0.8477035024212709,31334,31494,Stone+Taney,Stone,29,209,Missouri,MO
29213,29CS045,527,502,551,622,95,71,120,72,-0.15773678316778136,1.638689054645705,3.355791453265013,0.7467911634139117,649,620,678,793,144,115,173,103,0.25216212628781587,0.7174753814730233,1.2694758922677958,0.7093879238463267,56064,56333,Stone+Taney,Taney,29,213,Missouri,MO
29011,29CS046,129,124,134,132,3,-2,8,16,-6.509892767283565,-4.6887422543297435,-2.9201647327197184,4.52809359577341,157,151,163,167,10,4,16,26,-1.9074394455340715,-1.403587472957572,-0.8680542440817965,2.4365525183776717,11628,11651,Vernon and Nearby Counties,Barton,29,11,Missouri,MO
29013,29CS046,174,167,181,191,17,10,24,16,-1.4448416789727578,0.2675289309201885,2.069847966205864,0.878869282206847,211,203,219,244,33,25,41,42,-1.1047352564047455,-0.5804837915687309,-0.06004799868539037,1.2413599964895852,16075,16096,Vernon and Nearby Counties,Bates,29,13,Missouri,MO
29039,29CS046,180,174,186,157,-23,-29,-17,13,-11.825807532394785,-10.178781867934475,-8.424520478293985,-0.5832276817331571,221,214,229,236,15,7,22,34,-1.883576931485657,-1.3397034469005342,-0.8195063143778756,2.190405447097743,14245,14453,Vernon and Nearby Counties,Cedar,29,39,Missouri,MO
29057,29CS046,91,90,92,111,20,19,21,28,-4.610899866670695,-4.227000601692842,-3.820657769882682,1.3336008264000068,112,111,113,119,7,6,8,10,-0.4624608059483345,-0.3430855191396764,-0.20716168385120118,1.1872609694430185,7582,7597,Vernon and Nearby Counties,Dade,29,57,Missouri,MO
29217,29CS046,197,189,206,251,54,45,62,37,1.7693613930495509,3.415761933229098,5.066921461520737,0.6749607393351025,238,228,248,340,102,92,112,44,2.4460497535029257,2.9710130477400383,3.4723110271842934,0.426724614413476,19785,19602,Vernon and Nearby Counties,Vernon,29,217,Missouri,MO
30001,30CS001,75,74,76,94,19,18,20,4,5.819975660469582,6.273388228886579,6.664549758523843,0.20287441454060773,93,92,95,122,29,27,30,18,0.995067376137518,1.118546584548602,1.2486483566555922,0.6070155893086648,9403,9502,Beaverhead+Gallatin+Madison,Beaverhead,30,1,Montana,MT
30031,30CS001,675,616,734,705,30,-29,89,40,-2.095430858628789,-0.32090539023368503,1.4837128056363162,1.2928473956684037,853,781,925,876,23,-49,95,80,-0.9365782590166503,-0.4148391397955974,0.1197282541238397,3.3793040907160123,136240,139677,Beaverhead+Gallatin+Madison,Gallatin,30,31,Montana,MT
30057,30CS001,76,75,77,91,15,14,16,5,4.152705065738092,4.558029592748921,4.9616877978617655,0.3136489636734087,95,94,96,105,10,9,11,14,-0.5927413349427205,-0.4744076006073628,-0.34978749615779764,1.296597611586654,8698,8879,Beaverhead+Gallatin+Madison,Madison,30,57,Montana,MT
30013,30CS002,781,745,817,908,127,91,163,137,-2.3629704234289868,-0.468957036074693,1.171523479392734,1.0721775449772684,961,918,1005,1029,68,24,111,114,-1.07221290302822,-0.5531371766661659,-0.013472577461255951,1.6631742654143833,83919,84484,Cascade,Cascade,30,13,Montana,MT
30023,30CS003,106,105,107,133,27,26,28,3,9.927793146923543,10.304137859055395,10.699247967798593,0.1063432311915343,131,129,132,125,-6,-7,-4,14,-2.180968142912292,-2.0654562564700303,-1.9380821919436466,-3.073875527524852,9391,9480,Deer Lodge and Nearby Counties,Deer Lodge,30,23,Montana,MT
30039,30CS003,28,27,28,25,-3,-3,-2,5,-9.611111227262962,-9.188454183136614,-8.759515222950313,-3.092143413690658,34,34,34,39,5,5,5,4,0.1533951704979619,0.2811959937306654,0.41588397762321044,0.6733813655552319,3316,3339,Deer Lodge and Nearby Counties,Granite,30,39,Montana,MT
30077,30CS003,67,67,68,81,14,13,14,2,6.2869188503430316,6.690911913492364,7.062334571427756,0.1371236992851826,83,82,84,82,-1,-2,-0,14,-2.3063883602379827,-2.1746386441464285,-2.0580859532628546,-68.33930417218305,6929,6990,Deer Lodge and Nearby Counties,Powell,30,77,Montana,MT
30081,30CS003,415,395,434,478,63,44,83,35,0.7934461383064537,2.5525549574582396,4.217789536833945,0.5438274336318674,522,498,545,665,143,120,167,106,0.30598601962021094,0.7990963663319015,1.3390620371484734,0.7339547475784308,44489,45724,Deer Lodge and Nearby Counties,Ravalli,30,81,Montana,MT
30093,30CS003,363,348,378,402,39,24,54,54,-3.418475727315654,-1.74748342154484,0.10997915334540286,1.3577832751707328,447,428,465,536,89,71,108,51,0.587215825084677,1.086057027506325,1.6361186068728217,0.5650064417760964,35154,35376,Deer Lodge and Nearby Counties,Silver Bow,30,93,Montana,MT
30003,30CS004,134,128,139,197,63,58,69,61,-1.0164205823447712,0.6440048736682512,2.4784328558549933,0.9500595119783275,163,156,169,165,2,-4,9,24,-2.165396041055889,-1.6911295457865883,-1.177350053817311,7.1614046904638675,13070,12971,Eastern Montana,Big Horn,30,3,Montana,MT
30011,30CS004,16,15,16,17,1,1,2,3,-4.793104328438169,-4.372782860695739,-3.970361562634435,1.2117054740644106,20,19,20,12,-8,-8,-7,6,-9.601221558997251,-9.489085705396697,-9.360544801454974,-0.9194462483652012,1390,1426,Eastern Montana,Carter,30,11,Montana,MT
30017,30CS004,120,119,121,119,-1,-2,0,12,-4.733029716465439,-4.319845927629467,-3.9343253480918885,56.13469938779287,148,147,150,158,10,8,11,28,-1.6698752953333689,-1.547625752294726,-1.4145569804781315,2.651761620712794,11792,11908,Eastern Montana,Custer,30,17,Montana,MT
30019,30CS004,17,17,18,25,8,7,8,6,3.3104238214619093,3.6938532624292724,4.104364061288684,0.7031734575533196,22,22,22,20,-2,-2,-2,4,-3.537674846357363,-3.4040813221154576,-3.2782887321324936,-5.531560419019507,1659,1682,Eastern Montana,Daniels,30,19,Montana,MT
30021,30CS004,79,78,80,115,36,35,37,20,6.871928276545897,7.299204726352378,7.687257282171494,0.5378250889288196,97,96,98,139,42,41,43,22,2.10229358521663,2.227090889628746,2.3527558462348517,0.5134020567699262,8879,8907,Eastern Montana,Dawson,30,21,Montana,MT
30025,30CS004,26,26,27,29,3,2,3,4,-2.2920090609224184,-1.8709825460421075,-1.4636732925813158,1.1149450255316036,33,32,33,34,1,1,2,4,-0.973031887216468,-0.8496692914264437,-0.7214307470771606,1.6481841289892505,3009,3019,Eastern Montana,Fallon,30,25,Montana,MT
30033,30CS004,12,12,12,12,-0,-0,-0,3,-11.348274901611294,-10.930448876980424,-10.50295138144192,3.979519919976224,15,15,15,19,4,4,4,5,-1.1191684817788454,-0.9929293768125694,-0.8592328466947619,1.0401717291513797,1190,1204,Eastern Montana,Garfield,30,33,Montana,MT
30055,30CS004,17,17,17,13,-4,-4,-4,4,-18.445510507811914,-18.07185158148747,-17.64813582434096,-1.4479113003240327,21,20,21,25,4,4,5,3,0.7050165395664258,0.8206721057110462,0.9519851590586174,0.5546118486689128,1719,1720,Eastern Montana,McCone,30,55,Montana,MT
30071,30CS004,46,46,47,46,-0,-1,0,12,-12.261924154320557,-11.839795480407963,-11.426229180051727,17.071699273353744,57,57,58,67,10,9,10,13,-0.8976859610829757,-0.7779019613910851,-0.6617218883794003,1.2104738388709213,4156,4192,Eastern Montana,Phillips,30,71,Montana,MT
30075,30CS004,17,17,17,15,-2,-2,-2,2,-9.104663111911133,-8.711367165716519,-8.307333131449672,-2.8911598658552196,21,20,21,22,1,1,2,1,0.12420357804565144,0.24587846899794588,0.37341057653274423,0.41327702334478117,1693,1701,Eastern Montana,Powder River,30,75,Montana,MT
30079,30CS004,15,14,15,18,3,3,4,3,-1.1695324982039048,0.5060683868814269,2.344972033272935,0.7227780455826426,18,18,19,12,-6,-7,-6,5,-10.892567663255877,-10.354060326315505,-9.819649676986364,-0.9471527899583266,1076,1089,Eastern Montana,Prairie,30,79,Montana,MT
30083,30CS004,80,79,81,95,15,14,16,15,-0.2918096486655081,0.10163155365432847,0.5169850884158393,0.9211549660726234,98,96,99,128,30,29,32,16,1.1520292778303343,1.2761142688409481,1.4045094399013145,0.5081466276913601,11397,11315,Eastern Montana,Richland,30,83,Montana,MT
30085,30CS004,123,119,128,167,44,39,48,45,-2.12489323138144,-0.5499858144465972,1.3517213794800673,1.0101592119844192,151,145,156,192,41,36,47,22,1.2760342848591941,1.7602049782117717,2.3049250365651117,0.5222802290851664,10820,10815,Eastern Montana,Roosevelt,30,85,Montana,MT
30087,30CS004,73,72,74,123,50,49,51,35,6.910298517846865,7.3232511204967246,7.7385557385647505,0.6818582972423833,87,86,88,126,39,38,40,21,2.0972023126659862,2.214878621441042,2.3477009897665644,0.5237254551473081,8376,8149,Eastern Montana,Rosebud,30,87,Montana,MT
30091,30CS004,40,39,40,29,-11,-11,-10,6,-19.680478478190732,-19.23969992943368,-18.847465004715325,-0.6127031959842671,49,49,50,61,12,11,12,2,2.612447599078197,2.7493412104349995,2.8892779955778964,0.15734082644463945,3490,3526,Eastern Montana,Sheridan,30,91,Montana,MT
30103,30CS004,10,10,11,5,-5,-6,-5,5,-57.252491359784415,-55.470114682697435,-53.87832579654946,-1.1284045278858685,13,12,13,4,-9,-9,-8,4,-17.34198226590851,-16.783861456007262,-16.24764594511987,-0.5078541457912178,752,767,Eastern Montana,Treasure,30,103,Montana,MT
30105,30CS004,77,76,78,91,14,13,15,17,-1.8683650557023932,-1.4661935029257427,-1.051304446223,1.11545570822118,94,93,95,102,8,7,9,13,-0.8448410157148399,-0.7089101602707096,-0.5878415912998541,1.5044772227161813,7526,7539,Eastern Montana,Valley,30,105,Montana,MT
30109,30CS004,13,12,13,19,6,6,7,6,-1.0304376112794227,0.6960675829251631,2.3549523717984577,0.8376643762926379,16,15,16,20,4,4,5,3,0.9171310601347827,1.4554860555442493,1.9354149520991037,0.5624032074805239,932,933,Eastern Montana,Wibaux,30,109,Montana,MT
30029,30CS005,815,770,860,941,126,81,171,62,0.6928958671277784,2.4317383120778526,4.129934693142438,0.48887480062494626,1026,970,1081,1250,224,169,280,150,0.19438567036670137,0.6975866844078981,1.2068028246993383,0.665960577927024,105026,107917,Flathead,Flathead,30,29,Montana,MT
30043,30CS006,89,88,90,136,47,46,48,7,12.685736926028513,13.094053430346102,13.50173877998549,0.14621883390575252,112,110,113,177,65,64,67,18,3.679309791214497,3.8046056713656116,3.9369257491393825,0.271532417500825,12179,12421,Jefferson+Lewis and Clark,Jefferson,30,43,Montana,MT
30049,30CS006,552,521,583,604,52,21,83,49,-1.543679033759455,0.15826233103157306,1.8329412404105292,0.9237908431178972,686,648,723,782,96,59,134,99,-0.5457101174267684,-0.054100581740798466,0.48799856132443853,1.0160509050358228,70990,72058,Jefferson+Lewis and Clark,Lewis and Clark,30,49,Montana,MT
30047,30CS007,274,260,287,319,45,32,59,23,1.1247559215691396,2.834464206132889,4.55919187699421,0.49501021357252606,339,323,356,397,58,41,74,62,-0.6750800913493025,-0.15252566806960305,0.3823599909864079,1.05974412180408,31241,31920,Lake+Lincoln+Mineral+Sanders,Lake,30,47,Montana,MT
30053,30CS007,210,202,219,239,29,20,37,12,1.7670937407336496,3.4209499288388043,4.97828605051547,0.4032398956006644,262,252,273,331,69,58,79,50,0.3684318154126422,0.9295574481561623,1.4424938262800908,0.7167553420998979,19867,20409,Lake+Lincoln+Mineral+Sanders,Lincoln,30,53,Montana,MT
30061,30CS007,50,49,50,54,4,4,5,5,-0.8779428740916466,-0.46773658768778575,-0.08926984406957228,0.9147266714422159,64,63,64,84,20,20,21,13,1.409944328658814,1.5315617018901666,1.6630334007937961,0.6074978039762955,4575,4817,Lake+Lincoln+Mineral+Sanders,Mineral,30,61,Montana,MT
30089,30CS007,146,141,152,163,17,11,22,14,-0.841978558967375,0.8530939914114194,2.795884807105783,0.784909627281556,183,176,190,233,50,43,57,39,0.3538750567891789,0.842668569265613,1.3147430411553316,0.7662044008196345,12430,12885,Lake+Lincoln+Mineral+Sanders,Sanders,30,89,Montana,MT
30063,30CS008,771,720,822,835,64,13,115,56,-1.4641477068299562,0.31012486021755886,1.9866494405138315,0.8590402868977597,955,893,1017,1090,135,73,197,94,-0.1881916100791822,0.34098331703874596,0.8641933737679889,0.6909146547904726,118639,119344,Missoula,Missoula,30,63,Montana,MT
30005,30CS009,60,59,60,89,29,29,30,24,2.6630780314436273,3.0840012491283755,3.5046533403706754,0.7905602863720146,73,72,74,76,3,2,4,7,-0.7392826972881957,-0.6159184730292414,-0.498165860885694,1.9034866849063088,6956,6983,North Central Montana,Blaine,30,5,Montana,MT
30015,30CS009,51,50,51,64,13,13,14,1,8.056209027221723,8.476409050383067,8.856111543460147,0.06922326006947309,62,62,63,72,10,9,10,4,0.8258197158084012,0.9507888044054023,1.0661455228046899,0.3765816360945337,5869,5914,North Central Montana,Chouteau,30,15,Montana,MT
30027,30CS009,132,130,133,150,18,17,20,15,0.795643940480616,1.2214790081656335,1.6111979337737874,0.7700603149071219,163,162,165,172,9,7,10,23,-1.3636033258354354,-1.2376728766742,-1.113694892615547,2.3832649692479873,11412,11594,North Central Montana,Fergus,30,27,Montana,MT
30035,30CS009,135,129,141,160,25,19,31,42,-6.540631678535796,-4.984981855724647,-3.280790297553287,1.6266600422467954,165,158,173,183,18,10,25,21,-0.7580978095301641,-0.24615287051524987,0.24918589196560334,1.1285668086889302,13744,13779,North Central Montana,Glacier,30,35,Montana,MT
30041,30CS009,141,134,148,158,17,10,24,34,-5.968246295885695,-4.190095490970691,-2.593424627766142,1.9278736613542427,172,164,181,205,33,24,41,29,-0.27578275088519516,0.21776582990584503,0.7672556995622465,0.857549995948705,16278,16189,North Central Montana,Hill,30,41,Montana,MT
30045,30CS009,16,16,17,16,-0,-1,-0,8,-16.933573050292715,-16.52843923151109,-16.12661333169263,12.14207166146612,20,20,20,24,4,4,4,2,0.7414515376028075,0.8633887337343498,0.9879877017924144,0.4193686039914638,2019,2040,North Central Montana,Judith Basin,30,45,Montana,MT
30051,30CS009,13,13,13,18,5,5,5,5,-0.7301887817572977,-0.37220023888148257,0.027365162315621673,0.8598389489413976,16,15,16,15,-1,-1,-0,5,-3.004214119680319,-2.873532343425493,-2.7514559579204403,12.488216610537721,2021,1948,North Central Montana,Liberty,30,51,Montana,MT
30069,30CS009,7,7,7,3,-4,-4,-4,3,-55.464137609574145,-53.84120396195646,-52.16233144088277,-1.103340437170382,8,8,9,8,-0,-1,-0,8,-16.814585035146106,-16.315282364057985,-15.754408611194103,13.650965360880024,500,516,North Central Montana,Petroleum,30,69,Montana,MT
30073,30CS009,62,61,62,67,5,5,6,1,2.392040830699169,2.810861102814799,3.1789317720846144,0.1632794236599912,77,76,78,69,-8,-9,-7,6,-2.440148068061568,-2.311011984446958,-2.196732026503149,-0.8817438490101464,5890,5978,North Central Montana,Pondera,30,73,Montana,MT
30099,30CS009,56,56,57,65,9,8,9,2,3.9756441136471823,4.341109699807796,4.7628524821625815,0.2043640430398289,69,68,70,92,23,22,24,14,1.2826103784837515,1.4084653965622784,1.5245403710313097,0.587982601844452,6231,6265,North Central Montana,Teton,30,99,Montana,MT
30101,30CS009,45,44,45,48,3,3,4,2,0.6798574730334467,1.0768030618450937,1.439681057453644,0.46343170869679606,56,55,56,75,19,19,20,9,1.9704162198923378,2.0945958273519114,2.221816398998218,0.4391444247065626,4932,5004,North Central Montana,Toole,30,101,Montana,MT
30007,30CS010,58,57,59,43,-15,-16,-14,9,-14.584403222499468,-14.193368083748503,-13.783823450270475,-0.6374688980967416,75,74,76,92,17,16,18,20,-0.5896671661082701,-0.45214351094318295,-0.3289123270508633,1.1281664349287253,6798,7224,South Central Montana,Broadwater,30,7,Montana,MT
30009,30CS010,89,88,90,104,15,14,16,7,2.6895973727474254,3.0960517263566483,3.4514209256260586,0.43345192873057486,111,109,112,109,-2,-3,-0,18,-1.9250599451681536,-1.820163907314631,-1.683489548850575,-30.39327176611883,10575,10798,South Central Montana,Carbon,30,9,Montana,MT
30037,30CS010,11,11,12,12,1,0,1,4,-17.526259606683904,-15.92062960504672,-14.193411574800729,2.310690921297766,14,13,14,17,3,3,4,4,-1.508854106555283,-0.976846786948726,-0.48055703177950654,0.9570265322902853,822,829,South Central Montana,Golden Valley,30,37,Montana,MT
30059,30CS010,20,20,20,18,-2,-2,-2,5,-15.400398397692861,-14.9718235233449,-14.563743610593969,-4.251661700854554,25,25,25,19,-6,-6,-6,3,-4.782469868395664,-4.657137325431672,-4.531446086246624,-0.5865036514157171,1917,1958,South Central Montana,Meagher,30,59,Montana,MT
30065,30CS010,51,50,51,60,9,9,10,5,3.0525496499722373,3.466985699383478,3.8772843696836796,0.4942829677983352,64,63,64,92,28,28,29,17,2.205184106703224,2.318005167955278,2.4492629608785186,0.5799501053741435,4745,4874,South Central Montana,Musselshell,30,65,Montana,MT
30095,30CS010,71,70,72,95,24,23,25,7,7.111417952628887,7.539633020840466,7.9367949771464685,0.27823504696188456,86,85,87,133,47,46,48,20,2.902643194465198,3.0212351151397705,3.1448477246921116,0.41403472638013694,9110,9039,South Central Montana,Stillwater,30,95,Montana,MT
30097,30CS010,31,31,32,46,15,14,15,4,11.293226378149273,11.689403743438643,12.086761213821497,0.25367437180168845,38,38,39,42,4,3,4,8,-1.307863876204325,-1.1844036502227413,-1.0515120199251737,1.7402336685113042,3683,3715,South Central Montana,Sweet Grass,30,97,Montana,MT
30107,30CS010,23,23,23,32,9,9,9,2,13.482228317921427,13.887528455763237,14.245997431107844,0.194980901046107,27,27,28,31,4,3,4,2,0.6694658354383121,0.7995671485920555,0.9198035642361898,0.43039514472987855,2091,2064,South Central Montana,Wheatland,30,107,Montana,MT
30111,30CS011,1375,1304,1445,1579,204,134,275,173,-0.9111447246885097,0.7577525025306109,2.4278270095248766,0.8420154679544051,1706,1620,1793,1942,236,149,322,238,-0.5208703893077253,-0.02221577329338756,0.5422548636028396,1.0061779256648797,164725,166840,Yellowstone,Yellowstone,30,111,Montana,MT
31007,31CS001,9,9,10,3,-6,-7,-6,3,-56.37729627090159,-54.59655221904319,-53.03119109635652,-0.5459901480082037,12,11,12,4,-8,-8,-7,4,-17.28132570596437,-16.764472087255697,-16.267122412567776,-0.6082769113451739,695,691,Banner and Nearby Counties,Banner,31,7,Nebraska,NE
31033,31CS001,84,83,85,107,23,22,24,13,3.94362537095539,4.318926889640516,4.7164267010723835,0.5379824289092009,105,103,106,136,31,30,33,15,1.6105782282975145,1.7272246311136557,1.853746782190422,0.46193657492738605,9418,9522,Banner and Nearby Counties,Cheyenne,31,33,Nebraska,NE
31105,31CS001,47,46,48,56,9,8,10,3,5.171883102238388,6.997338167678966,8.661256193718982,0.3005576966235736,57,55,59,50,-7,-9,-5,6,-4.398257450407258,-3.8516125185276087,-3.3917581328091018,-0.9739344080985809,3431,3410,Banner and Nearby Counties,Kimball,31,105,Nebraska,NE
31123,31CS001,49,48,49,69,20,20,21,12,6.927713994006413,7.31640643085236,7.743286794283235,0.5625524213933063,60,59,61,73,13,12,14,14,-0.3615633093679195,-0.23393465560280455,-0.10752076820755514,1.0045696553929266,4555,4569,Banner and Nearby Counties,Morrill,31,123,Nebraska,NE
31157,31CS001,364,349,380,460,96,80,111,96,-1.779470164639732,-0.04554534684685226,1.6754150083800656,0.9905340909272007,444,426,463,465,21,2,39,48,-1.3046011134048991,-0.7668836080550265,-0.23462120598456024,2.2143557417610644,35914,35782,Banner and Nearby Counties,Scotts Bluff,31,157,Nebraska,NE
31019,31CS002,316,294,337,385,69,48,91,58,-0.9009397809303413,0.9006742487728251,2.644753955584086,0.8258177918611082,391,365,417,424,33,7,59,35,-0.5256986571757812,-0.036103096440258754,0.4364768006567559,1.0255865631914685,50106,50308,Buffalo+Kearney+Sherman,Buffalo,31,19,Nebraska,NE
31099,31CS002,64,63,65,61,-3,-4,-2,3,-4.011528055416764,-3.6003009572851377,-3.203451900723788,-1.4891773823339707,78,77,79,63,-15,-16,-14,5,-3.1322783107899403,-3.0165244771693702,-2.885592192048943,-0.35442602808181956,6680,6677,Buffalo+Kearney+Sherman,Kearney,31,99,Nebraska,NE
31163,31CS002,34,33,34,43,9,9,10,1,10.740292524791123,11.151665048469013,11.55786849594595,0.0975100943423848,41,41,42,39,-2,-3,-2,5,-2.5463007319126243,-2.4306481244090055,-2.30790921359944,-4.184990350814644,2961,2963,Buffalo+Kearney+Sherman,Sherman,31,163,Nebraska,NE
31021,31CS003,81,80,81,94,13,13,14,11,1.0586613174810091,1.4280077001757214,1.8223775686842716,0.7650139922274469,99,98,100,72,-27,-28,-26,5,-4.9105527767469725,-4.788383678103026,-4.66743468992921,-0.1912135523146819,6687,6711,Burt+Dakota+Thurston+Washington,Burt,31,21,Nebraska,NE
31043,31CS003,155,146,165,210,55,45,64,68,-4.136180378890151,-2.5011570298379797,-0.8104784262141953,1.2230182997791972,190,179,201,157,-33,-44,-22,11,-2.581808421759981,-2.067410921126868,-1.5267129630621263,-0.3454809157751116,21270,21279,Burt+Dakota+Thurston+Washington,Dakota,31,43,Nebraska,NE
31173,31CS003,67,66,68,84,17,16,18,10,3.6692887933873966,4.066977675584151,4.450748761339522,0.5580745260487485,80,79,81,102,22,21,23,18,0.44991249949680506,0.5709312288357486,0.6951988754685587,0.7884702882162352,6821,6642,Burt+Dakota+Thurston+Washington,Thurston,31,173,Nebraska,NE
31177,31CS003,163,154,172,177,14,5,23,19,-2.672395067709767,-1.010658120382033,0.695996451461926,1.3010422867505178,201,190,211,201,0,-10,11,17,-1.2948310962598237,-0.7806942472314142,-0.276530240810452,11.958689667284203,20879,20960,Burt+Dakota+Thurston+Washington,Washington,31,177,Nebraska,NE
31027,31CS004,86,85,87,95,9,8,10,20,-5.534255628779385,-5.115151059892094,-4.713981861164782,1.9488160083736317,104,103,105,87,-17,-18,-16,12,-3.648674284411838,-3.527725311099018,-3.395024333108298,-0.7320299000297735,8375,8336,Cuming and Nearby Counties,Cedar,31,27,Nebraska,NE
31037,31CS004,66,65,67,65,-1,-2,0,21,-8.693201338602204,-8.312166254661332,-7.919174825529762,356.43461706592075,81,79,82,65,-16,-17,-14,4,-1.9918081684929707,-1.858678256219284,-1.7313458897094907,-0.2751525460157752,10560,10505,Cuming and Nearby Counties,Colfax,31,37,Nebraska,NE
31039,31CS004,81,80,82,104,23,22,24,12,4.38666799374802,4.78235664927213,5.20418796176423,0.5056269392122087,100,98,101,121,21,20,23,5,1.7033300339779096,1.8241205329658028,1.952546478303038,0.22310604803164988,8979,8988,Cuming and Nearby Counties,Cuming,31,39,Nebraska,NE
31051,31CS004,51,51,52,64,13,12,13,14,-1.4151119491046065,-0.9940701697980633,-0.58986627476697,1.0292809410955177,63,62,63,64,1,1,2,4,-0.5837302510319029,-0.4543936143420761,-0.3306741652541707,1.6181166926594674,5585,5550,Cuming and Nearby Counties,Dixon,31,51,Nebraska,NE
31167,31CS004,37,36,37,55,18,18,19,6,7.92915510935484,8.35252138385037,8.754667317009059,0.31277780632742413,45,44,46,43,-2,-3,-1,4,-1.162334967741775,-1.0360001398950207,-0.912910293887123,-3.8832122642516715,5839,5817,Cuming and Nearby Counties,Stanton,31,167,Nebraska,NE
31179,31CS004,61,60,62,67,6,5,7,3,0.7276353991507541,1.0972174132550427,1.4816277458116875,0.4508870398509321,76,75,77,72,-4,-5,-3,2,-0.7584629018867715,-0.6313245866793251,-0.5015849443020823,-0.6278043002131046,9657,9770,Cuming and Nearby Counties,Wayne,31,179,Nebraska,NE
31053,31CS005,380,364,396,451,71,55,87,57,-0.11363757660156869,1.5305747596870125,3.2829525476284447,0.7880609099864812,462,443,481,488,26,7,45,41,-0.9200638656886363,-0.407765937668807,0.10889364830511633,1.5278122598200643,37006,37103,Dodge+Saunders,Dodge,31,53,Nebraska,NE
31155,31CS005,196,186,205,234,38,29,48,18,1.7775568491479998,3.6641998464271155,5.51303666137445,0.45798062201044476,242,231,254,251,9,-3,20,23,-1.1232925764337627,-0.6241510550044694,-0.09978155869242553,2.388188116514748,22289,22725,Dodge+Saunders,Saunders,31,155,Nebraska,NE
31055,31CS006,3658,3407,3910,4168,510,258,761,488,-1.5648142293632494,0.12199689473467253,1.716013588355394,0.955914183878438,4520,4218,4822,4692,172,-130,474,384,-0.9118252033048093,-0.3759737521341895,0.16449887734140411,2.216459736511852,582946,585008,Douglas,Douglas,31,55,Nebraska,NE
31029,31CS007,44,44,45,46,2,1,2,7,-5.858695011803471,-5.435157432534218,-5.0365832623345534,2.5727941405424724,54,53,54,60,6,6,7,5,0.15049759020111841,0.27109133791315765,0.3970390094497913,0.7099894688489456,3878,3834,Frontier and Nearby Counties,Chase,31,29,Nebraska,NE
31047,31CS007,191,181,201,228,37,27,47,36,-1.6278457499977466,0.18031530757123868,1.9230186921814514,0.9438093692185396,235,223,248,241,6,-7,18,29,-1.5052414383807307,-0.9857489029009535,-0.4852453241551795,4.292921217344234,23956,23919,Frontier and Nearby Counties,Dawson,31,47,Nebraska,NE
31057,31CS007,20,20,21,20,-0,-1,-0,3,-8.777964323785405,-8.421416618963809,-8.026825716506702,5.6975523975706315,25,25,25,25,0,-0,0,3,-1.954069845216983,-1.8192760229906713,-1.695555723052422,2.9565748990242735,1651,1637,Frontier and Nearby Counties,Dundy,31,57,Nebraska,NE
31063,31CS007,17,17,17,19,2,2,2,1,0.9744759674043113,1.3905548968272592,1.7729460115718698,0.34729738413913175,21,21,22,31,10,9,10,7,0.8849681992770517,1.005722743778525,1.137905165466462,0.6622941672260031,2532,2548,Frontier and Nearby Counties,Frontier,31,63,Nebraska,NE
31073,31CS007,20,20,20,29,9,9,9,4,10.576291805672314,10.989636952796294,11.370669816664662,0.3917948259383615,24,23,24,22,-2,-2,-1,9,-5.904953116577188,-5.786660901250947,-5.660565618224131,-14.656283341373658,1897,1834,Frontier and Nearby Counties,Gosper,31,73,Nebraska,NE
31085,31CS007,8,8,8,5,-3,-3,-3,5,-37.982094858869175,-37.56154049547901,-37.159169711392416,-2.3891142851997564,10,10,10,2,-8,-8,-8,2,-11.72554671113547,-11.604544455039585,-11.471218907228554,-0.2939200575351086,862,845,Frontier and Nearby Counties,Hayes,31,85,Nebraska,NE
31087,31CS007,31,31,32,44,13,12,13,4,12.604023397143944,12.999848065548262,13.419158689951722,0.2952676020819503,38,38,38,45,7,7,7,6,0.19505931978466703,0.323545914115877,0.4577389027444856,0.7653600822953234,2629,2590,Frontier and Nearby Counties,Hitchcock,31,87,Nebraska,NE
31145,31CS007,114,113,115,119,5,4,6,4,-0.006474977644818831,0.38149305034348796,0.7723540784823034,0.6635875421491496,140,139,141,171,31,30,32,12,1.658011755668905,1.7794166890113225,1.9080379882664786,0.37551456121066473,10673,10630,Frontier and Nearby Counties,Red Willow,31,145,Nebraska,NE
31079,31CS008,488,462,515,549,61,34,87,111,-4.948214544556624,-3.1858006377994137,-1.4071497053941975,1.8022423077984264,594,562,626,624,30,-2,62,53,-0.8528757648885801,-0.36983976554141645,0.10946172845139515,1.7340136404986748,62466,62089,Hall,Hall,31,79,Nebraska,NE
31093,31CS009,64,63,65,70,6,5,7,14,-5.325220952933918,-4.916595130133339,-4.52513266608734,1.9933090605623223,79,79,80,93,14,13,14,6,1.038524962061262,1.160433356049229,1.2781958311345631,0.4116158680600105,6489,6526,Howard+Merrick+Nance+Platte,Howard,31,93,Nebraska,NE
31121,31CS009,73,72,74,90,17,16,18,17,-0.2928183276746383,0.0838272717802031,0.4500915297053013,0.9357271371477862,90,89,91,95,5,4,6,4,0.045437456148437146,0.1663228643014781,0.2983475832113713,0.6389824068753152,7683,7664,Howard+Merrick+Nance+Platte,Merrick,31,121,Nebraska,NE
31125,31CS009,44,44,45,52,8,7,8,3,5.115691176106023,5.499180569776083,5.907224785094706,0.3459651870904305,54,54,55,49,-5,-6,-5,4,-2.886257769897745,-2.766608497677135,-2.639449571619949,-0.9118837228606471,3397,3389,Howard+Merrick+Nance+Platte,Nance,31,125,Nebraska,NE
31141,31CS009,264,249,278,305,41,27,56,51,-2.8324305505561167,-1.165673225239663,0.5376476655189407,1.2075227307666423,326,309,344,344,18,-0,35,32,-0.9266706892490852,-0.41527287964849136,0.06702818044851463,1.7202419757704843,34150,34247,Howard+Merrick+Nance+Platte,Platte,31,141,Nebraska,NE
31109,31CS010,1974,1835,2113,2179,205,66,344,148,-0.946548742066784,0.6889724345785081,2.420109654760129,0.7184599401015719,2451,2284,2619,2551,100,-68,267,179,-0.7461965608399426,-0.2600230139839215,0.2935469490385986,1.7766663088842962,322420,324280,Lancaster,Lancaster,31,109,Nebraska,NE
31049,31CS011,20,19,20,18,-2,-2,-1,7,-19.353253181720675,-18.931229392519512,-18.547693689999484,-10.464605886298097,24,24,25,35,11,10,11,3,3.9049455225581062,4.034557239374515,4.164201185690059,0.26071774122427144,1831,1860,Lincoln and Nearby Counties,Deuel,31,49,Nebraska,NE
31101,31CS011,82,81,83,78,-4,-5,-3,1,-2.7790502559438175,-2.3538362675745463,-1.95385334389412,-0.3456449340813353,101,100,102,132,31,30,32,15,1.8491504981043787,1.9835359508311992,2.0953468372950916,0.46301890195780365,8274,8285,Lincoln and Nearby Counties,Keith,31,101,Nebraska,NE
31111,31CS011,316,301,331,406,90,75,105,55,2.315682235219629,4.046024699004213,5.725452919167083,0.6052221955969629,383,366,401,501,118,100,135,60,1.1777747713247169,1.6982741389090763,2.1953866761392513,0.5055031305352288,34552,34194,Lincoln and Nearby Counties,Lincoln,31,111,Nebraska,NE
31113,31CS011,9,9,9,12,3,3,3,6,-19.07008538318546,-17.350642198412746,-15.638267783576694,1.5366117690069658,11,10,11,6,-5,-5,-4,6,-16.002543724277096,-15.52066418754887,-15.013185246429739,-1.6121719626394257,716,691,Lincoln and Nearby Counties,Logan,31,113,Nebraska,NE
31117,31CS011,5,5,5,2,-3,-3,-3,2,-51.93501957520726,-50.237030315175375,-48.67809263356353,-0.9414093479164299,6,6,6,8,2,2,2,8,-16.078972496071138,-15.526727293186074,-14.9980507965618,2.597213892032191,408,381,Lincoln and Nearby Counties,McPherson,31,117,Nebraska,NE
31135,31CS011,29,29,29,28,-1,-1,-1,11,-16.993472098210226,-16.581101728312163,-16.198872384908423,64.78163340404636,35,35,35,36,1,1,1,3,-0.8816811050619345,-0.7501682898401294,-0.6241583496187509,1.6001722417677244,2854,2835,Lincoln and Nearby Counties,Perkins,31,135,Nebraska,NE
31005,31CS012,6,6,6,8,2,2,2,8,-57.97635233946163,-56.1852282155159,-54.367482764525114,2.7953548344039367,8,7,8,6,-2,-2,-1,6,-17.677574309793567,-17.157235179553705,-16.608855078239355,-11.668663175428147,437,438,Northwest Nebraska,Arthur,31,5,Nebraska,NE
31009,31CS012,6,6,6,4,-2,-2,-2,4,-57.97499471403046,-56.26053199238392,-54.68429131131629,-3.4427579737248353,8,8,8,3,-5,-5,-5,3,-17.678818077434638,-17.142628029338262,-16.668286263871405,-0.7822111597513741,438,457,Northwest Nebraska,Blaine,31,9,Nebraska,NE
31013,31CS012,98,97,99,112,14,13,15,5,2.8889669326576226,3.266726154337346,3.682959207423574,0.3372146500569837,117,116,119,130,13,11,14,15,-0.35795617203745694,-0.2356631305759319,-0.1025890618420623,1.1076330229482112,10796,10636,Northwest Nebraska,Box Butte,31,13,Nebraska,NE
31017,31CS012,30,30,30,40,10,10,10,7,3.568393237878334,3.9522184493526424,4.346373532465299,0.6438025995090686,37,36,37,50,13,13,14,4,3.1361048602905526,3.2596814632429982,3.3838558567893715,0.27632733631274486,2913,2907,Northwest Nebraska,Brown,31,17,Nebraska,NE
31031,31CS012,52,51,52,70,18,18,19,10,5.7233750490957345,6.142790626878003,6.552918682493981,0.5137917428857521,62,61,63,79,17,16,18,10,1.147580264029541,1.2688154650769574,1.3872791628964727,0.5575617909876665,5505,5459,Northwest Nebraska,Cherry,31,31,Nebraska,NE
31041,31CS012,100,99,101,126,26,25,27,15,3.7712825442022155,4.204430218397266,4.613584627816134,0.5534566939685117,121,119,122,144,23,22,25,14,0.780552337324437,0.9027355310087752,1.0443219907191255,0.571743340032405,10535,10465,Northwest Nebraska,Custer,31,41,Nebraska,NE
31045,31CS012,70,70,71,90,20,19,20,16,1.311142709781296,1.699650594802008,2.142669801957127,0.7804358541425077,85,84,86,107,22,21,23,4,2.0866484132687475,2.2107581329988863,2.340407479543396,0.17363348808749401,8210,8148,Northwest Nebraska,Dawes,31,45,Nebraska,NE
31069,31CS012,26,26,27,24,-2,-3,-2,2,-11.105552056190238,-9.470886591475294,-7.720765828460807,-1.4043156272966981,32,31,33,36,4,3,5,6,-1.5186595511764929,-0.974478967438296,-0.4620747514755891,1.1523693578972825,1870,1852,Northwest Nebraska,Garden,31,69,Nebraska,NE
31075,31CS012,9,9,9,14,5,5,5,4,6.0824290990301435,6.490612236569107,6.9061892074893105,0.667580080920968,10,10,11,7,-3,-4,-3,7,-18.046784362259164,-17.91665050178303,-17.788396929324925,-2.8414392165053917,611,584,Northwest Nebraska,Grant,31,75,Nebraska,NE
31091,31CS012,13,13,13,10,-3,-3,-3,2,-29.18892809637209,-28.781500286149484,-28.372261537189413,-0.9684431537994802,16,16,17,15,-1,-2,-1,7,-11.717463968458798,-11.598364799131211,-11.464620347529987,-15.088617508985786,704,730,Northwest Nebraska,Hooker,31,91,Nebraska,NE
31103,31CS012,11,11,11,6,-5,-5,-5,6,-58.1922235505157,-56.41750720701237,-54.60171128379483,-1.5662903881951888,13,13,14,3,-10,-11,-10,3,-17.672525114791252,-17.158543111837727,-16.614198232679676,-0.3175956490195063,769,784,Northwest Nebraska,Keya Paha,31,103,Nebraska,NE
31115,31CS012,10,10,10,8,-2,-2,-2,8,-65.89043838058846,-65.47489361412379,-65.07534648605642,-7.607092173578344,12,12,12,1,-11,-11,-11,1,-20.052464660909116,-19.92243377310368,-19.796716799357053,-0.09968660572525871,614,604,Northwest Nebraska,Loup,31,115,Nebraska,NE
31149,31CS012,18,17,19,15,-3,-4,-2,6,-29.85463229768243,-28.067527581406466,-26.31667213960707,-3.0153612381132535,22,21,22,24,2,2,3,3,-1.0441973867699808,-0.5561516897730577,-0.08278976450767621,0.9097212352592167,1282,1264,Northwest Nebraska,Rock,31,149,Nebraska,NE
31161,31CS012,62,62,63,86,24,23,24,16,5.533745075194881,5.937549805001496,6.356306461152218,0.6505434830492529,76,75,76,71,-5,-5,-4,13,-3.5608826740765984,-3.437623996977248,-3.3087887294386493,-3.707090970151968,5116,5095,Northwest Nebraska,Sheridan,31,161,Nebraska,NE
31165,31CS012,9,9,9,10,1,1,1,6,-16.565041350284574,-16.168875108445267,-15.783758588734477,2.5336756357187515,10,10,11,13,3,2,3,8,-4.898072282615678,-4.77003288330638,-4.641732742599241,2.25565972733451,1146,1143,Northwest Nebraska,Sioux,31,165,Nebraska,NE
31171,31CS012,10,9,10,7,-3,-3,-2,7,-57.803296371449875,-56.13721117623685,-54.37833495543118,-4.573006220009101,12,11,12,6,-6,-6,-5,6,-17.67812823378444,-17.172977126832468,-16.65027923839175,-1.3198841450272523,679,673,Northwest Nebraska,Thomas,31,171,Nebraska,NE
31059,31CS013,69,68,69,71,2,2,3,13,-8.007577398214043,-7.600697842215241,-7.184789605305432,3.76744262369227,84,83,85,82,-2,-3,-1,2,-0.8629990034150119,-0.7429336051866955,-0.623502599143716,-1.8119650411890664,5553,5549,Saline and Nearby Counties,Fillmore,31,59,Nebraska,NE
31067,31CS013,234,225,243,252,18,9,27,25,-3.010753450660953,-1.2526093237460638,0.5155484998190528,1.3039125301951915,286,274,297,330,44,33,56,30,0.16074279180877143,0.6399764717989722,1.1808920819183406,0.6613737357728307,21640,21623,Saline and Nearby Counties,Gage,31,67,Nebraska,NE
31095,31CS013,91,90,92,96,5,4,6,3,0.7054945206641601,1.1006066702612791,1.5099249499643639,0.5025960856198155,111,110,112,123,12,11,13,10,0.10554033770193216,0.23437274321045576,0.3640441690990789,0.7876684732982998,7216,7188,Saline and Nearby Counties,Jefferson,31,95,Nebraska,NE
31129,31CS013,52,51,52,70,18,18,19,12,5.72694155517316,6.128813930739179,6.575830697770169,0.6227863754291089,63,63,64,62,-1,-2,-1,5,-1.6294128769330412,-1.4966612821677425,-1.384913936528509,-54.227657938543274,4089,4063,Saline and Nearby Counties,Nuckolls,31,129,Nebraska,NE
31151,31CS013,125,124,127,102,-23,-25,-22,2,-7.490748073038699,-7.054372213240147,-6.683541376623485,-0.09022510313362479,154,152,156,133,-21,-23,-19,8,-2.1490706278888205,-2.030690872370105,-1.9037494671301936,-0.40264271150766784,14235,14200,Saline and Nearby Counties,Saline,31,151,Nebraska,NE
31169,31CS013,67,66,67,65,-2,-2,-1,3,-4.361154853606193,-3.9581379343235783,-3.5342055426751235,-3.1729450443884097,81,80,82,95,14,13,15,8,1.085451942046411,1.2165192577142583,1.3467023619596528,0.5328395396479789,4997,4928,Saline and Nearby Counties,Thayer,31,169,Nebraska,NE
31153,31CS014,916,834,998,1136,220,138,302,116,0.3738383735364154,2.2117266135584095,3.7912207361629253,0.5242589428826425,1155,1055,1254,1298,143,44,243,105,-0.34245731193984036,0.18688012167343762,0.7162372972842429,0.7268763573442995,190738,193082,Sarpy,Sarpy,31,153,Nebraska,NE
31001,31CS015,265,252,278,337,72,59,85,47,1.474679047669436,3.2116936295285097,4.946023223472935,0.6431703984990845,323,307,339,363,40,24,56,32,-0.2669331247573128,0.24337176542396455,0.782284798124514,0.7824836047060217,31158,31044,South Central Nebraska,Adams,31,1,Nebraska,NE
31035,31CS015,58,57,59,74,16,15,17,12,2.1225982320285772,2.5439498857558247,2.9609619367723865,0.7106234733706402,70,70,71,83,13,12,13,11,0.15300381206131694,0.27073892312826264,0.39618941925702655,0.8067333580906021,6116,6081,South Central Nebraska,Clay,31,35,Nebraska,NE
31061,31CS015,32,32,33,40,8,7,8,6,1.9779316991532565,2.358573059083223,2.7490658663525096,0.6887156561407554,39,39,40,65,26,25,26,7,6.2801231596113665,6.422247743415395,6.544971604713529,0.2629066214358553,2896,2900,South Central Nebraska,Franklin,31,61,Nebraska,NE
31065,31CS015,52,52,52,57,5,5,5,7,-2.1130514602568793,-1.738010987455311,-1.323730895224008,1.1661850832263843,63,62,64,79,16,15,17,10,1.1792098376398155,1.2928860533717994,1.4226267034246591,0.5897166981639425,4625,4606,South Central Nebraska,Furnas,31,65,Nebraska,NE
31083,31CS015,32,32,32,37,5,5,5,3,2.3072019584691286,2.7070785308018,3.0775944787242357,0.49205899834749917,39,38,39,62,23,23,24,2,6.812875189337185,6.928736373526792,7.062375341746751,0.08200579828528534,3104,3086,South Central Nebraska,Harlan,31,83,Nebraska,NE
31137,31CS015,94,93,95,98,4,3,5,12,-3.937671546326408,-3.5356180788560447,-3.1329317552694684,2.364793765620897,114,113,115,141,27,26,28,11,1.653331756119226,1.787874334583633,1.9238049713165237,0.3931391192710621,8968,8942,South Central Nebraska,Phelps,31,137,Nebraska,NE
31181,31CS015,48,48,48,54,6,6,6,7,-1.6344164853757939,-1.2442426704286946,-0.8385797119540769,1.008024113319417,59,58,59,63,4,4,5,7,-0.8884784157898445,-0.76503401302536,-0.6505022478380583,1.2984666661431514,3401,3408,South Central Nebraska,Webster,31,181,Nebraska,NE
31025,31CS016,202,190,213,266,64,53,76,17,5.316615920900343,7.110272832250394,8.902774407432439,0.26087605771206956,250,236,264,265,15,1,29,22,-0.7542177296803985,-0.2518010841578979,0.22776155039074092,1.3859611967325254,26578,26955,Southeast Nebraska,Cass,31,25,Nebraska,NE
31097,31CS016,59,58,59,51,-8,-8,-7,4,-9.318629931963708,-8.908406485233826,-8.507195952476902,-0.5967135486838641,73,72,73,67,-6,-6,-5,6,-2.3386454342831526,-2.2142003687508436,-2.087961528110217,-1.2595017335094896,5256,5312,Southeast Nebraska,Johnson,31,97,Nebraska,NE
31127,31CS016,72,71,72,81,9,9,10,14,-2.9676138476031153,-2.6057548641801116,-2.2048736574480796,1.3440891376832147,88,87,89,90,2,1,3,10,-1.245201806531008,-1.1202988271044536,-0.986944952463551,3.239067504114325,7064,7068,Southeast Nebraska,Nemaha,31,127,Nebraska,NE
31131,31CS016,153,146,160,148,-5,-12,2,4,-4.061797159424093,-2.32420974440543,-0.6544303189428431,-0.9458913653699569,187,179,195,193,6,-2,14,14,-0.983556561482415,-0.5041408707784631,0.026855471795370692,1.9847968736047648,15911,15924,Southeast Nebraska,Otoe,31,131,Nebraska,NE
31133,31CS016,34,33,35,43,9,8,10,4,6.818868398890416,8.329667425467626,10.075835014839775,0.3865406619660963,41,40,42,41,0,-1,1,6,-2.8010866446211464,-2.2848275100598516,-1.7550580862666312,5.162486995974466,2552,2546,Southeast Nebraska,Pawnee,31,133,Nebraska,NE
31147,31CS016,98,97,98,129,31,31,32,18,6.486066761331472,6.886830261583387,7.283556993995195,0.5540709911273348,119,118,120,131,12,11,13,12,-0.06984416448161072,0.05996730486722373,0.17704385685074167,0.8940326271360446,7831,7770,Southeast Nebraska,Richardson,31,147,Nebraska,NE
31003,31CS017,62,61,63,75,13,12,14,10,1.6073151459852197,1.9859569483700228,2.3804614597944074,0.708382523188384,75,75,76,82,7,6,7,7,-0.19608873810377206,-0.07132839261944955,0.06335198562326615,0.9216479715287366,6282,6279,Wheeler and Nearby Counties,Antelope,31,3,Nebraska,NE
31011,31CS017,56,56,57,62,6,5,6,5,0.07902246617679735,0.4612045678838084,0.8788273145606974,0.7553483246198771,69,69,70,82,13,12,13,5,1.2805261728372266,1.415419510769337,1.5457907570406404,0.36756476290212897,5329,5381,Wheeler and Nearby Counties,Boone,31,11,Nebraska,NE
31015,31CS017,26,26,27,33,7,6,7,6,-0.41789740460715885,1.358872680333989,2.9203466534045237,0.7896542541115237,32,31,33,38,6,5,7,2,1.826984979653319,2.3530841780917098,2.818659659312271,0.2767312294358342,1817,1791,Wheeler and Nearby Counties,Boyd,31,15,Nebraska,NE
31071,31CS017,27,26,27,23,-4,-4,-3,1,-11.624409601601098,-10.076884182561814,-8.291058921018436,-0.3864406049574524,33,32,33,40,7,7,8,4,1.3900790166074726,1.902699725750703,2.37548528992241,0.47208290219975674,1833,1834,Wheeler and Nearby Counties,Garfield,31,71,Nebraska,NE
31077,31CS017,23,23,23,27,4,4,4,7,-6.139791993472378,-5.761470272855242,-5.322744939483288,1.44854138483629,28,28,28,28,0,-0,0,5,-2.339980295067217,-2.204984038455846,-2.080958842851988,4.117682625328982,2206,2171,Wheeler and Nearby Counties,Greeley,31,77,Nebraska,NE
31089,31CS017,105,104,106,112,7,6,8,17,-4.528314581422382,-4.141431411757734,-3.75331197160642,2.2408015305026834,128,127,129,123,-5,-6,-4,5,-1.1384786013366561,-1.0095148359513109,-0.8820540240754039,-1.1967639015258689,10080,10054,Wheeler and Nearby Counties,Holt,31,89,Nebraska,NE
31107,31CS017,89,88,90,104,15,14,16,12,0.9715414477733667,1.3932805792285525,1.8117848200217048,0.7556616331669042,109,108,110,122,13,12,14,12,0.0035744181049139354,0.13214853675811544,0.2646767005665244,0.8510682144317427,8378,8398,Wheeler and Nearby Counties,Knox,31,107,Nebraska,NE
31119,31CS017,320,305,336,327,7,-9,22,41,-5.556545159666658,-3.827802129024164,-2.2065493038532007,5.38402843796261,392,374,411,356,-36,-55,-18,24,-2.249461386397157,-1.7005058262141861,-1.1284823850337427,-0.6781304019541249,35398,35357,Wheeler and Nearby Counties,Madison,31,119,Nebraska,NE
31139,31CS017,62,62,63,64,2,1,2,17,-8.814627929671175,-8.400514321723477,-7.9940177497030716,6.388323256241649,76,75,77,82,6,5,7,4,0.1241202809460792,0.2488832324323619,0.3631517814089961,0.5888721531425344,7298,7315,Wheeler and Nearby Counties,Pierce,31,139,Nebraska,NE
31175,31CS017,44,43,44,41,-3,-3,-2,6,-9.108601350166564,-8.67624091066379,-8.283975105524094,-3.304167919559725,53,53,54,73,20,19,20,4,3.7000806721712114,3.8280076696735836,3.9561191192847254,0.1946997143007824,4060,4063,Wheeler and Nearby Counties,Valley,31,175,Nebraska,NE
31183,31CS017,11,11,12,6,-5,-6,-5,6,-60.131918379888305,-58.30865570914828,-56.61761159854489,-1.3899929839656027,14,14,14,5,-9,-9,-9,5,-18.20952780984991,-17.72666195387893,-17.223353565071502,-0.621822631815685,776,792,Wheeler and Nearby Counties,Wheeler,31,183,Nebraska,NE
31023,31CS018,94,94,95,90,-4,-5,-4,11,-7.838090822650656,-7.403843141629176,-7.026765540720705,-3.2232992914774625,117,116,118,109,-8,-9,-7,6,-1.815536184942968,-1.688818858607308,-1.5585043687053795,-0.8294522847047581,8307,8430,York and Nearby Counties,Butler,31,23,Nebraska,NE
31081,31CS018,72,71,73,101,29,28,30,20,3.247386687873049,3.656214374503979,4.049206826408665,0.6762316725351983,89,88,90,112,23,22,24,1,2.2282247276662432,2.3537973365457456,2.4841205235529187,0.04149402735553671,9384,9388,York and Nearby Counties,Hamilton,31,81,Nebraska,NE
31143,31CS018,50,50,51,90,40,39,40,10,22.264766209499683,22.65657398309671,23.055359377567626,0.24685051851466344,62,61,62,63,1,1,2,3,-0.41910893646128,-0.2897401940635645,-0.1655247374538886,1.2029416049129138,5209,5181,York and Nearby Counties,Polk,31,143,Nebraska,NE
31159,31CS018,156,149,164,155,-1,-9,6,23,-7.343239121465242,-5.524938483500399,-3.8728088310911666,-47.85694820128887,190,181,200,177,-13,-23,-4,19,-2.340410996822991,-1.8430122880887096,-1.3559976465447359,-1.526685194636922,17563,17603,York and Nearby Counties,Seward,31,159,Nebraska,NE
31185,31CS018,145,139,151,137,-8,-14,-2,10,-6.78494680662287,-5.1840094950419395,-3.488380120300265,-1.3861056328642565,178,171,185,179,1,-6,8,11,-1.1991199852053631,-0.7240707589783223,-0.20880197641384488,5.922825874591958,14032,14221,York and Nearby Counties,York,31,185,Nebraska,NE
32005,32CS001,451,429,472,522,71,50,93,43,0.6456400643290563,2.277013484043605,4.136197522042849,0.5947460919337829,555,530,581,660,105,79,130,53,0.5712883297857818,1.0302103490033103,1.591277615820059,0.5014580949699651,49441,49811,Carson City (city)+Douglas,Douglas,32,5,Nevada,NV
32510,32CS001,708,683,734,786,78,52,103,68,-1.0003180517078232,0.6590303399022515,2.48140499225416,0.8652013938675687,870,839,900,985,115,85,146,110,-0.4344317330210783,0.08537309004498864,0.6002304236615715,0.9457989051420597,58304,58947,Carson City (city)+Douglas,Carson City (city),32,510,Nevada,NV
32003,32CS002,15108,14130,16087,18083,2975,1996,3953,2428,-0.8236434326848913,0.9308568138108838,2.7156971850754688,0.8159214136062567,18894,17712,20076,22825,3931,2749,5113,3895,-0.5110316265984811,0.018774607657296178,0.576516914967123,0.9906716514262967,2275739,2289692,Clark+Nye,Clark,32,3,Nevada,NV
32023,32CS002,753,731,776,783,30,7,52,66,-4.656411295354106,-2.882825446364111,-1.0892517791823382,2.1575463327041904,946,918,973,1087,141,114,169,187,-1.3659442806933202,-0.8705511674327827,-0.3241151164928537,1.3141265603858798,51375,53234,Clark+Nye,Nye,32,23,Nevada,NV
32001,32CS003,252,241,263,325,73,62,84,46,2.543769265720631,4.2962720541356685,5.9875007726794935,0.6187642331614203,310,296,323,388,78,65,92,50,0.6115306122509688,1.0829607589073655,1.616208120534368,0.6300328688921261,25487,25696,Lyon and Nearby Counties,Churchill,32,1,Nevada,NV
32009,32CS003,9,9,9,6,-3,-3,-3,6,-48.94400292506042,-47.21336978803177,-45.50448281548008,-3.198699039896892,11,10,11,12,1,1,2,8,-9.625751325604389,-9.154636953148893,-8.654656311206947,3.5974222563958063,752,741,Lyon and Nearby Counties,Esmeralda,32,9,Nevada,NV
32019,32CS003,576,550,601,699,123,98,149,61,2.643540752338455,4.219536078950911,5.902306234141447,0.49099296939069825,718,687,750,892,174,142,205,108,0.5925852241911143,1.0901697040751759,1.5827847764706053,0.6183898642545342,59303,60688,Lyon and Nearby Counties,Lyon,32,19,Nevada,NV
32021,32CS003,63,62,63,78,15,15,16,2,11.292827282195045,11.705777057457595,12.09644458118604,0.1226997667372991,77,77,78,87,10,9,10,14,-1.068478348682988,-0.9399692289405185,-0.8102731946905014,1.3086061579472779,4551,4581,Lyon and Nearby Counties,Mineral,32,21,Nevada,NV
32029,32CS003,33,33,34,36,3,2,3,5,-2.798242328974212,-2.386335575456435,-1.9570847372203295,1.4142485652823842,41,41,42,48,7,6,7,1,1.2455382013482705,1.369605586392101,1.502629880483027,0.13044194353568644,4123,4138,Lyon and Nearby Counties,Storey,32,29,Nevada,NV
32007,32CS004,283,260,306,340,57,34,80,42,-0.591542298258219,1.1297151918745156,2.92318709764908,0.7209305943734425,354,326,382,506,152,124,180,101,0.4338786562360443,0.959217649122052,1.4948435312903676,0.659526225076141,53640,53891,"Northern Nevada, excluding Washoe",Elko,32,7,Nevada,NV
32011,32CS004,12,12,13,11,-1,-2,-1,6,-16.22047943137731,-15.792361596352853,-15.384015257987244,-13.340205602674898,15,15,16,28,13,12,13,1,5.961605305749634,6.097958817530321,6.217882621962445,0.07380277114402281,1887,1895,"Northern Nevada, excluding Washoe",Eureka,32,11,Nevada,NV
32013,32CS004,130,123,138,124,-6,-14,1,10,-5.448729041106344,-3.8240444656266304,-2.1483795725091688,-1.823998855176073,164,155,173,207,43,34,52,36,-0.11824687745390564,0.42394889433689853,0.942533106965218,0.8112183959122817,17263,17595,"Northern Nevada, excluding Washoe",Humboldt,32,13,Nevada,NV
32015,32CS004,43,43,44,55,12,11,12,4,4.881023435225755,5.315387197411554,5.744518335272704,0.31847593481514563,54,54,55,70,16,15,16,12,0.5009847341086029,0.6249782085261615,0.7475504546958585,0.721250895565988,5702,5787,"Northern Nevada, excluding Washoe",Lander,32,15,Nevada,NV
32017,32CS004,40,39,40,51,11,11,12,3,6.961656344248602,7.355373600694158,7.760921759620265,0.24040585778302173,48,47,48,63,15,15,16,1,3.011145254348602,3.1404358447000584,3.2646254482128074,0.06170531748592542,4603,4522,"Northern Nevada, excluding Washoe",Lincoln,32,17,Nevada,NV
32027,32CS004,47,46,48,54,7,6,8,11,-2.809834171900722,-2.4377685203624546,-2.0587885407755055,1.3849181255151193,59,58,60,86,27,26,28,19,1.1008585667670963,1.2246856269757296,1.3425998837834097,0.6728942350402636,6648,6726,"Northern Nevada, excluding Washoe",Pershing,32,27,Nevada,NV
32033,32CS004,74,73,75,79,5,4,6,0,1.6226501304589016,2.0184393166090615,2.423286791038969,0,92,91,93,105,13,12,14,18,-0.6505901733459782,-0.5231109053912624,-0.39631108393287123,1.2676912369848607,9148,9167,"Northern Nevada, excluding Washoe",White Pine,32,33,Nevada,NV
32031,32CS005,3511,3302,3720,3998,487,278,696,441,-1.2172352173444838,0.37928147190200706,2.049816980482765,0.9034952068613034,4362,4108,4617,4847,485,230,739,522,-0.5607300790153114,-0.07145857043599915,0.4576391541956064,1.074695555556909,485825,492516,Washoe,Washoe,32,31,Nevada,NV
33001,33CS001,660,632,687,697,37,10,65,44,-2.178825056600244,-0.3795130745674834,1.3281668121556263,1.146738853120465,818,785,851,823,5,-28,38,80,-1.7063562680449977,-1.165977965214654,-0.6333122705473038,13.56126981805417,63476,64355,Belknap+Carroll,Belknap,33,1,New Hampshire,NH
33003,33CS001,505,483,526,489,-16,-37,6,3,-3.1667830770814493,-1.4555424144211304,0.16018532058310267,-0.2062973734857119,632,606,659,611,-21,-48,5,36,-1.6208879421006643,-1.115907162086818,-0.5992813720267013,-1.7817539187413287,50132,51312,Belknap+Carroll,Carroll,33,3,New Hampshire,NH
33005,33CS002,646,613,679,631,-15,-48,18,6,-2.861885491065338,-1.0581050659987887,0.6393600972665666,-0.4266845230547803,800,761,840,900,100,60,139,76,-0.18979029648521584,0.301352547619158,0.8143003478196682,0.7561258907792154,76497,77208,Cheshire,Cheshire,33,5,New Hampshire,NH
33007,33CS003,382,368,395,402,20,7,34,20,-1.6350304004458573,0.023645804564378845,1.6963657299990655,0.944922867341345,467,451,483,573,106,90,122,62,0.8724376777893282,1.3983151724516951,1.8705695227331967,0.5810818449262553,31221,31272,Coos+Grafton,Coos,33,7,New Hampshire,NH
33009,33CS003,744,704,783,734,-10,-49,30,11,-2.4456170798315506,-0.9274066881132935,0.7527948683309468,-1.2874142358420373,925,877,972,935,10,-37,58,44,-0.8957561923301034,-0.3466965409242843,0.15725700556591,3.843008401679694,91125,92044,Coos+Grafton,Grafton,33,9,New Hampshire,NH
33011,33CS004,3003,2822,3185,3420,417,235,598,412,-1.7230406811255554,0.048956719239563906,1.6774844175537167,0.9866684275872838,3712,3493,3931,3961,249,30,468,297,-0.6150587895380923,-0.12334667330938515,0.4148997220104803,1.1866631253104651,422124,423879,Hillsborough,Hillsborough,33,11,New Hampshire,NH
33013,33CS005,1236,1170,1302,1280,44,-22,110,58,-2.109874744736316,-0.3484570565120667,1.2752659528962835,1.2953228080541002,1530,1450,1610,1560,30,-50,110,101,-0.9341082746942889,-0.45227790442586036,0.061336087351626496,3.2148801701759333,153721,155046,Merrimack+Sullivan,Merrimack,33,13,New Hampshire,NH
33019,33CS005,390,371,408,405,15,-3,34,3,-0.6871987635198149,1.1026574973476195,2.8151254438979,0.18466827956991486,481,459,504,516,35,12,57,45,-0.73451084070291,-0.24155620008026799,0.30160266015556014,1.2581147213310682,43119,43460,Merrimack+Sullivan,Sullivan,33,19,New Hampshire,NH
33015,33CS006,2224,2089,2359,2461,237,102,372,183,-1.0165805881088503,0.6697624011117522,2.4561632705143803,0.7687703075209946,2760,2597,2923,2969,209,46,372,256,-0.6741393451915259,-0.15074989211850567,0.39588452752772224,1.2190231691320619,313995,316580,Rockingham,Rockingham,33,15,New Hampshire,NH
33017,33CS007,1001,945,1058,1019,18,-39,74,26,-1.915300699243453,-0.2635562475110003,1.4005049329277872,1.3771091045326367,1243,1175,1312,1338,95,26,163,114,-0.6557795942970905,-0.16133055622951997,0.3625087634819829,1.1906644584608468,131111,132210,Strafford,Strafford,33,17,New Hampshire,NH
34001,34CS001,2421,2303,2538,2830,409,292,527,286,0.08464222391994568,1.8854022767566376,3.470959032785839,0.6969837935915376,2988,2846,3130,3402,414,272,556,413,-0.5474190893687443,-0.004540666253959831,0.4967328539737866,0.9947525035452406,272735,274853,Atlantic,Atlantic,34,1,New Jersey,NJ
34003,34CS002,6316,5906,6726,8114,1798,1388,2208,1962,-2.4291860636142832,-0.6875657862300658,0.9809018611266866,1.0905354692794988,7806,7313,8298,7612,-194,-686,299,626,-1.3580536895662227,-0.8615504042974638,-0.38193243995105436,-3.2490028622968885,951391,953958,Bergen,Bergen,34,3,New Jersey,NJ
34005,34CS003,3622,3423,3820,4075,453,255,652,523,-2.22672391452938,-0.6201145227868137,0.9422124962831019,1.1509197922680912,4479,4240,4719,4556,77,-163,316,341,-1.0544475095114276,-0.5621251385638576,-0.02443639986086412,4.3951810501703985,459823,463918,Burlington,Burlington,34,5,New Jersey,NJ
34007,34CS004,4264,4040,4489,5018,754,529,978,700,-1.2281108099321112,0.4070974440493868,2.147008064504473,0.9273975620776843,5265,4995,5536,5642,377,106,647,516,-0.7408137320401921,-0.2534944584119712,0.26441086881205994,1.3663546469410348,520828,523688,Camden,Camden,34,7,New Jersey,NJ
34009,34CS005,1129,1088,1170,1224,95,54,136,112,-2.2872687193384293,-0.7710509986210521,1.0319704360420847,1.1688048336083545,1389,1340,1439,1436,47,-3,96,97,-1.0476117739388777,-0.5386040426988391,-0.009003434470434706,2.0308124182292664,94725,95576,Cape May,Cape May,34,9,New Jersey,NJ
34011,34CS006,1369,1303,1435,1630,261,195,327,180,0.48431982042228233,2.143915097625965,3.8418891491484475,0.6859338774203552,1684,1604,1763,1920,236,157,316,239,-0.5042321524449458,-0.019417369659208247,0.5060959292991569,1.0067458157181524,153117,153659,Cumberland,Cumberland,34,11,New Jersey,NJ
34013,34CS007,5450,5081,5818,7733,2283,1915,2652,2055,-0.7030037383757354,1.100796905700145,2.7400929950064996,0.8995985265159738,6727,6286,7169,6760,33,-409,474,721,-1.3375814869390197,-0.809644209871612,-0.28157565490408626,21.51094586280887,852560,855955,Essex,Essex,34,13,New Jersey,NJ
34015,34CS008,2401,2271,2531,2802,401,271,531,343,-0.9895867260073152,0.8244482369482965,2.5308432003975665,0.8525470016916058,2978,2821,3135,3183,205,48,362,321,-0.9103599740053797,-0.3630649788804406,0.09229337517121512,1.5586671997317776,301232,304204,Gloucester,Gloucester,34,15,New Jersey,NJ
34017,34CS009,3422,3114,3730,5136,1714,1406,2022,1511,-0.6842500774974771,1.1381595672381954,2.8808239911795095,0.88121277753567,4200,3835,4564,4532,332,-32,697,635,-0.9475634304034695,-0.4317123626922585,0.06374402811873683,1.9040783550501095,713461,705408,Hudson,Hudson,34,17,New Jersey,NJ
34019,34CS010,793,738,848,925,132,77,187,144,-2.079117990230555,-0.36555057552370984,1.3867844607146416,1.0831437641132486,989,922,1056,996,7,-60,74,66,-0.9463529298365511,-0.453684487688788,0.04439159566112864,7.805145561273949,128421,129766,Hunterdon,Hunterdon,34,19,New Jersey,NJ
34021,34CS011,2595,2429,2760,3247,652,487,818,607,-1.1885896870140855,0.5174250655989271,2.0941265643309355,0.9291900172795569,3209,3009,3408,3438,229,30,429,296,-0.6973334862625226,-0.1766449286154575,0.330399165723464,1.2856302890196147,383940,386024,Mercer,Mercer,34,21,New Jersey,NJ
34023,34CS012,5282,4913,5651,6749,1467,1098,1836,1445,-1.6596559560350685,0.10021714359472156,1.731457379190856,0.9843398627255482,6552,6107,6996,6779,227,-217,672,741,-1.134605900656212,-0.5989518878226785,-0.08571118179220016,3.2470338790157602,856323,860968,Middlesex,Middlesex,34,23,New Jersey,NJ
34025,34CS013,4894,4618,5170,5879,985,709,1261,937,-1.4011949363902239,0.2685339169924702,2.044179702730317,0.9505687438776818,6065,5732,6398,6320,255,-78,588,647,-1.0828669989076336,-0.5941567360974098,-0.1095851254361303,2.5252697569226203,639968,645034,Monmouth,Monmouth,34,25,New Jersey,NJ
34027,34CS014,3392,3173,3610,4288,896,678,1115,829,-1.1926596903532893,0.5595614980451538,2.14340316006391,0.9238252135066725,4213,3950,4477,4197,-16,-280,247,314,-1.1560945941392113,-0.6515031119414344,-0.14468690733634135,-20.36530834037649,506666,510692,Morris,Morris,34,27,New Jersey,NJ
34029,34CS015,6582,6308,6856,7343,761,487,1035,1136,-3.992761087222947,-2.3794926148412974,-0.6019167856627708,1.491408248508332,8164,7829,8498,8281,117,-217,452,891,-1.7114031589799081,-1.213340945726467,-0.6713709005944712,7.520871765835471,635315,647514,Ocean,Ocean,34,29,New Jersey,NJ
34031,34CS016,3297,3073,3521,4800,1503,1279,1727,1352,-0.4440761403833851,1.1934696543450938,2.87508664959863,0.8989602978667862,4061,3793,4329,4211,150,-118,418,514,-1.2045356328833876,-0.7012956458006796,-0.19562128098319284,3.4059410297465327,519480,518844,Passaic,Passaic,34,31,New Jersey,NJ
34033,34CS017,651,623,679,789,138,110,166,94,0.893973553862559,2.6835706382436366,4.433538954714374,0.6775451891495533,802,768,835,911,109,76,143,98,-0.3252011646626971,0.16858892820167393,0.6510907085589891,0.8877869844431633,64511,65019,Salem,Salem,34,33,New Jersey,NJ
34035,34CS018,2146,1998,2293,2624,478,331,626,525,-2.4384634973010026,-0.5899510409020167,1.1561671249334133,1.09499927932535,2667,2489,2845,2636,-31,-209,147,218,-1.2332963744198446,-0.7356866860703853,-0.1590542379696134,-7.285164007329696,342890,345555,Somerset,Somerset,34,35,New Jersey,NJ
34037,34CS019,1081,1019,1143,1321,240,178,302,217,-1.0521196411852693,0.6041443284784214,2.4927977611903005,0.9016570984178272,1347,1272,1422,1477,130,55,205,122,-0.46161706062919294,0.0438188883407422,0.5718149280267671,0.9306224171351396,143742,145330,Sussex,Sussex,34,37,New Jersey,NJ
34039,34CS020,3498,3251,3744,5073,1575,1329,1822,1389,-0.4598861252851514,1.3292328433482432,2.8645552443604387,0.8811358340197708,4322,4027,4618,4416,94,-202,389,480,-1.212646067142419,-0.661377460877473,-0.20591366504682213,5.063040611119586,571537,572440,Union,Union,34,39,New Jersey,NJ
34041,34CS021,901,854,948,1062,161,114,208,150,-1.3465295440823724,0.3963431098560737,2.170786176246239,0.9254818104464166,1118,1061,1175,1192,74,17,131,106,-0.8161042133275946,-0.28580197003156876,0.23683800188978144,1.408949587289953,109110,110565,Warren,Warren,34,41,New Jersey,NJ
35001,35CS001,4930,4639,5221,6092,1162,871,1453,602,1.567377994065404,3.3004950204615775,5.041315420758374,0.5176509172563655,6064,5715,6412,7313,1249,901,1598,797,0.16915894656242683,0.6541710582899631,1.198823714300759,0.6374884338411754,676768,674712,Bernalillo,Bernalillo,35,1,New Mexico,NM
35003,35CS002,37,36,39,38,1,-1,2,4,-5.4895918126854,-3.8127165436290085,-2.0853142918811556,2.4572734661393345,47,45,49,71,24,22,26,10,3.2886505821042578,3.8050485247641603,4.347770623747703,0.396985697279398,3609,3714,Catron+Cibola+Sierra+Socorro,Catron,35,3,New Mexico,NM
35006,35CS002,220,208,232,321,101,89,113,69,2.989670151697696,4.761326759337643,6.464778148044416,0.6768734093982943,271,257,285,390,119,105,133,85,0.7132572065319769,1.2425834039691135,1.7543486375202617,0.7079086568592199,27030,27168,Catron+Cibola+Sierra+Socorro,Cibola,35,6,New Mexico,NM
35051,35CS002,219,214,224,264,45,40,50,42,-0.5281204880694684,1.2080907578513467,2.9311244803482004,0.906905241207596,266,260,272,275,9,3,15,29,-2.2019041873031004,-1.7106402540196197,-1.2347296665580236,2.8169400190545804,11430,11506,Catron+Cibola+Sierra+Socorro,Sierra,35,51,New Mexico,NM
35053,35CS002,150,143,157,194,44,37,51,48,-2.775881008402083,-1.0582259537601635,0.7230297721118444,1.075456834007637,182,173,190,220,38,30,47,30,-0.010901717210396301,0.4910617191014959,1.0157354794705977,0.7666531448532176,16546,16348,Catron+Cibola+Sierra+Socorro,Socorro,35,53,New Mexico,NM
35005,35CS003,570,542,598,734,164,136,192,106,1.9026377241252046,3.5894448868024904,5.229204248674145,0.6406010799178776,696,663,730,842,146,112,179,142,-0.4579660960844815,0.06342720755301186,0.5858822845161304,0.9671481847672463,65027,64708,Chaves,Chaves,35,5,New Mexico,NM
35009,35CS004,348,328,369,400,52,31,72,57,-2.1498454611892566,-0.46296257252440404,1.3424682042967675,1.0832945429440544,427,402,452,551,124,99,149,102,-0.05124287957864001,0.46763832908184233,0.9897688130148495,0.8151460689172103,48402,48047,Curry+Roosevelt,Curry,35,9,New Mexico,NM
35041,35CS004,145,137,154,162,17,8,25,40,-6.6579863492263485,-4.922948917868619,-3.149410905428765,2.269218304273082,179,169,189,219,40,30,50,47,-0.8598308843403513,-0.3708369019245282,0.1155733722314728,1.140666215135972,19018,19033,Curry+Roosevelt,Roosevelt,35,41,New Mexico,NM
35013,35CS005,1391,1296,1486,1984,593,498,688,329,3.0126554488441135,4.759842829943925,6.603782752051418,0.5539391983063328,1732,1617,1846,2307,575,461,690,323,0.6601503989728251,1.159158848141564,1.687140882606888,0.5604012476009274,219916,221273,Do�a Ana,Do�a Ana,35,13,New Mexico,NM
35015,35CS006,530,504,557,534,4,-23,30,77,-6.417860255279751,-4.730519709197385,-2.9825113771328398,16.720924168705963,645,614,677,785,140,108,171,149,-0.6843500552528754,-0.1596766828900702,0.36841362211922507,1.059560432301613,61553,61107,Eddy,Eddy,35,15,New Mexico,NM
35017,35CS007,303,291,315,374,71,59,83,23,5.128533658934346,6.843218034433044,8.75052172738882,0.31954817498679056,370,356,385,424,54,39,68,58,-0.6779890022291494,-0.13735034283157813,0.3177472794941213,1.0574789566527183,27991,27936,Grant+Hidalgo+Luna,Grant,35,17,New Mexico,NM
35023,35CS007,45,45,46,47,2,1,2,6,-4.548572655331067,-4.142008318143774,-3.74270816875968,2.2190753630969278,55,54,55,61,6,6,7,7,-0.3386905325597136,-0.21567395188827843,-0.08988514485244561,0.9835376208177359,4149,4085,Grant+Hidalgo+Luna,Hidalgo,35,23,New Mexico,NM
35029,35CS007,274,263,285,337,63,52,74,59,-1.095017324351729,0.62725803656292,2.4389147633559563,0.9228345963122393,339,326,352,421,82,69,95,57,0.42372868606575825,0.9575649508853162,1.4877998287330885,0.6881425021077908,25192,25516,Grant+Hidalgo+Luna,Luna,35,29,New Mexico,NM
35011,35CS008,21,21,21,28,7,7,7,7,-0.3270069797369154,0.05691875903719181,0.48065208304386625,0.8717493432045922,26,25,26,38,12,12,13,6,3.6870245139151674,3.8143670278851776,3.9450985676132233,0.447444626472698,1687,1680,Guadalupe and Nearby Counties,De Baca,35,11,New Mexico,NM
35019,35CS008,42,42,42,55,13,13,13,5,6.822303496844173,7.226553719578402,7.615869744557153,0.3575215121469492,52,51,52,58,6,6,7,4,0.33519326847424635,0.4686843581137831,0.5803439346788511,0.5662532910048567,4423,4449,Guadalupe and Nearby Counties,Guadalupe,35,19,New Mexico,NM
35027,35CS008,205,197,214,208,3,-6,11,18,-4.824564250399974,-3.027868125217585,-1.249676608492636,4.939524702128564,254,244,265,317,63,52,73,40,0.6504618426532768,1.1299247251631352,1.6408076380096495,0.6258173789887126,20228,20416,Guadalupe and Nearby Counties,Lincoln,35,27,New Mexico,NM
35037,35CS008,104,103,105,140,36,35,37,10,11.463307296177812,11.866620484856284,12.271361394337333,0.27287055536124327,128,127,129,173,45,44,46,39,0.5383215064408428,0.6610858717905386,0.7858822729082001,0.8527781772014256,8645,8665,Guadalupe and Nearby Counties,Quay,35,37,New Mexico,NM
35057,35CS008,142,136,149,151,9,2,15,10,-1.9708363082600386,-0.376647124299952,1.3843383960936437,1.0264284907808232,177,169,185,234,57,49,65,45,0.33490113899387547,0.7979029959414823,1.3263351003114243,0.7730030264869524,15135,15270,Guadalupe and Nearby Counties,Torrance,35,57,New Mexico,NM
35025,35CS009,502,470,533,604,102,71,134,134,-3.3952905212231332,-1.6893472715353839,-0.10866157001324578,1.2960622112954647,614,576,652,742,128,90,166,163,-0.960436982273564,-0.48851634029396407,0.055815983917773426,1.2650770992331326,73916,73235,Lea,Lea,35,25,New Mexico,NM
35028,35CS010,117,115,119,116,-1,-3,1,5,-1.7007775098837739,-1.2827724762580015,-0.9086309610201561,-18.944183794714306,144,141,146,139,-5,-7,-2,10,-0.8974399505326819,-0.7660749697769689,-0.6445372062919396,-2.6044037424060744,19408,19344,Los Alamos+Santa Fe,Los Alamos,35,28,New Mexico,NM
35049,35CS010,1071,1005,1138,1215,144,77,210,87,-0.2060272212576071,1.4573454093126732,3.1867507064219542,0.6013135457125987,1324,1244,1404,1582,258,178,338,133,0.303978952804492,0.8068053212034076,1.273327822554251,0.5137944645066607,154413,155168,Los Alamos+Santa Fe,Santa Fe,35,49,New Mexico,NM
35031,35CS011,569,562,577,1056,487,479,494,374,5.822637631002322,6.239459530404711,6.635437702443806,0.76699860287536,696,687,705,1008,312,303,321,179,1.7194468836939725,1.8482893599648604,1.9691548092541649,0.572264294263508,72373,71904,McKinley,McKinley,35,31,New Mexico,NM
35007,35CS012,123,122,124,150,27,26,28,30,-1.452370453436356,-1.0395113205209439,-0.6805781783520187,1.0793294978609573,152,151,154,176,24,22,25,32,-0.8002078285901856,-0.6739778321818964,-0.5443289555835957,1.2972679135410583,12297,12364,Northeast New Mexico,Colfax,35,7,New Mexico,NM
35021,35CS012,9,9,10,12,3,2,3,5,-15.471728172687309,-15.056502845553588,-14.635134283358452,1.412659021456095,11,11,11,14,3,3,3,2,0.8443936512393445,0.9683289298444372,1.0948290103668834,0.552230140546995,654,642,Northeast New Mexico,Harding,35,21,New Mexico,NM
35033,35CS012,41,39,43,43,2,0,4,4,-3.435758050741169,-1.7803982590424297,-0.014072744813045022,1.2827169383757828,50,48,52,56,6,4,8,8,-0.9335214591451471,-0.391713079877777,0.09314718589661296,1.1058367717612485,4230,4194,Northeast New Mexico,Mora,35,33,New Mexico,NM
35047,35CS012,243,232,255,264,21,9,32,10,-0.042908759630793145,1.5496453570371838,3.248009809629512,0.4646532856813206,298,284,312,391,93,79,107,45,1.2612979320024928,1.7635421288254038,2.269552473575757,0.4794232169089106,27151,27145,Northeast New Mexico,San Miguel,35,47,New Mexico,NM
35059,35CS012,40,38,41,48,8,7,10,3,3.685406629523971,5.391961046722645,7.081325864607986,0.3160310652515289,49,47,51,55,6,4,8,6,-0.42276271876844135,0.10592799248220512,0.5827524660778832,0.8173661308148288,4068,4101,Northeast New Mexico,Union,35,59,New Mexico,NM
35035,35CS013,542,512,571,640,98,69,128,45,1.5399591926493439,3.1521351716043866,4.831851179984861,0.45274372967909277,670,634,705,850,180,145,216,122,0.3176058953300354,0.8257574684780437,1.3743135486213516,0.6724711210770692,67889,68438,Otero,Otero,35,35,New Mexico,NM
35039,35CS014,367,350,385,438,71,53,88,45,0.9039923250490742,2.5339149985413996,4.314984234213344,0.6290682790185181,451,430,471,594,143,123,164,70,1.2884962004706453,1.8378908271203998,2.3688678439923065,0.48455900876752417,40054,40191,Rio Arriba+Taos,Rio Arriba,35,39,New Mexico,NM
35055,35CS014,282,267,296,344,62,48,77,44,0.4965159037110473,2.193345613104906,3.8740625330489777,0.6951795393941221,349,331,367,422,73,55,91,36,0.5719200021386844,1.0767273120864296,1.600766155935118,0.48505678891371473,34177,34589,Rio Arriba+Taos,Taos,35,55,New Mexico,NM
35043,35CS015,1029,965,1093,1237,208,144,272,153,-0.1391992501180717,1.491459436854318,3.2763687390770024,0.7318740728365458,1288,1210,1366,1536,248,170,326,177,-0.019937358733698455,0.4604451628854145,0.9669133979168053,0.7106530966032913,149125,151055,Sandoval,Sandoval,35,43,New Mexico,NM
35045,35CS016,905,853,958,1336,431,378,483,327,1.72009124228336,3.3277620648821857,5.192116869693469,0.7576101509592394,1115,1052,1177,1696,581,519,644,369,1.1998981905889612,1.7497938910657023,2.254999913257015,0.633890929853007,121762,121057,San Juan,San Juan,35,45,New Mexico,NM
35061,35CS017,598,565,631,740,142,109,175,73,1.906981474041027,3.5531470155138076,5.20457281650332,0.5115450536932493,743,703,783,954,211,171,251,142,0.3829391808862771,0.9081770721238887,1.427293801114361,0.6694791347873223,76510,77064,Valencia,Valencia,35,61,New Mexico,NM
36001,36CS001,2389,2255,2524,2634,245,110,379,209,-1.2668279185060451,0.5313978154511669,2.315830511956682,0.8513202259734948,2939,2777,3101,3188,249,87,411,256,-0.5417423093558633,-0.01812304815060433,0.521599097714719,1.0247690758888848,312901,313834,Albany+Greene,Albany,36,1,New York,NY
36039,36CS001,449,428,469,461,12,-8,33,28,-2.9850723160863026,-1.2645819620184509,0.4105350083737256,2.1269058852817593,555,530,580,653,98,73,123,67,0.14755022144888363,0.6440294725755566,1.144490391792317,0.6749481727911597,47854,48410,Albany+Greene,Greene,36,39,New York,NY
36003,36CS002,418,398,438,474,56,36,76,69,-2.869900679355934,-1.1066667291712273,0.6241350186201802,1.2133319457151517,512,488,536,562,50,26,74,81,-1.1711814848113207,-0.6630754509282599,-0.19770862106071324,1.598115118195162,46278,46145,Allegany+Steuben,Allegany,36,3,New York,NY
36101,36CS002,852,811,892,972,120,80,161,123,-1.9047725977169772,-0.0672049732542699,1.599957139304986,1.0123786892797655,1041,993,1089,1267,226,178,274,145,0.35517074333762727,0.8761262157251846,1.3978328300713028,0.6396877783070655,93606,93009,Allegany+Steuben,Steuben,36,101,New York,NY
36005,36CS003,8329,7702,8955,14136,5807,5181,6434,4277,2.5803632183547665,4.203968230047409,6.054166040536014,0.7363820475992693,10144,9405,10882,11761,1617,879,2356,1456,-0.3773583614725969,0.09575604252896981,0.6320608829359272,0.899692910078762,1455080,1430999,Bronx,Bronx,36,5,New York,NY
36007,36CS004,1842,1757,1927,2054,212,127,297,211,-1.75958378272782,0.09282879475486736,1.7013653998710134,0.9912756412966989,2257,2155,2359,2510,253,151,355,298,-0.7469429828733606,-0.23087276284230604,0.29984730063805215,1.1745159940295766,197011,197380,Broome,Broome,36,7,New York,NY
36009,36CS005,722,689,755,789,67,34,100,53,-0.9985540975491476,0.7421279256260502,2.415387635386317,0.7773789421947692,880,841,920,1156,276,236,315,161,0.988327929294084,1.4997198981569955,2.0304585025929396,0.5816424270209433,76758,76496,Cattaraugus+Wyoming,Cattaraugus,36,9,New York,NY
36121,36CS005,326,308,343,373,47,30,65,28,0.24190418736597616,1.9107977922738213,3.609412366592236,0.5778184152216582,401,380,422,428,27,6,48,54,-1.1866541883195472,-0.6598205485972657,-0.15397284611085565,1.9194079316140849,40331,40478,Cattaraugus+Wyoming,Wyoming,36,121,New York,NY
36011,36CS006,644,611,676,759,115,83,148,29,2.806121599322162,4.560597825867933,6.33006266056766,0.2494378861393142,787,748,826,940,153,114,192,111,0.056036326206305345,0.5487438547975433,1.0132280743681372,0.7194911260666109,76124,75911,Cayuga,Cayuga,36,11,New York,NY
36013,36CS007,1279,1224,1333,1291,12,-42,67,41,-2.600380808258723,-0.9261107113511444,0.9636110992726882,3.09150319985633,1559,1494,1625,1873,314,248,379,286,-0.2700753675777015,0.24110488391526622,0.7292037750912037,0.9081562402174762,127245,126897,Chautauqua,Chautauqua,36,13,New York,NY
36015,36CS008,864,828,900,942,78,42,114,100,-2.727918551328291,-1.0500351280309985,0.7310314454800374,1.2583573418175031,1052,1009,1095,1138,86,43,129,123,-0.9541771774958793,-0.44642055949603543,0.07498137476162742,1.4122976256525577,83725,83167,Chemung,Chemung,36,15,New York,NY
36017,36CS009,487,467,507,519,32,12,52,29,-1.4974556771971492,0.26176936349726376,2.0914777856249103,0.8830478243669633,589,565,613,698,109,85,133,83,0.009016688725132437,0.5392449693474035,1.0845636968951005,0.7556746122697228,47041,46615,Chenango+Cortland,Chenango,36,17,New York,NY
36023,36CS009,373,353,393,425,52,32,72,28,0.2779284390378164,2.021240461828492,3.740420884544282,0.5307369300042463,454,430,478,556,102,78,126,54,0.5569769804496174,1.0332132545207147,1.4983447621123933,0.5242184967310718,46780,46371,Chenango+Cortland,Cortland,36,23,New York,NY
36019,36CS010,619,585,654,676,57,22,91,10,0.5956192380257495,2.3394985362445024,3.9056864264972044,0.1736792562833957,763,722,805,866,103,61,144,57,0.07492273345309106,0.5771988979178815,1.0859538106777205,0.5502402099716064,79749,79613,Clinton,Clinton,36,19,New York,NY
36021,36CS011,588,561,614,579,-9,-35,18,44,-5.126460467138356,-3.4327769218071396,-1.779657025807911,-5.627842691510093,723,691,755,762,39,7,71,65,-0.9456670154826564,-0.40630655743189714,0.12338110087085324,1.6098625011953127,61287,61745,Columbia,Columbia,36,21,New York,NY
36025,36CS012,452,433,471,476,24,5,43,23,-1.6596113693711034,0.07743427862230522,1.764530797722427,0.9211225259607,557,534,580,673,116,93,139,70,0.5076296120334924,1.06289521665609,1.5680217870026936,0.5966868741711197,44231,44350,Delaware+Schoharie,Delaware,36,25,New York,NY
36095,36CS012,246,233,259,258,12,-1,25,2,-0.5543571949386645,1.3479578065280768,3.100259367838519,0.15333386144960723,304,288,319,357,53,38,69,33,0.15527167315073845,0.6639877090572424,1.2080647121047907,0.6066334970818745,29929,29842,Delaware+Schoharie,Schoharie,36,95,New York,NY
36027,36CS013,2180,2053,2307,2497,317,190,444,264,-0.9739812553034415,0.784338366573358,2.4477812687156577,0.8304350244067578,2700,2547,2853,3136,436,283,589,335,-0.18734749566446288,0.33601084132830505,0.8642029333422528,0.7667160185942997,295621,296912,Dutchess,Dutchess,36,27,New York,NY
36029,36CS014,8523,8114,8931,9465,942,534,1351,1189,-2.7779960642116457,-1.0208768860465502,0.8102289981534083,1.2604471206397236,10445,9954,10936,10896,451,-40,942,1200,-1.2913720581715906,-0.7860360550792387,-0.24421787243323528,2.6529451243656097,947964,951058,Erie,Erie,36,29,New York,NY
36031,36CS015,366,350,382,403,37,21,53,3,1.9622154911489538,3.6784454858380786,5.421773914682771,0.07821161400619556,447,428,466,490,43,24,62,33,-0.2739929605825374,0.2650632396639224,0.786003689499474,0.754011253964874,37278,37278,Essex+Franklin,Essex,36,31,New York,NY
36033,36CS015,380,360,401,413,33,12,53,11,0.001289989402806615,1.8176514958652494,3.5501291214932866,0.3255007541193985,465,440,489,546,81,57,106,37,0.39053599331534955,0.9459145672835508,1.4343736514725998,0.44965060932934015,47895,47466,Essex+Franklin,Franklin,36,33,New York,NY
36035,36CS016,514,491,537,565,51,28,74,48,-1.465111249334637,0.20799550462789798,1.8819739823703343,0.9199554388240403,630,602,657,803,173,146,201,117,0.5506845750780801,1.0731628678667553,1.5794352831389071,0.6720270092683805,53181,53122,Fulton+Hamilton,Fulton,36,35,New York,NY
36041,36CS016,57,56,57,64,7,7,8,2,3.6207377797076816,4.007742878801814,4.392150373091278,0.24962929639834697,72,71,72,79,7,7,8,4,0.5122155337032139,0.6321048950056865,0.755234247025393,0.48584314774349624,4989,5113,Fulton+Hamilton,Hamilton,36,41,New York,NY
36037,36CS017,539,514,564,607,68,43,93,57,-0.9969448359578672,0.6799186727474279,2.407170647591569,0.8301191161024659,661,631,691,734,73,43,103,121,-1.3538418158739365,-0.8272409421712487,-0.3214163996671998,1.627349339287744,58093,57912,Genesee+Orleans,Genesee,36,37,New York,NY
36073,36CS017,356,339,373,418,62,45,79,49,-0.28236458826376876,1.300810840746027,2.9134074061319666,0.7785021294319522,438,417,459,487,49,28,70,52,-0.5746452810037317,-0.07035081750631715,0.409863335808288,1.0369370069155135,40248,40198,Genesee+Orleans,Orleans,36,73,New York,NY
36043,36CS018,559,533,585,609,50,24,76,35,-0.7081728156107847,0.9739255049177424,2.6945214197096146,0.6826237137955949,680,649,711,834,154,123,185,139,-0.2661327358267974,0.2530538730909193,0.7694732906995907,0.8966547818413675,60196,59947,Herkimer,Herkimer,36,43,New York,NY
36045,36CS019,814,765,864,793,-21,-71,28,13,-2.966088512104111,-1.1528366747515983,0.4326137718134018,-0.638161546749036,1015,955,1075,1081,66,6,126,119,-0.9555174534305226,-0.44708927817313443,0.06116581090319376,1.7849139754372847,115277,116272,Jefferson+Lewis,Jefferson,36,45,New York,NY
36049,36CS019,223,211,234,205,-18,-29,-6,6,-5.269988918109275,-3.5792305634746593,-1.9417385165731196,-0.3583498228913751,275,261,289,304,29,15,43,40,-0.9353586190422205,-0.4126831416015401,0.03975164186341834,1.3427290087424386,26511,26568,Jefferson+Lewis,Lewis,36,49,New York,NY
36047,36CS020,14153,12990,15315,22012,7859,6697,9022,6645,0.14088999544475733,1.7756181891019935,3.5990671990462215,0.8453693772327548,17265,15895,18636,18745,1480,109,2850,2754,-1.0116000137614716,-0.46625278654351837,0.0070446172399364826,1.8601645341298363,2694327,2653643,Kings,Kings,36,47,New York,NY
36051,36CS021,482,456,509,482,-0,-27,26,33,-3.8186725215044635,-2.193552511897067,-0.4319809676907651,54.51173341593124,593,561,625,678,85,53,117,74,-0.35249633524956886,0.1513259342206954,0.6755393362472176,0.8632270608810506,61861,61596,Livingston,Livingston,36,51,New York,NY
36053,36CS022,486,457,516,612,126,96,155,70,1.4249547818332018,3.192283510395234,4.929421008166438,0.5521236112173189,594,559,629,716,122,87,157,71,0.22762555379936733,0.7483162940730241,1.2437342622918728,0.5785769855742293,68301,67692,Madison,Madison,36,53,New York,NY
36055,36CS023,5834,5508,6159,6541,707,382,1033,654,-1.5412000236481957,0.2244625921239305,2.022207276118114,0.9236057348761404,7167,6777,7557,8101,934,544,1324,896,-0.4504490190702149,0.039944973541299604,0.5608710268794838,0.9586456723304013,755875,755655,Monroe,Monroe,36,55,New York,NY
36057,36CS024,492,471,513,560,68,47,89,33,1.0622554863200795,2.854081611246233,4.615222720327068,0.4782347371893935,601,576,627,737,136,110,161,116,-0.13202593114064887,0.3889493252930492,0.9061866876436243,0.8495686252859121,49435,49540,Montgomery,Montgomery,36,57,New York,NY
36059,36CS025,9511,8913,10109,12307,2796,2198,3394,2756,-1.469117234953657,0.16749706744055418,1.8804349308120232,0.985298713790878,11722,11003,12440,12164,442,-276,1161,1300,-1.1278768540659492,-0.6294342595129666,-0.10972482642722428,2.9329802941468475,1388130,1391355,Nassau,Nassau,36,59,New York,NY
36061,36CS026,8712,7994,9429,12306,3594,2877,4312,2787,0.2179360031300663,1.9318050240487956,3.532077326506743,0.7751702402863231,10331,9508,11153,11300,969,147,1792,1124,-0.6129237386654939,-0.10213233354809291,0.42486821749901704,1.1585051105702313,1668181,1593057,New York (county),New York (county),36,61,New York,NY
36063,36CS027,2043,1952,2134,2390,347,256,438,234,0.37655622446420506,2.16862894176275,3.816717628451671,0.6727436967251688,2498,2389,2607,2967,469,360,578,372,-0.02115912322122449,0.4541526217819116,0.9754051318571934,0.7912379945421525,211797,211740,Niagara,Niagara,36,63,New York,NY
36065,36CS028,2204,2104,2303,2455,251,152,351,246,-1.5653487557865156,0.10459379492279228,1.7430692932765515,0.9749552377748513,2691,2572,2810,3040,349,230,468,471,-1.019658250625658,-0.532911557213044,-0.004654302254230969,1.344847367716222,231043,230481,Oneida,Oneida,36,65,New York,NY
36067,36CS029,3786,3582,3990,4339,553,349,757,474,-1.0867448842202072,0.6799602931628362,2.4032370141941604,0.8556774907399339,4643,4399,4888,5172,529,284,773,514,-0.46420417810502346,0.038104895985227705,0.5492922379390432,0.9699178146392956,473245,473588,Onondaga,Onondaga,36,67,New York,NY
36069,36CS030,944,896,993,935,-9,-58,39,74,-4.828723782414768,-3.00261741843381,-1.2547220828128138,-8.794035090078056,1161,1103,1219,1193,32,-26,90,103,-1.1282068952869149,-0.6309022962074379,-0.11644672041497271,3.136760291214994,112115,112503,Ontario,Ontario,36,69,New York,NY
36071,36CS031,2455,2283,2627,3006,551,379,723,594,-2.1477235402639194,-0.4808405720125309,1.2732714560540448,1.0759638924776505,3060,2851,3269,3163,103,-106,312,393,-1.2394964208533445,-0.7217012235824602,-0.19929518347119918,3.7803688034478213,399268,404058,Orange,Orange,36,71,New York,NY
36075,36CS032,932,882,983,981,49,-2,99,48,-1.690055331644066,0.06091289313779747,1.7704014091811324,0.9657047202317164,1149,1088,1210,1328,179,118,240,138,-0.18244048338734228,0.34693691840662055,0.8267902822725977,0.7666837967822387,117294,117382,Oswego,Oswego,36,75,New York,NY
36077,36CS033,515,490,540,571,56,31,81,19,0.9490966402471047,2.537360311353448,4.125524857846316,0.3329525321654718,630,600,660,735,105,75,135,85,-0.21250311643572883,0.3382170868382264,0.8266058786656265,0.8046538416222064,58472,58156,Otsego,Otsego,36,77,New York,NY
36079,36CS034,601,559,643,777,176,134,218,116,0.6456195675113875,2.503965065594534,4.223084607026649,0.6541378027082237,742,691,792,753,11,-39,62,53,-0.9148677404248677,-0.4251248124382173,0.1641413849048751,4.397470740005732,97813,97896,Putnam,Putnam,36,79,New York,NY
36081,36CS035,12854,11833,13876,20419,7565,6543,8586,6559,0.05353573043545122,1.6820910920631258,3.3936984520104887,0.8669614428708055,15723,14514,16931,17198,1475,267,2684,2511,-0.9492060048597437,-0.4676940977613874,0.07928252954672317,1.7010443264773136,2368371,2340571,Queens,Queens,36,81,New York,NY
36083,36CS036,1267,1198,1336,1393,126,57,195,78,-0.5034044320901467,1.2249288820145172,3.125828695063562,0.6130510334917827,1552,1470,1635,1786,234,151,316,167,-0.1009551641504769,0.4291231983598588,0.9165849341744071,0.7117837448059123,160568,160333,Rensselaer,Rensselaer,36,83,New York,NY
36085,36CS037,3289,3077,3501,4420,1131,919,1343,1125,-1.5766074646264938,0.05685690178531172,1.7606137416569854,0.993791329090319,4058,3803,4313,4367,309,54,564,594,-1.0964786170093586,-0.5728642216035729,-0.07414567802392569,1.9174812615064867,492484,493790,Richmond,Richmond,36,85,New York,NY
36087,36CS038,1979,1833,2124,2791,812,667,958,819,-1.842336648967475,-0.10578326706912657,1.6640439040951744,1.0067682031709724,2464,2289,2639,2476,12,-163,187,273,-1.2775523823044648,-0.7712137029036116,-0.2824784620454787,20.46793247555161,336520,339066,Rockland,Rockland,36,87,New York,NY
36089,36CS039,855,809,902,939,84,37,130,47,-0.4205021254774681,1.334904378370155,3.0341618763323104,0.5552004095567548,1054,998,1110,1261,207,151,263,139,0.10489269957102164,0.6075757797096805,1.1423122335528708,0.6681932599209106,108204,108089,St. Lawrence,St. Lawrence,36,89,New York,NY
36091,36CS040,1671,1570,1772,1689,18,-83,119,64,-2.4420174836055137,-0.7872021637560919,0.9144782340822557,3.386131215085904,2074,1952,2196,2364,290,168,412,252,-0.34569159203905064,0.1660843923683907,0.7024216617578414,0.8661485832177477,234980,237115,Saratoga,Saratoga,36,91,New York,NY
36093,36CS041,1341,1274,1409,1453,112,44,179,88,-1.1764235931618772,0.5967660300881127,2.409051286844805,0.7809638751777772,1648,1566,1729,1851,203,122,285,188,-0.44484723645881147,0.11196183277271905,0.6102852943062306,0.9197933581912755,157547,158056,Schenectady,Schenectady,36,93,New York,NY
36097,36CS042,176,169,184,192,16,8,23,11,-0.6399204824108697,1.0393499441762548,2.758022332769629,0.6567384597016344,215,206,224,259,44,35,53,17,0.9580106736791039,1.488698533071697,1.9964625524420787,0.3802695744211763,17840,17767,Schuyler+Seneca+Yates,Schuyler,36,97,New York,NY
36099,36CS042,310,295,324,324,14,-0,29,30,-3.540787759133243,-1.8698996275729665,-0.14403782314428132,1.982463316834648,380,363,397,410,30,13,47,52,-1.1833282910305738,-0.6481345445466014,-0.14789135181951568,1.6769756557213886,33781,33692,Schuyler+Seneca+Yates,Seneca,36,99,New York,NY
36123,36CS042,231,221,242,256,25,14,35,16,-0.37342634623536314,1.3933749813322747,3.0402016946039856,0.6244661622699695,283,270,296,279,-4,-17,9,25,-1.7098845012570014,-1.1626097101496713,-0.7142531169405982,-7.98277705003333,24727,24627,Schuyler+Seneca+Yates,Yates,36,123,New York,NY
36103,36CS043,10827,10173,11481,13547,2720,2066,3374,2805,-1.8665811983057985,-0.25008635349013836,1.456455539199508,1.0309221164399707,13397,12609,14185,14310,913,125,1701,1770,-1.0596331883102714,-0.5646698204774881,-0.02954674007369525,1.9366896777399625,1517657,1526017,Suffolk,Suffolk,36,103,New York,NY
36105,36CS044,648,614,681,739,91,58,125,63,-0.3317599005759351,1.4027151443396648,3.2069119547435885,0.6820095549298898,807,766,848,875,68,27,109,81,-0.6687257556630823,-0.16489289947207197,0.3315315218942766,1.1703442691982402,78313,79636,Sullivan,Sullivan,36,105,New York,NY
36107,36CS045,403,382,423,492,89,69,110,57,0.8974682558381352,2.686472742605855,4.360919054272114,0.6309840627396948,492,467,517,559,67,42,92,59,-0.34925755186635216,0.15866444571861682,0.6620596339674405,0.8693988447854868,48296,48035,Tioga,Tioga,36,107,New York,NY
36109,36CS046,612,567,657,584,-28,-73,17,22,-3.704688039433212,-1.8542620216044075,-0.12122427273950918,-0.8186789252032499,758,704,813,759,1,-54,55,54,-1.013779340008344,-0.5049583016607638,-0.012388993130296242,32.99126514463329,104878,105197,Tompkins,Tompkins,36,109,New York,NY
36111,36CS047,1504,1426,1582,1664,160,82,238,149,-1.3453233590844331,0.24090147185448274,1.8929889518216338,0.9267819801344294,1858,1764,1953,2042,184,89,278,209,-0.652159100803821,-0.15143867583774717,0.3598808853682045,1.131502286634244,181271,182767,Ulster,Ulster,36,111,New York,NY
36113,36CS048,632,604,660,671,39,11,67,37,-1.4877252001660766,0.1378072313628807,1.8857016566590254,0.929363307997121,776,742,810,883,107,73,141,71,-0.008328326956164405,0.5376876509979729,1.103052219893399,0.658427513601754,65394,65621,Warren,Warren,36,113,New York,NY
36115,36CS049,552,526,578,627,75,49,101,16,2.230186022396927,3.8846629982362266,5.48823911751237,0.2102503708866507,678,647,710,781,103,71,134,91,-0.3006380316802127,0.20225044337852455,0.7073531432597204,0.8754819462750524,61127,60983,Washington,Washington,36,115,New York,NY
36117,36CS050,768,729,807,832,64,25,103,50,-1.0583073255475663,0.6010843271694306,2.387277880923263,0.7655733559680684,943,896,990,1039,96,49,143,106,-0.648702818859316,-0.10419711152564577,0.38005875718282317,1.0925627142310435,90897,90949,Wayne,Wayne,36,117,New York,NY
36119,36CS051,6302,5872,6732,8319,2017,1587,2447,1926,-1.3067276164130304,0.3260407178285314,2.029727468753609,0.954542360927597,7779,7263,8294,8014,235,-280,751,930,-1.2190693790622233,-0.7168709154657414,-0.14982585092884482,3.9376827766761306,997616,998675,Westchester,Westchester,36,119,New York,NY
37001,37CS001,1520,1446,1594,1726,206,132,280,149,-0.35411322515575694,1.3659185139107761,3.0511431462077185,0.7184244255100696,1880,1791,1970,1881,1,-89,90,173,-1.538561321478638,-0.9892142598645747,-0.4934812031120647,97.89307417081795,171665,173580,Alamance,Alamance,37,1,North Carolina,NC
37003,37CS002,335,319,351,440,105,89,121,44,4.7250616290156495,6.6712986794486175,8.404269446331297,0.4154992205568789,410,391,429,586,176,157,195,97,1.6278895635158046,2.1505260372979356,2.616153722523118,0.5492441736386618,36596,36613,Alexander+Catawba,Alexander,37,3,North Carolina,NC
37035,37CS002,1454,1385,1524,1706,252,182,321,174,0.24122831396120717,1.897035238490179,3.6959207333785336,0.6888647868830207,1787,1704,1871,2029,242,158,325,320,-0.976732776450169,-0.4805614462248137,0.02537581828375385,1.3185689102226004,160647,161581,Alexander+Catawba,Catawba,37,35,North Carolina,NC
37005,37CS003,121,120,123,129,8,6,9,4,0.87859963471081,1.2980885544870442,1.6800839978475304,0.46692790293362707,150,149,152,160,10,8,11,14,-0.5109278003832411,-0.39214744995000683,-0.26230718076260257,1.3038144546174435,10949,11027,Alleghany+Ashe+Avery+Watauga,Alleghany,37,5,North Carolina,NC
37009,37CS003,289,277,300,343,54,43,66,34,1.3559404596775486,2.983714563057297,4.65229606337114,0.6160089892084951,355,341,368,412,57,44,71,57,-0.5279067766512274,0.0015041265393301662,0.5341012480380223,0.9773533690632611,26678,26690,Alleghany+Ashe+Avery+Watauga,Ashe,37,9,North Carolina,NC
37011,37CS003,187,180,195,187,-0,-8,7,19,-6.022388766025909,-4.350054891563699,-2.4563165358238006,23.383595131083183,231,221,240,239,8,-1,18,32,-1.8009807550323862,-1.3164918823392882,-0.8014790382793833,3.3913945591313994,17761,17854,Alleghany+Ashe+Avery+Watauga,Avery,37,11,North Carolina,NC
37189,37CS003,308,284,331,361,53,30,77,24,0.41651793905003537,2.1672316530098246,3.909839605328677,0.4420222604950799,384,356,412,422,38,10,66,39,-0.5375543346438356,-0.0058372970578818555,0.5030750682453268,0.9988768994869762,54410,54210,Alleghany+Ashe+Avery+Watauga,Watauga,37,189,North Carolina,NC
37007,37CS004,239,229,248,286,47,38,57,34,0.6309428546984748,2.353987992218968,4.0462470466340745,0.7068796628912632,290,278,301,384,94,83,106,73,0.472290259434567,0.9732985134778315,1.4855971828704646,0.7649798553785672,22253,22056,Anson+Richmond,Anson,37,7,North Carolina,NC
37153,37CS004,460,442,479,575,115,96,133,57,3.7709408882603883,5.379947633416098,7.235073010268931,0.4915158782833984,557,535,579,694,137,115,159,104,0.23919714069320347,0.7950978413280267,1.30188022650828,0.7526503999843456,43138,42747,Anson+Richmond,Richmond,37,153,North Carolina,NC
37013,37CS005,489,470,508,571,82,63,101,65,-0.1582069570816805,1.469653188094794,3.266299051266433,0.7814497769781741,593,570,615,602,9,-13,32,80,-2.106991106083043,-1.5882764065238484,-1.055756910568919,7.631728992645777,44964,44490,Beaufort+Martin+Pamlico,Beaufort,37,13,North Carolina,NC
37117,37CS005,254,244,263,341,87,78,97,30,8.69057798184695,10.408450165033747,12.062859073596172,0.34039259583137466,307,296,318,345,38,27,49,54,-1.2608803086507383,-0.7171679250916091,-0.2623758136081234,1.3861831309869266,22002,21782,Beaufort+Martin+Pamlico,Martin,37,117,North Carolina,NC
37137,37CS005,149,144,154,152,3,-2,8,1,-1.1131879208428888,0.6078044486277611,2.366707606838109,0.25666834103953484,182,176,188,187,5,-1,11,21,-1.8175295191900211,-1.3118453158550125,-0.7982193865865845,3.4671799341027225,12341,12335,Beaufort+Martin+Pamlico,Pamlico,37,137,North Carolina,NC
37017,37CS006,320,307,333,421,101,88,114,27,8.182885667775027,9.887794869816817,11.598739417100415,0.2638417352763946,387,372,402,518,131,116,146,87,0.9893791847575674,1.4893289650275543,1.997554076928192,0.6588301801340745,30067,29536,Bladen+Columbus,Bladen,37,17,North Carolina,NC
37047,37CS006,549,528,571,753,204,182,225,85,7.703917308639317,9.285907054319944,11.022669619281407,0.4155478333372791,663,637,689,836,173,147,199,154,-0.13140404233028968,0.39515314614726127,0.9131861205778452,0.8847102441923382,51183,50152,Bladen+Columbus,Columbus,37,47,North Carolina,NC
37019,37CS007,1325,1265,1385,1530,205,145,265,84,1.8114739986101724,3.4408090158211406,5.244767596781737,0.4074618082168046,1669,1595,1743,1926,257,183,331,203,-0.1369728740900774,0.35601870985218725,0.8602905312523662,0.7872087584274416,139438,143321,Brunswick,Brunswick,37,19,North Carolina,NC
37021,37CS008,2394,2279,2510,2542,148,32,263,158,-1.9026105445680532,-0.1202348478923533,1.4751065720255188,1.0635012426439068,2968,2828,3108,3016,48,-92,188,264,-1.3284226742984306,-0.7934034577859221,-0.29840822677101453,5.431723416456645,268716,271255,Buncombe+Madison,Buncombe,37,21,North Carolina,NC
37115,37CS008,221,212,231,239,18,8,27,14,-1.0299264331209286,0.6082323516440777,2.397971111349503,0.7535484798951508,274,263,285,282,8,-3,19,40,-2.0100768922896513,-1.4778239117193122,-0.971157061469514,4.301410884148425,21302,21459,Buncombe+Madison,Madison,37,115,North Carolina,NC
37023,37CS009,859,821,897,1016,157,119,195,85,1.5713338150548741,3.341722177919209,5.023579941946008,0.5377578233582695,1049,1003,1094,1194,145,100,191,178,-0.8902161023028705,-0.36548262181067137,0.12676302351119362,1.2154089638767125,87972,87602,Burke,Burke,37,23,North Carolina,NC
37025,37CS010,1467,1369,1564,1580,113,16,211,127,-1.9936998447193441,-0.23076621467748745,1.3019001521722366,1.1116988206303298,1835,1716,1954,1870,35,-84,154,272,-1.5405195856019347,-1.0264033338101322,-0.49836248470685757,7.499821223233866,225940,230664,Cabarrus,Cabarrus,37,25,North Carolina,NC
37027,37CS011,820,785,855,976,156,121,191,108,0.5848636874857438,2.3487779434223746,4.138789210293282,0.6877484412461039,1002,961,1044,1152,150,108,191,173,-0.7945050996567778,-0.2898031266908244,0.22534349611595378,1.1480881085655674,80764,80470,Caldwell,Caldwell,37,27,North Carolina,NC
37029,37CS012,77,76,78,95,18,17,19,6,4.251702708967696,4.651757939556746,5.0298583698423585,0.31269436922399335,97,95,98,105,8,7,10,10,-0.29070464960253173,-0.16553157132196691,-0.04048301658374122,1.0838456130819,10498,10771,Camden+Currituck+Pasquotank,Camden,37,29,North Carolina,NC
37053,37CS012,207,194,219,262,55,43,68,13,4.297571504522109,5.962202985548748,7.567340938363312,0.23112387913543175,262,247,277,301,39,24,54,27,-0.054357796028490876,0.4053461905293036,0.9008876398039519,0.6724680700963548,28449,29468,Camden+Currituck+Pasquotank,Currituck,37,53,North Carolina,NC
37139,37CS012,371,354,389,442,71,53,88,41,1.3203794210158317,2.863420073976752,4.642991726036827,0.5703616917584386,455,434,476,531,76,55,97,56,-0.02082633000241077,0.48586007065320946,1.0329273259051284,0.7265942846886517,40565,40795,Camden+Currituck+Pasquotank,Pasquotank,37,139,North Carolina,NC
37031,37CS013,710,681,739,754,44,15,73,31,-0.8135015902763763,0.7936099581061953,2.5021658459208225,0.6910016397807164,878,842,913,973,95,60,131,79,-0.26311199305374083,0.24567722172831324,0.737904264532141,0.8213114984531809,68019,68412,Carteret,Carteret,37,31,North Carolina,NC
37033,37CS014,238,229,248,279,41,31,50,16,2.7133017744499144,4.368129756738998,6.033252967602956,0.3841233491335967,293,281,305,347,54,42,66,44,-0.08145006187049722,0.4272757323758301,0.9199904882803088,0.8000890178623111,22681,22711,Caswell+Person,Caswell,37,33,North Carolina,NC
37145,37CS014,385,368,402,449,64,47,81,26,2.1337777889535112,3.873443887568407,5.514562264518119,0.40009443569205355,473,453,493,515,42,22,62,76,-1.3405733668439443,-0.8604686318356113,-0.36943156214094486,1.7640240145860193,39213,39130,Caswell+Person,Person,37,145,North Carolina,NC
37037,37CS015,647,614,680,727,80,47,113,51,-0.3290941744768807,1.4911199381244118,3.1835028141325505,0.6268878279923465,806,766,846,795,-11,-51,29,55,-1.3910107604664128,-0.834480804767287,-0.3096445813945607,-5.389236118730217,76424,77703,Chatham,Chatham,37,37,North Carolina,NC
37039,37CS016,346,334,358,351,5,-7,17,28,-4.955978805566668,-3.173581352532889,-1.4450013756511646,4.6229154619742365,430,415,445,531,101,86,116,94,-0.30373315546549523,0.2352642872095792,0.7522227145641274,0.924271298311569,28850,29118,Cherokee+Clay+Graham+Swain,Cherokee,37,39,North Carolina,NC
37043,37CS016,136,134,137,111,-25,-26,-23,5,-10.989498373048914,-10.560541940136135,-10.155440123683315,-0.21268980039707722,169,167,170,184,15,14,17,42,-2.477759320217935,-2.3603017259324215,-2.2463853565911776,2.568290787137922,11161,11281,Cherokee+Clay+Graham+Swain,Clay,37,43,North Carolina,NC
37075,37CS016,86,85,87,113,27,26,28,10,7.9084494085383765,8.290593918014128,8.67203864995688,0.36029548218099355,106,105,107,110,4,3,5,15,-1.4588886322301546,-1.3386153030764676,-1.2107057149496998,2.866717688434798,8085,8039,Cherokee+Clay+Graham+Swain,Graham,37,75,North Carolina,NC
37173,37CS016,173,167,179,211,38,32,44,10,6.219491767036599,7.985993580010445,9.549531927969573,0.25612001958723035,213,206,221,242,29,21,36,30,-0.622088100501528,-0.09490328351143487,0.4066617563642883,1.0143623174018597,14122,14128,Cherokee+Clay+Graham+Swain,Swain,37,173,North Carolina,NC
37045,37CS017,1069,1026,1112,1263,194,151,237,162,-0.3671987010210329,1.297239666900529,3.1634370907837894,0.8299726116529224,1314,1262,1366,1316,2,-50,54,218,-2.6658507909956946,-2.1607896550448604,-1.618982024445846,70.0262845028039,99534,100267,Cleveland,Cleveland,37,45,North Carolina,NC
37049,37CS018,928,885,971,1121,193,150,236,102,1.891914839491337,3.613228029254522,5.2651960436292,0.5253166395972,1137,1085,1189,1114,-23,-75,29,108,-1.7991211351274823,-1.288783510166314,-0.8017498308063615,-4.957736311140876,100780,100656,Craven,Craven,37,49,North Carolina,NC
37051,37CS019,2225,2081,2369,2594,369,225,513,148,0.9570392372076314,2.5530563188517896,4.32780559223593,0.39973827925143446,2754,2581,2927,3245,491,318,664,444,-0.38505424726699206,0.15354054117618568,0.6727302000792486,0.9029408692220185,334803,335342,Cumberland,Cumberland,37,51,North Carolina,NC
37055,37CS020,314,298,330,324,10,-6,26,5,-1.077929509368524,0.5997775689310031,2.2901423976905604,0.455170699028797,394,375,414,393,-1,-21,18,26,-1.2067975647974039,-0.7249860559409967,-0.2125731318766282,-540.5504621790518,37097,37706,Dare+Hyde+Tyrrell+Washington,Dare,37,55,North Carolina,NC
37095,37CS020,49,49,50,49,-0,-1,-0,4,-4.310543213793145,-3.897746667404239,-3.4957433741418313,7.579699598205576,60,59,60,47,-13,-13,-12,4,-3.8217533569151647,-3.6899717530749125,-3.567203554368421,-0.3436084233144293,4601,4514,Dare+Hyde+Tyrrell+Washington,Hyde,37,95,North Carolina,NC
37177,37CS020,36,35,38,39,3,1,4,2,-0.5547770775189438,1.0613487392038083,2.6335845012437,0.512905872072702,44,42,46,47,3,1,5,5,-1.1011503431718843,-0.575842835991188,-0.03719905300538523,1.20454652069514,3319,3251,Dare+Hyde+Tyrrell+Washington,Tyrrell,37,177,North Carolina,NC
37187,37CS020,134,129,139,167,33,28,38,12,5.971271249059086,7.519527584580632,9.180233999853664,0.35483978850290054,163,157,168,197,34,29,40,33,-0.3926645288654421,0.1176254236049985,0.6252308653930586,0.9364990028651007,11048,10901,Dare+Hyde+Tyrrell+Washington,Washington,37,187,North Carolina,NC
37057,37CS021,1583,1510,1655,1849,266,194,339,137,1.364884243148392,3.1188248342638456,4.7054711860594365,0.5123637211348728,1951,1863,2039,2256,305,217,393,349,-0.7435481898720467,-0.2553189478425818,0.25788345107233696,1.140037246145,169158,170417,Davidson,Davidson,37,57,North Carolina,NC
37059,37CS022,411,393,429,438,27,9,45,34,-2.3572851659143077,-0.6688338602881138,1.2182650364309398,1.2136754138620014,508,486,531,548,40,17,62,84,-1.5292422742370497,-1.034212931178264,-0.5036963317177666,2.0729608653465768,42866,43427,Davie+Yadkin,Davie,37,59,North Carolina,NC
37197,37CS022,373,357,389,433,60,44,76,40,0.4813901421926671,2.176081134484542,3.8259423919964113,0.6558379514041877,455,436,474,472,17,-2,36,66,-1.8463758281507787,-1.3209274506952697,-0.8307981126302193,3.6867430326024504,37246,37191,Davie+Yadkin,Yadkin,37,197,North Carolina,NC
37061,37CS023,390,369,411,596,206,185,227,74,8.855175117504995,10.539868315249945,12.210398221660679,0.3575847187339354,469,444,494,678,209,184,234,107,1.5648492996313432,2.104249769098419,2.6058200775513995,0.509321763818726,50135,48538,Duplin,Duplin,37,61,North Carolina,NC
37063,37CS024,1829,1689,1969,2037,208,68,348,138,-0.8010468830634319,0.8800445714171147,2.531100709990747,0.6607331532816131,2270,2102,2439,1984,-286,-455,-118,133,-1.8136485005888447,-1.2778955473792342,-0.778063426275259,-0.46622320993550875,325273,326050,Durham,Durham,37,63,North Carolina,NC
37065,37CS025,546,525,567,680,134,113,155,85,2.2601163383419336,4.025776705884481,5.681401942752701,0.6274061934099139,663,638,688,629,-34,-59,-9,61,-2.480084713735401,-1.9626670956624228,-1.4528935614074414,-1.8523625189440591,49060,48408,Edgecombe,Edgecombe,37,65,North Carolina,NC
37067,37CS026,2987,2822,3152,3325,338,173,503,244,-0.8515502005306302,0.8650279247826586,2.765483934678565,0.7201074631157874,3693,3494,3892,3903,210,11,409,409,-0.9872575849570351,-0.5336056476769192,0.02766969203756939,1.940254323893607,382934,385116,Forsyth+Stokes,Forsyth,37,67,North Carolina,NC
37169,37CS026,469,450,488,554,85,66,104,35,2.7433394977348806,4.491343299728496,6.162816162560453,0.40824061569140063,573,550,596,637,64,41,87,76,-0.7719831768511449,-0.2687554563503533,0.24255345829895558,1.1617355521664088,44684,44548,Forsyth+Stokes,Stokes,37,169,North Carolina,NC
37069,37CS027,544,515,574,593,49,19,78,43,-1.1827167239996543,0.3542602994564177,2.057168755248784,0.8666598281798025,688,651,725,686,-2,-39,35,73,-1.5490523225813375,-1.0501927409401686,-0.5358255108381613,-106.52545466438674,69440,71318,Franklin+Warren,Franklin,37,69,North Carolina,NC
37185,37CS027,205,197,214,262,57,48,65,14,7.467358362410524,9.01843520929678,10.876431348040118,0.2433720149316342,251,242,261,275,24,14,33,29,-0.7751278826688759,-0.28616797828083484,0.23698970754392484,1.1789674663832967,18775,18738,Franklin+Warren,Warren,37,185,North Carolina,NC
37071,37CS028,2085,1987,2183,2346,261,163,359,226,-1.0885290341758453,0.6309503765644107,2.319807792517081,0.8633730784899635,2580,2461,2699,2769,189,70,308,452,-1.6699998689390225,-1.1545204067376809,-0.6760321016641844,2.3781803932932695,228011,230479,Gaston,Gaston,37,71,North Carolina,NC
37015,37CS029,200,192,207,261,61,54,69,38,3.4642527088194277,5.100876704375466,6.789878058566747,0.610850626494591,242,233,251,275,33,24,42,28,-0.18485769900875756,0.309899973790762,0.7983587758059413,0.8136811817424865,17977,17555,Gates and Nearby Counties,Bertie,37,15,North Carolina,NC
37041,37CS029,167,161,173,194,27,21,33,22,-0.275118458794922,1.5165901076908805,3.0418836565689134,0.7873297391007912,206,199,213,222,16,9,23,21,-0.8637234896022622,-0.3452309665705522,0.17700168137864686,1.2201340526952178,13708,13714,Gates and Nearby Counties,Chowan,37,41,North Carolina,NC
37073,37CS029,105,104,106,126,21,20,22,18,0.5823043543137939,1.0185899570335402,1.395133631484814,0.8311429998557465,127,126,128,155,28,27,29,19,0.7321275956280535,0.8608022465731954,0.9755334089469571,0.6569797966464069,10601,10379,Gates and Nearby Counties,Gates,37,73,North Carolina,NC
37091,37CS029,215,206,224,315,100,91,109,47,8.025007755156588,9.75612159143303,11.427604358130147,0.4652233101989579,262,251,273,267,5,-6,16,30,-1.6728152850933828,-1.1645098066861599,-0.5793306439921413,5.065087394500622,21752,21303,Gates and Nearby Counties,Hertford,37,91,North Carolina,NC
37143,37CS029,151,145,156,182,31,26,37,15,3.0720232586381386,5.039525838709058,6.591362312747584,0.4664028886281645,186,180,193,188,2,-5,8,26,-2.3811649347774924,-1.8642704407701485,-1.3621388924812317,10.283089912399086,13096,13111,Gates and Nearby Counties,Perquimans,37,143,North Carolina,NC
37077,37CS030,483,457,510,594,111,84,137,48,2.4521459904099783,4.109889194956767,5.681127535479173,0.4303916768653306,601,569,633,613,12,-20,44,67,-1.4395369464141003,-0.8760667188132342,-0.407891395974896,5.230231251852466,61040,61848,Granville+Vance,Granville,37,77,North Carolina,NC
37181,37CS030,430,411,448,566,136,118,155,71,4.376343224107758,6.071914179863455,7.8680483541531014,0.5173285365833544,520,498,542,596,76,54,98,60,-0.12712434706061854,0.3754476413231184,0.9084595271855367,0.7799242550931499,42805,42235,Granville+Vance,Vance,37,181,North Carolina,NC
37079,37CS031,173,164,182,206,33,24,42,26,-0.2959229414565586,1.3589374392847877,3.049266964021261,0.7649513847839676,212,202,223,229,17,6,27,21,-0.7578194911522529,-0.24233702075659916,0.291340200665761,1.1998615106234451,20510,20421,Greene+Jones+Lenoir,Greene,37,79,North Carolina,NC
37103,37CS031,98,97,99,135,37,36,38,17,8.336751536620149,8.726578617905954,9.116227140664748,0.44710401688938556,121,120,122,149,28,27,29,16,1.1935163634991062,1.3161156597374761,1.4369275407768727,0.5486297988019816,9193,9241,Greene+Jones+Lenoir,Jones,37,103,North Carolina,NC
37107,37CS031,607,584,631,733,126,102,149,78,1.736818948083513,3.4963674288123014,5.260179592452955,0.6161120845152929,740,711,768,801,61,33,90,111,-1.4216441651522478,-0.9057391205358212,-0.40275641029793147,1.7794508665900486,55122,54748,Greene+Jones+Lenoir,Lenoir,37,107,North Carolina,NC
37081,37CS032,3938,3705,4171,4378,440,207,673,346,-1.1591185540321634,0.687833367383323,2.43757334188471,0.7847072237548032,4862,4583,5142,5634,772,492,1051,547,-0.08895340568947112,0.42760865037400614,0.8985109469525315,0.7080750119853888,540951,542255,Guilford,Guilford,37,81,North Carolina,NC
37083,37CS033,541,520,562,696,155,134,176,53,6.605419503387916,8.43197675479531,10.065338508072156,0.3403873704872972,659,634,683,761,102,78,127,92,-0.2926895380866416,0.2317187367436857,0.7492283495597002,0.889014481007294,48702,48305,Halifax+Northampton,Halifax,37,83,North Carolina,NC
37131,37CS033,202,194,209,305,103,96,111,43,12.02417635810342,13.698153487363182,15.341698725179938,0.41162617461588147,241,232,250,307,66,57,75,45,0.7195341668413122,1.2118102245981301,1.7475692634146347,0.6711513070115263,17706,17174,Halifax+Northampton,Northampton,37,131,North Carolina,NC
37085,37CS034,878,820,935,1068,190,133,248,97,1.0303387265627597,2.76390291961298,4.456553405427158,0.5069966545066311,1094,1024,1164,1265,171,101,241,187,-0.6832692763033418,-0.12980516055778119,0.42596453774220355,1.087441865453727,134342,135644,Harnett,Harnett,37,85,North Carolina,NC
37087,37CS035,696,669,722,806,110,84,137,72,0.7735094848674567,2.4281852574743086,3.9998702226344056,0.6470962127455097,853,821,886,868,15,-18,47,107,-2.0149660691931928,-1.47429968987505,-0.9616395994761382,6.813392566388805,62222,62426,Haywood,Haywood,37,87,North Carolina,NC
37089,37CS036,1215,1165,1265,1298,83,33,133,98,-2.1902657889501134,-0.5583186065210839,1.1290119188959675,1.1712448385463714,1485,1425,1545,1520,35,-25,95,149,-1.474427745385361,-0.9722457267967756,-0.5091800871922033,4.146419968796953,116653,116780,Henderson,Henderson,37,89,North Carolina,NC
37093,37CS037,297,274,319,410,113,91,136,40,3.883583659088541,5.587639686072067,7.158048986747586,0.34980204018597977,373,346,400,449,76,49,103,77,-0.48383301187816014,-0.028569835627648248,0.4805062888482906,1.001134183531223,52745,52984,Hoke+Scotland,Hoke,37,93,North Carolina,NC
37165,37CS037,337,322,352,484,147,132,162,56,8.737862834999198,10.609456166475663,12.430388621035174,0.37815415960341103,414,396,432,532,118,100,136,78,0.6866344212536841,1.1782056454462557,1.6574771595535476,0.6554420776849991,34219,34210,Hoke+Scotland,Scotland,37,165,North Carolina,NC
37097,37CS038,1422,1341,1503,1614,192,111,273,134,-0.5952139207674839,1.2159025312349891,2.9321689565578346,0.6936874432605152,1779,1681,1878,1757,-22,-121,76,302,-2.2205087101003724,-1.7015099182771045,-1.2091000764090596,-14.152272311360754,187241,191335,Iredell,Iredell,37,97,North Carolina,NC
37099,37CS039,339,320,357,381,42,24,61,31,-0.6380130161384182,1.0451301858519588,2.7607406351487946,0.7140695588662576,417,395,439,396,-21,-43,1,50,-2.1680074942249994,-1.6372188544247757,-1.1026094035864684,-2.4934360740255075,43251,43370,Jackson+Macon+Transylvania,Jackson,37,99,North Carolina,NC
37113,37CS039,422,406,438,463,41,25,57,16,0.9839412479401568,2.7079614748000265,4.438102405309643,0.38182059357089504,521,502,541,577,56,36,75,90,-1.440714071832303,-0.9018087056762065,-0.38100473996663015,1.5856453036853537,36910,37489,Jackson+Macon+Transylvania,Macon,37,113,North Carolina,NC
37175,37CS039,353,339,368,369,16,1,30,14,-1.5567724713785993,0.17426436562133338,1.8705814222058748,0.8434924571289167,431,414,448,490,59,42,76,47,-0.14370179983633377,0.3344140187285294,0.8706906647803632,0.7873853764829238,33209,33142,Jackson+Macon+Transylvania,Transylvania,37,175,North Carolina,NC
37101,37CS040,1416,1322,1509,1536,120,27,214,121,-1.8320204058113763,-0.011314080541080894,1.5929719341805046,0.9964404153129877,1801,1685,1917,1894,93,-23,209,249,-1.2504889541625153,-0.696000300994124,-0.17620356555716635,2.6477702039033035,217397,225207,Johnston,Johnston,37,101,North Carolina,NC
37105,37CS041,533,506,560,646,113,86,140,46,2.4334754565917995,4.248286184994701,5.922629660315181,0.40326822153308656,659,626,692,674,15,-18,48,85,-1.6179095589201888,-1.0933155476788863,-0.5927650850601004,5.4354279172810775,63230,64028,Lee,Lee,37,105,North Carolina,NC
37109,37CS042,733,695,770,850,117,80,155,74,0.2980263955760538,2.014340322046921,3.7347854541982897,0.6248543470584712,915,869,962,849,-66,-113,-20,174,-3.1833139804191473,-2.6831568221520494,-2.1940418808877324,-2.6579462891864365,87366,89308,Lincoln,Lincoln,37,109,North Carolina,NC
37111,37CS043,448,429,467,541,93,74,112,64,0.910208092888164,2.659009132847386,4.328630701110015,0.6793716386313058,551,528,574,598,47,24,70,110,-1.939614196582382,-1.3810722048228363,-0.9126741275625799,2.276599282765948,44737,44691,McDowell+Mitchell+Yancey,McDowell,37,111,North Carolina,NC
37121,37CS043,200,194,206,214,14,8,20,26,-4.966817295504974,-3.202435400875369,-1.5763843904053731,1.741040846026774,245,238,253,249,4,-4,11,36,-2.6866049276424775,-2.1719799928412353,-1.6822606368055706,7.713714680649644,14896,14951,McDowell+Mitchell+Yancey,Mitchell,37,121,North Carolina,NC
37199,37CS043,207,199,215,234,27,19,35,19,0.02820473854360328,1.8084753802632114,3.5636059897443544,0.6728215175629393,257,247,266,288,31,22,41,50,-1.5278131175704401,-1.0043914500062594,-0.48933526149616785,1.5519725502072863,18444,18716,McDowell+Mitchell+Yancey,Yancey,37,199,North Carolina,NC
37119,37CS044,5557,5076,6038,6552,995,514,1476,611,-0.40150403974549703,1.3320226858996926,3.0889108607336246,0.6135377075891422,6926,6347,7505,7610,684,105,1263,847,-0.6561951114229042,-0.13544548024975514,0.3867386017797718,1.2370845149714849,1118013,1121702,Mecklenburg,Mecklenburg,37,119,North Carolina,NC
37123,37CS045,252,241,263,314,62,51,73,38,1.9565270442084741,3.7910739348867493,5.386349879015337,0.5997833626390144,308,294,321,384,76,63,90,65,-0.09138190203564625,0.4327538105629435,0.9656951342458259,0.841947107101958,25945,25787,Montgomery+Moore,Montgomery,37,123,North Carolina,NC
37125,37CS045,1005,962,1048,1118,113,70,156,97,-1.0277994323492812,0.6102472018188503,2.2283663707712087,0.8516465686623146,1254,1201,1307,1307,53,0,106,149,-1.4579616686312058,-0.9324012205614084,-0.4075294821175136,2.757362366113686,100584,102385,Montgomery+Moore,Moore,37,125,North Carolina,NC
37127,37CS046,934,893,975,1058,124,83,165,115,-1.2998583108281305,0.4010526105363842,2.023235597754985,0.9185527398126314,1147,1098,1196,1183,36,-13,85,133,-1.5058017289842038,-1.0428395422260308,-0.4660962232288529,3.5831084392287647,94930,95154,Nash,Nash,37,127,North Carolina,NC
37129,37CS047,1684,1586,1781,1952,268,171,366,88,1.5639515247060953,3.2092745193449628,4.765621797486251,0.32679847856120847,2084,1966,2202,2278,194,76,312,205,-0.5313946155888805,-0.04675751921235,0.4709604644699744,1.0500900396769766,227566,228587,New Hanover,New Hanover,37,129,North Carolina,NC
37133,37CS048,1081,993,1169,1205,124,36,212,79,-0.8583305241426771,0.8719062979553112,2.6303194317034193,0.6317008109609671,1353,1247,1459,1527,174,68,280,220,-0.7143244170256996,-0.21620995324437,0.3208334088106391,1.2574963794956706,204601,205952,Onslow,Onslow,37,133,North Carolina,NC
37135,37CS049,717,653,781,754,37,-27,101,52,-2.0784090708225573,-0.39281305269537137,1.4171515878885133,1.355592782138838,892,816,969,887,-5,-82,71,51,-0.8908544214889219,-0.3839200705554203,0.13479888314567612,-11.42959521929144,148714,148871,Orange,Orange,37,135,North Carolina,NC
37141,37CS050,509,482,535,579,70,44,97,31,0.9222658453929922,2.5493000404055395,4.3437029224734856,0.4338744676920924,639,606,671,745,106,74,139,88,-0.21917614794148588,0.2959003028168715,0.7905797133206799,0.8190610674142021,61160,62487,Pender,Pender,37,141,North Carolina,NC
37147,37CS051,1074,1000,1148,1393,319,245,393,126,2.6373629633878544,4.446356138888208,6.313926952912875,0.39399392669677313,1330,1241,1419,1608,278,189,367,180,0.11724855665562889,0.5671983957168595,1.0876596109507644,0.6451123565746388,172295,171936,Pitt,Pitt,37,147,North Carolina,NC
37149,37CS052,244,236,253,275,31,22,39,17,1.1781612055035977,2.858281780252772,4.487038652364144,0.5351637210887936,299,289,309,344,45,35,55,53,-0.9506958571256825,-0.3994493872918803,0.06886745368932393,1.1543527542467504,19599,19615,Polk+Rutherford,Polk,37,149,North Carolina,NC
37161,37CS052,713,685,741,889,176,148,204,115,2.1082002743564434,3.818741286856767,5.425295619658507,0.6493524725903592,869,836,903,1058,189,155,222,210,-0.8106765773348732,-0.3354942552696619,0.15546651091567953,1.1076385925136012,64819,64562,Polk+Rutherford,Rutherford,37,161,North Carolina,NC
37151,37CS053,1345,1283,1407,1564,219,157,281,137,0.5102404569094514,2.262615323540598,3.972839867288821,0.623229769572301,1658,1583,1733,1988,330,255,405,294,-0.3157176059250292,0.2450245415505395,0.7710098936555003,0.8875641461022331,144299,145050,Randolph,Randolph,37,151,North Carolina,NC
37155,37CS054,1083,1032,1133,1529,446,396,497,194,6.840297137058502,8.570426215648443,10.28098148981349,0.4338378625531949,1317,1257,1377,1872,555,495,615,300,1.699187127855801,2.1978725312285596,2.711883061604289,0.5394071836319131,118411,116333,Robeson,Robeson,37,155,North Carolina,NC
37157,37CS055,998,958,1037,1204,206,167,246,104,2.7833551698461787,4.474031133104699,6.120930233958343,0.5015889619817909,1222,1175,1269,1475,253,206,300,167,0.4484113719981487,0.9546121025999513,1.4161208540689676,0.6578208001171632,91105,91239,Rockingham,Rockingham,37,157,North Carolina,NC
37159,37CS056,1449,1386,1512,1687,238,175,301,157,0.7437995194575497,2.2581545853559972,3.876217475555336,0.6559601344989182,1785,1709,1862,2073,288,211,364,349,-0.9598362276630825,-0.4055547880533189,0.07285017151618015,1.2096795493468622,146384,147986,Rowan,Rowan,37,159,North Carolina,NC
37163,37CS057,557,531,582,647,90,65,116,57,0.5768306423015198,2.227351366928828,3.946872907541585,0.6241887575150964,677,646,707,813,136,106,167,118,-0.19377623935565944,0.31933843855358535,0.8087195961598188,0.8590052082700241,59652,58995,Sampson,Sampson,37,163,North Carolina,NC
37167,37CS058,623,596,650,718,95,68,122,74,-0.37556543274365545,1.323958841691925,3.035249291678435,0.7703490820933444,768,735,800,861,93,61,126,138,-1.2054046083559682,-0.7133911730272327,-0.16894158275797846,1.4630367653624974,62699,63306,Stanly,Stanly,37,167,North Carolina,NC
37171,37CS059,805,775,836,919,114,83,144,86,-0.26098763922107515,1.5235342507603535,3.148557459748981,0.7508639721661117,985,948,1021,1034,49,13,86,169,-2.18773221909452,-1.7039839795135312,-1.1751927996842233,3.355806933862867,71314,71167,Surry,Surry,37,171,North Carolina,NC
37179,37CS060,1303,1199,1406,1448,145,42,249,117,-1.1884952962438478,0.4805716265287303,2.1949300727971672,0.7988296408827523,1637,1511,1762,1909,272,147,398,292,-0.600637663453086,-0.08073766974655247,0.42696601525064254,1.0684229624370272,239849,243012,Union,Union,37,179,North Carolina,NC
37183,37CS061,5162,4674,5650,5693,531,43,1019,449,-1.5416515964112514,0.3468881749793631,2.02044904196346,0.8439563784766014,6523,5930,7115,6581,58,-534,651,525,-0.9135339921760771,-0.4105253450089032,0.11214180226571621,8.843849132178628,1132260,1147776,Wake,Wake,37,183,North Carolina,NC
37191,37CS062,1041,990,1091,1316,275,225,326,149,2.675839582784895,4.295450493419391,6.0545547491309435,0.5389112075235891,1273,1213,1334,1422,149,88,209,191,-0.8800035859905448,-0.3713836374626574,0.15049676634045575,1.2761114866659093,118159,116892,Wayne,Wayne,37,191,North Carolina,NC
37193,37CS063,688,660,717,827,139,110,167,77,1.9641783077018866,3.7698250670090503,5.331734451293655,0.5512939400594747,839,805,873,987,148,114,182,157,-0.6883323295276033,-0.12070472342515613,0.37168321089447776,1.0511302674265999,66218,65815,Wilkes,Wilkes,37,193,North Carolina,NC
37195,37CS064,741,707,775,942,201,167,235,110,2.8592976807223147,4.631475635604925,6.347483564900839,0.5439760941843007,904,864,945,1123,219,178,259,136,0.5503273502333548,1.0520355107083366,1.5356739458159925,0.6195656050719521,79197,78433,Wilson,Wilson,37,195,North Carolina,NC
38005,38CS001,51,50,51,91,40,40,41,15,16.39202245364497,16.776753682357757,17.17976715001123,0.3619928659653064,60,59,60,89,29,29,30,4,4.225207512254801,4.348489677120416,4.470850250046934,0.1317579504150382,6067,5830,Benson and Nearby Counties,Benson,38,5,North Dakota,ND
38027,38CS001,39,38,40,32,-7,-8,-6,4,-20.95036942656412,-19.08385297401288,-17.373785148459838,-0.6573654031660368,48,47,49,47,-1,-2,0,5,-2.9944344792875617,-2.4668372661441706,-1.9588878671493033,21.784808684889413,2320,2336,Benson and Nearby Counties,Eddy,38,27,North Dakota,ND
38031,38CS001,37,37,38,52,15,14,15,21,-8.04152690967829,-7.653339584718668,-7.270073424124989,1.3491119183651745,46,46,46,40,-6,-6,-6,3,-2.786332933466513,-2.654552931851284,-2.5250201520039077,-0.60837796925358,3361,3368,Benson and Nearby Counties,Foster,38,31,North Dakota,ND
38039,38CS001,33,33,33,30,-3,-3,-3,5,-14.291350272300878,-13.859041813020632,-13.48876633547595,-2.6191163959200936,40,40,41,22,-18,-19,-18,1,-8.556551678195117,-8.423423781572744,-8.30059927447608,-0.05799589336447197,2283,2283,Benson and Nearby Counties,Griggs,38,39,North Dakota,ND
38069,38CS001,43,43,43,53,10,10,10,21,-11.56663054486512,-11.150440627753035,-10.76406566884132,1.9222381491468865,53,52,53,56,3,3,4,4,-0.2726950355997176,-0.1388314320604841,-0.013579370771617695,0.9003079222026187,3971,3955,Benson and Nearby Counties,Pierce,38,69,North Dakota,ND
38071,38CS001,115,114,117,150,35,33,36,20,4.641932598138504,5.035147477392541,5.423283439135254,0.5624709491593837,142,140,143,120,-22,-23,-20,16,-3.3944839657937136,-3.265023007001846,-3.146913427465869,-0.7705048664598249,11547,11570,Benson and Nearby Counties,Ramsey,38,71,North Dakota,ND
38079,38CS001,110,105,115,159,49,44,54,21,7.368483282433142,9.006149859126719,10.693132804100765,0.4198795595763386,133,126,139,187,54,48,61,13,2.938431194013902,3.422062273260749,3.9748179226726434,0.2344348737809105,12458,12065,Benson and Nearby Counties,Rolette,38,79,North Dakota,ND
38095,38CS001,23,23,23,35,12,12,12,4,14.373465663929514,14.781307422196562,15.158382147905662,0.30978817383338364,28,28,29,30,2,1,2,4,-1.1778089607219449,-1.0517425350072838,-0.9168549510819086,1.453269663126672,2142,2140,Benson and Nearby Counties,Towner,38,95,North Dakota,ND
38103,38CS001,55,54,55,60,5,5,6,8,-3.0518020979531353,-2.616877182626252,-2.209389312581985,1.2430880040112655,66,66,67,52,-14,-15,-14,3,-4.593981019158073,-4.472135857754941,-4.3532895598439865,-0.22230652992192163,3926,3912,Benson and Nearby Counties,Wells,38,103,North Dakota,ND
38017,38CS002,1012,933,1092,1197,185,105,264,153,-1.0087849091489598,0.627070599791607,2.529121412736081,0.8241732933786355,1267,1171,1363,1230,-37,-133,59,104,-1.2886516642248682,-0.7525881677561486,-0.2660126321108701,-2.900994618592121,184661,186315,Cass,Cass,38,17,North Dakota,ND
38003,38CS003,111,110,112,151,40,39,41,26,4.7704018707804385,5.17556554302126,5.570007082011887,0.6351167359809307,136,135,138,149,13,11,14,12,-0.0514347232196492,0.05667969298046683,0.18435219777014927,0.8780570874268805,10771,10810,LaMoure and Nearby Counties,Barnes,38,3,North Dakota,ND
38021,38CS003,58,58,59,82,24,23,24,35,-9.614995216354172,-9.235073617989139,-8.851577164133023,1.4219166401024774,71,70,72,64,-7,-8,-6,5,-2.549919563147195,-2.4265711138190817,-2.304247185727384,-0.8451545812483937,4937,4906,LaMoure and Nearby Counties,Dickey,38,21,North Dakota,ND
38045,38CS003,36,36,37,50,14,13,14,14,-0.7260278392887746,-0.34873319497955463,0.040648756985803745,0.9556357163537148,44,44,45,31,-13,-14,-13,2,-3.9161112947707166,-3.7881874452191275,-3.67104813743112,-0.16111688506388375,4076,4068,LaMoure and Nearby Counties,LaMoure,38,45,North Dakota,ND
38073,38CS003,72,71,72,73,1,1,2,5,-3.016573752712424,-2.6479015190569815,-2.244587148197944,2.2052537878754053,88,88,89,67,-21,-22,-21,4,-4.6074102419464715,-4.476219578975005,-4.347446957424291,-0.19588461445155514,5629,5679,LaMoure and Nearby Counties,Ransom,38,73,North Dakota,ND
38077,38CS003,128,126,129,136,8,7,10,20,-3.2511667637354913,-2.7974853885331012,-2.4171463986694355,2.120526253095397,157,155,159,115,-42,-44,-40,3,-2.851585178731508,-2.717538220639264,-2.5853272363559907,-0.07310163463350915,16479,16555,LaMoure and Nearby Counties,Richland,38,77,North Dakota,ND
38081,38CS003,30,30,31,38,8,7,8,5,2.498234261892009,2.9074808408970787,3.3158208888092706,0.5684975603158801,37,36,37,44,7,7,8,4,0.7162529377041683,0.8463142678255453,0.9707195724026159,0.4856608088010673,3856,3831,LaMoure and Nearby Counties,Sargent,38,81,North Dakota,ND
38093,38CS003,211,201,220,244,33,24,43,65,-7.68508542499901,-5.960707596604142,-4.184896738007775,1.8940158641937446,260,249,271,242,-18,-29,-7,15,-2.053400515027757,-1.5343849180742137,-1.0197955020996843,-0.8754029162244529,21412,21569,LaMoure and Nearby Counties,Stutsman,38,93,North Dakota,ND
38009,38CS004,70,69,71,68,-2,-3,-1,21,-14.789774591522995,-14.383978393562646,-13.958726859903324,-23.9217756979279,87,86,87,63,-24,-24,-23,4,-4.445493885881871,-4.309791013602957,-4.178120809769064,-0.1775735982688269,6366,6388,McHenry and Nearby Counties,Bottineau,38,9,North Dakota,ND
38049,38CS004,51,50,51,80,29,29,30,11,13.065725658221156,13.502831405426717,13.895174403262956,0.36487730233653853,62,61,62,72,10,10,11,4,1.1095484072737944,1.2329173613157047,1.3703047864713886,0.34838752182182076,5377,5260,McHenry and Nearby Counties,McHenry,38,49,North Dakota,ND
38055,38CS004,96,95,97,114,18,17,19,22,-2.080290401262244,-1.68389480850396,-1.3227172098148932,1.1652423249020294,120,119,121,108,-12,-13,-11,10,-2.354619826749473,-2.223344473891873,-2.0965240988365297,-0.9281496739657528,9709,9789,McHenry and Nearby Counties,McLean,38,55,North Dakota,ND
38075,38CS004,24,23,24,30,6,6,7,12,-10.255371886780805,-9.829928520125208,-9.41274997681866,1.6227033564200923,29,29,29,28,-1,-1,-1,4,-2.3350202326114484,-2.2023611836457393,-2.0801384331939086,1702.1824435741244,2279,2267,McHenry and Nearby Counties,Renville,38,75,North Dakota,ND
38083,38CS004,10,10,10,18,8,8,8,3,15.369044844363644,15.77053202706702,16.149298448523965,0.3340278865586239,12,12,13,18,6,5,6,3,1.8856020494136227,2.011371564400854,2.143733136960924,0.45811028327518044,1264,1267,McHenry and Nearby Counties,Sheridan,38,83,North Dakota,ND
38101,38CS004,412,382,442,638,226,196,256,159,2.0902745905294386,3.86680872573084,5.6116094650039505,0.6994168104291576,509,473,545,541,32,-4,68,50,-0.7984102551341953,-0.2680340994458644,0.29670584033590713,1.5245493254857712,69562,69184,McHenry and Nearby Counties,Ward,38,101,North Dakota,ND
38019,38CS005,39,39,39,40,1,1,1,4,-3.7642324440533343,-3.3787552061364186,-2.965292049383053,2.120981294302734,48,47,48,48,0,-0,1,3,-0.8467803206079726,-0.7295952500252585,-0.6103914927469273,2.2735508446331867,3696,3667,Northeast North Dakota,Cavalier,38,19,North Dakota,ND
38035,38CS005,456,425,488,486,30,-2,61,66,-3.6936513478689315,-2.012229585463374,-0.27131488833667605,2.159359234138025,568,530,605,513,-55,-92,-17,37,-1.7424949380294656,-1.2440661251359453,-0.7459927182712475,-0.6905542393445535,72530,72757,Northeast North Dakota,Grand Forks,38,35,North Dakota,ND
38063,38CS005,47,47,47,52,5,5,5,11,-8.41938260843712,-8.00664906736279,-7.629330304302222,1.8210963346150588,59,58,59,41,-18,-18,-17,6,-7.948844413967047,-7.822123361290774,-7.691990341556213,-0.3565992542644971,2976,3045,Northeast North Dakota,Nelson,38,63,North Dakota,ND
38067,38CS005,67,67,68,77,10,9,10,10,-0.6528228516446665,-0.22243120258614527,0.1858172935247718,0.9422563411656563,82,82,83,79,-3,-4,-3,5,-1.3667828485753895,-1.2492177384489778,-1.1316853866575225,-2.0485856901245048,6810,6776,Northeast North Dakota,Pembina,38,67,North Dakota,ND
38091,38CS005,15,14,15,13,-2,-2,-1,5,-15.134797666164406,-14.741612169719133,-14.345101464269874,-7.365220997279223,18,18,18,25,7,7,7,1,3.173443110655831,3.2954204263107987,3.4242030624723423,0.12562405758047632,1813,1808,Northeast North Dakota,Steele,38,91,North Dakota,ND
38097,38CS005,81,80,81,87,6,6,7,14,-4.181074856714068,-3.7630092171172596,-3.3652432515529114,1.8725856167028025,99,98,100,90,-9,-10,-8,2,-1.5203059762907343,-1.3934927459708708,-1.2714501421563715,-0.2454864511057501,7986,7999,Northeast North Dakota,Traill,38,97,North Dakota,ND
38099,38CS005,121,120,122,128,7,6,8,22,-6.053006656872233,-5.662791032279547,-5.268874241890172,2.7219877762309808,148,146,149,112,-36,-37,-34,11,-4.595745770400518,-4.466990021533552,-4.351592671280178,-0.31603991789206887,10523,10476,Northeast North Dakota,Walsh,38,99,North Dakota,ND
38007,38CS006,8,8,8,4,-4,-4,-4,4,-34.40866861318446,-34.00481324775079,-33.59921187769944,-1.3605747647161832,10,10,10,3,-7,-7,-7,3,-10.492322158673838,-10.36753886516295,-10.247531262406074,-0.5112941491748497,934,952,Northwest North Dakota,Billings,38,7,North Dakota,ND
38013,38CS006,16,15,16,19,3,3,4,3,0.18370568474406274,0.6214695530004922,1.0447467375389219,0.6916410542140661,19,19,19,20,1,1,1,5,-1.970965233080982,-1.8486048689439898,-1.719234464386815,2.495120686726107,2177,2163,Northwest North Dakota,Burke,38,13,North Dakota,ND
38023,38CS006,22,22,23,18,-4,-5,-4,3,-13.989291634944882,-13.579466685122652,-13.19070604708936,-0.8609870264521523,27,27,28,28,1,0,1,4,-1.6109091610176172,-1.483054267731669,-1.3565025611055488,2.2827425169780633,2204,2189,Northwest North Dakota,Divide,38,23,North Dakota,ND
38025,38CS006,27,27,28,34,7,6,7,4,2.141273704229626,2.5102378607859768,2.9081218712620203,0.5259791633667731,33,32,33,38,5,5,6,5,-0.04610273010067443,0.07406185560965406,0.19605868558072345,0.7921891530627847,4141,4045,Northwest North Dakota,Dunn,38,25,North Dakota,ND
38033,38CS006,10,10,10,12,2,2,2,1,1.7663986996738195,2.1722826177007764,2.5612248402903885,0.33971163189483466,12,12,13,19,7,6,7,3,1.8675075381244721,2.0023273939508615,2.118261453309991,0.3984604756082775,1739,1764,Northwest North Dakota,Golden Valley,38,33,North Dakota,ND
38053,38CS006,66,65,68,90,24,22,25,11,3.060468295972082,3.4676638810418505,3.8621975725938364,0.4438594011896568,77,75,79,91,14,12,16,17,-0.34458456690107075,-0.2122495407933519,-0.08033302336310699,1.1322926366695705,14691,13954,Northwest North Dakota,McKenzie,38,53,North Dakota,ND
38061,38CS006,77,76,78,108,31,30,32,18,5.0616043213915605,5.442801227386456,5.8727130582296905,0.5546622827889881,91,90,92,89,-2,-3,-1,16,-2.0080902322379672,-1.888366602528945,-1.7649676262705793,-14.849838494016383,9854,9604,Northwest North Dakota,Mountrail,38,61,North Dakota,ND
38089,38CS006,213,199,228,258,45,30,59,45,-1.7537733435231326,-0.026447132982021605,1.6500651302799911,0.9857254939878282,259,242,277,245,-14,-32,3,28,-1.7557276533046688,-1.2699945472823886,-0.7292032077061026,-2.087051475869183,33387,33157,Northwest North Dakota,Stark,38,89,North Dakota,ND
38105,38CS006,224,207,242,193,-31,-49,-14,31,-7.78738003181959,-6.1787848636926705,-4.409951905283972,-1.0263827949177933,265,245,285,220,-45,-65,-25,30,-2.4617102820863295,-1.9438580905095435,-1.4194673149542185,-0.6768090184287233,40397,38873,Northwest North Dakota,Williams,38,105,North Dakota,ND
38015,38CS007,662,620,704,871,209,167,251,161,0.20980365811832496,1.9306992892025185,3.757497440022285,0.7661194482024689,825,774,876,841,16,-35,67,87,-1.2234072187552172,-0.7178459600342378,-0.20945252869149628,5.002047522780014,98129,98865,South Central North Dakota,Burleigh,38,15,North Dakota,ND
38029,38CS007,39,39,39,52,13,13,13,11,2.1562712988015833,2.5447847742966503,2.963665441075848,0.7809913762107981,48,47,48,42,-6,-6,-5,7,-4.003151759835218,-3.877604383193462,-3.751273359625367,-1.4910582797190268,3274,3273,South Central North Dakota,Emmons,38,29,North Dakota,ND
38043,38CS007,18,18,19,24,6,5,6,3,3.864478161653012,4.271733756001308,4.663034167723891,0.4576976393880564,22,22,23,33,11,10,11,6,1.7841244775054457,1.9064079327929184,2.0368026354497424,0.520566878317744,2397,2371,South Central North Dakota,Kidder,38,43,North Dakota,ND
38047,38CS007,22,22,22,25,3,3,3,4,-2.898992333076697,-2.495905473650548,-2.064330475154966,1.0434265229349964,27,27,27,25,-2,-2,-2,2,-2.3688203047618765,-2.244455439590611,-2.110704497569486,-1.6252581819529923,1880,1883,South Central North Dakota,Logan,38,47,North Dakota,ND
38051,38CS007,39,39,40,51,12,11,12,4,11.71991384267795,12.120418984173869,12.491531714582589,0.31770838815736224,48,48,49,40,-8,-9,-8,3,-4.64625903916654,-4.514321085209494,-4.386176112066312,-0.40811241700906487,2506,2513,South Central North Dakota,McIntosh,38,51,North Dakota,ND
38001,38CS008,28,27,29,24,-4,-5,-3,3,-14.253241889374735,-12.670383238878507,-10.979542260954322,-1.0276722792585131,34,33,35,38,4,3,5,2,0.502960419133214,1.0339499063770758,1.5379969938611346,0.38347797065747613,2192,2170,Southwest North Dakota,Adams,38,1,North Dakota,ND
38011,38CS008,28,28,29,41,13,12,13,6,8.556029119382789,8.985446318421651,9.374690299622022,0.43824333398149684,34,34,34,34,-0,-0,0,5,-1.8585938541719662,-1.7239925937926641,-1.5944445322760048,5.139956018253202,2981,2914,Southwest North Dakota,Bowman,38,11,North Dakota,ND
38037,38CS008,29,28,30,37,8,7,9,5,3.135573885282372,5.026633206034335,6.674087341616416,0.5653214636688838,36,35,37,44,8,7,9,4,1.1932316306361999,1.7078019468206915,2.22921503888567,0.4477273169760529,2284,2317,Southwest North Dakota,Grant,38,37,North Dakota,ND
38041,38CS008,24,24,24,38,14,14,14,8,8.907418165677111,9.310914063201551,9.723141797089628,0.542028706061925,29,29,30,23,-6,-7,-6,6,-5.190866605371963,-5.055533585228407,-4.915400741938787,-1.129268062499469,2476,2436,Southwest North Dakota,Hettinger,38,41,North Dakota,ND
38057,38CS008,66,65,67,60,-6,-7,-5,6,-6.278447142439432,-5.848372647806586,-5.449311640325949,-1.1580693998007487,82,81,83,87,5,4,6,10,-0.6819921931056545,-0.555793363512446,-0.4175851655629142,1.5690795618346458,8314,8324,Southwest North Dakota,Mercer,38,57,North Dakota,ND
38059,38CS008,280,265,294,326,46,32,61,61,-3.4758634580226233,-1.7554581628836772,-0.0819933599961039,1.2889872922239254,348,331,365,353,5,-12,22,32,-1.3108870789099967,-0.8014113835011516,-0.3313069011741089,5.449824949503093,33066,33570,Southwest North Dakota,Morton,38,59,North Dakota,ND
38065,38CS008,11,10,11,16,5,5,6,2,6.877893023753744,7.262494446384937,7.659299634467972,0.31169461475435856,13,13,13,13,-0,-0,0,5,-2.816971267054196,-2.701316934656184,-2.5697874569927297,5.30208463101195,1879,1872,Southwest North Dakota,Oliver,38,65,North Dakota,ND
38085,38CS008,33,32,33,53,20,20,21,3,17.031974681661225,17.439182398577195,17.8319953577783,0.1421091832002188,39,38,39,51,12,12,13,5,1.7906592154530536,1.9149043296428077,2.048429579734411,0.3787329048143053,3923,3759,Southwest North Dakota,Sioux,38,85,North Dakota,ND
38087,38CS008,9,9,9,4,-5,-5,-5,4,-52.41141361050317,-50.78436677789207,-49.11095235632562,-1.0045720690681408,11,10,11,2,-9,-9,-8,2,-16.084390357346006,-15.556384240839206,-15.068935632101274,-0.2574827943566884,708,692,Southwest North Dakota,Slope,38,87,North Dakota,ND
39001,39CS001,305,294,317,347,42,30,53,30,0.04219520654850509,1.7278864993663015,3.4239644163221814,0.70438276340024,375,360,389,515,140,126,155,95,1.1637751700779326,1.6532967499799305,2.1501835023769087,0.6723532358020083,27475,27526,Adams+Brown,Adams,39,1,Ohio,OH
39015,39CS001,457,438,475,544,87,69,106,30,3.544820655223866,5.264204019643245,6.981948141280852,0.3391817159228594,560,538,583,681,121,98,143,118,-0.44465245801039105,0.06981863327065085,0.6003246838852425,0.9678119947642083,43610,43657,Adams+Brown,Brown,39,15,Ohio,OH
39003,39CS002,969,925,1013,1178,209,165,253,172,-0.12708620201221116,1.4556254208878996,3.192263524783403,0.8176555808945828,1184,1132,1237,1359,175,122,227,215,-0.8971144982588853,-0.40516063197346863,0.12725336295780706,1.2232160461753114,102076,101727,Allen,Allen,39,3,Ohio,OH
39005,39CS003,489,467,512,570,81,58,103,69,-0.7819758700092662,0.9010414120872443,2.5593138083197693,0.8440271412494733,598,571,625,724,126,99,153,104,-0.049804730725751034,0.41418360368252144,0.9518325821574506,0.8196730503933205,52555,52331,Ashland,Ashland,39,5,Ohio,OH
39007,39CS004,1034,992,1076,1111,77,35,119,125,-3.5907119312182365,-2.011171582453351,-0.2519906121579523,1.6073226627050583,1265,1215,1316,1539,274,223,324,229,-0.03826760347720911,0.43962940186421134,0.9875178713427825,0.833686682925605,97358,97348,Ashtabula,Ashtabula,39,7,Ohio,OH
39009,39CS005,415,388,442,494,79,52,106,25,1.8371220748667227,3.3765138017977527,5.003851382679272,0.3136226634062952,514,482,546,648,134,102,166,77,0.4178692062950889,0.9113252718999866,1.4196470668041008,0.5685382394996877,62791,62099,Athens+Hocking,Athens,39,9,Ohio,OH
39073,39CS005,273,261,285,328,55,43,67,42,0.1462294941592836,1.9429594007108588,3.571123358116223,0.7448148334175895,336,322,351,434,98,83,112,68,0.5261439134097032,1.0527846688076574,1.5638603278870131,0.6894000426202282,28044,28083,Athens+Hocking,Hocking,39,73,Ohio,OH
39011,39CS006,416,396,436,541,125,105,145,66,3.4683904428500534,5.188747103896978,6.843801185687284,0.5236819563111931,507,483,531,609,102,78,126,86,-0.19753354621466687,0.35097529428217783,0.8584521052423191,0.8347384750329071,46266,46180,Auglaize+Mercer,Auglaize,39,11,Ohio,OH
39107,39CS006,355,337,373,456,101,83,119,75,0.8260006526500246,2.4415328620085286,4.027279836979819,0.736593231485799,434,413,456,459,25,3,46,37,-0.779454617259019,-0.30637950693246807,0.2641601557050924,1.4507287441864531,42277,42333,Auglaize+Mercer,Mercer,39,107,Ohio,OH
39013,39CS007,741,712,769,879,138,110,167,98,0.6270469715058484,2.4281519720050206,4.017756045128186,0.7045218911742493,901,867,935,1106,205,171,239,166,0.09404923466389391,0.582345141335018,1.097144706635975,0.805895539924219,66303,65905,Belmont,Belmont,39,13,Ohio,OH
39017,39CS008,3004,2837,3172,3648,644,476,811,399,0.7651684389256663,2.4846918332901224,4.235591251561462,0.619058523095549,3699,3498,3901,4219,520,318,721,547,-0.5783893149176572,-0.04991460856615474,0.45069942414179276,1.050243245395157,389541,390287,Butler,Butler,39,17,Ohio,OH
39019,39CS009,275,263,286,331,56,45,68,27,2.5957749388591407,4.400989068922511,6.181972094585704,0.4707250692116729,338,324,351,398,60,47,74,81,-1.272057059754014,-0.7689416141831971,-0.2483543915436269,1.3171610478997857,26732,26691,Carroll+Harrison+Tuscarawas,Carroll,39,19,Ohio,OH
39067,39CS009,169,163,175,198,29,23,35,17,1.4626755820905393,3.2458469692616605,4.954864320525133,0.5707375288192654,207,199,214,288,81,74,89,46,1.927206338196348,2.444203821480915,2.9296882873815417,0.5588854927912864,14573,14479,Carroll+Harrison+Tuscarawas,Harrison,39,67,Ohio,OH
39157,39CS009,949,909,989,1157,208,168,248,178,-0.5537326108693507,1.3302976222290805,2.975573069595741,0.8505800623347926,1163,1115,1211,1374,211,163,259,266,-1.1118721883274905,-0.6058099282009834,-0.11350904248120862,1.2556077537456067,92848,92582,Carroll+Harrison+Tuscarawas,Tuscarawas,39,157,Ohio,OH
39021,39CS010,350,334,367,432,82,65,98,36,3.07500952826892,4.72818344584738,6.448603196451477,0.43518080523946545,428,408,448,500,72,52,92,77,-0.6503209339416481,-0.13063047399139688,0.41258697486063256,1.0563034605076027,38737,38700,Champaign+Logan+Madison+Shelby,Champaign,39,21,Ohio,OH
39091,39CS010,440,420,459,473,33,14,53,43,-2.5245729295661246,-0.8039934786926615,0.8505661879680257,1.2472276749889755,537,513,561,624,87,63,111,98,-0.744897077100277,-0.24932608049728067,0.2562726248226664,1.1160798573254773,45993,46039,Champaign+Logan+Madison+Shelby,Logan,39,91,Ohio,OH
39097,39CS010,362,343,381,395,33,14,52,45,-2.867319055327668,-1.1187765655885358,0.7668682616783045,1.3256948102711807,447,424,470,557,110,87,133,68,0.453798114588398,0.9641475501726521,1.460811219783175,0.6116474871540852,44026,44304,Champaign+Logan+Madison+Shelby,Madison,39,97,Ohio,OH
39149,39CS010,396,375,416,518,122,102,143,54,3.91619190502332,5.672870890675965,7.464183770190124,0.4380567152572136,483,459,508,597,114,89,138,104,-0.3502340913939887,0.20856328416938538,0.6780122868297348,0.907694771921215,48173,47998,Champaign+Logan+Madison+Shelby,Shelby,39,149,Ohio,OH
39023,39CS011,1505,1447,1563,1775,270,212,328,209,-0.0037039030311174378,1.8166878339613253,3.55040028317925,0.7713925986230482,1836,1766,1906,2134,298,228,368,235,-0.060819165398881166,0.4813899208444306,0.9883784616513698,0.7853829852351385,135505,135646,Clark,Clark,39,23,Ohio,OH
39025,39CS012,1600,1510,1690,1865,265,175,355,147,0.5260639274247018,2.316430828081498,3.8710627299420253,0.5526399297886307,1977,1869,2086,2407,430,321,538,288,0.1433235534915348,0.6550830819506072,1.187558001351156,0.6689438025958769,208480,209495,Clermont,Clermont,39,25,Ohio,OH
39027,39CS013,388,370,406,475,87,69,105,45,2.2622047965058174,4.019245403322108,5.825636359494777,0.5098478149476766,475,454,497,574,99,77,120,85,-0.1905264195006023,0.3190127351999722,0.8234093546358536,0.8521663161692364,41972,41998,Clinton+Fayette+Highland,Clinton,39,27,Ohio,OH
39047,39CS013,321,309,333,336,15,3,27,31,-3.8723619514782537,-2.206615570464366,-0.5890765135488983,1.9433969961743491,392,377,407,440,48,33,63,65,-1.0701006293883355,-0.5954450918853181,-0.09640354733882206,1.3295476450896115,28870,28911,Clinton+Fayette+Highland,Fayette,39,47,Ohio,OH
39071,39CS013,431,413,450,486,55,36,73,41,-0.4351872450419564,1.274094204445283,2.991765081542005,0.7357526457947636,528,506,550,642,114,92,136,102,-0.24135379106705163,0.2680946602198317,0.7642897055522672,0.8869371133131997,43296,43349,Clinton+Fayette+Highland,Highland,39,71,Ohio,OH
39029,39CS014,1105,1061,1148,1284,179,136,223,161,-0.9800554491860781,0.694129319141655,2.4740516327083375,0.892413929877316,1348,1295,1400,1624,276,224,329,251,-0.2396243980833162,0.2517288491033049,0.7610584053450699,0.9049481631736389,101603,101353,Columbiana,Columbiana,39,29,Ohio,OH
39031,39CS015,360,345,376,426,66,50,81,37,1.392148740088588,3.152531769515702,4.849607628802185,0.5547416638579079,444,425,463,549,105,86,124,98,-0.3268936978996075,0.2207408885837423,0.7416579106566138,0.921522150584934,36555,36608,Coshocton+Holmes,Coshocton,39,31,Ohio,OH
39075,39CS015,295,276,314,372,77,58,96,75,-1.4704711563990527,0.1739777407348024,1.866507605579929,0.9651430739079252,368,345,391,418,50,27,73,77,-1.087418572256325,-0.6280842557002363,-0.052547731754345496,1.5051741758365997,44177,44260,Coshocton+Holmes,Holmes,39,75,Ohio,OH
39033,39CS016,488,470,506,584,96,78,114,75,0.47084217038542414,2.0185425184195074,3.8019339277083284,0.7727307027482756,596,574,617,722,126,105,148,100,0.10999677157661654,0.6265231513029565,1.1307678873782454,0.7852597556955854,41832,41779,Crawford+Richland,Crawford,39,33,Ohio,OH
39139,39CS016,1292,1238,1346,1455,163,109,217,141,-1.0870544959713149,0.7147313093227142,2.3515830990038076,0.8596827750296,1591,1526,1656,1785,194,129,259,281,-1.2158181069276546,-0.6966155483514558,-0.14905938670273938,1.4405238429286693,124373,125143,Crawford+Richland,Richland,39,139,Ohio,OH
39035,39CS017,11937,11396,12478,13820,1883,1342,2424,1496,-0.5493085355739628,1.217839270881595,2.9983193945483992,0.7939538684165174,14539,13893,15185,15948,1409,763,2055,1677,-0.7314973724813278,-0.21182013201824812,0.29570190307268246,1.1893293221412555,1256604,1251182,Cuyahoga,Cuyahoga,39,35,Ohio,OH
39037,39CS018,542,520,564,607,65,43,87,98,-4.236579973749144,-2.539862721218417,-0.7542872937337579,1.4850333977626193,663,637,690,727,64,37,90,106,-1.3379580615528177,-0.820353634407912,-0.31799481261918383,1.63701464183094,51750,51639,Darke+Preble,Darke,39,37,Ohio,OH
39135,39CS018,414,396,431,486,72,55,90,70,-1.5300898955295872,0.23126610033560244,2.0658157140712268,0.9564901868482153,507,486,529,631,124,102,145,92,0.26103140369324773,0.770583140433172,1.2873220379125667,0.7387509023918144,40937,40881,Darke+Preble,Preble,39,135,Ohio,OH
39039,39CS019,352,335,368,409,57,41,74,70,-3.0561913197340576,-1.2651134082111892,0.328790337125524,1.2023388827313148,432,412,452,486,54,34,74,65,-0.8362014345732767,-0.28106698868598634,0.21223583406338906,1.1834582360868893,38182,38156,Defiance+Williams,Defiance,39,39,Ohio,OH
39171,39CS019,368,353,384,368,-0,-16,15,51,-7.234885691661969,-5.635372862853299,-3.9085630447173316,90.64622147318832,450,431,469,517,67,48,86,87,-1.044150283172928,-0.5464033427055744,-0.0588132006679623,1.2739925242234407,36955,36761,Defiance+Williams,Williams,39,171,Ohio,OH
39041,39CS020,1050,957,1142,1241,191,99,284,89,0.17392298777474186,1.9357460350878335,3.633032033037111,0.46264480515120104,1339,1225,1452,1525,186,73,300,132,-0.27492778382274136,0.2539164971212379,0.7251465670571853,0.7044918720506472,214881,219912,Delaware,Delaware,39,41,Ohio,OH
39043,39CS021,827,795,859,1025,198,166,230,114,2.8243241847874616,4.499221376686078,6.138439977760839,0.5727080876650614,1006,967,1044,1136,130,92,169,111,-0.2644444612572693,0.2569002546049621,0.7790515378463805,0.844476561519782,75187,74936,Erie,Erie,39,43,Ohio,OH
39045,39CS022,1214,1146,1283,1439,225,156,293,136,0.5141742286950574,2.200482184792556,3.784869673836175,0.6026723710050891,1511,1428,1594,1816,305,222,388,221,0.017601117531575252,0.5141071124830033,1.0082116953068376,0.7230182291830934,159294,160815,Fairfield,Fairfield,39,45,Ohio,OH
39049,39CS023,8660,8091,9229,10063,1403,834,1972,1033,-0.5325621440552493,1.1461366183856008,2.6734824116155216,0.7355314335365379,10669,9987,11352,11848,1179,496,1861,1056,-0.3677845003585192,0.09626650205809255,0.6108555560842577,0.8950243540405827,1322977,1321793,Franklin,Franklin,39,49,Ohio,OH
39051,39CS024,378,360,396,450,72,54,90,47,0.7387205007466916,2.393274854665823,3.955996945897121,0.6423082682630852,463,441,485,545,82,60,104,103,-1.0259648769671523,-0.5073933781303519,0.015366825987465832,1.2425111169641254,42537,42475,Fulton+Henry,Fulton,39,51,Ohio,OH
39069,39CS024,255,244,267,315,60,48,71,50,-0.22979402769627905,1.410080829113751,3.1278817333240156,0.8260407750322737,313,299,328,370,57,42,71,45,-0.08471182043828408,0.41738270650334974,0.9157238416287523,0.7807874395731852,27519,27551,Fulton+Henry,Henry,39,69,Ohio,OH
39053,39CS025,324,311,336,381,57,45,70,30,1.874562781033455,3.7444988028077675,5.505258751585046,0.5132417196191524,395,380,410,438,43,28,58,63,-1.203985388203478,-0.6744255518974568,-0.2101092622900464,1.439434149919536,29285,29163,Gallia+Meigs,Gallia,39,53,Ohio,OH
39105,39CS025,251,242,261,299,48,38,57,22,2.9801892695668286,4.628579774782756,6.256073150973995,0.4525455155455622,306,295,318,379,73,61,84,49,0.5304148148523001,1.0671714404549382,1.59477484737258,0.6640356909453868,22220,22059,Gallia+Meigs,Meigs,39,105,Ohio,OH
39055,39CS026,732,691,773,887,155,114,196,118,-0.2798502430367973,1.5622903950951057,3.140097837550411,0.754869865959357,904,855,953,1094,190,141,239,109,0.32881294054923466,0.8709598928374537,1.371147561073832,0.5701677791985529,95090,95531,Geauga,Geauga,39,55,Ohio,OH
39057,39CS027,1320,1248,1393,1595,275,202,347,169,0.7643134501212128,2.5349636552922337,4.178768255406399,0.6131702077410369,1629,1542,1716,1912,283,196,370,255,-0.36888872826097485,0.17626999425896445,0.6863582626150083,0.896972301383537,168259,168356,Greene,Greene,39,57,Ohio,OH
39059,39CS028,407,391,424,458,51,34,67,38,-0.3761302854411796,1.2959715742769005,2.9464759109507153,0.7339932572482141,497,477,517,656,159,139,179,74,1.685245638866014,2.212521803824742,2.693565407423707,0.46282274859868267,38450,38302,Guernsey+Monroe+Noble,Guernsey,39,59,Ohio,OH
39111,39CS028,146,140,152,163,17,11,23,27,-4.523142100253777,-2.953043414785637,-1.2375577725490838,1.4873839628675276,178,171,185,235,57,50,64,37,1.00953616034596,1.5038502806739857,1.9975961289615332,0.6361339447502656,13403,13333,Guernsey+Monroe+Noble,Monroe,39,111,Ohio,OH
39121,39CS028,120,118,121,135,15,14,17,32,-5.096069310353864,-4.677713358703027,-4.297430693844792,1.9493807975161086,148,146,149,162,14,13,16,19,-0.44868826804950224,-0.31966899937889326,-0.19180345515905367,1.2283211009498116,14152,14163,Guernsey+Monroe+Noble,Noble,39,121,Ohio,OH
39061,39CS029,6946,6590,7302,7950,1004,648,1360,802,-0.8944870643997249,0.9577788139169736,2.6931953212551796,0.7981144233405778,8496,8069,8923,9021,525,98,952,928,-0.9838068318647516,-0.48760713412723006,-0.003619945620608626,1.76425953756254,827875,826689,Hamilton,Hamilton,39,61,Ohio,OH
39063,39CS030,663,631,695,766,103,71,135,96,-1.324549630339612,0.29960185611976387,2.039242413074784,0.9257240081746647,811,772,849,920,109,71,148,136,-0.8728715319790847,-0.369248760245412,0.16298883649610407,1.235492325430518,74937,74681,Hancock,Hancock,39,63,Ohio,OH
39065,39CS031,267,254,280,340,73,60,86,47,1.6200682107093796,3.342013499712963,5.018389730819212,0.6372834253421693,327,311,343,486,159,143,175,80,2.125413337314127,2.5657165467382215,3.0856713833814595,0.4992991478771075,30808,30636,Hardin+Wyandot,Hardin,39,65,Ohio,OH
39175,39CS031,218,209,227,274,56,47,65,34,2.3891815012395137,4.006247237381758,5.638528682110088,0.5953448076006924,266,254,277,304,38,27,50,49,-0.9778724115025192,-0.4755112375503187,0.022677369224362594,1.241655875170004,21830,21729,Hardin+Wyandot,Wyandot,39,175,Ohio,OH
39077,39CS032,527,502,553,652,125,99,150,79,1.4902758834554735,3.0961610439172595,4.753493603083758,0.6293206514503863,649,619,679,733,84,54,114,107,-0.9091548937524869,-0.3882264647106331,0.08878541226894827,1.2564480715391775,58407,58378,Huron,Huron,39,77,Ohio,OH
39079,39CS033,373,359,387,405,32,18,46,36,-2.0328881047820873,-0.4632155209741408,1.2539507117963116,1.0886781611128429,458,441,475,518,60,43,77,80,-1.146683291708797,-0.6123911888935285,-0.08794689388808903,1.309647751359286,32589,32530,Jackson+Pike+Vinton,Jackson,39,79,Ohio,OH
39131,39CS033,315,304,327,363,48,36,59,14,3.10029381499888,5.028004860411511,6.644081058016477,0.2866667526730563,387,373,401,481,94,80,108,74,0.19767449275104354,0.7436215363784998,1.2820910177587377,0.7805333569359445,27161,27083,Jackson+Pike+Vinton,Pike,39,131,Ohio,OH
39163,39CS033,137,132,143,163,26,20,31,10,3.1618883139626073,4.901187891794165,6.636634708899011,0.376118686115876,168,162,175,226,58,51,64,35,1.2664169142571702,1.7961224260460038,2.3027924367920494,0.59579070211623,12810,12709,Jackson+Pike+Vinton,Vinton,39,163,Ohio,OH
39081,39CS034,783,755,811,867,84,56,112,91,-2.0823901361327275,-0.5203135024335013,1.3206853110377994,1.0767791409951852,951,918,985,1173,222,188,255,170,0.31056680117628127,0.7991226180073098,1.297405278527977,0.7627886848406599,65130,64835,Jefferson,Jefferson,39,81,Ohio,OH
39083,39CS035,532,505,559,642,110,83,137,73,0.5699463477796517,2.2979880038399707,4.108878219570012,0.6599204330614277,650,618,683,816,166,133,198,125,0.08828291862416275,0.6409484243680801,1.177190425522612,0.7507284289884881,62702,62878,Knox+Morrow,Knox,39,83,Ohio,OH
39117,39CS035,276,261,291,320,44,29,59,26,0.19971156996508777,2.058864547199665,3.7276269855515842,0.578773370243681,338,320,356,416,78,60,96,58,0.07082906042674951,0.5733042214506949,1.132875866633937,0.7338362163313132,35039,35124,Knox+Morrow,Morrow,39,117,Ohio,OH
39085,39CS036,2183,2083,2283,2476,293,193,393,246,-0.8232491343031811,0.8649748924022657,2.403207685990555,0.8371630796350422,2675,2555,2795,3086,411,291,531,359,-0.30624287941793876,0.22839393552027196,0.7448872445301253,0.8712351153608393,231980,232079,Lake,Lake,39,85,Ohio,OH
39087,39CS037,703,678,728,814,111,86,136,59,1.8202091092588102,3.6277149440358545,5.4001074885429325,0.5250303878912673,851,821,880,1078,227,198,257,137,1.0369120115573816,1.5772199530995679,2.0750218235420665,0.6002063986517149,58268,57545,Lawrence,Lawrence,39,87,Ohio,OH
39089,39CS038,1477,1401,1554,1618,141,64,217,156,-2.026303849927416,-0.3169470633451545,1.2956746614316912,1.1023167314271056,1830,1737,1923,2178,348,255,441,247,0.047219289101346304,0.5596277592601626,1.098893501918122,0.7078330892496673,178640,180150,Licking,Licking,39,89,Ohio,OH
39093,39CS039,2763,2628,2898,3103,340,205,475,314,-1.4777847532039106,0.3282853700457128,2.03867728085485,0.9213732838053225,3412,3249,3575,4042,630,467,793,497,-0.12373013401983386,0.41417994057568125,0.9898217159238535,0.787919855925926,313123,315270,Lorain,Lorain,39,93,Ohio,OH
39095,39CS040,3935,3750,4120,4860,925,740,1110,591,1.4301104492504864,3.0711095195220937,4.831246277506426,0.6380327691936887,4823,4601,5045,5496,673,451,895,602,-0.3063442239731704,0.17097628279675647,0.6565193434446678,0.893161986075291,430300,429415,Lucas+Ottawa,Lucas,39,95,Ohio,OH
39123,39CS040,429,412,446,506,77,60,94,54,0.6812226828941981,2.3233843841150907,4.073321421288831,0.6909214159281016,523,503,544,626,103,82,123,72,0.23574616775427099,0.7578538633132573,1.2719910368979932,0.694446515146154,40283,40127,Lucas+Ottawa,Ottawa,39,123,Ohio,OH
39099,39CS041,2566,2468,2664,3285,719,621,817,476,2.532059397922534,4.288431433267629,5.89409721493772,0.6608418044690488,3118,3001,3235,3615,497,380,614,459,-0.3403888701877998,0.17578687268822668,0.7058606585001812,0.9222553177408318,227761,226935,Mahoning,Mahoning,39,99,Ohio,OH
39101,39CS042,665,637,693,709,44,16,72,111,-5.901353097935415,-4.069163602382265,-2.3312381389444576,2.455035757164446,814,780,847,934,120,87,154,120,-0.48839353325957274,-0.009573191244695967,0.4691137322999308,0.9891480547970579,65311,65302,Marion,Marion,39,101,Ohio,OH
39103,39CS043,1338,1259,1416,1593,255,177,334,182,-0.0967763997702209,1.5777523918444194,3.266442840655602,0.7107353712622484,1653,1559,1748,2003,350,255,444,245,0.0701752799234214,0.5669234376013759,1.091386014193188,0.6987304015688961,182252,183013,Medina,Medina,39,103,Ohio,OH
39109,39CS044,989,943,1036,1096,107,60,153,130,-2.618662891474248,-0.837428306660857,0.8573163157582789,1.2077915058912678,1219,1163,1275,1465,246,190,302,257,-0.6159565371668128,-0.09946747245804846,0.39759162886585964,1.0400302792918232,108601,109199,Miami,Miami,39,109,Ohio,OH
39113,39CS045,5413,5182,5643,6341,928,698,1159,692,0.13553506021711714,1.7971609556059553,3.4745472474097903,0.7445884659481343,6624,6347,6900,7357,733,457,1010,886,-0.8052747020359506,-0.28091428176359806,0.18904378698015284,1.2063376223969358,535892,535955,Montgomery,Montgomery,39,113,Ohio,OH
39115,39CS046,149,144,155,188,39,33,44,16,4.793662770610879,6.505742561042767,8.225224256898642,0.4047398851840676,182,175,189,267,85,78,92,36,3.0762628891590844,3.584718206028215,4.073713983985698,0.41753192761395214,13846,13691,Morgan+Perry,Morgan,39,115,Ohio,OH
39127,39CS046,312,296,327,372,60,45,76,36,0.8917907394037163,2.752380276632074,4.551398327245507,0.5862620987081046,383,365,402,491,108,89,126,66,0.6720388442118767,1.1704847330262762,1.697486648561476,0.6073710575493523,35542,35457,Morgan+Perry,Perry,39,127,Ohio,OH
39119,39CS047,865,828,902,983,118,81,155,84,-0.1374293414951938,1.6074399842554687,3.2626259670946918,0.7039031706887191,1059,1015,1104,1180,121,76,165,165,-1.0295257988254467,-0.5089186151133929,0.0063821753947148315,1.3544690300688556,86305,86398,Muskingum,Muskingum,39,119,Ohio,OH
39125,39CS048,182,173,190,204,22,14,31,28,-2.780657559199258,-1.2095731814962054,0.48465467746732405,1.1947392806175294,223,213,233,220,-3,-13,7,42,-2.892264733883858,-2.4028543746770135,-1.9059815895274255,-20.081118221351463,18792,18861,Paulding+Putnam+Van Wert,Paulding,39,125,Ohio,OH
39137,39CS048,272,257,287,350,78,63,93,81,-2.051709389540146,-0.3224880648023961,1.3345551328248286,1.023063034737909,334,317,352,381,47,29,64,56,-0.8167837528512392,-0.2677555649777615,0.20436381337792695,1.1774382677046895,34295,34327,Paulding+Putnam+Van Wert,Putnam,39,137,Ohio,OH
39161,39CS048,282,269,294,342,60,48,73,56,-1.2033922376859598,0.5319418680728274,2.2133151341993997,0.9147942790742897,344,330,359,402,58,43,72,66,-0.825691375875237,-0.2867233031864377,0.2505402864041521,1.1272344074860323,28768,28753,Paulding+Putnam+Van Wert,Van Wert,39,161,Ohio,OH
39129,39CS049,530,505,556,627,97,71,122,83,-0.7725872291897157,0.850434553020394,2.6808698344068245,0.8505077215416751,658,627,688,766,108,78,139,104,-0.43649130063241726,0.051132920879348495,0.5537265181464686,0.9498061135501298,58686,59230,Pickaway,Pickaway,39,129,Ohio,OH
39133,39CS050,1286,1217,1356,1453,167,97,236,125,-0.5443434190677678,1.0594908129923395,2.7602590420851176,0.7450609148523947,1584,1501,1668,1947,363,279,446,250,0.17210457519480551,0.6997488476894902,1.2154795428320122,0.6875360702313758,161933,162293,Portage,Portage,39,133,Ohio,OH
39141,39CS051,749,715,782,948,199,166,233,102,3.3083014751531494,5.078672280350685,6.8812858977161175,0.5087748046350874,916,877,956,1144,228,188,267,154,0.42512980243397136,0.9492017031600196,1.4759337881322805,0.6737146504209081,76921,76905,Ross,Ross,39,141,Ohio,OH
39143,39CS052,586,561,611,633,47,22,72,87,-4.467762258198644,-2.713512417255438,-0.9959663899104113,1.810764769492689,718,687,748,859,141,111,172,115,-0.10322706998360025,0.43166063139589667,0.9728154075512899,0.8084301361904653,58774,58732,Sandusky,Sandusky,39,143,Ohio,OH
39145,39CS053,876,845,908,1092,216,184,247,66,6.437835399800423,8.089306455842658,9.869860647019745,0.30475440978344476,1068,1030,1106,1313,245,207,283,142,0.894304177533799,1.405677464327054,1.9202426625335622,0.5775151809912558,73875,73401,Scioto,Scioto,39,145,Ohio,OH
39147,39CS054,521,498,545,609,88,64,111,76,-0.8472859801892737,0.8857650343315723,2.5509197551732536,0.8571509702623513,638,610,666,774,136,108,164,129,-0.37814275911798523,0.11984272472818108,0.6508603422863585,0.9407205182291651,55015,54918,Seneca,Seneca,39,147,Ohio,OH
39151,39CS055,3753,3593,3914,4484,731,570,891,643,-0.8390835130922076,0.8775759110371284,2.7155601346875184,0.878906408220355,4599,4406,4792,5401,802,609,995,796,-0.48016810880020927,0.026253383670205896,0.57089556684938,0.9908280527245915,373773,373910,Stark,Stark,39,151,Ohio,OH
39153,39CS056,5004,4772,5236,5794,790,558,1022,651,-0.6526319485963145,1.0512393100555832,2.6300662701826307,0.823231271040056,6112,5835,6390,7029,917,639,1194,805,-0.31950370688077273,0.2178689698344409,0.7397931407062356,0.8772973108451312,539520,537910,Summit,Summit,39,153,Ohio,OH
39155,39CS057,2225,2138,2311,2647,422,336,509,353,-0.3375649163362076,1.3176327104474757,3.0451931738207003,0.833767678228547,2721,2617,2825,3251,530,426,634,435,-0.048623572087018244,0.48360993192775353,0.9979406856612911,0.8188495731765615,200911,201345,Trumbull,Trumbull,39,155,Ohio,OH
39159,39CS058,377,350,404,412,35,8,62,27,-1.2773656746345252,0.5587198972422405,2.2230343667639474,0.7443651058982104,479,446,512,493,14,-19,47,56,-1.1920767576855797,-0.6439515007118705,-0.11640395539792,3.727914197631833,62688,64695,Union,Union,39,159,Ohio,OH
39165,39CS059,1615,1510,1719,1888,273,169,378,208,-0.6261545152043866,1.0898182227151265,2.9120790666467045,0.7588556098241953,2024,1897,2151,2348,324,197,451,291,-0.37521128181261476,0.12781379104921733,0.6619561262967557,0.8965582120454613,242294,246035,Warren,Warren,39,165,Ohio,OH
39167,39CS060,636,610,662,696,60,34,86,80,-3.0200518075772496,-1.30381003020692,0.4495720067109714,1.3085328871684345,774,743,804,875,101,71,132,88,-0.32839832051270873,0.22267369149522598,0.7932904398548496,0.8589787145788829,59652,59451,Washington,Washington,39,167,Ohio,OH
39169,39CS061,1009,959,1060,1153,144,93,194,156,-2.204980128962658,-0.3737338703224729,1.3254577488921546,1.0788913757735867,1242,1182,1303,1494,252,191,312,208,-0.14058620796116852,0.3733811312738169,0.9362587743514668,0.8235639920920116,116678,116729,Wayne,Wayne,39,169,Ohio,OH
39173,39CS062,1013,956,1070,1197,184,127,241,145,-0.6082704420620911,1.2280300535760114,2.8758762717544144,0.7836456062894998,1250,1181,1318,1361,111,43,180,152,-0.8299429741460171,-0.29993828948522305,0.21283631836967704,1.3516259959195414,132075,132434,Wood,Wood,39,173,Ohio,OH
40001,40CS001,191,182,199,241,50,42,59,28,2.803417037889327,4.425675634759601,6.099410025148787,0.5473412085480402,230,220,240,343,113,103,123,61,2.203518711249732,2.6745520718957394,3.2102412294330427,0.5354675555372539,19825,19414,Adair+Cherokee+Sequoyah,Adair,40,1,Oklahoma,OK
40021,40CS001,405,384,425,514,109,89,130,52,3.076508390357345,4.805825924488895,6.474012232757567,0.47144179165500316,498,473,522,632,134,110,159,72,0.801755123947974,1.3077349415679218,1.8515074844932247,0.5318593547686786,47391,47547,Adair+Cherokee+Sequoyah,Cherokee,40,21,Oklahoma,OK
40135,40CS001,420,403,437,560,140,123,157,54,6.928194700443127,8.582023447271624,10.374721003139344,0.3835126740375831,512,492,532,689,177,157,197,108,1.2239576638105365,1.7604531781180974,2.297637917033878,0.6063525080916475,39623,39471,Adair+Cherokee+Sequoyah,Sequoyah,40,135,Oklahoma,OK
40005,40CS002,150,144,156,180,30,24,36,20,1.0616026835518688,2.810369717612043,4.456434851995793,0.6495518144580972,185,177,192,195,10,3,18,33,-2.1202159649009515,-1.5751652652582298,-1.0736088744090788,2.88393264465405,14126,14302,Atoka+Bryan+Coal,Atoka,40,5,Oklahoma,OK
40013,40CS002,436,416,456,524,88,68,108,68,0.18995664346304403,1.7383444045749736,3.410315766908057,0.7601499990826547,536,511,560,713,177,153,202,110,0.9200068348119136,1.431548928788571,1.9235548873414796,0.6164783205532942,46640,46987,Atoka+Bryan+Coal,Bryan,40,13,Oklahoma,OK
40029,40CS002,70,70,71,93,23,22,23,10,9.183490359491937,9.56086870225852,9.987723974628992,0.4217527113455038,85,85,86,93,8,7,8,6,0.20530676200262435,0.3253184513580503,0.4591220624227387,0.6880469811919304,5313,5276,Atoka+Bryan+Coal,Coal,40,29,Oklahoma,OK
40009,40CS003,206,196,215,249,43,34,53,49,-2.7632172144186096,-1.0072930366535535,0.6304131877431052,1.1114738237323674,252,240,263,298,46,35,58,46,-0.5500040269625862,0.006524223734034739,0.5520009360129062,0.9762750491905126,22207,22083,Beckham+Custer+Roger Mills+Washita,Beckham,40,9,Oklahoma,OK
40039,40CS003,261,248,273,341,80,68,93,72,-0.5825414785801548,1.2093908210684596,2.8138358310323,0.8837752874447256,318,304,333,332,14,-1,28,55,-1.973968671238874,-1.4672286487056023,-0.9254395961107358,3.7362286077818747,28467,28201,Beckham+Custer+Roger Mills+Washita,Custer,40,39,Oklahoma,OK
40129,40CS003,30,30,30,47,17,17,17,11,6.561729185495868,6.949489536278055,7.372890808666794,0.6111587091485001,36,36,37,52,16,15,16,3,3.5894178472540594,3.72451293423446,3.8458339745942975,0.18045169783843162,3447,3392,Beckham+Custer+Roger Mills+Washita,Roger Mills,40,129,Oklahoma,OK
40149,40CS003,119,118,120,138,19,18,20,20,-0.7825587722472931,-0.376710292796749,0.024001871371392144,1.0017508117746685,146,145,148,162,16,14,17,27,-1.1629146593295303,-1.0401787755978886,-0.9141587874461476,1.6191500094816558,10910,10913,Beckham+Custer+Roger Mills+Washita,Washita,40,149,Oklahoma,OK
40015,40CS004,298,286,309,413,115,104,127,81,3.300239167753677,5.136882234448286,6.733943216206973,0.6957588700897808,358,344,371,437,79,66,93,73,-0.28269683075306434,0.21849948910702466,0.7611212572673796,0.9085520473733358,27109,26439,Caddo+Grady,Caddo,40,15,Oklahoma,OK
40051,40CS004,482,458,505,608,126,103,150,92,0.8259568617198824,2.51173986122621,4.098854049758625,0.7219496394583024,598,570,627,747,149,120,177,114,0.13495648203297972,0.6339141198135432,1.1388173597894995,0.7610559140131165,55018,55405,Caddo+Grady,Grady,40,51,Oklahoma,OK
40017,40CS005,984,917,1051,1086,102,35,169,157,-3.093244390440293,-1.5382765916852268,0.24613594882221895,1.5281354472194801,1257,1174,1340,1355,98,15,181,186,-1.0922862946379739,-0.5330736293703997,-0.006370221115122847,1.8751848564586613,155154,160828,Canadian,Canadian,40,17,Oklahoma,OK
40019,40CS006,482,461,503,590,108,87,129,51,3.0434713518558416,4.734178083778939,6.417719248768254,0.46782139677059104,587,562,612,814,227,202,252,153,1.0083917235184696,1.5349579936097644,2.080503559593465,0.6699671290861227,48080,48249,Carter+Johnston+Love+Marshall,Carter,40,19,Oklahoma,OK
40069,40CS006,121,117,126,125,4,-1,8,19,-7.420410605140197,-5.8205301854808695,-4.1077968588015805,3.9136097121120694,146,141,152,177,31,25,36,34,-0.7962953917653854,-0.33419549825835443,0.18217673886617838,1.0786214955665892,10352,10289,Carter+Johnston+Love+Marshall,Johnston,40,69,Oklahoma,OK
40085,40CS006,100,99,101,119,19,18,20,17,0.38892035988839885,0.7864379922824154,1.1698767804382098,0.8494920644370887,123,122,125,148,25,23,26,25,-0.15327161359662864,-0.018213006325895603,0.1134658018574739,0.9698493826704649,10156,10205,Carter+Johnston+Love+Marshall,Love,40,85,Oklahoma,OK
40095,40CS006,159,153,166,220,61,54,67,19,8.940260221438011,10.698207134711073,12.550312155836759,0.30784116264976336,194,186,202,267,73,65,81,34,1.9742715380371068,2.5290381863713933,3.0621841739662083,0.4573224867316289,15602,15557,Carter+Johnston+Love+Marshall,Marshall,40,95,Oklahoma,OK
40023,40CS007,170,164,176,232,62,56,68,22,9.456637693538907,11.163048923918756,12.895335858682712,0.3503491443291113,206,199,214,294,88,80,95,54,1.847727329591499,2.361290604216113,2.8656784996769074,0.6098154945078923,14273,14291,Choctaw+McCurtain+Pushmataha,Choctaw,40,23,Oklahoma,OK
40089,40CS007,325,312,338,476,151,138,164,84,6.9424820486912315,8.667731533792452,10.343873725419472,0.552066788625269,392,376,408,602,210,194,226,114,2.5824288200709176,3.0960436455582916,3.6305428981345593,0.540402482912023,31082,30870,Choctaw+McCurtain+Pushmataha,McCurtain,40,89,Oklahoma,OK
40127,40CS007,138,133,143,159,21,16,26,10,2.3776047003320615,4.106457831781973,5.80782521846671,0.4526844949780162,167,161,172,253,86,81,92,45,3.3442620235290716,3.838736624536392,4.378143870030391,0.5148449072899988,10833,10812,Choctaw+McCurtain+Pushmataha,Pushmataha,40,127,Oklahoma,OK
40027,40CS008,1824,1697,1951,2071,247,120,374,238,-1.6430140725732285,0.0748115376746183,1.7900254322708051,0.9609200915530732,2274,2121,2428,2565,291,137,444,309,-0.5980034222264226,-0.06149303660458322,0.4276644995625396,1.0600000513064123,294509,297367,Cleveland,Cleveland,40,27,Oklahoma,OK
40031,40CS009,883,831,935,1077,194,142,246,92,1.6964605233546475,3.378679907805666,5.241863940420741,0.471926572745635,1092,1029,1155,1424,332,269,395,224,0.3527216923861932,0.8828899903599065,1.3802240825489145,0.6719637640514645,121240,121927,Comanche,Comanche,40,31,Oklahoma,OK
40033,40CS010,62,61,62,84,22,22,23,13,6.162776684200528,6.554698323466661,6.926703226130878,0.5628886243863856,75,74,76,107,32,31,33,15,2.9663981506646375,3.0844465158057495,3.216199851509768,0.4552821231300389,5552,5489,Cotton+Jefferson+Stephens,Cotton,40,33,Oklahoma,OK
40067,40CS010,65,64,65,88,23,23,24,5,13.051764557292374,13.428206886299254,13.847047710816673,0.20615669522280491,79,78,80,97,18,17,19,12,0.9479647351943377,1.073018958976607,1.195867250948903,0.6373845175793309,5434,5422,Cotton+Jefferson+Stephens,Jefferson,40,67,Oklahoma,OK
40137,40CS010,484,465,502,541,57,39,76,56,-1.6178062179567931,0.10276907506078106,1.7337059735109466,0.9615300126624698,597,574,619,697,100,78,123,110,-0.7124000145035672,-0.22093321591248075,0.2955674963008228,1.0848804719808054,42866,43074,Cotton+Jefferson+Stephens,Stephens,40,137,Oklahoma,OK
40035,40CS011,172,166,178,196,24,18,30,19,-0.197733485397175,1.5191334599309785,3.228160255242183,0.7487574679975781,209,201,216,225,16,9,24,27,-1.2544068411768567,-0.7561876765903647,-0.26810291771134553,1.5522462753500061,14138,14120,Craig+Mayes,Craig,40,35,Oklahoma,OK
40097,40CS011,402,385,419,470,68,51,85,53,-0.06252970763561566,1.4668742686334262,3.259463603671279,0.7688136053894186,489,469,509,649,160,140,180,86,1.341221602743811,1.8778519593156116,2.4071186335426864,0.5350859679201154,39378,39145,Craig+Mayes,Mayes,40,97,Oklahoma,OK
40037,40CS012,733,703,764,801,68,37,98,100,-3.5300237235272243,-1.822896465077649,-0.039487611578196795,1.4578076098486918,898,861,935,1070,172,135,209,188,-0.7141948382901482,-0.2087099272141264,0.2987129528441264,1.0875612426524481,71742,71992,Creek,Creek,40,37,Oklahoma,OK
40041,40CS013,450,433,468,612,162,144,179,88,5.578477320033331,7.219873845464411,8.96708313119786,0.540008484107349,551,530,573,751,200,178,221,118,1.4909351386633982,1.9797373909109925,2.5002969480739177,0.5885105530375433,40843,40912,Delaware+Ottawa,Delaware,40,41,Oklahoma,OK
40115,40CS013,360,347,373,408,48,35,61,53,-2.370749370965735,-0.6605201587824403,1.0149547552418228,1.0776580572078578,438,423,454,566,128,112,143,74,1.2613276110506086,1.7874088702678133,2.2638650951992227,0.5752605112533653,30364,30321,Delaware+Ottawa,Ottawa,40,115,Oklahoma,OK
40047,40CS014,600,573,627,709,109,82,136,128,-3.0927144890844773,-1.2277119368353613,0.54739243828867,1.1644666265526809,730,698,762,861,131,99,163,92,0.13778791606922364,0.6420724083501705,1.13637274868582,0.6953907930181081,62367,62029,Garfield,Garfield,40,47,Oklahoma,OK
40049,40CS015,285,274,296,361,76,65,87,47,2.700256555150066,4.423217032390021,6.191069761019112,0.6112551118385412,349,336,362,452,103,90,116,72,0.6875239416371896,1.2103895096608772,1.685960985363507,0.6922078391262476,25946,25778,Garvin+McClain+Murray,Garvin,40,49,Oklahoma,OK
40087,40CS015,349,331,367,389,40,22,58,62,-3.9015976219132726,-2.0449367179700797,-0.38992581426855044,1.5063501941312474,444,422,466,437,-7,-29,15,51,-1.901404564492871,-1.3376244864275755,-0.8357303568024418,-8.387695819170663,41849,43278,Garvin+McClain+Murray,McClain,40,87,Oklahoma,OK
40099,40CS015,165,159,171,183,18,12,24,16,-1.1988272839218626,0.47663731956571964,2.1543610607856176,0.8576898605678095,201,193,208,242,41,34,49,42,-0.5494622155854473,-0.05758035027530088,0.49494940588192265,0.990178278815198,13884,13740,Garvin+McClain+Murray,Murray,40,99,Oklahoma,OK
40053,40CS016,50,50,51,66,16,15,16,5,9.725245983168415,10.139500965837815,10.549693527714544,0.30085953146791156,61,61,62,70,9,8,9,4,1.049185771352871,1.174749343937763,1.3058305007334472,0.4060333524573853,4187,4136,Grant+Kay,Grant,40,53,Oklahoma,OK
40071,40CS016,500,481,518,606,106,88,125,102,-1.334109035393354,0.43822300397937214,2.1398430552465135,0.9490954278300764,614,591,637,680,66,43,89,90,-1.0441436418612813,-0.5523000726265067,-0.05776119744372349,1.3420684353804362,43579,43704,Grant+Kay,Kay,40,71,Oklahoma,OK
40061,40CS017,137,132,142,152,15,10,20,13,-1.1860516527847922,0.5567171408773532,2.3279029271422695,0.8271810801956752,166,160,172,196,30,24,36,34,-0.9066187120856097,-0.3836176044408185,0.1892842457550868,1.110145460701344,11718,11594,Haskell+Latimer+Pittsburg,Haskell,40,61,Oklahoma,OK
40077,40CS017,116,115,117,100,-16,-17,-15,10,-11.390600991513892,-10.991937397835851,-10.589941956434862,-0.6574907391899146,140,139,142,167,27,25,28,27,-0.17452029766397256,-0.049499298862591794,0.07086569450782287,0.9811872334471468,9542,9432,Haskell+Latimer+Pittsburg,Latimer,40,77,Oklahoma,OK
40121,40CS017,509,490,528,586,77,58,96,52,0.5803818258222495,2.2623557751978156,3.930579536535664,0.6677121887113368,619,597,642,810,191,168,213,136,0.7653223945437321,1.2589992444523088,1.7816686019786125,0.7092127674985262,43709,43647,Haskell+Latimer+Pittsburg,Pittsburg,40,121,Oklahoma,OK
40063,40CS018,167,161,173,183,16,10,22,26,-4.713876949344118,-3.007888991183145,-1.333741777396488,1.5376781702693272,205,198,212,228,23,16,30,29,-1.0003023352567355,-0.4659386714733486,0.04778555947467241,1.2245758030461795,13328,13395,Hughes+Okfuskee+Pontotoc+Seminole,Hughes,40,63,Oklahoma,OK
40107,40CS018,153,149,158,174,21,16,25,28,-4.32129118601533,-2.643938849704583,-0.7613019573322055,1.2947218714032562,186,180,192,191,5,-1,11,30,-2.744785668532582,-2.2142821123223855,-1.713334291267402,4.8776126699069655,11338,11203,Hughes+Okfuskee+Pontotoc+Seminole,Okfuskee,40,107,Oklahoma,OK
40123,40CS018,376,360,393,429,53,36,69,43,-0.6454642393309672,1.0341100539480959,2.7540602454838936,0.7981532740370443,463,443,483,596,133,113,153,79,0.898666098429563,1.4042196569536551,1.898958306091027,0.58939228059131,38126,38150,Hughes+Okfuskee+Pontotoc+Seminole,Pontotoc,40,123,Oklahoma,OK
40133,40CS018,282,272,292,353,71,61,81,41,3.457709867412086,5.014064199950659,6.758243806427044,0.5713272140756869,345,333,357,427,82,70,94,62,0.3719364932003107,0.8323007152893612,1.3557384065604225,0.7487414675361184,23633,23558,Hughes+Okfuskee+Pontotoc+Seminole,Seminole,40,133,Oklahoma,OK
40079,40CS019,524,503,545,630,106,85,127,59,2.063526116601603,3.869160971147564,5.653401177333112,0.552540606670555,643,618,668,796,153,128,178,104,0.5176589071631718,1.0044470281586668,1.5680032293924746,0.6745675919241516,48411,48426,Le Flore,Le Flore,40,79,Oklahoma,OK
40081,40CS020,321,307,335,382,61,47,75,50,-0.2945760451601937,1.3203575780571446,3.067463975596006,0.8065073995216022,393,376,411,484,91,73,108,69,0.10917949442864391,0.625006883381829,1.1869589203218391,0.7532117456403898,33721,33776,Lincoln+Logan,Lincoln,40,81,Oklahoma,OK
40083,40CS020,343,322,365,366,23,1,44,31,-2.5627690261724934,-0.696244913377117,0.9869775570298749,1.3067889504672932,430,404,456,509,79,53,105,84,-0.6088371935473871,-0.1119614543045609,0.4016561300149107,1.0497879506428274,49607,50716,Lincoln+Logan,Logan,40,83,Oklahoma,OK
40091,40CS021,249,241,258,306,57,48,65,34,2.937402390555188,4.760794727647245,6.42604859660812,0.5898761660141436,308,298,318,416,108,98,118,67,1.6623799354791458,2.152780887274712,2.64102909143166,0.6130356855680931,19072,19201,McIntosh+Okmulgee,McIntosh,40,91,Oklahoma,OK
40111,40CS021,426,410,442,538,112,96,128,57,4.190581261065816,5.994700617783082,7.715969293809301,0.5048055448991285,522,503,541,668,146,127,165,103,0.6373016103794633,1.154896953849484,1.6932122504174134,0.7020581383808773,36950,36819,McIntosh+Okmulgee,Okmulgee,40,111,Oklahoma,OK
40003,40CS022,51,51,52,66,15,14,15,5,6.248934138121242,6.668426045481794,7.0810324763489545,0.32201706166154515,64,63,64,53,-11,-11,-10,2,-2.3464481352334747,-2.215345288347807,-2.096257415744592,-0.20703285527891238,5706,5710,Major and Nearby Counties,Alfalfa,40,3,Oklahoma,OK
40011,40CS022,104,103,105,135,31,30,32,17,5.9410306222398495,6.34320247639407,6.731356639842375,0.5320147720936601,125,124,126,162,37,36,38,21,1.7549417803030427,1.8783938195365228,2.013108088336122,0.5509643568103407,8804,8584,Major and Nearby Counties,Blaine,40,11,Oklahoma,OK
40043,40CS022,54,53,54,61,7,7,8,13,-5.293012874361538,-4.91517461211377,-4.497199846199585,1.5391162625829076,64,64,65,85,21,20,21,10,2.250646454116076,2.379618690464969,2.515224549334893,0.464688755868069,4524,4424,Major and Nearby Counties,Dewey,40,43,Oklahoma,OK
40073,40CS022,138,132,145,152,14,7,20,33,-6.721318781093656,-5.056144633227679,-3.2716728176205105,2.231174606244511,170,162,177,173,3,-4,11,19,-1.54863489587016,-1.0186491657779861,-0.4776266230926741,4.267662042111544,15266,15196,Major and Nearby Counties,Kingfisher,40,73,Oklahoma,OK
40093,40CS022,89,88,90,99,10,9,11,20,-5.569167868402417,-5.1650338252092025,-4.777426102588893,1.816034565696946,109,108,110,120,11,10,12,14,-0.5057751363029969,-0.3852290253951064,-0.2610555292348728,1.1631589301577336,7724,7680,Major and Nearby Counties,Major,40,93,Oklahoma,OK
40151,40CS022,84,84,85,93,9,8,9,3,2.1790907860699984,2.573553849153411,2.9607349292450746,0.3143585346406107,104,103,105,100,-4,-5,-3,21,-3.017422884718853,-2.896526433666986,-2.7759859789464536,-7.395628035531368,8616,8584,Major and Nearby Counties,Woods,40,151,Oklahoma,OK
40101,40CS023,751,723,780,896,145,116,173,108,0.5133506826783129,2.174006189056282,3.8970394989579167,0.740613306049962,912,878,947,1147,235,200,269,185,0.24998581051723237,0.7365272211938264,1.2515216180889732,0.7854512606861448,66441,66148,Muskogee,Muskogee,40,101,Oklahoma,OK
40103,40CS024,118,117,119,123,5,4,6,12,-2.9223433234218246,-2.519557977697565,-2.1134773930543935,1.9675745477604838,145,143,146,178,33,32,35,23,0.8369008495481097,0.9548047956303568,1.0906421112947462,0.6680774265244857,10943,10928,Noble+Osage+Pawnee,Noble,40,103,Oklahoma,OK
40113,40CS024,388,368,407,442,54,35,74,43,-0.7567791068543408,0.9532979985836395,2.6082620073139546,0.7772272328708676,477,453,500,615,138,115,162,99,0.3401483450559453,0.8503690079192887,1.365045698409389,0.7097671055719316,45919,45767,Noble+Osage+Pawnee,Osage,40,113,Oklahoma,OK
40117,40CS024,174,167,181,211,37,30,44,26,1.1094772891259526,2.8582743325868885,4.594918971919024,0.6821542340874795,214,206,222,258,44,36,52,31,0.34616097520567723,0.8351160165502441,1.342013047008921,0.685470026073594,15686,15712,Noble+Osage+Pawnee,Pawnee,40,117,Oklahoma,OK
40105,40CS025,106,105,107,120,14,13,15,14,-0.25310968540750584,0.13356088825746218,0.5200810055735678,0.9147856721171865,128,127,129,164,36,35,37,21,1.4988561923684371,1.627004560246895,1.7463657816924303,0.565865175791884,9417,9302,Nowata+Washington,Nowata,40,105,Oklahoma,OK
40147,40CS025,556,534,579,598,42,19,64,70,-3.8690055152462985,-2.189132745234517,-0.45083855608859547,1.6463464316091487,683,656,711,786,103,75,130,135,-1.1201340801507471,-0.6145469018088553,-0.11121958675350631,1.3040772263794256,52476,52746,Nowata+Washington,Washington,40,147,Oklahoma,OK
40109,40CS026,6263,5920,6606,7521,1258,915,1601,864,0.1345383561822353,1.9542066082617764,3.7412817790553397,0.6863651107157941,7705,7293,8117,8922,1217,805,1629,1058,-0.3418529240605335,0.19007831566208966,0.6980174433813666,0.8686092081820345,797468,798388,Oklahoma (county),Oklahoma (county),40,109,Oklahoma,OK
40007,40CS027,44,43,44,56,12,12,13,10,1.4891781551206098,1.8905454345735628,2.290520640557343,0.7469832717300404,52,52,53,63,11,10,11,8,0.38941578589451825,0.523784303162284,0.642849586054105,0.6904007364134497,5052,4985,Oklahoma Panhandle,Beaver,40,7,Oklahoma,OK
40025,40CS027,24,24,24,22,-2,-2,-2,0,-4.071424807362382,-3.6882225474450205,-3.2484482831407697,-0,29,29,29,31,2,2,2,4,-1.105755343968203,-0.9754537156709582,-0.848862367425725,1.4240413626748514,2265,2254,Oklahoma Panhandle,Cimarron,40,25,Oklahoma,OK
40045,40CS027,42,42,42,44,2,2,2,6,-4.727140917767463,-4.28513944949723,-3.8536943031208244,2.0238191552424425,51,51,52,50,-1,-2,-1,5,-1.7518050475107956,-1.6251309054942893,-1.5030791223545616,-42.66469944156037,3764,3760,Oklahoma Panhandle,Ellis,40,45,Oklahoma,OK
40059,40CS027,29,29,30,51,22,21,22,7,17.11773229533958,17.50112650489455,17.909554341216374,0.31109828792990746,35,34,35,38,3,3,4,7,-1.253892825837387,-1.130658032094048,-1.0026883594507532,1.591817648664575,3313,3191,Oklahoma Panhandle,Harper,40,59,Oklahoma,OK
40139,40CS027,157,154,159,159,2,0,5,38,-7.14367209683704,-6.749492645817586,-6.323942518427532,10.900608005250255,189,187,192,161,-28,-31,-26,25,-2.6746405328094194,-2.5415551037701736,-2.4233426985770814,-0.917700705387894,21084,20926,Oklahoma Panhandle,Texas,40,139,Oklahoma,OK
40153,40CS027,171,162,180,215,44,35,53,28,1.3815840296118702,3.22459297344764,4.8740240630929215,0.6218216515153486,209,199,219,251,42,32,52,34,-0.13164964867199158,0.3838780903691891,0.9421641673513408,0.7915666076953316,20330,20231,Oklahoma Panhandle,Woodward,40,153,Oklahoma,OK
40119,40CS028,512,477,547,568,56,21,91,55,-1.819587832503631,0.012658075930298503,1.803989304587161,0.970078763717491,638,595,680,764,126,84,169,82,0.05278561931791965,0.5319869619571167,1.0540294741935992,0.6438627959473382,81647,81931,Payne,Payne,40,119,Oklahoma,OK
40125,40CS029,732,701,764,850,118,86,149,80,0.4412680740013352,2.084986027472262,3.8561780829506165,0.6741365810833179,900,863,938,1139,239,201,276,146,0.7628193224033157,1.2832636990527821,1.832786185701076,0.6091269079492901,72539,72935,Pottawatomie,Pottawatomie,40,125,Oklahoma,OK
40131,40CS030,792,751,833,929,137,96,178,114,-0.8735574992133331,0.9196846504704961,2.6859983157156124,0.8273769108563572,983,933,1033,1122,139,89,189,167,-0.785622520154172,-0.2875395034149831,0.20522416832608517,1.1951273547824839,95065,96494,Rogers,Rogers,40,131,Oklahoma,OK
40055,40CS031,57,56,57,73,16,16,17,19,-2.5253751142595178,-2.1325981484262275,-1.725531361744807,1.1138097413628216,70,69,70,97,27,27,28,4,4.131809619956604,4.262041151736972,4.392077917207993,0.14085484873493267,5519,5487,Southwest Oklahoma,Greer,40,55,Oklahoma,OK
40057,40CS031,25,24,25,39,14,14,15,6,13.270126654708184,13.672913803708289,14.08119085139986,0.3872227317776702,29,29,30,45,16,15,16,7,3.4210410279791863,3.546633019586756,3.683091535029428,0.42154183180767313,2486,2425,Southwest Oklahoma,Harmon,40,57,Oklahoma,OK
40065,40CS031,220,210,231,281,61,50,71,55,-0.6220664113858256,0.9435742770736034,2.5880315538569327,0.8898655966298973,272,259,285,287,15,2,28,35,-1.3058633882204689,-0.8188182376930695,-0.29658345668077535,2.161850006505541,24692,24770,Southwest Oklahoma,Jackson,40,65,Oklahoma,OK
40075,40CS031,126,122,129,160,34,31,38,27,1.7076325800444903,3.4721739162295977,5.249523026298629,0.764694868912531,152,147,156,140,-12,-16,-7,20,-4.307461415162574,-3.772852613112422,-3.288613613644469,-1.8439984686512618,8514,8421,Southwest Oklahoma,Kiowa,40,75,Oklahoma,OK
40141,40CS031,77,76,77,106,29,29,30,18,5.987085308837013,6.39702300687891,6.75756330648857,0.5955761893137579,95,94,96,122,27,26,28,18,1.164221527841556,1.2766995980078215,1.4152890868517318,0.6415155187254667,7013,7058,Southwest Oklahoma,Tillman,40,141,Oklahoma,OK
40143,40CS032,5207,4919,5495,5987,780,492,1068,621,-0.6773405197556117,0.9268348939891947,2.681972064351128,0.7952145198591658,6434,6086,6781,7784,1350,1003,1698,1169,-0.29527432956064975,0.26534712732431087,0.7549049168273779,0.8650089554427173,667815,672464,Tulsa,Tulsa,40,143,Oklahoma,OK
40145,40CS033,556,521,592,648,92,56,127,64,-0.4443234154496553,1.312368505256515,3.003528559060808,0.6914507837457543,703,659,746,906,203,160,247,169,-0.11246167661268257,0.40062225941510277,0.9282308973533264,0.8266643081632035,81668,83660,Wagoner,Wagoner,40,145,Oklahoma,OK
41001,41CS001,188,180,195,206,18,11,26,1,2.4945701591242893,4.235123357661567,5.79326964287309,0.05149640307820783,231,222,240,274,43,34,52,31,0.1316068825167899,0.7103785475592281,1.2300286532848295,0.7063816284250153,16623,16824,Baker+Harney+Lake+Malheur,Baker,41,1,Oregon,OR
41025,41CS001,75,75,76,78,3,2,3,5,-1.7272772074008431,-1.3170786138238357,-0.9079270976887464,1.4197978285354251,94,93,94,124,30,30,31,30,-0.0653570700940642,0.06524219303180004,0.18954751392340496,0.9524940101787223,7483,7563,Baker+Harney+Lake+Malheur,Harney,41,25,Oregon,OR
41037,41CS001,87,86,88,98,11,10,12,4,3.198168054556865,3.5946968730971345,3.9968687180755103,0.3253226517072165,108,107,109,144,36,35,37,16,2.3120736981453565,2.4385853130599497,2.5559504199835548,0.43099089122276957,8132,8257,Baker+Harney+Lake+Malheur,Lake,41,37,Oregon,OR
41045,41CS001,269,255,282,326,57,44,71,42,0.260568865737969,1.9424235061470125,3.678639824794394,0.7182601553067948,331,314,347,392,61,45,78,46,-0.028697953052810827,0.4824429222811035,0.9941227619152616,0.7401896679360446,31484,31681,Baker+Harney+Lake+Malheur,Malheur,41,45,Oregon,OR
41003,41CS002,519,478,560,504,-15,-56,26,10,-2.708771478801515,-1.046597540666455,0.6491558994495985,-0.69975770433841,649,600,699,741,92,42,141,23,0.20009568247711432,0.7162198572448714,1.253915198680935,0.24788412519094788,94956,95893,Benton,Benton,41,3,Oregon,OR
41005,41CS003,2989,2807,3170,3188,199,18,381,116,-0.8698452728569103,0.7917783293162814,2.6226891044518417,0.5792140671402298,3680,3462,3898,4003,323,105,541,302,-0.42857943850982777,0.054138657188700624,0.5883925885143901,0.9317880651910804,421622,422482,Clackamas,Clackamas,41,5,Oregon,OR
41007,41CS004,350,333,368,348,-2,-20,15,5,-2.544122706104552,-0.7379194055037478,1.009313794780955,-3.508438251662984,433,412,455,542,109,87,130,29,1.3563050511875976,1.9115905540851448,2.4280095490065006,0.26463075994359303,41036,41705,Clatsop+Lincoln+Tillamook,Clatsop,41,7,Oregon,OR
41041,41CS004,538,517,560,592,54,32,75,14,1.4519228380405347,3.1278212342442195,4.970486303098744,0.25646499911023696,658,632,685,729,71,44,97,34,0.18302663588071819,0.7033829694983661,1.2279794155225663,0.47474978171401955,50462,50805,Clatsop+Lincoln+Tillamook,Lincoln,41,41,Oregon,OR
41057,41CS004,266,254,278,303,37,25,49,1,3.545534889485253,5.20763171116645,6.923479812392182,0.02647013121508492,327,312,341,412,85,71,100,42,1.0381655631957596,1.5682245238470591,2.055891819445009,0.48642678335819206,27450,27708,Clatsop+Lincoln+Tillamook,Tillamook,41,57,Oregon,OR
41009,41CS005,402,380,425,447,45,22,67,22,-0.11914615537008304,1.7126060985048894,3.3785975574937757,0.4824811277101745,497,469,524,630,133,106,161,58,0.9313704266400125,1.4063726752710906,1.9607502913459884,0.4319012668660517,52675,53009,Columbia+Washington,Columbia,41,9,Oregon,OR
41067,41CS005,2960,2701,3218,3194,234,-24,493,131,-1.0966821469541554,0.7334376832451434,2.3345266801116615,0.5566205771550012,3675,3365,3986,4150,475,164,785,243,-0.10066938353399452,0.3903618317832792,0.89471729426167,0.5109786012517712,600737,600793,Columbia+Washington,Washington,41,67,Oregon,OR
41011,41CS006,783,755,811,777,-6,-34,22,10,-2.6701343524598964,-1.0463058817534696,0.7989388987959439,-1.9672669135203842,953,919,986,1138,185,152,219,98,0.8268533273915705,1.33688023903081,1.8601493158676488,0.5263486683664769,64868,64983,Coos+Curry,Coos,41,11,Oregon,OR
41015,41CS006,336,326,346,393,57,47,67,5,7.263020662844879,8.945729949704269,10.731083595119935,0.08564656122953047,410,398,422,512,102,90,114,36,2.3235495864629443,2.788665659527521,3.312939078925291,0.3494796266946637,23446,23657,Coos+Curry,Curry,41,15,Oregon,OR
41017,41CS007,1368,1282,1454,1333,-35,-121,51,24,-2.9439292965838395,-1.1704013739719843,0.5558237268478632,-0.7152457381197287,1713,1608,1818,1820,107,2,212,167,-0.7723809240671032,-0.2938037825600266,0.19507374071912126,1.5463763069544114,199640,204007,Deschutes,Deschutes,41,17,Oregon,OR
41019,41CS008,1302,1254,1350,1421,119,71,167,35,1.349477475017707,3.0669218994876934,4.724659749170672,0.2917435933298847,1596,1539,1654,2052,456,398,513,244,1.362455661153849,1.887317958820227,2.3992101858574544,0.5344748855656712,111267,111870,Douglas,Douglas,41,19,Oregon,OR
41027,41CS009,166,155,176,156,-10,-20,1,12,-5.374425706757483,-3.6714739408517945,-1.915574389348412,-1.3871398862794446,204,192,217,200,-4,-17,8,17,-1.4035349832781334,-0.8673540684737272,-0.3551677862289971,-5.451151896924642,23868,24040,Hood River+Jefferson+Sherman+Wasco,Hood River,41,27,Oregon,OR
41031,41CS009,182,171,192,272,90,80,101,19,9.840196183565492,11.558764828151977,13.25262584038634,0.20857880819057512,226,213,239,327,101,88,114,37,2.0601536685952238,2.5366359558127614,3.054970806117661,0.3630842965042498,24594,24988,Hood River+Jefferson+Sherman+Wasco,Jefferson,41,31,Oregon,OR
41055,41CS009,17,16,17,16,-1,-1,0,2,-7.514386402851657,-5.822239918772246,-4.049133865819813,6.430800232722243,21,20,22,26,5,4,6,5,-0.34593624242517657,0.16543971909437008,0.6671851515140372,0.7944967161996958,1864,1902,Hood River+Jefferson+Sherman+Wasco,Sherman,41,55,Oregon,OR
41065,41CS009,278,266,289,295,17,6,29,27,-3.1135767972904276,-1.480983766538383,0.30851786057107145,1.4722059890274282,339,325,353,374,35,21,49,28,-0.25870594099722644,0.252914903915888,0.7519314048486089,0.7781074877660565,26611,26709,Hood River+Jefferson+Sherman+Wasco,Wasco,41,65,Oregon,OR
41029,41CS010,2084,1988,2180,2242,158,62,254,68,-0.026761582806730713,1.5806991348532957,3.3989091503813946,0.4272024820576492,2551,2435,2666,2925,374,259,490,292,-0.12485634409033089,0.3638751769093148,0.9087724506842012,0.7785092350434724,223053,223684,Jackson,Jackson,41,29,Oregon,OR
41033,41CS011,1068,1030,1106,1112,44,6,82,25,-0.8990768694999687,0.8206427991950833,2.5791895854146465,0.5586540014632234,1305,1259,1350,1583,278,233,324,224,0.10535198349429101,0.6045766242074513,1.1253467395448176,0.8022434813885864,88068,88311,Josephine,Josephine,41,33,Oregon,OR
41035,41CS012,719,689,748,779,60,31,90,25,0.4644552663332538,2.0294752066375343,3.8788157257090705,0.40698386038335443,887,851,924,1065,178,141,214,150,-0.13875568661769858,0.39349252674916846,0.9018611217155974,0.8399578617730056,69403,70068,Klamath,Klamath,41,35,Oregon,OR
41039,41CS013,3182,3017,3346,3372,190,26,355,76,-0.5064605929989247,1.14411924081494,2.9464118176765335,0.39754796827313926,3910,3712,4108,4522,612,414,810,233,0.44900426285160855,0.9992081882909792,1.4933143333505339,0.38016420813197715,382838,383153,Lane,Lane,41,39,Oregon,OR
41043,41CS014,1155,1099,1210,1247,92,37,148,35,0.06586705348762477,1.7928223702397084,3.497921779098607,0.3743361735327399,1420,1353,1487,1721,301,234,368,152,0.6382015605111051,1.1380586139780797,1.6512905885259812,0.5034518855816272,129127,129707,Linn,Linn,41,43,Oregon,OR
41047,41CS015,2445,2296,2594,2685,240,91,389,182,-0.9966881099747658,0.6813879497502785,2.2713063914034746,0.7552324800934862,3013,2834,3192,3456,443,264,622,304,-0.1413021192392159,0.41464663167801064,0.9020090507107026,0.6845380423390778,346495,346985,Marion,Marion,41,47,Oregon,OR
41051,41CS016,4978,4628,5328,5449,471,121,821,389,-1.2916250085024188,0.41356516914802033,2.0660860804347125,0.8236671774922589,6081,5665,6497,6883,802,386,1218,422,-0.023202745917253322,0.46393345749530673,0.9938622756875304,0.5254810705379731,814069,805199,Multnomah,Multnomah,41,51,Oregon,OR
41053,41CS017,631,593,668,669,38,1,76,25,-1.0658590521150053,0.6623131492755451,2.281437606252872,0.6333617108434386,786,740,832,842,56,10,102,68,-0.6597222684301913,-0.13099412391577733,0.3439427130712993,1.1961170161873622,87705,88974,Polk,Polk,41,53,Oregon,OR
41013,41CS018,245,234,256,211,-34,-45,-23,2,-7.521550694017779,-5.797784829584072,-4.021372833456253,-0.06069949660569293,308,295,321,321,13,0,26,46,-1.7991862216555579,-1.2585119814110426,-0.717456249002697,3.2309078413461907,24930,25620,Umatilla and Nearby Counties,Crook,41,13,Oregon,OR
41021,41CS018,18,18,18,14,-4,-4,-4,5,-18.401705396870312,-17.993933908350307,-17.590945350294092,-1.6702010444966298,22,22,22,37,15,15,15,5,4.855670037291671,4.981519706431523,5.100787200520299,0.31250965062154074,2000,2007,Umatilla and Nearby Counties,Gilliam,41,21,Oregon,OR
41023,41CS018,77,77,78,85,8,7,8,5,0.9969126394368817,1.4198359043054374,1.8249579140337027,0.5854208343547054,95,94,96,111,16,15,17,14,0.1586524112545411,0.285860142580963,0.4103650551046332,0.8205216152040943,7220,7265,Umatilla and Nearby Counties,Grant,41,23,Oregon,OR
41049,41CS018,77,75,78,96,19,18,21,11,2.381945609292234,2.7936068100080718,3.2097873918657087,0.5378541621873228,95,93,96,122,27,26,29,14,0.9580892033551185,1.0915720026285596,1.2066980560508762,0.49355802807764654,12118,12287,Umatilla and Nearby Counties,Morrow,41,49,Oregon,OR
41059,41CS018,593,559,627,709,116,82,150,60,0.9150345574601213,2.794722066460123,4.470222758789624,0.5133953877685848,733,692,775,885,152,110,193,101,0.1031937206444304,0.6441651533751819,1.18576275621991,0.6610248105379088,79678,79991,Umatilla and Nearby Counties,Umatilla,41,59,Oregon,OR
41061,41CS018,242,231,254,247,5,-7,16,5,-1.8051356125560578,-0.03664654477847998,1.6003777418919913,0.8751500424382584,297,284,311,373,76,62,89,49,0.46252860968481413,1.0193736617440272,1.5151538238015365,0.6380225320706883,26241,26203,Umatilla and Nearby Counties,Union,41,61,Oregon,OR
41063,41CS018,77,76,78,61,-16,-17,-15,3,-10.721662291558347,-10.325302700355241,-9.900304692976174,-0.19997100023372208,96,95,97,103,7,6,8,1,0.7037085552703128,0.8376894778340538,0.966454118950641,0.12059940817948235,7372,7522,Umatilla and Nearby Counties,Wallowa,41,63,Oregon,OR
41069,41CS018,16,15,16,17,1,1,2,6,-14.400831767177522,-12.668791521297836,-10.928642456451314,2.455126516219484,19,18,20,21,2,1,3,1,0.13311541228102053,0.6333850857960226,1.1523329092820858,0.3438357765741661,1440,1452,Umatilla and Nearby Counties,Wheeler,41,69,Oregon,OR
41071,41CS019,828,781,874,883,55,9,102,37,-1.0542594550200657,0.7205096446338494,2.4187127516457663,0.6566739450231287,1018,962,1074,1251,233,177,289,102,0.6961003257677765,1.197810505125948,1.6828976789490866,0.4361167028108466,107742,108180,Yamhill,Yamhill,41,71,Oregon,OR
42001,42CS001,907,862,952,996,89,44,134,81,-1.3555973936186265,0.31352352771531217,1.8978227948808262,0.9009349814495708,1114,1060,1168,1232,118,64,172,172,-1.013080720607833,-0.532323555481787,0.00424770574023599,1.447350733935822,103681,104079,Adams,Adams,42,1,Pennsylvania,PA
42003,42CS002,11874,11339,12410,12850,976,440,1511,1108,-2.0658568417877894,-0.4614312013461665,1.3237000294915287,1.1346311944718364,14463,13823,15103,15230,767,127,1407,1390,-1.0190054916321594,-0.5096689702821262,-0.00931704457744622,1.8108302377248193,1242797,1239640,Allegheny,Allegheny,42,3,Pennsylvania,PA
42005,42CS003,727,699,755,785,58,30,86,43,-0.8284430926894726,0.8956446172472893,2.658136382008661,0.733315433038038,885,851,919,1096,211,177,245,185,-0.10200915801431594,0.3953586536496603,0.9514204816773869,0.8727203572378229,65300,65144,Armstrong,Armstrong,42,5,Pennsylvania,PA
42007,42CS004,1872,1800,1944,2109,237,165,309,243,-1.8662149751290862,-0.16479596347269262,1.5887475359450642,1.020719316149537,2279,2193,2366,2431,152,65,238,310,-1.4799199265477427,-0.946370352522904,-0.4380087180555509,2.0324744499394556,167066,166786,Beaver,Beaver,42,7,Pennsylvania,PA
42009,42CS005,479,459,500,635,156,135,176,98,3.060539747416384,4.915415271241928,6.445183785236326,0.6260374157649443,582,558,607,709,127,102,151,138,-0.7580053745771389,-0.2280756518278038,0.31524433078165354,1.0797059909239866,47573,47470,Bedford+Fulton,Bedford,42,9,Pennsylvania,PA
42057,42CS005,146,139,152,146,0,-6,7,13,-5.119017350823352,-3.4567834428621746,-1.808855082892505,9.991453058646645,177,170,185,237,60,52,67,44,0.5835282612978296,1.1082874212400664,1.6191107951535364,0.7218069663741712,14539,14527,Bedford+Fulton,Fulton,42,57,Pennsylvania,PA
42011,42CS006,3470,3286,3654,3927,457,273,641,575,-2.7472568262006316,-1.1079027183175287,0.47215899586594484,1.2561249476433742,4268,4046,4489,4822,554,333,776,678,-0.8086640647627358,-0.2665784820997966,0.21977889939340683,1.2210548974730426,427548,429248,Berks,Berks,42,11,Pennsylvania,PA
42013,42CS007,1353,1300,1406,1613,260,207,313,193,0.35735071126038376,2.1557808584954876,3.8029768250039346,0.7396430927484009,1643,1580,1706,1855,212,149,275,302,-1.250479749471087,-0.76227683962394,-0.23106566362508899,1.4198908824915064,122356,121877,Blair,Blair,42,13,Pennsylvania,PA
42015,42CS008,587,562,613,592,5,-21,30,57,-5.026610289974099,-3.5366030763809446,-1.8064619962924067,10.107984432953327,720,689,751,837,117,86,148,106,-0.3812817026165589,0.19667506825188066,0.676344842063085,0.8966014801442905,59945,59887,Bradford+Sullivan,Bradford,42,15,Pennsylvania,PA
42113,42CS008,80,79,80,88,8,8,9,3,3.2763288017779235,3.6959917323110703,4.105559415751359,0.31884889181606135,98,97,98,131,33,33,34,23,1.643168000278013,1.7780239712300991,1.9042299037815658,0.6685181044561707,5859,5864,Bradford+Sullivan,Sullivan,42,113,Pennsylvania,PA
42017,42CS009,5337,5060,5614,6046,709,432,986,875,-2.7079621897262167,-1.0737288663931082,0.5447885768824562,1.232536458862604,6569,6235,6902,6903,334,1,668,589,-0.9365897214880131,-0.38733908886285034,0.14541202097400133,1.7560747018022902,643464,646085,Bucks,Bucks,42,17,Pennsylvania,PA
42019,42CS010,1774,1691,1857,1973,199,116,282,226,-2.260673036616957,-0.5394182888373232,1.055420179537812,1.1294114193621418,2184,2084,2284,2417,233,133,333,332,-0.9855590599190482,-0.5129778243645698,0.01408685128573903,1.417625130334012,193087,194211,Butler,Butler,42,19,Pennsylvania,PA
42021,42CS011,1594,1537,1651,1844,250,193,307,280,-2.6913909849194844,-0.926396861213608,0.8212887227593739,1.1152365681529024,1938,1869,2006,2069,131,63,200,297,-1.7567312841039997,-1.2453990419262237,-0.7115975545061506,2.244930741261492,132459,132282,Cambria,Cambria,42,21,Pennsylvania,PA
42025,42CS012,685,657,712,827,142,115,170,93,1.2689943193357132,3.0235298029567113,4.782934976451769,0.6485557315850509,839,805,873,995,156,122,190,143,-0.2964308177333853,0.21105574504397887,0.7481960488980294,0.9109277930652707,64729,65316,Carbon,Carbon,42,25,Pennsylvania,PA
42027,42CS013,826,758,894,1047,221,153,289,141,0.23307453210043766,2.0410705877891755,3.72146471469006,0.6343042997205273,1021,940,1102,1217,196,115,277,127,-0.0640235882930215,0.4357480249961709,0.9439308999861663,0.6444730203655114,158495,157586,Centre,Centre,42,27,Pennsylvania,PA
42029,42CS014,3516,3286,3745,3919,403,174,633,555,-2.8571658737625683,-1.158392891653127,0.5545776569810693,1.3727624775913896,4368,4090,4645,4398,30,-247,308,351,-1.0984280934418411,-0.5892517399493623,-0.09903802385307568,11.193578711511687,533664,538065,Chester,Chester,42,29,Pennsylvania,PA
42031,42CS015,341,325,357,451,110,94,126,48,4.88399141299467,6.611575425081111,8.323390416196228,0.43300904320078765,416,397,436,596,180,160,199,116,1.2131047447471444,1.7182745867103972,2.2027509583538176,0.6421462166445976,37368,37159,Clarion+Jefferson,Clarion,42,31,Pennsylvania,PA
42065,42CS015,475,456,494,526,51,32,70,58,-2.310894564131715,-0.5836492046442067,1.0136638283586055,1.1138753401629,578,555,601,635,57,34,80,123,-2.0033701988447703,-1.5019818431156662,-1.0007142080823725,2.127354753085896,44233,44160,Clarion+Jefferson,Jefferson,42,65,Pennsylvania,PA
42033,42CS016,826,792,861,878,52,17,86,54,-1.7266105870189894,-0.15350871379025743,1.645136257373862,1.0192414304234327,1011,969,1052,1195,184,143,226,206,-0.7943631329489613,-0.27012957972337476,0.23607090042401435,1.1106325037284452,80185,80128,Clearfield,Clearfield,42,33,Pennsylvania,PA
42035,42CS017,346,330,362,371,25,9,41,29,-2.0140967884872087,-0.46632863418331827,1.2072237590281019,1.126866766103547,426,407,445,481,55,36,74,74,-0.9981320779090697,-0.5267982585269223,0.023354810724469703,1.3200355079333468,37501,37448,Clinton+Potter+Tioga,Clinton,42,35,Pennsylvania,PA
42105,42CS017,181,174,188,188,7,0,14,15,-3.598518428252475,-1.8808123787550577,-0.2157560545644003,1.7924573042917729,220,212,229,297,77,68,85,63,0.3756747373541693,0.8463592819250171,1.3403965313864485,0.8091276938270106,16373,16273,Clinton+Potter+Tioga,Potter,42,105,Pennsylvania,PA
42117,42CS017,396,379,414,463,67,49,84,79,-2.8728434243609846,-1.1639152996579292,0.5197606195551375,1.1644425441797843,487,466,508,596,109,88,130,103,-0.33399940991970917,0.14429984864558174,0.6669696954775134,0.9340531995014728,40920,40935,Clinton+Potter+Tioga,Tioga,42,117,Pennsylvania,PA
42037,42CS018,592,564,620,659,67,39,95,83,-2.6451512057820437,-0.9870892291860631,0.6187082937768907,1.2228716817339687,727,693,760,866,139,106,173,113,-0.11055566240524828,0.39345875400087654,0.8868168062034373,0.8050602090003142,64740,64842,Columbia,Columbia,42,37,Pennsylvania,PA
42039,42CS019,836,800,872,921,85,49,121,90,-1.922540079625473,-0.2515520793362272,1.5142847440629954,1.0478569518200638,1018,975,1061,1215,197,154,240,153,0.006935055321325538,0.5198542184777302,1.000421818131607,0.7735525837731141,83786,83405,Crawford,Crawford,42,39,Pennsylvania,PA
42041,42CS020,2098,1986,2209,2361,263,152,375,321,-2.6272284956427283,-0.8804268583113232,0.7866955513985735,1.2141972357049524,2593,2458,2729,2784,191,55,326,365,-1.1437780529250157,-0.6585662974260105,-0.10953264659755525,1.9018480038647325,259300,262493,Cumberland+Perry,Cumberland,42,41,Pennsylvania,PA
42099,42CS020,386,367,406,450,64,44,83,42,0.11155122644857177,1.8794444671237205,3.562955032301255,0.6505817866199672,473,449,497,580,107,83,131,102,-0.3792259386957978,0.12582152286620055,0.6291849091449238,0.9463965941277754,45912,45962,Cumberland+Perry,Perry,42,99,Pennsylvania,PA
42043,42CS021,2247,2124,2370,2589,342,219,465,329,-1.6533853372749638,0.13537341137751802,1.89477174544254,0.9598027078837369,2770,2622,2919,3169,399,250,547,386,-0.4821722533662392,0.051729586104608184,0.5367017720783774,0.965791309154832,285449,287275,Dauphin,Dauphin,42,43,Pennsylvania,PA
42045,42CS022,4758,4511,5006,5578,820,572,1067,979,-2.808533486700495,-1.0952832389539733,0.5582517109001782,1.1930505414063628,5828,5531,6124,5904,76,-220,373,544,-1.3127770033416624,-0.809979744680378,-0.2613135138464317,7.028159620821967,574682,574219,Delaware,Delaware,42,45,Pennsylvania,PA
42049,42CS023,2451,2335,2567,2777,326,210,442,259,-0.6364894903771737,0.97186968039094,2.7510795039500517,0.7919828092182707,2994,2855,3133,3384,390,251,529,358,-0.40110441811982206,0.12414025099043084,0.6764006171584236,0.9167164798298583,270149,269218,Erie,Erie,42,49,Pennsylvania,PA
42051,42CS024,1507,1452,1562,1679,172,117,227,164,-1.4906378780370761,0.2954261836947158,1.8889748451345403,0.9471351566172691,1821,1756,1887,2251,430,364,495,378,-0.10686107169659247,0.40116301806255106,0.9061530745476697,0.8776102674630958,128391,127144,Fayette+Greene,Fayette,42,51,Pennsylvania,PA
42059,42CS024,375,359,390,401,26,11,42,34,-2.5375445324191785,-0.8187433753197152,0.8297705604933088,1.240460770454775,453,435,472,538,85,66,103,68,-0.018309863811481683,0.4726335944933669,0.9783501636599181,0.7939417750070478,35803,35434,Fayette+Greene,Greene,42,59,Pennsylvania,PA
42055,42CS025,1363,1296,1430,1699,336,269,403,235,0.9238975802334247,2.603007071050369,4.251119371261342,0.6964710457281243,1673,1592,1754,2035,362,281,443,289,-0.035734640907568276,0.4566655503208773,0.9476158010415494,0.7958301599680941,155866,156228,Franklin,Franklin,42,55,Pennsylvania,PA
42061,42CS026,395,376,414,489,94,75,113,75,-0.013637975008933427,1.695382549006489,3.4841294665695632,0.7919974871055321,482,459,504,567,85,63,108,101,-0.8573330882369985,-0.348992512621465,0.17150999188201146,1.1682688964131263,44141,43910,Huntingdon+Juniata+Mifflin,Huntingdon,42,61,Pennsylvania,PA
42067,42CS026,208,198,218,295,87,77,97,64,2.233107350330132,3.9412625504480143,5.663392388806145,0.725593774586257,252,240,264,355,103,91,115,73,0.8169308063935364,1.297117013631006,1.850340273560757,0.7006633003494118,23626,23319,Huntingdon+Juniata+Mifflin,Juniata,42,67,Pennsylvania,PA
42087,42CS026,474,454,494,614,140,120,160,126,-0.44713603954355113,1.2671159161821985,2.901848820042778,0.8940412342016664,579,555,603,656,77,53,101,105,-1.1193679931727731,-0.5884066739331503,-0.12199140463423873,1.3453532368730179,46082,46127,Huntingdon+Juniata+Mifflin,Mifflin,42,87,Pennsylvania,PA
42063,42CS027,761,725,797,935,174,138,210,116,0.9686299106443346,2.692271773744466,4.528320970682339,0.6620548518049039,929,886,972,1115,186,143,229,159,-0.17152048814255005,0.32188161233701595,0.8408815891892372,0.8498393570230988,83224,82920,Indiana,Indiana,42,63,Pennsylvania,PA
42069,42CS028,2323,2231,2415,2524,201,109,293,267,-2.859408834489806,-1.2110666659496123,0.43663412059452095,1.3218161795091434,2853,2741,2964,2904,51,-60,163,315,-1.7341298011631843,-1.212220551524206,-0.7260986714569124,6.009732012932004,214699,215642,Lackawanna+Wyoming,Lackawanna,42,69,Pennsylvania,PA
42131,42CS028,269,258,280,278,9,-2,20,30,-5.046666790536427,-3.197981776888658,-1.6228409457785211,3.008907307727633,329,316,343,393,64,50,77,54,-0.11587498597675013,0.3582158474306617,0.9015796262112444,0.8335305529035186,26120,26029,Lackawanna+Wyoming,Wyoming,42,131,Pennsylvania,PA
42071,42CS029,4410,4172,4647,5188,778,541,1016,748,-1.4015287025817877,0.24333945342068194,1.873312975969125,0.9595897850139045,5424,5138,5710,5905,481,195,767,739,-0.9869530391734772,-0.4706023700665492,0.049662311630898716,1.5328206579948531,551663,553498,Lancaster,Lancaster,42,71,Pennsylvania,PA
42073,42CS030,994,957,1031,1217,223,186,260,140,2.172739940476685,3.8812940973498753,5.583922427594473,0.6244793991934439,1210,1166,1254,1371,161,117,205,196,-0.9345708918055547,-0.3872958723402008,0.09764997909326717,1.2082548485855518,85774,85551,Lawrence,Lawrence,42,73,Pennsylvania,PA
42075,42CS031,1321,1260,1383,1523,202,140,263,156,-0.3577294066118973,1.274644247662315,3.14800460580033,0.7696646813609601,1622,1548,1696,1872,250,176,324,226,-0.3774069432604559,0.15324408458857444,0.6687850639375484,0.9005834368984026,142988,143456,Lebanon,Lebanon,42,75,Pennsylvania,PA
42077,42CS032,2961,2800,3122,3397,436,275,597,518,-2.743790094124594,-0.8610494094099879,0.9767257760083616,1.1846567447405882,3646,3452,3840,3968,322,128,516,472,-0.9087853851134668,-0.3928139465189845,0.10432961511983238,1.4621266158188195,373854,375388,Lehigh,Lehigh,42,77,Pennsylvania,PA
42079,42CS033,3543,3404,3683,3970,427,287,566,463,-2.113560563780049,-0.4794110346990207,1.2614398695533413,1.0830296148934653,4351,4183,4519,4572,221,53,389,534,-1.4694553897599694,-0.9675477004090366,-0.4463559107172292,2.4062471551657287,324050,325908,Luzerne,Luzerne,42,79,Pennsylvania,PA
42081,42CS034,1096,1047,1145,1268,172,123,221,130,-0.25316375352668835,1.424706313015124,3.2361092634078577,0.7514355722706914,1341,1282,1399,1547,206,148,265,261,-1.0123301241969604,-0.4703153226745208,0.011126363321993534,1.2592034625421196,113883,113660,Lycoming,Lycoming,42,81,Pennsylvania,PA
42023,42CS035,53,52,53,57,4,4,5,5,-1.1041205648754946,-0.6934656417496667,-0.2601812112595261,0.9561831766841881,64,64,65,75,11,10,11,3,1.5931654883535882,1.7176366820737146,1.834993626477646,0.2566965723659392,4499,4468,McKean and Nearby Counties,Cameron,42,23,Pennsylvania,PA
42047,42CS035,334,321,347,317,-17,-30,-4,21,-6.625201831535966,-4.840623465907122,-3.088131559941744,-1.3182208397155928,408,392,424,467,59,43,75,57,-0.42565305258736674,0.06180020896621356,0.555566755773615,0.9485727621348132,30761,30804,McKean and Nearby Counties,Elk,42,47,Pennsylvania,PA
42053,42CS035,71,70,72,87,16,15,17,4,6.529284955889983,6.917502702164838,7.359292475764031,0.23392789419944227,88,87,89,108,20,19,21,21,-0.22479480231773655,-0.10581471330502798,0.023136275605106477,0.9877753039239517,6972,7020,McKean and Nearby Counties,Forest,42,53,Pennsylvania,PA
42083,42CS035,435,418,452,444,9,-8,26,26,-3.3815136647057735,-1.7012711568987056,-0.05264173297699472,2.5576234936773345,528,507,548,630,102,82,123,97,-0.36459416034379,0.13920281728828737,0.6530213667633137,0.9384660185462904,40315,39994,McKean and Nearby Counties,McKean,42,83,Pennsylvania,PA
42123,42CS035,414,398,431,501,87,70,103,40,3.1583237270129008,4.827920958397798,6.558260665539648,0.4568642256559655,503,483,522,681,178,159,198,90,1.7776502254164135,2.30803316621653,2.837622898747435,0.5014599528040332,38545,38184,McKean and Nearby Counties,Warren,42,123,Pennsylvania,PA
42085,42CS036,1251,1204,1298,1446,195,148,242,170,-0.7847677198148771,0.9301237198825005,2.6683887460862237,0.8669414957491943,1526,1470,1583,1833,307,250,363,244,0.04951158105572508,0.5610374931056752,1.11682186817078,0.7930456872929464,110144,110025,Mercer,Mercer,42,85,Pennsylvania,PA
42089,42CS037,1281,1209,1354,1540,259,186,331,213,-0.5842718222831008,1.0566623471481764,2.8932820919993985,0.8193681182329188,1579,1492,1667,1808,229,141,316,202,-0.3794616846606225,0.1600658460051445,0.6680084316451655,0.8797208526817164,168622,169124,Monroe,Monroe,42,89,Pennsylvania,PA
42091,42CS038,6737,6369,7105,7627,890,522,1258,1168,-2.970003288520423,-1.307427095813002,0.41052677792835796,1.3109896146923483,8327,7883,8771,8365,38,-406,482,715,-1.3240504396134172,-0.8008055393173936,-0.2647617997368316,18.50040830765215,853453,860048,Montgomery,Montgomery,42,91,Pennsylvania,PA
42093,42CS039,197,189,205,217,20,12,28,28,-3.4881075375552517,-1.7438683941155444,-0.20980966672721885,1.3220550061199168,240,231,249,253,13,4,22,48,-2.42508264459773,-1.967024683773383,-1.4026300550453943,3.4503715718961074,18122,18091,Montour+Northumberland,Montour,42,93,Pennsylvania,PA
42097,42CS039,996,957,1035,1265,269,230,308,239,-0.48641064138845636,1.3709968346345232,2.9871499780004687,0.8846263354553933,1215,1168,1262,1269,54,7,101,206,-2.1707156205907894,-1.6901610173522328,-1.1764796470043197,3.7682913214685265,91335,91296,Montour+Northumberland,Northumberland,42,97,Pennsylvania,PA
42095,42CS040,2661,2527,2795,3032,371,237,505,417,-2.1657543314484107,-0.554527939408509,1.1217980727654142,1.120720317877639,3275,3113,3437,3542,267,105,429,381,-0.8598035452773993,-0.36455103659638644,0.1590595896250687,1.4202139974490389,311865,313515,Northampton,Northampton,42,95,Pennsylvania,PA
42101,42CS041,12228,11541,12914,15527,3299,2613,3986,2461,0.40305498582311283,2.1372250767793783,3.7812023681378966,0.7456809061894608,14859,14044,15675,16376,1517,701,2332,1576,-0.5523566180544603,-0.0589600635468558,0.48055595066676715,1.0384781185708911,1596011,1579861,Philadelphia,Philadelphia,42,101,Pennsylvania,PA
42103,42CS042,477,452,502,525,48,23,73,45,-1.4906914385115215,0.26112191606983653,2.008463572613328,0.9122816294506743,597,566,628,684,87,56,118,77,-0.3661255479823962,0.1657844753001621,0.6720602730883747,0.8750249415677952,58330,59754,Pike,Pike,42,103,Pennsylvania,PA
42107,42CS043,1647,1585,1708,1916,269,208,331,239,-0.8097654582781566,0.8792312582026225,2.592264192681534,0.8838529363074807,2014,1940,2088,2132,118,44,192,261,-1.5071912248153605,-0.9919773597263212,-0.5140123095961743,2.190821467109209,142593,143193,Schuylkill,Schuylkill,42,107,Pennsylvania,PA
42109,42CS044,304,287,321,361,57,40,74,42,-0.23678634666596984,1.491101289622066,3.197518775793393,0.724168616691065,374,354,394,428,54,34,74,79,-1.119205950350446,-0.6272304153380516,-0.16988846405625374,1.4360850304269261,39806,39635,Snyder+Union,Snyder,42,109,Pennsylvania,PA
42119,42CS044,306,288,325,390,84,65,102,42,2.095305722318891,3.840268973012059,5.689887671070941,0.49624132020263545,377,355,399,483,106,84,128,78,0.1645847528437218,0.6545883670463504,1.1800727487586553,0.7291118253136585,42892,42576,Snyder+Union,Union,42,119,Pennsylvania,PA
42111,42CS045,824,793,856,950,126,94,157,103,-0.3778066467860618,1.2213836871051855,3.0100059831562755,0.813421809070589,1003,965,1041,1189,186,148,224,212,-0.8507742937593734,-0.3568422761089738,0.13334147675481955,1.1348773220973465,73818,73669,Somerset,Somerset,42,111,Pennsylvania,PA
42115,42CS046,394,378,411,465,71,54,87,37,1.9175681557744366,3.5478909076711673,5.224756327429296,0.515729464684429,480,460,500,575,95,75,115,56,0.5121917725813562,1.0099255878422975,1.4980116483568127,0.5816184476675487,38633,38384,Susquehanna+Wayne,Susquehanna,42,115,Pennsylvania,PA
42127,42CS046,517,495,539,594,77,55,99,29,2.203963149428269,3.7573664557626096,5.402267963145097,0.37072796978841366,634,607,660,828,194,168,221,109,1.108645391807305,1.6594058305597847,2.188038077478034,0.5587343230347918,51160,51383,Susquehanna+Wayne,Wayne,42,127,Pennsylvania,PA
42121,42CS047,538,516,559,635,97,76,119,58,1.5927804664687335,3.049931053243861,4.828845483798849,0.5897018289482345,654,628,680,872,218,192,244,136,1.098822038317876,1.6420129667704788,2.162869880434062,0.6203744015720154,50327,49987,Venango,Venango,42,121,Pennsylvania,PA
42125,42CS048,2203,2113,2293,2308,105,15,195,135,-2.305305105994271,-0.5519601707262979,1.1998382819125346,1.27404923139372,2696,2588,2804,2989,293,185,401,354,-0.8306214540555316,-0.29784370883424843,0.2450824286919082,1.2036549313959481,208856,209424,Washington,Washington,42,125,Pennsylvania,PA
42129,42CS049,3880,3728,4032,4253,373,221,525,425,-2.3391733962467645,-0.6466939125797828,1.1372699109238473,1.1367146477521552,4736,4554,4918,5195,459,277,641,589,-0.8918466979298563,-0.3670175341719926,0.10764557441075912,1.2804891988378444,353162,353194,Westmoreland,Westmoreland,42,129,Pennsylvania,PA
42133,42CS050,3645,3449,3841,4231,586,390,782,424,-0.3041025879024838,1.4100294373996687,3.0813882268536372,0.7225218275721758,4495,4259,4732,5251,756,519,992,684,-0.3598281838876697,0.14485822420941205,0.6999660232837833,0.9038286199187896,455601,458360,York,York,42,133,Pennsylvania,PA
44001,44CS001,460,438,481,495,35,14,57,63,-3.832884839619661,-2.1855631435495138,-0.48730011719229027,1.7336620327536583,564,537,590,591,27,1,54,66,-1.3010208709942035,-0.7628859870562924,-0.2398090262380454,2.334436571978005,50433,50808,Bristol+Providence,Bristol,44,1,Rhode Island,RI
44007,44CS001,4959,4676,5242,5966,1007,724,1290,1192,-2.985265112057339,-1.13466843071665,0.6381137132620742,1.182562763928002,6080,5741,6420,6213,133,-207,472,626,-1.2462794220395659,-0.7391058450239207,-0.22797852704179553,4.688610113052389,656479,658483,Bristol+Providence,Providence,44,7,Rhode Island,RI
44003,44CS002,1556,1483,1629,1691,135,62,208,205,-3.4047384118627804,-1.6899268831111962,0.15734574832874318,1.503427322589344,1917,1828,2005,2092,175,87,264,163,-0.444452749089854,0.0516927542847971,0.5696402336405435,0.9238896868629681,169476,170658,Kent,Kent,44,3,Rhode Island,RI
44005,44CS003,721,684,757,719,-2,-38,35,38,-3.5224174628750196,-1.934698508534506,-0.18622280321305584,-71.50322564740961,885,841,929,884,-1,-45,43,52,-1.140457751376311,-0.6264087235853862,-0.10675062281960618,-175.47450358220672,84950,85282,Newport,Newport,44,5,Rhode Island,RI
44009,44CS004,1055,999,1111,1163,108,52,164,87,-1.1579839720282445,0.6338163148399312,2.465180018486549,0.7978841743799617,1307,1239,1374,1365,58,-9,126,71,-0.5949909480767127,-0.0865525768482522,0.4077495686567301,1.1934926415666454,129275,130470,Washington,Washington,44,9,Rhode Island,RI
45001,45CS001,262,251,272,301,39,29,50,34,-0.8309864938315352,0.8374045101401579,2.628139369219874,0.8467729472793177,322,310,335,418,96,83,108,41,1.7196773505538283,2.257009499538125,2.7656185076504096,0.4240969653929822,24275,24286,Abbeville+Edgefield+Greenwood+McCormick,Abbeville,45,1,South Carolina,SC
45037,45CS001,196,185,207,275,79,68,90,27,6.22857427471645,7.948565704627556,9.676308646607767,0.33902266816224785,246,232,259,369,123,110,137,56,2.0635017043215655,2.5812217264812602,3.0777820572317167,0.4506139579791033,25969,26083,Abbeville+Edgefield+Greenwood+McCormick,Edgefield,45,37,South Carolina,SC
45047,45CS001,687,657,717,838,151,121,181,84,2.043932650047258,3.8841778018850306,5.532660842367246,0.5523912509444243,843,808,879,1014,171,135,206,131,0.04911774513851458,0.5749831131130895,1.1081298059296179,0.7638438200072929,69596,69261,Abbeville+Edgefield+Greenwood+McCormick,Greenwood,45,47,South Carolina,SC
45065,45CS001,138,134,142,136,-2,-6,2,13,-8.020027218763731,-6.260824173074962,-4.653970437437261,-13.699879365779976,172,167,177,180,8,3,13,19,-1.601944044123398,-1.1300721152619448,-0.6321017952465064,2.0652860331823604,9531,9724,Abbeville+Edgefield+Greenwood+McCormick,McCormick,45,65,South Carolina,SC
45003,45CS002,1553,1480,1625,1928,375,303,448,157,3.435674817594105,5.159472946018539,6.994096750312538,0.4170141030575801,1919,1831,2007,2498,579,491,667,390,0.5987475800194181,1.1142232117939201,1.633751352266507,0.6724970015940852,169544,170522,Aiken,Aiken,45,3,South Carolina,SC
45007,45CS003,1947,1860,2035,2446,499,411,586,295,2.304433402132819,3.9352404076798537,5.636909554421365,0.5905788781559083,2405,2298,2512,3024,619,512,726,504,0.024387949901581715,0.5648475012499481,1.0469233101611717,0.8127882724858514,204097,206489,Anderson,Anderson,45,7,South Carolina,SC
45013,45CS004,1381,1300,1462,1638,257,176,338,100,1.6465081235111194,3.3682757020453797,5.254323714367589,0.3870297850814773,1723,1624,1821,2106,383,285,482,184,0.5205875709112109,1.0431411548371696,1.5300211569175206,0.47858723693723115,188835,191156,Beaufort,Beaufort,45,13,South Carolina,SC
45015,45CS005,1399,1299,1499,1617,218,118,318,126,-0.04377376979603427,1.5526702620176518,3.2523662800626973,0.5760144388800674,1760,1638,1882,2139,379,257,501,282,-0.1266233047860022,0.41484448118198575,0.9104681545930091,0.7426793662918502,231721,235952,Berkeley,Berkeley,45,15,South Carolina,SC
45017,45CS006,149,143,156,193,44,37,50,15,6.422884112145647,7.996471159626664,9.762626854965768,0.3367730624923528,183,175,190,235,52,45,60,39,0.4350476688223771,0.9316815625485045,1.447909785981359,0.7316709121927203,14186,14159,Calhoun+Richland,Calhoun,45,17,South Carolina,SC
45079,45CS006,2673,2494,2852,3272,599,420,778,304,1.1914607450497094,2.8599607100410225,4.561256818040517,0.5066656384726174,3317,3102,3533,3978,661,445,876,429,0.0019684190848525823,0.5442727712281599,1.0549152532589268,0.6484583909142205,416785,418047,Calhoun+Richland,Richland,45,79,South Carolina,SC
45019,45CS007,2865,2688,3041,3276,411,235,588,274,-0.40043686965406267,1.342054140521885,3.1170163032982705,0.6646838685492442,3549,3336,3762,3831,282,69,495,378,-0.7687982510944279,-0.23449756558013493,0.282120445354593,1.33661528130612,410260,412498,Charleston,Charleston,45,19,South Carolina,SC
45021,45CS008,561,537,585,680,119,95,143,85,0.6599009297241673,2.3934581472247194,4.106681712521195,0.7077124858637448,685,656,714,929,244,215,273,187,0.5065831532510139,1.0192263742566654,1.5050573879480735,0.7622365823047129,56334,56071,Cherokee,Cherokee,45,21,South Carolina,SC
45023,45CS009,365,351,379,474,109,95,123,46,6.071240122609717,7.871464721014906,9.595916099907097,0.41796039630400694,447,430,463,544,97,81,114,85,-0.13223926059560226,0.3858449602305106,0.8929212984471594,0.8658412475556068,32256,32219,Chester+Fairfield,Chester,45,23,South Carolina,SC
45039,45CS009,236,227,245,329,93,84,102,41,8.093852608949538,9.838060602209552,11.601417207722575,0.4375792939579924,286,276,297,391,105,94,115,50,2.111820029275698,2.6554801824222944,3.1243754121853793,0.4731037815135851,21054,20714,Chester+Fairfield,Fairfield,45,39,South Carolina,SC
45025,45CS010,432,413,450,597,165,147,184,67,7.381414872880872,9.056869993799195,10.736876688092446,0.4024629841111253,526,504,549,687,161,138,183,113,0.5972789322575867,1.1209176967219676,1.6056439299536849,0.6995196925733089,43605,43267,Chesterfield+Marlboro,Chesterfield,45,25,South Carolina,SC
45069,45CS010,300,289,312,356,56,44,67,38,0.8347202717795152,2.656041938612307,4.43616639960873,0.6689077481272547,366,352,379,450,84,71,98,73,-0.07575347923599024,0.42009083009768156,0.939418629479313,0.8571232903481355,26465,26405,Chesterfield+Marlboro,Marlboro,45,69,South Carolina,SC
45027,45CS011,321,308,335,501,180,166,193,77,11.29686088568778,12.974708555516292,14.773786797065199,0.426335949970826,391,375,407,563,172,156,188,70,2.7401129707742324,3.285779659805703,3.8102018987180113,0.40505382269810475,31481,31034,Clarendon+Williamsburg,Clarendon,45,27,South Carolina,SC
45089,45CS011,357,344,370,469,112,99,125,79,2.5955660261605686,4.320266599343552,6.09101941432798,0.6988541535318042,434,418,450,537,103,87,119,72,0.49680356023339894,1.0513941715324486,1.5111972753531606,0.6905900926758569,30764,30545,Clarendon+Williamsburg,Williamsburg,45,89,South Carolina,SC
45031,45CS012,690,663,717,879,189,162,216,101,3.9266750564649993,5.490256299463288,7.31472172060776,0.5322441698007304,840,807,872,1097,257,225,290,154,1.1374158141303548,1.6505224382968573,2.1300698892744996,0.5958420608582361,63382,62766,Darlington,Darlington,45,31,South Carolina,SC
45033,45CS013,304,292,316,461,157,145,169,48,13.567637674826623,15.255340187712937,16.969261983434883,0.30385598813592024,368,354,383,500,132,117,146,65,1.8956243592970774,2.3494382894756294,2.8872507876116194,0.49021038722005483,28565,28116,Dillon+Marion,Dillon,45,33,South Carolina,SC
45067,45CS013,340,328,353,468,128,115,140,80,4.965476467015631,6.544040923827984,8.15769261839519,0.6205556542245733,412,397,426,517,105,91,120,80,0.3948488530651972,0.8851237728818723,1.388170359347971,0.7512487982778958,29238,28822,Dillon+Marion,Marion,45,67,South Carolina,SC
45035,45CS014,1037,967,1107,1252,215,145,285,103,0.9979992603373145,2.748931917601018,4.386623191478201,0.4774683366838717,1288,1204,1372,1587,299,215,383,229,-0.06654895099171833,0.42827801068839877,0.9706318612762791,0.7638927206055369,162341,163130,Dorchester,Dorchester,45,35,South Carolina,SC
45041,45CS015,1317,1259,1376,1751,434,375,492,240,4.003823108914652,5.714827424667331,7.403531657983784,0.5522656388784594,1616,1546,1687,2058,442,371,512,275,0.7194842248818899,1.2096549837348622,1.702203752167374,0.6210617921927133,136967,136548,Florence,Florence,45,41,South Carolina,SC
45043,45CS016,687,660,714,885,198,171,225,91,4.9818381515119725,6.824584195548836,8.479004912068241,0.4571606448796111,845,812,878,1052,207,174,240,126,0.7584529004892805,1.2754290513818232,1.8035405676517116,0.6050176019575875,63430,63851,Georgetown,Georgetown,45,43,South Carolina,SC
45045,45CS017,3872,3645,4099,4546,674,447,901,449,-0.020993118929825333,1.6970722335014448,3.396444606584612,0.665085689678147,4801,4526,5076,5772,971,696,1246,881,-0.3220800467753418,0.1659180634750621,0.7382525699286587,0.9064112853228026,527368,532834,Greenville,Greenville,45,45,South Carolina,SC
45005,45CS018,91,90,92,119,28,27,29,14,6.396166899184301,6.795006603408635,7.202976079370497,0.48805692050920024,110,109,111,154,44,43,45,17,3.316675962539596,3.440974160804759,3.570704075281849,0.37682511822758163,8069,7877,Hampton and Nearby Counties,Allendale,45,5,South Carolina,SC
45009,45CS018,160,154,166,205,45,39,51,31,2.6829311055461074,4.266901430679189,5.956025325608598,0.6709585622175752,195,188,201,237,42,36,49,24,0.9110375187968801,1.3903924614877412,1.9322599041729147,0.5527370808732329,13370,13198,Hampton and Nearby Counties,Bamberg,45,9,South Carolina,SC
45011,45CS018,219,210,228,296,77,68,86,34,6.510435931597024,8.321197462253354,10.023007535071823,0.437755351954879,270,259,281,317,47,36,58,51,-0.7175650940887501,-0.1985098515523762,0.3028448382410716,1.0618456556849576,20620,20578,Hampton and Nearby Counties,Barnwell,45,11,South Carolina,SC
45029,45CS018,474,458,491,558,84,67,100,59,0.7865369115988182,2.5750389093349115,4.320517403493321,0.6974625393057889,583,563,603,729,146,126,166,122,0.09907755563474961,0.6483364029989979,1.162364254745937,0.8279076789598055,38412,38474,Hampton and Nearby Counties,Colleton,45,29,South Carolina,SC
45049,45CS018,199,191,207,250,51,43,59,31,2.722747952502365,4.35188137964229,6.026055840491696,0.5957684444701565,241,232,250,294,53,44,62,36,0.40628512711385356,0.9432953480748247,1.408307109217262,0.6670199288905735,18595,18228,Hampton and Nearby Counties,Hampton,45,49,South Carolina,SC
45053,45CS018,227,214,240,269,42,29,55,24,0.6998335303209303,2.4432078400753476,4.081758865215228,0.5591654158505083,290,275,306,386,96,80,111,68,0.44418170340808383,0.9175432709872882,1.410427231790507,0.7024258303310544,29381,30142,Hampton and Nearby Counties,Jasper,45,53,South Carolina,SC
45051,45CS019,3289,3137,3442,4023,734,581,886,353,2.596636360683984,4.335076805626804,6.001827120568709,0.48059519020582014,4129,3941,4317,5244,1115,927,1303,639,0.789277446773726,1.3156913274488955,1.8716126590909568,0.5724805036974943,354891,363817,Horry,Horry,45,51,South Carolina,SC
45055,45CS020,598,569,626,716,118,90,147,73,1.0029937072782855,2.7570704059785793,4.430551886664228,0.6114250487380606,739,705,773,984,245,211,279,124,1.3111572620128786,1.821165161672275,2.3143607705392273,0.5042644017603175,65775,66043,Kershaw+Lee,Kershaw,45,55,South Carolina,SC
45061,45CS020,202,195,209,267,65,58,72,51,1.543865475143104,3.331123685562734,4.945536238908002,0.7773729479342175,245,237,253,297,52,44,60,53,-0.6047914558443117,-0.05162928686604821,0.45677383794529003,1.0005124173000666,16498,16306,Kershaw+Lee,Lee,45,61,South Carolina,SC
45057,45CS021,816,774,858,968,152,110,194,94,0.6302694040536524,2.36077092008044,4.068868757371334,0.6150418698368746,1026,975,1078,1273,247,195,298,174,0.21342251098944598,0.717730670040249,1.2216509317595856,0.7028375578370953,97273,99799,Lancaster,Lancaster,45,57,South Carolina,SC
45059,45CS022,745,716,774,851,106,77,135,79,-0.12263005817954309,1.5841461832690946,3.251557965244358,0.7376169806833173,915,880,950,1127,212,177,247,180,-0.039326198989837025,0.47384264429158324,0.9846077013802826,0.8458117638536042,67562,67766,Laurens,Laurens,45,59,South Carolina,SC
45063,45CS023,2200,2073,2327,2618,418,291,545,235,0.8460117259571429,2.4414915758716758,4.204761221207924,0.5607740599977467,2740,2585,2894,3290,550,396,705,405,-0.05182170518854152,0.46603774573597134,1.0152696245334212,0.7348447833308543,296098,299372,Lexington,Lexington,45,63,South Carolina,SC
45071,45CS024,364,348,381,488,124,107,140,67,4.179028494635717,5.989590531955965,7.654920049304641,0.5379163386441205,444,425,464,561,117,97,136,71,0.7161973419661427,1.2159848894566332,1.7108729662341509,0.6030808243574202,37845,37955,Newberry+Saluda,Newberry,45,71,South Carolina,SC
45081,45CS024,168,160,177,267,99,90,107,30,12.706423390155996,14.383731798600547,16.061098313368124,0.30131489934847516,203,194,213,285,82,72,91,44,1.4878346286432838,2.00309983924754,2.541095375440102,0.5317729507456507,19055,18822,Newberry+Saluda,Saluda,45,81,South Carolina,SC
45073,45CS025,801,767,835,869,68,34,102,75,-1.96439316432423,-0.3311946688713759,1.4273389291600453,1.0822302240879165,985,944,1025,1192,207,167,248,205,-0.44426095678744887,0.04840744642467778,0.552573561583428,0.9834296216114897,78815,79121,Oconee,Oconee,45,73,South Carolina,SC
45075,45CS026,881,845,918,1155,274,237,310,132,4.938518474045985,6.718866704479517,8.363673510563583,0.48083663514017566,1069,1026,1112,1416,347,304,390,190,1.3914836663591421,1.8794716216121674,2.4091635997690224,0.5462712096560078,84186,83107,Orangeburg,Orangeburg,45,75,South Carolina,SC
45077,45CS027,1108,1052,1165,1319,211,154,267,145,0.160400532077637,1.9840260656232602,3.6546218433487883,0.6844772657353357,1370,1302,1438,1697,327,259,395,296,-0.2872862674187901,0.2510403072382514,0.7645449711784256,0.9022661868260342,130992,132138,Pickens,Pickens,45,77,South Carolina,SC
45083,45CS028,2833,2691,2975,3356,523,381,665,382,-0.12881185685058194,1.739402344625445,3.4937583825108733,0.7288718673255442,3518,3345,3691,4304,786,613,959,803,-0.5438660477836202,-0.04286203348709453,0.4909898100337642,1.020703679516805,328713,334916,Spartanburg+Union,Spartanburg,45,83,South Carolina,SC
45087,45CS028,328,317,340,409,81,69,92,43,3.7636868159300088,5.599089877581689,7.303602846911991,0.5271299968088438,398,384,412,516,118,104,132,71,1.210568545678451,1.7386362076164705,2.2753096083677593,0.5950232294376413,27145,27035,Spartanburg+Union,Union,45,87,South Carolina,SC
45085,45CS029,963,917,1008,1223,260,215,306,127,3.298793380412709,5.064984887869762,6.788084339835071,0.48580606920336866,1173,1119,1227,1510,337,283,391,206,0.7409154848618754,1.2390600781859302,1.7850488867148286,0.6094417957466636,105526,104854,Sumter,Sumter,45,85,South Carolina,SC
45091,45CS030,1932,1810,2055,2240,308,185,430,224,-0.5645201288825888,1.1209689966382992,2.958084755388529,0.7259473380074761,2408,2259,2556,2795,387,239,536,370,-0.45264815187423474,0.06765042898635405,0.5884339934091262,0.9524228096183831,284038,287910,York,York,45,91,South Carolina,SC
46005,46CS001,174,166,182,195,21,13,29,36,-4.731312741893027,-3.0953483473960652,-1.4873980748711757,1.6351245739999631,213,204,223,184,-29,-39,-20,13,-2.7597012726714953,-2.242841012419153,-1.7287712144245064,-0.45779809467506116,19033,19125,Clark and Nearby Counties,Beadle,46,5,South Dakota,SD
46025,46CS001,35,35,36,34,-1,-2,-1,0,-1.7871250345449727,-1.3732040453423544,-0.9947162087578323,-0,43,43,44,31,-12,-13,-12,6,-4.880092535502364,-4.747709956146657,-4.60662299570181,-0.5308795501663185,3834,3854,Clark and Nearby Counties,Clark,46,25,South Dakota,SD
46029,46CS001,210,198,223,300,90,77,102,68,1.378446839387292,3.062873558254695,4.720112652220226,0.7507061716434018,260,245,274,280,20,6,35,17,-0.38836381684173504,0.11446103652016744,0.601213955803563,0.7916238543746432,28290,28410,Clark and Nearby Counties,Codington,46,29,South Dakota,SD
46039,46CS001,40,40,40,40,-0,-0,0,4,-4.135563463389994,-3.740877556003613,-3.320025656690876,4.111263483779964,49,48,49,41,-8,-8,-7,4,-2.810536650491805,-2.690351829679866,-2.5765113522165617,-0.61328846393054,4301,4276,Clark and Nearby Counties,Deuel,46,39,South Dakota,SD
46057,46CS001,54,54,55,90,36,35,36,28,4.475615100522047,4.875116131748639,5.266915714964545,0.7666935446305471,67,66,68,53,-14,-15,-13,5,-3.1822650656272704,-3.0546648181545972,-2.9249821593821563,-0.38276313244536597,6184,6242,Clark and Nearby Counties,Hamlin,46,57,South Dakota,SD
46077,46CS001,56,56,57,57,1,0,1,12,-9.137634989818347,-8.75526949390824,-8.32364763084145,6.9603928285995105,69,68,70,72,3,2,4,8,-1.082767331902641,-0.9655040681366562,-0.8269675495407784,1.9991570712448459,5165,5195,Clark and Nearby Counties,Kingsbury,46,77,South Dakota,SD
46115,46CS001,61,60,61,95,34,34,35,20,8.503595496414398,8.921619637888039,9.291057896020607,0.5688606332323628,73,73,74,68,-5,-6,-5,10,-2.586149729879825,-2.463257854613655,-2.336195482988297,-2.2354435859090964,6340,6279,Clark and Nearby Counties,Spink,46,115,South Dakota,SD
46027,46CS002,94,93,96,98,4,2,5,12,-2.6017775355031674,-2.189179980469503,-1.8063143557882317,2.4643241675374767,118,116,119,115,-3,-4,-1,5,-0.6246568217566195,-0.49718443518922745,-0.3538875994020398,-3.3296936552002667,14882,15128,Clay+Turner+Union+Yankton,Clay,46,27,South Dakota,SD
46125,46CS002,92,92,93,127,35,34,35,37,-1.5115745177642725,-1.0996670467511351,-0.676292955661398,1.0391029357562083,114,113,115,109,-5,-6,-4,4,-1.1660241748483693,-1.0411470841854567,-0.9038268069939415,-0.9892662700147787,8625,8703,Clay+Turner+Union+Yankton,Turner,46,125,South Dakota,SD
46127,46CS002,119,117,121,142,23,21,25,26,-1.0920219601639785,-0.6895166522678556,-0.30123800623388086,1.078081680680287,147,145,149,130,-17,-19,-15,8,-1.6245971095000065,-1.4869356732823464,-1.367495480052092,-0.4952407040077985,16715,16866,Clay+Turner+Union+Yankton,Union,46,127,South Dakota,SD
46135,46CS002,215,205,225,228,13,3,23,27,-4.113674175311749,-2.456290197297031,-0.5871312136337848,1.9220110315182677,263,251,275,268,5,-7,17,13,-0.8617876373177122,-0.34218810434500485,0.15153934086290918,2.3204221669696214,23186,23288,Clay+Turner+Union+Yankton,Yankton,46,135,South Dakota,SD
46003,46CS003,25,24,25,41,16,16,17,11,7.344208521919021,7.725859339913203,8.119218817039044,0.6363627693494497,31,30,31,46,15,15,16,6,3.3234105444903546,3.4528091227620985,3.5804889245234164,0.3642639991496348,2737,2746,Douglas and Nearby Counties,Aurora,46,3,South Dakota,SD
46009,46CS003,69,68,69,95,26,26,27,21,2.605056059053074,3.0362133283813795,3.3888493219959552,0.7701338862007242,85,84,86,105,20,19,21,2,2.446601032079565,2.5665474173702187,2.7039904823993215,0.09513989148495366,6973,7009,Douglas and Nearby Counties,Bon Homme,46,9,South Dakota,SD
46015,46CS003,47,46,47,48,1,1,2,4,-2.3291892312945137,-1.9263793482243854,-1.5191067874785276,1.6253657421657628,57,57,58,49,-8,-9,-8,5,-2.6386591138708466,-2.5185343731361334,-2.3953033085340825,-0.6936797370055444,5255,5245,Douglas and Nearby Counties,Brule,46,15,South Dakota,SD
46023,46CS003,97,96,98,130,33,32,34,16,6.8992880372937915,7.284054430393932,7.718518650896815,0.47086992580372894,118,116,119,117,-1,-2,1,13,-1.6036471048487384,-1.4785768053002646,-1.3626587312024647,31.057931609934737,9322,9190,Douglas and Nearby Counties,Charles Mix,46,23,South Dakota,SD
46035,46CS003,193,184,201,221,28,20,37,52,-6.555648471415547,-4.742383677222255,-2.968266878894574,1.7731335845220946,236,225,246,235,-1,-11,10,14,-1.2032036552317267,-0.7253662687312343,-0.19448397694317834,40.89234713996449,19920,19886,Douglas and Nearby Counties,Davison,46,35,South Dakota,SD
46043,46CS003,38,37,39,44,6,5,7,10,-6.958200517946109,-5.389714850557616,-3.5620210541591915,1.3930151619071358,46,44,47,47,1,-0,3,7,-2.6152284343794467,-2.093015688637987,-1.5981018342294206,3.3698684918660202,2836,2821,Douglas and Nearby Counties,Douglas,46,43,South Dakota,SD
46067,46CS003,96,95,97,103,7,6,8,16,-5.22960275651367,-4.841877478949628,-4.442580776330466,1.9859537380768486,118,117,119,109,-9,-10,-8,5,-2.017220506842545,-1.8840612522627933,-1.7559289353820011,-0.6263962420558111,7393,7411,Douglas and Nearby Counties,Hutchinson,46,67,South Dakota,SD
46083,46CS004,267,239,295,323,56,28,84,66,-2.3646518277632307,-0.6481589869472582,1.2614168788763618,1.1607816191170202,345,310,380,309,-36,-71,-1,14,-1.26982040343453,-0.7353784389490198,-0.22665229309375165,-0.39599489780721886,65210,67541,Lincoln+Minnehaha,Lincoln,46,83,South Dakota,SD
46099,46CS004,1301,1216,1386,1619,318,233,403,267,-0.7249958410243416,0.9294398122397052,2.812178970105178,0.8372376155129114,1620,1517,1723,1684,64,-39,167,124,-0.7889448318996463,-0.30439594680335047,0.22075963533608237,1.9186964555125858,197248,199368,Lincoln+Minnehaha,Minnehaha,46,99,South Dakota,SD
46011,46CS005,166,152,181,221,55,40,69,29,1.138438810264691,2.9579596458115343,4.668702848966529,0.5217293230939243,208,190,226,202,-6,-24,12,5,-0.8456430975083657,-0.31087106307942886,0.19934008607689685,-0.9414406357746082,34534,34595,Miner and Nearby Counties,Brookings,46,11,South Dakota,SD
46061,46CS005,21,21,22,19,-2,-3,-2,4,-7.631624774568681,-7.242445458040668,-6.8126188315135146,-3.151494741738499,27,26,27,34,7,7,8,2,1.4376428832829955,1.5661175049392615,1.6845606112504306,0.236087919604357,3466,3499,Miner and Nearby Counties,Hanson,46,61,South Dakota,SD
46073,46CS005,20,19,21,32,12,11,13,15,-9.036171051876124,-7.372005807561282,-5.752492698475552,1.168691865503861,24,23,25,12,-12,-13,-11,2,-9.033786960649131,-8.497291539323406,-7.979974537779706,-0.18313545365759662,1707,1639,Miner and Nearby Counties,Jerauld,46,73,South Dakota,SD
46079,46CS005,89,88,90,91,2,1,3,14,-4.547527150427678,-4.175967093016248,-3.795250156777533,4.29598102048829,106,104,107,118,12,11,14,4,0.646780044292326,0.7666851168324312,0.8975793066423375,0.29895036511513967,11250,10874,Miner and Nearby Counties,Lake,46,79,South Dakota,SD
46087,46CS005,63,63,64,80,17,16,17,23,-4.842738111502215,-4.453727017136358,-4.067635924360836,1.2982206561667087,78,77,79,74,-4,-5,-3,2,-1.20479590056084,-1.0898884672502556,-0.9654609333449287,-0.6260224770833993,5650,5690,Miner and Nearby Counties,McCook,46,87,South Dakota,SD
46097,46CS005,27,26,28,26,-1,-2,-0,2,-7.692797738862862,-5.958426043808166,-4.113302815955567,-4.818608814351461,34,33,35,40,6,5,7,3,0.8677783271172865,1.4128389401957155,1.9103931816895197,0.41238554710688835,2285,2311,Miner and Nearby Counties,Miner,46,97,South Dakota,SD
46101,46CS005,49,48,49,67,18,18,19,15,1.5726789694806085,1.9799925784589754,2.371448599389436,0.7834661977152393,60,59,61,71,11,10,12,11,-0.09070742621431063,0.03602495929683544,0.15414100327668404,0.9010742514882126,6357,6316,Miner and Nearby Counties,Moody,46,101,South Dakota,SD
46111,46CS005,22,22,22,18,-4,-4,-4,3,-12.538598893725354,-12.130839293845511,-11.716967858090532,-0.9781664634892591,28,27,28,30,2,2,3,6,-1.6421671268484042,-1.5167902093765053,-1.39935044600172,1.7618127726024186,2328,2369,Miner and Nearby Counties,Sanborn,46,111,South Dakota,SD
46017,46CS006,26,25,27,31,5,4,6,12,-15.604186290986542,-13.798631707175938,-12.04103775226173,1.918784340282408,31,30,32,53,22,21,23,3,9.347806422712106,9.796589473890602,10.319438438963706,0.13109701613646155,1947,1926,North Central South Dakota,Buffalo,46,17,South Dakota,SD
46021,46CS006,13,12,13,16,3,3,4,8,-13.724766936410129,-13.333485486439608,-12.911772594362425,1.8102807873532005,15,15,15,25,10,10,10,8,1.1266133408377819,1.2574623749812002,1.3804561846727008,0.74535624842847,1376,1379,North Central South Dakota,Campbell,46,21,South Dakota,SD
46045,46CS006,34,34,35,42,8,7,8,10,-2.9317315198147043,-2.5225581061517492,-2.089678384178668,1.175596425816198,42,42,43,59,17,16,17,4,3.011779230800593,3.1361277567424097,3.2705743072261644,0.226807472050811,3965,4025,North Central South Dakota,Edmunds,46,45,South Dakota,SD
46049,46CS006,28,27,29,38,10,9,11,4,8.845683667553878,10.432250213753855,12.064474263173635,0.37703090075874585,35,33,36,30,-5,-6,-3,6,-5.445555343744257,-4.911790488792423,-4.401694912226958,-1.7139799850049018,2155,2136,North Central South Dakota,Faulk,46,49,South Dakota,SD
46059,46CS006,41,40,43,42,1,-1,2,3,-4.78421145017852,-3.1424544371456498,-1.233660232526311,1.9077578699991522,50,48,52,58,8,6,10,4,0.7750226273070269,1.278101892506341,1.8245353532343316,0.44859638479917063,3132,3100,North Central South Dakota,Hand,46,59,South Dakota,SD
46065,46CS006,156,148,163,175,19,12,27,28,-3.6999114243214644,-1.8853681344405182,-0.043308735423470295,1.3793180755661696,192,183,201,209,17,8,26,20,-0.6736221322869067,-0.15435811720840623,0.3118892675971362,1.0915519473732602,17671,17695,North Central South Dakota,Hughes,46,65,South Dakota,SD
46069,46CS006,18,18,18,20,2,2,2,5,-10.830803790894477,-10.448387823240674,-10.02470271505013,1.8450919966091373,22,22,22,36,14,14,14,8,4.8817519264333145,5.009810264214117,5.138624187813837,0.5260507861876613,1261,1239,North Central South Dakota,Hyde,46,69,South Dakota,SD
46085,46CS006,30,29,30,51,21,21,22,3,19.09605220447964,19.516041794003552,19.906568969911255,0.13518131578585804,36,36,37,50,14,13,14,1,3.244676428492957,3.3794308022431165,3.5140205091554586,0.06807496318985934,3730,3757,North Central South Dakota,Lyman,46,85,South Dakota,SD
46089,46CS006,32,31,33,30,-2,-3,-1,2,-7.929977055886391,-6.31808376988868,-4.549626889135596,-2.615017433365659,39,38,40,37,-2,-3,-1,1,-1.7687265120406894,-1.2551091617093482,-0.7128206323235903,-0.9629469133392179,2398,2417,North Central South Dakota,McPherson,46,89,South Dakota,SD
46107,46CS006,32,31,33,34,2,1,3,5,-7.2864203219913595,-5.5366491022484015,-3.802545964025226,1.894925871970698,40,39,41,32,-8,-9,-7,1,-4.174145479028224,-3.611429407720088,-3.1127610695253938,-0.14341043712127466,2424,2474,North Central South Dakota,Potter,46,107,South Dakota,SD
46117,46CS006,17,16,17,18,1,1,2,6,-6.509393803914749,-6.075076344293506,-5.682137498242783,2.4622932611596435,20,20,20,33,13,13,13,2,3.467011674700442,3.596740266063276,3.7288686315709114,0.1440110716200705,3004,3024,North Central South Dakota,Stanley,46,117,South Dakota,SD
46119,46CS006,11,11,11,10,-1,-1,-1,3,-11.75620859658131,-11.366092190789004,-10.947701759459132,-34.539064474238224,14,14,14,15,1,1,1,8,-4.685577715481036,-4.552291716948721,-4.42903108655041,3.4926808874390165,1439,1472,North Central South Dakota,Sully,46,119,South Dakota,SD
46129,46CS006,61,61,62,69,8,7,8,14,-5.023193751009477,-4.607060827961425,-4.170548793333869,1.5733375287537048,73,73,74,86,13,12,13,5,1.3361449619003505,1.4621762644277647,1.5811439384357873,0.36576955627951857,5304,5254,North Central South Dakota,Walworth,46,129,South Dakota,SD
46013,46CS007,299,283,316,390,91,74,107,58,1.867387502217666,3.3609963467853925,5.16747826557412,0.6328205419350613,366,346,385,372,6,-13,26,38,-1.382878322783804,-0.8178921945153902,-0.2651893005601661,5.0952240361500465,38297,38117,Northeast South Dakota,Brown,46,13,South Dakota,SD
46037,46CS007,63,63,64,93,30,29,30,25,2.9914073175903733,3.3818848774062404,3.7685730764256657,0.8180158469923511,77,77,78,71,-6,-7,-6,6,-2.4361786845068623,-2.3103389515491055,-2.181305027302719,-1.0936705412242476,5422,5416,Northeast South Dakota,Day,46,37,South Dakota,SD
46051,46CS007,78,77,78,94,16,16,17,33,-9.289059361267753,-8.900490238243314,-8.49751080334729,1.896882008379089,96,95,97,96,0,-1,1,2,-0.3431024011865186,-0.21442250826106443,-0.09182733772426555,1.4727599936994729,7468,7521,Northeast South Dakota,Grant,46,51,South Dakota,SD
46091,46CS007,33,33,34,41,8,7,8,7,0.07520606957740071,0.4632473795290887,0.8648834994021543,0.8216419171829624,40,40,41,53,13,12,13,5,1.672307968837721,1.8008559258973855,1.9165162305667782,0.36376315071735266,4390,4303,Northeast South Dakota,Marshall,46,91,South Dakota,SD
46109,46CS007,95,94,96,108,13,12,14,29,-6.7416540724910625,-6.31233370902374,-5.8884430903187095,2.1013354704314873,116,114,117,120,4,3,6,10,-0.6549565731975291,-0.5461997057678942,-0.4241042844643257,1.8356677461909858,10268,10177,Northeast South Dakota,Roberts,46,109,South Dakota,SD
46019,46CS008,95,94,96,101,6,5,7,19,-5.305769756452222,-4.9094196985077065,-4.510701051099595,2.5707962859680062,117,116,119,141,24,22,25,22,0.019865306201030452,0.1533353339216518,0.2780091445806952,0.8944901793093867,10295,10426,Northwest South Dakota,Butte,46,19,South Dakota,SD
46031,46CS008,40,40,40,56,16,16,16,14,1.5757940258417815,1.9409705060165092,2.360220891712324,0.827855784036855,49,48,49,56,7,7,8,4,0.7586203769390578,0.8899134619634765,1.0102502942538416,0.473709408766236,3918,3875,Northwest South Dakota,Corson,46,31,South Dakota,SD
46041,46CS008,46,45,47,82,36,35,37,16,14.617648684697297,15.028989455477772,15.39975651072037,0.43259022550817766,56,55,56,92,36,36,37,11,4.730471409353065,4.848639305388527,4.979059865134305,0.29389534067842443,5322,5243,Northwest South Dakota,Dewey,46,41,South Dakota,SD
46063,46CS008,11,11,11,11,0,0,0,6,-17.996113507745648,-17.607894295032402,-17.216838856454245,4.985885797252127,13,13,14,10,-3,-4,-3,5,-6.4125531030468,-6.28939777782405,-6.153997739002541,-2.1440052874969,1317,1326,Northwest South Dakota,Harding,46,63,South Dakota,SD
46081,46CS008,210,199,221,248,38,27,49,36,-1.2959533772457108,0.3430786069264692,1.9897229179403861,0.9150353104333103,261,247,274,303,42,29,56,36,-0.3241618420089023,0.24381094688459867,0.71921994590761,0.8279821230040915,25863,26114,Northwest South Dakota,Lawrence,46,81,South Dakota,SD
46093,46CS008,195,182,208,193,-2,-15,11,18,-4.3077407314669065,-2.7037982297840357,-0.9126091874182128,-14.488647615081309,245,229,260,245,0,-15,16,28,-1.48080610431744,-0.9151060275488762,-0.38806276728562195,19.75786883288594,29684,30126,Northwest South Dakota,Meade,46,93,South Dakota,SD
46105,46CS008,32,32,32,45,13,13,13,11,2.3250098944409725,2.744382813516608,3.154652541010677,0.7889758426261151,39,39,40,33,-6,-7,-6,2,-3.022642361258148,-2.8950992914244975,-2.7737919859657616,-0.3877428644123794,2825,2820,Northwest South Dakota,Perkins,46,105,South Dakota,SD
46137,46CS008,14,13,14,23,9,9,10,3,9.956186771107848,10.35303895341407,10.742959924498258,0.29055508740461916,16,16,17,41,25,24,25,4,8.53423605272986,8.659453278731146,8.78905564631501,0.15613815537356054,2447,2381,Northwest South Dakota,Ziebach,46,137,South Dakota,SD
46103,46CS009,815,768,862,1003,188,141,235,129,0.4537496697125873,2.0948963795436746,3.8581683439473835,0.6826917513502097,1017,960,1075,1251,234,176,291,130,0.41165542844404035,0.9483624062648683,1.4189991782073679,0.5537485393764767,110437,111466,Pennington,Pennington,46,103,South Dakota,SD
46007,46CS010,32,31,32,32,0,0,1,2,-2.329195857050503,-1.9350040858470843,-1.5078734608089586,1.4704043256912536,39,38,39,50,11,11,12,3,2.272970757000353,2.4029538381273827,2.5312801266032454,0.2466559187867256,3385,3403,Southwest Central South Dakota,Bennett,46,7,South Dakota,SD
46033,46CS010,82,81,83,91,9,8,10,11,-1.4851528464282346,-1.072660750493092,-0.6735335382870056,1.1311480161525704,102,101,103,95,-7,-8,-6,5,-1.5173303352564664,-1.3904109178475346,-1.2658149535551861,-0.8474723520727521,8445,8568,Southwest Central South Dakota,Custer,46,33,South Dakota,SD
46047,46CS010,100,100,101,109,9,8,9,3,2.920608686503599,3.3089245127317395,3.717487923354368,0.3079234031621543,126,125,127,149,23,22,24,18,0.5532326162204404,0.685216909445033,0.8077712867012845,0.7528809770459552,6949,7167,Southwest Central South Dakota,Fall River,46,47,South Dakota,SD
46053,46CS010,48,47,48,76,28,28,29,26,1.7657153938605836,2.1719093430952108,2.5611343789559147,0.891234502793241,58,57,58,75,17,17,18,3,3.4432328790119238,3.5779665766581434,3.7113575265090373,0.16447759829165362,4020,3979,Southwest Central South Dakota,Gregory,46,53,South Dakota,SD
46055,46CS010,22,21,22,24,2,2,3,5,-5.997388884565687,-5.614110113101569,-5.224959104854609,1.474580083994262,26,26,26,28,2,2,2,7,-2.8377318677727916,-2.721361751460785,-2.6113209321234327,2.3407621467797557,1865,1840,Southwest Central South Dakota,Haakon,46,55,South Dakota,SD
46071,46CS010,25,25,25,42,17,17,17,13,5.385849728427649,5.775472146845014,6.173216730479344,0.7151922408860842,30,30,30,70,40,40,40,3,12.74764893139859,12.883893171716537,13.013490620475178,0.07325868589743999,2894,2868,Southwest Central South Dakota,Jackson,46,71,South Dakota,SD
46075,46CS010,10,10,11,4,-6,-7,-6,4,-45.759848605394,-45.366553016447,-44.949310257849824,-0.7390519037329356,12,12,12,13,1,1,1,2,-1.5448622965985832,-1.4156551738950696,-1.2893592672190362,1.1461713222300083,918,886,Southwest Central South Dakota,Jones,46,75,South Dakota,SD
46095,46CS010,23,23,23,27,4,4,4,3,1.2714372863642567,1.6606664360837184,2.0717127086461953,0.6244353288006882,28,28,28,30,2,2,2,4,-1.1153759971650805,-0.9906247930170128,-0.8677617735283272,1.2841697750078067,1937,1909,Southwest Central South Dakota,Mellette,46,95,South Dakota,SD
46102,46CS010,134,128,140,191,57,51,63,33,5.239374792886353,7.047234966586536,8.675769678342707,0.5676861228515218,162,155,169,191,29,22,36,6,1.1127139618436632,1.673374323244458,2.19048508235212,0.20220845111832278,13736,13599,Southwest Central South Dakota,Southwest Central South Dakota,46,102,South Dakota,SD
46121,46CS010,72,71,73,118,46,45,47,23,9.16601031062331,9.574338459593402,9.94078728516433,0.49323533992135327,87,86,88,139,52,51,53,15,3.873972388728225,3.9995218424368146,4.115897589393458,0.28225848724252695,9459,9291,Southwest Central South Dakota,Todd,46,121,South Dakota,SD
46123,46CS010,65,64,66,81,16,15,17,13,1.7737280136370461,2.174004418497306,2.5942788439995437,0.7641030430811122,79,79,80,68,-11,-12,-11,2,-2.5078655604340256,-2.3865421811257814,-2.259376429497279,-0.19422844535893635,5573,5574,Southwest Central South Dakota,Tripp,46,123,South Dakota,SD
47001,47CS001,863,830,897,928,65,31,98,69,-1.890829757562927,-0.27812440645392505,1.3411801347454964,1.0514176878915131,1062,1022,1102,1272,210,170,250,140,0.408312682698596,0.8972180429178179,1.4524327514002655,0.6622643153147928,77215,77522,Anderson,Anderson,47,1,Tennessee,TN
47003,47CS002,450,428,472,514,64,42,86,68,-1.9542867628396403,-0.3497471627534177,1.4259441322466047,1.0472995976245163,560,533,586,668,108,82,135,112,-0.5890154449991079,-0.05740749857627046,0.42800194765185817,1.0247134470584582,50297,51000,Bedford+Lincoln+Moore,Bedford,47,3,Tennessee,TN
47103,47CS002,385,369,400,461,76,61,92,42,2.226150582331382,3.8846786205411727,5.625966442067763,0.5425940156167695,473,454,491,550,77,59,96,94,-0.9831974070280743,-0.4593884172178402,0.07859733566365723,1.1974679416974818,35195,35415,Bedford+Lincoln+Moore,Lincoln,47,103,Tennessee,TN
47127,47CS002,59,58,60,68,9,8,10,4,2.6135345048617866,3.0374272229970987,3.427026105759937,0.40414385564284533,74,73,75,95,21,20,22,17,0.4481500706654013,0.5728644629113195,0.7103483592175279,0.7803341072408986,6474,6617,Bedford+Lincoln+Moore,Moore,47,127,Tennessee,TN
47005,47CS003,215,208,222,264,49,42,56,34,2.194545767828085,3.889483432323577,5.623219626208912,0.6765893800818236,261,253,269,331,70,62,78,56,0.36694545788045635,0.8731667221723806,1.4015093871479292,0.7895486653896644,15875,15863,Benton+Carroll+Henry,Benton,47,5,Tennessee,TN
47017,47CS003,367,355,379,459,92,80,104,53,3.8519949429825933,5.498531449606374,7.132166013112767,0.5690705419966609,447,432,462,484,37,22,52,73,-1.800854282304765,-1.2600309269503682,-0.7760181953737649,1.9260631765987237,28314,28430,Benton+Carroll+Henry,Carroll,47,17,Tennessee,TN
47079,47CS003,401,387,415,473,72,58,86,46,1.4247539872844976,3.2169890173281415,4.928883820192396,0.630264603170647,489,472,505,567,78,62,95,71,-0.3191340014505032,0.2336603033587179,0.7336988609629325,0.8966889788366466,32156,32221,Benton+Carroll+Henry,Henry,47,79,Tennessee,TN
47007,47CS004,141,135,148,150,9,2,15,6,-1.0239226250171067,0.6989081091900347,2.4193494619729576,0.6236080946951367,174,167,182,184,10,2,17,37,-2.3092247180278824,-1.7997817007131343,-1.3286679209893175,3.506053438640581,14984,15190,Bledsoe+Rhea+Van Buren+White,Bledsoe,47,7,Tennessee,TN
47143,47CS004,360,346,374,431,71,57,85,46,1.2774565361838035,2.950834356720655,4.840858260765126,0.6396819544476455,439,422,456,552,113,96,130,66,0.9017729111979454,1.4225056986369735,1.9404820436731562,0.5806621962242154,32971,33102,Bledsoe+Rhea+Van Buren+White,Rhea,47,143,Tennessee,TN
47175,47CS004,78,77,79,77,-1,-2,-0,7,-5.6515851616532435,-5.248929858006671,-4.838488873367628,-124.7120719660906,98,97,99,146,48,47,49,36,1.7492477990253685,1.8763613072089078,2.0004335663730752,0.737397399062368,6144,6302,Bledsoe+Rhea+Van Buren+White,Van Buren,47,175,Tennessee,TN
47185,47CS004,320,308,332,346,26,14,38,32,-2.724315430846009,-0.8837682358234586,0.9163670025867308,1.1828778560449411,391,376,405,482,91,77,106,73,0.14482415058787645,0.6699578044483658,1.1774458231803235,0.7913177239635073,27441,27617,Bledsoe+Rhea+Van Buren+White,White,47,185,Tennessee,TN
47009,47CS005,1284,1226,1342,1417,133,75,191,105,-0.8728133522922662,0.8255620717157177,2.553927324505866,0.7844681549262068,1594,1523,1665,1917,323,252,394,192,0.4418692789156827,0.9427544155944235,1.4297400689609352,0.5929696411642682,135462,137308,Blount+Loudon,Blount,47,9,Tennessee,TN
47105,47CS005,596,572,620,600,4,-20,28,47,-4.827713374820406,-3.1791748502975357,-1.382360686674061,9.45257230291611,745,716,775,835,90,60,119,94,-0.6454717066101544,-0.08471410005813387,0.47107030045317444,1.0381278018667137,55109,56458,Blount+Loudon,Loudon,47,105,Tennessee,TN
47011,47CS006,970,923,1017,1194,224,177,271,72,3.8713767678934525,5.578244459840958,7.200941395095463,0.3200920689181599,1204,1147,1261,1597,393,336,450,219,1.0341985389302997,1.5637270197193402,2.062732323329661,0.5561207169744383,108815,109955,Bradley+Polk,Bradley,47,11,Tennessee,TN
47139,47CS006,216,209,224,246,30,22,37,13,2.260920226525876,3.8401456837008734,5.636011477458776,0.4205534038370703,267,258,276,346,79,70,88,41,1.6246891589705963,2.14224689352591,2.6022378491178753,0.513558086889069,17473,17746,Bradley+Polk,Polk,47,139,Tennessee,TN
47013,47CS007,505,488,522,548,43,26,60,41,-1.513583113354369,0.1913198426524421,1.9882589066783571,0.9276704146862269,616,596,637,777,161,140,181,80,1.5482640476592102,2.050480102493003,2.56001651040021,0.49438973983086104,39381,39534,Campbell+Claiborne+Hancock+Scott,Campbell,47,13,Tennessee,TN
47025,47CS007,368,354,382,409,41,27,55,24,0.38915193299778517,2.1888301393631027,3.838303667367684,0.5725855302695312,450,434,467,598,148,131,164,111,0.6229327707592281,1.135854480828661,1.6543660955455173,0.7470656040101054,32044,32234,Campbell+Claiborne+Hancock+Scott,Claiborne,47,25,Tennessee,TN
47067,47CS007,85,85,86,94,9,8,9,5,1.7274164838472934,2.1369392344574116,2.5243002254046454,0.5244146819313303,106,106,107,125,19,18,19,18,-0.04632338546143091,0.08141717190477694,0.21273013185969217,0.9196571473753843,6637,6763,Campbell+Claiborne+Hancock+Scott,Hancock,47,67,Tennessee,TN
47151,47CS007,232,223,242,242,10,0,19,28,-5.057001433394288,-3.3614454929694935,-1.6392362157283848,2.615108197437843,283,272,295,377,94,82,105,56,1.181185596461905,1.707782355870734,2.2131082249533214,0.5922137297102398,21888,21906,Campbell+Claiborne+Hancock+Scott,Scott,47,151,Tennessee,TN
47015,47CS008,159,152,165,181,22,16,29,16,0.06910215466720798,1.7731741728276469,3.307150987969866,0.6865978917919586,193,186,201,215,22,14,29,27,-0.9016899310637415,-0.3590774782624925,0.1753063685573081,1.1822203395790987,14553,14552,Cannon+DeKalb+Warren,Cannon,47,15,Tennessee,TN
47041,47CS008,215,206,224,274,59,50,68,30,4.002340295408503,5.724615765767977,7.440419845195449,0.4997243553986538,264,254,275,335,71,60,81,45,0.7402792314329855,1.2601411493588623,1.7954895851880144,0.6278930361183237,20238,20433,Cannon+DeKalb+Warren,DeKalb,47,41,Tennessee,TN
47177,47CS008,434,416,451,503,69,52,87,51,0.0553892331760364,1.8525648162856325,3.4101714277426805,0.7264631375174778,533,511,554,612,79,58,101,90,-0.7846241282599051,-0.25095655589335575,0.21625688948502544,1.1190939909347115,41111,41450,Cannon+DeKalb+Warren,Warren,47,177,Tennessee,TN
47019,47CS009,654,630,678,786,132,108,156,87,1.5398444373869564,3.1894967894242785,4.982788896531294,0.6546054928910605,804,775,833,955,151,122,180,128,-0.10466719524330267,0.4217761031233351,0.9715846328086236,0.8408857149910726,56308,56160,Carter+Johnson+Unicoi,Carter,47,19,Tennessee,TN
47091,47CS009,224,216,232,258,34,26,42,33,-1.7175131081149981,0.13326110647721112,1.9340661436290363,0.9479064959565057,278,269,288,299,21,11,30,44,-1.820893233179901,-1.2820322318147535,-0.7178432891786547,2.0173952240163815,17959,18140,Carter+Johnson+Unicoi,Johnson,47,91,Tennessee,TN
47171,47CS009,251,244,259,291,40,32,47,26,1.463638119332807,3.114455427486624,4.751059869784289,0.637908768744247,306,297,315,375,69,60,78,34,1.449979548569134,1.9766027291028518,2.4701629313165694,0.48513256881494976,17856,17723,Carter+Johnson+Unicoi,Unicoi,47,171,Tennessee,TN
47021,47CS010,374,356,392,434,60,42,78,29,1.2800868452109766,3.007511189543565,4.6477491448073565,0.47591066454895087,461,440,483,565,104,82,125,64,0.4086803159275559,0.9441619909428688,1.4571276610380435,0.6116334535356641,41095,41459,Cheatham+Dickson,Cheatham,47,21,Tennessee,TN
47043,47CS010,516,492,539,565,49,26,73,68,-3.086646615761908,-1.3235107456035067,0.2886942367685286,1.350904918783985,638,610,667,772,134,105,162,140,-0.6455387543865303,-0.10642294342379582,0.46814065449580905,1.0379837342135467,54438,55167,Cheatham+Dickson,Dickson,47,43,Tennessee,TN
47023,47CS011,167,160,174,195,28,21,35,27,-1.4895117497537131,0.23068472102521356,1.8995733446801164,0.9306968675789739,206,197,215,262,56,47,65,41,0.3253909177816864,0.8411773125768631,1.3410118291125332,0.7226034307267442,17357,17481,Chester+Madison,Chester,47,23,Tennessee,TN
47113,47CS011,909,867,952,1128,219,176,261,155,0.9148806251366858,2.595310560824202,4.387145832519727,0.705950089699226,1118,1067,1169,1297,179,128,230,171,-0.3867863126348021,0.10269816321970554,0.5663436224856967,0.9477622799338398,98670,98775,Chester+Madison,Madison,47,113,Tennessee,TN
47029,47CS012,461,445,476,571,110,95,126,65,3.3895506000206024,5.090058745512348,6.757785060544148,0.5830545787710166,566,547,585,737,171,152,190,97,1.5193011300906623,2.03897026731455,2.5671203041050896,0.5631703677250208,36063,36360,Cocke+Jefferson,Cocke,47,29,Tennessee,TN
47089,47CS012,565,541,589,642,77,53,101,61,-0.5599648154282325,1.068489723431414,2.9067219632656522,0.7821338703576937,698,670,727,891,193,164,221,132,0.6003039949255055,1.0779059094188304,1.6421517301788038,0.6818193672459283,54904,55514,Cocke+Jefferson,Jefferson,47,89,Tennessee,TN
47031,47CS013,604,579,629,669,65,40,90,70,-2.161893135834472,-0.3795644182064282,1.1956087632727948,1.0579036821975096,745,715,776,876,131,100,161,129,-0.46791004019757193,0.03259296048781961,0.5500811844648236,0.9797377656500565,57997,58896,Coffee+Franklin,Coffee,47,31,Tennessee,TN
47051,47CS013,436,418,455,546,110,91,128,51,3.721604985232973,5.479263876933594,7.110265227614507,0.46055885476125835,536,514,558,651,115,93,137,81,0.2662517924882924,0.7854124875153529,1.3690219018030838,0.6975437246754586,42750,43152,Coffee+Franklin,Franklin,47,51,Tennessee,TN
47033,47CS014,167,161,173,208,41,35,47,27,2.2607517120308693,4.011804097867973,5.811602024525777,0.6454165107586701,205,198,212,212,7,-0,14,23,-1.6679747598175818,-1.1593755926974303,-0.6000978401684386,2.902204718143328,13938,13965,Crockett+Gibson+Haywood,Crockett,47,33,Tennessee,TN
47053,47CS014,597,575,618,724,127,106,149,87,1.5066540198227307,3.2224820718844165,4.877663705050751,0.6774333677577039,733,707,759,919,186,160,212,102,1.1186936568139765,1.6793394871422316,2.165776706947677,0.5456907780553304,50208,50517,Crockett+Gibson+Haywood,Gibson,47,53,Tennessee,TN
47075,47CS014,190,182,197,230,40,33,48,40,-1.6509925640784242,0.10046078713190273,1.7288338419404863,0.9700723065568561,232,223,241,286,54,45,63,41,0.24620084875859793,0.7289784938172186,1.2551515165907574,0.7492497095951489,17704,17709,Crockett+Gibson+Haywood,Haywood,47,75,Tennessee,TN
47035,47CS015,738,712,765,865,127,100,153,64,2.4616791312494337,4.08739642524434,5.762989073207748,0.5015438731173427,912,880,944,1246,334,302,366,182,1.931703919519994,2.458746061812967,2.9787876043599675,0.5429287739870806,61331,62279,Cumberland+Fentress,Cumberland,47,35,Tennessee,TN
47049,47CS015,222,214,230,273,51,43,59,32,2.33470985659906,4.170147148441886,5.671319224548976,0.614551342011984,274,264,283,378,104,95,114,62,1.750487483890162,2.239008100202327,2.798789628200424,0.5879251971738015,18563,18802,Cumberland+Fentress,Fentress,47,49,Tennessee,TN
47037,47CS016,4782,4476,5088,5572,790,484,1096,539,-0.27757945057124545,1.4396152267690854,3.175834477918381,0.6812920982158568,5843,5478,6207,5937,94,-270,459,687,-1.330689429372744,-0.8414680971883719,-0.33959591646705223,7.216121059953032,711005,705635,Davidson,Davidson,47,37,Tennessee,TN
47039,47CS017,151,146,156,199,48,43,53,22,7.314770634909976,8.950445845169998,10.797390817405537,0.45267601136546537,183,178,189,211,28,22,33,22,-0.021417201971586326,0.4879147004606831,0.9599754008800873,0.7694297263152204,11431,11393,Decatur+Henderson+Lewis+Perry,Decatur,47,39,Tennessee,TN
47077,47CS017,293,281,305,366,73,61,85,55,0.7827333723543454,2.5991218059117376,4.314873721993389,0.7418747622038175,358,343,372,436,78,64,93,74,-0.361802925180593,0.1635208781576358,0.6844397102354258,0.9324973123664207,27866,27933,Decatur+Henderson+Lewis+Perry,Henderson,47,77,Tennessee,TN
47101,47CS017,152,147,158,171,19,13,24,15,-0.3273307582310456,1.1563506086225457,2.8706885507334525,0.7579899133710455,188,182,195,224,36,29,42,27,0.16599471246394354,0.6807570195676537,1.2177467339613124,0.7323930351774562,12580,12820,Decatur+Henderson+Lewis+Perry,Lewis,47,101,Tennessee,TN
47135,47CS017,109,108,110,112,3,2,4,17,-7.05636195827706,-6.684581610185684,-6.226297524078424,4.136497101756847,135,134,136,145,10,9,11,21,-1.4610389843865532,-1.339759395186004,-1.2164766858533809,1.9604321530461306,8331,8456,Decatur+Henderson+Lewis+Perry,Perry,47,135,Tennessee,TN
47045,47CS018,407,392,423,533,126,110,141,63,5.160069503566675,6.795017559002803,8.545909834260803,0.4978627633573142,498,480,517,627,129,110,147,85,0.658002021624416,1.187772106821516,1.7285833185436943,0.6561011286857303,36712,36620,Dyer+Lake+Lauderdale,Dyer,47,45,Tennessee,TN
47095,47CS018,80,79,81,93,13,12,14,12,0.1278337352095124,0.49620982322454815,0.9062628648624861,0.8642371351555789,100,99,101,137,37,36,38,16,2.866620534152646,2.9872032136487774,3.116617990471625,0.4184005849388538,7000,7106,Dyer+Lake+Lauderdale,Lake,47,95,Tennessee,TN
47097,47CS018,255,244,265,296,41,31,52,32,-0.25892407139248036,1.530691103145979,3.133470783097969,0.7558004575148692,312,299,325,357,45,32,58,51,-0.7332668961710705,-0.24410311527237155,0.25911660305266865,1.1140731153143029,25175,25107,Dyer+Lake+Lauderdale,Lauderdale,47,97,Tennessee,TN
47047,47CS019,378,360,396,461,83,65,101,41,2.3365093774294974,3.9961335443563306,5.8290949240542975,0.4861311681748818,468,446,491,565,97,74,119,83,-0.19698896332866517,0.3263144837293375,0.8087575142192379,0.8510667554454747,42052,42731,Fayette+Hardeman,Fayette,47,47,Tennessee,TN
47069,47CS019,259,248,270,333,74,63,85,50,2.0051980533832157,3.7211508843688077,5.468453909871937,0.6694922428041923,317,304,330,383,66,53,79,42,0.42820393535706053,0.9484426057126373,1.4542743596612777,0.6268340573017371,25359,25424,Fayette+Hardeman,Hardeman,47,69,Tennessee,TN
47055,47CS020,343,330,356,413,70,57,83,43,2.0445982739836315,3.628871950193447,5.25218911827745,0.6018790858025974,423,407,439,526,103,87,119,79,0.2861351350107224,0.7744648910612594,1.3075493254743635,0.7587431301026175,30202,30506,Giles+Marshall,Giles,47,55,Tennessee,TN
47117,47CS020,325,310,340,369,44,29,59,31,-0.13971924655943088,1.5163041801214143,3.159897136027586,0.6847140472290886,404,386,422,466,62,44,80,67,-0.6072127762638511,-0.13923241072420167,0.36752020851516987,1.0583300890980474,34507,34905,Giles+Marshall,Marshall,47,117,Tennessee,TN
47057,47CS021,258,248,269,332,74,63,84,27,6.194502921220892,7.8368544072047674,9.605958940355388,0.36187024959788744,319,306,331,394,75,63,88,59,0.17777721584343392,0.6770311408791096,1.2132687234925639,0.7720376977893895,23532,23728,Grainger+Hamblen,Grainger,47,57,Tennessee,TN
47063,47CS021,664,636,692,859,195,167,223,79,5.467320449711046,7.2001919531887175,8.865599070904699,0.4029319049873518,813,780,846,1110,297,264,330,169,1.479607832038426,1.9957260298306252,2.4767541388127743,0.5674491146444944,64502,64463,Grainger+Hamblen,Hamblen,47,63,Tennessee,TN
47059,47CS022,837,807,867,931,94,64,124,88,-1.35673012449075,0.38043813482888816,2.1436444991780284,0.9283366915138302,1030,993,1066,1285,255,219,292,167,0.7421040109786763,1.2526697971578593,1.7309135307349228,0.6516977376790404,70102,70563,Greene,Greene,47,59,Tennessee,TN
47061,47CS023,181,175,186,197,16,11,22,17,-1.8562501304269017,-0.23474560349682116,1.4927754733205871,0.9727656901320055,220,213,227,246,26,19,33,42,-1.6966623800697946,-1.1464489744097481,-0.6407818661580941,1.5448953401708556,13523,13609,Grundy+Marion+Sequatchie,Grundy,47,61,Tennessee,TN
47115,47CS023,314,301,326,359,45,33,58,36,-0.4270510405152226,1.23871899445192,3.0340422816520394,0.7748384293192793,381,366,396,475,94,79,109,72,0.23975256376421683,0.7726076048838573,1.273473904353767,0.756082634242597,28845,28871,Grundy+Marion+Sequatchie,Marion,47,115,Tennessee,TN
47153,47CS023,155,148,162,165,10,3,17,12,-2.2555083519059527,-0.5075722127523972,1.3416342231446272,1.0800503951461502,194,185,202,229,35,27,44,48,-1.2870695399862415,-0.7805985985462435,-0.2329984522547716,1.3157902911951036,15803,16318,Grundy+Marion+Sequatchie,Sequatchie,47,153,Tennessee,TN
47065,47CS024,3189,3031,3347,3584,395,237,553,257,-0.19805635641079347,1.475163230908399,3.2224199085619145,0.649722758007277,3932,3741,4122,4508,576,386,767,527,-0.4032640871876732,0.13700766709526965,0.6716538348465876,0.912883419216611,367329,368822,Hamilton,Hamilton,47,65,Tennessee,TN
47071,47CS025,348,336,359,404,56,45,68,36,1.3815218131568887,3.0450103867020175,4.787956464771314,0.6287512573505656,427,413,441,527,100,86,114,71,0.5668988177509466,1.0806310001041544,1.5852912388889238,0.7044517738513935,26639,26879,Hardin+McNairy,Hardin,47,71,Tennessee,TN
47109,47CS025,329,318,340,404,75,64,86,35,4.490017531293592,6.274750792312815,7.91420046445236,0.4590251812483114,402,389,415,462,60,47,73,50,-0.09246141206970111,0.3841420793533405,0.9209871324366632,0.8198225322175008,25815,25857,Hardin+McNairy,McNairy,47,109,Tennessee,TN
47073,47CS026,639,614,663,767,128,104,153,55,3.4923580214081995,5.119795498498725,6.922860960918601,0.42514113034635254,787,758,817,1038,251,221,280,155,1.1495766781778365,1.6710316210489322,2.1955633175845324,0.6158759030571902,56761,57198,Hawkins,Hawkins,47,73,Tennessee,TN
47081,47CS027,252,241,262,326,74,64,85,34,4.682402526967942,6.469530991576177,8.13129178202545,0.4516903441141971,311,298,324,378,67,54,80,60,-0.27313906666567067,0.2757156872343637,0.8238997528722588,0.8852711192499044,25011,25254,Hickman+Houston+Humphreys+Stewart,Hickman,47,81,Tennessee,TN
47083,47CS027,102,101,103,128,26,25,27,17,4.074169762947851,4.4619790343709695,4.849903642663611,0.6244458544307792,125,124,126,141,16,15,17,23,-1.010700483013928,-0.885023236934317,-0.7471713093479081,1.382216025307861,8277,8312,Hickman+Houston+Humphreys+Stewart,Houston,47,83,Tennessee,TN
47085,47CS027,223,215,231,241,18,10,26,19,-1.8988708617720336,-0.2170971183714581,1.53243288582217,0.9955447966719787,275,265,285,350,75,65,85,43,1.1654458591500572,1.6603132631713051,2.157321536175639,0.5662778158717404,18944,19176,Hickman+Houston+Humphreys+Stewart,Humphreys,47,85,Tennessee,TN
47161,47CS027,151,146,157,158,7,1,12,20,-5.7721367493475,-3.9234078447771927,-2.25081240489785,2.6516081793156565,187,180,194,208,21,14,28,25,-0.8159915526410042,-0.28761763298050685,0.25053037007878437,1.1244882705770127,13703,13830,Hickman+Houston+Humphreys+Stewart,Stewart,47,161,Tennessee,TN
47087,47CS028,146,141,151,170,24,19,29,23,-1.4616321665612015,0.19706139293099156,1.9759702096227068,0.9331868797745061,179,173,185,182,3,-3,9,21,-2.073986606698353,-1.531030599045109,-1.028914093794459,5.580945228424088,11663,11731,Jackson+Putnam+Smith,Jackson,47,87,Tennessee,TN
47141,47CS028,734,700,769,924,190,155,224,118,1.79268294902728,3.564322582536323,5.422724016831284,0.6183031482089717,907,866,949,1043,136,94,177,91,0.0461383147206267,0.5594317316199686,1.043956787439828,0.666481595127339,80104,81012,Jackson+Putnam+Smith,Putnam,47,141,Tennessee,TN
47159,47CS028,184,175,193,217,33,24,42,21,0.716325755438975,2.4249008207169522,4.121589190358558,0.6178800332486333,227,216,237,286,59,49,70,39,0.466661038355178,1.0071796710682188,1.5450988175301394,0.6468208316774611,19989,20138,Jackson+Putnam+Smith,Smith,47,159,Tennessee,TN
47093,47CS029,3993,3787,4200,4556,563,356,769,287,0.706780684181296,2.3711875110805933,4.019442224188356,0.5091171376755919,4946,4696,5197,5782,836,585,1086,606,-0.05972032954051076,0.4528267813678849,0.9783838810786677,0.7242785646521221,479352,485722,Knox+Union,Knox,47,93,Tennessee,TN
47173,47CS029,194,185,202,247,53,45,62,17,5.620855769820355,7.2743690588865055,8.989203849758525,0.31320370380288265,238,228,249,348,110,99,120,48,2.576737973784497,3.1008196046303347,3.600119654141332,0.43351279248764596,19860,20008,Knox+Union,Union,47,173,Tennessee,TN
47099,47CS030,484,465,503,595,111,92,130,62,2.7137482660760894,4.365854117790557,6.075840572544041,0.5546790354530601,597,574,620,694,97,74,120,102,-0.6301469263117473,-0.10665974049441394,0.3643449241231131,1.0401317498227125,44252,44735,Lawrence+Wayne,Lawrence,47,99,Tennessee,TN
47181,47CS030,176,169,183,196,20,13,27,19,-1.550573108744593,0.27400893250535113,2.075514931655089,0.8985084707801043,216,208,225,264,48,39,56,32,0.5279316380476116,0.9708753686455266,1.4681442094947472,0.6538197401110075,16288,16379,Lawrence+Wayne,Wayne,47,181,Tennessee,TN
47107,47CS031,600,577,623,708,108,85,131,61,1.801764787844084,3.488085668544713,5.184484009284038,0.5585860994257634,743,715,771,947,204,176,232,123,0.9552871569738,1.4988881329072536,2.006663596095591,0.6006213896699933,53465,53950,McMinn+Meigs+Monroe,McMinn,47,107,Tennessee,TN
47121,47CS031,162,157,168,156,-6,-12,-1,17,-8.849516716699032,-7.2912039258107635,-5.502142269096097,-3.3319225702475577,202,195,209,210,8,1,15,29,-2.146344747753477,-1.6116110187706407,-1.1215001873232615,3.232094894160387,12750,13010,McMinn+Meigs+Monroe,Meigs,47,121,Tennessee,TN
47123,47CS031,516,496,536,606,90,70,110,53,1.482437856816651,3.2325939694217745,4.810118674435158,0.5812165815503089,636,612,660,824,188,164,212,127,0.8164166210678795,1.297674290309815,1.8288328935369222,0.6727115256191123,46456,46652,McMinn+Meigs+Monroe,Monroe,47,123,Tennessee,TN
47119,47CS032,894,850,938,909,15,-29,59,105,-5.227583645103566,-3.568787678847395,-1.8978729923681403,6.612317151371091,1124,1070,1178,1197,73,19,127,143,-1.1933615093834093,-0.691608161234149,-0.1399680052331515,1.924373214320433,101303,104314,Maury,Maury,47,119,Tennessee,TN
47125,47CS033,1274,1179,1369,1493,219,124,314,112,0.20540435312221741,1.946528361690604,3.670657400351887,0.5084905208240514,1621,1504,1739,1947,326,208,443,304,-0.4412410508857389,0.10180917456025271,0.5826688064697463,0.9309711691014927,220206,226917,Montgomery,Montgomery,47,125,Tennessee,TN
47129,47CS034,214,205,223,227,13,4,22,11,-1.3520066036071243,0.41300359432239847,2.179484162020775,0.7915454151730329,265,254,276,335,70,59,81,42,0.8123025551886918,1.3178397377683078,1.8297576376018683,0.5898105149919463,21098,21220,Morgan+Roane,Morgan,47,129,Tennessee,TN
47145,47CS034,659,636,682,750,91,68,114,54,0.9294873363497007,2.714844536362656,4.461447568202165,0.589097924316236,812,784,840,922,110,82,138,114,-0.6041295290036752,-0.08463217648577454,0.4094662022743289,1.0278298334054956,53558,53922,Morgan+Roane,Roane,47,145,Tennessee,TN
47027,47CS035,96,95,97,137,41,40,42,19,11.261243944892904,11.68065724072646,12.115350444119658,0.4514970061271749,117,116,118,139,22,21,23,16,0.664381226902861,0.7946116551287893,0.9164332497568798,0.6951132226177131,7560,7555,North Central Tennessee,Clay,47,27,Tennessee,TN
47111,47CS035,241,230,252,301,60,49,71,41,1.1590081998560169,3.0405090941547472,4.834976701106359,0.6734021736347776,298,285,312,341,43,29,56,59,-1.1496629941515693,-0.6283014563669472,-0.13997684523230539,1.3495171986975396,25200,25632,North Central Tennessee,Macon,47,111,Tennessee,TN
47133,47CS035,268,259,278,343,75,65,84,42,4.142643347434365,5.82221811557078,7.642138958469771,0.5542162749440899,329,317,341,404,75,63,87,55,0.3698538815118158,0.8992341803957518,1.4218668827366696,0.7226666605485358,22568,22802,North Central Tennessee,Overton,47,133,Tennessee,TN
47137,47CS035,63,63,64,79,16,15,16,18,-2.237475782500113,-1.8084253937961157,-1.4027448538822216,1.0761424826463781,78,77,79,80,2,1,3,1,0.06702855063717666,0.1890019516264214,0.32301376637577445,0.3370600027607863,5014,5067,North Central Tennessee,Pickett,47,137,Tennessee,TN
47169,47CS035,98,96,99,107,9,8,11,13,-1.6345797792104644,-1.2349699348250893,-0.8128746201975764,1.2466508652821189,123,121,124,152,29,28,31,20,0.6475702023460711,0.7720755617442938,0.89546840584204,0.6610214978912211,11644,11980,North Central Tennessee,Trousdale,47,169,Tennessee,TN
47131,47CS036,336,323,349,455,119,106,132,72,4.470311718231809,6.200485465835578,7.858380518741289,0.5992438031650024,410,395,426,497,87,71,102,74,-0.13588807469441183,0.41278086099403294,0.9559817956060551,0.8439857851641467,30622,30502,Obion+Weakley,Obion,47,131,Tennessee,TN
47183,47CS036,338,323,352,380,42,28,57,35,-0.8084487255743535,0.8216786324807657,2.476781268441628,0.8065287827074232,416,399,433,496,80,63,97,59,0.1630161871872623,0.6369667065352488,1.085139357102886,0.7296107963414112,32941,33011,Obion+Weakley,Weakley,47,183,Tennessee,TN
47147,47CS037,608,576,639,769,161,130,193,73,3.204959336776757,4.865614984890019,6.560889071021428,0.4494984457989343,755,717,794,959,204,165,242,116,0.6299366706404277,1.1848095568860348,1.7126124957476048,0.5670890423251239,72819,73917,Robertson,Robertson,47,147,Tennessee,TN
47149,47CS038,1913,1766,2061,2287,374,226,521,235,-0.04635655186683642,1.6314549693292093,3.411425879718258,0.6274352620606596,2426,2245,2607,2886,460,279,641,432,-0.44222410199247,0.08417629427610958,0.5987161581032591,0.9365646078534656,342467,350862,Rutherford,Rutherford,47,149,Tennessee,TN
47155,47CS039,942,899,984,1105,163,121,206,86,1.4793400231874498,3.136060237929782,4.885643149280507,0.5233354478684392,1164,1112,1215,1479,315,264,367,219,0.449722109285586,0.9577549740846462,1.4580984552955765,0.6920903838949302,98589,99368,Sevier,Sevier,47,155,Tennessee,TN
47157,47CS040,7068,6669,7468,9054,1986,1586,2385,955,2.7292925344626324,4.4361142534228275,6.113855299297991,0.48066122444872106,8666,8188,9143,12526,3860,3383,4338,1620,1.9649391006022376,2.4288951166867627,2.9418006390747946,0.4195485725196215,929436,925065,Shelby,Shelby,47,157,Tennessee,TN
47163,47CS041,1807,1739,1875,2145,338,270,406,184,2.1644204760391923,3.902248286365836,5.461839418510229,0.5432748015887142,2218,2136,2300,2690,472,390,554,319,0.45743543779553714,0.9687718066177906,1.44274560825542,0.674481989924341,158269,159094,Sullivan,Sullivan,47,163,Tennessee,TN
47165,47CS042,1486,1402,1571,1729,243,158,327,188,-0.5502332863058956,1.1571138679008146,2.9497609878768563,0.7718057532829601,1855,1752,1959,2298,443,339,546,337,0.03037957269708231,0.5245258660187294,1.0424679573367794,0.7594530240079067,196772,200078,Sumner,Sumner,47,165,Tennessee,TN
47167,47CS043,519,492,545,598,79,53,106,64,-0.6939604259839692,1.0185774072783869,2.8119269772800908,0.7960621565078211,635,603,666,804,169,138,201,126,0.15592857294410795,0.7121871805130894,1.283431976674929,0.7404954343864333,61075,60998,Tipton,Tipton,47,167,Tennessee,TN
47179,47CS044,1297,1240,1354,1539,242,185,299,151,1.083302103617276,2.7175950533217965,4.436006497085494,0.6206857393268559,1602,1532,1671,1901,299,230,369,199,0.25533924807255504,0.7566819692880771,1.2474548044207203,0.6623419347136337,132703,134067,Washington,Washington,47,179,Tennessee,TN
47187,47CS045,1254,1147,1362,1390,136,28,243,138,-1.7085335213842578,-0.012202485155337311,1.5723537476895801,1.0108895861663818,1598,1466,1729,1671,73,-58,205,173,-0.9139456981027774,-0.3931856607048357,0.1484910187431746,2.332960441523711,248496,254815,Williamson,Williamson,47,187,Tennessee,TN
47189,47CS046,1045,981,1109,1283,238,174,302,144,0.7828194737676046,2.5908460462409364,4.25259936849612,0.6018776282005752,1312,1234,1390,1558,246,168,324,244,-0.4899950251949981,0.017954838559976535,0.5779136784309827,0.9868828188590599,148322,151428,Wilson,Wilson,47,189,Tennessee,TN
48001,48CS001,566,541,591,612,46,21,71,76,-3.8545590317818577,-2.1257811355288703,-0.33237464992693133,1.623563567228909,697,667,727,883,186,156,216,138,0.29200716249622344,0.8196713072886362,1.3628486501284414,0.7373832692013034,57926,58326,Anderson+Houston,Anderson,48,1,Texas,TX
48225,48CS001,237,227,246,308,71,62,81,27,6.216170749952496,7.949469717953791,9.616608369613104,0.37471336732275556,290,279,301,392,102,91,113,70,0.8895473443516249,1.447442832453252,1.9770421794063722,0.679523052229233,22204,22216,Anderson+Houston,Houston,48,225,Texas,TX
48005,48CS002,769,732,807,990,221,183,258,163,0.7946369920128756,2.6136131427287244,4.3131819533899645,0.7357694155097207,945,901,990,1256,311,266,355,262,0.047658666207684844,0.5479279075155797,1.0654462421852027,0.8407345172208105,86422,86483,Angelina,Angelina,48,5,Texas,TX
48007,48CS003,285,274,295,380,95,85,106,23,10.337394349505994,12.157255245204578,13.773465047565354,0.23855464162836718,354,341,366,428,74,62,87,46,0.649518585208758,1.1451093878741339,1.6399039856386295,0.6117603664790346,23897,24423,Aransas+Calhoun+Refugio,Aransas,48,7,Texas,TX
48057,48CS003,163,154,172,216,53,44,62,11,6.651897079877576,8.34422696943831,9.901666253762626,0.20404962537965776,197,187,207,268,71,61,81,29,1.6281211928599977,2.130921326956507,2.641197795868561,0.4024373777212003,20187,19774,Aransas+Calhoun+Refugio,Calhoun,48,57,Texas,TX
48391,48CS003,72,71,73,100,28,27,29,17,6.0614067627384784,6.473494814427632,6.850058700416453,0.5875183398650734,88,87,89,112,24,23,25,13,1.4928814699891237,1.6065736978097904,1.7306672062781592,0.5220847375049056,6759,6755,Aransas+Calhoun+Refugio,Refugio,48,391,Texas,TX
48009,48CS004,76,75,77,76,0,-1,1,4,-2.2488136824132425,-1.8465920530436222,-1.4557658291162239,3.8569395182140824,94,93,95,112,18,17,19,22,-0.5980208741972612,-0.46688130653472276,-0.33712478363144993,1.1598502741351515,8590,8663,Archer+Wichita,Archer,48,9,Texas,TX
48485,48CS004,1163,1107,1219,1403,240,184,296,240,-1.7295731895339321,-0.044884246401127204,1.6613399217196103,0.9970660293641607,1430,1362,1497,1775,345,278,413,306,-0.20928582608733337,0.3060184133372863,0.8324174736947528,0.8833215529187604,130006,129993,Archer+Wichita,Wichita,48,485,Texas,TX
48013,48CS005,350,328,371,485,135,114,157,89,2.08859458152793,3.7683442442665234,5.4770153161910375,0.6521867222747609,434,409,460,627,193,167,218,136,0.6314760201920117,1.1436102623878701,1.6262305556832601,0.7027202784572217,49477,49815,Atascosa+Live Oak+McMullen,Atascosa,48,13,Texas,TX
48297,48CS005,101,100,102,131,30,29,31,17,4.131766038961142,4.576406843019236,4.988031471929646,0.5463754696358886,122,121,124,155,33,31,34,30,0.09808686855635071,0.22374773658455593,0.3476123663770744,0.8937479237969832,11477,11372,Atascosa+Live Oak+McMullen,Live Oak,48,297,Texas,TX
48311,48CS005,8,8,8,17,9,9,9,6,21.5922596226323,21.97787512981966,22.381433513552363,0.5768341781233343,9,9,9,14,5,5,5,3,3.0065697396781115,3.134021500794358,3.2662004949416974,0.508152519415786,619,607,Atascosa+Live Oak+McMullen,McMullen,48,311,Texas,TX
48015,48CS006,241,228,254,271,30,17,43,19,-0.23053985629915572,1.4326999744823463,3.2496532530509232,0.6196422315555253,297,282,313,365,68,52,83,42,0.3280579137429483,0.845828099939174,1.3507266328227767,0.6103674827700377,30137,30340,Austin+Waller+Washington,Austin,48,15,Texas,TX
48473,48CS006,305,280,329,395,90,66,115,27,2.6947113723839653,4.415274106523972,6.236337759081993,0.2953457432893485,389,358,420,501,112,81,143,78,0.09689095988795049,0.5733752343546531,1.1228601274342487,0.6893958671965432,57305,59426,Austin+Waller+Washington,Waller,48,473,Texas,TX
48477,48CS006,320,305,336,416,96,80,111,65,1.7068420864192535,3.450517197704484,5.099831473873995,0.6726452947186577,392,373,410,521,129,111,148,76,0.9490687177112399,1.4693238020019368,2.004128381364745,0.5837321261042182,35812,35883,Austin+Waller+Washington,Washington,48,477,Texas,TX
48019,48CS007,204,194,213,264,60,51,70,15,6.670265032415344,8.518832833976685,10.257782281103733,0.24390761358765956,251,240,262,329,78,67,89,49,0.8171748195942362,1.3456696486739412,1.8779746739092267,0.6209325439951945,21367,21481,Bandera+Kendall+Kerr,Bandera,48,19,Texas,TX
48259,48CS007,329,310,349,379,50,30,69,38,-0.5947326589735912,1.0533560026684763,2.7234943661653443,0.7481613512368622,416,392,440,457,41,17,65,58,-0.8770408400191015,-0.3667978136077929,0.159715813153747,1.3908636225426556,45184,46458,Bandera+Kendall+Kerr,Kendall,48,259,Texas,TX
48265,48CS007,635,612,657,699,64,42,87,51,-0.7421613736969286,0.9989108612658082,2.662250393919258,0.7822524228993093,778,750,805,863,85,58,113,92,-0.6521720167647159,-0.11022935409187769,0.3881484948613033,1.0652589499822072,52689,53090,Bandera+Kendall+Kerr,Kerr,48,265,Texas,TX
48021,48CS008,680,638,722,697,17,-25,59,53,-3.211029539699313,-1.4903150047756515,-0.016644542212106442,3.001736054981377,870,817,922,943,73,21,126,144,-1.1867133618624448,-0.6959104599505161,-0.22085553733945967,1.939500745264708,97059,101464,Bastrop+Caldwell,Bastrop,48,21,Texas,TX
48055,48CS008,332,312,352,414,82,62,102,50,1.0932533828748494,2.874688286735178,4.486247252662388,0.6012259008467308,415,391,439,489,74,50,98,102,-1.0914596044130385,-0.6214767056197253,-0.05903502299035133,1.366500156765798,45705,46671,Bastrop+Caldwell,Caldwell,48,55,Texas,TX
48025,48CS009,224,211,238,276,52,38,65,49,-1.3064962842393717,0.35120847814015993,2.129802552168431,0.9286778551022817,276,260,292,398,122,106,138,90,0.5281696542456787,1.044488229762956,1.5189172514526499,0.730852520720183,31221,30934,Bee+Goliad+Karnes,Bee,48,25,Texas,TX
48175,48CS009,67,67,68,64,-3,-4,-3,4,-4.559194648444618,-4.153500763966443,-3.792221609518872,-1.6907888896525962,83,82,84,98,15,14,16,19,-0.6835831769882323,-0.5546079704817433,-0.42657997338109055,1.1860476314095203,7109,7140,Bee+Goliad+Karnes,Goliad,48,175,Texas,TX
48255,48CS009,133,127,140,156,23,16,29,24,-2.109091328182668,-0.34198251142529834,1.3308674851300677,1.015274803732627,164,156,171,175,11,4,19,30,-1.724005611565296,-1.2612633597793959,-0.7463496710710356,2.439959542188853,14817,14749,Bee+Goliad+Karnes,Karnes,48,255,Texas,TX
48027,48CS010,2089,1929,2249,2385,296,136,456,202,-0.823770114933751,0.9878737078674472,2.7296084728248204,0.6809827259119493,2632,2437,2828,3349,717,521,912,551,-0.0769517978941208,0.4291191759723251,0.9543466151934827,0.767595183487543,371568,378503,Bell,Bell,48,27,Texas,TX
48029,48CS011,11851,10985,12718,14275,2424,1557,3290,1952,-0.7480395669426971,0.9779318672611613,2.824190111152616,0.8050664077547547,14736,13690,15782,18940,4204,3158,5250,3396,-0.08374770345314823,0.3995155231112101,0.9669924804292053,0.8076534247367099,2013837,2026168,Bexar+Wilson,Bexar,48,29,Texas,TX
48493,48CS011,356,334,377,382,26,5,48,37,-2.5673384437209865,-0.8708703423372975,0.9826173773313902,1.3491075816197968,445,418,471,641,196,170,223,115,1.1140738822850285,1.5931460729846154,2.107998619005328,0.5828136775162159,50265,51073,Bexar+Wilson,Wilson,48,493,Texas,TX
48035,48CS012,209,201,217,274,65,57,73,20,8.124555040899047,9.883483644396815,11.519999400572003,0.3020022234202581,255,246,265,305,50,40,59,36,0.23272613044077176,0.7428244818717322,1.2362317118167079,0.7104223010070367,18318,18464,Bosque+Hamilton+Hill,Bosque,48,35,Texas,TX
48193,48CS012,115,115,116,105,-10,-11,-10,16,-13.23007917511436,-12.791020528065962,-12.416928763886435,-1.6969015275123231,140,139,141,157,17,16,18,6,1.1630729059536233,1.2855586828004777,1.4115833847344488,0.3412393369702882,8264,8229,Bosque+Hamilton+Hill,Hamilton,48,193,Texas,TX
48217,48CS012,381,365,396,451,70,55,86,40,1.5787967649857504,3.2913729944824155,5.018541527274232,0.562687273421066,466,447,485,673,207,188,226,139,1.3595692931261534,1.8539410843939943,2.3778370952888346,0.6690031157284749,36101,36397,Bosque+Hamilton+Hill,Hill,48,217,Texas,TX
48037,48CS013,891,851,931,1063,172,132,212,126,0.3296992922068097,2.0243618764208446,3.6820362945799334,0.7291051753175043,1089,1042,1137,1379,290,242,337,228,0.1388811777436778,0.6634840022051943,1.2000270187849742,0.7846545512196345,92874,92612,Bowie,Bowie,48,37,Texas,TX
48039,48CS014,2077,1916,2238,2443,366,205,527,239,-0.4099751588556723,1.3607009114673763,3.0845063756424054,0.6514736927467779,2603,2408,2799,3457,854,658,1049,605,0.09269465388448757,0.6463868430070122,1.1500536938490789,0.7077693601550533,374221,378767,Brazoria,Brazoria,48,39,Texas,TX
48041,48CS015,931,830,1032,1141,210,109,311,146,-0.6160692713512925,1.00383443038697,2.7558193323648106,0.6918859451855037,1172,1050,1294,1414,242,120,364,216,-0.4011789554059738,0.11327354296983524,0.6142006167678977,0.8883969585855285,234008,236660,Brazos+Burleson+Grimes+Robertson,Brazos,48,41,Texas,TX
48051,48CS015,193,186,201,211,18,10,25,20,-2.1118981676595583,-0.5236275043545343,1.1721535671724201,1.0626739484373293,238,229,247,297,59,50,68,41,0.46597105694998464,0.9823191980603907,1.4619450172515787,0.6847372016922137,17800,17992,Brazos+Burleson+Grimes+Robertson,Burleson,48,51,Texas,TX
48185,48CS015,252,240,265,314,62,49,74,47,0.16687111572570937,1.9476623178731576,3.7967010948194777,0.7501826231496528,315,300,331,395,80,64,95,64,0.0070741632192340646,0.5337126273129262,1.0310163054650348,0.7929590700350737,29436,30160,Brazos+Burleson+Grimes+Robertson,Grimes,48,185,Texas,TX
48395,48CS015,162,154,169,202,40,33,48,23,2.4588573210288063,4.132615948242044,5.818168194353818,0.5556902550396843,199,190,207,267,68,60,77,48,0.6993207262738387,1.2086585714005875,1.7293624979935491,0.6909457870550011,16816,16926,Brazos+Burleson+Grimes+Robertson,Robertson,48,395,Texas,TX
48049,48CS016,432,416,448,584,152,136,168,73,6.676043678208033,8.29271664612308,10.04013856418214,0.47712018006941675,531,512,551,647,116,96,135,107,-0.2447305529114919,0.20631624735769688,0.726296948728043,0.9176823023978806,37988,38164,Brown+Coleman+Mills,Brown,48,49,Texas,TX
48083,48CS016,127,124,130,124,-3,-6,0,16,-11.604838784977582,-9.807079686609592,-8.137774613771953,-7.814627831646428,155,151,159,214,59,55,63,42,1.7130803356431377,2.2265499556506363,2.723900322555956,0.6978363539775743,7744,7726,Brown+Coleman+Mills,Coleman,48,83,Texas,TX
48333,48CS016,57,57,58,74,17,16,17,14,1.9642394762979762,2.3816380947914335,2.80109783988587,0.7910012851781174,70,70,71,92,22,21,22,14,1.628259723390156,1.7632636639025596,1.8828430438611827,0.6121074510812007,4506,4474,Brown+Coleman+Mills,Mills,48,333,Texas,TX
48053,48CS017,473,452,495,498,25,3,46,30,-2.3153844284216825,-0.4345995431456458,1.3145326273835256,1.1763494950865485,596,570,622,691,95,69,121,114,-0.8710034355812971,-0.3797218196260527,0.09298006695047155,1.1840833536767101,49419,50731,Burnet+Lampasas+Llano,Burnet,48,53,Texas,TX
48281,48CS017,197,187,206,252,55,46,65,13,6.173210876467951,7.757516328436768,9.71044896701676,0.23014764971883134,246,235,258,331,85,73,96,54,0.8686148007404613,1.362564145738787,1.8646718287040625,0.6304784281514875,21723,22173,Burnet+Lampasas+Llano,Lampasas,48,281,Texas,TX
48299,48CS017,283,274,292,302,19,10,28,17,-1.2798496053131396,0.3153069903857176,2.0977282535325217,0.8502751046001884,353,342,364,412,59,48,70,67,-0.877654749635703,-0.36611892978661553,0.10065395190465394,1.119683556290529,21407,21872,Burnet+Lampasas+Llano,Llano,48,299,Texas,TX
48059,48CS018,146,140,152,196,50,44,56,26,5.25934379170834,6.826681230089012,8.571342473830692,0.5126214558816838,181,173,188,231,50,43,58,36,0.5287504781740865,1.0198162295180748,1.5468501690613172,0.6996832278268478,13816,14062,Callahan and Nearby Counties,Callahan,48,59,Texas,TX
48133,48CS018,210,202,217,230,20,13,28,18,-1.2804088445657622,0.5912738043588037,2.30957095825741,0.8392191305601304,254,245,264,383,129,119,138,70,2.7925815756429686,3.2975788289393573,3.8018348603739147,0.5398819182700452,17840,17848,Callahan and Nearby Counties,Eastland,48,133,Texas,TX
48253,48CS018,153,145,162,221,68,59,76,39,4.123080030327091,5.839844711373749,7.512526782608572,0.5676307430523009,188,178,198,261,73,63,83,62,0.03088447487373466,0.5630548947638492,1.0981098118002635,0.8351279330702509,19724,19844,Callahan and Nearby Counties,Jones,48,253,Texas,TX
48417,48CS018,25,24,25,38,13,13,14,8,6.554260941729326,6.984020896514129,7.359878890657551,0.5519382905298778,30,30,31,42,12,11,12,6,1.6118143773415798,1.7354661603107722,1.8577281109266708,0.47752822277997076,3153,3199,Callahan and Nearby Counties,Shackelford,48,417,Texas,TX
48429,48CS018,91,90,92,123,32,31,33,17,6.094427645060055,6.52285799646974,6.920345701072786,0.5170321578000899,112,111,113,144,32,31,33,24,0.7685108727923377,0.8965547222179422,1.0257796199091684,0.7217494022136405,9130,9159,Callahan and Nearby Counties,Stephens,48,429,Texas,TX
48061,48CS019,2342,2161,2523,3734,1392,1211,1573,1075,1.3986781997826132,3.0199427939943093,4.725196702914971,0.7716971189243801,2911,2693,3130,3805,894,675,1112,740,-0.17051686335493849,0.36344718393989267,0.8465830965826313,0.8270562516129522,421595,422761,Cameron,Cameron,48,61,Texas,TX
48067,48CS020,331,319,343,455,124,112,136,60,7.140971204868803,8.890113908541746,10.518309570257253,0.48082866370326327,403,388,418,586,183,168,198,111,1.9774070336436413,2.5380688825124027,3.0278291240140236,0.6036045867724824,28650,28537,Cass+Marion+Morris,Cass,48,67,Texas,TX
48315,48CS020,144,140,148,163,19,15,23,21,-2.5447360072897682,-0.8866094552018914,0.9047738980090567,1.0571000381563993,173,168,178,212,39,34,44,40,-0.6902052524057303,-0.1532826745698779,0.3806368361612714,1.0113165235511414,9755,9661,Cass+Marion+Morris,Marion,48,315,Texas,TX
48343,48CS020,155,150,160,168,13,8,18,15,-2.3975592552558056,-0.7411651481067578,1.0427045179860626,1.0745114999405163,189,183,195,228,39,33,45,43,-0.8241834493364976,-0.31151381397385663,0.19613022213759623,1.069510456783947,12025,12020,Cass+Marion+Morris,Morris,48,343,Texas,TX
48071,48CS021,277,257,297,334,57,37,77,28,0.760736982379308,2.537233949536494,4.088894982981462,0.48057891049761686,352,327,377,418,66,41,91,86,-0.9100182155634471,-0.40667659470384154,0.08421961599675533,1.2809688683302294,46755,48600,Chambers+Liberty,Chambers,48,71,Texas,TX
48291,48CS021,764,724,804,768,4,-36,44,92,-5.515967681857822,-3.823523489550061,-1.9735822614587997,17.889172389590904,975,925,1025,1153,178,128,228,240,-1.15722188028673,-0.6451627423393334,-0.10223113069727637,1.3371612016677488,92332,96852,Chambers+Liberty,Liberty,48,291,Texas,TX
48073,48CS022,464,442,486,601,137,115,159,97,1.463999665781918,3.127324494192325,4.872560926508958,0.701516866322128,570,544,597,794,224,197,250,148,0.9596461067030383,1.4692979884337645,1.9493299653227365,0.6587015923844254,50846,51007,Cherokee,Cherokee,48,73,Texas,TX
48077,48CS023,108,107,109,128,20,19,21,13,2.2934420315971833,2.714248172579036,3.115810373407194,0.6199196779309037,132,131,134,151,19,17,20,16,0.12228421819598666,0.24023575133602854,0.3742418402213162,0.8204190317723986,10279,10260,Clay+Cooke+Montague,Clay,48,77,Texas,TX
48097,48CS023,373,355,391,424,51,33,69,39,-0.5233442614120736,1.2251672356649281,2.8486723773711504,0.7451644469891585,463,442,485,520,57,35,78,85,-1.2224719109813342,-0.6731615318702319,-0.16445173159896057,1.4747113070623776,41663,42164,Clay+Cooke+Montague,Cooke,48,97,Texas,TX
48337,48CS023,245,237,254,325,80,71,88,41,5.9001312888229895,7.706941641295098,9.319923648733521,0.5086881062864574,305,294,315,368,63,53,74,55,-0.10675320072985967,0.3942155411309024,0.8915311991827225,0.8566700958881407,19997,20345,Clay+Cooke+Montague,Montague,48,337,Texas,TX
48085,48CS024,4222,3759,4684,4832,610,148,1073,443,-1.2082490028924648,0.6497562363206447,2.4279093679613695,0.7244778229732565,5448,4878,6018,6210,762,192,1332,819,-0.5842292473241824,-0.05523379199228857,0.45321079792373664,1.0738355587391448,1071379,1104166,Collin,Collin,48,85,Texas,TX
48091,48CS025,1215,1144,1285,1357,142,72,213,137,-1.605426285698187,0.13188382385306222,1.8667669165410967,0.9557581587747257,1574,1484,1663,1785,211,122,301,289,-0.9670898711707916,-0.45404435003489163,0.05394104787500851,1.3621180130186765,163721,173322,Comal,Comal,48,91,Texas,TX
48093,48CS026,158,152,164,194,36,30,42,36,-1.581842079358109,0.06897294355468483,1.7202789290383473,0.9684408918461118,193,186,200,220,27,20,34,32,-0.8888115947724686,-0.3769662141265086,0.1844629590075754,1.151415019650125,13622,13749,Comanche+Erath+Somervell,Comanche,48,93,Texas,TX
48143,48CS026,288,270,307,315,27,8,45,37,-2.53092496385713,-0.8937708061716583,0.7194965092887465,1.327926602850816,356,334,379,462,106,83,128,79,0.10679829406960947,0.6044861448681057,1.0920316704519597,0.7405443338289487,42758,43281,Comanche+Erath+Somervell,Erath,48,143,Texas,TX
48425,48CS026,82,82,83,99,17,16,17,3,5.455885341092003,5.86906774174187,6.291917005565357,0.1709661360143973,103,102,104,123,20,19,21,17,0.15696391305217935,0.29007738225048313,0.4203406266397357,0.8200352635323465,9227,9432,Comanche+Erath+Somervell,Somervell,48,425,Texas,TX
48099,48CS027,464,429,500,534,70,34,105,40,-0.16237071782536033,1.457719592291067,3.2112189213493894,0.5652256758872497,585,542,628,704,119,76,162,130,-0.6073458967685761,-0.12343196591378061,0.3862310559580184,1.0826140177532322,82259,84066,Coryell,Coryell,48,99,Texas,TX
48105,48CS028,30,29,32,56,26,24,27,10,18.162204939964138,19.856550775452202,21.62509512744121,0.3751748804697592,37,35,38,55,18,17,20,6,3.5461022644820814,4.079424021664567,4.545314680841358,0.3079833427205446,3159,3074,Crockett+Kinney+Terrell+Val Verde,Crockett,48,105,Texas,TX
48271,48CS028,31,29,32,45,14,13,16,4,11.076615627910323,12.771345935240799,14.47879448371207,0.26159432916505276,37,36,39,53,16,14,17,2,3.9070498308814305,4.41165084632241,4.935574878007727,0.11885058078026403,3206,3130,Crockett+Kinney+Terrell+Val Verde,Kinney,48,271,Texas,TX
48443,48CS028,9,9,9,12,3,3,3,3,-2.5403246843972798,-2.133513840245903,-1.7091002177929793,0.8321267108732969,11,11,11,20,9,9,9,4,6.363261005844403,6.493022231013477,6.611034381075565,0.4115444683980179,743,727,Crockett+Kinney+Terrell+Val Verde,Terrell,48,443,Texas,TX
48465,48CS028,328,308,349,498,170,149,190,162,-1.053274222037945,0.6462722254215069,2.356775581491253,0.949805396660866,406,381,430,499,93,69,118,99,-0.6266429861205401,-0.1105880471349287,0.3870989339772445,1.049029115242291,47793,47567,Crockett+Kinney+Terrell+Val Verde,Val Verde,48,465,Texas,TX
48107,48CS029,55,54,55,83,28,28,29,23,3.6835580081462673,4.0823602993374015,4.488039184339674,0.7851318771610228,66,65,67,99,33,32,34,20,2.4143648708380705,2.5373715880477987,2.666749308101336,0.589302386971224,5187,5105,Crosby+Floyd+Hale+Swisher,Crosby,48,107,Texas,TX
48153,48CS029,50,50,51,93,43,42,43,27,11.192623788204227,11.611248764401044,12.001315236895875,0.6169659061736331,61,60,62,93,32,31,33,15,3.0691812256627693,3.1978176758803616,3.327166225046904,0.4525250440948961,5430,5354,Crosby+Floyd+Hale+Swisher,Floyd,48,153,Texas,TX
48189,48CS029,265,251,279,392,127,113,141,129,-2.1163290587849763,-0.26844737869722424,1.468497086971028,1.0076804687682037,326,309,342,394,68,52,85,76,-0.756383227775609,-0.24912764901204834,0.2678824626077961,1.094830020020473,32512,32252,Crosby+Floyd+Hale+Swisher,Hale,48,189,Texas,TX
48437,48CS029,69,69,70,99,30,29,30,12,9.562439298194455,9.985469643506807,10.370471538529197,0.3929179721835633,85,84,86,96,11,10,12,13,-0.4140018438498358,-0.27960056653670595,-0.14969933521236115,1.0793504253627366,7027,7001,Crosby+Floyd+Hale+Swisher,Swisher,48,437,Texas,TX
48113,48CS030,13906,12784,15028,17173,3267,2145,4389,2301,-0.19122863262774412,1.4975240471384268,3.1004340224801705,0.7041271532156845,17124,15787,18461,20545,3421,2084,4758,3389,-0.5338521441758012,0.016873034110128648,0.545285990134735,0.9902485017507032,2611957,2589682,Dallas,Dallas,48,113,Texas,TX
48121,48CS031,3553,3160,3947,4109,556,162,949,405,-1.0586869196153736,0.7256972401884041,2.387198532912504,0.727714612868149,4571,4087,5056,5335,764,279,1248,693,-0.4514694056737314,0.0823781804806382,0.6212044461076041,0.9064576350855886,913125,937601,Denton,Denton,48,121,Texas,TX
48127,48CS032,67,66,68,91,24,23,25,13,4.555652416599876,4.955816023315416,5.361901918139322,0.5223767419326212,79,78,81,154,75,73,76,35,4.527189872862647,4.6563472086446485,4.772971581345607,0.46357383927841467,8778,8486,Dimmit+La Salle+Maverick,Dimmit,48,127,Texas,TX
48283,48CS032,44,43,45,68,24,23,25,19,2.489170123130639,2.885399075911315,3.2889638830733943,0.7635195134515763,53,52,54,84,31,30,32,25,0.7358517268359479,0.8688556580414575,0.9908516738357347,0.7871644453696635,6777,6666,Dimmit+La Salle+Maverick,La Salle,48,283,Texas,TX
48323,48CS032,344,338,350,611,267,261,273,216,3.1072961620603636,3.5034930552907615,3.9427620728421098,0.8064377401191332,423,416,431,612,189,181,196,201,-0.3391504608861181,-0.2072430583833511,-0.0768486590765712,1.0590840554994823,57941,58025,Dimmit+La Salle+Maverick,Maverick,48,323,Texas,TX
48047,48CS033,67,67,68,101,34,33,34,28,2.836914097923294,3.212812979407882,3.632017566138593,0.807549486534901,82,81,83,97,15,14,16,20,-0.875474644623824,-0.7454309070104718,-0.626178173584211,1.2656734425534855,7035,6999,Duval and Nearby Counties,Brooks,48,47,Texas,TX
48131,48CS033,98,97,99,123,25,24,26,25,-0.3676455468796847,0.06605105290372867,0.4879017227223496,0.95459017064557,117,116,118,172,55,54,56,31,2.3081152458869982,2.4372023910201324,2.5574043243802342,0.5556597285334172,9997,9764,Duval and Nearby Counties,Duval,48,131,Texas,TX
48247,48CS033,40,39,40,54,14,14,15,12,1.3336655582407888,1.7133603357959342,2.111243559622796,0.7955898063894309,48,48,49,69,21,20,21,4,3.351606327195874,3.4774318274537057,3.6016764270024635,0.18434112178680245,4882,4807,Duval and Nearby Counties,Jim Hogg,48,247,Texas,TX
48249,48CS033,330,313,346,429,99,83,116,68,1.409008558152851,3.229806349468638,4.951427516824386,0.6777835276134985,403,383,423,594,191,171,211,109,1.610002385512854,2.1067878634210984,2.6526045980178385,0.5673602974616876,39073,38842,Duval and Nearby Counties,Jim Wells,48,249,Texas,TX
48505,48CS033,82,81,84,115,33,31,34,22,2.644085610131517,3.0657509588622243,3.4435657816941068,0.6537120360010712,101,100,103,139,38,36,39,23,0.9190017856767642,1.0515942061701884,1.180968404911671,0.5955655072911303,13936,13904,Duval and Nearby Counties,Zapata,48,505,Texas,TX
48011,48CS034,24,24,24,34,10,10,10,7,5.931381919701552,6.310133965866904,6.7259765657309085,0.6413058030545553,29,29,29,31,2,2,2,4,-1.301632789998643,-1.1784783807713188,-1.0377060014750017,1.4102937846770998,1847,1840,Eastern Central Panhandle,Armstrong,48,11,Texas,TX
48023,48CS034,51,51,52,57,6,5,6,6,-0.9619606758485324,-0.5357817050161218,-0.1329559334817533,0.9178517724838342,63,62,63,81,18,18,19,17,0.2830856448938456,0.41328290257707717,0.5419914069931507,0.8749024006409591,3474,3475,Eastern Central Panhandle,Baylor,48,23,Texas,TX
48045,48CS034,15,15,15,22,7,7,7,3,10.550407190297715,10.908497557527406,11.329390470974445,0.37855004836268413,18,18,18,16,-2,-2,-2,5,-5.045186408306532,-4.92671023423031,-4.790791786460337,-5.424585895401107,1437,1406,Eastern Central Panhandle,Briscoe,48,45,Texas,TX
48075,48CS034,61,61,62,72,11,10,11,13,-1.7654541194563353,-1.3630956647030863,-0.9350893392462725,1.1102991629452605,74,73,75,84,10,9,11,13,-0.6145169281281273,-0.48207559057371446,-0.3617595010768196,1.2119619737629983,6741,6723,Eastern Central Panhandle,Childress,48,75,Texas,TX
48101,48CS034,21,21,22,27,6,5,6,6,-2.7174157756211637,-1.1202607643700835,0.5457773773846089,0.9059964219063779,26,26,27,21,-5,-6,-5,8,-10.071910007786565,-9.563068864648733,-9.058693616406453,-1.897080871331775,1376,1380,Eastern Central Panhandle,Cottle,48,101,Texas,TX
48125,48CS034,19,19,19,38,19,19,19,7,25.48552070905779,25.862966999314125,26.269584886980624,0.3541172022098704,22,22,23,30,8,7,8,4,1.9476017191708317,2.075955610345623,2.207300847951,0.4641740976263463,1820,1743,Eastern Central Panhandle,Dickens,48,125,Texas,TX
48129,48CS034,41,40,41,47,6,6,7,5,1.1957938817003786,1.5731806298445514,2.000293596512357,0.6855271544596999,49,49,50,64,15,14,15,12,0.6561478636783158,0.7683205879623798,0.8942790385844761,0.772931497515192,3268,3268,Eastern Central Panhandle,Donley,48,129,Texas,TX
48155,48CS034,17,16,17,27,10,10,11,4,20.438436385853947,22.080765590347383,23.73012162773384,0.3621381315350495,21,20,21,25,4,4,5,3,0.8341036354929512,1.3366161714776732,1.9045627000932617,0.54898240444964,1096,1081,Eastern Central Panhandle,Foard,48,155,Texas,TX
48191,48CS034,35,34,35,47,12,12,13,7,7.355744334448363,7.75391969075289,8.133530432104505,0.5186429598776764,42,42,42,52,10,10,10,5,1.638465343733553,1.7637013180033498,1.8866782123074546,0.45492585252518175,2833,2839,Eastern Central Panhandle,Hall,48,191,Texas,TX
48197,48CS034,37,37,37,68,31,31,31,10,22.84544540469211,23.254024630812204,23.68300530683072,0.31256342897267203,44,44,45,45,1,0,1,4,-1.032354834682406,-0.9151372702733364,-0.7814948315309772,2.2662258102454946,3612,3553,Eastern Central Panhandle,Hardeman,48,197,Texas,TX
48207,48CS034,59,58,59,71,12,12,13,15,-2.473303997387565,-2.0633725390914366,-1.683481245746888,1.1388506321401064,71,70,72,111,40,39,41,20,3.587848957103375,3.7156001492534267,3.83804934218555,0.4866324298722886,5458,5413,Eastern Central Panhandle,Haskell,48,207,Texas,TX
48269,48CS034,4,4,4,4,-0,-0,-0,4,-63.92318046544401,-62.214671015538016,-60.486473852473516,4.806261326153113,5,5,5,8,3,3,3,8,-19.45433736365053,-18.972854823280297,-18.48295579622104,1.9683276309303388,268,260,Eastern Central Panhandle,King,48,269,Texas,TX
48275,48CS034,41,40,41,66,25,25,26,12,15.365374692487137,15.765621277464316,16.18428666982737,0.4542975941756098,49,48,49,71,22,22,23,10,3.5808317182064466,3.7092301182914516,3.836766564137534,0.4269391057139534,3404,3352,Eastern Central Panhandle,Knox,48,275,Texas,TX
48345,48CS034,17,16,17,18,1,1,2,5,-14.905555401313752,-13.258176252028425,-11.60824383046955,2.057563846574043,20,20,21,31,11,10,11,2,7.677938952288868,8.240755172268926,8.72671564180127,0.1699062313912385,1075,1065,Eastern Central Panhandle,Motley,48,345,Texas,TX
48433,48CS034,19,19,20,25,6,5,6,6,-2.891280882966197,-1.2748378690556124,0.36808845054411815,0.9103892569951443,23,23,24,24,1,0,1,6,-4.790334711401503,-4.255596248251173,-3.739322324231217,3.3343164631623394,1255,1221,Eastern Central Panhandle,Stonewall,48,433,Texas,TX
48447,48CS034,18,18,18,15,-3,-3,-3,6,-25.612424426339015,-25.21995362042418,-24.825675425067754,-2.7784819298252463,23,22,23,23,0,0,1,8,-5.2378984446984225,-5.109646454071344,-4.981064119356155,5.699292284914894,1453,1487,Eastern Central Panhandle,Throckmorton,48,447,Texas,TX
48487,48CS034,151,146,157,182,31,25,36,38,-3.939981741683079,-2.2116209063360697,-0.5226569205999222,1.1885228379250572,185,178,191,198,13,7,20,37,-2.3775233167304886,-1.8665393938248056,-1.3363833428394225,2.5941414356301538,12812,12748,Eastern Central Panhandle,Wilbarger,48,487,Texas,TX
48135,48CS035,1070,999,1141,1393,323,252,394,268,-0.4198134250169076,1.3325146818873659,2.933782854450283,0.828027137272186,1295,1212,1379,1614,319,235,402,317,-0.48066555782569526,-0.017616319706723133,0.4877955774233594,0.9912172284403551,165119,161729,Ector,Ector,48,135,Texas,TX
48139,48CS036,1211,1127,1294,1420,209,126,293,184,-1.2025686162963038,0.5161251675379173,2.1861263623422724,0.8751216957686296,1545,1441,1649,1820,275,171,379,283,-0.5817027081117323,-0.047595002291150434,0.48087981273540803,1.0268456926313274,193761,201452,Ellis,Ellis,48,139,Texas,TX
48141,48CS037,4833,4462,5205,7370,2537,2165,2908,2091,0.3745341828866196,2.0862806737193504,3.859127337138195,0.8239083915815472,6026,5578,6474,7290,1264,816,1712,1193,-0.49662393731324966,0.09779671716737535,0.597112029629112,0.9431791469404445,862116,867677,El Paso,El Paso,48,141,Texas,TX
48145,48CS038,157,150,165,168,11,3,18,22,-4.334516074654433,-2.6866705617827873,-0.788622249913079,1.9076287737295472,195,186,204,245,50,41,59,38,0.19416730888570774,0.7081034240917637,1.2126406967533747,0.7398310222880216,17044,17262,Falls+Lee+Milam,Falls,48,145,Texas,TX
48287,48CS038,163,155,170,196,33,26,41,29,-0.9040739366729149,0.9901561741727591,2.743732902470294,0.8474292040964838,200,191,210,209,9,-1,18,27,-1.5626200065462368,-1.0508462027225616,-0.5463878638393697,2.8228385425821414,17491,17676,Falls+Lee+Milam,Lee,48,287,Texas,TX
48331,48CS038,249,238,259,256,7,-3,18,19,-3.5626171752556584,-1.922161322866621,-0.20537426416223684,2.3199015141203922,306,294,319,414,108,95,120,74,0.8090334016593901,1.3283826376795114,1.8669947292434546,0.6819683239043144,24763,25050,Falls+Lee+Milam,Milam,48,331,Texas,TX
48147,48CS039,395,380,411,427,32,16,47,65,-5.49880084267254,-3.7536779464737373,-1.9244275002505842,1.989232276389134,492,473,511,597,105,86,124,103,-0.44298705910519076,0.057009968078627064,0.5781606789690973,0.970754829248099,35793,36447,Fannin+Lamar+Red River,Fannin,48,147,Texas,TX
48277,48CS039,535,514,557,675,140,118,161,97,1.5752843576162665,3.4956084229470106,5.064194226538736,0.689752773583005,656,630,682,823,167,141,193,126,0.31504308754028953,0.824447502312397,1.3176465607342789,0.7488778820918421,50036,50095,Fannin+Lamar+Red River,Lamar,48,277,Texas,TX
48387,48CS039,156,151,161,213,57,52,62,28,8.050263793635787,9.816693715055333,11.617751722762728,0.4853480027933881,190,184,196,230,40,34,46,29,0.4151271215288454,0.9551641657778142,1.5028038162064403,0.7044285851630124,11630,11554,Fannin+Lamar+Red River,Red River,48,387,Texas,TX
48157,48CS040,3118,2761,3476,3864,746,388,1103,429,-0.09611548055071768,1.532696080991716,3.2649651745089496,0.5745529886305797,4031,3590,4472,4852,821,380,1262,640,-0.2899872684402227,0.2233350313330719,0.688953977665153,0.7789053334711717,829428,854167,Fort Bend,Fort Bend,48,157,Texas,TX
48161,48CS041,187,179,196,245,58,49,66,31,3.8236753573247055,5.380654488718986,7.369437741515368,0.5285972723890892,232,222,242,255,23,13,33,46,-1.6527076106225527,-1.1744789143808272,-0.6732299650488021,1.9380896309288997,19524,19726,Freestone+Leon+Limestone+Navarro,Freestone,48,161,Texas,TX
48289,48CS041,172,165,179,217,45,38,52,22,3.998897827307204,5.740424848747805,7.524858347039843,0.4771509608819063,211,202,219,274,63,55,72,38,1.0778328789685347,1.591980151719382,2.1054420614972367,0.5902333076782983,15998,15925,Freestone+Leon+Limestone+Navarro,Leon,48,289,Texas,TX
48293,48CS041,226,217,236,297,71,61,80,28,5.811067182090437,7.632418871599576,9.500150829008053,0.3913511586840073,276,265,288,399,123,111,134,78,1.5280569966209363,2.014968910557563,2.5151911318063247,0.629849462433433,22292,22117,Freestone+Leon+Limestone+Navarro,Limestone,48,293,Texas,TX
48349,48CS041,512,490,535,527,15,-8,37,74,-6.2573055988664334,-4.553522563426027,-2.803255051265866,4.73234183144788,638,610,666,685,47,19,75,136,-2.1820769593482856,-1.6558038213208186,-1.1650556187229066,2.8337861559799125,52459,53473,Freestone+Leon+Limestone+Navarro,Navarro,48,349,Texas,TX
48163,48CS042,129,121,137,157,28,20,36,21,-0.26938686238228965,1.461878686444983,3.0414350060364823,0.7340345309858526,159,150,169,223,64,54,73,57,-0.11501938239678879,0.3755087631068232,0.8859590930701129,0.8778157083418778,18641,18426,Frio+Medina+Uvalde+Zavala,Frio,48,163,Texas,TX
48325,48CS042,386,364,408,447,61,39,83,57,-1.4636355619056454,0.2622134195478528,1.7991191619790468,0.9216905590196917,483,456,510,587,104,77,131,120,-0.8219582243917598,-0.29667066610162923,0.22475911727611025,1.1426555181067322,51131,51826,Frio+Medina+Uvalde+Zavala,Medina,48,325,Texas,TX
48463,48CS042,202,192,213,281,79,68,89,40,4.47835562582827,6.155585379632858,7.855472794097153,0.5017866870220583,248,236,261,350,102,89,114,72,0.687117212261281,1.2016687678100473,1.699077833150272,0.7022999047124289,24888,24701,Frio+Medina+Uvalde+Zavala,Uvalde,48,463,Texas,TX
48507,48CS042,79,78,80,140,61,60,62,27,13.294428211581106,13.685751920826897,14.09774399672321,0.4351849336398511,93,92,94,149,56,55,57,26,2.99603316435553,3.123087192160576,3.241335195512794,0.45797827424395643,9954,9551,Frio+Medina+Uvalde+Zavala,Zavala,48,507,Texas,TX
48003,48CS043,117,116,119,128,11,9,12,32,-4.97269334138826,-4.606544032860631,-4.174973215807789,2.7643039906484805,143,141,146,158,15,12,17,35,-1.228551124639794,-1.10481792026541,-0.9780584664900538,2.2521470322175507,18625,18465,Gaines and Nearby Counties,Andrews,48,3,Texas,TX
48115,48CS043,124,119,129,169,45,40,50,52,-3.9184065742128746,-2.245011154764219,-0.5838891343285734,1.1296629492330739,151,145,157,166,15,9,21,31,-1.8021420336025722,-1.29708421100164,-0.7664971760847414,1.9448571064705698,12516,12417,Gaines and Nearby Counties,Dawson,48,115,Texas,TX
48165,48CS043,112,110,114,147,35,33,37,33,-0.053741981811169286,0.34238315533212665,0.7254513674518673,0.9200471297300252,140,137,142,176,36,34,39,40,-0.2825158813473019,-0.1718184813408912,-0.046977201792224386,1.070958421927131,21698,21867,Gaines and Nearby Counties,Gaines,48,165,Texas,TX
48305,48CS043,50,49,50,82,32,32,33,16,11.001825187654172,11.39466405450058,11.769851069757069,0.4829338727643129,61,61,62,85,24,23,24,14,1.5900857593022062,1.6998913091911843,1.8218610506863995,0.567716141002702,5666,5676,Gaines and Nearby Counties,Lynn,48,305,Texas,TX
48317,48CS043,41,40,41,56,15,15,16,17,-1.64929789932412,-1.2501463749966273,-0.8734518399741557,1.0400979019855499,49,48,50,52,3,2,4,2,0.054448053770963775,0.1820915244064371,0.3059855253120382,0.5043046857667206,5318,5217,Gaines and Nearby Counties,Martin,48,317,Texas,TX
48445,48CS043,123,118,129,155,32,26,37,44,-5.8901410483954315,-4.184710019613116,-2.4533475629569996,1.3508314479359016,150,144,156,148,-2,-8,4,26,-2.8900302396174573,-2.406745903144213,-1.8992892218239423,-23.975764064455333,11870,11760,Gaines and Nearby Counties,Terry,48,445,Texas,TX
48501,48CS043,50,49,50,81,31,31,32,22,4.402826947717523,4.784362099648538,5.173214441871657,0.680439630091752,60,59,61,78,18,17,19,13,0.5819399978277616,0.7049215391952485,0.8273906699130847,0.6725795464810064,7811,7616,Gaines and Nearby Counties,Yoakum,48,501,Texas,TX
48167,48CS044,2504,2353,2655,2863,359,208,510,220,-0.07709168304729844,1.5851872516148502,3.246476849135313,0.6104488266913705,3110,2927,3293,3687,577,394,760,474,-0.22136046730727948,0.30077327818580246,0.8246243250252812,0.8199255356838915,350387,354536,Galveston,Galveston,48,167,Texas,TX
48181,48CS045,1290,1232,1349,1533,243,184,301,192,-0.13232189914840578,1.4946255244617193,3.2674718688713384,0.787922192722489,1605,1534,1677,1971,366,294,437,339,-0.31865441224054525,0.18505812536674388,0.6961996725455015,0.9242210254516533,136379,138852,Grayson,Grayson,48,181,Texas,TX
48183,48CS046,1128,1074,1181,1404,276,223,330,175,1.6806122396261358,3.258722826244934,4.946811972229827,0.630763564524077,1384,1320,1448,1827,443,379,507,325,0.4292313375191367,0.9454947212133178,1.483518614704813,0.7323783825813969,124166,124197,Gregg,Gregg,48,183,Texas,TX
48187,48CS047,1041,967,1116,1169,128,53,202,119,-1.470031263755886,0.1654820999879152,1.8903566011549389,0.9234593569569542,1311,1220,1402,1617,306,215,397,249,-0.19518797416973419,0.332224368585781,0.8237224588338196,0.8105128316097832,172947,176526,Guadalupe,Guadalupe,48,187,Texas,TX
48199,48CS048,504,480,528,574,70,46,94,54,-0.687775154310875,1.1521279025146245,2.820453134100005,0.7601895677985342,623,594,653,806,183,153,212,162,-0.15346879196925278,0.3572508004206909,0.925965072025776,0.8814018190880724,56571,56872,Hardin,Hardin,48,199,Texas,TX
48201,48CS049,22991,20958,25025,28388,5397,3363,7430,3653,-0.1772248322842189,1.4600163849434602,3.1250084750744827,0.6767922158227888,28606,26165,31047,36171,7565,5124,10006,6096,-0.19276823921898728,0.3022504351900937,0.8182582093523575,0.8057000596644445,4728636,4728681,Harris,Harris,48,201,Texas,TX
48203,48CS050,585,556,615,669,84,54,113,84,-1.8589229465728005,-0.07874527242052637,1.7102229712164099,0.9917353441400987,721,685,756,945,224,189,260,159,0.41352271200842117,0.9633492343108292,1.4503566088525157,0.7051254879941354,68482,69096,Harrison+Upshur,Harrison,48,203,Texas,TX
48459,48CS050,403,385,421,474,71,53,89,49,0.6131450018289923,2.1837329629411375,3.84166259498616,0.679385383120838,498,476,519,659,161,140,183,137,0.060477646476186656,0.5966958756423636,1.127338056417524,0.8434380115695541,41165,41657,Harrison+Upshur,Upshur,48,459,Texas,TX
48209,48CS051,1093,988,1198,1140,47,-58,152,102,-2.717922328438538,-0.8964067606395569,0.6999060064273808,2.12527617848835,1415,1284,1546,1649,234,103,365,238,-0.5401868419451836,-0.006524575580052272,0.5358867895629561,1.013112581881109,243061,253707,Hays,Hays,48,209,Texas,TX
48213,48CS052,953,917,988,1130,177,142,213,99,2.0149202799470314,3.8401691848809545,5.539164191250665,0.5559367052669001,1175,1132,1218,1566,391,348,434,288,0.7260926588821042,1.2250779935036478,1.7443822508528044,0.7348493258324243,82555,83475,Henderson,Henderson,48,213,Texas,TX
48215,48CS053,3904,3529,4280,6443,2539,2163,2914,2013,0.6864513913437155,2.4650301321878842,4.222630118671537,0.7926448736479877,4917,4464,5371,6403,1486,1032,1939,1202,-0.163873908746858,0.31696220937862246,0.8458282280155228,0.8086013378654617,872326,879167,Hidalgo,Hidalgo,48,215,Texas,TX
48221,48CS054,651,624,678,767,116,89,143,74,0.9743310004572688,2.7258231386572866,4.393039927567164,0.6323593318411557,814,781,847,991,177,144,210,128,0.2594206338038266,0.752999428587036,1.2474262012731028,0.7207049723360981,62162,63891,Hood,Hood,48,221,Texas,TX
48063,48CS055,136,131,142,173,37,31,42,23,2.6452917735086685,4.318628309530792,6.085001019134408,0.6124306395801876,168,162,175,232,64,57,70,41,1.3162334404684715,1.8247199728901682,2.3857593349000497,0.6318002478743096,12559,12592,Hopkins and Nearby Counties,Camp,48,63,Texas,TX
48119,48CS055,59,59,60,79,20,19,20,1,13.788982355496952,14.214800681869603,14.641145455286557,0.048316782414979206,74,73,75,91,17,16,18,17,-0.13338064479790768,-0.015096927616511088,0.1244601960622199,0.9471240244100001,5263,5369,Hopkins and Nearby Counties,Delta,48,119,Texas,TX
48159,48CS055,100,99,102,137,37,35,38,14,8.210868914978528,8.633016796147745,9.028418935519682,0.3732499097480989,123,122,125,128,5,3,6,23,-1.8866167873733817,-1.7501192997400354,-1.6305752656930075,4.075742015999985,10432,10450,Hopkins and Nearby Counties,Franklin,48,159,Texas,TX
48223,48CS055,357,341,373,448,91,75,107,87,-1.296577226547316,0.41104258236140556,2.1544409857900506,0.9434544267864413,442,423,461,523,81,62,100,67,-0.15086899759948305,0.3909626530215337,0.8752788894844751,0.8140854760862374,36877,37150,Hopkins and Nearby Counties,Hopkins,48,223,Texas,TX
48449,48CS055,250,236,263,288,38,25,52,57,-4.171398533065623,-2.419291832361281,-0.843836492912491,1.4559030225505332,307,291,323,357,50,34,66,60,-0.8816268904682147,-0.3025253114966944,0.16907340205316596,1.1702816468267783,31471,31195,Hopkins and Nearby Counties,Titus,48,449,Texas,TX
48499,48CS055,550,531,570,644,94,74,113,77,-0.06412145438338152,1.486964756782153,3.3226059709970484,0.8128595767485943,681,658,705,912,231,207,254,155,1.118684752186791,1.651576997742979,2.176937193200197,0.6693720148305032,45189,45749,Hopkins and Nearby Counties,Wood,48,499,Texas,TX
48231,48CS056,863,819,906,981,118,75,162,97,-0.8413899591714388,0.914923389779764,2.5421135072716403,0.8121758102861736,1080,1027,1133,1303,223,170,276,244,-0.744652648383383,-0.2108862333475805,0.3504644764241413,1.089677439745592,100317,102933,Hunt,Hunt,48,231,Texas,TX
48237,48CS057,81,80,81,97,16,16,17,12,1.6443822631211342,2.063097446374557,2.468467852133781,0.6884905614668525,100,99,101,108,8,7,9,10,-0.33999408215752985,-0.21650368282176288,-0.101696285523841,1.0971187254688624,8581,8680,Jack+Palo Pinto+Young,Jack,48,237,Texas,TX
48363,48CS057,283,270,295,389,106,94,119,49,6.388795012058884,8.021857509708637,9.692310867678895,0.45660269484551524,346,331,361,457,111,96,126,83,0.48893153501362646,0.9706223958732165,1.4719361945400191,0.7403746624959486,28554,28648,Jack+Palo Pinto+Young,Palo Pinto,48,363,Texas,TX
48503,48CS057,212,204,220,272,60,52,68,30,5.089855144690332,6.750710196859186,8.479789883221848,0.4906883385751773,259,249,268,323,64,55,74,39,0.8752609569686446,1.401563411509407,1.9158768747928028,0.5977929818067268,17868,17957,Jack+Palo Pinto+Young,Young,48,503,Texas,TX
48239,48CS058,147,141,153,158,11,5,17,23,-4.997661415770212,-3.204680530910285,-1.493694687197941,1.9211083260171045,181,173,189,170,-11,-19,-3,28,-3.074659495561744,-2.5942834968222397,-2.048522818077899,-2.8120394444417305,14978,15103,Jackson+Matagorda+Wharton,Jackson,48,239,Texas,TX
48321,48CS058,340,325,356,408,68,52,83,67,-1.6640499650356828,0.06033225369364405,1.6288830971385173,0.9750722966753093,416,398,435,467,51,32,69,95,-1.7499528051113253,-1.2167053355417605,-0.7271948086190806,1.8416222659610726,36333,36333,Jackson+Matagorda+Wharton,Matagorda,48,321,Texas,TX
48481,48CS058,367,349,385,465,98,80,116,77,0.12645593550434225,1.9922155774423493,3.858964256386057,0.7786424911865654,451,429,472,568,117,96,139,116,-0.48712237264644376,0.04792054614061015,0.5644850595713258,0.9806964062535064,41585,41696,Jackson+Matagorda+Wharton,Wharton,48,481,Texas,TX
48241,48CS059,348,333,362,447,99,85,114,53,3.953142275915463,5.532686091325881,7.325184145446146,0.5283545898315787,422,405,440,604,182,164,199,122,1.2733830950296225,1.7999972757339662,2.298229610922866,0.668453671284879,33303,32964,Jasper+Newton,Jasper,48,241,Texas,TX
48351,48CS059,128,123,133,174,46,41,51,19,7.087027804918656,8.779692941104392,10.486420710802793,0.4028468104782454,155,149,162,231,76,69,82,45,2.009734611991899,2.5114044695210107,3.0239545784823236,0.5865376031801958,12391,12230,Jasper+Newton,Newton,48,351,Texas,TX
48245,48CS060,2130,2021,2240,2570,440,330,549,271,0.9506687192509999,2.6491850930772656,4.297687322435461,0.615042071544312,2598,2467,2729,3168,570,439,701,474,-0.1722701593728674,0.3676278245294976,0.9320089835633789,0.8302265957362303,255062,254036,Jefferson,Jefferson,48,245,Texas,TX
48251,48CS061,1325,1247,1403,1556,231,153,309,175,-0.451355430636773,1.2506354080144848,2.8600097420006154,0.7539459651692285,1677,1581,1773,2034,357,261,453,388,-0.6957335358669419,-0.1553108431120055,0.33236883396754097,1.0835044235322409,180724,186325,Johnson,Johnson,48,251,Texas,TX
48257,48CS062,999,936,1062,1078,79,16,142,132,-3.2321618780597507,-1.4631770975110063,0.3471950553045272,1.650271775060047,1305,1224,1385,1466,161,81,242,261,-1.17807186789,-0.6359135655734224,-0.10536395359451338,1.6079100364321899,146574,156196,Kaufman,Kaufman,48,257,Texas,TX
48261,48CS063,3,3,4,5,2,1,2,5,-40.02161570195816,-38.37763732080138,-36.617251746428146,1.8985283096045946,4,4,4,5,1,1,1,5,-12.38370558858589,-11.875707777480565,-11.34795148421549,2.565272298968155,351,341,Kenedy+Kleberg+Willacy,Kenedy,48,261,Texas,TX
48273,48CS063,243,230,257,295,52,38,65,62,-3.097175321493811,-1.4257024986215538,0.47690395844885813,1.1797982808972467,299,283,315,333,34,18,50,69,-1.667817898225283,-1.144712129058181,-0.6072115184575042,1.988800615237792,30858,30682,Kenedy+Kleberg+Willacy,Kleberg,48,273,Texas,TX
48489,48CS063,149,140,158,222,73,64,82,64,0.07170943728899079,1.8319999023730937,3.2908503853360758,0.8659445089624821,185,175,196,228,43,32,53,46,-0.6482872466956837,-0.1488394407897932,0.3847699619948074,1.0495761685038827,20316,20289,Kenedy+Kleberg+Willacy,Willacy,48,489,Texas,TX
48089,48CS064,212,203,221,260,48,39,57,16,4.412669582360874,6.1392706250660565,7.940582005037113,0.3268195866112972,258,247,269,343,85,74,96,41,1.6075278481753892,2.1360583371676296,2.6167336644703036,0.4770840868375599,20704,20621,Lavaca and Nearby Counties,Colorado,48,89,Texas,TX
48123,48CS064,220,211,228,259,39,31,48,50,-3.8392927435204705,-2.1724378550931265,-0.38538443542687645,1.2426981970294444,268,258,279,289,21,10,31,38,-1.3854115272010827,-0.8587016394144228,-0.369439136801163,1.7492580157131856,19864,19902,Lavaca and Nearby Counties,DeWitt,48,123,Texas,TX
48149,48CS064,260,249,271,323,63,52,74,39,2.200749391250146,3.894791350715911,5.618043870681406,0.609690761818735,318,305,331,391,73,60,86,52,0.36127213932643654,0.8622539548215633,1.3891835936845265,0.7030342032949484,24601,24653,Lavaca and Nearby Counties,Fayette,48,149,Texas,TX
48177,48CS064,170,162,179,222,52,43,60,24,3.7883612404792113,5.563087747905588,7.216742803760186,0.45638239938156405,207,197,217,272,65,55,75,63,-0.44706358207435437,0.07681821064969675,0.603600080866103,0.9559834397758871,19833,19643,Lavaca and Nearby Counties,Gonzales,48,177,Texas,TX
48285,48CS064,221,212,230,274,53,44,62,48,-0.8508766670810864,0.9676236199599644,2.7071324712125624,0.8928826119087568,272,261,282,296,24,14,35,38,-1.1653455945321256,-0.6763042037107608,-0.13325157853566036,1.495947233764531,20333,20514,Lavaca and Nearby Counties,Lavaca,48,285,Texas,TX
48303,48CS065,2220,2086,2354,3014,794,660,928,616,0.48236004507114916,2.2833041313371303,3.92235176403075,0.7751520512088207,2756,2594,2918,3346,590,428,752,519,-0.32226576225475756,0.22514591657913616,0.7542290662591634,0.8781425347914739,311686,314009,Lubbock,Lubbock,48,303,Texas,TX
48309,48CS066,1922,1809,2034,2338,416,304,529,304,0.007479784408253068,1.7308381332872391,3.4576366111564383,0.7283415536620452,2382,2246,2518,2941,559,423,695,462,-0.13957778011916067,0.38711322820685024,0.9070163688279159,0.8250200960252586,260666,262810,McLennan,McLennan,48,309,Texas,TX
48313,48CS067,129,123,135,140,11,5,17,21,-4.600528168848828,-2.866233281685707,-0.9684615831705069,1.711166356862252,159,152,166,177,18,11,25,30,-1.3991697361147164,-0.8714026871156108,-0.40062048832873215,1.5836961250551018,13610,13678,Madison+Trinity+Walker,Madison,48,313,Texas,TX
48455,48CS067,194,188,200,216,22,16,28,12,1.178127699670323,2.873536002652089,4.5940357838769375,0.5221108994991331,237,230,244,326,89,82,96,48,2.4453591270426247,2.9713829409934904,3.4463632969783062,0.5338817971726931,13798,13797,Madison+Trinity+Walker,Trinity,48,455,Texas,TX
48471,48CS067,490,458,523,579,89,56,121,93,-1.913632857031507,-0.2198800300188638,1.505231242684983,1.03748771985787,618,578,658,711,93,53,133,105,-0.6773050115382768,-0.1356099824150857,0.3612522887194735,1.1179415544681193,75986,77768,Madison+Trinity+Walker,Walker,48,471,Texas,TX
48031,48CS068,111,109,112,111,0,-1,2,7,-2.6957284358819456,-2.2966867912893068,-1.9047144988103193,5.030389689728437,139,138,141,157,18,16,19,22,-0.49161720514632806,-0.3567404203012188,-0.23179417752602774,1.172034884643579,11574,11823,Menard and Nearby Counties,Blanco,48,31,Texas,TX
48081,48CS068,45,44,46,55,10,9,11,10,-1.683117718537595,-0.08415308846721357,1.6990214298990027,0.9111595611908745,55,53,57,69,14,12,16,7,1.5069887837151787,2.0366306448142377,2.522322926751155,0.47328025648378585,3296,3316,Menard and Nearby Counties,Coke,48,81,Texas,TX
48095,48CS068,29,29,29,28,-1,-1,-1,4,-6.462987926104739,-6.031580964320334,-5.62915249409646,32.412876746517945,37,36,37,34,-3,-3,-2,7,-3.0385216507991357,-2.908656434522196,-2.780948994058779,-4.0860587084503415,3238,3338,Menard and Nearby Counties,Concho,48,95,Texas,TX
48137,48CS068,20,19,21,28,8,7,9,8,-1.4102249299941931,0.17197370273791296,1.8299640938079351,0.8835993415267711,24,23,25,31,7,6,8,0,4.465798858633301,4.978479302522764,5.484718310649112,0,1490,1434,Menard and Nearby Counties,Edwards,48,137,Texas,TX
48171,48CS068,306,295,318,329,23,11,34,25,-2.195608505523954,-0.38654053168842506,1.3303069830272405,1.0637625544799731,380,366,394,417,37,23,51,58,-1.2797537343605314,-0.7639593971096241,-0.25187213669918096,1.5245112719551843,26819,27215,Menard and Nearby Counties,Gillespie,48,171,Texas,TX
48173,48CS068,12,12,12,6,-6,-6,-6,6,-41.36774095488837,-40.966835336426534,-40.5599321110762,-1.2191137485427301,14,14,15,12,-2,-3,-2,2,-4.005757151965335,-3.873939133308111,-3.760589611602663,-1.4006289579293885,1164,1144,Menard and Nearby Counties,Glasscock,48,173,Texas,TX
48235,48CS068,12,11,12,14,2,2,3,2,0.5226036846406609,0.9152303150448229,1.313827427274113,0.59705050050859,15,14,15,24,9,9,10,5,2.740889842228117,2.871954121270081,2.987743898859567,0.47877663854357355,1531,1548,Menard and Nearby Counties,Irion,48,235,Texas,TX
48267,48CS068,50,49,50,51,1,1,2,4,-2.888498149436212,-2.454568547373328,-2.0508523650622785,1.6912720456797026,62,61,62,63,1,1,2,1,-0.057829537795502955,0.07571541526361117,0.20152376764691077,0.4321663535989384,4308,4354,Menard and Nearby Counties,Kimble,48,267,Texas,TX
48307,48CS068,87,87,88,109,22,21,22,12,4.682855869622425,5.091299044616594,5.491372880900408,0.5285516380420019,106,105,107,166,60,59,61,28,4.10603949335741,4.236127754514382,4.368071410802768,0.459578255827096,7628,7538,Menard and Nearby Counties,McCulloch,48,307,Texas,TX
48319,48CS068,41,41,42,39,-2,-3,-2,6,-8.595718055308335,-8.171503809931004,-7.765350014075376,-4.997781138967722,50,49,50,67,17,17,18,6,2.6793981483834375,2.806529265146202,2.9361337339887243,0.3320336091452871,4009,3946,Menard and Nearby Counties,Mason,48,319,Texas,TX
48327,48CS068,27,26,28,33,6,5,7,6,-1.856141096008225,-0.1852991657920819,1.4904419635561792,0.8700603547043992,33,32,34,38,5,4,6,6,-1.0290562811360862,-0.49137592047210615,0.03833713797445902,0.9952277109070167,1991,1980,Menard and Nearby Counties,Menard,48,327,Texas,TX
48383,48CS068,23,22,23,28,5,5,6,7,-2.1792527116680893,-1.78276162823627,-1.3910509141707241,1.0830184101129101,27,26,27,32,5,5,6,5,-0.02235107866528992,0.10894808004300653,0.24204092316517486,0.7850438530222366,3431,3271,Menard and Nearby Counties,Reagan,48,383,Texas,TX
48385,48CS068,36,35,36,64,28,28,29,12,22.383966107203328,22.773927371697837,23.16565473719743,0.41015082294934163,43,43,44,63,20,19,20,11,2.9807677871601257,3.1101955978043874,3.2306978894701657,0.5303681094022004,2856,2814,Menard and Nearby Counties,Real,48,385,Texas,TX
48399,48CS068,127,123,132,137,10,5,14,20,-5.9722957247386,-4.183129233602518,-2.507856070808607,1.8831233942293166,155,150,160,190,35,30,40,36,-0.6167135395368352,-0.1176709018075085,0.4199816282735783,1.0036281267662608,9973,9940,Menard and Nearby Counties,Runnels,48,399,Texas,TX
48411,48CS068,58,57,59,83,25,24,26,15,6.504690017152352,6.87371505031688,7.257576983639878,0.5784471126543616,72,71,73,90,18,17,19,14,0.5710512463645908,0.7040594054716518,0.8327715624014259,0.7333190705320974,5781,5813,Menard and Nearby Counties,San Saba,48,411,Texas,TX
48413,48CS068,21,21,21,25,4,4,4,8,-6.786768944322598,-6.395706304382816,-5.9773743977115705,1.5934327360448155,25,25,26,33,8,7,8,2,2.233757985360019,2.3586200518954583,2.4964288272202655,0.22864833267273493,2493,2431,Menard and Nearby Counties,Schleicher,48,413,Texas,TX
48431,48CS068,13,13,13,13,0,0,0,7,-20.17997094930876,-19.804894219389087,-19.40297018904337,5.7668668503036296,16,16,16,16,0,-0,0,3,-2.2147023220727626,-2.095599275685021,-1.9628692347004453,2.7064289300922377,1370,1381,Menard and Nearby Counties,Sterling,48,431,Texas,TX
48435,48CS068,25,25,25,38,13,13,13,3,11.413883048022816,11.811983355589671,12.237901252665818,0.21278441986084726,30,30,30,47,17,17,17,4,3.7896376396195675,3.91433112207867,4.053618596497551,0.22186145733282908,3418,3325,Menard and Nearby Counties,Sutton,48,435,Texas,TX
48329,48CS069,967,894,1041,1106,139,65,212,200,-3.1224864340243,-1.4233838425562997,0.3539091558651709,1.4313118572739285,1182,1095,1269,1403,221,134,308,233,-0.579165723315631,-0.05631211746297723,0.4630315078789992,1.04805911014135,170894,168297,Midland,Midland,48,329,Texas,TX
48339,48CS070,3578,3308,3847,4026,448,179,718,290,-0.7160013366002318,1.0581518007906714,2.733471116070166,0.6456095822726765,4558,4224,4891,5406,848,515,1182,850,-0.5387668050254953,0.0024678058159989355,0.5324367966653144,1.000644320785601,624902,645394,Montgomery,Montgomery,48,339,Texas,TX
48347,48CS071,492,465,520,635,143,115,170,103,0.6586201309205858,2.436684612049117,4.097450844247867,0.7170602964014325,606,573,640,789,183,149,216,128,0.37183302596206325,0.83466013929495,1.3801156659957277,0.6962804131869618,64661,64662,Nacogdoches,Nacogdoches,48,347,Texas,TX
48087,48CS072,30,29,31,43,13,12,14,4,11.91471436745242,13.573677405845714,15.240280228483844,0.28387736556925697,36,35,37,42,6,5,7,8,-1.3226697531386626,-0.800503682262604,-0.27699264610621877,1.1566271161120525,2675,2618,Northeast Panhandle,Collingsworth,48,87,Texas,TX
48179,48CS072,218,209,227,245,27,18,36,41,-4.3704732672525095,-2.59304017238821,-0.942058539818708,1.4696895985038223,265,255,276,349,84,73,94,63,0.45722542790673876,0.9718881437756656,1.4947801761549355,0.7451091218510447,21261,21052,Northeast Panhandle,Gray,48,179,Texas,TX
48195,48CS072,41,41,42,50,9,8,9,19,-8.154192172783544,-7.761608849979635,-7.353467908082285,1.936342448208697,50,49,50,61,11,11,12,10,0.12128182652491952,0.24296406234983992,0.36732406998608746,0.8154917246072976,5263,5173,Northeast Panhandle,Hansford,48,195,Texas,TX
48211,48CS072,26,26,27,20,-6,-7,-6,4,-12.372895359773697,-11.98555565701879,-11.601455203743727,-0.7586352064649002,31,31,31,24,-7,-7,-7,6,-4.076155239036721,-3.9484791597137305,-3.824643447941372,-1.0060114140824765,3425,3285,Northeast Panhandle,Hemphill,48,211,Texas,TX
48295,48CS072,22,22,22,34,12,12,12,2,12.492350507905016,12.92119704612827,13.330357778397893,0.1554140878628277,26,26,27,40,14,13,14,2,3.864300003758085,3.986388237832544,4.112828007970597,0.13557845846101294,3056,2947,Northeast Panhandle,Lipscomb,48,295,Texas,TX
48357,48CS072,63,62,64,93,30,29,31,20,3.580208079585932,3.999996532194473,4.437715002277738,0.6461618670588001,77,76,78,90,13,12,14,24,-1.2297555799785833,-1.0938092722019508,-0.9732729700311757,1.6858520322873765,9920,9808,Northeast Panhandle,Ochiltree,48,357,Texas,TX
48393,48CS072,9,9,10,12,3,2,3,1,6.973850164234231,8.56952307672156,10.242213159008294,0.26605496562862785,11,11,11,1,-10,-10,-10,1,-14.296000536460541,-13.777876418155744,-13.241576717557733,-0.11063416649219122,822,801,Northeast Panhandle,Roberts,48,393,Texas,TX
48483,48CS072,52,51,52,62,10,10,11,11,-1.1486316334111237,-0.7526366266845562,-0.3560291192005527,0.9943441024183424,63,62,64,92,29,28,30,5,4.732195563429417,4.851539145617882,4.974761280411392,0.16699666215361633,4981,4935,Northeast Panhandle,Wheeler,48,483,Texas,TX
48065,48CS073,49,49,50,80,31,30,31,12,12.441653886807117,12.840345472499427,13.25642505875169,0.3790389194461691,60,59,60,84,24,24,25,13,1.8350046997878067,1.961664288298831,2.0857042487564392,0.5143553255901662,5810,5755,Northwest Panhandle,Carson,48,65,Texas,TX
48111,48CS073,37,36,38,68,31,30,32,14,9.040613786000579,9.405189572292626,9.81057467836701,0.4399828689410565,46,45,47,79,33,32,34,2,4.229779920077926,4.370622697266938,4.49415108607659,0.058326144237211414,7142,7164,Northwest Panhandle,Dallam,48,111,Texas,TX
48205,48CS073,37,36,37,48,11,11,12,11,-0.048203686247835574,0.36520273891182714,0.7642553426830324,0.8804112690805491,45,44,45,45,0,-0,1,4,-0.8125547464787748,-0.6881760673216906,-0.5630146343015098,3.0948836108211104,5387,5392,Northwest Panhandle,Hartley,48,205,Texas,TX
48233,48CS073,209,200,218,274,65,56,74,56,-0.03296993677968321,1.783976204078285,3.4215362314733713,0.8478774980053193,255,244,265,347,92,82,103,64,0.8789727701412113,1.3667506727071963,1.9043639986915282,0.6869401196014312,20587,20501,Northwest Panhandle,Hutchinson,48,233,Texas,TX
48341,48CS073,145,136,154,175,30,21,39,63,-7.947137301914764,-6.128105739114136,-4.474312089723978,2.0167804020279325,178,167,189,190,12,1,23,35,-1.6392656241054475,-1.0877962218263608,-0.5953818610174264,2.7021359707812707,21207,21141,Northwest Panhandle,Moore,48,341,Texas,TX
48359,48CS073,12,12,12,17,5,5,5,2,6.0183901602891154,6.422556063175475,6.820280255717759,0.3386522228040146,14,14,14,19,5,5,5,1,2.1292330449968593,2.2643504231797387,2.38878014249665,0.16966132078667615,1808,1723,Northwest Panhandle,Oldham,48,359,Texas,TX
48421,48CS073,21,20,21,27,6,6,7,12,-8.520550843136704,-8.126780260404828,-7.719837869362394,1.6484501283732462,25,25,26,33,8,7,8,7,0.18071283337705846,0.3003910958200234,0.4312552179166997,0.79099580117622,2816,2795,Northwest Panhandle,Sherman,48,421,Texas,TX
48355,48CS074,2465,2313,2617,3260,795,643,947,510,1.3600105511899216,3.1976651249460457,4.9946203630287895,0.6405966221999271,3029,2846,3211,4047,1018,836,1201,621,0.5549992243378327,1.1350322241316975,1.64468858370698,0.6092164531897903,354439,353081,Nueces,Nueces,48,355,Texas,TX
48361,48CS075,840,804,877,977,137,100,173,75,1.179318688422867,2.9321292012700932,4.66264318329904,0.5447991634496251,1029,985,1073,1234,205,161,249,234,-0.8304689278340319,-0.3333349982372572,0.16494713900424715,1.135712632737874,84470,84736,Orange,Orange,48,361,Texas,TX
48365,48CS076,227,218,237,333,106,96,115,45,9.039180837762972,10.737391631759857,12.370493733756351,0.42158794391388416,278,267,290,368,90,78,101,74,0.17344206751897728,0.6881605185918716,1.2013643906965592,0.8159520887332876,22616,22651,Panola+Sabine+San Augustine+Shelby,Panola,48,365,Texas,TX
48403,48CS076,142,138,146,156,14,10,18,16,-2.554434601497992,-0.8487859924790934,0.8339491371740944,1.0777855914041627,174,169,179,258,84,79,89,52,2.7233617483098422,3.2113984882162354,3.732242595114606,0.6101894196919246,9986,10016,Panola+Sabine+San Augustine+Shelby,Sabine,48,403,Texas,TX
48405,48CS076,104,103,105,149,45,44,46,28,8.06678853741281,8.492565765729085,8.886476389493016,0.6097712880158477,127,126,128,190,63,62,64,13,6.230062588784914,6.358852029420124,6.472773974739925,0.20201425229589617,7963,7922,Panola+Sabine+San Augustine+Shelby,San Augustine,48,405,Texas,TX
48419,48CS076,237,227,247,295,58,48,68,44,0.7244834676078771,2.277358430257972,4.107692397312919,0.7473353245946831,288,276,301,386,98,85,110,75,0.455706481334416,0.9596338933933429,1.4758862915914992,0.760184520740078,24127,23937,Panola+Sabine+San Augustine+Shelby,Shelby,48,419,Texas,TX
48367,48CS077,1100,1036,1165,1222,122,57,186,109,-1.2909807501710744,0.3564909656207419,2.204071804105489,0.8873719876722004,1406,1325,1486,1614,208,128,289,287,-1.0258455595510467,-0.502552960835281,0.018575734931798107,1.3724480351714665,149279,155695,Parker,Parker,48,367,Texas,TX
48373,48CS078,580,558,602,719,139,117,161,66,4.053328749697763,5.738670152779547,7.368459978150741,0.4716762020067104,719,692,745,961,242,216,269,163,1.0634347530137571,1.5142807706515213,2.0227316802307875,0.669923599195751,50759,51696,Polk+San Jacinto+Tyler,Polk,48,373,Texas,TX
48407,48CS078,268,256,280,323,55,43,67,24,2.856145715924963,4.523471487059098,6.115877514888866,0.42740568345029073,329,314,343,482,153,139,168,79,2.220428506946047,2.6676390275947055,3.1643912559894285,0.5115061702020741,27726,27820,Polk+San Jacinto+Tyler,San Jacinto,48,407,Texas,TX
48457,48CS078,218,209,226,272,54,46,63,17,5.7206851463261055,7.410899135235278,9.006018617024425,0.307381417094571,266,255,276,410,144,134,155,60,3.675123758748656,4.195015493826571,4.69963564224376,0.4129392863609062,20078,20036,Polk+San Jacinto+Tyler,Tyler,48,457,Texas,TX
48375,48CS079,1049,998,1099,1402,353,303,404,299,0.18006129416988184,1.8371388360621481,3.568043225224774,0.8435291091389975,1278,1218,1338,1579,301,241,361,269,-0.2361613930727524,0.2922999584224557,0.7707299942381223,0.8904894389740431,117806,116784,Potter,Potter,48,375,Texas,TX
48379,48CS080,147,142,152,170,23,18,28,20,-0.5829208915831836,1.0400619336411863,2.694170787785516,0.8292869821060226,181,175,188,205,24,17,30,32,-1.1516691982831073,-0.6508080770614441,-0.15203382651692457,1.2997053230706945,12261,12464,Rains+Van Zandt,Rains,48,379,Texas,TX
48467,48CS080,590,564,615,698,108,83,134,71,0.7453188480646663,2.4582815195529966,4.1211345490352045,0.6504205966090528,735,703,766,983,248,217,280,174,0.7173786036207507,1.2293211957863899,1.7286961839903061,0.6984005135691577,59425,61044,Rains+Van Zandt,Van Zandt,48,467,Texas,TX
48381,48CS081,955,894,1016,1200,245,184,306,206,-0.6558965752923774,1.053936457866625,2.8745271583720586,0.8381868922786228,1195,1121,1269,1476,281,207,355,218,-0.04121644404339278,0.4439734277266866,0.9795670310151615,0.7724556348711391,141000,143471,Randall,Randall,48,381,Texas,TX
48397,48CS082,583,536,630,632,49,2,96,54,-1.7478575676380326,-0.16471239051809933,1.4663945120708095,1.078524931291092,762,702,821,877,115,56,175,168,-0.9503402466497217,-0.45702274454831426,0.1005936597307451,1.44555632700812,109233,115318,Rockwall,Rockwall,48,397,Texas,TX
48401,48CS083,450,428,473,577,127,104,149,76,2.1529938295357787,3.849144712112864,5.463378026589645,0.5960367054820837,554,527,581,767,213,186,240,151,0.6486792133970646,1.1909601249151005,1.6935062428051897,0.7059973365345399,52594,52667,Rusk,Rusk,48,401,Texas,TX
48409,48CS084,557,527,586,661,104,75,134,98,-1.383278187923774,0.3431561707880201,2.0977534917389375,0.9308287312852106,692,656,728,881,189,153,225,195,-0.5643407139882411,-0.09067714980958677,0.44834654613731467,1.0246883118552388,68560,69564,San Patricio,San Patricio,48,409,Texas,TX
48033,48CS085,8,8,8,7,-1,-1,-1,7,-52.219611325150126,-51.82105873698602,-51.444840226973106,-22.9335211295904,10,10,10,3,-7,-7,-7,3,-15.968649394072807,-15.842346344272277,-15.706675400566139,-0.515240076610313,641,620,Scurry and Nearby Counties,Borden,48,33,Texas,TX
48151,48CS085,38,36,40,59,21,19,23,12,8.198119690457569,9.777113099896008,11.428309247116678,0.5447466528327105,47,45,49,66,19,17,21,13,1.1833026625945882,1.7246285899408604,2.230799926928945,0.6380115553148645,3699,3702,Scurry and Nearby Counties,Fisher,48,151,Texas,TX
48169,48CS085,38,38,39,53,15,14,15,15,-0.5334656503556116,-0.11936328668361822,0.269617098515581,0.9479045161051644,47,46,47,64,17,17,18,11,0.9482677106937044,1.0779161128178365,1.2133897451122129,0.6010517096768867,5866,5853,Scurry and Nearby Counties,Garza,48,169,Texas,TX
48227,48CS085,311,296,326,414,103,88,118,85,0.34197534237416494,2.0383356447778795,3.6761729326762906,0.8200787913618469,375,358,393,458,83,65,100,70,-0.14411249301331305,0.37368093859158796,0.8870443843545586,0.8370941051329387,35010,34226,Scurry and Nearby Counties,Howard,48,227,Texas,TX
48263,48CS085,12,11,12,16,4,4,5,7,-13.801685482122387,-13.40271598414753,-12.98609388355448,1.2820100547822857,14,14,14,20,6,6,6,3,3.9483570684987948,4.075588016586992,4.21150273918286,0.4253564036466102,758,750,Scurry and Nearby Counties,Kent,48,263,Texas,TX
48335,48CS085,84,83,85,76,-8,-9,-7,16,-11.090469187545857,-10.71906487368686,-10.32310800545403,-2.35682418766691,105,103,106,109,4,3,6,27,-2.6339243921919326,-2.4969959744847805,-2.3605257325991085,4.995961414499699,8874,9058,Scurry and Nearby Counties,Mitchell,48,335,Texas,TX
48353,48CS085,162,156,168,202,40,34,46,32,0.43900536892247694,2.1250026273793448,3.9118815104275657,0.7813321384743996,197,189,204,214,17,10,25,51,-2.8396856347013575,-2.3053621806814757,-1.7542211158412402,2.8107373508443083,14724,14615,Scurry and Nearby Counties,Nolan,48,353,Texas,TX
48415,48CS085,150,143,157,201,51,44,58,38,1.4713727369848517,3.1016147746334726,4.862897446541459,0.7277154560502513,183,175,192,223,40,31,48,55,-1.4112047051133243,-0.9273720987039693,-0.40570625542712274,1.3561933919634082,16880,16840,Scurry and Nearby Counties,Scurry,48,415,Texas,TX
48423,48CS086,1862,1762,1963,2318,456,355,556,286,1.104552016363833,2.9177790273822826,4.733247764370405,0.6263112846904031,2310,2187,2432,2977,667,545,790,531,0.0714068506019347,0.5531592004679924,1.1215550361320972,0.7944811200672485,234221,236731,Smith,Smith,48,423,Texas,TX
48427,48CS087,380,373,386,641,261,255,268,210,2.7354245889250652,3.1228134257178217,3.545225323077641,0.8001943179555309,471,462,479,632,161,153,170,126,0.40269377890888264,0.5342300389503574,0.6527351669896344,0.7769855682050507,65633,66018,Starr,Starr,48,427,Texas,TX
48439,48CS088,11529,10620,12439,13952,2423,1513,3332,1732,-0.5608672945497136,1.2581694477155694,3.071961655849437,0.7145951548821609,14368,13271,15465,17727,3359,2262,4456,2929,-0.2925896642487,0.19472404459305234,0.7427131037732633,0.8716594449850454,2113977,2124761,Tarrant,Tarrant,48,439,Texas,TX
48441,48CS089,1235,1174,1297,1390,155,93,216,218,-3.4974600877767386,-1.817601172836538,-0.05521087427914007,1.4013655056945138,1521,1447,1595,1838,317,243,391,391,-1.0218598721127188,-0.5154757199468821,-0.009464806739379349,1.2305632002260838,142613,143334,Taylor,Taylor,48,441,Texas,TX
48451,48CS090,928,876,979,1222,294,243,346,190,1.8639603905424613,3.4714683558358566,5.0794207408437595,0.6435333498486064,1139,1077,1201,1456,317,255,379,211,0.38499107141754924,0.890566497619214,1.3994066602111817,0.6631313004912799,119934,119512,Tom Green,Tom Green,48,451,Texas,TX
48453,48CS091,5142,4585,5699,5943,801,244,1358,586,-1.06522016899229,0.6302442124179696,2.385913317420273,0.7304396634480643,6490,5817,7163,7382,892,219,1565,874,-0.5067914572908009,0.015127441774669024,0.5284106695379115,0.9790161636650786,1293757,1303834,Travis,Travis,48,453,Texas,TX
48469,48CS092,705,666,744,906,201,162,240,129,1.3677965346196537,3.148773573247817,4.872989492973866,0.6384564149870414,864,817,911,1117,253,206,300,231,-0.2572594425112121,0.2456812870106253,0.7132586570904097,0.9090790681424361,91322,91004,Victoria,Victoria,48,469,Texas,TX
48479,48CS093,1176,1061,1291,1897,721,606,836,526,1.1434803403038811,2.900750616984247,4.636079161890898,0.7283818250196707,1467,1329,1605,1973,506,368,644,423,-0.19158104871403497,0.317390517490493,0.7917752581417302,0.8341681216427915,268643,267841,Webb,Webb,48,479,Texas,TX
48017,48CS094,49,49,50,59,10,9,10,14,-2.9010994581987237,-2.4918280192148186,-2.072602541832629,1.303900275918402,60,60,61,81,21,20,21,19,0.0876147809997166,0.21787047197699658,0.34506685345028665,0.8828462712665321,6856,6838,Western Central Panhandle,Bailey,48,17,Texas,TX
48069,48CS094,51,51,52,75,24,23,24,24,-0.5137908221179729,-0.13345776043236254,0.24285613577940018,0.9696873844971737,63,62,64,96,33,32,34,19,1.757386139131721,1.8768152312186206,2.008182508489077,0.5614912026100132,7362,7369,Western Central Panhandle,Castro,48,69,Texas,TX
48079,48CS094,21,21,22,34,13,12,13,10,3.577220577337006,4.008513785735428,4.415782415838247,0.7356576737039956,26,25,26,45,19,19,20,10,3.6107781553171567,3.730729925352312,3.873829435373,0.48991767349054416,2593,2522,Western Central Panhandle,Cochran,48,79,Texas,TX
48117,48CS094,138,130,146,173,35,27,43,60,-7.053241434864678,-5.3269629405699925,-3.690533367086156,1.6509264136206891,169,160,179,216,47,37,56,41,-0.18522555557508305,0.3141760863224791,0.8689704840654027,0.8554582970073327,18493,18354,Western Central Panhandle,Deaf Smith,48,117,Texas,TX
48219,48CS094,177,167,186,285,108,99,118,91,1.5587769035479886,3.246787758155323,4.801103619365931,0.8312424565319826,215,204,227,294,79,67,90,58,0.4737177239592182,0.9533160504076451,1.4606030892226203,0.7295314357283267,21705,21382,Western Central Panhandle,Hockley,48,219,Texas,TX
48279,48CS094,140,134,146,194,54,48,60,67,-5.612329548125988,-4.0414910526849015,-2.190777372789712,1.2193549835779172,171,164,178,173,2,-5,9,28,-2.5115870317292925,-2.016414287464413,-1.4767856977844767,9.019414055783043,12963,12911,Western Central Panhandle,Lamb,48,279,Texas,TX
48369,48CS094,67,66,68,105,38,37,39,36,0.448354919911406,0.8639997355056751,1.245471060072717,0.9198082080055214,82,81,84,103,21,19,22,10,0.9538937202877037,1.0685596280133207,1.1885793688646904,0.4645800171479081,9804,9819,Western Central Panhandle,Parmer,48,369,Texas,TX
48043,48CS095,77,76,78,81,4,3,5,12,-3.6033309177088455,-3.1722418836710418,-2.7846190026729514,2.2002785145296393,95,93,96,108,13,12,15,14,-0.1877009509448987,-0.05860692614936689,0.06908756771105966,0.9692640099742125,9492,9467,"West Texas, excluding El Paso",Brewster,48,43,Texas,TX
48103,48CS095,32,32,33,39,7,6,7,4,1.8298841246038375,2.2350072774052,2.645613070367876,0.5239466950703464,40,40,41,48,8,7,8,10,-0.5818993484263897,-0.46245595667052763,-0.33572076543541046,1.1327215185962045,4683,4678,"West Texas, excluding El Paso",Crane,48,103,Texas,TX
48109,48CS095,18,17,18,27,9,9,10,2,13.195786214604267,13.593753145072998,13.987686418192364,0.19177500415996845,22,22,22,30,8,8,8,5,1.3217218464346305,1.4463260884148141,1.5621788344342862,0.5454449110458858,2186,2193,"West Texas, excluding El Paso",Culberson,48,109,Texas,TX
48229,48CS095,18,17,18,35,17,17,18,6,12.748081125216459,13.178936503750734,13.57964870920601,0.3267758412745182,21,21,21,39,18,18,18,5,3.8499933794360324,3.98917272355503,4.109379112366673,0.26239173855285,3450,3274,"West Texas, excluding El Paso",Hudspeth,48,229,Texas,TX
48243,48CS095,16,16,16,19,3,3,3,5,-3.7706773831712965,-3.380190608289193,-2.956259250087018,1.1642787010872218,19,19,19,28,9,9,9,3,3.0357571361464126,3.1534303761252818,3.284123040841704,0.2952198385878969,2018,1953,"West Texas, excluding El Paso",Jeff Davis,48,243,Texas,TX
48301,48CS095,1,1,1,7,6,6,6,7,-39.43627990927061,-37.941044398138814,-36.27369081394444,0.9665505293340442,1,1,1,5,4,4,4,5,-13.096669615735772,-12.569073835055924,-12.041927838669176,0.9486758083623417,80,58,"West Texas, excluding El Paso",Loving,48,301,Texas,TX
48371,48CS095,106,104,107,164,58,57,60,28,7.58041471478158,7.976298683258945,8.375402795919001,0.47136165628158755,130,128,132,176,46,44,48,33,0.7218869318324634,0.8508380862393348,0.9746118288604564,0.7041360775095674,15246,15125,"West Texas, excluding El Paso",Pecos,48,371,Texas,TX
48377,48CS095,37,36,38,55,18,17,19,20,-1.6288763703883082,-1.2405691332358713,-0.8311285608625653,1.047058745523293,46,45,46,69,23,23,24,14,1.3956840455415147,1.5253250154820581,1.6469098900893637,0.5749485642140798,6180,6134,"West Texas, excluding El Paso",Presidio,48,377,Texas,TX
48389,48CS095,97,96,99,128,31,29,32,28,0.2782412697837565,0.666525503260788,1.0629741455804345,0.8887147696200375,118,116,120,157,39,37,41,32,0.3340010665980522,0.45832851721957246,0.5794019337756093,0.8064986858420825,14883,14522,"West Texas, excluding El Paso",Reeves,48,389,Texas,TX
48461,48CS095,25,25,25,34,9,9,9,5,4.208508717347087,4.589756030169626,4.981637279455166,0.5080434905271413,31,30,31,32,1,1,2,5,-1.1960641201839128,-1.0762461438806183,-0.9526061892799457,2.0086916958481975,3344,3270,"West Texas, excluding El Paso",Upton,48,461,Texas,TX
48475,48CS095,101,100,102,115,14,13,15,13,-0.025785018300390206,0.386906282028332,0.8041239478753998,0.8608272647087518,121,119,122,122,1,-0,3,24,-2.132659019833538,-2.001183581540133,-1.8806505082155658,9.977969368336067,11656,11261,"West Texas, excluding El Paso",Ward,48,475,Texas,TX
48495,48CS095,61,61,62,75,14,13,14,15,-1.044823237801006,-0.6749655407031951,-0.2795752530984912,1.0209372288462457,73,72,74,88,15,14,16,17,-0.42065697874509766,-0.28984343023451914,-0.1616554222496325,1.0752158691635612,7746,7464,"West Texas, excluding El Paso",Winkler,48,495,Texas,TX
48491,48CS096,2781,2515,3046,3106,325,60,591,256,-1.2697912143839434,0.48029281955009195,2.30761681367729,0.7843139613916571,3594,3264,3924,4064,470,140,800,564,-0.6259298148940791,-0.14466763693323376,0.33971106717025873,1.1982302223937813,614739,638978,Williamson,Williamson,48,491,Texas,TX
48497,48CS097,552,523,582,665,113,83,142,78,0.21586981260162869,2.03990027789445,3.7727510922814513,0.686827327934203,698,661,734,832,134,98,171,153,-0.7865155322012379,-0.24566005688229509,0.2517194902594972,1.129765139171626,69310,71299,Wise,Wise,48,497,Texas,TX
49001,49CS001,55,54,55,43,-12,-12,-11,5,-9.835456161045908,-9.42470047498325,-9.006397238524812,-0.4717900989474017,69,68,69,91,22,22,23,13,1.1790563026939263,1.3035401265802546,1.4381099944091782,0.5543647916806185,7043,7224,Beaver+Iron+Millard,Beaver,49,1,Utah,UT
49021,49CS001,307,282,332,337,30,5,55,16,-0.7910135685083005,0.9133554022144798,2.587530069788974,0.5171723791725232,393,362,424,446,53,22,84,65,-0.7480513273708147,-0.19872522492712652,0.3101557706978769,1.2077513403395208,57594,60099,Beaver+Iron+Millard,Iron,49,21,Utah,UT
49027,49CS001,90,88,91,111,21,20,23,7,3.9663703707886153,4.3876440728089845,4.807014822029146,0.313586638344522,111,109,112,154,43,42,45,31,0.8188376088702641,0.9370285849350142,1.0497192945743352,0.6997597839308275,13043,13142,Beaver+Iron+Millard,Millard,49,27,Utah,UT
49003,49CS002,357,332,382,417,60,35,85,29,0.2676992788638627,2.108685279829311,3.826008470460479,0.4759538476615265,452,421,483,511,59,28,90,77,-0.8266888747914876,-0.29774314983895295,0.22241387614792127,1.283071446501183,57809,59428,Box Elder+Cache+Rich,Box Elder,49,3,Utah,UT
49005,49CS002,525,468,582,529,4,-53,61,31,-2.6117853272519964,-0.8328542095848374,0.8807820771140459,6.212490725238089,675,604,745,732,57,-13,128,60,-0.5355984684655629,-0.01444788410277896,0.502228048634812,1.0299004738674435,133171,136850,Box Elder+Cache+Rich,Cache,49,5,Utah,UT
49033,49CS002,15,15,15,11,-4,-4,-4,5,-14.792561281350237,-14.412727471047555,-13.980290774200387,-1.6525984756247178,19,19,19,20,1,1,1,2,-0.5022710711077646,-0.38353524316950477,-0.26234977534885234,0.9954754116909277,2508,2583,Box Elder+Cache+Rich,Rich,49,33,Utah,UT
49007,49CS003,191,182,199,220,29,21,38,6,2.8809501736693752,4.587359135685059,6.319296226202423,0.19709914840764062,233,222,243,292,59,49,70,30,0.8962351014049602,1.4331255784335266,1.8947944716494578,0.4959038439295483,20457,20386,Carbon+Daggett+Duchesne+Uintah,Carbon,49,7,Utah,UT
49009,49CS003,10,10,10,3,-7,-7,-7,3,-41.354766799889155,-40.9487113519751,-40.54202789443301,-0.5182450846720585,12,12,12,5,-7,-7,-7,5,-12.691192140405384,-12.551697299794398,-12.432178597359233,-0.8059221012495476,956,972,Carbon+Daggett+Duchesne+Uintah,Daggett,49,9,Utah,UT
49013,49CS003,135,127,144,137,2,-7,10,1,-1.7581648835204364,0.08747876750938831,1.804614923139548,0.38498381631922124,168,158,178,195,27,17,37,16,0.029179878986856974,0.5730675464112114,1.085446410253151,0.5707586243195424,19646,19760,Carbon+Daggett+Duchesne+Uintah,Duchesne,49,13,Utah,UT
49047,49CS003,213,198,228,254,41,26,56,15,1.1776898527479656,2.9160050517061533,4.618700733492463,0.35783242262901177,267,248,285,339,72,54,91,43,0.28419110618993654,0.8140011210220606,1.3513675972393278,0.5868390826736505,35706,36119,Carbon+Daggett+Duchesne+Uintah,Uintah,49,47,Utah,UT
49011,49CS004,1636,1480,1792,1840,204,48,360,92,-0.5265616008016654,1.2818446315157652,3.0132599805014797,0.44850848395890663,2061,1872,2250,2333,272,83,461,212,-0.34951346216508283,0.16824679466386272,0.6960801432790904,0.7761363892481635,362693,366732,Davis,Davis,49,11,Utah,UT
49023,49CS005,67,66,68,72,5,4,6,7,-1.0833712322953117,-0.6983840776715368,-0.2954748252040121,1.1817864108084435,84,83,86,84,-0,-2,1,3,-0.4062172354862798,-0.2738309911610547,-0.1481498176354835,4.534837514555412,11884,12107,Juab+Sanpete+Tooele,Juab,49,23,Utah,UT
49039,49CS005,161,149,174,208,47,34,59,14,2.8578789732680625,4.5369635108108755,6.195803849626243,0.2944211868869764,201,186,216,280,79,64,94,32,1.059579721764427,1.5943327238786362,2.136391013662619,0.40138033017375757,28932,29019,Juab+Sanpete+Tooele,Sanpete,49,39,Utah,UT
49045,49CS005,351,319,382,352,1,-30,33,20,-2.657032172744242,-0.9942661640273726,0.676030368837887,8.314829680462639,451,412,490,526,75,36,114,64,-0.36570799865926235,0.16144377826874132,0.6522424471120889,0.8421525417442827,73460,76150,Juab+Sanpete+Tooele,Tooele,49,45,Utah,UT
49029,49CS006,59,57,60,72,13,12,15,8,1.2932713991106841,1.7379136946247191,2.1068550990424617,0.5579102441272501,74,72,75,65,-9,-10,-7,2,-0.9855559687338697,-0.8491967781934402,-0.7307046647837533,-0.25914218552534474,12379,12618,Morgan+Summit+Wasatch,Morgan,49,29,Utah,UT
49043,49CS006,143,124,161,147,4,-14,23,5,-1.6236455447121132,-0.051698800825494155,1.5834491212941506,0.9318881682178886,181,159,203,207,26,4,48,13,-0.24426118661729887,0.2974517667388214,0.8216680488929192,0.4860224057121151,42465,43000,Morgan+Summit+Wasatch,Summit,49,43,Utah,UT
49051,49CS006,138,135,142,166,28,24,31,16,0.9339498079618713,1.3479177874073687,1.7257221240888798,0.5535844622946905,175,171,180,173,-2,-7,2,12,-0.5270238459863337,-0.4022196246278847,-0.2716639969437505,-8.156867142933548,35031,36007,Morgan+Summit+Wasatch,Wasatch,49,51,Utah,UT
49035,49CS007,5972,5463,6482,6695,723,213,1232,576,-1.0656681543695352,0.5330209409189263,2.2461412525567654,0.7960982948213278,7437,6825,8050,7930,493,-120,1105,623,-0.6022640569701596,-0.11729629026640706,0.42315832867952485,1.2622432682347093,1182223,1186394,Salt Lake,Salt Lake,49,35,Utah,UT
49049,49CS008,2406,2120,2691,2649,243,-42,529,223,-1.6047643847008526,0.09491194814089589,1.91335457587608,0.9132390478129271,3108,2756,3460,3245,137,-215,489,389,-0.8948795591012705,-0.3870749160440818,0.18016263987882222,2.8212579383920193,661413,681801,Utah (county),Utah (county),49,49,Utah,UT
49053,49CS009,1283,1204,1361,1478,195,117,274,111,0.20439199857140142,1.7936412014928047,3.5306656267309147,0.5653835693486562,1642,1543,1740,1888,246,148,345,249,-0.524222636377526,-0.027825415098303125,0.4943957228923212,1.006129139053644,182312,189869,Washington,Washington,49,53,Utah,UT
49015,49CS010,84,83,85,96,12,11,13,7,1.5382278744565925,1.946978272757512,2.3363634183117274,0.5474342152011054,104,103,106,127,23,21,24,20,0.1373027634460081,0.26397494418949996,0.38819650873366274,0.845704489202756,9883,9948,Wayne and Nearby Counties,Emery,49,15,Utah,UT
49017,49CS010,43,42,43,51,8,8,9,4,2.8985139263366526,3.296712594397921,3.7528077888640365,0.43550588697577086,53,53,54,61,8,7,8,3,0.8226119352207623,0.9502391552423969,1.074007834971714,0.3391629415345591,5081,5123,Wayne and Nearby Counties,Garfield,49,17,Utah,UT
49019,49CS010,76,75,77,61,-15,-16,-14,4,-8.237576868945455,-7.8821905214167876,-7.478788691716929,-0.28423129308058315,93,92,95,85,-8,-10,-7,7,-1.7268925007511842,-1.603568545614926,-1.4750035958187315,-0.9351004949487365,9693,9666,Wayne and Nearby Counties,Grand,49,19,Utah,UT
49025,49CS010,67,67,68,57,-10,-11,-10,4,-7.824352838277536,-7.415700099084046,-7.059817865019933,-0.4277539143279082,85,84,86,108,23,22,24,13,1.1163612760759862,1.2450594621070818,1.3673367082462036,0.5449153838326622,7735,7945,Wayne and Nearby Counties,Kane,49,25,Utah,UT
49031,49CS010,15,15,16,15,-0,-1,0,1,-5.350343070332486,-3.6805525143378484,-1.9445901065935023,1.4339242584108802,19,18,20,23,4,3,5,2,0.704646953477561,1.2001319719479557,1.706520766194661,0.4181632847622061,1447,1480,Wayne and Nearby Counties,Piute,49,31,Utah,UT
49037,49CS010,99,97,100,147,48,47,50,43,1.045966553641124,1.490378091223009,1.9180869524951087,0.8699592827158626,121,119,122,153,32,31,34,27,0.24995744507851478,0.3654095299932042,0.49521364426336967,0.8096812291870908,14624,14494,Wayne and Nearby Counties,San Juan,49,37,Utah,UT
49041,49CS010,182,172,191,198,16,7,26,2,0.837976674231103,2.6635431543624826,4.40530868408347,0.11565748792338856,227,216,238,230,3,-8,14,14,-1.0052982994738904,-0.5081093543885875,0.006800672841608648,3.4929132729497554,21597,21854,Wayne and Nearby Counties,Sevier,49,41,Utah,UT
49055,49CS010,21,20,21,33,12,12,13,2,16.074348583310897,16.459036520258394,16.871933557011975,0.14899134218869647,26,25,26,33,7,7,8,1,2.4289452750185623,2.5486260061043198,2.6770152569941925,0.11768498088444806,2533,2549,Wayne and Nearby Counties,Wayne,49,55,Utah,UT
49057,49CS011,1592,1479,1705,1773,181,68,294,110,-0.7170536320945744,1.0783742238763234,2.7364086117562576,0.6044712848417864,1987,1850,2125,2138,151,13,288,213,-0.7274220279019903,-0.23292367019984453,0.2581170992063379,1.4044800653111353,262810,266448,Weber,Weber,49,57,Utah,UT
50001,50CS001,272,256,288,287,15,-1,31,3,-0.3788651402419186,1.3072283301386185,2.995929746352238,0.18558352059172367,334,315,353,370,36,17,55,7,0.28839244029692007,0.7744643358432421,1.2763331044357666,0.19016385652667955,37245,37265,Addison+Chittenden,Addison,50,1,Vermont,VT
50007,50CS001,1011,938,1083,1048,37,-35,110,62,-2.310480814528644,-0.6108385111465089,1.1629297140847377,1.6135559894083071,1254,1167,1342,1318,64,-24,151,42,-0.3776790534483406,0.13816370556685426,0.6433375829083151,0.6509080577684833,167712,168781,Addison+Chittenden,Chittenden,50,7,Vermont,VT
50003,50CS002,407,391,423,399,-8,-24,8,2,-2.6655559494176133,-1.1093995509854948,0.6209474725038545,-0.29927989993669724,498,479,518,547,49,29,68,25,0.06989368987610678,0.6435170630278637,1.1466225291597891,0.5044654734501482,37022,37306,Bennington+Windham,Bennington,50,3,Vermont,VT
50025,50CS002,414,394,434,390,-24,-44,-4,6,-4.428375493452645,-2.6599232364019847,-0.952873140243997,-0.26010191311055164,512,488,536,536,24,0,48,24,-0.512624006469384,-0.00605532706138819,0.5037013472137144,0.9666115063126052,45342,46054,Bennington+Windham,Windham,50,25,Vermont,VT
50005,50CS003,271,258,284,268,-3,-16,10,2,-2.405045400157089,-0.6622154815441867,0.9775647820344535,-0.8163051325028425,336,320,351,387,51,36,67,14,0.7113073102987214,1.2370540342613705,1.7345287045378406,0.266774128897643,30160,30371,Caledonia+Essex+Orange,Caledonia,50,5,Vermont,VT
50009,50CS003,61,61,62,68,7,6,7,5,0.8724383588189922,1.2440931378884736,1.6527425160118319,0.6366455408394244,75,74,76,87,12,11,13,6,0.9174418551631405,1.0483267509916578,1.1767732201072663,0.45401963446504773,5946,5923,Caledonia+Essex+Orange,Essex,50,9,Vermont,VT
50017,50CS003,241,229,254,240,-1,-14,11,7,-2.901510247100179,-1.1794570941275746,0.5151494891831006,-16.425369166166973,300,284,315,295,-5,-20,11,3,-0.7923537261424795,-0.24219489304756123,0.26444688836019975,-0.8198374851399673,29223,29500,Caledonia+Essex+Orange,Orange,50,17,Vermont,VT
50011,50CS004,380,359,402,404,24,2,45,25,-1.7945201442363747,-0.11740065820645043,1.6158192511476996,1.0164237807423508,470,444,496,481,11,-15,37,24,-0.7691833071157214,-0.2818340884949933,0.25106575770470246,2.075483646106633,49941,50277,Franklin+Grand Isle,Franklin,50,11,Vermont,VT
50013,50CS004,53,52,54,57,4,3,5,4,-0.5105558820922004,-0.12071137876460783,0.2722596163819055,0.8380057594462438,66,65,67,95,29,28,30,5,3.081235558227443,3.2061684818209657,3.331364140916106,0.1682164222858071,7283,7400,Franklin+Grand Isle,Grand Isle,50,13,Vermont,VT
50015,50CS005,181,170,192,214,33,22,44,5,2.662026251588897,4.3003326243780915,6.0448178098726615,0.1470241987496483,223,210,237,245,22,8,35,6,0.07871197323785795,0.6085025106481988,1.0725189200321914,0.2656799970555586,25864,26095,Lamoille+Orleans,Lamoille,50,15,Vermont,VT
50019,50CS005,275,263,287,277,2,-10,14,4,-1.9574894332188277,-0.30957979373586964,1.3183629705536313,1.4363774326337828,337,323,351,428,91,77,105,24,1.8837266010918958,2.420002652854888,2.937269287241439,0.2614359619905997,27314,27518,Lamoille+Orleans,Orleans,50,19,Vermont,VT
50021,50CS006,612,586,638,650,38,12,64,2,0.7818247860085046,2.3211758100475786,3.9919594506340585,0.05178321212939179,754,722,785,803,49,18,81,34,-0.25682582715945373,0.24539830495853257,0.7508781337190992,0.6759583559851712,60129,60571,Rutland,Rutland,50,21,Vermont,VT
50023,50CS007,472,446,498,536,64,38,90,2,2.3258347089044737,4.140456636202838,5.819266135020917,0.030737625118130014,582,551,613,610,28,-3,59,20,-0.3855315455020084,0.13901623125533152,0.6030100404266332,0.6986751478409268,59583,59937,Washington,Washington,50,23,Vermont,VT
50027,50CS008,522,497,547,554,32,7,57,6,-0.09738985127780411,1.805859762887356,3.5506285303214793,0.181475701344502,645,615,675,675,30,0,60,27,-0.43943717146276406,0.06706337590250529,0.5718333664686035,0.8606268313810912,57363,58124,Windsor,Windsor,50,27,Vermont,VT
51001,51CS001,375,361,390,423,48,33,62,32,0.06983863078914335,1.8517524111143555,3.682831146402726,0.6567958721453618,459,441,476,555,96,79,114,50,0.8536166361337523,1.4027265001182432,1.8815445146893814,0.5132792842938066,33188,33261,Accomack+Northampton+Virginia Beach (city),Accomack,51,1,Virginia,VA
51131,51CS001,162,157,167,194,32,27,37,23,1.2272406744456716,2.9374399099010042,4.790989367948903,0.6975706376877463,196,190,203,213,17,10,23,20,-0.8060629335169407,-0.266878261402194,0.20237600545422027,1.1273457294932165,12154,12106,Accomack+Northampton+Virginia Beach (city),Northampton,51,131,Virginia,VA
51810,51CS001,2761,2564,2958,3056,295,98,492,163,-0.5335691064807503,1.1320223136865706,2.8443010755293314,0.5501568036006961,3421,3184,3657,4056,635,399,872,403,-0.013629101301163729,0.5029135028420104,1.030338687621677,0.6332288901672175,457941,457920,Accomack+Northampton+Virginia Beach (city),Virginia Beach (city),51,810,Virginia,VA
51003,51CS002,746,697,794,852,106,58,155,46,0.48916234421113824,2.1800650374333985,3.9140219818366035,0.4290297447113303,925,866,983,1022,97,39,156,73,-0.3129155169112855,0.20607891191511404,0.7197063292901023,0.7437339969723823,112217,113383,Albemarle+Charlottesville (city),Albemarle,51,3,Virginia,VA
51540,51CS002,242,222,262,259,17,-3,37,26,-2.482582546704118,-0.8060827933418051,0.8404038574659577,1.4380335327767255,295,272,319,329,34,10,57,23,-0.30466852082606305,0.23224538371606127,0.7707411744156055,0.6651868361961419,46470,45782,Albemarle+Charlottesville (city),Charlottesville (city),51,540,Virginia,VA
51510,51CS003,629,560,697,705,76,8,145,87,-1.9139673960988022,-0.28980958266932083,1.4016435548157054,1.1236839560093057,774,693,854,798,24,-56,105,58,-0.7460017666702429,-0.22283078566119283,0.30303712407433064,2.2830856714312384,158633,155346,Alexandria (city),Alexandria (city),51,510,Virginia,VA
51005,51CS004,182,175,188,211,29,23,36,25,-0.6454342306093541,1.2038782706737141,2.9286947591369006,0.8208919545938449,220,213,228,318,98,90,105,49,2.747000662393519,3.2303404572519607,3.6984676790576296,0.4972952706620802,15104,15012,Alleghany and Nearby Counties and Independent Cities,Alleghany,51,5,Virginia,VA
51017,51CS004,55,55,56,65,10,9,10,1,7.7364207916692695,8.151294245541747,8.54898020573118,0.09496886462070983,67,67,68,77,10,9,10,12,-0.6546798866983189,-0.5260155899761733,-0.4003567711770249,1.1079729664745535,4184,4126,Alleghany and Nearby Counties and Independent Cities,Bath,51,17,Virginia,VA
51023,51CS004,308,293,322,321,13,-1,28,20,-2.501391510922572,-0.7878180175536655,0.8725154926141812,1.3820848393369356,380,363,398,484,104,86,121,56,0.9077643435572484,1.3934797603045723,1.9364876893054204,0.5353961007404019,33624,33829,Alleghany and Nearby Counties and Independent Cities,Botetourt,51,23,Virginia,VA
51091,51CS004,25,25,26,25,-0,-1,-0,3,-6.375513606656824,-5.963360892820823,-5.57885931425285,4.431571992464986,31,31,31,33,2,2,2,7,-2.4496760872408245,-2.3130939543253306,-2.1909251401120056,2.4624849893285394,2226,2227,Alleghany and Nearby Counties and Independent Cities,Highland,51,91,Virginia,VA
51580,51CS004,97,96,97,88,-9,-9,-8,4,-9.453890612184656,-9.031614242428148,-8.633739811001462,-0.5069205151517218,119,118,120,117,-2,-3,-1,25,-4.831949916427808,-4.718335231101304,-4.586553951519549,-26.12345849574547,5706,5718,Alleghany and Nearby Counties and Independent Cities,Covington (city),51,580,Virginia,VA
51007,51CS005,144,138,150,156,12,6,18,3,1.0995391292207624,2.798134729125932,4.401544479027406,0.2278086555785439,177,170,184,224,47,40,54,29,0.8386576267364813,1.3526290266672454,1.904721671909801,0.605190524815058,13221,13265,Amelia+Brunswick+Lunenburg+Nottoway,Amelia,51,7,Virginia,VA
51025,51CS005,180,173,187,193,13,6,20,13,-1.8033719686782521,-0.07712420538675964,1.7336573953610974,0.9411683771767995,222,214,230,274,52,44,60,27,0.990761285505855,1.5719389209111183,2.0796078445633484,0.509420101667468,15874,15920,Amelia+Brunswick+Lunenburg+Nottoway,Brunswick,51,25,Virginia,VA
51111,51CS005,134,129,139,136,2,-3,7,2,-1.832593809055968,-0.07306834676044438,1.5797135548508086,0.7203975879768564,164,158,170,177,13,7,19,18,-0.9685941332809375,-0.4405888865039279,0.11114015511497989,1.3157456552782913,11976,11927,Amelia+Brunswick+Lunenburg+Nottoway,Lunenburg,51,111,Virginia,VA
51135,51CS005,180,173,186,184,4,-2,11,21,-6.087686079874214,-4.332707709584525,-2.5204098189911788,4.022939863877027,221,213,229,261,40,32,48,29,0.1944469854769921,0.7121662090011059,1.2353953687315502,0.703872589061113,15552,15597,Amelia+Brunswick+Lunenburg+Nottoway,Nottoway,51,135,Virginia,VA
51009,51CS006,294,280,307,324,30,17,44,18,-0.11926584805227823,1.5777493167635686,3.3498497562523,0.5740959588641067,360,344,376,478,118,102,134,49,1.7045095839076567,2.222372355841805,2.775580329591762,0.4122706381410036,31324,31271,Amherst+Lynchburg (city)+Nelson,Amherst,51,9,Virginia,VA
51125,51CS006,166,159,172,186,20,14,27,4,2.863388676472248,4.443325213352164,6.1277071653267585,0.18750158969056396,203,195,211,206,3,-5,11,24,-1.9903044946143282,-1.4326289208881826,-0.8768193839452689,6.045143088604479,14758,14782,Amherst+Lynchburg (city)+Nelson,Nelson,51,125,Virginia,VA
51680,51CS006,674,640,708,779,105,71,139,56,0.6249327560274268,2.412668864947641,4.215473326850924,0.5301379940066229,828,787,869,976,148,107,189,116,-0.12832113843716686,0.4229130753681836,0.920603944453375,0.7792896634237436,79306,78989,Amherst+Lynchburg (city)+Nelson,Lynchburg (city),51,680,Virginia,VA
51011,51CS007,165,158,172,156,-9,-16,-2,3,-4.881650714480458,-3.061026550535065,-1.4162016555585557,-0.35974706760175823,204,196,213,201,-3,-12,5,24,-2.189158231058325,-1.6796377154120545,-1.1906169365542432,-9.975764906733591,16122,16321,Appomattox+Campbell,Appomattox,51,11,Virginia,VA
51031,51CS007,492,468,516,603,111,87,135,46,2.9515486129701776,4.685125587157497,6.3763800092506475,0.4093473220952537,602,573,631,766,164,135,193,105,0.563311840120735,1.0644407153991386,1.5473232923728146,0.6364434744533528,55584,55513,Appomattox+Campbell,Campbell,51,31,Virginia,VA
51013,51CS008,779,677,882,986,207,104,309,152,-0.7787516311957525,0.869296908421545,2.6663422655474376,0.7315540008825125,965,844,1086,1016,51,-70,172,75,-0.6322057509270066,-0.09650388092411998,0.38612667794652944,1.443927401156603,238107,233811,Arlington,Arlington,51,13,Virginia,VA
51015,51CS009,602,568,635,715,113,80,147,50,1.5374910810200209,3.2629754836420695,5.06169427991142,0.4374558791239694,733,693,773,965,232,192,272,97,1.2132240448369136,1.7535849325412125,2.2542848475516837,0.4164675210635234,77314,77556,Augusta+Rockbridge and Independent Cities,Augusta,51,15,Virginia,VA
51163,51CS009,220,210,230,271,51,41,61,21,3.649980578232634,5.3824925766826865,6.981785564830331,0.40231962678956606,267,255,278,346,79,68,91,63,0.22268906183016396,0.7281434332696302,1.2329056885902525,0.784163235169958,22637,22636,Augusta+Rockbridge and Independent Cities,Rockbridge,51,163,Virginia,VA
51530,51CS009,69,68,69,89,20,20,21,10,5.874569719009778,6.29405222219949,6.728699538065772,0.467769894490131,84,83,85,112,28,27,29,17,1.5446860782934062,1.6674189269966881,1.792193027259735,0.585709927821216,6598,6604,Augusta+Rockbridge and Independent Cities,Buena Vista (city),51,530,Virginia,VA
51678,51CS009,74,73,75,67,-7,-8,-6,1,-4.671131717233173,-4.305328536861665,-3.916970552444332,-0.17050090736232804,92,91,93,72,-20,-21,-19,14,-4.662170824316698,-4.542546015596204,-4.412439930115691,-0.7459637948990907,7318,7435,Augusta+Rockbridge and Independent Cities,Lexington (city),51,678,Virginia,VA
51790,51CS009,330,319,341,345,15,4,26,36,-4.915988520364701,-3.2278176437029606,-1.5559116255571648,2.226306403843439,399,385,412,423,24,11,38,43,-1.2321885682737954,-0.6932331254310896,-0.1834074144809792,1.691433865009866,25657,25681,Augusta+Rockbridge and Independent Cities,Staunton (city),51,790,Virginia,VA
51820,51CS009,236,227,246,225,-11,-21,-2,15,-6.359070419536789,-4.682786257877292,-2.936456268519311,-1.4745314346837144,289,277,300,317,28,17,40,28,-0.5134401339705463,0.028223096739195076,0.5425345501498526,0.9499857568082009,22327,22510,Augusta+Rockbridge and Independent Cities,Waynesboro (city),51,820,Virginia,VA
51019,51CS010,704,670,738,817,113,79,147,42,1.8190322077212404,3.5611248316238773,5.345587519058789,0.36769351922385896,869,827,910,1066,197,156,239,126,0.34290788834540414,0.873359702748878,1.39135281945525,0.6350634737825145,79559,80040,Bedford (county)+Bedford (city),Bedford (county),51,19,Virginia,VA
51021,51CS011,69,69,70,80,11,10,11,6,2.5446857916187455,2.952099759173472,3.316664068713113,0.5164497791193673,84,83,85,98,14,13,15,7,0.976556352131211,1.1071477180974558,1.2223609021854103,0.47218681636846094,6246,6184,Bland+Smyth+Wythe,Bland,51,21,Virginia,VA
51173,51CS011,376,363,388,441,65,53,78,46,0.8010238529246527,2.6342817497196505,4.365420607726307,0.693293956819723,456,440,471,601,145,130,161,77,1.827031609436701,2.315502092309068,2.898235358672018,0.5257120690163093,29770,29514,Bland+Smyth+Wythe,Smyth,51,173,Virginia,VA
51197,51CS011,344,332,356,398,54,42,66,39,0.4395209765965962,2.121995484225104,3.8965288516123207,0.710708830662727,419,405,434,505,86,71,100,75,-0.12161197230814257,0.38851315942876635,0.9182874496311308,0.8645973669495495,28314,28192,Bland+Smyth+Wythe,Wythe,51,197,Virginia,VA
51191,51CS012,540,517,563,687,147,124,170,65,4.46456399520098,6.179842223819187,7.81416476202112,0.4383395226994356,651,624,679,886,235,207,262,111,1.7550807531538022,2.299579275917968,2.8179657440960657,0.4709261294605487,53820,53665,Bristol (city)+Washington,Washington,51,191,Virginia,VA
51520,51CS012,232,225,240,249,17,9,24,20,-2.5076247282694677,-0.7440885863057675,1.0289192979772717,1.1231237565744852,278,269,287,306,28,19,37,38,-1.1034948028444544,-0.6068993694886601,-0.07119857178666897,1.3223293509258705,17205,17084,Bristol (city)+Washington,Bristol (city),51,520,Virginia,VA
51027,51CS013,254,246,263,333,79,70,87,29,7.971919098452832,9.735775656349283,11.35461143209449,0.364432059481819,306,295,316,394,88,78,99,64,0.7424697843865641,1.2094938050761632,1.6983235108389005,0.7166333681960719,20293,19874,Buchanan+Dickenson+Russell+Tazewell,Buchanan,51,27,Virginia,VA
51051,51CS013,179,173,185,195,16,10,22,16,-1.6755657594630806,0.15627160242636345,1.8034071583571627,0.9177874139380418,215,208,222,230,15,8,22,24,-1.186087687712361,-0.6603418453158965,-0.14029570568725686,1.5129047692849749,14055,13825,Buchanan+Dickenson+Russell+Tazewell,Dickenson,51,51,Virginia,VA
51167,51CS013,296,285,307,341,45,34,56,23,1.6400725672005567,3.360011429199094,5.103226684596998,0.4985493754943244,360,346,373,463,103,90,117,59,1.2585187226495105,1.7449409978927797,2.2610584587899094,0.5649013525172337,25855,25576,Buchanan+Dickenson+Russell+Tazewell,Russell,51,167,Virginia,VA
51185,51CS013,511,493,528,609,98,81,116,31,4.9776461074179155,6.669897016971265,8.344995847304745,0.3122328573082656,619,599,640,785,166,145,186,94,1.2920454806615482,1.7995171517987543,2.2713468880422925,0.5642702885873392,40356,39986,Buchanan+Dickenson+Russell+Tazewell,Tazewell,51,185,Virginia,VA
51035,51CS014,303,290,315,394,91,79,104,49,3.991546660216363,5.821454712338663,7.523340142760323,0.5304762066877489,369,354,384,524,155,140,170,70,2.3509109383885867,2.9177909707932823,3.4073938067323155,0.44984952805707906,29252,29060,Carroll+Galax (city)+Grayson,Carroll,51,35,Virginia,VA
51077,51CS014,171,165,178,214,43,36,49,29,1.9587801448834032,3.618731950425549,5.420856039483627,0.6609364078125668,210,202,218,281,71,63,79,41,1.4821649700264572,1.9613689934832312,2.493592384116844,0.5677754081617684,15346,15350,Carroll+Galax (city)+Grayson,Grayson,51,77,Virginia,VA
51640,51CS014,140,139,141,123,-17,-18,-16,19,-22.06442342394861,-21.693653052604443,-21.300694622411655,-1.1892753399688607,172,171,173,165,-7,-8,-6,24,-4.738840558654383,-4.604473624215609,-4.490362022572237,-4.22255321937067,6634,6665,Carroll+Galax (city)+Grayson,Galax (city),51,640,Virginia,VA
51036,51CS015,71,70,72,89,18,17,19,2,9.092798415160813,9.499778889884299,9.889445029567282,0.1051241077914351,86,85,86,115,29,29,30,14,2.2147422417475933,2.3358116627448697,2.4605905791858884,0.45973698397224266,6753,6614,Charles City+Goochland+Henrico+New Kent,Charles City,51,36,Virginia,VA
51075,51CS015,191,180,201,207,16,6,27,12,-1.0077388723218081,0.6493295281861978,2.396582655223262,0.6926276161348229,240,227,253,277,37,24,50,33,-0.36708123327074965,0.1608687884235857,0.6560111590497061,0.86892613052533485,24769,25392,Charles City+Goochland+Henrico+New Kent,Goochland,51,75,Virginia,VA
51087,51CS015,2453,2310,2597,2929,476,332,619,275,0.721122665271518,2.3741460323521477,4.061927335582768,0.5768585404092537,3021,2849,3194,3583,562,389,734,364,0.07998721030852851,0.5863196963130008,1.0793998945106935,0.6469087300650513,333960,333662,Charles City+Goochland+Henrico+New Kent,Henrico,51,87,Virginia,VA
51127,51CS015,170,160,180,178,8,-2,18,12,-2.311966096872558,-0.6875615758025374,0.982151630434035,1.3105246983017824,215,202,227,245,30,18,43,20,-0.06836080499310408,0.4196952303457802,0.9233193768522915,0.640370420773326,23156,23779,Charles City+Goochland+Henrico+New Kent,New Kent,51,127,Virginia,VA
51550,51CS016,1615,1508,1723,1810,195,87,302,138,-0.8132005537794209,0.9453279687702282,2.723143892971318,0.7056727597543699,2007,1878,2137,2388,381,251,510,237,0.05766129114736411,0.5931045062340211,1.0839841499371714,0.6212306165185308,249221,251037,Chesapeake (city),Chesapeake (city),51,550,Virginia,VA
51041,51CS017,2286,2129,2443,2583,297,140,454,185,-0.34578475060175595,1.2319639494650643,2.9186302462121456,0.6206009786739303,2851,2660,3042,3333,482,291,673,362,-0.19530231768791043,0.33748564009322685,0.8595800849264916,0.7500483282264678,364322,369941,Chesterfield+Colonial Heights (city)+Powhatan,Chesterfield,51,41,Virginia,VA
51145,51CS017,195,182,208,245,50,37,63,10,3.4194688393408623,5.230565407847085,6.987476578052119,0.19657829809477706,245,229,261,315,70,54,86,30,0.7879729860193798,1.308418888633084,1.7753679820052564,0.4201728114211051,30404,31033,Chesterfield+Colonial Heights (city)+Powhatan,Powhatan,51,145,Virginia,VA
51570,51CS017,229,221,236,229,0,-7,8,13,-4.472242189270837,-2.7309925790486975,-1.0881725012220798,8.819535556582485,280,271,290,320,40,30,49,38,-0.3946559217111901,0.10584600016613828,0.5708895455175637,0.9299648130309579,18039,18261,Chesterfield+Colonial Heights (city)+Powhatan,Colonial Heights (city),51,570,Virginia,VA
51043,51CS018,145,139,152,153,8,1,14,10,-2.3934370351502054,-0.6434722072140749,1.1386478608753814,1.1635805141629654,179,171,187,185,6,-2,14,19,-1.4037821910118666,-0.8967652166089566,-0.3486682422203506,2.734403196052893,14767,14867,Clarke+Warren,Clarke,51,43,Virginia,VA
51187,51CS018,340,323,358,351,11,-7,28,29,-3.594916088560706,-1.7644278360671806,-0.01603074882475066,2.4258637165147685,419,398,440,532,113,92,134,77,0.3400078000341068,0.8722003631244527,1.366523704500592,0.6774989420204498,40717,40904,Clarke+Warren,Warren,51,187,Virginia,VA
51045,51CS019,45,45,46,55,10,9,10,7,1.808539279157581,2.166430665885427,2.5891741256273493,0.6559610941833287,55,54,56,72,17,16,18,7,1.899673332870476,2.0315544361618643,2.157664183986509,0.3913881353477099,4914,4867,Craig+Franklin (county)+Roanoke (county)+Salem (city),Craig,51,45,Virginia,VA
51067,51CS019,503,480,527,618,115,91,138,41,3.705153218687277,5.33607870253042,7.109415382012997,0.35452466841145697,618,590,646,795,177,149,205,88,1.1263182633164912,1.6379490104199526,2.1511202396245643,0.4944207626604164,54768,54870,Craig+Franklin (county)+Roanoke (county)+Salem (city),Franklin (county),51,67,Virginia,VA
51161,51CS019,888,846,929,1003,115,74,157,92,-0.7046672509923595,0.8920922322792338,2.511567071194903,0.790610435610052,1086,1036,1136,1350,264,214,314,113,1.0957190131425847,1.5705227140972768,2.10059195282005,0.42693241944384225,96465,96626,Craig+Franklin (county)+Roanoke (county)+Salem (city),Roanoke (county),51,161,Virginia,VA
51775,51CS019,301,291,312,348,47,36,57,25,1.700626793579343,3.3175445748523544,5.1583880317577915,0.526220024463943,367,354,381,395,28,14,41,51,-1.4081570010451843,-0.9246615462373168,-0.4311910925633217,1.7876523979009458,25350,25373,Craig+Franklin (county)+Roanoke (county)+Salem (city),Salem (city),51,775,Virginia,VA
51047,51CS020,389,366,412,406,17,-6,40,33,-3.0533752214189076,-1.1914971765716216,0.4295768911633213,1.8389353344710873,484,457,512,557,73,45,100,56,-0.2024694388829593,0.30665114256560744,0.8265958362792314,0.761539400508084,52809,53468,Culpeper+Madison+Rappahannock,Culpeper,51,47,Virginia,VA
51113,51CS020,133,131,134,121,-12,-13,-10,7,-5.879727213228172,-5.467337139171811,-5.076123273418337,-0.6463679181027898,165,163,167,177,12,10,14,27,-1.210160827739385,-1.0906085478701097,-0.968901958199224,2.1100984545392483,13757,13927,Culpeper+Madison+Rappahannock,Madison,51,113,Virginia,VA
51157,51CS020,59,58,59,63,4,4,5,7,-1.7401568057528172,-1.3605248963206635,-0.9358408790221882,1.2747196119518764,73,72,74,96,23,22,24,1,2.899256429461521,3.0168301742425196,3.1466360685120396,0.04106169438552245,7331,7393,Culpeper+Madison+Rappahannock,Rappahannock,51,157,Virginia,VA
51143,51CS021,615,589,641,694,79,53,105,55,-0.09806632462852327,1.5724516255686294,3.304550320086422,0.687809067624704,754,723,785,890,136,105,167,105,-8.762000247603924e-4,0.5150746044751668,1.0469864778832787,0.7660665436504184,60300,60022,Danville (city)+Pittsylvania,Pittsylvania,51,143,Virginia,VA
51590,51CS021,612,594,630,669,57,39,75,69,-2.6873270701587946,-1.0104225953969534,0.6132300063450261,1.1836774156958414,748,726,770,883,135,113,157,109,0.0995913738527976,0.627935439608303,1.157122781978998,0.800855220134746,42085,42251,Danville (city)+Pittsylvania,Danville (city),51,590,Virginia,VA
51053,51CS022,229,217,241,277,48,36,60,18,2.621361703538155,4.256519955805307,5.967798841800579,0.36876122651374194,283,269,298,371,88,73,102,42,1.1058268477656992,1.64501238691294,2.1568893697025397,0.47353486378280973,28033,27910,Dinwiddie+Petersburg (city),Dinwiddie,51,53,Virginia,VA
51730,51CS022,489,475,503,522,33,19,47,38,-2.407198379993526,-0.5433247526037974,1.1878704587500768,1.1124743311605592,602,584,619,667,65,48,83,73,-0.7553125222684358,-0.2244437529344004,0.26154295620667556,1.0992497904470269,33015,33429,Dinwiddie+Petersburg (city),Petersburg (city),51,730,Virginia,VA
51059,51CS023,4547,4053,5040,5343,796,303,1290,688,-1.3377922975222423,0.39612360400677654,2.1173297180262454,0.8627558834379109,5720,5131,6309,6027,307,-282,896,423,-0.5889030205813897,-0.1097340607735816,0.39343940427227825,1.3731522854012161,1148127,1140996,Fairfax (county)+Fairfax (city)+Falls Church (city),Fairfax (county),51,59,Virginia,VA
51600,51CS023,217,207,227,217,0,-10,10,15,-4.332683009651534,-2.43603569625667,-0.8622948925841765,14.34834708111854,269,256,281,233,-36,-48,-23,19,-2.8030358067077574,-2.247710620798299,-1.7651494186728773,-0.5501088183655939,24023,24255,Fairfax (county)+Fairfax (city)+Falls Church (city),Fairfax (city),51,600,Virginia,VA
51610,51CS023,83,82,85,84,1,-1,2,10,-2.9634824123215453,-2.5559464916413854,-2.1444058609987584,6.02364153444611,102,101,104,99,-3,-5,-2,3,-0.5770939306215095,-0.442944424909253,-0.31083929123031,-1.219806918590147,14622,14516,Fairfax (county)+Fairfax (city)+Falls Church (city),Falls Church (city),51,610,Virginia,VA
51061,51CS024,494,463,526,524,30,-2,61,23,-1.438364100302276,0.32638289138255094,1.9369641433365068,0.7466120308019931,615,577,653,707,92,54,130,58,-0.05206074312180035,0.4562378398475067,0.9879605638723488,0.6255714918867745,72790,73687,Fauquier,Fauquier,51,61,Virginia,VA
51063,51CS025,147,140,153,198,51,45,58,12,8.506010738613186,10.20674276828964,11.935238170198032,0.22894272587093825,180,172,188,212,32,24,40,15,0.5909191327725419,1.1109603913935955,1.631819331633847,0.45410016292533617,15531,15553,Floyd+Giles+Montgomery,Floyd,51,63,Virginia,VA
51071,51CS025,198,191,205,244,46,39,53,13,6.17529014332089,7.843600198559207,9.479427197692095,0.2782486855400976,240,231,248,299,59,51,68,31,1.2108493205807478,1.695696206409559,2.216444322974407,0.5158200769340303,16725,16590,Floyd+Giles+Montgomery,Giles,51,71,Virginia,VA
51121,51CS025,554,511,597,604,50,7,93,54,-1.8913143464711537,-0.08778451986218289,1.6040322209373092,1.0579771520352672,683,632,734,799,116,65,167,74,-0.0724157282739588,0.4455171328734628,0.9471004195764463,0.6333009770461379,99307,98624,Floyd+Giles+Montgomery,Montgomery,51,121,Virginia,VA
51069,51CS026,661,621,700,762,101,62,141,53,0.3950245629975905,2.1380868454171944,3.7985685559459492,0.5193562941136968,830,782,879,1026,196,147,244,132,0.15500178905021042,0.6709045143716292,1.1768265196286258,0.6715510133209832,91636,93432,Frederick+Winchester (city),Frederick,51,69,Virginia,VA
51840,51CS026,221,209,233,269,48,36,60,25,1.5431857707810341,3.238004061630169,5.1792422925692785,0.5142179059429054,274,259,288,323,49,35,64,41,-0.20218794884057203,0.31757416799714977,0.8216223715340987,0.8131644094174909,28025,28117,Frederick+Winchester (city),Winchester (city),51,840,Virginia,VA
51177,51CS027,849,788,909,982,133,73,194,71,0.2146703812106906,1.7306751441223673,3.4515040376491193,0.5284131146968258,1070,996,1144,1226,156,82,230,115,-0.22247963054439424,0.2798066836469376,0.8034390525242985,0.7328025985331091,140221,143209,Fredericksburg (city)+Spotsylvania,Spotsylvania,51,177,Virginia,VA
51630,51CS027,174,162,187,202,28,15,40,1,2.0519395624056362,3.7867263102657596,5.297495049199765,0.03503704067282186,217,202,232,257,40,25,55,11,0.5194699318241943,1.043585307882546,1.5415518046916057,0.2680449551143605,28217,28313,Fredericksburg (city)+Spotsylvania,Fredericksburg (city),51,630,Virginia,VA
51079,51CS028,149,140,158,154,5,-4,14,5,-1.8491494058098363,0.011342878440434724,1.6868716262030998,0.8182824785708155,187,176,198,236,49,38,60,37,0.10621130730781955,0.5742831610121552,1.102079320074091,0.7388065754084034,20530,20913,Greene+Louisa+Orange,Greene,51,79,Virginia,VA
51109,51CS028,314,297,330,341,27,11,44,14,-0.4567822917468733,1.4366409767049577,3.258902195353926,0.49377243798446346,394,374,414,492,98,78,118,41,0.9791142384132306,1.4493123278320434,1.9779614775951886,0.41574434560276713,37830,38689,Greene+Louisa+Orange,Louisa,51,109,Virginia,VA
51137,51CS028,352,336,367,379,27,12,43,12,-0.14112214590872407,1.7183681490055012,3.3539794582551283,0.42238473745407495,438,418,457,472,34,15,54,52,-0.938564215308516,-0.44321186210069347,0.06732218033408749,1.4652480149397724,36558,37072,Greene+Louisa+Orange,Orange,51,137,Virginia,VA
51083,51CS029,403,388,418,494,91,76,106,64,1.5489616561652226,3.1853337475949046,4.941700721144633,0.6952673326823217,492,475,510,605,113,95,130,70,0.7798585907535448,1.2672570773893896,1.7901209170094419,0.6149574974986611,33904,33762,Halifax+Mecklenburg,Halifax,51,83,Virginia,VA
51117,51CS029,393,380,406,443,50,37,63,51,-1.8185392556198368,-0.0658415298627935,1.5872622235261602,0.9952929112385945,480,464,495,553,73,58,89,49,0.2730121658214122,0.8077578548947241,1.3475483769455896,0.6593465790002963,30347,30254,Halifax+Mecklenburg,Mecklenburg,51,117,Virginia,VA
51650,51CS030,1105,1047,1164,1250,145,86,203,73,0.3541989526346049,2.0738793429484947,3.934123106680799,0.5015432548100763,1362,1291,1433,1623,261,190,332,179,0.08991567475272298,0.5910147957802488,1.1173166988727081,0.6842795122982319,136891,137656,Hampton (city)+Poquoson (city),Hampton (city),51,650,Virginia,VA
51735,51CS030,107,105,108,110,3,2,5,4,-0.6022488563738216,-0.1982632565238246,0.22144349922205997,0.9147929591605446,132,131,134,137,5,3,6,12,-0.6907111713276027,-0.5746679101786526,-0.4491348215697452,2.063099693194044,12434,12557,Hampton (city)+Poquoson (city),Poquoson (city),51,735,Virginia,VA
51085,51CS031,842,794,889,955,113,66,161,75,-0.18041935520116142,1.4025527730559604,3.0582695606141055,0.6564050024930677,1048,991,1106,1251,203,145,260,103,0.36140492203251506,0.9050122996440265,1.3814395620906683,0.5056858294254268,109884,111384,Hanover,Hanover,51,85,Virginia,VA
51165,51CS032,641,605,677,788,147,111,183,76,1.6161852454963455,3.443750289052783,5.1418106676064275,0.5134018979321132,792,749,836,1018,226,182,269,145,0.45431116705564534,0.984141230401379,1.4898313553989015,0.6390128473660445,83588,84301,Harrisonburg (city)+Rockingham,Rockingham,51,165,Virginia,VA
51660,51CS032,261,239,283,292,31,9,53,37,-2.285717285573564,-0.46185323039307247,1.2494314777533475,1.1510801918966627,322,295,348,368,46,20,73,40,-0.40602445962817063,0.12091337158875896,0.6409117865551656,0.8461035602899724,51898,51466,Harrisonburg (city)+Rockingham,Harrisonburg (city),51,660,Virginia,VA
51089,51CS033,575,553,597,732,157,135,179,76,4.7741529482343426,6.355707918962003,8.094691221891457,0.4817933467890533,697,671,723,976,279,253,305,148,2.0595862890566443,2.592653041107692,3.1157885921615835,0.5291626635663584,50718,50326,Henry+Martinsville (city)+Patrick,Henry,51,89,Virginia,VA
51141,51CS033,221,214,229,273,52,44,59,32,2.896498090177459,4.515245691462319,6.238046418454929,0.606614045898108,270,261,279,359,89,80,98,47,1.8731199049194005,2.385640147871155,2.9032184389032527,0.5232554592182856,17569,17596,Henry+Martinsville (city)+Patrick,Patrick,51,141,Virginia,VA
51690,51CS033,277,271,282,261,-16,-21,-10,31,-15.716828632923892,-14.123169385192726,-12.396503302352901,-2.1142024159841353,339,332,346,293,-46,-53,-39,57,-8.070459366594381,-7.613061167666573,-7.145550771040743,-1.265800890664928,13289,13503,Henry+Martinsville (city)+Patrick,Martinsville (city),51,690,Virginia,VA
51149,51CS034,231,213,250,243,12,-7,30,12,-1.686035179317293,-0.01597003303666195,1.6674887739788078,0.9480867504983542,289,267,311,364,75,53,97,48,0.11497207438128211,0.6237729239171512,1.1336437880062769,0.6339773268766602,42353,42901,Hopewell (city)+Prince George,Prince George,51,149,Virginia,VA
51670,51CS034,269,259,279,273,4,-6,14,19,-4.2678298428498955,-2.614461231115283,-1.0570901557372328,3.860504806696014,330,319,342,426,96,84,107,62,0.9349882104655421,1.4533701197211082,1.963060786681616,0.6422404080935362,22920,23115,Hopewell (city)+Prince George,Hopewell (city),51,670,Virginia,VA
51095,51CS035,682,649,716,762,80,46,113,35,0.5914190180787975,2.351946797969755,3.9148546985349317,0.4334569593017552,846,805,887,956,110,69,151,56,0.17108005141353452,0.6725928824140998,1.1881857056702496,0.5053006885021021,78336,79668,James City +Williamsburg (city),James City,51,95,Virginia,VA
51830,51CS035,69,68,71,84,15,13,16,4,2.3515826103239763,2.7742346539030294,3.156614444215279,0.25586167032871,88,86,89,84,-4,-5,-2,3,-0.5441922542078526,-0.41552363441773676,-0.2827453188553525,-1.191535203106241,15398,15569,James City +Williamsburg (city),Williamsburg (city),51,830,Virginia,VA
51033,51CS036,250,236,263,278,28,15,42,23,-1.1028867302802872,0.6185989541154424,2.3812204710997458,0.7857536438872211,311,294,327,376,65,49,82,38,0.3560883877306215,0.864765558667718,1.3710641929734264,0.5724109577316626,30926,31270,King and Queen and Nearby Counties,Caroline,51,33,Virginia,VA
51057,51CS036,111,110,112,132,21,20,22,5,5.478494820128496,5.892361943901924,6.308871313413122,0.23068559681232698,136,135,137,183,47,46,48,18,2.614955114898666,2.7336446581683327,2.8721347774266435,0.3754957363630364,10639,10576,King and Queen and Nearby Counties,Essex,51,57,Virginia,VA
51073,51CS036,362,345,378,417,55,39,72,13,2.6526714323362617,4.402882436532616,6.10451811439003,0.23019128493640575,448,428,468,497,49,29,69,56,-0.6883336831960292,-0.17811520132568873,0.32085213489702247,1.1160947969500559,38554,39013,King and Queen and Nearby Counties,Gloucester,51,73,Virginia,VA
51097,51CS036,74,74,75,93,19,18,19,5,7.849894642687896,8.24596926372021,8.626985052787834,0.2532805872444437,91,90,92,102,11,10,12,5,0.7470012276547222,0.8815662188385882,1.0042660900788616,0.42179194729226194,6659,6652,King and Queen and Nearby Counties,King and Queen,51,97,Virginia,VA
51101,51CS036,148,141,156,152,4,-4,11,7,-2.398494441357281,-0.7873570948092246,1.0657301037988802,1.5192757676911877,185,176,194,220,35,26,44,17,0.477057321300733,0.9862555419737078,1.5185991290097314,0.47383334413661166,17830,18132,King and Queen and Nearby Counties,King William,51,101,Virginia,VA
51115,51CS036,122,118,126,119,-3,-7,1,10,-7.848311100206883,-6.101249635265462,-4.429032703165711,-4.809343757397589,149,144,153,178,29,25,34,15,1.1591129861773497,1.70807439656178,2.202276508979254,0.49233768282263635,8564,8543,King and Queen and Nearby Counties,Mathews,51,115,Virginia,VA
51119,51CS036,141,137,146,162,21,16,25,4,4.538424241018799,6.336187432824005,7.9348856319837315,0.18434469711861035,174,169,180,212,38,32,43,24,0.786611331185656,1.286943529272422,1.7985780423241704,0.6179452125717977,10630,10758,King and Queen and Nearby Counties,Middlesex,51,119,Virginia,VA
51105,51CS037,244,234,254,315,71,61,81,33,5.15241696787953,6.852081173825778,8.46405294306088,0.45820822883264567,296,285,308,412,116,104,127,53,2.337066721775656,2.835550972611886,3.3669133775639337,0.45446277853733547,22286,21998,Lee+Norton (city)+Scott+Wise,Lee,51,105,Virginia,VA
51169,51CS037,277,267,286,302,25,16,35,37,-4.0200423001583,-2.2220943199570518,-0.5676444180384189,1.4098595281925166,337,326,348,390,53,42,64,56,-0.6371470025610687,-0.10006473830661734,0.387145142538216,1.0309269625238833,21538,21438,Lee+Norton (city)+Scott+Wise,Scott,51,169,Virginia,VA
51195,51CS037,414,398,429,490,76,61,92,43,1.9070845455830607,3.668304327793495,5.356559803421664,0.5561780091750288,501,483,520,659,158,139,176,73,1.8517637927905652,2.3757781005111047,2.8875519229275532,0.45955185419694955,36185,35701,Lee+Norton (city)+Scott+Wise,Wise,51,195,Virginia,VA
51720,51CS037,43,43,43,58,15,15,15,3,12.442246896368653,12.879615066379774,13.293642280336906,0.18777818761949627,52,52,53,95,43,42,43,13,8.047171434808305,8.167033604141816,8.296281544618534,0.2958232345221657,3722,3668,Lee+Norton (city)+Scott+Wise,Norton (city),51,720,Virginia,VA
51107,51CS038,1324,1142,1505,1543,219,38,401,162,-1.1787135481454656,0.5776568574611782,2.216193183524396,0.7351489584451802,1697,1477,1918,1751,54,-167,274,130,-0.7236292743215321,-0.16748398096831596,0.32997208864309074,2.3740146625042513,421991,426864,Loudoun,Loudoun,51,107,Virginia,VA
51683,51CS039,222,204,241,251,29,10,47,45,-3.32644123256535,-1.5245001838592978,0.17331272154132926,1.5208221404061548,278,256,300,288,10,-12,32,27,-0.88589865446473,-0.42314820830267613,0.11359442973759905,2.544812582367904,42460,42711,Manassas (city)+Manassas Park (city),Manassas (city),51,683,Virginia,VA
51685,51CS039,37,36,39,33,-4,-6,-3,8,-3.30338568831526,-2.8833984764340648,-2.4967270803100345,-2.3168198614589226,47,44,49,49,2,0,5,5,-0.27583436145915213,-0.1570599098377466,-0.029132598245730223,1.4943040315773157,17261,17022,Manassas (city)+Manassas Park (city),Manassas Park (city),51,685,Virginia,VA
51700,51CS040,1376,1297,1456,1599,223,143,302,94,0.9403375849128724,2.745702801257353,4.414918319939221,0.4205435908955089,1690,1594,1785,1972,282,187,378,201,-0.07583806702933871,0.4247178779006099,0.9232090922461184,0.7094568593754911,184876,184781,Newport News (city),Newport News (city),51,700,Virginia,VA
51710,51CS041,1663,1561,1765,1896,233,131,335,123,0.2421880466548994,1.8634606579062871,3.574025989912327,0.5256436311882048,2030,1909,2152,2445,415,293,536,216,0.3427021388742144,0.8505341937437222,1.3437673371762597,0.5197323063859396,238204,235454,Norfolk (city),Norfolk (city),51,710,Virginia,VA
51139,51CS042,252,242,262,319,67,57,77,36,3.5214881944713943,5.226209390437091,6.944351751255915,0.528583700403617,309,297,321,358,49,37,61,53,-0.7577800675319227,-0.18501595914205624,0.38351519857992855,1.0642429243166909,23740,23790,Page+Shenandoah,Page,51,139,Virginia,VA
51171,51CS042,431,412,450,544,113,94,132,62,2.7174134604758615,4.575152303034946,6.419158483361921,0.5455276679768352,534,511,557,639,105,82,128,103,-0.4907745090242579,0.06312617499480704,0.5632753039510954,0.9721073771591371,44205,44680,Page+Shenandoah,Shenandoah,51,171,Virginia,VA
51740,51CS043,914,872,956,1065,151,109,193,85,1.1753804400099837,2.70306977128152,4.457646485224993,0.5585207117717412,1116,1066,1167,1342,226,175,276,151,0.28137727760030823,0.7817025064595384,1.289195759186075,0.6656904031184281,97496,97866,Portsmouth (city),Portsmouth (city),51,740,Virginia,VA
51029,51CS044,146,139,153,174,28,21,35,23,-0.6076203436175094,1.2041604090386298,2.9352075947894476,0.7996907134318159,181,173,190,222,41,32,49,21,0.6631731548857157,1.174572512731628,1.6574341483193793,0.5032993659190532,16879,16928,Prince Edward and Nearby Counties,Buckingham,51,29,Virginia,VA
51037,51CS044,144,140,149,161,17,12,21,13,-0.5611667352975116,1.1965299081713947,2.9536069297775644,0.7419559697901124,176,170,182,236,60,54,66,32,1.9303574462358353,2.4655619839258565,2.957302214150905,0.5226066140519898,11550,11456,Prince Edward and Nearby Counties,Charlotte,51,37,Virginia,VA
51049,51CS044,83,82,84,102,19,18,20,8,4.053970044831857,4.45473592413626,4.856904279025093,0.4039158769545491,102,101,103,130,28,27,29,13,1.4007736536277602,1.52839099035637,1.657632454162435,0.45099680297116607,9704,9677,Prince Edward and Nearby Counties,Cumberland,51,49,Virginia,VA
51065,51CS044,209,197,221,223,14,2,26,14,-1.7342197643998043,0.05135077366463055,1.6274273930964465,0.9324209451076875,262,248,276,290,28,14,42,19,-0.22344016071989212,0.3401384133683437,0.8398323049750666,0.6568723826300841,27324,27658,Prince Edward and Nearby Counties,Fluvanna,51,65,Virginia,VA
51147,51CS044,199,190,209,222,23,13,32,17,-0.6774082690806351,1.025190314623398,2.7055904464991487,0.7220875821153253,246,234,257,273,27,16,39,25,-0.4163941935205594,0.1252132792267783,0.609391846058904,0.8829829479907838,22003,21920,Prince Edward and Nearby Counties,Prince Edward,51,147,Virginia,VA
51153,51CS045,1768,1561,1975,2300,532,325,739,324,0.04468242134028619,1.7645670811113379,3.4353695608419903,0.6081225132866864,2242,1992,2492,2641,399,149,649,274,-0.258255584837838,0.25813192313570926,0.7777142324295956,0.6843511509384674,481320,484219,Prince William,Prince William,51,153,Virginia,VA
51155,51CS046,385,370,399,452,67,53,82,47,0.6017119708745545,2.386270234605741,4.235342492541999,0.6904221878892022,471,454,489,578,107,89,124,60,0.87685023322624,1.3767229476525198,1.8849093773456331,0.5568607805518262,33796,33759,Pulaski+Radford (city),Pulaski,51,155,Virginia,VA
51750,51CS046,102,100,103,103,1,-0,3,3,-0.7841863350084388,-0.3762025629940758,0.03143001712339486,1.2251589670957577,126,123,128,139,13,11,16,16,-0.27684959416127164,-0.15765965243455918,-0.022440535233401334,1.1092210976363532,16426,16439,Pulaski+Radford (city),Radford (city),51,750,Virginia,VA
51760,51CS047,1575,1477,1673,1732,157,59,255,138,-1.354394622027581,0.36479953516259206,2.090904266423827,0.8733244143424653,1941,1824,2058,2295,354,237,471,224,0.04500653119134037,0.5752209255339036,1.1247315694620184,0.631354092045062,227299,226614,Richmond (city),Richmond (city),51,760,Virginia,VA
51770,51CS048,1042,1000,1085,1284,242,199,284,107,3.669714971215559,5.415314470437598,6.9335052304374605,0.4410987792017296,1269,1218,1320,1468,199,148,250,117,0.29594436483647624,0.8304787965177349,1.3429834515772028,0.583899870120417,99674,99012,Roanoke (city),Roanoke (city),51,770,Virginia,VA
51081,51CS049,128,126,129,138,10,9,12,21,-4.060120607256563,-3.712259397476224,-3.2739233050660332,1.8284888085405668,157,156,159,161,4,2,5,16,-1.2003623678422,-1.0761967097532057,-0.9544523173998931,3.4406996372876644,11382,11431,Southampton and Nearby Counties and Independent Cities,Greensville,51,81,Virginia,VA
51093,51CS049,314,297,330,352,38,22,55,27,-0.5900381398326067,1.148049184947602,2.7033336276514066,0.687481902274621,390,370,411,476,86,65,106,55,0.2649468061199545,0.7968217806163479,1.2660642063695833,0.634671076028161,38539,39188,Southampton and Nearby Counties and Independent Cities,Isle of Wight,51,93,Virginia,VA
51175,51CS049,159,151,167,194,35,27,43,33,-1.192779435749994,0.4944921699956261,2.2338152992171127,0.9154156677738524,195,186,204,258,63,54,72,29,1.372648327363136,1.8777593770121848,2.3668491412085984,0.4545868152360922,17933,17998,Southampton and Nearby Counties and Independent Cities,Southampton,51,175,Virginia,VA
51181,51CS049,69,68,69,74,5,5,6,6,-0.8761861845062564,-0.49209061555436445,-0.11012380941336916,0.9693106178338009,85,84,86,101,16,15,17,3,1.9051097537512949,2.0351408268405042,2.1641802777661607,0.173532888198828,6524,6532,Southampton and Nearby Counties and Independent Cities,Surry,51,181,Virginia,VA
51183,51CS049,127,123,132,125,-2,-7,2,17,-8.754307350462408,-7.149099357470085,-5.296302083380097,-12.215769438678212,155,149,160,176,21,16,27,20,-0.3730757149517695,0.13025773954295128,0.628320047751232,0.8991010118828582,10815,10764,Southampton and Nearby Counties and Independent Cities,Sussex,51,183,Virginia,VA
51595,51CS049,51,50,51,110,59,59,60,21,26.465915849656444,26.87902736037774,27.277132515790225,0.34956799275224554,63,62,64,95,32,31,33,7,4.320300968738322,4.441073737792579,4.5547550805631065,0.21097799978282136,5666,5674,Southampton and Nearby Counties and Independent Cities,Emporia (city),51,595,Virginia,VA
51620,51CS049,118,117,119,132,14,13,15,20,-3.3537046306169116,-2.9587256967719755,-2.523795720997245,1.3363104175491036,146,145,147,179,33,32,34,18,1.6841389048297195,1.8171831224276338,1.9428192058732936,0.5310276085353134,8131,8210,Southampton and Nearby Counties and Independent Cities,Franklin (city),51,620,Virginia,VA
51179,51CS050,719,651,787,751,32,-36,100,36,-1.7591553942594493,-0.1472571244981569,1.7094244531292986,1.0868254486233653,915,832,998,1028,113,30,196,87,-0.36427620705301816,0.15723371458461258,0.6780428797231476,0.762305336122273,157387,160400,Stafford,Stafford,51,179,Virginia,VA
51800,51CS051,685,644,725,838,153,113,194,83,1.2089043267469148,2.956760739581052,4.749186706408915,0.5379038279833388,855,805,905,1062,207,157,257,140,0.20836747376986287,0.690024910340733,1.2429373265682548,0.672992422758851,94491,95974,Suffolk (city),Suffolk (city),51,800,Virginia,VA
51099,51CS052,170,158,181,196,26,15,38,16,-0.2868556168146945,1.5218554288625814,3.4307180570434244,0.5840028752209497,216,202,230,201,-15,-29,-1,17,-1.7285869751219693,-1.1782734688408965,-0.62661381163624,-1.2103964668762868,26903,27389,Westmoreland and Nearby Counties,King George,51,99,Virginia,VA
51103,51CS052,189,185,194,196,7,2,11,5,-1.0973386395850873,0.6137384559330857,2.400923915613915,0.6484552809131195,231,226,237,241,10,4,15,17,-1.188997495634323,-0.6879324258245061,-0.17219397416172327,1.6182739152754455,10869,10925,Westmoreland and Nearby Counties,Lancaster,51,103,Virginia,VA
51133,51CS052,154,149,160,177,23,17,28,12,1.8078174076840008,3.534067216291936,5.205115174665341,0.5097418929979887,191,185,197,245,54,48,60,28,1.6387522428605041,2.153767365029355,2.6449033527693144,0.510050704202463,11892,12001,Westmoreland and Nearby Counties,Northumberland,51,133,Virginia,VA
51159,51CS052,106,105,107,106,-0,-1,1,5,-2.634563540167297,-2.24908691346605,-1.8447597316283435,5.366634100351677,131,130,132,132,1,-0,2,10,-1.1335073615897768,-0.9976506494933928,-0.877619010070418,4.966757616579553,8951,9003,Westmoreland and Nearby Counties,Richmond (county),51,159,Virginia,VA
51193,51CS052,214,206,221,230,16,9,24,16,-1.6040033233052373,0.1313280838939431,1.7928325847508442,0.9165970532270105,265,256,275,256,-9,-19,0,28,-2.487501930921074,-1.9944476087161398,-1.486286393732907,-3.392260380197071,18452,18697,Westmoreland and Nearby Counties,Westmoreland,51,193,Virginia,VA
51199,51CS053,401,371,431,453,52,22,82,21,0.0789983478559281,1.7444402897522706,3.60468868232659,0.39394599483665316,504,467,540,628,124,88,161,63,0.32973043398820656,0.8729348604389575,1.345630576503041,0.5035491895812625,70004,70804,York,York,51,199,Virginia,VA
53001,53CS001,110,108,112,110,0,-2,2,18,-3.8724037104264237,-3.466316867325887,-3.069686300789558,14.685518953937352,136,133,138,155,19,17,22,18,-0.06950946598216445,0.06669217930661275,0.19049484894151647,0.8850518458701987,20512,20619,Adams+Grant,Adams,53,1,Washington,WA
53025,53CS001,614,571,657,710,96,53,139,82,-1.0561534429110038,0.5182173793755306,2.212803211646791,0.8470032181815813,763,712,815,911,148,96,199,120,-0.2111400881790707,0.27489394845213677,0.790736145008275,0.8075266239657259,99257,100161,Adams+Grant,Grant,53,25,Washington,WA
53003,53CS002,217,208,227,266,49,39,58,22,3.0335578618473953,4.698212583839689,6.546378667146092,0.444144419565747,266,255,278,289,23,11,34,29,-0.801240513431729,-0.267817884472369,0.24182577689962084,1.2222294325852754,22359,22381,Asotin+Columbia+Garfield+Whitman,Asotin,53,3,Washington,WA
53013,53CS002,48,47,48,52,4,4,5,3,0.9821597654319066,1.3726826295939591,1.7806330456691848,0.5588862813019057,59,59,60,74,15,14,15,1,3.335298656051087,3.465414652196743,3.5951025087806148,0.06265638404362718,3969,4028,Asotin+Columbia+Garfield+Whitman,Columbia,53,13,Washington,WA
53023,53CS002,24,23,25,24,0,-1,1,5,-10.201198714448008,-8.461034557690958,-6.74621725292035,4.370666726859662,30,28,31,32,2,1,4,5,-1.6474445051693847,-1.1226984785614726,-0.5659549714607641,1.4893374386015845,2294,2338,Asotin+Columbia+Garfield+Whitman,Garfield,53,23,Washington,WA
53075,53CS002,230,209,250,270,40,20,61,25,-0.4002815347462543,1.2875990584859431,3.0502357090165364,0.6076617480095332,285,261,310,396,111,86,135,44,0.8647143367774096,1.3841843946447865,1.8761448453717329,0.39386624934421677,48138,47860,Asotin+Columbia+Garfield+Whitman,Whitman,53,75,Washington,WA
53005,53CS003,1299,1210,1388,1520,221,132,310,149,-0.2563724282036578,1.4128385581415,3.1275282727924014,0.6701453230826799,1618,1510,1726,1904,286,178,394,227,-0.21144679607914207,0.29711478171698985,0.8297971241206812,0.790358281187567,207075,209617,Benton,Benton,53,5,Washington,WA
53007,53CS004,616,582,650,653,37,3,71,40,-1.90395356393776,-0.21411492296955228,1.6402669979895064,1.0644345691989932,763,722,804,832,69,28,110,73,-0.5595438350816401,-0.07253296485161632,0.45699242959051284,1.0422476064298776,78922,79579,Chelan+Kittitas,Chelan,53,7,Washington,WA
53037,53CS004,268,249,288,302,34,14,53,29,-1.1447688293269729,0.3720451815830041,2.163715019238856,0.8384855690827409,335,312,359,384,49,25,72,30,-0.12171302808738804,0.41538631697869915,0.9289812238503109,0.6030284246232844,45160,45366,Chelan+Kittitas,Kittitas,53,37,Washington,WA
53009,53CS005,895,861,928,917,22,-11,56,6,-0.8781138641194975,0.8428998013383302,2.5413546500596933,0.2578258373032843,1105,1065,1145,1255,150,110,190,75,0.4743950541249077,0.9352278615510621,1.4867087705865791,0.497055445723761,77403,78074,Clallam+Jefferson,Clallam,53,9,Washington,WA
53031,53CS005,347,333,361,350,3,-11,17,3,-1.698526763689662,-0.008950869339036691,1.5673256653868737,0.7964842447826027,432,415,449,448,16,-1,33,18,-0.5621671343023342,-0.06734340155787905,0.4599579668477395,1.0645352323647514,33004,33524,Clallam+Jefferson,Jefferson,53,31,Washington,WA
53011,53CS006,3225,3008,3442,3577,352,135,569,137,0.05793373493638103,1.6561734747201775,3.45905250195075,0.3877326376419608,4033,3769,4296,4642,609,346,873,409,-0.09624045850732121,0.3806727887990599,0.9280225336018011,0.6701462739482918,503383,510472,Clark,Clark,53,11,Washington,WA
53015,53CS007,1055,1007,1103,1084,29,-19,77,25,-1.5132104732974159,0.13690145400188417,1.8603024261861505,0.8362490125496104,1300,1242,1358,1587,287,229,345,229,0.03450932554792409,0.5083931701834643,1.0640495903272205,0.7950753995312559,110908,111436,Cowlitz+Klickitat+Skamania+Wahkiakum,Cowlitz,53,15,Washington,WA
53039,53CS007,183,173,193,177,-6,-16,4,5,-3.6241207416698105,-1.8667920617128828,-0.1997021157229569,-1.0394738587529302,228,216,240,296,68,56,80,26,1.3443680918099625,1.8312853321801368,2.3269767304722633,0.3760406247689649,22767,23069,Cowlitz+Klickitat+Skamania+Wahkiakum,Klickitat,53,39,Washington,WA
53059,53CS007,82,81,83,86,4,3,5,7,-1.4701559888197457,-1.0765524368468071,-0.6950589898115604,1.47526078164627,102,101,104,105,3,1,4,2,-0.06396529508533619,0.06449945060481896,0.1943650360007295,0.5382944971696486,12057,12150,Cowlitz+Klickitat+Skamania+Wahkiakum,Skamania,53,59,Washington,WA
53069,53CS007,43,43,44,41,-2,-3,-2,2,-4.361304515321128,-3.956042267326177,-3.5684110392564965,-1.4254594616228895,55,54,55,68,13,13,14,2,2.3727510616063565,2.4907712217028326,2.616823034113504,0.13905619032622446,4454,4562,Cowlitz+Klickitat+Skamania+Wahkiakum,Wahkiakum,53,69,Washington,WA
53017,53CS008,267,249,286,283,16,-3,34,13,-1.4877463297247173,0.24281887795618587,2.083658298604174,0.7714087248767927,333,311,356,387,54,31,76,42,-0.2677922073132976,0.2467960037453901,0.7715690760094724,0.7694257304148365,43108,43594,Douglas+Okanogan,Douglas,53,17,Washington,WA
53047,53CS008,385,366,403,413,28,10,47,33,-2.1961941536491763,-0.4204469251550259,1.3999878672983872,1.1204701085989819,474,452,496,562,88,66,110,76,-0.28930458621744326,0.2913065173218649,0.8303396470369283,0.85697347808398,42213,42559,Douglas+Okanogan,Okanogan,53,47,Washington,WA
53019,53CS009,67,67,68,85,18,17,18,6,6.03230261063018,6.453309178983753,6.860446926997322,0.3209803246329005,83,82,83,133,50,50,51,12,5.168395633827578,5.298745439442195,5.420570513405868,0.23321986301637018,7261,7259,Ferry+Lincoln+Pend Oreille+Stevens,Ferry,53,19,Washington,WA
53043,53CS009,100,99,101,102,2,1,3,9,-3.0712203419048922,-2.679897153215011,-2.2374089215639845,3.394258063881585,126,124,127,144,18,17,20,20,-0.27473981348734555,-0.15307648319580913,-0.025759268671517954,1.036500118982997,10955,11186,Ferry+Lincoln+Pend Oreille+Stevens,Lincoln,53,43,Washington,WA
53051,53CS009,141,135,146,144,3,-2,9,5,-2.1907271017472265,-0.5045514638160218,1.2019350931192754,1.1505078923586718,175,168,182,236,61,54,68,23,2.2410080193437567,2.7738189707016265,3.2559009213070707,0.36947878256505534,13560,13827,Ferry+Lincoln+Pend Oreille+Stevens,Pend Oreille,53,51,Washington,WA
53065,53CS009,408,388,428,432,24,4,44,21,-1.481779507487976,0.2550628034501195,2.0089724435557694,0.8395299156051185,506,481,530,631,125,101,150,101,-0.022921325598418835,0.5234105015533751,1.061416502214732,0.7992738038463321,46546,47301,Ferry+Lincoln+Pend Oreille+Stevens,Stevens,53,65,Washington,WA
53021,53CS010,366,324,408,454,88,46,130,69,-0.8279999278456526,0.7779547196976613,2.6842947585929644,0.773829368221861,466,416,517,554,88,37,138,95,-0.5751329025297205,-0.08090486570068114,0.443033112098144,1.069298009730607,96962,98094,Franklin,Franklin,53,21,Washington,WA
53027,53CS011,756,723,788,800,44,12,77,28,-0.9082794020284348,0.872340157999145,2.6092178389293763,0.6157896446392797,935,895,974,1133,198,159,238,116,0.5606242192214946,1.0924887251724646,1.602172324448306,0.5818651878886772,75807,76691,Grays Harbor+Pacific,Grays Harbor,53,27,Washington,WA
53049,53CS011,298,288,308,268,-30,-40,-20,4,-7.388279713125669,-5.834671154064651,-4.078708931364395,-0.13799047315312116,370,357,382,412,42,30,55,30,-0.002957711947060959,0.49695473403403945,1.0250094479048137,0.6944682525803384,23381,23878,Grays Harbor+Pacific,Pacific,53,49,Washington,WA
53029,53CS012,689,651,726,704,15,-22,53,30,-2.461175039715942,-0.6607441211735536,0.969627102862134,1.8315770736087857,851,806,896,907,56,11,101,41,-0.35510404991501765,0.1631810362118007,0.6201365757735628,0.7217191910341784,86764,87361,Island,Island,53,29,Washington,WA
53033,53CS013,11600,10625,12576,12136,536,-440,1511,976,-2.411728239424127,-0.742501052048712,0.8693157370016817,1.8185870895360552,14326,13162,15491,15033,707,-458,1871,734,-0.5113293842355547,-0.012136069685580944,0.529042533957044,1.037161529877806,2267118,2255260,King,King,53,33,Washington,WA
53035,53CS014,1972,1854,2091,2012,40,-79,158,41,-1.8018841748934227,0.005185785628783029,1.6352305827419165,1.0053393682792797,2423,2281,2565,2647,224,82,366,192,-0.34086110957112725,0.10502895097425635,0.6265085632135023,0.8524928797498076,275030,274510,Kitsap,Kitsap,53,35,Washington,WA
53041,53CS015,816,781,852,863,47,11,82,31,-1.0705442134545682,0.7913269116022384,2.3589343170250645,0.6489440928144367,1016,973,1060,1129,113,69,156,145,-0.8842769729836408,-0.3827628646653866,0.12378063676907305,1.2770371294566687,82401,84117,Lewis,Lewis,53,41,Washington,WA
53045,53CS016,604,576,633,623,19,-10,47,13,-1.3920579547353447,0.3367164635599932,2.106169391689509,0.663597388322157,751,716,786,875,124,89,159,75,0.23877744316656643,0.7266700563243976,1.2435175021945923,0.5990387249747711,66326,67384,Mason,Mason,53,45,Washington,WA
53053,53CS017,6022,5625,6418,6198,176,-220,573,304,-2.2995635038845568,-0.6159457264176387,1.3071315585876,1.7160043572094787,7454,6976,7932,8216,762,284,1240,627,-0.40104249008088627,0.1201955619504419,0.6907444638614888,0.8219559378987366,920633,925288,Pierce,Pierce,53,53,Washington,WA
53055,53CS018,131,130,133,124,-7,-9,-6,7,-3.596042502494772,-3.2097118766919364,-2.8076719264270484,-1.1075205582054601,167,164,169,159,-8,-10,-5,7,-0.9221161479402608,-0.7926911644733033,-0.6706123875101883,-1.0601325333347762,17827,18449,San Juan+Skagit,San Juan,53,55,Washington,WA
53057,53CS018,1063,1007,1119,1128,65,9,121,43,-1.2168199474921562,0.6580055230715125,2.500928610182175,0.6536512683210278,1305,1237,1372,1535,230,163,298,96,0.504651136861691,1.0297779365226467,1.5342200542028201,0.41529364618520065,129842,130573,San Juan+Skagit,Skagit,53,57,Washington,WA
53061,53CS019,4825,4468,5182,5226,401,44,758,368,-1.490459749146121,0.21307195153583003,1.8837077181279132,0.9153838850193665,5994,5564,6424,6381,387,-43,817,348,-0.43459863158029605,0.031668817758281384,0.5644020645991545,0.8969925131197042,828761,832926,Snohomish,Snohomish,53,61,Washington,WA
53063,53CS020,4176,3944,4408,4498,322,90,554,289,-1.489319077862459,0.24048035938960757,1.9933818263830476,0.8939658734058079,5174,4893,5456,5861,687,405,968,641,-0.45320683114748855,0.07347495705342456,0.5962387634185048,0.9319800937810333,538563,545261,Spokane,Spokane,53,63,Washington,WA
53067,53CS021,2063,1935,2190,2101,38,-89,166,57,-1.9709544768553264,-0.21023047618507867,1.5071511288234904,1.4448529691071534,2560,2406,2714,2906,346,192,500,201,-0.007521276248766215,0.4858353441569629,0.9767725478351603,0.5792143079074459,295078,297649,Thurston,Thurston,53,67,Washington,WA
53071,53CS022,508,481,535,541,33,6,60,37,-1.9802930528808773,-0.2583372164116106,1.5306287713130924,1.096804290233324,624,591,656,711,87,55,120,63,-0.09665951379885633,0.3759646849056035,0.8872393149638402,0.7141017208852473,62365,62666,Walla Walla,Walla Walla,53,71,Washington,WA
53073,53CS023,1489,1391,1587,1570,81,-17,179,56,-1.3899352540519225,0.4610512047633804,1.9767248284973598,0.6858070818188429,1845,1727,1963,2081,236,118,354,129,0.006685920899282627,0.4808415438729856,0.9790907060250204,0.5432338583183594,227663,228608,Whatcom,Whatcom,53,73,Washington,WA
53077,53CS024,1765,1655,1875,2127,362,252,472,303,-0.690192306492148,0.882095812252892,2.5035232496948945,0.8341224729150863,2176,2043,2308,2535,359,227,492,308,-0.2777643156803332,0.19631468393487325,0.7178268225609821,0.8548111673207317,255755,256108,Yakima,Yakima,53,77,Washington,WA
54001,54CS001,155,149,162,211,56,49,62,12,9.471470022791223,11.16680484356105,13.044253064463566,0.2117694356033506,189,181,197,251,62,54,70,35,1.2210586685768072,1.732173139345899,2.236828393734581,0.5582757363279327,15593,15464,Barbour+Pocahontas+Randolph+Tucker,Barbour,54,1,West Virginia,WV
54075,54CS001,84,83,85,99,15,14,16,3,5.731653604323037,6.112356267717901,6.493311807296556,0.18645102085127158,102,101,103,134,32,31,33,14,2.116412529444306,2.2421051267164094,2.3666161214002948,0.42983020504605185,7909,7842,Barbour+Pocahontas+Randolph+Tucker,Pocahontas,54,75,West Virginia,WV
54083,54CS001,300,288,312,323,23,11,35,4,0.9678119398003399,2.6525827617610025,4.381525810937416,0.16854323569589738,366,351,380,448,82,68,97,55,0.5045852490269556,0.9803649171247035,1.557920493301627,0.6600332036413954,27966,27813,Barbour+Pocahontas+Randolph+Tucker,Randolph,54,83,West Virginia,WV
54093,54CS001,76,76,77,101,25,24,25,4,11.851317145846869,12.245667703904676,12.655999799373697,0.15562836650608702,93,92,94,112,19,18,20,24,-0.8379020924068469,-0.7118260436224478,-0.5898489719172688,1.1851196957101002,6764,6684,Barbour+Pocahontas+Randolph+Tucker,Tucker,54,93,West Virginia,WV
54003,54CS002,958,905,1011,1158,200,147,253,65,2.778731924008945,4.3677540400459955,6.110626266921926,0.32298936820458696,1204,1139,1269,1449,245,180,310,186,-0.045744198260786004,0.45224814728857404,1.0385093563393113,0.7558391413301729,122568,125571,Berkeley+Morgan,Berkeley,54,3,West Virginia,WV
54065,54CS002,186,179,194,203,17,9,24,4,1.1390149732520884,2.913807493473603,4.733081321957637,0.22794848823508018,229,220,237,272,43,35,52,48,-0.7716735149175405,-0.27229054534953895,0.23408196168371603,1.0797167662783411,17178,17194,Berkeley+Morgan,Morgan,54,65,West Virginia,WV
54005,54CS003,273,263,282,298,25,16,35,14,0.24894023344518143,2.013819504087499,3.7550417390700366,0.5343552695475715,331,320,342,379,48,37,59,35,0.0610615853801914,0.6263822219856794,1.1102785158736863,0.7129897924684571,21619,21371,Boone+Lincoln+Logan,Boone,54,5,West Virginia,WV
54043,54CS003,242,233,251,271,29,20,38,11,1.7849494959291443,3.5827082999975977,5.209168280435666,0.36724540083598106,295,285,306,365,70,59,80,46,0.669603932598884,1.193627957091214,1.734389390607876,0.6496774152196164,20332,20157,Boone+Lincoln+Logan,Lincoln,54,43,West Virginia,WV
54045,54CS003,467,453,481,518,51,37,65,56,-2.174951610602721,-0.5943145589419108,1.164955243073966,1.0716417941232317,565,548,581,669,104,88,121,77,0.3147125989386858,0.8501520621894192,1.3813985776050346,0.732915506333032,32344,31991,Boone+Lincoln+Logan,Logan,54,45,West Virginia,WV
54007,54CS004,138,132,143,153,15,10,21,4,1.8227271762439328,3.5705771316813517,5.329585859656456,0.24614111688376075,165,158,171,199,34,28,41,22,0.5041166522508704,0.9875278275992793,1.5515848580715788,0.6243799043506235,12591,12267,Braxton+Gilmer+Lewis+Upshur,Braxton,54,7,West Virginia,WV
54021,54CS004,69,68,70,80,11,10,12,1,4.945525318752814,5.3631252202360065,5.772882772277182,0.08335805697721602,84,83,85,85,1,0,2,13,-1.7448379300360397,-1.6216704370656696,-1.4938109490581726,6.278729435900508,7452,7377,Braxton+Gilmer+Lewis+Upshur,Gilmer,54,21,West Virginia,WV
54041,54CS004,209,202,217,214,5,-3,12,5,-1.8172244581968728,-0.12473297917627409,1.5034096538672392,0.8895734697855469,255,246,264,331,76,67,85,59,0.47173523530362904,1.0198184806560515,1.5195750892809896,0.7648366943949189,16832,16909,Braxton+Gilmer+Lewis+Upshur,Lewis,54,41,West Virginia,WV
54097,54CS004,224,213,234,255,31,21,42,8,2.2276630460054005,3.863834631832418,5.612404126588223,0.24727659993896164,273,260,285,334,61,49,74,61,-0.4903216894330079,0.018572699489472256,0.49196530784069037,0.9800899992020745,23861,23790,Braxton+Gilmer+Lewis+Upshur,Upshur,54,97,West Virginia,WV
54009,54CS005,275,266,285,350,75,65,84,37,5.088651677551708,6.747843599064695,8.507022590198753,0.48903354285933626,333,321,344,418,85,74,97,57,0.7778473846194471,1.2637143786230867,1.7776592119903725,0.6607986928856776,22355,22188,Brooke+Hancock,Brooke,54,9,West Virginia,WV
54029,54CS005,362,350,374,452,90,78,102,63,1.9225855142881136,3.7872628700442035,5.479786293261596,0.6920938081153001,437,423,452,501,64,49,78,84,-1.2170854445672092,-0.686987338143042,-0.19229618259126277,1.2991375696677188,28954,28709,Brooke+Hancock,Hancock,54,29,West Virginia,WV
54011,54CS006,1100,1059,1140,1171,71,31,112,95,-2.663246044590727,-1.0445962482163669,0.792528791767892,1.3118645710685084,1341,1293,1389,1490,149,101,197,154,-0.5564701972590805,-0.06478116395785834,0.47570835870861544,1.026694787787925,93735,93523,Cabell,Cabell,54,11,West Virginia,WV
54015,54CS007,96,95,96,112,16,16,17,6,4.795839500760791,5.200390994246239,5.606138153484712,0.3433429024829183,115,114,116,146,31,30,32,20,1.26153901404161,1.3807176974798168,1.4975463160142048,0.6264312360887896,8067,7909,Clay+Fayette+Nicholas+Webster,Clay,54,15,West Virginia,WV
54019,54CS007,518,500,535,574,56,39,74,39,-0.013906142401813336,1.6965560218521327,3.475970954855709,0.6826052029868441,627,607,648,752,125,104,145,82,0.5378259718315365,1.0751771927244722,1.5913914302122594,0.6527250233092527,40625,39990,Clay+Fayette+Nicholas+Webster,Fayette,54,19,West Virginia,WV
54067,54CS007,284,274,295,291,7,-4,17,4,-1.3588174414688912,0.5020799016691542,2.263667038703113,0.5097690381993577,347,334,359,419,72,60,85,70,-0.3893005400669083,0.09886331560842185,0.6252526952771212,0.9576647418786319,24506,24333,Clay+Fayette+Nicholas+Webster,Nicholas,54,67,West Virginia,WV
54101,54CS007,105,104,106,103,-2,-3,-1,8,-5.139415998997983,-4.7472800075388975,-4.321121899929131,-9.434923027418565,128,127,129,144,16,15,17,26,-1.362017924032662,-1.2308975035020824,-1.1070081117978645,1.5440126158191827,8299,8261,Clay+Fayette+Nicholas+Webster,Webster,54,101,West Virginia,WV
54025,54CS008,408,394,422,472,64,50,78,41,1.0399216535407556,2.749988730121213,4.434140341464279,0.6322591241875167,495,478,512,609,114,97,131,78,0.5521898835084822,1.0868816309330047,1.6017543337658489,0.6786229528704668,33097,32646,Greenbrier+Monroe+Summers,Greenbrier,54,25,West Virginia,WV
54063,54CS008,148,142,153,183,35,30,41,16,4.422570021371451,6.201361735933606,7.839049399333629,0.4407422278599887,180,174,186,220,40,34,46,18,1.2981133766541937,1.7818303026387317,2.302822865163888,0.4386915835020806,12471,12332,Greenbrier+Monroe+Summers,Monroe,54,63,West Virginia,WV
54089,54CS008,163,158,168,187,24,19,29,10,3.0189911104656626,4.80789044349259,6.456223178239993,0.39549425790573034,198,192,204,247,49,43,55,23,1.6864389929334183,2.1914174193121148,2.6981959841780316,0.46060308946806655,12005,11909,Greenbrier+Monroe+Summers,Summers,54,89,West Virginia,WV
54023,54CS009,129,125,134,143,14,9,18,22,-4.662019775292626,-3.02065982912133,-1.3632936546481136,1.4970026612735436,158,152,164,168,10,4,16,27,-2.054961709581164,-1.5413708010260647,-1.0163148476796569,2.451894233584315,11035,10979,Hardy and Nearby Counties,Grant,54,23,West Virginia,WV
54027,54CS009,238,228,247,268,30,21,40,23,-0.5298535080988294,1.230968530150552,3.10482821187349,0.7305941774872707,294,282,306,341,47,35,59,46,-0.46008423304261886,0.04600939627393759,0.5489942486629267,0.9517707786432192,23113,23268,Hardy and Nearby Counties,Hampshire,54,27,West Virginia,WV
54031,54CS009,150,144,157,171,21,14,27,9,1.5036417350672056,3.194874812636486,4.8769936650218355,0.4177039009809329,184,177,192,200,16,8,23,36,-1.9350353286927178,-1.4461947951006897,-0.926305518090958,2.161508286731059,14171,14172,Hardy and Nearby Counties,Hardy,54,31,West Virginia,WV
54057,54CS009,287,276,299,353,66,54,77,70,-2.2690862414094024,-0.6000938628594158,1.072608650535032,1.0460403417684867,352,338,366,405,53,39,67,69,-1.0742877613090922,-0.5961499790447947,-0.09651572601570103,1.278404732340932,26879,26860,Hardy and Nearby Counties,Mineral,54,57,West Virginia,WV
54071,54CS009,73,73,74,100,27,26,27,0,16.53018959026172,16.950141277524253,17.37817154545932,0,89,88,89,110,21,21,22,10,1.7271478686956958,1.8565912484141347,1.9747344697506117,0.44650485228996234,6255,6141,Hardy and Nearby Counties,Pendleton,54,71,West Virginia,WV
54033,54CS010,715,686,743,724,9,-19,38,27,-2.967774220123999,-1.0562457135062195,0.5266256112648633,2.591061689955759,865,831,898,1044,179,146,213,149,-0.010791729862584618,0.46536821307343906,0.9925152410514182,0.8255980958496415,65936,65247,Harrison+Taylor,Harrison,54,33,West Virginia,WV
54091,54CS010,172,165,179,209,37,30,44,10,4.730334269229272,6.4355121262555235,8.146657233576985,0.264353396192716,208,200,217,250,42,33,50,35,-0.13559780870056012,0.38414122422162583,0.9104947364788115,0.8218132946940138,16680,16522,Harrison+Taylor,Taylor,54,91,West Virginia,WV
54013,54CS011,70,69,71,86,16,15,17,3,7.747627904348684,8.13775587023533,8.560569512803063,0.1777586014440827,84,83,85,115,31,30,32,5,4.05403333082666,4.17622585160183,4.312343409955485,0.15720586350018131,6325,6179,Jackson and Nearby Counties,Calhoun,54,13,West Virginia,WV
54035,54CS011,305,293,317,347,42,30,54,28,0.24517300215284007,1.9593171072469249,3.7152152362062583,0.6550390814168655,375,360,389,439,64,50,79,62,-0.44196641175600987,0.08979090012639461,0.5688057302835995,0.9486532952652729,27870,27738,Jackson and Nearby Counties,Jackson,54,35,West Virginia,WV
54053,54CS011,297,286,308,332,35,24,46,22,0.41816220152942135,2.01310562638066,3.7965702282079565,0.6133795869234228,362,349,375,466,104,91,117,54,1.460913911245414,2.004547134866195,2.5000620994092047,0.5122531511930503,25513,25186,Jackson and Nearby Counties,Mason,54,53,West Virginia,WV
54087,54CS011,180,174,186,170,-10,-16,-4,5,-6.19560477762218,-4.414782173123922,-2.729654100208216,-0.5343889292278236,221,213,228,223,2,-5,10,22,-1.9462176852749005,-1.3981059720029094,-0.8858758335185772,6.582149868709794,13921,13910,Jackson and Nearby Counties,Roane,54,87,West Virginia,WV
54105,54CS011,48,48,49,53,5,4,5,7,-2.0498398467908827,-1.6443321540101223,-1.259211408878919,1.201382207360073,57,57,58,83,26,25,26,13,2.362515119948277,2.491699408169196,2.618345728333146,0.4873414936958576,5258,5080,Jackson and Nearby Counties,Wirt,54,105,West Virginia,WV
54037,54CS012,430,405,455,505,75,50,100,36,1.0443306426680825,2.7538699989764552,4.398446696222337,0.47419679824749283,534,504,564,579,45,15,75,66,-0.882645705403964,-0.35923987370006893,0.1555032873471846,1.4460405620178733,57742,58277,Jefferson,Jefferson,54,37,West Virginia,WV
54039,54CS013,2135,2058,2213,2484,349,271,426,189,1.7684002810242427,3.5200452686212897,5.213838365468287,0.5404431292711486,2589,2497,2681,2966,377,285,469,303,-0.07841427948956103,0.3983088536895882,0.9101824246570287,0.8008058499222149,179588,178258,Kanawha,Kanawha,54,39,West Virginia,WV
54047,54CS014,285,277,293,309,24,16,32,5,2.47464265133711,3.960695843892439,5.833255161298711,0.20145234971018638,342,333,352,388,46,36,55,60,-1.2603576890011998,-0.7546678648216567,-0.25883913639929296,1.2829576296092788,18666,18444,McDowell+Mercer,McDowell,54,47,West Virginia,WV
54055,54CS014,754,729,780,884,130,104,155,50,3.645781985786842,5.3265990979553015,7.214296417791385,0.38221193502726375,919,888,949,1100,181,151,212,149,0.028330800710009832,0.5448322658504685,1.0833101520950126,0.8178370065854028,59331,59150,McDowell+Mercer,Mercer,54,55,West Virginia,WV
54049,54CS015,602,578,626,608,6,-18,30,18,-2.52955534190819,-0.8624865126609419,0.8344789213200337,2.5859843700837795,734,705,763,841,107,78,136,118,-0.6960558256698884,-0.1811493513296292,0.34468594653984475,1.0924153788692057,56129,56024,Marion,Marion,54,49,West Virginia,WV
54051,54CS016,331,318,344,398,67,54,80,58,-0.46059332932450003,1.173355486156269,2.798248509916254,0.8557394122313003,402,386,417,487,85,70,101,76,-0.22406674193655907,0.3054796528470641,0.8309877056465641,0.8826326309732223,30426,30163,Marshall+Ohio,Marshall,54,51,West Virginia,WV
54069,54CS016,499,481,517,600,101,83,119,47,3.3836900873730524,5.144470507010689,6.930402396539811,0.4600205351408136,605,583,627,692,87,65,109,73,-0.17218001862997545,0.35422531960415116,0.8482053327200195,0.8293904780231166,42120,41847,Marshall+Ohio,Ohio,54,69,West Virginia,WV
54059,54CS017,294,284,304,337,43,33,53,25,1.2526967389402208,3.010417262956499,4.7042882499048995,0.5732587690619331,356,344,368,472,116,104,128,89,0.7042403236853763,1.1960853505908913,1.6590506657978747,0.7589557142504602,23399,23071,Mingo+Wayne,Mingo,54,59,West Virginia,WV
54099,54CS017,438,421,455,527,89,72,106,29,4.543443479843862,6.222108760001545,8.070566455012417,0.3217794171632324,534,514,553,678,144,125,164,88,0.93335432800755,1.4751868817657663,1.98684925361927,0.605094836392432,38901,38546,Mingo+Wayne,Wayne,54,99,West Virginia,WV
54061,54CS018,606,560,652,671,65,19,111,33,-0.47808729521263504,1.2562612304814957,2.874840613298452,0.5005981158119823,749,694,804,796,47,-8,102,99,-0.9970315471493228,-0.48505118831008887,0.011378575743447573,2.0737011584981313,106018,106318,Monongalia+Preston,Monongalia,54,61,West Virginia,WV
54077,54CS018,320,305,335,343,23,8,38,36,-3.205056726642335,-1.512161786991248,0.1553519799577825,1.4957256100606107,392,375,410,460,68,50,85,78,-0.8629262442719035,-0.29555892044155535,0.1927219963780627,1.1383266951909217,34093,34331,Monongalia+Preston,Preston,54,77,West Virginia,WV
54079,54CS019,528,504,553,595,67,42,91,54,-0.8281648074689396,0.9095271385131607,2.660209448369856,0.7989402886844995,648,619,678,706,58,28,87,62,-0.5735621903595048,-0.08199281023684794,0.4199768664470502,1.0588954515701654,57254,57280,Putnam,Putnam,54,79,West Virginia,WV
54081,54CS020,900,868,932,1019,119,87,151,28,3.3226109161312642,4.917668202115285,6.625599020850013,0.23357235633700962,1093,1055,1131,1290,197,159,235,140,0.2641047353504258,0.7700176448619683,1.2443571596569785,0.70644024320904375,74188,73855,Raleigh+Wyoming,Raleigh,54,81,West Virginia,WV
54109,54CS020,270,261,280,319,49,39,58,23,3.0830914808161496,4.887872032933561,6.491398124497018,0.46391042615542954,328,317,339,388,60,49,71,58,-0.3830038152922188,0.12547126395010766,0.62225645827652,0.9463978166800637,21169,21091,Raleigh+Wyoming,Wyoming,54,109,West Virginia,WV
54017,54CS021,64,63,65,78,14,13,15,2,5.725987392279472,6.096617922427393,6.545574890459356,0.13309265594338862,77,76,78,93,16,15,17,12,0.3493090494624291,0.4658078848235672,0.5929363718418881,0.722108510811866,7878,7742,Tyler and Nearby Counties,Doddridge,54,17,West Virginia,WV
54073,54CS021,83,82,84,88,5,4,6,7,-1.6013726205740557,-1.1861825909101233,-0.8122506683407791,1.2192416219439124,102,101,103,121,19,18,20,19,-0.14632583329749388,-0.01937800703917112,0.11308858360447284,0.9563555797327772,7610,7608,Tyler and Nearby Counties,Pleasants,54,73,West Virginia,WV
54085,54CS021,90,89,91,113,23,22,24,5,7.933756644195879,8.34773695475367,8.748249833083063,0.2090070055910667,108,107,109,135,27,26,28,16,1.1968105413080432,1.3217114333765405,1.4424058308895924,0.5701362267320833,8594,8389,Tyler and Nearby Counties,Ritchie,54,85,West Virginia,WV
54095,54CS021,92,91,93,86,-6,-7,-5,9,-7.701098289013269,-7.267212061929718,-6.888339823992857,-1.7570957607199233,111,110,112,137,26,25,27,21,0.47390371107498475,0.600456416982837,0.7256793787175131,0.7800774539438236,8316,8173,Tyler and Nearby Counties,Tyler,54,95,West Virginia,WV
54103,54CS021,178,172,184,195,17,11,23,14,-0.8287706514467781,0.8450982942133419,2.545191962986605,0.7780056137209924,214,207,222,300,86,78,93,49,2.0165041123579766,2.5772119976736367,3.0771020759550254,0.5664154101062271,14469,14201,Tyler and Nearby Counties,Wetzel,54,103,West Virginia,WV
54107,54CS022,928,892,964,1004,76,40,112,74,-1.7048041610199491,0.10753231192682171,1.7708184419832333,0.9600311481932059,1132,1088,1175,1292,160,117,204,167,-0.6222081353778955,-0.07028475653437849,0.44568962608027113,1.0345398435697817,83909,83678,Wood,Wood,54,107,West Virginia,WV
55001,55CS001,229,221,238,241,12,3,20,16,-2.55153268521715,-0.8873168727411465,0.8511665694391535,1.2748516177882458,282,271,292,322,40,30,51,30,-0.027933253429683058,0.5019225971150023,1.0300349859917812,0.7230298258737292,20635,20846,Adams+Juneau+Monroe+Vernon,Adams,55,1,Wisconsin,WI
55057,55CS001,254,243,266,257,3,-9,14,18,-3.9364663849274324,-2.2703008668849955,-0.5746850870517242,5.027224999111686,311,297,324,382,71,58,85,37,0.7707067764222002,1.2560650062265308,1.785847552462614,0.5108151029792504,26753,26796,Adams+Juneau+Monroe+Vernon,Juneau,55,57,Wisconsin,WI
55081,55CS001,362,342,381,419,57,38,77,27,0.8969870624537978,2.622846776896337,4.351366092932337,0.46157855404738457,441,417,465,547,106,82,130,41,0.8967234994578293,1.396724678824004,1.9279690364787438,0.38405317647947407,46329,46206,Adams+Juneau+Monroe+Vernon,Monroe,55,81,Wisconsin,WI
55123,55CS001,253,240,266,318,65,52,78,22,3.751793570737067,5.601293572504636,7.362621456681773,0.3332224333957313,311,295,327,355,44,28,60,33,-0.17768595456043865,0.3668135869317343,0.888514154940569,0.7264711443180137,30743,30883,Adams+Juneau+Monroe+Vernon,Vernon,55,123,Wisconsin,WI
55003,55CS002,166,159,173,163,-3,-10,4,11,-5.26455161650092,-3.5238832046061344,-1.8265333737304723,-5.126746019578771,205,196,213,206,1,-7,10,18,-1.5854069004518387,-1.0377344890520317,-0.4966970794798467,7.771537559490117,15922,16088,Ashland+Bayfield+Douglas+Price,Ashland,55,3,Wisconsin,WI
55007,55CS002,150,148,152,163,13,11,15,17,-1.3555752281339175,-0.9731888986290177,-0.5718585847470405,1.206134139125912,186,184,188,189,3,1,5,13,-0.7581977708087191,-0.633841091167896,-0.5015279064527166,3.5536165230517502,16084,16307,Ashland+Bayfield+Douglas+Price,Bayfield,55,7,Wisconsin,WI
55031,55CS002,363,344,382,466,103,84,122,53,2.9937621724307037,4.488151001998612,6.331282704309275,0.5073430863140233,445,422,468,497,52,29,75,36,-0.1781050474911764,0.3712411440054929,0.871430029530347,0.6814255904280704,44155,44214,Ashland+Bayfield+Douglas+Price,Douglas,55,31,Wisconsin,WI
55099,55CS002,169,163,175,177,8,2,14,3,-0.22597603172776437,1.4634731526706863,3.1304605288020393,0.3341639896940681,207,200,214,213,6,-1,13,18,-1.346086838057469,-0.8738452869060949,-0.3592924220543351,2.6438736978357205,13921,14045,Ashland+Bayfield+Douglas+Price,Price,55,99,Wisconsin,WI
55005,55CS003,459,439,479,503,44,24,64,55,-2.7857113908604347,-0.9260821217870239,0.7734706727706746,1.2177349233753407,565,541,589,618,53,29,77,51,-0.4716212181578786,0.0457853297556146,0.5501964720644235,0.9489783239340376,46444,46708,Barron+Sawyer+Washburn,Barron,55,5,Wisconsin,WI
55113,55CS003,199,191,207,217,18,10,26,16,-1.2355695618910356,0.5314253699036395,2.198028278680486,0.8360933047598345,247,238,257,278,31,21,40,34,-0.7030560201556003,-0.1670861485072142,0.31408945742875777,1.0666073572022206,17898,18268,Barron+Sawyer+Washburn,Sawyer,55,113,Wisconsin,WI
55129,55CS003,184,177,191,203,19,12,26,13,-0.3056976782775385,1.5451504460654446,3.2674595539636218,0.6393073917403543,227,219,236,278,51,42,59,25,1.0258855787973105,1.54439852739454,2.0864877034288924,0.48392213981934495,16492,16729,Barron+Sawyer+Washburn,Washburn,55,129,Wisconsin,WI
55009,55CS004,1802,1687,1918,2060,258,142,373,216,-1.0376951393606766,0.6394326807743018,2.264959864192584,0.8342773335653408,2232,2093,2371,2374,142,3,281,196,-0.6998797649939301,-0.17668857062404983,0.3522077453715143,1.3684721938843158,268123,269467,Brown,Brown,55,9,Wisconsin,WI
55011,55CS005,113,112,114,109,-4,-5,-3,11,-4.9330896654999945,-4.520255776097192,-4.116759077922184,-3.6224061993664733,139,137,141,143,4,2,6,5,-0.20025760901282863,-0.07759478309153915,0.04205848503273772,1.00575675736506,13273,13305,Buffalo+Jackson+Pepin+Trempealeau,Buffalo,55,11,Wisconsin,WI
55053,55CS005,183,174,193,224,41,31,50,18,2.4725764178321894,4.2670524634824405,5.921812740482827,0.4331359016822294,225,214,236,236,11,0,22,15,-0.6778737827913996,-0.18195305817407115,0.33756921188805017,1.2549967254186085,21042,21118,Buffalo+Jackson+Pepin+Trempealeau,Jackson,55,53,Wisconsin,WI
55091,55CS005,60,59,60,61,1,1,2,3,-1.2733921094445042,-0.8784587472169056,-0.4633219637395729,1.2466844709985723,73,73,74,81,8,7,8,10,-0.4654530414715945,-0.33512761683273523,-0.2093497731765605,1.172721614290177,7328,7360,Buffalo+Jackson+Pepin+Trempealeau,Pepin,55,91,Wisconsin,WI
55121,55CS005,260,247,273,269,9,-4,22,33,-4.8759044446888185,-3.079736115480529,-1.3427372570850415,3.282479402981445,319,303,335,303,-16,-32,-0,16,-1.56606305793737,-1.0352066217028337,-0.5390676032867473,-1.0676358605079015,30597,30732,Buffalo+Jackson+Pepin+Trempealeau,Trempealeau,55,121,Wisconsin,WI
55013,55CS006,178,171,185,170,-8,-15,-1,27,-10.08500870372717,-8.411728846297262,-6.519669631380147,-4.085821031561587,220,212,229,229,9,0,17,23,-1.3533384255292409,-0.8578534797272575,-0.33934257765789005,2.369999379464427,16430,16721,Burnett+Polk,Burnett,55,13,Wisconsin,WI
55095,55CS006,407,388,426,423,16,-3,35,29,-2.8509152169397343,-1.1370421296492101,0.6111198243909548,1.6925087442235769,505,481,528,580,75,52,99,83,-0.6742212499175954,-0.1620351948754205,0.3732237897685271,1.0877632063264933,44861,45369,Burnett+Polk,Polk,55,95,Wisconsin,WI
55015,55CS007,323,300,345,353,30,8,53,34,-1.91918541868599,-0.3315720974663994,1.4253582577410926,1.0956172227279877,401,374,428,404,3,-24,30,57,-1.5384757217388552,-1.018707219045544,-0.502335899910929,14.430068469657595,52138,52530,Calumet+Winnebago,Calumet,55,15,Wisconsin,WI
55139,55CS007,1306,1233,1380,1525,219,145,292,172,-0.5754849160788073,1.1483287061420802,2.7130412268827553,0.7832483141771303,1605,1517,1694,1729,124,35,212,137,-0.5909701158841092,-0.08500891472092015,0.4488158716052131,1.0998645195497903,171666,171626,Calumet+Winnebago,Winnebago,55,139,Wisconsin,WI
55017,55CS008,535,507,564,584,49,20,77,56,-2.1800978016474155,-0.3966781809113421,1.324008258581433,1.1285716795911636,662,628,697,674,12,-23,46,64,-1.2815651699415938,-0.7813105657454853,-0.27927228792115755,5.0713315549810165,66109,66780,Chippewa+Rusk,Chippewa,55,17,Wisconsin,WI
55107,55CS008,160,154,166,163,3,-3,9,17,-5.488164842556555,-3.8702123123760828,-2.187919239001617,4.0506712013812685,194,187,202,234,40,32,47,28,0.30268472736302443,0.811131526121708,1.295340071083962,0.6910668952938265,14152,14130,Chippewa+Rusk,Rusk,55,107,Wisconsin,WI
55019,55CS009,290,275,305,332,42,27,57,52,-2.990666559502132,-1.0825362692066576,0.6372135619399942,1.2069979073012609,355,338,373,389,34,16,51,45,-0.8192739906692484,-0.33178627440830377,0.17234674170021888,1.3018268531735337,34663,34729,Clark+Taylor,Clark,55,19,Wisconsin,WI
55119,55CS009,162,153,170,175,13,5,22,24,-3.922200189550376,-2.064467296400068,-0.28884331189134704,1.670728251058563,198,187,208,226,28,18,39,29,-0.5315108936900673,-0.024086226868682063,0.4899359487157289,0.9891836900792333,19964,19919,Clark+Taylor,Taylor,55,119,Wisconsin,WI
55021,55CS010,484,459,509,528,44,19,69,40,-1.624895487930465,0.3543242970407985,1.8522294013896843,0.8820348479903155,595,564,625,631,36,6,67,50,-0.7239020772923295,-0.23024956279194572,0.268541862637878,1.3352296703846995,58366,58491,Columbia,Columbia,55,21,Wisconsin,WI
55023,55CS011,155,148,162,165,10,3,17,11,-1.8609437867183634,-0.23695253090666896,1.5170945995230891,0.998210000241484,190,182,199,197,7,-2,15,11,-0.7718670988157895,-0.27505697565152726,0.27045335640142265,1.4103485095989576,16090,16077,Crawford+Grant+Richland,Crawford,55,23,Wisconsin,WI
55043,55CS011,436,413,458,503,67,45,90,51,-0.4806667538820845,1.1855153451088252,3.1347728091178944,0.746808001314653,539,512,565,578,39,13,66,35,-0.41077610235538237,0.09477376082721979,0.5906386073214508,0.8660796657765927,51890,52084,Crawford+Grant+Richland,Grant,55,43,Wisconsin,WI
55103,55CS011,167,160,174,191,24,17,31,11,1.3540860326663426,2.984033597918336,5.028103462010325,0.4406951357766156,205,196,213,226,21,13,30,24,-0.6548146411772119,-0.13363737116575192,0.34781344440241324,1.0690324130716093,17273,17221,Crawford+Grant+Richland,Richland,55,103,Wisconsin,WI
55025,55CS012,2977,2735,3218,3366,389,148,631,216,-0.39426565067752434,1.2527201795858294,2.966677233624782,0.5532727464864896,3713,3422,4004,3767,54,-237,345,147,-0.6962082342119924,-0.16910569582839388,0.3280783214788319,2.656417668056161,560338,563711,Dane,Dane,55,25,Wisconsin,WI
55027,55CS013,818,780,856,1019,201,163,239,126,1.6860463634217526,3.4159002876593916,4.991726894497172,0.6235918377925109,1005,959,1051,1111,106,60,152,112,-0.595049287097718,-0.08310380535520745,0.42169905041379646,1.0495820600284274,89029,89306,Dodge,Dodge,55,27,Wisconsin,WI
55029,55CS014,311,298,324,325,14,1,27,25,-3.2513528776770064,-1.4335713808229773,0.16284729495756123,1.6848467924856199,384,368,400,381,-3,-19,13,22,-1.3514974600970115,-0.831105824536337,-0.31040302974124,-11.121586151018732,29787,30330,Door+Kewaunee+Manitowoc,Door,55,29,Wisconsin,WI
55061,55CS014,163,154,172,191,28,19,37,26,-1.2949830805737252,0.36894218219667585,2.062558181982312,0.9007101339231994,200,189,210,206,6,-4,17,15,-0.942902769579284,-0.4340701005013565,0.12792311194779274,2.0574738548206755,20527,20542,Door+Kewaunee+Manitowoc,Kewaunee,55,61,Wisconsin,WI
55071,55CS014,763,728,798,844,81,46,116,56,-0.4885802049414109,1.221438488485163,2.95373950273133,0.6807718168817916,935,893,977,948,13,-29,55,71,-1.1913718468712329,-0.7241190060557643,-0.2199494302284315,5.073675737857007,80917,81468,Door+Kewaunee+Manitowoc,Manitowoc,55,71,Wisconsin,WI
55033,55CS015,302,283,322,306,4,-16,23,23,-3.4157684864226425,-1.695302199938476,0.08900009537871918,4.821304089366152,373,349,396,414,41,18,65,33,-0.36882961574206474,0.19067313872207736,0.6852779209203992,0.7765979434908669,45443,45531,Dunn+Eau Claire,Dunn,55,33,Wisconsin,WI
55035,55CS015,758,712,803,846,88,43,134,81,-1.2149587308978151,0.29058779765252346,2.0236061621976416,0.9054612406721122,935,880,990,998,63,8,118,68,-0.5518345812499594,-0.05201980571025038,0.4146807273580406,1.0693452879147758,105687,106360,Dunn+Eau Claire,Eau Claire,55,35,Wisconsin,WI
55037,55CS016,59,58,59,63,4,4,5,13,-8.1441243563955,-7.743850246819707,-7.332960142875391,2.4804415488375895,73,72,74,67,-6,-7,-5,8,-3.1924613033474474,-3.0689368401349344,-2.945731403092017,-1.5780398604907302,4523,4588,Florence+Forest+Marinette+Oconto,Florence,55,37,Wisconsin,WI
55041,55CS016,107,106,108,99,-8,-9,-7,21,-12.981080383652909,-12.552893527503537,-12.16042389354092,-3.110300094663319,132,131,133,152,20,19,21,15,0.3823786781295532,0.5116367966705329,0.6362844973680435,0.7246007358367932,9152,9244,Florence+Forest+Marinette+Oconto,Forest,55,41,Wisconsin,WI
55075,55CS016,475,457,492,538,63,46,81,63,-1.5879193823014934,0.0363367057199609,1.6616716821247375,0.9771057266782327,583,561,604,615,32,11,54,44,-0.7877431448664736,-0.27582605693463746,0.23127863496767553,1.3253785824350524,41634,41874,Florence+Forest+Marinette+Oconto,Marinette,55,75,Wisconsin,WI
55083,55CS016,332,315,348,396,64,48,81,49,-0.12807124710788026,1.5704579304712756,3.364608255693356,0.7482138504439839,412,391,432,414,2,-18,23,34,-1.3246615651299318,-0.8137544961030856,-0.25442317783749535,10.350903603640283,38932,39310,Florence+Forest+Marinette+Oconto,Oconto,55,83,Wisconsin,WI
55039,55CS017,836,792,881,999,163,118,207,108,0.43878501486484334,2.118244478182936,3.865766084929539,0.6596836210222485,1033,979,1087,1182,149,95,203,106,-0.10637606834258578,0.40712071645651005,0.9039227240045807,0.7064751086561644,103960,104320,Fond du Lac,Fond du Lac,55,39,Wisconsin,WI
55045,55CS018,296,280,312,340,44,28,60,14,1.4725260701334386,3.210596830405584,4.8776315090121365,0.31365673822821577,362,343,381,397,35,16,54,29,-0.3524660125473795,0.1609841673404702,0.6928928747168055,0.8120836248827425,36971,36989,Green+Iowa+Lafayette,Green,55,45,Wisconsin,WI
55049,55CS018,178,168,188,197,19,9,29,3,1.1340657418031965,2.760615553569487,4.399473517187215,0.14771169071618595,218,206,230,212,-6,-18,6,12,-1.2665054517049847,-0.7534173355495598,-0.26298310581712586,-2.4089351695441814,23680,23744,Green+Iowa+Lafayette,Iowa,55,49,Wisconsin,WI
55065,55CS018,121,120,123,142,21,19,22,3,3.807101780447653,4.225375859245301,4.610095591955038,0.139235143545008,150,148,152,165,15,13,17,14,-0.08874233202767459,0.0392928623430664,0.16010295428911192,0.8927355148516076,16633,16758,Green+Iowa+Lafayette,Lafayette,55,65,Wisconsin,WI
55047,55CS019,203,195,212,221,18,9,26,19,-1.9926147730841437,-0.36430491341082916,1.3338418227974922,1.0226124155421417,251,241,260,286,35,26,45,31,-0.2949803803825665,0.22990999272589138,0.7237032453396968,0.8509234229576175,19008,19195,Green Lake+Marquette+Waushara,Green Lake,55,47,Wisconsin,WI
55077,55CS019,173,166,180,210,37,30,44,24,1.6121485875302175,3.3930092272256798,4.983707831432297,0.6300836285037383,213,205,221,250,37,29,45,25,0.24263528392662376,0.7506249299003376,1.302563906135038,0.6580216815367319,15599,15762,Green Lake+Marquette+Waushara,Marquette,55,77,Wisconsin,WI
55137,55CS019,246,235,257,289,43,32,54,25,1.180769056832704,2.8733500698544976,4.685162604057258,0.5682556431970307,304,291,316,331,27,15,40,41,-1.070231998033253,-0.5495878467398346,-0.01957460463332821,1.4402341052686818,24526,24782,Green Lake+Marquette+Waushara,Waushara,55,137,Wisconsin,WI
55051,55CS020,79,79,80,93,14,13,14,19,-3.9260438247217326,-3.538388167642793,-3.1333038320981723,1.2975013835788822,99,98,100,109,10,9,11,5,0.7099677219173611,0.8417700181647197,0.9747619171242935,0.44733940640613196,6069,6171,Iron+Oneida+Vilas,Iron,55,51,Wisconsin,WI
55085,55CS020,424,408,441,499,75,58,91,46,1.3664465034451716,3.0132863805393555,4.748088364822822,0.6088961065513436,526,506,545,531,5,-14,25,45,-1.5548570406900681,-1.0617057713209854,-0.48336320688814033,7.169835594679249,37557,38198,Iron+Oneida+Vilas,Oneida,55,85,Wisconsin,WI
55125,55CS020,280,270,290,282,2,-8,12,29,-6.357051025032787,-4.6408526482096955,-2.9425552620443143,8.639872025228815,347,335,359,365,18,6,30,42,-1.577216595740885,-1.0457630809447882,-0.4948069406053164,2.252150056552271,22988,23455,Iron+Oneida+Vilas,Vilas,55,125,Wisconsin,WI
55055,55CS021,608,571,644,713,105,69,142,83,-0.6529019053745645,1.0238284123462618,2.814764079589325,0.7828356684586396,751,707,795,891,140,96,184,85,0.135057289252871,0.6369883762344993,1.1563017620871736,0.6029434122507858,84863,84931,Jefferson,Jefferson,55,55,Wisconsin,WI
55059,55CS022,1250,1177,1323,1488,238,165,311,229,-1.5198909585070075,0.16593783561055514,1.8527970403296645,0.9583059861772593,1538,1451,1625,1707,169,82,256,180,-0.5779212293712362,-0.05556049357143336,0.4716984521645122,1.0606903511730261,169138,168782,Kenosha,Kenosha,55,59,Wisconsin,WI
55063,55CS023,893,842,945,1004,111,59,162,69,-0.3588474031205889,1.4149900944335192,3.20276094156218,0.6186648759448735,1101,1039,1163,1140,39,-23,101,68,-0.741335905348036,-0.24473667118082285,0.2855544823921784,1.7088120149571004,120414,120494,La Crosse,La Crosse,55,63,Wisconsin,WI
55067,55CS024,200,192,209,256,56,47,64,35,2.5544179349990634,4.277562546523707,6.00579997078712,0.618065336133988,246,236,256,306,60,50,70,18,1.6639852542576605,2.1493789501180305,2.625201247333374,0.295246426744472,19411,19493,Langlade+Lincoln+Menominee+Shawano,Langlade,55,67,Wisconsin,WI
55069,55CS024,294,281,306,372,78,66,91,68,-0.29626709190170786,1.4242839788300035,3.1057847034150234,0.8569812238077855,362,347,376,437,75,61,90,50,0.4116595767159767,0.892905398812922,1.3781040153319168,0.655216725161365,28278,28517,Langlade+Lincoln+Menominee+Shawano,Lincoln,55,69,Wisconsin,WI
55078,55CS024,41,39,43,59,18,16,20,14,1.7665196499241085,3.4149989547229223,5.025738392417019,0.7495274585626813,51,48,53,65,14,12,17,5,1.714980092785867,2.207941336786749,2.6921424051387426,0.32519425409885394,4302,4284,Langlade+Lincoln+Menominee+Shawano,Menominee,55,78,Wisconsin,WI
55115,55CS024,407,389,424,477,70,53,88,63,-0.9634216443224681,0.7056548998418596,2.519542217020539,0.8843941264831429,498,477,519,505,7,-14,28,39,-1.3296112563741584,-0.7955771674424573,-0.2909939899378144,5.097575537138328,40834,40856,Langlade+Lincoln+Menominee+Shawano,Shawano,55,115,Wisconsin,WI
55073,55CS025,1065,1006,1124,1209,144,85,203,156,-2.0680907584704453,-0.36997151201639844,1.3888610038046403,1.074909765093788,1309,1238,1381,1444,135,63,206,190,-0.9227469553877019,-0.4033726780577033,0.11849880754857967,1.4018718442231972,137593,137693,Marathon,Marathon,55,73,Wisconsin,WI
55079,55CS026,7061,6658,7464,8848,1787,1384,2190,898,2.041117053757094,3.8151525924597673,5.426087293149437,0.5022701805014568,8623,8143,9103,9486,863,383,1343,274,0.14676136515213192,0.6275343405830217,1.1352352413323814,0.31698250807431855,938390,929530,Milwaukee,Milwaukee,55,79,Wisconsin,WI
55087,55CS027,1295,1213,1377,1498,203,121,285,164,-0.8870616348595515,0.8515129069391161,2.4487012237002266,0.8049290908974455,1604,1505,1702,1673,69,-29,168,140,-0.8839863833638834,-0.37415279828131803,0.1450363763473301,1.9893429459879712,190483,191441,Outagamie,Outagamie,55,87,Wisconsin,WI
55089,55CS028,703,664,742,781,78,39,117,85,-2.0281707411713716,-0.28459942690341516,1.3316199227932322,1.0751833315970705,872,824,920,906,34,-14,82,71,-0.9037848781118819,-0.41270744718948077,0.09892574799917558,2.035324214777144,91378,92362,Ozaukee,Ozaukee,55,89,Wisconsin,WI
55093,55CS029,247,229,265,287,40,22,58,25,-0.2280532909179316,1.4160020986392585,3.1235300987413157,0.6082005559569005,306,284,328,370,64,42,86,30,0.27951647417488584,0.7908993018172841,1.3187928835410125,0.46149056640303443,42316,42529,Pierce+St. Croix,Pierce,55,93,Wisconsin,WI
55109,55CS029,545,505,586,628,83,42,123,41,0.13574163820967228,1.8572426046115547,3.429049150566933,0.4898080246718436,680,632,729,812,132,83,180,90,-0.07155492962498818,0.4378643459639946,0.9639679383645108,0.6792256336725702,93474,94862,Pierce+St. Croix,St. Croix,55,109,Wisconsin,WI
55097,55CS030,455,425,486,520,65,34,95,45,-0.6634653568449768,1.0898937751845674,2.8045074159177723,0.6843094711199559,562,526,599,717,155,118,191,76,0.5742224786587531,1.0893847708044764,1.5917223891182457,0.4883607760606513,70470,70455,Portage,Portage,55,97,Wisconsin,WI
55101,55CS031,1611,1526,1695,1934,323,239,408,267,-0.6397436175976337,1.1480653542635129,2.9702662798763155,0.8228454218037392,1977,1876,2079,2230,253,151,354,217,-0.3433945586584769,0.18380306983446354,0.6649773581340075,0.85590992836256,197203,196975,Racine,Racine,55,101,Wisconsin,WI
55105,55CS032,1326,1256,1397,1564,238,167,308,139,0.7718602473763958,2.382167258812543,4.105802997764594,0.5820626362793876,1636,1551,1720,1770,134,50,219,127,-0.4718246249713543,0.046161560792997915,0.5606461905307577,0.9379403404938291,163644,164273,Rock,Rock,55,105,Wisconsin,WI
55111,55CS033,565,537,593,631,66,38,94,44,-0.32796503448396175,1.4405537498007177,3.1331977400308335,0.65772828193946,692,658,726,753,61,27,95,67,-0.6139902248542172,-0.1083083551054223,0.4449070428516811,1.0834560248596556,65527,65700,Sauk,Sauk,55,111,Wisconsin,WI
55117,55CS034,986,935,1037,1137,151,100,202,127,-0.870255606694073,0.7925255744069951,2.5946177837583697,0.8355413672013033,1211,1150,1272,1251,40,-21,101,102,-1.0223767178497676,-0.5247542438980347,0.029577197228755906,2.47343470455752,117523,117775,Sheboygan,Sheboygan,55,117,Wisconsin,WI
55127,55CS035,835,790,881,998,163,117,208,116,-0.015333809180256234,1.7574479811175,3.3936293918049873,0.7083009683223943,1033,978,1088,1095,62,7,117,95,-0.8234516566373559,-0.3136179830911374,0.2057131767156822,1.5034761587030172,106151,106755,Walworth,Walworth,55,127,Wisconsin,WI
55131,55CS036,1017,958,1076,1188,171,112,230,117,-0.20409799815592658,1.5732026511853892,3.4099683379924546,0.6813285435585297,1258,1187,1329,1387,129,58,200,129,-0.4923124459160909,0.01124748171991943,0.5094383219762904,0.991521499120236,136715,137110,Washington,Washington,55,131,Wisconsin,WI
55133,55CS037,3024,2848,3199,3670,646,471,822,421,0.41087078846305247,2.244131212791836,3.995343690227458,0.6502082029216886,3739,3528,3950,4148,409,198,620,329,-0.3770930305248752,0.20614959520974796,0.7244711715685742,0.8019189044205931,406936,408522,Waukesha,Waukesha,55,133,Wisconsin,WI
55135,55CS038,621,599,643,716,95,73,117,118,-3.490087367787526,-1.7625873393519647,-0.1219375810131675,1.232032590154377,756,729,783,759,3,-24,30,71,-1.8605118818019566,-1.3344379210316104,-0.8186992643948043,18.303477753643303,51574,51591,Waupaca,Waupaca,55,135,Wisconsin,WI
55141,55CS039,721,689,753,824,103,71,135,52,1.076337259271275,2.754111247202196,4.510097137957996,0.49969487286770436,885,847,923,1051,166,128,204,122,0.0695385177933881,0.5874971445684525,1.1155836631105271,0.729454583356588,73900,74073,Wood,Wood,55,141,Wisconsin,WI
56003,56CS001,118,117,119,127,9,8,10,14,-2.0694214381371228,-1.644754946655881,-1.2510822972597617,1.3656021019466313,146,145,147,190,44,43,45,32,0.9061836820799728,1.0322407655472623,1.1625762682917893,0.7111123778307386,11525,11608,Big Horn+Hot Springs+Park+Washakie,Big Horn,56,3,Wyoming,WY
56017,56CS001,63,63,64,80,17,16,17,2,12.404489054874647,12.791127048074982,13.194271373648926,0.1131734578313043,78,77,78,87,9,9,10,10,-0.33318220600259707,-0.20201644470965457,-0.07046064303718809,0.9912890047258476,4589,4601,Big Horn+Hot Springs+Park+Washakie,Hot Springs,56,17,Wyoming,WY
56029,56CS001,257,244,270,303,46,33,59,14,2.510322890546645,4.303807499244323,6.036761171660375,0.29871437098798403,322,307,338,441,119,103,134,103,-0.009680336128358238,0.5344386502938656,1.0280638174762935,0.8605338552245207,29635,30042,Big Horn+Hot Springs+Park+Washakie,Park,56,29,Wyoming,WY
56043,56CS001,72,71,73,87,15,14,16,21,-3.6430641274493567,-3.2301197197952547,-2.8211990271217013,1.3311642913969248,89,88,90,113,24,23,25,18,0.6298351771025688,0.764672101998996,0.8869169921543059,0.7238692284758284,7687,7698,Big Horn+Hot Springs+Park+Washakie,Washakie,56,43,Wyoming,WY
56013,56CS002,362,345,379,486,124,107,141,64,4.4402807739792305,6.142702731338483,7.821512219991939,0.5106226331192484,445,425,466,579,134,113,154,91,0.5458617043627191,1.0782789643214379,1.5450652863564567,0.6755598546057386,39236,39313,Fremont+Lincoln+Sublette+Teton,Fremont,56,13,Wyoming,WY
56023,56CS002,123,121,125,155,32,30,34,10,4.043823366163963,4.426488514390671,4.811262542395829,0.30372637217938403,155,152,157,173,18,16,21,15,0.03779445900147585,0.1667566206515144,0.2974087640995095,0.7735152461933409,19762,20083,Fremont+Lincoln+Sublette+Teton,Lincoln,56,23,Wyoming,WY
56035,56CS002,47,46,48,67,20,19,21,4,6.649000219745824,7.051195357148043,7.4774531666103865,0.19366695361593203,57,56,59,78,21,19,22,16,0.3935103947654813,0.5200319874250124,0.650632794704427,0.7425446924044838,8887,8701,Fremont+Lincoln+Sublette+Teton,Sublette,56,35,Wyoming,WY
56039,56CS002,87,85,90,79,-8,-11,-6,8,-3.199932973773784,-2.786328146968229,-2.393558948138591,-1.099797162801721,110,107,113,89,-21,-24,-18,5,-1.222943976098913,-1.0986924171420043,-0.9698180880677719,-0.25246074250383854,23376,23542,Fremont+Lincoln+Sublette+Teton,Teton,56,39,Wyoming,WY
56021,56CS003,744,700,787,821,77,34,121,63,-1.187768188057743,0.5722472831349387,2.2354470683410748,0.8044109168516955,919,867,971,1258,339,287,391,173,1.1128924000878158,1.6477750236438975,2.144258422289426,0.5086223898106401,100588,100838,Laramie,Laramie,56,21,Wyoming,WY
56025,56CS004,622,587,656,761,139,105,174,95,0.6010797565170057,2.215701376776625,3.8520765989005783,0.6764844693222771,761,720,802,934,173,132,214,131,-0.001558667469147233,0.5370587828314328,1.0619636708304538,0.753299764499998,80087,79653,Natrona,Natrona,56,25,Wyoming,WY
56005,56CS005,218,198,238,276,58,38,78,39,-0.05877600902567878,1.5860039368129546,3.2867938198577815,0.6642721616707117,270,246,294,367,97,73,121,86,-0.2517805922609398,0.237452632069511,0.7424233981001276,0.8788794076221873,46940,46505,Northeast Wyoming,Campbell,56,5,Wyoming,WY
56011,56CS005,53,52,53,99,46,46,47,10,19.63777339334043,20.01749979065786,20.423773053917017,0.21148843494083705,65,64,66,82,17,16,18,13,0.3849843189196706,0.5168245706762132,0.640504941732401,0.7318278017261932,7250,7295,Northeast Wyoming,Crook,56,11,Wyoming,WY
56019,56CS005,83,82,83,84,1,1,2,6,-2.5722394743585584,-2.1638404784615815,-1.7618934406309994,2.493907793804101,103,102,104,110,7,6,8,0,0.7345997404785877,0.8545713740335348,0.996317462183877,0,8489,8599,Northeast Wyoming,Johnson,56,19,Wyoming,WY
56033,56CS005,286,272,299,300,14,1,28,18,-2.075636943460822,-0.4962548928434873,1.4169026026447271,1.1623427672199973,355,339,372,384,29,12,45,43,-0.9378185306140836,-0.46337337507572285,0.054361369737732826,1.4539522317219369,31006,31551,Northeast Wyoming,Sheridan,56,33,Wyoming,WY
56045,56CS005,55,54,56,68,13,12,14,7,3.182650353357676,3.590238252366477,4.014352649707337,0.49627609533190437,67,66,68,106,39,38,40,11,4.029910185064218,4.169834469394453,4.29523814261112,0.2740551486948236,6813,6754,Northeast Wyoming,Weston,56,45,Wyoming,WY
56001,56CS006,172,156,188,213,41,25,57,10,1.587751943404187,3.345130056190981,5.045337888097177,0.23788772082814413,218,199,237,267,49,30,68,34,-0.10018847419725961,0.40849735396348597,0.9000513255685803,0.6815361971980491,37388,37531,"Southeast Wyoming, excluding Laramie",Albany,56,1,Wyoming,WY
56007,56CS006,108,107,110,137,29,27,30,17,2.8374401780513847,3.237797657616044,3.6507665571413117,0.5708547453727572,133,131,135,162,29,27,31,31,-0.28104723942570037,-0.15044528842478835,-0.021355662862663896,1.0414105777409866,14563,14627,"Southeast Wyoming, excluding Laramie",Carbon,56,7,Wyoming,WY
56009,56CS006,103,101,104,127,24,23,26,4,5.5440509056318685,5.9274261691577,6.3423491289398255,0.15764261677178992,125,124,127,164,39,37,40,36,0.07278712389874091,0.20152991023898775,0.33251906436362355,0.9055062504932566,13739,13680,"Southeast Wyoming, excluding Laramie",Converse,56,9,Wyoming,WY
56015,56CS006,135,129,140,160,25,20,31,19,0.48701399450956306,2.0454300079459165,3.7448172436425535,0.7208279293875474,165,158,171,188,23,17,30,31,-1.1515066696133867,-0.5963620078769983,-0.10003759176953919,1.2707993149663412,12612,12532,"Southeast Wyoming, excluding Laramie",Goshen,56,15,Wyoming,WY
56027,56CS006,24,23,25,33,9,8,10,6,3.7508505880466214,5.433911334998506,7.067871804600081,0.5849326472566162,29,28,31,36,7,5,8,8,-1.015115211669909,-0.5139255309901408,0.04340503425289922,1.0341835145845137,2424,2438,"Southeast Wyoming, excluding Laramie",Niobrara,56,27,Wyoming,WY
56031,56CS006,84,83,85,96,12,11,13,6,2.302212006234456,2.6827752554398776,3.0744139302305267,0.46935857001002057,104,103,105,171,67,66,68,25,4.71717275586446,4.835524783012083,4.967356631514093,0.36752754222685524,8609,8688,"Southeast Wyoming, excluding Laramie",Platte,56,31,Wyoming,WY
56037,56CS007,253,235,271,357,104,86,122,22,6.073154966942192,7.7826621888792085,9.507202608329397,0.2096586551476405,311,289,332,414,103,82,125,82,-0.0046543489917731115,0.505420373012305,1.0687517413097272,0.7874074865078896,42212,41693,Sweetwater+Uinta,Sweetwater,56,37,Wyoming,WY
56041,56CS007,139,130,148,154,15,6,24,2,0.7994607350057937,2.4807715147429885,4.184584659265756,0.12650250896590137,174,163,184,186,12,2,23,23,-1.0544380216454585,-0.4989333948297145,-6.967670103795101e-4,1.704730332765402,20425,20607,Sweetwater+Uinta,Uinta,56,41,Wyoming,WY
