FIPSCode,csCode,expDeathsMed2020,expDeathsLow2020,expDeathsUp2020,deaths2020,excDeathsMed2020,excDeathsLow2020,excDeathsUp2020,COVIDDeaths2020,nonCovidExcCDRLow2020,nonCovidExcCDRMed2020,nonCovidExcCDRUp2020,COVIDExcRatio2020,expDeathsMed2021,expDeathsLow2021,expDeathsUp2021,deaths2021,excDeathsMed2021,excDeathsLow2021,excDeathsUp2021,COVIDDeaths2021,nonCovidExcCDRLow2021,nonCovidExcCDRMed2021,nonCovidExcCDRUp2021,COVIDExcRatio2021,pop2020,pop2021,csName,countyName,stateFIPS,countyFIPS,state,stateStr
01001,01CS001,455,431,479,565,110,86,134,55,0.5548473529606054,0.9866068746897615,1.4196231368847794,0.4958529305050821,559,530,588,706,147,118,176,107,0.242370352765157,0.8287001735876572,1.4971510338393208,0.7237602690669342,55926,55926,Autauga,Autauga,1,1,Alabama,AL
01003,01CS002,1984,1886,2083,2277,293,194,391,165,0.12705879593275415,0.5647841375683663,1.0227192370593037,0.5614501427115937,2440,2321,2558,3094,654,536,773,435,0.5745102490914151,1.1504376716843372,1.8229889408049154,0.6637673192280646,225949,225949,Baldwin,Baldwin,1,3,Alabama,AL
01005,01CS003,252,241,262,324,72,62,83,38,0.9745343110885161,1.3878982632720047,1.807432150966069,0.519734066076134,309,296,322,372,63,50,76,52,-0.07029976688452161,0.5354020872981649,1.156916191556715,0.8143730127427036,24629,24629,Barbour+Bullock+Henry,Barbour,1,5,Alabama,AL
01011,01CS003,101,100,102,132,31,30,32,20,0.9822694797686509,1.0942428552794046,1.193354187071978,0.6254878528140384,124,123,125,141,17,16,18,13,0.32487184982895134,0.46569086651008895,0.6177711671979367,0.7252511083512884,10074,10074,Barbour+Bullock+Henry,Bullock,1,11,Alabama,AL
01067,01CS003,193,185,200,228,35,28,43,24,0.21745059616613854,0.6461575374967734,1.0665926984348082,0.6623256661126431,236,227,245,269,33,24,42,37,-0.9373177999959701,-0.3196661071196249,0.27487915956771236,1.0979482505735516,17166,17166,Barbour+Bullock+Henry,Henry,1,67,Alabama,AL
01007,01CS004,219,209,228,252,33,24,43,40,-0.7402052557140417,-0.27668715960268425,0.11203673170589361,1.1657664434011876,269,257,280,336,67,56,79,46,0.5709241583186088,1.1379774720461087,1.7328602876363406,0.67538228139970935,22239,22239,Bibb+Chilton+Coosa+Perry,Bibb,1,7,Alabama,AL
01021,01CS004,439,420,458,529,90,71,109,76,-0.10425210934591557,0.3252976108130128,0.7952116552719051,0.8338664237944189,540,517,563,653,113,90,136,107,-0.46692670776014455,0.15861676987249965,0.7837064607022536,0.9389274849928582,44348,44348,Bibb+Chilton+Coosa+Perry,Chilton,1,21,Alabama,AL
01037,01CS004,133,128,138,144,11,6,16,19,-1.164357688139563,-0.7531650642038268,-0.3388234147446113,1.5890767855555594,163,157,168,184,21,16,27,21,-0.5537396606966455,0.037505453679791,0.6567776348446522,0.9465504753171817,10666,10666,Bibb+Chilton+Coosa+Perry,Coosa,1,37,Alabama,AL
01105,01CS004,101,100,102,141,40,39,41,23,1.8463847898438512,1.9442455046779195,2.0552513102324035,0.5583371410368145,124,122,125,160,36,35,38,21,1.9485038834864763,2.100491377058114,2.2622591085574895,0.5605539143690597,8835,8835,Bibb+Chilton+Coosa+Perry,Perry,1,105,Alabama,AL
01009,01CS005,586,561,611,731,145,120,170,92,0.4972130650722419,0.9054739477201937,1.3632545348778482,0.6318465908657709,719,689,749,838,119,89,149,98,-0.24071701327422,0.4334145782006331,1.0548582098405446,0.8179931200738303,57856,57856,Blount,Blount,1,9,Alabama,AL
01013,01CS006,219,211,228,256,37,28,45,52,-1.1969967056548647,-0.7828641122286396,-0.3590939248300997,1.3778346315641499,268,258,278,307,39,29,49,47,-1.0642729219712945,-0.46222017292252665,0.1285395842243516,1.1667795654435067,19502,19502,Butler+Crenshaw+Pike,Butler,1,13,Alabama,AL
01041,01CS006,161,155,167,209,48,42,54,29,0.9775743826092749,1.4005151020244606,1.8322840867650168,0.5884768975558813,196,189,203,240,44,37,51,30,0.6030015050937202,1.2150395886439656,1.7852601261482917,0.6657434660795458,13757,13757,Butler+Crenshaw+Pike,Crenshaw,1,41,Alabama,AL
01109,01CS006,268,254,282,359,91,77,105,45,0.9797194029079024,1.4033159741530787,1.8383345731213039,0.4885512930516197,329,312,346,455,126,109,143,74,1.2918966509757366,1.8875320144743282,2.507670218665662,0.5835627083141238,33006,33006,Butler+Crenshaw+Pike,Pike,1,109,Alabama,AL
01015,01CS007,1238,1189,1287,1535,297,248,346,175,0.6284417224563974,1.0741052191851406,1.516249603653694,0.5872644250723044,1511,1453,1570,1863,352,293,410,302,-0.07423927184695125,0.5092331686251718,1.1654409835273147,0.8564651165922668,113820,113820,Calhoun,Calhoun,1,15,Alabama,AL
01017,01CS008,357,342,371,516,159,145,174,73,2.140467223163596,2.616068928207017,3.01831323797426,0.4551181377813716,433,416,450,576,143,126,160,77,1.8081902170932498,2.3903257834054226,3.010950883726675,0.5351198007683162,33086,33086,Chambers+Cleburne+Randolph,Chambers,1,17,Alabama,AL
01029,01CS008,168,161,174,189,21,15,28,25,-0.6506862234162335,-0.24693001644704216,0.15462969498279164,1.1272514622723682,204,196,212,261,57,49,65,41,0.6585410849689101,1.2916742356114603,1.935789272353932,0.706359234496966,14958,14958,Chambers+Cleburne+Randolph,Cleburne,1,29,Alabama,AL
01111,01CS008,260,250,270,306,46,36,56,54,-0.7855433285713632,-0.35420739287715647,0.0786551087019852,1.151483488034594,316,304,328,355,39,27,51,55,-1.5021962423815247,-0.8502122977289043,-0.2556583031846332,1.3817020576021837,22839,22839,Chambers+Cleburne+Randolph,Randolph,1,111,Alabama,AL
01019,01CS009,305,294,316,398,93,82,104,34,1.799172438097831,2.2360869257756506,2.657184489297538,0.36201402614531797,372,359,386,468,96,82,109,64,0.7744090736756832,1.4541775964001888,2.1102099549741644,0.6623121808406839,26271,26271,Cherokee+Etowah,Cherokee,1,19,Alabama,AL
01055,01CS009,1190,1146,1234,1446,256,212,300,222,-0.11551030406476204,0.340130963794591,0.7638102848998044,0.8638963490666182,1452,1399,1505,1818,366,313,419,287,0.33214117315399055,0.9355127125382457,1.5358467608660422,0.7823519319609898,102423,102423,Cherokee+Etowah,Etowah,1,55,Alabama,AL
01023,01CS010,152,147,158,160,8,2,13,31,-2.295627375568998,-1.8646990814775886,-1.4527535512502658,3.5924561880911945,186,180,193,210,24,17,30,23,-0.5432922243636743,0.07637639607544593,0.6560911052385171,0.927659603980391,12511,12511,Choctaw+Clarke+Washington,Choctaw,1,23,Alabama,AL
01025,01CS010,255,245,265,371,116,106,126,43,2.7045205576939786,3.115047838841834,3.5761624328380766,0.36629947500385807,312,300,324,388,76,64,88,53,0.6123536758033955,1.2174587581146035,1.802252037309952,0.6865945395218053,23501,23501,Choctaw+Clarke+Washington,Clarke,1,25,Alabama,AL
01129,01CS010,172,165,179,188,16,9,23,24,-0.90121202932981,-0.4736122787680823,-0.05246816940544942,1.3913776508793303,210,202,219,243,33,24,41,32,-0.5689657712980698,0.025769363816079575,0.6045283757604597,0.950935056299712,16153,16153,Choctaw+Clarke+Washington,Washington,1,129,Alabama,AL
01027,01CS011,152,146,158,218,66,60,72,40,1.5303533488212016,1.9561935482114288,2.403272184590686,0.5975590207823498,185,178,192,235,50,43,57,24,1.6687344018766903,2.3566179096622215,2.970625148738465,0.47305493735293935,13201,13201,Clay+Talladega,Clay,1,27,Alabama,AL
01121,01CS011,854,819,888,1038,184,150,219,130,0.28011427627163044,0.6734170122584824,1.0965462070874243,0.7012020881220112,1042,1001,1084,1362,320,278,361,203,1.1906759321510587,1.7394022119344352,2.3766441786665466,0.6327950242082585,80126,80126,Clay+Talladega,Talladega,1,121,Alabama,AL
01031,01CS012,473,451,496,616,143,120,165,70,0.9459712992472649,1.3694392138873273,1.8126582016803998,0.4876652800418176,583,555,610,715,132,105,160,128,-0.5681239405091334,0.0830910261793772,0.7412269377342137,0.9619154997412089,52885,52885,Coffee+Geneva,Coffee,1,31,Alabama,AL
01061,01CS012,312,301,324,402,90,78,101,54,0.8648689132196447,1.3502616363926134,1.738235325725951,0.5962820197145796,382,368,396,527,145,131,159,81,2.259120763051969,2.9179476890706453,3.517049655726599,0.5552353620962812,26352,26352,Coffee+Geneva,Geneva,1,61,Alabama,AL
01033,01CS013,630,606,654,675,45,21,69,83,-1.1168272897504743,-0.6822583541497066,-0.2743650485864159,1.8170303078702408,770,741,799,882,112,83,141,117,-0.7550066239305886,-0.11355404492656135,0.46909249569982403,1.0348951623890548,55312,55312,Colbert,Colbert,1,33,Alabama,AL
01035,01CS014,152,147,157,183,31,26,36,27,-0.11382183253976456,0.3315977825097153,0.7390406083976596,0.84745756600739,187,181,193,220,33,27,39,35,-0.805685479459947,-0.16584548762052154,0.42527685657355135,1.0235881823847703,11970,11970,Conecuh+Marengo+Monroe+Wilcox,Conecuh,1,35,Alabama,AL
01091,01CS014,232,224,240,281,49,41,57,35,0.35475183222345735,0.7497614104384027,1.1419235954149989,0.69888189129552,285,276,295,350,65,55,74,60,-0.32092396309078064,0.31848774921961126,0.9314759473849366,0.9117207457643045,18842,18842,Conecuh+Marengo+Monroe+Wilcox,Marengo,1,91,Alabama,AL
01099,01CS014,226,217,235,283,57,48,66,30,0.9102000301163716,1.2968036760453565,1.733289423821925,0.5187675925195141,279,268,289,373,94,84,105,52,1.816551778742353,2.4636269708012883,3.062915115590803,0.5469208732038796,20593,20593,Conecuh+Marengo+Monroe+Wilcox,Monroe,1,99,Alabama,AL
01131,01CS014,136,131,140,150,14,10,19,22,-1.1732578519057755,-0.7703139534440466,-0.3174251677914847,1.4511117853404345,167,161,172,182,15,10,21,25,-1.7305298512027476,-1.1256158125591844,-0.5020470579908769,1.5271529287940215,10317,10317,Conecuh+Marengo+Monroe+Wilcox,Wilcox,1,131,Alabama,AL
01039,01CS015,457,441,473,591,134,118,150,90,0.7527063787652356,1.1998052909405774,1.6188429758005465,0.6668739818509708,557,538,576,723,166,147,185,126,0.676742198754094,1.3000177589185935,1.9186010715386455,0.7550597338887625,37019,37019,Convington+Escambia,Covington,1,39,Alabama,AL
01053,01CS015,403,388,419,515,112,96,127,58,1.0479627865709842,1.4641875714630348,1.932098631909303,0.5152829921006945,493,474,511,655,162,144,181,108,1.158858602572646,1.8086267768994777,2.4383605440772977,0.6606032850564254,36449,36449,Convington+Escambia,Escambia,1,53,Alabama,AL
01043,01CS016,909,873,945,1043,134,98,170,121,-0.2992117379053235,0.16656046393029722,0.5651211093028022,0.8964439509218443,1113,1070,1157,1307,194,150,237,187,-0.5507153942037969,0.09483858435667247,0.6958066060403363,0.9597489980531743,84007,84007,Cullman,Cullman,1,43,Alabama,AL
01045,01CS017,452,431,473,555,103,82,124,86,-0.10391342551304815,0.3422179744683747,0.7765583913106703,0.8240534420741602,553,528,579,735,182,156,207,96,1.4903054020819575,2.0743443780738557,2.700904224790334,0.5256176671461347,49154,49154,Dale,Dale,1,45,Alabama,AL
01047,01CS018,415,400,431,560,145,129,160,100,0.7985825109953478,1.2145425945836812,1.6391932717684066,0.6864458634952237,506,487,525,678,172,153,191,101,1.6794927313260437,2.320777671892183,2.9420392874375842,0.5833329783198353,36730,36730,Dallas+Lowndes,Dallas,1,47,Alabama,AL
01085,01CS018,127,123,131,156,29,25,33,39,-1.4408975902125265,-1.0155662381866974,-0.560679125311886,1.2899433076734783,154,149,159,184,30,25,35,33,-1.031009964342003,-0.44661919232948094,0.1658918092962227,1.076314680538423,9691,9691,Dallas+Lowndes,Lowndes,1,85,Alabama,AL
01049,01CS019,701,670,731,868,167,137,198,123,0.20966669533387133,0.6155391331722493,1.0916980633621354,0.7304967853296961,858,821,895,1119,261,224,298,172,0.8704466752690547,1.4817370138448716,2.1105018820068886,0.6556842165426314,71569,71569,DeKalb,DeKalb,1,49,Alabama,AL
01051,01CS020,683,648,719,850,167,131,202,93,0.5095584630709018,0.9006624317809729,1.308221409089179,0.5547749251698941,840,797,882,1085,245,203,288,157,0.6871338032415318,1.2999979381269675,1.9269350774804823,0.6370148276209102,81818,81818,Elmore,Elmore,1,51,Alabama,AL
01057,01CS021,193,186,200,236,43,36,50,41,-0.28636798868645447,0.12286298291331053,0.5417555532311528,0.9294427590175119,234,226,243,314,80,71,88,51,1.490893728882298,2.1248913902845485,2.6837817171314247,0.6329630846865218,16263,16263,Fayette+Lamar+Marion,Fayette,1,57,Alabama,AL
01075,01CS021,167,161,172,220,53,48,59,45,0.1906189432646681,0.59424077364541406,1.056656273372839,0.8260450786035489,202,195,209,242,40,33,47,34,-0.1348672955804165,0.4955865153764473,1.0851878177996532,0.8356225521473594,13795,13795,Fayette+Lamar+Marion,Lamar,1,75,Alabama,AL
01093,01CS021,350,338,363,444,94,81,106,61,0.6680595575104912,1.1104445005734829,1.5234920690284044,0.6453505768794777,426,411,441,508,82,67,97,72,-0.18015501431527817,0.42999643359135226,1.0307164129105142,0.8666949995715146,29775,29775,Fayette+Lamar+Marion,Marion,1,93,Alabama,AL
01059,01CS022,315,302,329,385,70,56,83,49,0.21849290879860234,0.6606329106510929,1.045175188893799,0.693323917074595,385,369,402,490,105,88,121,57,1.2156161269146672,1.8151280450273857,2.432285905575411,0.5397546138739536,31554,31554,Franklin+Lawrence,Franklin,1,59,Alabama,AL
01079,01CS022,347,333,361,461,114,100,128,59,1.2475703803491989,1.6584235829684932,2.1103900983334243,0.513794218142119,424,407,441,582,158,141,175,96,1.6357192145575912,2.257385799279774,2.8555797972763117,0.603769688887602,32854,32854,Franklin+Lawrence,Lawrence,1,79,Alabama,AL
01063,01CS023,89,88,90,133,44,43,45,21,2.736628307458253,2.838285504444852,2.9376209654178544,0.4679295628045493,109,108,111,136,27,25,28,23,0.37227622309335745,0.5291230052735785,0.6842061574377412,0.834902372443958,8056,8056,Greene+Hale+Pickens+Sumter,Greene,1,63,Alabama,AL
01065,01CS023,168,162,174,216,48,42,54,37,0.26469294589176345,0.7475140721258546,1.175957087572273,0.7556277333239051,206,199,214,262,56,48,63,40,0.6553365176550239,1.2779061279705168,1.8968993429490841,0.7052449588141306,14669,14669,Greene+Hale+Pickens+Sumter,Hale,1,65,Alabama,AL
01107,01CS023,216,207,224,277,61,53,70,37,0.7939279317411714,1.2230597705047337,1.6710271311587657,0.5920597634001218,265,254,275,339,74,64,85,48,0.9210803200288193,1.5688068717637536,2.1625790644558176,0.637489657288092,19879,19879,Greene+Hale+Pickens+Sumter,Pickens,1,107,Alabama,AL
01119,01CS023,142,137,148,171,29,23,34,27,-0.2943693932080822,0.13027944270423092,0.5356321586637341,0.9128074751289565,175,168,181,163,-12,-18,-5,14,-3.1324884218443954,-2.4890747242695714,-1.829511973649004,-1.3190181075664196,12303,12303,Greene+Hale+Pickens+Sumter,Sumter,1,119,Alabama,AL
01069,01CS024,978,932,1023,1210,232,187,278,171,0.146032600437649,0.5828074389082993,0.9803278885564459,0.7323997213317412,1198,1143,1254,1602,404,348,459,244,1.164852302596598,1.818490621507551,2.3887170687567316,0.6032112273137419,106382,106382,Houston,Houston,1,69,Alabama,AL
01071,01CS025,603,581,625,747,144,122,166,69,1.0358452976861707,1.4533037061030212,1.8940340386470838,0.47616258209078016,735,709,762,985,250,223,276,159,1.4785374161281124,2.1189317928242852,2.763573719607902,0.6341343931276294,51634,51634,Jackson,Jackson,1,71,Alabama,AL
01073,01CS026,6101,5819,6383,7235,1134,852,1416,748,0.11166348391870798,0.5758581382097412,1.0002177889055761,0.6591966706220632,7469,7130,7807,8972,1503,1165,1842,1033,0.27591688798244635,0.8428666930334692,1.4830187684111216,0.6866407933015267,657207,657207,Jefferson,Jefferson,1,73,Alabama,AL
01077,01CS027,959,919,999,1121,162,122,202,130,-0.06416222694895113,0.3364729181239174,0.7489799232255518,0.7975752241006797,1172,1124,1220,1303,131,83,179,174,-1.2074206315369875,-0.5611209500553503,0.06112528607976009,1.320825487942919,93170,93170,Lauderdale,Lauderdale,1,77,Alabama,AL
01081,01CS028,971,899,1043,1123,152,80,224,130,-0.289916389724545,0.14544251095533248,0.5883577217975685,0.8503410327379827,1207,1121,1294,1442,235,148,321,189,-0.33081054990656367,0.33971566504399714,0.9640961336556818,0.8021632402707768,165772,165772,Lee,Lee,1,81,Alabama,AL
01083,01CS029,751,707,795,925,174,130,218,91,0.36697614623420827,0.8157605802820913,1.2978484583365055,0.5205555035564066,928,876,981,1147,219,166,271,122,0.5563497053288319,1.1529952747366488,1.826451826136004,0.555380539167299,100424,100424,Limestone,Limestone,1,83,Alabama,AL
01087,01CS030,206,198,214,289,83,75,91,38,2.090347363227206,2.5164646843622687,2.921514144613716,0.45213084643442936,253,244,263,244,-9,-19,-0,30,-3.249345235179033,-2.640183103366274,-2.032068446938201,-3.5490447164835075,17994,17994,Macon+Tallapoosa,Macon,1,87,Alabama,AL
01123,01CS030,471,454,488,534,63,46,80,79,-0.8151360406510021,-0.39045810614650456,0.03063187740756133,1.2331230316366084,579,559,600,726,147,126,167,99,0.7917966954661705,1.417375772291319,2.078262997277612,0.6710673503948285,40252,40252,Macon+Tallapoosa,Tallapoosa,1,123,Alabama,AL
01089,01CS031,2875,2712,3038,3158,283,120,446,217,-0.26121631970542325,0.1779613675734119,0.6060054051818301,0.7628015861939113,3541,3345,3737,4086,545,349,741,466,-0.35817856320136504,0.2441531097350948,0.8568638829649611,0.8540416963479989,375424,375424,Madison,Madison,1,89,Alabama,AL
01095,01CS032,982,940,1024,1227,245,203,287,147,0.6065783405652392,1.014683800637559,1.4361231053516448,0.5971919064367223,1199,1149,1250,1420,221,170,271,152,0.26358537335300336,0.8684119523108835,1.4227126159499004,0.6859302310701891,96851,96851,Marshall,Marshall,1,95,Alabama,AL
01097,01CS033,3732,3554,3909,4423,691,514,869,473,0.1077443178377142,0.514895644483554,0.9541245513888157,0.6831927896289769,4577,4364,4790,5813,1236,1023,1449,844,0.5331742007623923,1.1397633978149957,1.724219476976046,0.6823556154248309,413183,413183,Mobile,Mobile,1,97,Alabama,AL
01101,01CS034,1786,1689,1882,2377,591,495,688,337,0.6772416176568531,1.1121862781677265,1.5486802351015891,0.5688904902120513,2189,2073,2305,2776,587,471,703,384,0.4411295298982395,1.08663142549443,1.6827891718389554,0.6527234556405751,225476,225476,Montgomery,Montgomery,1,101,Alabama,AL
01103,01CS035,1173,1121,1224,1492,319,268,371,169,0.8410429602776823,1.2499260962183907,1.70552452387262,0.5274173659332618,1438,1376,1500,1690,252,190,314,214,-0.2446335994901942,0.41614994348796197,0.9619327518495028,0.845276464178669,119735,119735,Morgan,Morgan,1,103,Alabama,AL
01113,01CS036,539,514,564,637,98,73,123,70,0.0796460165384071,0.469242831730529,0.93505029791811,0.7041895436976895,658,628,688,850,192,162,222,124,0.7728232781989556,1.3943188543995098,2.0481045118192194,0.6430128109992567,58156,58156,Russell,Russell,1,113,Alabama,AL
01115,01CS037,828,789,867,1035,207,168,246,136,0.3813672087387235,0.775864895760736,1.189563714367343,0.6548203596092321,1015,968,1062,1311,296,249,343,219,0.430622479007475,1.039219269090544,1.619823447186717,0.7381933885206592,90153,90153,St. Clair,St. Clair,1,115,Alabama,AL
01117,01CS038,1333,1238,1428,1592,259,164,354,148,0.08466151399123746,0.4923685030414317,0.9411521983073735,0.5691623482304561,1656,1541,1770,1931,275,161,390,225,-0.3614218117318729,0.27185316929567166,0.8731980462432003,0.8143115711920185,219531,219531,Shelby,Shelby,1,117,Alabama,AL
01125,01CS039,1516,1425,1607,1887,371,280,462,252,0.16594466432087815,0.5651856312972524,1.0088894715660774,0.6775874624912356,1864,1755,1973,2339,475,366,584,362,0.05016578883623664,0.652309636873257,1.2965158716314775,0.7604480491824126,210503,210503,Tuscaloosa,Tuscaloosa,1,125,Alabama,AL
01127,01CS040,854,827,881,1111,257,230,284,165,1.016706834525003,1.4531554930859072,1.8797973663405683,0.6398604625993972,1038,1005,1070,1291,253,221,286,201,0.37045663602547224,1.0005133857644584,1.6049659578554725,0.7906893255878276,63456,63456,Walker+Winston,Walker,1,127,Alabama,AL
01133,01CS040,264,254,274,327,63,53,73,37,0.6878515712797236,1.0960740366646875,1.5093529033973119,0.5772440362465155,322,309,334,424,102,90,115,71,1.0312647851809813,1.5966766976233238,2.213791281878811,0.6860954495218387,23620,23620,Walker+Winston,Winston,1,133,Alabama,AL
02020,02CS001,1456,1332,1579,1748,292,169,416,117,0.1538254032637781,0.6166964140303866,1.01640158495196,0.3991785608593054,1815,1666,1963,2351,536,388,685,278,0.5087222089624496,1.0746927134245856,1.7072513809348449,0.5172924199720185,288084,288084,Anchorage,Anchorage,2,20,Alaska,AK
02090,02CS002,397,356,438,473,76,35,117,19,0.20997889081637114,0.5958611228864038,1.013066015314046,0.24611672589057076,496,446,545,680,184,135,234,90,0.5586398399597918,1.1374410064939473,1.8436748180587617,0.48595726520393145,96489,96489,Fairbanks North Star,Fairbanks North Star,2,90,Alaska,AK
02122,02CS003,394,368,419,393,-1,-26,25,18,-0.7528935921344896,-0.3436954665230309,0.12904673055295937,388.295122704118,486,455,517,586,100,69,131,66,0.02789499658815878,0.6911727946467968,1.283978739987306,0.653662842450791,59122,59122,Kenai Peninsula,Kenai Peninsula,2,122,Alaska,AK
02170,02CS004,545,497,592,639,94,47,142,33,0.12852075509717656,0.557517360993069,0.9845550798869868,0.3460204459214392,679,622,736,989,310,253,367,165,1.0244318684532183,1.596124577326222,2.2275237043489313,0.5299867577866803,109259,109259,Matanuska-Susitna,Matanuska-Susitna,2,170,Alaska,AK
02140,02CS005,47,46,48,52,5,4,6,4,0.0050842372796152495,0.10608507566821195,0.20345987404411942,0.6902944841484091,58,57,59,69,11,10,12,7,0.45606402706462557,0.613668046919548,0.7664439528899902,0.5869341116888259,7661,7661,Northern Alaska,Northern Alaska,2,140,Alaska,AK
02180,02CS005,63,62,64,66,3,2,4,8,-0.6219493944119463,-0.5115619901555801,-0.409295539148209,2.0593688851821006,78,76,79,91,13,12,15,2,1.212482480910978,1.3686172096644722,1.528984262909776,0.139125470928739,9985,9985,Northern Alaska,Nome,2,180,Alaska,AK
02185,02CS005,48,47,49,45,-3,-4,-2,8,-1.2430197874684645,-1.1385576306269267,-1.034423600879163,-4.768242685982494,59,58,60,59,0,-1,1,6,-0.8898926067453071,-0.7439049360572406,-0.5742788580697391,4.979817040678788,9375,9375,Northern Alaska,North Slope,2,185,Alaska,AK
02240,02CS005,91,89,92,108,17,16,19,6,0.6858998803638312,0.7862332503642475,0.8909840006539224,0.32992528028877094,112,110,114,145,33,31,35,10,1.8171586996991533,1.9728792619891737,2.118285803493284,0.2913432070119592,14198,14198,Northern Alaska,Southeast Fairbanks,2,240,Alaska,AK
02261,02CS005,52,51,53,3,-49,-50,-48,3,-5.625483203762081,-5.526287245154801,-5.4216328397002576,-0.06276707134941152,64,63,65,4,-60,-61,-59,4,-8.320379325615201,-8.160251888050297,-8.00845289619167,-0.06802269561276636,9375,9375,Northern Alaska,Valdez-Cordova,2,261,Alaska,AK
02100,02CS006,12,12,12,19,7,7,7,7,-0.02422802490303578,0.06959602101007284,0.17552079462809178,0.8549996541776754,15,14,15,21,6,6,7,5,0.5362439323836409,0.6903839626608276,0.8411788445407784,0.667757839532362,2583,2583,Southeast Alaska,Haines,2,100,Alaska,AK
02110,02CS006,165,151,178,171,6,-7,20,4,-0.3485838687895196,0.07510454894365756,0.48099520707785687,0.5518930575066334,204,187,220,218,14,-2,31,13,-0.5393864182187759,0.055695873658036035,0.6531682989328956,0.8423547921517044,31959,31959,Southeast Alaska,Juneau,2,110,Alaska,AK
02195,02CS006,196,185,207,231,35,24,46,8,0.6025073683030338,1.0346827166687442,1.4581536799444064,0.22337606054582498,240,227,253,348,108,95,121,16,3.6333421107298864,4.268164269399346,4.890362094126132,0.14687315212778307,25830,25830,Southeast Alaska,Petersburg,2,195,Alaska,AK
02220,02CS006,51,50,52,56,5,4,6,3,0.15811715951488148,0.26372632438249566,0.36501005417873544,0.4797083953583953,62,61,63,76,14,13,15,1,1.6638100501130004,1.8201500357901834,1.9857216185271915,0.06754675937233605,8461,8461,Southeast Alaska,Sitka,2,220,Alaska,AK
02232,02CS006,30,28,32,20,-10,-12,-8,2,-3.519373394176436,-3.1123065697272434,-2.636628859709983,-0.21845424228701338,37,35,39,44,7,5,9,6,-0.2992842249002971,0.3374186447595032,0.9329235707375589,0.7464678966003304,3931,3931,Southeast Alaska,Southeast Alaska,2,232,Alaska,AK
02010,02CS007,18,17,19,18,0,-1,1,7,-0.8628914826395095,-0.7583387307528544,-0.6587307788221921,6.303748027158484,22,21,24,27,5,3,6,7,-0.4703284450039743,-0.3151256323207853,-0.15989994188299209,1.2386992759944724,9067,9067,Southwest Alaska,Southwest Alaska,2,10,Alaska,AK
02050,02CS007,105,103,107,115,10,8,12,15,-0.3719602967217323,-0.270032120421446,-0.17063932947981908,1.3630669578261465,129,126,131,144,15,13,18,22,-0.6073859674745767,-0.45161847960443346,-0.2996143340063576,1.367222701723844,18470,18470,Southwest Alaska,Bethel,2,50,Alaska,AK
02060,02CS007,7,7,7,5,-2,-2,-2,5,-8.755365791213185,-8.657567029899408,-8.5516221415035,-4.629453551303886,9,9,9,15,6,6,6,4,3.2700085659334226,3.419387022172858,3.5765319148975006,0.54531668949049406,818,818,Southwest Alaska,Bristol Bay,2,60,Alaska,AK
02070,02CS007,41,41,42,53,12,11,12,3,1.2479384570652479,1.3514759821544273,1.461827319356456,0.23637470745781514,51,50,52,62,11,10,12,11,-0.10393473691546384,0.0632240322632635,0.2144307952328399,0.8915992412416717,6436,6436,Southwest Alaska,Dillingham,2,70,Alaska,AK
02150,02CS007,53,52,54,66,13,12,14,1,0.811330400258,0.9207917319465059,1.022956528263058,0.07109650429674053,65,64,67,104,39,37,40,6,2.843241455934319,2.993410963594656,3.1675960869566686,0.1508993578293754,13119,13119,Southwest Alaska,Kodiak Island,2,150,Alaska,AK
02158,02CS007,52,51,53,52,-0,-1,1,4,-0.6294919221993268,-0.5233437409968714,-0.4101233047035241,5.966901144676159,64,63,65,82,18,17,19,10,0.9595961775165319,1.1207502173466932,1.2812546717063047,0.5317236682475136,8361,8361,Southwest Alaska,Southwest Alaska,2,158,Alaska,AK
04001,04CS001,606,599,614,1042,436,428,443,300,1.7809381854344408,1.886387347384499,1.9935532142281118,0.6871591989996083,745,735,754,1190,445,436,455,270,2.7676666898736144,2.9207642054356815,3.0817706434188534,0.6051929377248032,71901,71901,Apache,Apache,4,1,Arizona,AZ
04003,04CS002,1166,1111,1221,1387,221,166,276,171,-0.04525681860289976,0.37366689620929855,0.821131491009405,0.770616480409728,1433,1367,1499,1832,399,333,465,311,0.21300282607815918,0.8314190194337033,1.4325666143426274,0.7778121233880021,127332,127332,Cochise+Graham+Greenee,Cochise,4,3,Arizona,AZ
04009,04CS002,260,243,276,322,62,46,79,50,-0.09193928616914694,0.32238271016472486,0.7429674425346056,0.7875705974092999,322,302,342,489,167,147,187,88,1.8272965996516204,2.415472872706719,3.0495830508898933,0.5237765736859042,39024,39024,Cochise+Graham+Greenee,Graham,4,9,Arizona,AZ
04011,04CS002,55,54,56,62,7,6,8,5,0.09159885993035936,0.19228123999913094,0.3019626041669071,0.6400858020851239,68,67,69,96,28,27,29,25,0.205001900208843,0.36631008511166907,0.5243604840258939,0.8660743903980813,9414,9414,Cochise+Graham+Greenee,Greenlee,4,11,Arizona,AZ
04005,04CS003,735,674,797,1027,292,230,353,207,0.16474448610392867,0.586134731737567,1.033300895831204,0.7069282937336637,913,839,986,1194,281,208,355,184,0.1910662260517334,0.8164729790230457,1.4429594679870894,0.6518222993808326,143348,143348,Coconino,Coconino,4,5,Arizona,AZ
04007,04CS004,669,646,693,834,165,141,188,118,0.4149741089307857,0.87275114574235,1.2486513060666797,0.7128342154418109,815,786,843,1054,239,211,268,157,1.210733144666653,1.824844691698841,2.451948213516319,0.6528282159717692,54171,54171,Gila,Gila,4,7,Arizona,AZ
04025,04CS005,2689,2586,2792,3143,454,351,557,252,0.413776550459785,0.8370202675566983,1.2986267452623723,0.5540979489444088,3285,3161,3409,4117,832,708,956,595,0.5728889523235617,1.2003426591550712,1.8534610670060376,0.7143151264680748,237797,237797,La Paz+Yavapai,Yavapai,4,25,Arizona,AZ
04013,04CS006,28101,26134,30068,34979,6878,4911,8845,4403,0.1200230337086393,0.5412978395655011,0.9786728920999509,0.6400616307739876,34810,32444,37175,44145,9335,6970,11701,6755,0.051805662666092656,0.7121068858097134,1.2965613001873906,0.7235086695802986,4528436,4528436,Maricopa,Maricopa,4,13,Arizona,AZ
04015,04CS007,2890,2797,2983,3445,555,462,648,326,0.6694128257219315,1.0583195466797128,1.4783271028800875,0.5864510910511702,3528,3416,3640,4616,1088,976,1200,767,1.1605093649504177,1.7882630159641024,2.4277028878155438,0.7044791768622816,215246,215246,Mohave,Mohave,4,15,Arizona,AZ
04017,04CS008,933,921,945,1519,586,574,598,365,1.8779816028366922,1.9882859001010997,2.0962445931314946,0.6214374265165503,1148,1133,1163,1843,695,680,710,366,3.3926404364939837,3.5396005055337247,3.69844500643687,0.5258169405318444,111485,111485,Navajo,Navajo,4,17,Arizona,AZ
04019,04CS009,8417,7960,8873,10505,2088,1632,2545,1182,0.4561994537572662,0.8557792637622097,1.3367661973432892,0.5657041214227354,10352,9803,10900,12818,2466,1918,3015,1745,0.21766987621548137,0.8280951891828735,1.4629142690423942,0.707216971215412,1054225,1054225,Pima+Santa Cruz,Pima,4,19,Arizona,AZ
04023,04CS009,259,239,279,413,154,134,174,103,0.6549641235847046,1.0845234184178707,1.4815696168569579,0.6659761838709924,322,298,346,427,105,81,129,79,0.10492542341786505,0.6529167012255505,1.299417928055625,0.7447703048129525,46761,46761,Pima+Santa Cruz,Santa Cruz,4,23,Arizona,AZ
04021,04CS010,2933,2727,3139,3650,717,511,923,389,0.2708299392736056,0.6909835092469827,1.1076139535270924,0.5419649236771884,3633,3384,3881,4936,1303,1055,1552,880,0.48612353547858833,1.0704497897049665,1.733265370676511,0.6747142981045066,469635,469635,Pinal,Pinal,4,21,Arizona,AZ
04027,04CS011,1639,1536,1742,2445,806,703,909,576,0.5510011175012427,0.9709174836009169,1.4178550333104796,0.7137688810035573,2028,1904,2152,2633,605,481,729,468,0.07480374436882449,0.6675927837975968,1.2960004879975415,0.7722737009668753,237049,237049,Yuma,Yuma,4,27,Arizona,AZ
05001,05CS001,208,201,216,259,51,43,58,22,1.2036279626668358,1.6400120963939055,2.0784530444421154,0.42543943642703763,256,247,265,336,80,71,89,30,2.8472058702142395,3.4251565046141037,4.063749196224108,0.37066760220980083,17460,17460,Arkansas (county)+Monroe+Phillips+Prairie,Arkansas (county),5,1,Arkansas,AR
05095,05CS001,97,96,98,116,19,18,20,11,1.087488198405234,1.2020182598336033,1.3051588824341391,0.5498709302283314,119,118,120,136,17,16,18,20,-0.6869722505879828,-0.5328657663612306,-0.37863869630320485,1.109265842827353,6665,6665,Arkansas (county)+Monroe+Phillips+Prairie,Monroe,5,95,Arkansas,AR
05107,05CS001,207,200,215,266,59,51,66,38,0.7695659796094922,1.1821508385464705,1.6116272682948491,0.6343528088690068,254,245,263,311,57,48,66,52,-0.30742893160982265,0.32566579478944596,0.8818346093108783,0.8995409178003075,17573,17573,Arkansas (county)+Monroe+Phillips+Prairie,Phillips,5,107,Arkansas,AR
05117,05CS001,91,91,92,127,36,35,36,14,2.5732567786746365,2.676439289942599,2.782150398021739,0.3835186757018811,112,111,114,145,33,31,34,20,1.709574457359206,1.8707557536267703,2.0183755978247766,0.5967614503703952,8040,8040,Arkansas (county)+Monroe+Phillips+Prairie,Prairie,5,117,Arkansas,AR
05005,05CS002,588,569,606,708,120,102,139,75,0.6614865979469898,1.080933656800288,1.5033920495837434,0.6176395937611635,713,691,735,928,215,193,237,125,1.9633778353524756,2.548538789232228,3.1859965173443143,0.5792499078410133,42088,42088,Baxter+Marion,Baxter,5,5,Arkansas,AR
05089,05CS002,223,216,230,268,45,38,52,23,0.885503692335832,1.3167665383841538,1.7431537553602703,0.49770450093247726,271,262,279,305,34,26,43,43,-1.2306167910504602,-0.6245061571437339,0.010151369452172501,1.2153827053082933,16705,16705,Baxter+Marion,Marion,5,89,Arkansas,AR
05007,05CS003,1713,1589,1837,1959,246,122,370,282,-0.5658100871257541,-0.10746183773691494,0.2894807640688706,1.1424913993598984,2121,1972,2270,2519,398,249,547,372,-0.5646007204070881,0.09430293485864641,0.7193007128902392,0.9330264728519723,283560,283560,Benton,Benton,5,7,Arkansas,AR
05009,05CS004,387,370,403,478,91,75,108,63,0.3280634093792653,0.7423308523944642,1.1719859423779864,0.6822975479420429,472,452,491,582,110,91,130,68,0.7090789428976136,1.3308550116634685,1.944224178214542,0.6100341826854015,37620,37620,Boone+Carroll+Madison,Boone,5,9,Arkansas,AR
05015,05CS004,280,268,292,314,34,22,46,38,-0.5658249247301637,-0.13177165686751827,0.24706298791743522,1.0872213057650828,342,327,356,394,52,38,67,40,-0.04979199222737889,0.5317314608205023,1.146666116545648,0.7495587958258658,28320,28320,Boone+Carroll+Madison,Carroll,5,15,Arkansas,AR
05087,05CS004,169,162,177,154,-15,-23,-8,10,-1.9653759002395272,-1.5303609796987936,-1.0970882617988276,-0.6953239781652302,207,198,215,259,52,44,61,32,0.876895938487685,1.4845093865348507,2.0964444819069934,0.6005603832708318,16571,16571,Boone+Carroll+Madison,Madison,5,87,Arkansas,AR
05011,05CS005,134,130,139,167,33,28,37,27,0.09014758169005377,0.5327672706736981,0.9626087639303691,0.7995463203105594,164,158,169,165,1,-4,7,18,-2.4138564679039547,-1.8569164576248554,-1.2862477609975298,7.386546789912083,10728,10728,Bradley+Calhoun+Cleveland+Union,Bradley,5,11,Arkansas,AR
05013,05CS005,63,63,64,69,6,5,6,4,0.19850050302292704,0.3031688658698361,0.4184580674129502,0.6096471402508337,78,77,79,89,11,10,12,5,1.2812986144123655,1.4379840819316467,1.5999711865943271,0.4117459682541887,5127,5127,Bradley+Calhoun+Cleveland+Union,Calhoun,5,13,Arkansas,AR
05025,05CS005,90,90,91,110,20,19,20,20,-0.16202791404288897,-0.058797521403233945,0.04608518385468546,0.9745259404727252,111,110,112,135,24,23,25,11,1.797120084022835,1.947051533589268,2.10906708525272,0.4422244236049474,7945,7945,Bradley+Calhoun+Cleveland+Union,Cleveland,5,25,Arkansas,AR
05139,05CS005,433,416,449,539,106,90,123,70,0.5305580602114617,0.9361282923364763,1.357812938578728,0.6526031662237355,528,509,548,617,89,69,108,70,-0.06693475725603083,0.558118936418975,1.222902867842319,0.7811837064270264,38486,38486,Bradley+Calhoun+Cleveland+Union,Union,5,139,Arkansas,AR
05019,05CS006,208,199,218,243,35,25,44,18,0.3300184284383576,0.7720253749442875,1.1643757843952038,0.5027731318693145,255,244,267,291,36,24,47,35,-0.5756756800183372,0.028375396685346443,0.6671547095899714,0.9524964392601812,22256,22256,Clark+Dallas+Ouachita,Clark,5,19,Arkansas,AR
05039,05CS006,88,87,88,105,17,17,18,14,0.39514439968185455,0.4992247928897052,0.6070192585564769,0.7593573598426672,107,106,108,119,12,11,13,5,1.0211810706941489,1.1769176580979785,1.337331047461715,0.39159466968596035,6889,6889,Clark+Dallas+Ouachita,Dallas,5,39,Arkansas,AR
05103,05CS006,287,277,297,341,54,44,64,38,0.283200362285318,0.6889027403055952,1.0932526505316429,0.6895381098208455,350,338,362,392,42,30,54,46,-0.8707856785769256,-0.2161133415113469,0.4146746744660449,1.0685749644546951,23287,23287,Clark+Dallas+Ouachita,Ouachita,5,103,Arkansas,AR
05021,05CS007,197,191,203,216,19,13,25,27,-0.9460942908794603,-0.5344676618697073,-0.08646329451883107,1.344473118157274,239,232,246,280,41,34,48,41,-0.6095763784409666,-0.016764767752533234,0.6692540133717689,0.9772689760084453,14444,14444,Clay+Greene,Clay,5,21,Arkansas,AR
05055,05CS007,430,410,449,495,65,46,85,56,-0.235196144596412,0.2020250793852113,0.6105536275086653,0.8447755067093532,525,502,549,612,87,63,110,73,-0.21279807418648963,0.35378935492871305,1.0265923669268506,0.8310196908720127,45433,45433,Clay+Greene,Greene,5,55,Arkansas,AR
05027,05CS008,241,231,251,319,78,68,88,30,1.6113098230436183,2.061524333709472,2.4734018737030636,0.3791047139976029,293,281,305,304,11,-1,23,24,-1.3120893095941064,-0.6897556002785151,-0.055639815061793614,1.9986631341372532,23427,23427,Columbia+Lafayette+Miller,Columbia,5,27,Arkansas,AR
05073,05CS008,80,79,81,105,25,24,26,5,2.916280692152864,3.015265975873689,3.1343791922936353,0.1923152534837715,98,97,99,105,7,6,8,13,-1.2651352710082713,-1.1163690317178403,-0.9489133029847409,1.6553254746894195,6631,6631,Columbia+Lafayette+Miller,Lafayette,5,73,Arkansas,AR
05091,05CS008,420,401,438,503,83,65,102,61,0.0679277479325307,0.5130547608927999,0.9540936016231463,0.7221621004797474,511,489,533,654,143,121,165,102,0.5480030890299761,1.1463313395499335,1.7558606857258692,0.7077562235171616,43290,43290,Columbia+Lafayette+Miller,Miller,5,91,Arkansas,AR
05029,05CS009,237,228,246,229,-8,-17,1,11,-1.282252599972356,-0.9233905424701608,-0.4775990969449562,-1.552107286938262,290,279,300,301,11,1,22,27,-1.545812552464858,-0.8776520237113599,-0.28354004928772597,2.1657775181812835,20960,20960,Conway+Pope,Conway,5,29,Arkansas,AR
05115,05CS009,522,494,549,642,120,93,148,56,0.5700320520814989,0.9891932880109287,1.4236106575706133,0.46191117610812576,641,608,674,752,111,78,144,93,-0.27214124178969207,0.3091933099138089,0.9570036517218276,0.8317635513156088,64224,64224,Conway+Pope,Pope,5,115,Arkansas,AR
05031,05CS010,838,789,886,1005,167,119,216,99,0.18996252291815677,0.6300400972919912,1.03100043008727,0.5879403422113483,1031,973,1089,1189,158,100,216,104,-0.020511419304395533,0.5914577887306425,1.2085054950730096,0.6553275978276613,111386,111386,Craighead,Craighead,5,31,Arkansas,AR
05033,05CS011,546,519,573,663,117,90,144,56,0.5322726436566094,0.9699974985794906,1.3697217712546095,0.4754510876989093,668,635,701,874,206,173,239,123,0.9422672957282412,1.5710741587152812,2.1537929546734347,0.5948281818835806,63407,63407,Crawford,Crawford,5,33,Arkansas,AR
05035,05CS012,432,412,453,555,123,102,143,68,0.7301937527520419,1.1526213172249435,1.5640301618484913,0.5487612329835226,531,506,556,685,154,129,179,87,1.0374405791328125,1.6962874846023657,2.2917616542849015,0.5612538821313783,47796,47796,Crittenden,Crittenden,5,35,Arkansas,AR
05037,05CS013,194,187,201,223,29,22,36,29,-0.41017645110645773,0.012608467525174328,0.41310940897161075,0.9646455298974356,237,229,246,266,29,20,37,29,-0.6397309844711482,0.01153293916815006,0.5889106461830944,0.9720146516921938,16253,16253,Cross+Lee+St. Francis,Cross,5,37,Arkansas,AR
05077,05CS013,95,94,96,144,49,48,50,17,3.5705328826552307,3.672591067346076,3.7715189850478947,0.33962616443352384,117,116,118,155,38,37,39,27,1.402865606527923,1.5572201359297153,1.7218307627332283,0.6860483185905727,8732,8732,Cross+Lee+St. Francis,Lee,5,77,Arkansas,AR
05123,05CS013,225,214,235,271,46,36,57,32,0.10961816939828603,0.5719767464865799,1.0107930174483468,0.6743792062950662,276,264,289,336,60,47,72,46,0.12089265460741443,0.6557749445417657,1.2980460749761886,0.7582106241401313,24854,24854,Cross+Lee+St. Francis,St. Francis,5,123,Arkansas,AR
05045,05CS014,871,816,925,954,83,29,138,70,-0.351137426372064,0.10464381503355828,0.539453010115613,0.8323223759720138,1076,1011,1142,1189,113,47,178,117,-0.6222696760404707,-0.05567037863061529,0.6005855535361688,1.0303023603407522,126283,126283,Faulkner,Faulkner,5,45,Arkansas,AR
05047,05CS015,197,189,205,242,45,37,53,22,0.884590664301784,1.281290117799304,1.7168106685778608,0.4780502089574069,240,231,250,275,35,25,44,31,-0.3758571568469211,0.23909196677643205,0.8760253625837744,0.872256132892867,17804,17804,Franklin+Johnson+Logan,Franklin,5,47,Arkansas,AR
05071,05CS015,235,224,246,272,37,26,48,20,0.22521406575331643,0.6179897065952554,1.0684797133558692,0.5273636482190646,288,274,301,354,66,53,80,46,0.30729625577506664,0.9037943018597498,1.5349072840138198,0.6845154643624269,26561,26561,Franklin+Johnson+Logan,Johnson,5,71,Arkansas,AR
05083,05CS015,243,233,252,285,42,33,52,12,1.010433080856709,1.4249829705420507,1.8595605241752142,0.2765555342179488,296,285,307,375,79,68,90,37,1.739286995839883,2.3702182660426336,2.99397199676455,0.46079184601431344,21460,21460,Franklin+Johnson+Logan,Logan,5,83,Arkansas,AR
05051,05CS016,1213,1170,1256,1365,152,109,195,137,-0.2889763542469345,0.149820398287948,0.5965237066642878,0.8953276846840844,1479,1428,1531,1705,226,174,277,229,-0.6441425188430357,-0.050241175905425636,0.5300961285056904,1.010450083207162,99604,99604,Garland,Garland,5,51,Arkansas,AR
05053,05CS017,181,173,188,201,20,13,28,14,-0.07931924966876742,0.35237985626807267,0.7792248141595869,0.6530728281564697,221,212,231,306,85,75,94,39,2.372396006143308,2.9862439466834605,3.5853933425984934,0.45475995393167856,18354,18354,Grant+Hot Spring,Grant,5,53,Arkansas,AR
05059,05CS017,368,353,382,441,73,59,88,51,0.25406933439555335,0.6571737697545544,1.0954548541928528,0.6853322136478539,449,432,467,526,77,59,94,53,0.22235337185927728,0.8578397795348052,1.4732047803861372,0.6809399860218498,33785,33785,Grant+Hot Spring,Hot Spring,5,59,Arkansas,AR
05057,05CS018,203,194,212,226,23,14,32,20,-0.2670910704802967,0.15199305168997718,0.5927085604028197,0.8270970506125027,249,238,260,280,31,20,42,29,-0.4570631892088469,0.1328759764617934,0.7200822953170757,0.8969247055566383,21437,21437,Hempstead+Howard+Nevada+Pike,Hempstead,5,57,Arkansas,AR
05061,05CS018,158,152,163,171,13,8,19,18,-0.7788894580149665,-0.38738482569041416,0.057670352683949704,1.2718162831352025,193,186,200,164,-29,-36,-22,14,-4.542792420731185,-3.8770158949027715,-3.250911023817559,-0.5048563423427376,13173,13173,Hempstead+Howard+Nevada+Pike,Howard,5,61,Arkansas,AR
05099,05CS018,98,97,98,118,20,20,21,22,-0.303210517915331,-0.2000749611676206,-0.09388423841818024,1.028988062377723,120,119,121,115,-5,-6,-4,18,-3.5001140325835047,-3.3431314229141114,-3.186645242978445,-4.818830364399401,8161,8161,Hempstead+Howard+Nevada+Pike,Nevada,5,99,Arkansas,AR
05109,05CS018,116,115,117,129,13,12,14,18,-0.5911118208845947,-0.48422886384269614,-0.3817476158676348,1.3013992863305845,143,141,144,177,34,33,36,27,0.675353670906412,0.8372059221042789,0.9788211763564199,0.7628176019925829,10679,10679,Hempstead+Howard+Nevada+Pike,Pike,5,109,Arkansas,AR
05063,05CS019,350,334,367,452,102,85,118,72,0.3723836759570011,0.7731387600961892,1.1975398794162664,0.7011476014229717,427,407,446,545,118,99,138,76,0.7297345358690709,1.328579942920253,1.912942337556572,0.636281857735826,37793,37793,Independence+Jackson+Woodruff,Independence,5,63,Arkansas,AR
05067,05CS019,187,180,194,239,52,45,59,22,1.3646883059637966,1.8038010071708637,2.239792228452743,0.4135686498984084,227,218,235,254,27,19,36,22,-0.2181785354237345,0.37576853226678797,0.978314996470007,0.778713620006773,16721,16721,Independence+Jackson+Woodruff,Jackson,5,67,Arkansas,AR
05147,05CS019,85,84,85,95,10,10,11,6,0.5816097938051005,0.6884848713105447,0.7903452456028655,0.5273187875000965,104,103,104,105,1,1,2,16,-2.914102985923519,-2.7543301945821246,-2.5948222875401403,6.684010472253924,6361,6361,Independence+Jackson+Woodruff,Woodruff,5,147,Arkansas,AR
05069,05CS020,672,644,700,901,229,201,257,132,1.029635683146453,1.452888009854241,1.8421383079958533,0.5744335169615143,819,785,853,998,179,145,213,102,0.8515936468958412,1.3920394563915608,1.948618540786777,0.5658931591171685,66404,66404,Jefferson,Jefferson,5,69,Arkansas,AR
05081,05CS021,150,144,155,192,42,37,48,28,0.7462627054569521,1.1535705609581879,1.5989560399207257,0.6472677585021217,183,176,189,200,17,11,24,35,-2.3653564746466977,-1.7280677758736265,-1.12060910172361,1.900893942222762,12290,12290,Little River+Polk+Sevier,Little River,5,81,Arkansas,AR
05113,05CS021,232,224,241,258,26,17,34,51,-1.692606048909478,-1.2861571126966007,-0.8410050283788941,1.9220756215118298,284,274,294,374,90,80,100,72,0.45712130122187183,1.1081397823901997,1.749651699332896,0.7889914288570051,19845,19845,Little River+Polk+Sevier,Polk,5,113,Arkansas,AR
05133,05CS021,142,135,150,175,33,25,40,29,-0.21461539495320547,0.22255244089253032,0.6479996428086205,0.862485646700699,175,166,184,229,54,45,63,35,0.7655737560864044,1.3520771040213455,1.9556062575277038,0.6353469796460689,16860,16860,Little River+Polk+Sevier,Sevier,5,133,Arkansas,AR
05085,05CS022,596,564,628,674,78,46,110,75,-0.39750686407705893,0.040212026563926945,0.4661562049739794,0.9500226742374137,731,693,769,836,105,67,143,85,-0.2653147528667617,0.3228405815254419,0.9494489913502681,0.8004024643588955,73762,73762,Lonoke,Lonoke,5,85,Arkansas,AR
05093,05CS023,423,406,441,571,148,130,165,82,1.2048869196571859,1.626471916532546,2.0801696892304937,0.5514879442203766,518,497,538,594,76,56,97,61,-0.15565092337814695,0.45225103471151684,1.0546430395431468,0.789508812926999,40446,40446,Mississippi+Poinsett,Mississippi,5,93,Arkansas,AR
05111,05CS023,288,278,298,352,64,54,74,49,0.21217889370365745,0.6425979320587895,1.0705879995044667,0.7508574550563865,351,339,363,423,72,60,84,40,1.032065017633624,1.6314408888373606,2.2306557939964677,0.5486624241295082,23411,23411,Mississippi+Poinsett,Poinsett,5,111,Arkansas,AR
05097,05CS024,132,128,136,135,3,-1,7,21,-2.349058234402466,-1.9678026366571044,-1.4833680184257625,4.884844917897767,160,155,164,173,13,9,18,34,-3.40088051206016,-2.789137667421527,-2.1534074717214247,2.3934966984014676,9030,9030,Montgomery+Perry+Scott+Yell,Montgomery,5,97,Arkansas,AR
05105,05CS024,109,108,110,111,2,1,3,3,-0.18587286991859492,-0.07347737928156124,0.0329444466577917,0.9283011946983427,133,132,135,152,19,17,20,20,-0.3140979126715912,-0.16085556542034776,1.1604553036687268e-4,1.0191452887474624,10380,10380,Montgomery+Perry+Scott+Yell,Perry,5,105,Arkansas,AR
05127,05CS024,112,111,113,141,29,28,30,14,1.3633975025467562,1.4695747319331678,1.5829288518936373,0.4667904713274045,137,136,139,181,44,42,45,19,2.7488476489725295,2.9036988032890942,3.074986390747014,0.425027533519052,10195,10195,Montgomery+Perry+Scott+Yell,Scott,5,127,Arkansas,AR
05149,05CS024,221,212,231,252,31,21,40,37,-0.707065425933903,-0.3059334762256028,0.14145395690211743,1.171944775346283,270,259,281,297,27,16,38,40,-1.3553645933770158,-0.71877644090756,-0.08025401538709048,1.4171146155062595,21295,21295,Montgomery+Perry+Scott+Yell,Yell,5,149,Arkansas,AR
05119,05CS025,3198,3029,3367,3803,605,436,774,342,0.23099299362102332,0.6687040177141684,1.102753653698671,0.5641366174841369,3931,3728,4134,4722,791,588,994,479,0.36791441370122385,0.9586647750986335,1.5841892387764478,0.6044629029330544,392594,392594,Pulaski,Pulaski,5,119,Arkansas,AR
05125,05CS026,1024,971,1077,1101,77,24,130,98,-0.5888964748530545,-0.17186897364289588,0.2920923992999044,1.2578525303270771,1259,1194,1323,1580,321,257,386,165,0.8671512719241298,1.537109551477685,2.1296390987625387,0.5116401195589273,123141,123141,Saline,Saline,5,125,Arkansas,AR
05131,05CS027,1109,1054,1164,1345,236,181,291,111,0.5360764547296542,0.9708130406941029,1.4113952925438153,0.46762220856480186,1360,1294,1426,1711,351,285,417,217,0.6251817082843218,1.2576817803755256,1.9073118546075747,0.6160259695410609,127647,127647,Sebastian,Sebastian,5,131,Arkansas,AR
05049,05CS028,168,162,173,183,15,10,21,35,-2.0283804297703694,-1.5775189460750147,-1.158469426227735,2.1578528671106523,204,198,210,256,52,46,58,43,0.20646191916696316,0.8771316963235407,1.4959749238715832,0.8110549604655962,12460,12460,Sharp and Nearby Counties,Fulton,5,49,Arkansas,AR
05065,05CS028,175,169,180,191,16,11,22,10,0.06392546287905575,0.4754175430448738,0.8864714397241205,0.5751397784077791,213,206,220,262,49,42,56,35,0.6497415236296125,1.2599671985928447,1.8871074591416326,0.6950029663928022,13617,13617,Sharp and Nearby Counties,Izard,5,65,Arkansas,AR
05075,05CS028,203,196,210,230,27,20,34,32,-0.7427529996061838,-0.3098108207885785,0.13353236153291073,1.143233102047705,247,239,256,250,3,-6,11,18,-1.7771835764226103,-1.0856955330268554,-0.516203304889354,4.900939704681688,16428,16428,Sharp and Nearby Counties,Lawrence,5,75,Arkansas,AR
05121,05CS028,218,210,226,258,40,32,48,44,-0.6486482152428233,-0.19999739098010408,0.20441843433832182,1.0664190373742515,266,256,275,283,17,8,27,24,-1.0099105815673481,-0.4192763423515017,0.15015348491658445,1.3020383966956262,18197,18197,Sharp and Nearby Counties,Randolph,5,121,Arkansas,AR
05135,05CS028,247,240,255,240,-7,-15,0,26,-2.349619355504385,-1.9158871351439357,-1.495442066705096,-4.225437142906672,301,292,310,347,46,37,55,42,-0.35074281156644266,0.2961726068502496,0.8954959117970478,0.8895154548224212,17338,17338,Sharp and Nearby Counties,Sharp,5,135,Arkansas,AR
05003,05CS029,215,207,224,248,33,24,41,21,0.17131065107433832,0.5947591676573833,1.0296860500214626,0.6257091062371998,264,254,274,321,57,47,67,37,0.6440682363569744,1.2459439192302004,1.845929044559855,0.6348069487035188,19574,19574,Southeast Arkansas,Ashley,5,3,Arkansas,AR
05017,05CS029,131,127,135,149,18,14,22,25,-1.1117588238202698,-0.7169754757361362,-0.2582685816904588,1.3275565000852279,160,155,165,171,11,6,16,13,-0.8168509995489123,-0.24074923604830858,0.3607165770669345,1.078299534910364,10079,10079,Southeast Arkansas,Chicot,5,17,Arkansas,AR
05041,05CS029,140,136,145,151,11,6,15,13,-0.6378808256913473,-0.21663836790064134,0.17670344914186747,1.1296106909963581,171,166,177,191,20,14,25,24,-1.052542464319779,-0.48270108436989173,0.11849690453361486,1.1685128582030304,11279,11279,Southeast Arkansas,Desha,5,41,Arkansas,AR
05043,05CS029,178,170,185,238,60,53,68,23,1.6511653956739276,2.088597581383279,2.5032783244650516,0.3748432889957761,218,209,228,223,5,-5,14,24,-1.8453251842375915,-1.3002181512088393,-0.684807266832415,4.211736391743046,18044,18044,Southeast Arkansas,Drew,5,43,Arkansas,AR
05079,05CS029,129,124,135,151,22,16,27,27,-0.841954279330565,-0.42068361327168124,-0.008555367198280822,1.196503412765775,159,152,166,176,17,10,24,28,-1.655807816585206,-1.0154083176741702,-0.4213036513610081,1.5582168365841746,12984,12984,Southeast Arkansas,Lincoln,5,79,Arkansas,AR
05023,05CS030,322,312,333,368,46,35,56,38,-0.10722606155517608,0.3071391769241725,0.7454579385024481,0.8137310284782735,393,381,406,457,64,51,76,61,-0.4853239720093959,0.1197405904658509,0.7478089774201642,0.9453950409826942,24984,24984,Van Buren and Nearby Counties,Cleburne,5,23,Arkansas,AR
05101,05CS030,82,81,83,124,42,41,43,17,3.186875187419698,3.2853364297894294,3.3971885895578033,0.39328573098973557,100,99,101,139,39,38,40,15,3.549724839120139,3.706429392952853,3.8489874211148685,0.3782894752600379,7666,7666,Van Buren and Nearby Counties,Newton,5,101,Arkansas,AR
05129,05CS030,100,99,101,91,-9,-10,-8,15,-3.1479549323863383,-3.051901963705356,-2.940600705662035,-1.8865160672212908,122,121,124,158,36,34,37,15,2.9814125588267815,3.1359472848174237,3.2939361676156067,0.4107137238404885,7854,7854,Van Buren and Nearby Counties,Searcy,5,129,Arkansas,AR
05137,05CS030,154,149,160,197,43,37,48,19,1.4719388557543065,1.8937579535304603,2.3317724765007344,0.4328503822631178,188,182,195,243,55,48,61,25,2.2011720280379934,2.8125836599286793,3.3950787099416906,0.45020283909218495,12639,12639,Van Buren and Nearby Counties,Stone,5,137,Arkansas,AR
05141,05CS030,210,203,217,201,-9,-16,-2,13,-1.7502038752310847,-1.3247364977472027,-0.8992064040142669,-1.686017500058926,256,248,265,323,67,58,75,35,1.7160982531645488,2.310778016324171,2.8906655756071733,0.5161919376269481,16534,16534,Van Buren and Nearby Counties,Van Buren,5,141,Arkansas,AR
05143,05CS031,1460,1355,1564,1646,186,82,291,217,-0.5651021637107259,-0.13484809420668956,0.28501103762689145,1.1583985932221363,1808,1682,1933,2044,236,111,362,237,-0.5927479915765629,-0.01736663413973341,0.6059409914359084,0.9992297142728613,240985,240985,Washington,Washington,5,143,Arkansas,AR
05145,05CS032,727,693,760,841,114,81,148,55,0.3293360601122144,0.7388022886558537,1.1695573531995418,0.4762710888600758,890,849,930,1094,204,164,245,111,0.8243123064373578,1.4285750486422717,2.0726043661891485,0.5407496052936636,78666,78666,White,White,5,145,Arkansas,AR
06001,06CS001,8533,7817,9248,9396,863,148,1579,635,-0.3193464747961014,0.13787581323662404,0.5514652556011571,0.7347572177575369,10598,9739,11457,11264,666,-193,1525,805,-0.7306812456969244,-0.09367342572515239,0.5008723666160576,1.2068161741089125,1665875,1665875,Alameda,Alameda,6,1,California,CA
06003,06CS002,17,17,17,19,2,2,2,4,-2.2350760642627048,-2.125882018241306,-2.0179990762169973,1.5247665774981158,21,21,22,27,6,5,6,4,1.5913234227378132,1.7520802874717891,1.9110367555939916,0.6033037355416706,1116,1116,Alpine and Nearby Counties,Alpine,6,3,California,CA
06005,06CS002,391,374,408,426,35,18,52,19,-0.0359095266520257,0.40788398090929995,0.8498886297194561,0.5245130028939764,479,458,500,549,70,49,91,43,0.20163443112415314,0.8200855373671225,1.4486049838498585,0.604833358022427,39856,39856,Alpine and Nearby Counties,Amador,6,5,California,CA
06009,06CS002,438,418,458,466,28,8,48,17,-0.19303400891042846,0.22736387153667048,0.6694792449832221,0.5905424255423026,537,513,561,619,82,58,106,59,-0.041302395820649436,0.5739263849245535,1.2031176053768242,0.7118109682148633,46198,46198,Alpine and Nearby Counties,Calaveras,6,9,California,CA
06027,06CS002,182,174,190,204,22,14,30,28,-0.7437589906714818,-0.3264776723695556,0.10006358069513806,1.2145911841045887,223,213,232,245,22,13,32,22,-0.6389461801845154,0.012828651904183041,0.6697225553795764,0.9444716782998599,18015,18015,Alpine and Nearby Counties,Inyo,6,27,California,CA
06051,06CS002,58,57,60,39,-19,-21,-18,2,-1.5798880445685288,-1.4731122558776741,-1.3599064277494024,-0.10900073618230265,74,72,76,64,-10,-12,-8,4,-1.3226396268800953,-1.1580889553695415,-1.000091450445931,-0.443843922390753,14485,14485,Alpine and Nearby Counties,Mono,6,51,California,CA
06007,06CS003,1900,1808,1992,1992,92,0,184,132,-0.6172892335561475,-0.18138094988437764,0.2457237141836096,1.4163598883499304,2317,2207,2427,2569,252,142,362,293,-0.8723851694659911,-0.2371743566431424,0.3853289744050336,1.159315329339259,216234,216234,Butte,Butte,6,7,California,CA
06011,06CS004,146,137,156,155,9,-1,18,15,-0.7121361828675307,-0.2999036256117446,0.11727774736280229,1.5490936907456316,180,169,191,183,3,-8,14,23,-1.7229864867135232,-1.1040926555251294,-0.5101905152275229,5.854679191625018,21509,21509,Colusa+Lake,Colusa,6,11,California,CA
06033,06CS004,738,710,766,719,-19,-47,9,39,-1.3422095080568082,-0.908891394096236,-0.4857339421029023,-2.142515083844674,899,866,932,956,57,24,90,89,-1.2286069884694237,-0.5976724242080674,-0.005700230613750214,1.537633462969587,64470,64470,Colusa+Lake,Lake,6,33,California,CA
06013,06CS005,6728,6232,7224,7277,549,53,1045,422,-0.30516333274648466,0.11638380075673484,0.5607364250674103,0.7672491596602943,8320,7725,8915,9111,791,196,1386,650,-0.44586817628252373,0.14231331500884645,0.7517954972713153,0.8208911381631343,1152654,1152654,Contra Costa,Contra Costa,6,13,California,CA
06015,06CS006,263,251,275,283,20,8,32,6,0.09869949282395303,0.4963631944011577,0.93082710959466,0.2802901709920493,322,308,337,380,58,43,72,45,-0.09644833258171702,0.528503592916053,1.188908252607787,0.7651465781602427,27930,27930,Del Norte+Humboldt+Trinity,Del Norte,6,15,California,CA
06023,06CS006,1141,1083,1199,1200,59,1,117,23,-0.17185103249556186,0.2731620792954769,0.6627686517207617,0.383761403481301,1402,1333,1472,1602,200,130,269,93,0.3199976032852336,0.9608744467919813,1.5881231409438024,0.46355638948565114,135480,135480,Del Norte+Humboldt+Trinity,Humboldt,6,23,California,CA
06105,06CS006,139,134,144,147,8,3,13,4,-0.06939436090346453,0.3313351627712378,0.764471058808752,0.43720399988028025,170,163,176,198,28,22,35,19,0.3031955675095459,0.9252811546264174,1.5126256269032705,0.6450312351375956,12287,12287,Del Norte+Humboldt+Trinity,Trinity,6,105,California,CA
06017,06CS007,1362,1279,1445,1514,152,69,235,72,-0.02169613604611696,0.4197085315263921,0.8454592510481057,0.47004615842547093,1675,1576,1775,1902,227,127,326,159,-0.2096447826084465,0.412802409506493,1.0349509162324448,0.6980342738616537,193002,193002,El Dorado,El Dorado,6,17,California,CA
06019,06CS008,5988,5558,6419,7507,1519,1088,1949,937,0.1450025679920742,0.5846668361249246,1.0245993880543374,0.616534795161771,7416,6899,7933,9345,1929,1412,2446,1402,0.014399301089152208,0.629188569463901,1.2521747302757824,0.7266015864457607,999127,999127,Fresno,Fresno,6,19,California,CA
06021,06CS009,229,216,241,223,-6,-18,7,22,-1.4088926249490523,-0.9581734643845738,-0.5589028783894326,-4.729976345348058,282,267,296,330,48,34,63,59,-1.0367865429205638,-0.44081484071143123,0.18483058678764794,1.1942887845922578,28378,28378,Glenn+Tehama,Glenn,6,21,California,CA
06103,06CS009,603,575,631,679,76,48,104,44,0.061397874987820705,0.502454189029687,0.8995544411419242,0.5724297885625322,740,707,773,940,200,167,233,129,0.7124533093048234,1.3007568263851952,1.8991384211781006,0.64135283616041,64898,64898,Glenn+Tehama,Tehama,6,103,California,CA
06025,06CS010,972,952,991,1660,688,669,708,529,0.7807241641926828,0.8843071239483322,0.988073525768986,0.767402127493978,1198,1174,1222,1585,387,363,411,344,0.1262415087810455,0.28497307688910617,0.43495036048619,0.8864248222758278,180367,180367,Imperial,Imperial,6,25,California,CA
06029,06CS011,5294,4907,5682,6535,1241,853,1628,678,0.2074450838691337,0.6303262766033162,1.0535383670308154,0.5460659377154997,6564,6098,7030,8582,2018,1552,2484,1345,0.24870092437715982,0.9188806904949796,1.4902937164178005,0.6661693001082373,899925,899925,Kern,Kern,6,29,California,CA
06031,06CS012,748,683,814,920,172,106,237,113,-0.04655544964121378,0.3690074261260788,0.7902413672044335,0.6549340620392143,934,855,1013,1301,367,288,446,225,0.5230556790166742,1.1247029492000387,1.741094223480069,0.6117570740985852,152712,152712,Kings,Kings,6,31,California,CA
06035,06CS013,206,193,219,247,41,28,54,16,0.3906417623454523,0.8274050648012068,1.2274200302652851,0.381687750206376,253,238,269,364,111,95,126,65,1.189527998589366,1.773884154023748,2.449675378055813,0.582245596997691,30412,30412,Lassen+Plumas+Sierra,Lassen,6,35,California,CA
06063,06CS013,195,187,203,232,37,29,45,7,1.1362954764560838,1.5665689699935066,1.9947269621308608,0.18532420979618355,238,229,248,278,40,30,49,30,0.011781298829658941,0.6143978152733567,1.2536766647027187,0.7374851977023226,19017,19017,Lassen+Plumas+Sierra,Plumas,6,63,California,CA
06091,06CS013,29,29,30,36,7,6,7,1,1.8582255764733366,1.9557526401298562,2.0616836678368546,0.12887129865759026,36,35,36,37,1,1,2,3,-0.9131419718741624,-0.7641646956986482,-0.597712957511869,1.4040045772245233,2943,2943,Lassen+Plumas+Sierra,Sierra,6,91,California,CA
06037,06CS014,53682,49402,57963,69724,16042,11761,20322,11176,0.05512424144727437,0.48998707721466966,0.9147215383300215,0.696645560266323,66623,61487,71758,82176,15553,10418,20689,13943,-0.44462472571890255,0.20010238541460823,0.779439396054832,0.8963966889464893,9983037,9983037,Los Angeles,Los Angeles,6,37,California,CA
06039,06CS015,953,885,1021,1137,184,116,252,170,-0.3496306390774563,0.08793193670747951,0.47096772953103483,0.9199755772414856,1178,1097,1260,1494,316,234,397,269,-0.2755335149639579,0.3574359396779538,1.000288532998191,0.8491062231963327,157152,157152,Madera,Madera,6,39,California,CA
06041,06CS016,1641,1530,1752,1754,113,2,224,114,-0.431679116937211,-0.005654716092620522,0.41904805974632164,1.0001642496746526,2025,1892,2158,2165,140,7,273,76,-0.3539335088547504,0.27891122175853483,0.8917440692431907,0.538410132774656,258355,258355,Marin,Marin,6,41,California,CA
06043,06CS017,173,166,181,175,2,-6,9,5,-0.6145077313901899,-0.18576213814830464,0.23564471365335243,1.9014138988645344,212,203,221,243,31,22,40,22,0.005983391948616449,0.637966855316572,1.3016985149874793,0.6828005703358541,17135,17135,Mariposa+Tuolumne,Mariposa,6,43,California,CA
06109,06CS017,574,550,597,647,73,50,97,33,0.34164014235620344,0.7421977748215036,1.1960300296746986,0.4430747745227473,700,672,728,847,147,119,175,115,0.0822053800560685,0.6940730974671864,1.368027850093937,0.7780358547424016,54384,54384,Mariposa+Tuolumne,Tuolumne,6,109,California,CA
06045,06CS018,715,678,752,870,155,118,192,35,0.9620319703817508,1.3892494648371887,1.8309223658646254,0.22400703174245637,876,832,921,1056,180,135,224,65,0.9961748182689214,1.5946285586312448,2.2026611898740835,0.36009372410949037,86569,86569,Mendocino,Mendocino,6,45,California,CA
06047,06CS019,1550,1430,1670,1948,398,278,518,260,0.08976214177808667,0.5021913741996792,0.9478613774321306,0.6521769364525744,1920,1776,2064,2341,421,277,565,384,-0.45223553379703585,0.16739312456596792,0.7350102660372225,0.9103898863714711,278005,278005,Merced,Merced,6,47,California,CA
06049,06CS020,95,94,96,101,6,5,7,2,0.33601482471324495,0.4382123419075734,0.5483466794992267,0.29039753757662323,117,115,118,141,24,23,26,12,1.53240617644451,1.6838069074875224,1.8466952715967886,0.47249895137496156,8823,8823,Modoc+Siskiyou,Modoc,6,49,California,CA
06093,06CS020,484,466,503,542,58,39,76,14,0.5738869805352679,1.0072885603639194,1.4267072463436161,0.23882232295477457,588,566,611,742,154,131,176,75,1.5661591220789401,2.169729472387734,2.794838019719158,0.48526098105201976,43489,43489,Modoc+Siskiyou,Siskiyou,6,93,California,CA
06053,06CS021,2212,2027,2398,2539,327,141,512,256,-0.2674127096362715,0.15814796131260545,0.5964883073085039,0.7809476872428723,2747,2524,2969,3156,409,187,632,367,-0.46044103000168063,0.13921872064377558,0.7226104439780375,0.8949357852953446,432349,432349,Monterey,Monterey,6,53,California,CA
06055,06CS022,1022,964,1081,1043,21,-38,79,38,-0.5452216403701026,-0.11935836429201702,0.28152277402247966,1.7436835156596935,1255,1185,1325,1344,89,19,159,73,-0.476201578327919,0.1423852076885553,0.7670566247806239,0.812028880277606,136964,136964,Napa,Napa,6,55,California,CA
06057,06CS023,888,845,931,988,100,57,143,63,-0.05726385148882016,0.3635549079152443,0.7869793329708534,0.6255615514122754,1089,1038,1141,1207,118,66,169,67,0.004008560103684477,0.5949684568466954,1.1831147082540294,0.5633313038516541,99630,99630,Nevada,Nevada,6,57,California,CA
06059,06CS024,17103,15740,18465,19959,2856,1494,4219,2459,-0.30990811794560796,0.12270987835917907,0.5454588884626779,0.8606429506311872,21246,19610,22882,25158,3912,2276,5548,3517,-0.4651503573647767,0.14421254332166103,0.7690746051029881,0.8988452536677146,3169187,3169187,Orange,Orange,6,59,California,CA
06061,06CS025,2857,2683,3030,2988,131,-42,305,157,-0.4829724932441123,-0.06863056071153228,0.36433964490499104,1.186123413896477,3516,3307,3724,3892,376,168,585,306,-0.3738952957555711,0.2067491221588702,0.9054633311229122,0.8107637891197607,400598,400598,Placer,Placer,6,61,California,CA
06065,06CS026,14796,13726,15866,18545,3749,2679,4819,2657,0.020435128860265772,0.43005368851375037,0.8911325914728101,0.7085187451448727,18335,17049,19621,23058,4723,3437,6009,3945,-0.23888183204824406,0.3952210650321924,1.0033027922209716,0.8350599941706687,2475410,2475410,Riverside,Riverside,6,65,California,CA
06067,06CS027,10130,9460,10801,11312,1182,511,1852,948,-0.25738664247144655,0.14000000934396933,0.5955285186276386,0.8015507525864076,12508,11703,13313,13863,1355,550,2160,1326,-0.6277837678702659,0.031347904519138714,0.6583235927391285,0.9778436795128156,1554779,1554779,Sacramento,Sacramento,6,67,California,CA
06069,06CS028,318,290,345,352,34,7,62,32,-0.4116411564257237,0.021154890069618692,0.4723112726217294,0.9112763785941802,397,363,430,475,78,45,112,60,-0.255789908235453,0.3280858784808463,1.0072761708400735,0.7554789344802799,63325,63325,San Benito,San Benito,6,69,California,CA
06071,06CS029,12450,11509,13392,16663,4213,3271,5154,2747,0.2507464827961006,0.6778937788003319,1.1088840990041502,0.651910060151481,15450,14319,16581,19890,4440,3309,5571,3626,-0.11802856831325965,0.44783089086786737,1.0521200697219988,0.8165190966003216,2182239,2182239,San Bernardino,San Bernardino,6,71,California,CA
06073,06CS030,18526,17092,19959,20772,2246,813,3680,1748,-0.2532127072779877,0.16263989213595756,0.6019273389231479,0.7778047801566101,22983,21262,24704,26416,3433,1712,5154,2869,-0.35049664503696215,0.20451139597011297,0.7980299102151478,0.8354795277822168,3331279,3331279,San Diego,San Diego,6,73,California,CA
06075,06CS031,4899,4526,5272,5343,444,71,817,222,-0.1979544238651954,0.24459035646720048,0.7011076486736789,0.4987979650671231,6059,5611,6507,6568,509,61,957,342,-0.3815053992626883,0.21527416385741668,0.829715330864021,0.6704637412853859,873734,873734,San Francisco,San Francisco,6,75,California,CA
06077,06CS032,4877,4547,5208,5976,1099,768,1429,793,-0.04304774449684742,0.39652752684486076,0.8134909465501623,0.7211516857995038,6022,5625,6419,7226,1204,807,1601,1092,-0.42910703514579246,0.1871883934272767,0.7916520543204466,0.9062119084492531,764236,764236,San Joaquin,San Joaquin,6,77,California,CA
06079,06CS033,2063,1942,2185,2068,5,-117,126,116,-0.8628458447081373,-0.4040488067130835,0.04970461475542556,20.944207742235108,2539,2393,2685,2670,131,-15,277,248,-1.0831591771120719,-0.48859407149357936,0.08773489237319841,1.882184774963815,282528,282528,San Luis Obispo,San Luis Obispo,6,79,California,CA
06081,06CS034,3998,3671,4324,4151,153,-173,480,248,-0.5545620765356035,-0.1333933141786154,0.3157600357770388,1.6069481015164135,4956,4564,5347,5115,159,-232,551,357,-0.9391667313568346,-0.30793729946262777,0.2799331669087649,2.2256018691099118,762101,762101,San Mateo,San Mateo,6,81,California,CA
06083,06CS035,2721,2530,2913,2900,179,-13,370,177,-0.4169585899934886,-0.011842512373762687,0.43321172744249054,0.985162460822505,3366,3136,3596,3659,293,63,523,378,-0.8369824866267245,-0.21912528646857926,0.3569034433469442,1.2851234826963398,445173,445173,Santa Barbara,Santa Barbara,6,83,California,CA
06085,06CS036,8612,7791,9433,9579,967,146,1788,852,-0.3952002752348577,0.06509685454136654,0.47871679705197995,0.8800001676010756,10740,9755,11725,11347,607,-378,1592,1085,-0.9570763361208996,-0.3018653253622791,0.32614773712083484,1.7838199909086916,1916034,1916034,Santa Clara,Santa Clara,6,85,California,CA
06087,06CS037,1478,1361,1594,1583,105,-11,222,122,-0.5024057426442348,-0.06387264119531191,0.346033450972592,1.145635160833166,1831,1691,1970,2003,172,33,312,147,-0.5852389239756021,0.09327069791349464,0.751974195739882,0.8485669686184936,271643,271643,Santa Cruz,Santa Cruz,6,87,California,CA
06089,06CS038,1899,1822,1976,2068,169,92,246,102,-0.062048669438623145,0.3799855753438493,0.764020660065615,0.5995282243989417,2317,2225,2410,2775,458,365,550,346,0.13051862761558344,0.7414381666649993,1.371937494953189,0.7545122479883425,179388,179388,Shasta,Shasta,6,89,California,CA
06095,06CS039,2915,2723,3107,3118,203,11,395,171,-0.3503332831091705,0.07826870429630925,0.4933712916783175,0.8379440457949234,3603,3372,3834,4077,474,243,705,358,-0.31249442883671197,0.31412157823107434,0.8920254448986308,0.7537465635220887,447226,447226,Solano,Solano,6,95,California,CA
06097,06CS040,3440,3229,3651,3693,253,42,464,196,-0.3239750456530762,0.12996270742412563,0.5701516486629672,0.7713262923645244,4235,3982,4488,4555,320,67,573,232,-0.4578756639995424,0.21186197662132603,0.8251096527455929,0.7237345202284203,491277,491277,Sonoma,Sonoma,6,97,California,CA
06099,06CS041,3712,3476,3949,4541,829,592,1065,634,-0.07621511101105968,0.35114606680536703,0.785012787538208,0.7640571928709852,4574,4290,4858,5580,1006,722,1290,860,-0.3344975224270585,0.31995109865720595,0.9365202883313353,0.853883496686029,549894,549894,Stanislaus,Stanislaus,6,99,California,CA
06101,06CS042,716,674,757,799,83,42,125,62,-0.20061207300253842,0.23175654335079904,0.6419406577014701,0.7367705503782122,880,830,930,1012,132,82,182,146,-0.793943691332586,-0.17450051088014237,0.4167520853534305,1.097955881398126,96691,96691,Sutter,Sutter,6,101,California,CA
06107,06CS043,2672,2470,2873,3323,651,450,853,451,-0.002561095870878956,0.4232944310305598,0.8356092203551339,0.691582949803961,3309,3067,3551,4330,1021,779,1263,783,-0.05438329865738667,0.6304346430125086,1.2188245393434416,0.7663310990568711,466971,466971,Tulare,Tulare,6,107,California,CA
06111,06CS044,4882,4520,5244,5547,665,303,1027,376,-0.06829857762220964,0.33629084059426456,0.7571344673541027,0.5645164573177304,6048,5613,6482,7127,1079,645,1514,818,-0.23739961623531597,0.3628989337259666,0.9809800193962118,0.7570713604214152,843030,843030,Ventura,Ventura,6,111,California,CA
06113,06CS045,1141,1046,1235,1253,112,18,207,110,-0.41943699545526,0.01047719250394301,0.43903185289316105,0.9702841454377876,1415,1302,1529,1540,125,11,238,131,-0.6585309087332852,-0.035710198339836,0.561461188308967,1.0422403888501033,219898,219898,Yolo,Yolo,6,113,California,CA
06115,06CS046,574,540,609,561,-13,-48,21,29,-0.9638032226968141,-0.5157660611139975,-0.12374867437780362,-2.3726267914947683,707,666,748,805,98,57,139,85,-0.4489353568598079,0.18292642755448335,0.7730075226643869,0.8588648080403309,79220,79220,Yuba,Yuba,6,115,California,CA
08005,08CS002,3376,3093,3659,4174,798,515,1081,492,0.01259732556695461,0.45659212742150534,0.9106627876491281,0.6156193083951136,4193,3853,4532,4869,676,337,1016,392,-0.12606251466230428,0.5345318252283072,1.1767722873559139,0.5787792686568141,656635,656635,Arapahoe,Arapahoe,8,5,Colorado,CO
08015,08CS005,163,155,172,182,19,10,27,15,-0.28299909611847623,0.17567502934471682,0.6244462415722412,0.7670525756994824,200,189,210,167,-33,-43,-22,12,-3.250462559082421,-2.6211759461752937,-2.0214161946597793,-0.37838957704482473,20462,20462,Central Colorado,Chaffee,8,15,Colorado,CO
08051,08CS005,67,65,69,70,3,1,5,5,-0.23470887214671346,-0.1198187299176893,-0.008299138326875184,1.2794601012525588,82,80,84,89,7,5,9,7,-0.13971438261100877,0.011525936036066975,0.1555495207577319,0.8641210675999189,17527,17527,Central Colorado,Gunnison,8,51,Colorado,CO
08065,08CS005,34,33,35,31,-3,-4,-2,6,-1.251440076014951,-1.1435815788487445,-1.0366465138550314,-2.7342803828338953,42,41,43,58,16,15,17,4,1.6742112099525037,1.8334023528880878,1.9782777557750397,0.23156210915675837,8037,8037,Central Colorado,Lake,8,65,Colorado,CO
08097,08CS005,51,49,53,60,9,7,11,6,0.054605407923509014,0.15970500532377788,0.26454037648611767,0.605645813819947,62,60,65,72,10,7,12,8,-0.059706553719369324,0.10727534400647865,0.25988244038769376,0.7579856698106957,17899,17899,Central Colorado,Pitkin,8,97,Colorado,CO
08109,08CS005,42,42,43,53,11,10,11,3,1.0062708404816478,1.1041842523496466,1.2066429681941413,0.2588115950855539,52,51,53,68,16,15,17,2,2.3522246008403065,2.497199565873739,2.644899800484146,0.11559126233186533,6874,6874,Central Colorado,Saguache,8,109,Colorado,CO
08027,08CS006,40,40,41,46,6,5,6,6,-0.1915700628781658,-0.0871901514613264,0.02150192413068549,0.9162087428948975,50,49,50,61,11,11,12,17,-1.4548060566480803,-1.3072664512145642,-1.1382829284867697,1.3705588557736736,5146,5146,Custer+Fremont,Custer,8,27,Colorado,CO
08043,08CS006,479,459,500,533,54,33,74,26,0.13376655190356496,0.5907509158509111,1.007808476507211,0.47434777361578717,586,561,611,755,169,144,194,137,0.1762961951453764,0.8076245576967219,1.395256790650518,0.8067528950578872,47950,47950,Custer+Fremont,Fremont,8,43,Colorado,CO
08029,08CS007,340,327,353,371,31,18,44,23,-0.1573133601762349,0.25073856041735026,0.6836608479841823,0.7157167414454516,415,399,431,504,89,73,105,93,-0.8040724834027829,-0.17683687810735396,0.45302029214151657,1.0366630026400665,31040,31040,Delta+Montrose,Delta,8,29,Colorado,CO
08085,08CS007,388,369,406,417,29,11,48,27,-0.3727920048633731,0.05669169409844335,0.47703547444081706,0.886078747490455,476,453,498,613,137,115,160,114,-0.024381061931928634,0.6606304595953808,1.215102816082621,0.8251408588447415,43012,43012,Delta+Montrose,Montrose,8,85,Colorado,CO
08031,08CS008,4035,3719,4351,4938,903,587,1219,647,-0.08375825442690726,0.35481769274936253,0.7605716995207581,0.7156099483105559,4996,4616,5376,5229,233,-147,613,408,-0.9459730136668634,-0.2852254766482639,0.3404042436892905,1.7463109369855194,729687,729687,Denver,Denver,8,31,Colorado,CO
08035,08CS009,1296,1141,1451,1611,315,160,470,166,-0.01100601677971278,0.41421291152977474,0.8608791048144065,0.5252094386739705,1638,1452,1825,1994,356,169,542,165,0.009192445544484167,0.6374430991100156,1.308159413342873,0.46277569861373447,355554,355554,Douglas,Douglas,8,35,Colorado,CO
08037,08CS010,134,128,140,130,-4,-10,2,13,-0.4062480809334873,-0.30819427696744955,-0.2010369233324174,-4.555739195844384,168,161,175,189,21,14,28,16,-0.03213326406953918,0.1101188509796055,0.2704325571111161,0.7188178245887522,55077,55077,Eagle,Eagle,8,37,Colorado,CO
08039,08CS011,144,133,156,150,6,-6,17,13,-0.7254754481679606,-0.28101278327961865,0.15845232966875444,1.93660293564215,180,166,194,210,30,16,44,25,-0.4092517684079261,0.23230580062037554,0.8518799676511835,0.8039915794892494,26960,26960,East Central Colorado,Elbert,8,39,Colorado,CO
08063,08CS011,57,57,58,81,24,23,24,5,2.4921736786282835,2.5967470633494107,2.7008809189654053,0.20360955413292964,70,69,71,103,33,32,34,15,2.824240146523617,2.9727453097664918,3.134190345949177,0.44529252327438,7144,7144,East Central Colorado,Kit Carson,8,63,Colorado,CO
08073,08CS011,49,49,50,50,1,0,1,4,-0.6532975251027519,-0.5512687667080972,-0.4491956259172592,2.167190369468354,60,59,61,67,7,6,8,6,0.016984528040721678,0.1719570384163381,0.3357959732162426,0.7635174230292981,5688,5688,East Central Colorado,Lincoln,8,73,Colorado,CO
08121,08CS011,45,45,46,65,20,19,20,14,1.0932889211015122,1.2030428923720968,1.3101687358737757,0.6711147709888609,55,55,56,67,12,11,12,14,-0.6917888922040693,-0.5386928984315412,-0.38822397661878527,1.094358860585695,4872,4872,East Central Colorado,Washington,8,121,Colorado,CO
08125,08CS011,84,83,85,101,17,16,18,12,0.3892521458593413,0.4911493398344168,0.594592773357485,0.6684208751919324,103,102,104,103,0,-1,1,7,-0.9828015647760081,-0.8154366475136303,-0.6591470574333029,6.103530621069177,10031,10031,East Central Colorado,Yuma,8,125,Colorado,CO
08041,08CS012,4242,3929,4555,5200,958,645,1271,530,0.133775039288647,0.5879434944811813,1.0089434438109037,0.5527220384327255,5263,4887,5639,6483,1220,844,1596,828,0.03319240320963835,0.6482012188457069,1.2179063058399997,0.6780180834291543,724588,724588,El Paso,El Paso,8,41,Colorado,CO
08045,08CS013,308,282,334,338,30,4,56,36,-0.4969735472615524,-0.09766314290488931,0.30975421417911225,1.156310747984254,383,352,414,423,40,9,71,40,-0.6426338962310647,0.02709149946858916,0.6080535209030989,0.9786543174027248,60171,60171,Garfield,Garfield,8,45,Colorado,CO
08059,08CS014,10081,9291,10870,11827,1746,957,2536,1405,-0.2517033296435789,0.17790533623245844,0.6342417071853269,0.8040500963178395,12502,11554,13451,14154,1652,703,2600,1420,-0.4635135905683214,0.14260999248198247,0.7579670351459604,0.8593023947090334,1827315,1827315,Jefferson,Jefferson,8,59,Colorado,CO
08067,08CS015,299,275,323,362,63,39,87,24,0.2885518322114382,0.694731387404899,1.1017754439425755,0.37529503761211697,372,343,401,440,68,39,97,36,0.03779838780498844,0.6936864537933533,1.2680996875580979,0.5199472441761205,56492,56492,La Plata+Montezuma,La Plata,8,67,Colorado,CO
08083,08CS015,234,223,246,251,17,5,28,16,-0.40569975534599534,0.01595897269944721,0.43763163882863326,0.9068530836467289,287,274,301,370,83,69,96,47,1.0065333761007014,1.6135140827631704,2.2006106750016516,0.5612269990359464,26385,26385,La Plata+Montezuma,Montezuma,8,83,Colorado,CO
08069,08CS016,2057,1902,2212,2213,156,1,311,114,-0.31080557269445214,0.1407420273623696,0.5586078298641883,0.7255537753767132,2545,2359,2731,2778,233,47,419,241,-0.6075702416588138,-0.03319120865067378,0.5970231019912997,1.0285022706464095,358569,358569,Larimer,Larimer,8,69,Colorado,CO
08075,08CS017,184,174,193,264,80,71,90,55,0.7346091334316075,1.1424089645297089,1.5293090677343502,0.6763997229668494,225,213,236,272,47,36,59,46,-0.5512094069282133,0.05044450696816252,0.7119639596103131,0.9537818560822305,22228,22228,Logan+Morgan+Phillips+Sedgwick,Logan,8,75,Colorado,CO
08087,08CS017,235,223,248,296,61,48,73,71,-0.7883589149451359,-0.34877448311282105,0.05789518710948083,1.1491096676153436,288,274,303,330,42,27,56,44,-0.7031140060726832,-0.11464180570632757,0.49871460496851533,1.0346575434242686,28939,28939,Logan+Morgan+Phillips+Sedgwick,Morgan,8,87,Colorado,CO
08095,08CS017,44,43,44,67,23,23,24,2,4.732223149442953,4.835934224675728,4.938050233455072,0.08307447144889471,54,53,54,71,17,17,18,1,4.357538254192514,4.516350342618462,4.6625480025793475,0.05429555208066929,4362,4362,Logan+Morgan+Phillips+Sedgwick,Phillips,8,95,Colorado,CO
08115,08CS017,29,29,30,41,12,11,12,5,2.8681344705079863,2.9621797878697023,3.0670662287330077,0.3932428446256516,36,35,36,34,-2,-2,-1,3,-2.6403632451861427,-2.4868946470230924,-2.3319200004296743,-4.280329409578925,2268,2268,Logan+Morgan+Phillips+Sedgwick,Sedgwick,8,115,Colorado,CO
08077,08CS018,1332,1265,1399,1536,204,137,271,108,0.20143582645166958,0.6323099824617898,1.0242869133450376,0.5260975561400109,1636,1556,1717,1995,359,278,439,319,-0.26793950535033534,0.2944545891142401,0.9461280468908223,0.8865790831923746,154990,154990,Mesa,Mesa,8,77,Colorado,CO
08049,08CS019,67,66,69,64,-3,-5,-2,4,-0.5610773149805998,-0.4583708766130927,-0.3518133859427335,-1.7867805876510445,83,81,85,100,17,15,19,13,0.15153639160641252,0.30689256537567006,0.447579676452828,0.723318339025703,15767,15767,Northwest Colorado,Grand,8,49,Colorado,CO
08057,08CS019,11,11,11,11,-0,-0,-0,8,-5.966821172428699,-5.851991004068238,-5.749769879602869,9.561025542465542,14,14,14,14,0,0,0,7,-5.910760831760492,-5.751558439828755,-5.598187563186886,5.33552124896265,1394,1394,Northwest Colorado,Jackson,8,57,Colorado,CO
08081,08CS019,86,85,88,139,53,51,54,21,2.2856515575006173,2.3974004627090144,2.4948124873869695,0.3919780445156625,106,104,108,157,51,49,53,32,1.5482174977558452,1.7115987812145044,1.866018990958803,0.6172943292776735,13182,13182,Northwest Colorado,Moffat,8,81,Colorado,CO
08103,08CS019,45,44,45,56,11,11,12,3,1.2141217113778713,1.3213255016584897,1.4263266738694214,0.24230323803202852,55,54,56,70,15,14,16,10,0.8321200202800229,0.995953927859593,1.1437088347445552,0.6161946759351855,6347,6347,Northwest Colorado,Rio Blanco,8,103,Colorado,CO
08107,08CS019,107,105,110,115,8,5,10,21,-0.627486529778892,-0.5323233911032282,-0.4132611154104131,2.468882550250458,133,129,136,133,0,-3,4,3,-0.2938680638063795,-0.13166251622970704,0.030543471143993275,2.4272404989217855,25571,25571,Northwest Colorado,Routt,8,107,Colorado,CO
08019,08CS020,54,53,55,57,3,2,4,4,-0.23033519402784947,-0.12166063415182747,-0.010172834626746263,1.0366649727475807,67,65,68,68,1,0,3,1,-0.12141643490870892,0.03777082465838134,0.20280939149984015,0.4285856355570066,9593,9593,Park and Nearby Counties,Clear Creek,8,19,Colorado,CO
08047,08CS020,28,27,29,27,-1,-2,-0,6,-1.2660948631021633,-1.1484954701275063,-1.0446071516369884,-39.72662597982519,35,34,36,40,5,4,6,1,0.6611984492518798,0.8132188589825549,0.9694999783097378,0.1604920632897774,6233,6233,Park and Nearby Counties,Gilpin,8,47,Colorado,CO
08093,08CS020,91,89,93,113,22,20,24,8,0.6104909978539078,0.7155253309055605,0.8137773090192173,0.35503990771201666,113,110,115,118,5,3,8,10,-0.4643284065031148,-0.3100848979439003,-0.15629567618846138,1.6278758911383762,18912,18912,Park and Nearby Counties,Park,8,93,Colorado,CO
08117,08CS020,70,67,73,72,2,-1,5,6,-0.2436800586857868,-0.13419779908104398,-0.03443624779888221,2.1240350149627214,88,84,92,88,0,-4,4,7,-0.4320453459262127,-0.26834782103032623,-0.1056892219028805,6.752281266260153,30759,30759,Park and Nearby Counties,Summit,8,117,Colorado,CO
08119,08CS020,154,143,165,183,29,18,40,3,0.571924513743483,1.0055189045682913,1.4582672304339876,0.10087592733111736,191,177,204,288,97,84,111,42,1.9897306924190223,2.6141546375181104,3.2761814010265216,0.4269610722141798,25458,25458,Park and Nearby Counties,Teller,8,119,Colorado,CO
08101,08CS021,1570,1497,1643,1998,428,355,501,262,0.5365811821131208,0.9893969075225452,1.4241794225259867,0.6108198725272657,1928,1841,2016,2470,542,454,629,365,0.5952520547323386,1.2520885036316685,1.8645476743576985,0.672530590446983,168998,168998,Pueblo,Pueblo,8,101,Colorado,CO
08009,08CS022,45,44,45,60,15,15,16,2,3.607231708365179,3.7166660065183468,3.81911295203184,0.12230101172603634,54,54,55,78,24,23,24,3,6.729483558362059,6.878006605672706,7.040944824283257,0.1219220084666414,3593,3593,Southeast Colorado,Baca,8,9,Colorado,CO
08011,08CS022,53,52,53,67,14,14,15,5,1.6107896786416085,1.7134373960043001,1.8221658952818847,0.3246854919692714,64,63,65,85,21,20,22,22,-0.4000112168630595,-0.2472476244491731,-0.08908744479079075,1.005261192832732,5486,5486,Southeast Colorado,Bent,8,11,Colorado,CO
08017,08CS022,16,16,16,23,7,7,7,2,2.7082007130014802,2.809295196406946,2.91759985884464,0.24694719158718206,19,19,20,24,5,4,5,7,-1.7320420256386675,-1.58173815385959,-1.4217764648068856,1.246835687092723,1812,1812,Southeast Colorado,Cheyenne,8,17,Colorado,CO
08021,08CS022,73,72,74,79,6,5,7,4,0.09976159954206033,0.2087548690607065,0.30675528403247715,0.5957306630636776,89,88,90,139,50,49,51,48,0.08818627066980075,0.2429532178932781,0.4044932846320112,0.9475140353811109,8158,8158,Southeast Colorado,Conejos,8,21,Colorado,CO
08023,08CS022,36,35,36,35,-1,-1,-0,8,-2.29837289296616,-2.191338975477297,-2.0921063540241636,16.890498042177686,43,43,44,58,15,14,15,10,1.2926542288009786,1.446610438667531,1.5947589735264818,0.6372677545954795,3892,3892,Southeast Colorado,Costilla,8,23,Colorado,CO
08025,08CS022,41,40,41,63,22,22,23,0,3.693440586840205,3.806064779446116,3.9059565977835504,0,50,49,50,69,19,19,20,13,1.14528535840676,1.296434360205105,1.4507738558175725,0.6384876891679544,5867,5867,Southeast Colorado,Crowley,8,25,Colorado,CO
08055,08CS022,92,91,93,113,21,20,22,10,1.5164583556775963,1.6235966892404698,1.7212491058918142,0.4515905605130148,112,111,113,138,26,25,27,7,3.178312451533761,3.3364592462584732,3.49285630126821,0.2582739236521069,6874,6874,Southeast Colorado,Huerfano,8,55,Colorado,CO
08061,08CS022,18,18,18,17,-1,-1,-1,3,-2.8016847412251673,-2.6969702800029065,-2.5839570122223194,22.91173829652397,22,22,22,20,-2,-2,-2,3,-4.140758175509491,-3.996650869256864,-3.819922336084002,-3.8956243119462086,1434,1434,Southeast Colorado,Kiowa,8,61,Colorado,CO
08071,08CS022,157,151,163,164,7,1,13,5,-0.3069698867940999,0.1286031306353419,0.5507087342728424,0.6357948970988462,191,183,198,239,48,41,56,27,1.1479496260091688,1.7719706340049362,2.4328136810825494,0.5467094585374426,14417,14417,Southeast Colorado,Las Animas,8,71,Colorado,CO
08089,08CS022,201,194,209,264,63,55,70,36,1.039658159591352,1.466832049749282,1.874937492766425,0.5658932476320078,244,235,254,313,69,59,78,62,-0.16189177820493014,0.4556880259276835,1.0575571166367184,0.8881806032097654,18226,18226,Southeast Colorado,Otero,8,89,Colorado,CO
08099,08CS022,110,109,112,148,38,36,39,18,1.5090198719454357,1.619062146350144,1.7227977782384742,0.4665808586092333,135,133,136,181,46,45,48,22,2.2546362801799855,2.4173139916388378,2.573282438949837,0.4642157896765286,12106,12106,Southeast Colorado,Prowers,8,99,Colorado,CO
08003,08CS023,134,127,141,140,6,-1,13,21,-1.343054529982911,-0.908349601851956,-0.49761930374917124,2.8518685154275034,164,156,172,187,23,15,31,26,-0.8668350857609408,-0.2359477393393034,0.3671710838691958,1.0850212974030036,16192,16192,Southwest Colorado,Alamosa,8,3,Colorado,CO
08007,08CS023,96,94,97,90,-6,-7,-4,4,-0.7909028740528924,-0.6897828879253766,-0.5823825157334256,-0.8532972256662896,119,117,121,135,16,14,18,11,0.2897915818876066,0.452258945228608,0.6003946981878775,0.6370734345718497,14040,14040,Southwest Colorado,Archuleta,8,7,Colorado,CO
08033,08CS023,21,20,22,21,0,-1,1,8,-4.134592926127134,-3.695514198715809,-3.255837972001201,5.7605365209027735,25,24,26,47,22,21,23,7,7.972696272028992,8.541399575554749,9.179837037118313,0.3079094150095562,2064,2064,Southwest Colorado,Dolores,8,33,Colorado,CO
08053,08CS023,9,9,9,2,-7,-7,-7,2,-11.878190358710224,-11.765106153876932,-11.660300828237398,-0.3135721171863338,12,11,12,2,-10,-10,-9,2,-17.527625031326426,-17.371550308662464,-17.217349866984605,-0.23419192810053865,797,797,Southwest Colorado,Hinsdale,8,53,Colorado,CO
08079,08CS023,9,9,10,7,-2,-3,-2,7,-12.450477178291127,-12.34663082469334,-12.24276999143739,-4.930403818747659,12,11,12,7,-5,-5,-4,7,-18.380438729532816,-18.224646261730125,-18.059282892133126,-1.9525792117528717,763,763,Southwest Colorado,Mineral,8,79,Colorado,CO
08091,08CS023,26,26,27,24,-2,-3,-2,5,-1.5495136839081196,-1.4482804127595663,-1.3441867580663351,-3.9682791073513335,33,32,33,32,-1,-1,-0,8,-2.2640491885257714,-2.105969279632755,-1.9633141337270232,35.84635180142534,5003,5003,Southwest Colorado,Ouray,8,91,Colorado,CO
08105,08CS023,112,111,113,142,30,29,31,6,2.0175286351705126,2.126093138673786,2.2337343676013566,0.1934601618562853,138,137,140,174,36,34,37,28,0.6844353327043751,0.8421817871353705,1.0022673078999815,0.7587451692851487,11285,11285,Southwest Colorado,Rio Grande,8,105,Colorado,CO
08111,08CS023,7,7,8,3,-4,-5,-4,3,-10.457605222995449,-10.026617063299582,-9.609157579609203,-0.8953290663381296,9,9,9,5,-4,-4,-4,5,-15.34615071310253,-14.764025319304915,-14.152701898840823,-1.6574414267136437,733,733,Southwest Colorado,San Juan,8,111,Colorado,CO
08113,08CS023,24,23,25,24,0,-1,1,2,-0.35017763931487833,-0.23972890377272477,-0.1396373998321817,1.9898718432842246,31,29,32,31,0,-1,2,1,-0.23500235659671423,-0.08209782638516441,0.08629108584297154,0.6879366908896544,8142,8142,Southwest Colorado,San Miguel,8,113,Colorado,CO
09001,09CS001,5815,5410,6221,7546,1731,1325,2136,1629,-0.359342420555924,0.12016842065519322,0.5725214092865747,0.9406679052996256,7182,6696,7669,7400,218,-269,704,517,-0.9716584224194618,-0.3608478996335696,0.22915155405616866,2.364387253413352,943570,943570,Fairfield,Fairfield,9,1,Connecticut,CT
09003,09CS002,6900,6517,7282,8610,1710,1328,2093,1731,-0.47263966721091843,-0.03164530653390091,0.3899054092796908,1.0115370552099723,8487,8028,8946,8822,335,-124,794,731,-1.1321647024708372,-0.5448476572861374,0.0905276169915702,2.1759762877770865,890464,890464,Hartford,Hartford,9,3,Connecticut,CT
09005,09CS003,1555,1478,1632,1890,335,258,412,249,0.054386746916391955,0.48275364368749374,0.8696716756252586,0.7408941407360432,1911,1819,2004,2040,129,36,221,143,-0.746486629963905,-0.11275535505317519,0.5264687247252755,1.1023872276107567,180068,180068,Litchfield,Litchfield,9,5,Connecticut,CT
09007,09CS004,1333,1263,1403,1526,193,123,263,214,-0.548264682241789,-0.100463843806676,0.30219086344202895,1.1028080151156687,1639,1555,1722,1694,55,-28,139,134,-1.1891367263650598,-0.5950432231660415,0.04518851864734565,2.374490797155416,162171,162171,Middlesex,Middlesex,9,7,Connecticut,CT
09009,09CS005,6676,6310,7043,8319,1643,1276,2009,1488,-0.23930356734377325,0.175131888093705,0.6210129145592327,0.9052772591786299,8205,7765,8645,8563,358,-82,798,717,-1.1106500358647398,-0.4947081095849491,0.0843120847406091,1.995638567100613,853039,853039,New Haven,New Haven,9,9,Connecticut,CT
09011,09CS006,2112,1998,2226,2348,236,122,350,274,-0.5465134317037633,-0.1436230037153692,0.328921905119936,1.1541995356136052,2599,2462,2735,2949,350,214,487,243,-0.13965807468566696,0.49017651723316047,1.0967629031188892,0.6915488079960738,265457,265457,New London,New London,9,11,Connecticut,CT
09013,09CS007,930,865,995,1042,112,47,177,113,-0.4333999132911749,0.009415507201751801,0.43396556957316446,1.0018547224186025,1153,1076,1231,1276,123,45,200,87,-0.3131981484535225,0.2895127634106211,0.8836563953248715,0.7038240139257836,150755,150755,Tolland,Tolland,9,13,Connecticut,CT
09015,09CS008,929,879,979,1084,155,105,205,84,0.16705748863395797,0.6070400204473771,1.015294805105301,0.5392976514360212,1144,1084,1204,1239,95,35,155,147,-1.1553911731155408,-0.5345700619839261,0.07405137998827932,1.5301025202976006,116741,116741,Windham,Windham,9,15,Connecticut,CT
10001,10CS001,1449,1370,1528,1740,291,212,370,191,0.1061006682266138,0.5432718889359692,0.9858934079365318,0.653767517898733,1783,1688,1877,2232,449,355,544,250,0.6647556452404795,1.2950465367317567,1.9520549635694362,0.5550658335552164,182388,182388,Kent,Kent,10,1,Delaware,DE
10003,10CS002,4122,3880,4363,4893,771,530,1013,499,0.045704425848872444,0.4879620808918148,0.8996619508474212,0.6462351614226602,5082,4792,5372,5700,618,328,908,523,-0.40626916395686097,0.19473777875583295,0.8460697358007452,0.8444349380435421,560604,560604,New Castle,New Castle,10,3,Delaware,DE
10005,10CS003,2377,2273,2481,2784,407,303,511,318,-0.021324487033007385,0.3709189692471673,0.780294250999514,0.7795021633070791,2913,2788,3038,3308,395,270,520,338,-0.3066065693321522,0.2672960276552301,0.8726785154580396,0.8539109670875842,237902,237902,Sussex,Sussex,10,5,Delaware,DE
11001,11CS001,4299,3993,4606,5284,985,678,1291,831,-0.2209089459468969,0.22335066257946626,0.6438811216953921,0.8430914162624266,5308,4939,5676,5813,505,137,874,463,-0.5528614901383528,0.05446271620367178,0.701767618260852,0.9143233535042431,710154,710154,District of Columbia,District of Columbia,11,1,District of Columbia,DC
12001,12CS001,1704,1587,1820,1931,227,111,344,133,-0.07663964656466336,0.35535726789606775,0.7558846674814994,0.5827348055342212,2105,1965,2246,2440,335,194,475,290,-0.45466414502685504,0.19099980264437078,0.8356468586846975,0.864252427230446,270209,270209,Alachua,Alachua,12,1,Florida,FL
12003,12CS002,231,218,244,257,26,13,39,36,-0.7388537323434797,-0.3419452861326026,0.0920578843954727,1.3365384770373658,284,269,299,368,84,69,99,80,-0.4734029474733791,0.15903417723247026,0.7544194967605339,0.9417489724771442,29404,29404,Baker+Bradford+Union,Baker,12,3,Florida,FL
12007,12CS002,283,270,295,294,11,-1,24,20,-0.7235421332686335,-0.3026589312668576,0.13995868938491396,1.6035009342180158,346,331,360,408,62,48,77,87,-1.65149095274588,-1.016841133446947,-0.436340213151928,1.3725694050934232,28450,28450,Baker+Bradford+Union,Bradford,12,7,Florida,FL
12125,12CS002,205,198,211,259,54,48,61,58,-0.6720426698058591,-0.2604496751078224,0.17993398355138804,1.0528624217658076,249,241,257,249,-0,-8,8,27,-2.753420125139916,-2.1673456335104273,-1.4906719805400646,34.41336582083452,15200,15200,Baker+Bradford+Union,Union,12,125,Florida,FL
12005,12CS003,1553,1479,1627,1811,258,184,332,179,0.04190509703538469,0.4595072019685407,0.8928780118851715,0.6911568601970535,1902,1813,1990,2546,644,556,733,420,0.9408982829183594,1.5234321571233218,2.1704328599905374,0.6507609016363587,172823,172823,Bay,Bay,12,5,Florida,FL
12009,12CS004,6507,6246,6769,7028,521,259,782,478,-0.3617080959605902,0.06016813535124044,0.5178574172844335,0.9164453746052229,7960,7645,8274,9270,1310,996,1625,1073,-0.16956888858078759,0.4790593807906516,1.068523935943052,0.8182835132299268,604122,604122,Brevard,Brevard,12,9,Florida,FL
12011,12CS005,13024,12182,13867,15293,2269,1426,3111,1736,-0.1650974485157608,0.2938104804533965,0.760190245247327,0.7648956780644852,16048,15037,17060,18739,2691,1679,3702,2673,-0.6149262934741385,0.023398069779362308,0.633395885237548,0.9930236204857754,1956571,1956571,Broward,Broward,12,11,Florida,FL
12015,12CS006,2404,2321,2488,2695,291,207,374,245,-0.21577951049801986,0.23918208013536182,0.663505664047066,0.8393123489614872,2933,2832,3033,3342,409,309,510,388,-0.46403216474495074,0.13748069202231056,0.7498692206162489,0.9461145083085153,191770,191770,Charlotte,Charlotte,12,15,Florida,FL
12017,12CS007,2301,2236,2367,2726,425,359,490,204,1.0128127591928933,1.4518967895176156,1.8896523177200133,0.47942541765840113,2802,2723,2881,3561,759,680,838,478,1.614200742185482,2.259112086023153,2.8443682537881343,0.6286502787410364,151343,151343,Citrus,Citrus,12,17,Florida,FL
12019,12CS008,1616,1521,1711,1861,245,150,340,148,0.006144174602628464,0.44468853665111296,0.853302917079855,0.6014177031885779,1992,1877,2106,2768,776,662,891,476,0.9984614000786171,1.6476480598492307,2.267301840808206,0.6125642470447149,220162,220162,Clay,Clay,12,19,Florida,FL
12021,12CS009,3064,2895,3233,3412,348,179,517,318,-0.3272154181943587,0.08534657887414282,0.5176586127714219,0.910727174295025,3775,3572,3978,4461,686,483,889,498,-0.08734915688658179,0.5810228862861201,1.2016476897032613,0.7251144170665492,388857,388857,Collier,Collier,12,21,Florida,FL
12023,12CS010,711,680,742,813,102,71,133,96,-0.35093905594010244,0.08852331035806482,0.5292712899777302,0.9308521405444656,872,834,909,1137,265,228,303,178,0.8146720904408952,1.4503329789630295,2.0985535539650186,0.66868195770895,72136,72136,Columbia,Columbia,12,23,Florida,FL
12027,12CS011,321,304,337,374,53,37,70,55,-0.471662210126819,-0.03638174606705058,0.3984063838816051,1.0111979743829966,395,375,415,469,74,54,94,78,-0.7172398013583611,-0.11834426964287449,0.4971797785454301,1.0370213768626604,38112,38112,DeSoto+Hardee,DeSoto,12,27,Florida,FL
12049,12CS011,192,180,203,217,25,14,37,21,-0.27049568375776883,0.1718665143876055,0.6128249023768373,0.7939979387038958,236,223,250,352,116,102,129,74,1.2490344355300411,1.8427971440241027,2.4316150321646,0.6349602978657939,26813,26813,DeSoto+Hardee,Hardee,12,49,Florida,FL
12029,12CS012,196,188,203,212,16,9,24,14,-0.28896482546450475,0.13364639208323167,0.5795014676961515,0.80107050237077,238,230,247,313,75,66,83,50,1.1499117952123694,1.7674680460311623,2.345690406937588,0.661196319827205,16958,16958,Dixie+Gilchrist+Levy,Dixie,12,29,Florida,FL
12041,12CS012,181,173,189,191,10,2,18,13,-0.5473325861771836,-0.17005243843090745,0.2725593627076396,1.175818820026126,221,212,231,301,80,70,89,42,1.8419832353785732,2.4038927459160875,2.995651646523337,0.5209197223820266,18702,18702,Dixie+Gilchrist+Levy,Gilchrist,12,41,Florida,FL
12075,12CS012,486,468,504,552,66,48,84,30,0.43465181528837005,0.8618668891452832,1.2776224998125818,0.44594757495965637,592,571,614,757,165,143,186,111,0.90877340683464,1.5445596039560805,2.1413214695349296,0.6701399005060309,41868,41868,Dixie+Gilchrist+Levy,Levy,12,75,Florida,FL
12031,12CS013,7355,6939,7770,8614,1259,844,1675,709,0.17590327433970412,0.567155819365633,0.996123145165,0.5625821097897323,9062,8563,9561,11527,2465,1966,2964,1831,0.16643176681713387,0.7823169277343713,1.410715121988809,0.7424622373828581,962718,962718,Duval,Duval,12,31,Florida,FL
12033,12CS014,3012,2874,3151,3586,574,435,712,327,0.3620173692096936,0.7599271557066282,1.1917710554592622,0.5688529795771824,3700,3533,3866,4581,881,715,1048,557,0.5863167631045593,1.215577856669228,1.8415817058064998,0.6313772370542743,320623,320623,Escambia,Escambia,12,33,Florida,FL
12035,12CS015,1241,1190,1292,1360,119,68,170,53,0.09747979690336368,0.5711674450389826,1.0021575547217016,0.4421906638644307,1525,1464,1586,1844,319,258,380,221,0.38854103301965726,1.0139128654137106,1.6386910486708823,0.6905984299823871,116718,116718,Flagler,Flagler,12,35,Florida,FL
12039,12CS016,398,379,418,481,83,63,102,54,0.22053813970429298,0.6331434284164916,1.070801834504109,0.6463184440568254,489,466,513,663,174,150,197,96,1.4328244729385904,2.072442461851361,2.6879708056227534,0.5490467988347674,45506,45506,Gadsden+Leon,Gadsden,12,39,Florida,FL
12073,12CS016,1680,1553,1807,2057,377,250,504,158,0.31400529978632824,0.7505678284429274,1.1690928458820766,0.4178077486893332,2091,1938,2244,2572,481,328,634,309,0.026333027619830435,0.6984534597553477,1.3508557863377144,0.6409700772176801,294530,294530,Gadsden+Leon,Leon,12,73,Florida,FL
12043,12CS017,112,111,114,129,17,15,18,16,-0.04773316966295841,0.06151107504271419,0.16358559048778057,0.8976866064926793,138,136,140,167,29,27,31,16,0.9753304607573119,1.1237893397664296,1.2787943271855955,0.5306712500224188,14032,14032,Glades+Hendry+Okeechobee,Glades,12,43,Florida,FL
12051,12CS017,278,260,297,315,37,18,55,51,-0.7747132236277692,-0.33462026487024304,0.06589601720398543,1.3517934493494148,344,322,366,479,135,113,157,79,0.9513137790212731,1.5705143330099216,2.1881581823398357,0.580777488495705,42379,42379,Glades+Hendry+Okeechobee,Hendry,12,51,Florida,FL
12093,12CS017,405,387,424,467,62,43,80,55,-0.295721626586422,0.16272434284141737,0.581704538867924,0.8798304107839947,496,474,518,657,161,139,183,103,1.0709059279395896,1.643106740965659,2.241870070619259,0.6364738833217919,42206,42206,Glades+Hendry+Okeechobee,Okeechobee,12,93,Florida,FL
12047,12CS018,143,137,149,176,33,27,39,19,0.5723306006137963,0.9702971382091355,1.3757447336361635,0.5581079576175945,175,168,183,226,51,43,58,33,0.8509419173986981,1.4609568482286281,2.096172840214284,0.6394518092254354,14491,14491,Hamilton+Lafayette+Suwannee,Hamilton,12,47,Florida,FL
12067,12CS018,68,67,69,97,29,28,30,16,1.3993678177034536,1.506668546187846,1.6084844150536193,0.539071122720588,84,83,85,118,34,33,35,22,1.5245077962606537,1.6818634391251577,1.851551769235494,0.6314166461853221,8425,8425,Hamilton+Lafayette+Suwannee,Lafayette,12,67,Florida,FL
12121,12CS018,498,478,517,587,89,70,109,71,-0.02769694751161311,0.4112558030026444,0.8476144524787259,0.7868102751886502,610,586,633,783,173,150,197,161,-0.2874207107417807,0.33229989698117385,0.9862801928484002,0.9227550135737537,44600,44600,Hamilton+Lafayette+Suwannee,Suwannee,12,121,Florida,FL
12053,12CS019,2478,2393,2563,2676,198,113,283,203,-0.4969442352280478,-0.017653974930514942,0.37451552257975523,1.0196974753072066,3025,2922,3127,3685,660,558,763,557,-0.02143751756273428,0.6346315182496994,1.2061233636064774,0.8423185683808463,196166,196166,Hernando,Hernando,12,53,Florida,FL
12055,12CS020,1392,1346,1438,1582,190,144,236,185,-0.37325126488508675,0.030816066407863107,0.4725777692122896,0.9686890535490282,1700,1645,1755,2129,429,374,484,284,1.0089103291755475,1.6280596198144581,2.2707157376164684,0.6605588643828274,106202,106202,Highlands,Highlands,12,55,Florida,FL
12057,12CS021,9519,8875,10163,10901,1382,738,2026,945,-0.14457067933513287,0.28924173208350556,0.7196653606677729,0.68334612312484,11752,10978,12526,14306,2554,1780,3328,1769,0.01502469043125488,0.6314249460254558,1.2652312884292851,0.6923470392920639,1485400,1485400,Hillsborough,Hillsborough,12,57,Florida,FL
12059,12CS022,238,230,247,286,48,39,56,28,0.5819061682303559,1.006615420614866,1.431326071080066,0.5730931173459588,292,281,302,362,70,60,81,47,0.8513013322889437,1.4219867943183941,2.0456560595132727,0.6575830237898824,19633,19633,Holmes+Walton,Holmes,12,59,Florida,FL
12131,12CS022,638,606,671,665,27,-6,59,49,-0.706992221868117,-0.31063467398983785,0.13604794603034603,1.7765778388282527,791,752,831,891,100,60,139,127,-1.0540411165181724,-0.4153370221559818,0.20970192394598947,1.258729630591875,75177,75177,Holmes+Walton,Walton,12,131,Florida,FL
12061,12CS023,1840,1771,1910,2023,183,113,252,141,-0.15745146419831846,0.2435022661501823,0.6886851129940113,0.767984861424821,2249,2165,2333,2717,468,384,552,358,0.1971630035425935,0.8131218030631513,1.4264916855215564,0.763899683276498,160897,160897,Indian River,Indian River,12,61,Florida,FL
12063,12CS024,527,507,547,666,139,119,159,102,0.4070070152990068,0.8131926332499126,1.25477089460451,0.7270021112704994,647,623,670,761,114,91,138,99,-0.175476472970069,0.41822176490839097,1.0121782608586096,0.8581757117399524,46185,46185,Jackson+Washington,Jackson,12,63,Florida,FL
12133,12CS024,300,289,311,299,-1,-12,10,22,-1.3344781872800315,-0.9074651907438069,-0.45602154871567796,82.50250316942066,368,355,382,417,49,35,62,62,-1.2652857090241383,-0.6210406947238428,0.007777468115313095,1.2486261653107331,25766,25766,Jackson+Washington,Washington,12,133,Florida,FL
12065,12CS025,154,148,160,184,30,24,36,13,0.7734325865550623,1.1968356360414594,1.6129732421182765,0.41900148505954693,188,180,195,225,37,30,45,32,-0.18984928004455343,0.4106905971350049,1.0203433700874214,0.8397111480652678,14390,14390,Jefferson+Madison+Taylor,Jefferson,12,65,Florida,FL
12079,12CS025,200,192,208,273,73,65,81,38,1.4459301888869447,1.9058882808997042,2.335408773190851,0.5113843073348191,243,234,253,303,60,50,69,51,-0.1082128592693948,0.5579905862924274,1.1567139300682185,0.8415677455968438,18644,18644,Jefferson+Madison+Taylor,Madison,12,79,Florida,FL
12123,12CS025,219,210,228,284,65,56,74,31,1.1380145536360395,1.5804811541803367,2.0280866580985957,0.46917731031501714,267,256,278,330,63,52,74,49,0.18170604773577848,0.8055257832675105,1.3848012794441493,0.7655400019298454,21563,21563,Jefferson+Madison+Taylor,Taylor,12,123,Florida,FL
12069,12CS026,3914,3752,4075,4366,452,291,614,292,-0.00603727621256216,0.4233600727836483,0.8883638266422174,0.6439250120452633,4791,4597,4985,5749,958,764,1152,778,-0.05058353078153987,0.5545010092880489,1.213395693552589,0.8111760822942411,370504,370504,Lake,Lake,12,69,Florida,FL
12071,12CS027,6538,6198,6877,7250,712,373,1052,599,-0.27153950225271084,0.1442412451775602,0.5964982432118705,0.839708697586283,8034,7625,8442,9402,1368,960,1777,1019,-0.09350575723342759,0.5386789342041474,1.169449261508139,0.7441436562248139,779976,779976,Lee,Lee,12,71,Florida,FL
12013,12CS028,153,147,159,180,27,21,33,20,0.08505931724532889,0.48802983433245056,0.9205392448191134,0.7190381734853172,188,181,196,239,51,43,58,42,0.14914449089044282,0.753118785072333,1.3641002317230844,0.8120535699535492,14114,14114,Liberty and Nearby Counties,Calhoun,12,13,Florida,FL
12037,12CS028,136,130,141,143,7,2,13,5,-0.2337552291049821,0.21696798608456977,0.6319781795854259,0.5887331833529087,167,160,173,205,38,32,45,38,-0.5647785824981717,0.04487421566144547,0.6266782325333733,0.9652276365341659,12150,12150,Liberty and Nearby Counties,Franklin,12,37,Florida,FL
12045,12CS028,148,142,154,197,49,43,55,22,1.5756279009645708,1.9973739001736428,2.4626179501693786,0.4391139747027045,182,175,189,242,60,53,67,32,1.8873810669077,2.5096938042404906,3.0917852774184835,0.5234769146225622,13513,13513,Liberty and Nearby Counties,Gulf,12,45,Florida,FL
12077,12CS028,62,61,63,78,16,15,17,15,0.014735484243279697,0.10808017037645283,0.20826510727042383,0.8873695934177804,77,76,78,117,40,39,41,17,3.181585836416014,3.332939590088955,3.4924474064902453,0.4126128010454783,8351,8351,Liberty and Nearby Counties,Liberty,12,77,Florida,FL
12129,12CS028,265,250,279,321,56,42,71,30,0.33568599813339284,0.771699123169333,1.1999334507981743,0.5238850507879738,329,312,347,414,85,67,102,60,0.28981565121282393,0.9016800264870372,1.5041339859801175,0.6997868580789776,33921,33921,Liberty and Nearby Counties,Wakulla,12,129,Florida,FL
12081,12CS029,3701,3524,3877,4106,405,229,582,379,-0.3751509174310484,0.06443044320339475,0.4690958998707236,0.9325166274539337,4540,4328,4752,5298,758,546,970,694,-0.35686785315855324,0.19802639234544067,0.8168863643160963,0.914311704430595,406411,406411,Manatee,Manatee,12,81,Florida,FL
12083,12CS030,4565,4405,4725,5251,686,526,846,441,0.24004020851835314,0.664848959307334,1.0938265274308703,0.6418618235462122,5578,5386,5771,7065,1487,1294,1679,1110,0.6155863080299597,1.2455792315811796,1.8496648161087488,0.7461908531686272,369129,369129,Marion,Marion,12,83,Florida,FL
12085,12CS031,1677,1607,1747,1995,318,248,388,167,0.487591719030936,0.9262886567026176,1.3873210815911663,0.5236285596702855,2049,1965,2132,2464,415,332,499,225,0.8175247015542151,1.4183685805788462,2.0417415360737636,0.5403409213969957,161577,161577,Martin,Martin,12,85,Florida,FL
12086,12CS032,17135,15970,18300,22009,4874,3709,6039,3655,0.03673093691952436,0.46212141656879474,0.8473456159654014,0.7498031012661966,21139,19741,22538,26064,4925,3526,6323,4101,-0.28111998593697357,0.38807704229204243,0.9837922074890517,0.8325997300311135,2709817,2709817,Miami-Dade,Miami-Dade,12,86,Florida,FL
12087,12CS033,594,563,626,662,68,36,99,40,-0.046351075588276475,0.3900370350045806,0.8104404363957726,0.582543927757993,726,688,765,853,127,88,165,56,0.5073899775900883,1.159100924497311,1.7272002962507076,0.43882439047423705,73898,73898,Monroe,Monroe,12,87,Florida,FL
12089,12CS034,829,790,868,901,72,33,111,67,-0.4112984756630379,0.0427459542802166,0.47188713018981354,0.9219055562567616,1018,971,1065,1208,190,143,237,169,-0.3504209181213146,0.28509030212515535,0.9075442555199643,0.8851520344119067,89637,89637,Nassau,Nassau,12,89,Florida,FL
12091,12CS035,1624,1533,1716,1896,272,180,363,200,-0.09165029346441177,0.3588303277813493,0.7650998432253395,0.7332481348152636,1996,1886,2106,2359,363,253,473,305,-0.25476411933547555,0.30235140042156655,0.9993801294983855,0.837488523611863,211998,211998,Okaloosa,Okaloosa,12,91,Florida,FL
12095,12CS036,7249,6645,7853,8379,1130,526,1734,745,-0.17604060597956758,0.26989421946664627,0.7158302540010436,0.6586364816265394,9010,8284,9735,10765,1755,1030,2481,1451,-0.39067649900370716,0.24546881776801488,0.8980819189940492,0.8261082073556466,1399131,1399131,Orange,Orange,12,95,Florida,FL
12097,12CS037,2179,2014,2344,2531,352,187,517,276,-0.25286820244254626,0.18977764465148023,0.6486939952525962,0.7818343356064157,2709,2510,2908,3532,823,624,1022,605,-0.01407813429138906,0.6834709868427274,1.2996918994351843,0.7342036036006225,378814,378814,Osceola,Osceola,12,97,Florida,FL
12099,12CS038,12760,12111,13408,14606,1846,1198,2495,1572,-0.23889374267136487,0.17904026559434702,0.6086878026084651,0.8509543980907365,15635,14856,16414,17795,2160,1381,2939,1994,-0.4825027024477145,0.13236598425563773,0.7075309136034719,0.9227542246086639,1501883,1501883,Palm Beach,Palm Beach,12,99,Florida,FL
12101,12CS039,5695,5450,5940,6147,452,207,697,352,-0.25542988404352474,0.17342760857320388,0.6010220055730348,0.7766513364451512,6977,6683,7272,8129,1152,857,1446,1049,-0.4201557692326343,0.22918518402375976,0.8208724678062117,0.9099226722741595,560857,560857,Pasco,Pasco,12,101,Florida,FL
12103,12CS040,10241,9821,10662,11173,932,511,1352,747,-0.2507734387240409,0.19814305737094615,0.6442104516486162,0.8010577388747188,12516,12011,13020,13920,1404,900,1909,1235,-0.39323234143862984,0.1915554719933074,0.8032527340374944,0.878859868307131,975965,975965,Pinellas,Pinellas,12,103,Florida,FL
12105,12CS041,6373,6054,6693,7210,837,517,1156,718,-0.253816781233297,0.16875985875832641,0.6378551974538964,0.8571191548866629,7827,7443,8212,9799,1972,1587,2356,1555,0.10332913890680945,0.6584608800358267,1.2754369619225445,0.7881966450255494,733127,733127,Polk,Polk,12,105,Florida,FL
12107,12CS042,868,836,900,994,126,94,158,71,0.26524938589507635,0.7326529319510292,1.1580206348706543,0.559710174037139,1061,1022,1099,1488,427,389,466,265,1.9761596863872268,2.6168919652506593,3.216713647933589,0.618552921990764,74520,74520,Putnam,Putnam,12,107,Florida,FL
12109,12CS043,1917,1798,2037,1984,67,-53,186,101,-0.5550972585676378,-0.13782652001983314,0.3199431800260046,1.4912048632831139,2368,2224,2512,2676,308,164,452,300,-0.580034577680355,0.03623620821925376,0.6890144620475858,0.9706312946189455,270754,270754,St. Johns,St. Johns,12,109,Florida,FL
12111,12CS044,2985,2840,3129,3405,420,276,565,362,-0.2581504636302207,0.1662687006114847,0.605681064553945,0.8593619566353807,3666,3492,3840,4438,772,598,946,522,0.27747464188303117,0.8765122124419041,1.5182738564147291,0.6752486964258375,331864,331864,St. Lucie,St. Lucie,12,111,Florida,FL
12113,12CS045,1421,1340,1502,1572,151,70,232,130,-0.310365868539364,0.10656545321663037,0.5502868135359013,0.8565252350052118,1758,1660,1856,2093,335,237,433,332,-0.6334717302541645,0.01118357364590048,0.5908201656572198,0.9880222778635539,186484,186484,Santa Rosa,Santa Rosa,12,113,Florida,FL
12115,12CS046,5098,4907,5288,5783,685,495,876,387,0.24913323864575487,0.6773313662757593,1.124268876872713,0.5638798992995762,6228,5999,6457,7117,889,660,1118,682,-0.06877098781285665,0.5623770245533743,1.1475230536011516,0.7664585686134979,438531,438531,Sarasota,Sarasota,12,115,Florida,FL
12117,12CS047,3051,2847,3255,3358,307,103,511,248,-0.2983112818055138,0.12460152736419074,0.5315608381051007,0.8052730108862276,3766,3521,4011,4398,632,387,877,530,-0.37758006975737723,0.2811511337240566,0.8654115505034001,0.8369277349467795,472783,472783,Seminole,Seminole,12,117,Florida,FL
12119,12CS048,1789,1729,1849,2017,228,168,288,117,0.3816081979198018,0.8038052796976138,1.2349142111186684,0.510911322035368,2190,2118,2262,2742,552,480,624,320,1.4225282621668507,2.061368997702305,2.6436474372278713,0.5787526577222353,135958,135958,Sumter,Sumter,12,119,Florida,FL
12127,12CS049,6349,6108,6590,6918,569,328,810,402,-0.13221075683741312,0.3040429256714396,0.7354698875665853,0.7053940622092901,7755,7465,8045,9311,1556,1266,1846,1137,0.29370897498402754,0.9090907307040175,1.573242580741768,0.7302345970529576,557162,557162,Volusia,Volusia,12,127,Florida,FL
13001,13CS001,176,168,184,232,56,48,64,48,0.04801835251474033,0.4422220317114689,0.9256606567708617,0.8367004794340723,214,205,224,269,55,45,64,58,-0.8022369551714815,-0.22618617299026791,0.4254586516366492,1.0382930920433637,18362,18362,Appling+Jeff Davis+Long+Wayne,Appling,13,1,Georgia,GA
13161,13CS001,150,143,156,186,36,30,43,26,0.26149181880737926,0.6923123933874822,1.109276801136451,0.6939575448712639,182,175,190,214,32,24,39,35,-0.8664760531028066,-0.27320720564461176,0.37528403983151537,1.074018439889125,15148,15148,Appling+Jeff Davis+Long+Wayne,Jeff Davis,13,161,Georgia,GA
13183,13CS001,94,92,96,105,11,9,13,4,0.258926945375299,0.35934768056869043,0.46370100502552497,0.32771974375715307,115,113,118,149,34,31,36,29,0.12582466766220973,0.2779483738887788,0.4416043546880432,0.8384220626622716,19865,19865,Appling+Jeff Davis+Long+Wayne,Long,13,183,Georgia,GA
13305,13CS001,298,285,311,336,38,25,51,40,-0.5006134556925341,-0.05477925644580563,0.3726675473669176,1.0153061310977713,363,347,378,511,148,133,164,103,1.1598969109406307,1.8075024046357473,2.4586826227479963,0.6902179011209868,30020,30020,Appling+Jeff Davis+Long+Wayne,Wayne,13,305,Georgia,GA
13005,13CS002,126,121,131,146,20,15,25,25,-0.9126435359670909,-0.4852864738979949,-0.04835294316051125,1.1987771788245298,154,148,160,185,31,25,37,40,-1.5557861968368476,-0.9679854051001926,-0.3436773308523266,1.2477890316608589,11072,11072,Bacon+Ben Hill+Coffee+Irwin,Bacon,13,5,Georgia,GA
13017,13CS002,190,182,197,267,77,70,85,50,1.2026523852902686,1.6465778047831716,2.051343567715602,0.6381387534630896,231,223,240,286,55,46,63,39,0.5234193822846239,1.1229564033247201,1.7240753937362734,0.701938925230469,16671,16671,Bacon+Ben Hill+Coffee+Irwin,Ben Hill,13,17,Georgia,GA
13069,13CS002,363,344,381,479,116,98,135,94,0.10462179079723209,0.5113213490869091,0.9299068450108876,0.8010413376812581,445,423,468,549,104,81,126,113,-0.9121476174286184,-0.2531360619462583,0.35762934754981857,1.0810729133902193,43253,43253,Bacon+Ben Hill+Coffee+Irwin,Coffee,13,69,Georgia,GA
13155,13CS002,98,97,99,121,23,22,24,18,0.4698112324724488,0.5780621875911354,0.6821496859856652,0.7363727637926045,120,118,121,154,34,33,36,27,0.7716181649211946,0.9264246557413041,1.0892627214298685,0.7641078092977032,9419,9419,Bacon+Ben Hill+Coffee+Irwin,Irwin,13,155,Georgia,GA
13011,13CS003,162,153,170,168,6,-2,15,18,-1.0493885035816561,-0.6205499469631055,-0.16536626744551813,2.4686802748526078,198,188,208,268,70,60,80,41,1.2121297021536697,1.805614034457074,2.4158674862296445,0.5799496509371698,19249,19249,Banks+Habersham,Banks,13,11,Georgia,GA
13137,13CS003,408,388,428,508,100,80,120,74,0.13263971646965592,0.5682017164605998,0.9612634350231508,0.7319739177962584,500,476,523,603,103,80,127,94,-0.4043853716916009,0.23282018519482545,0.8646066992893181,0.9012759887486405,45752,45752,Banks+Habersham,Habersham,13,137,Georgia,GA
13013,13CS004,574,537,611,619,45,8,82,55,-0.5512077848532938,-0.11378329166130424,0.33012733720463494,1.1963793788246648,710,666,754,887,177,133,221,114,0.2623161496217691,0.8787467437299652,1.5046396329881742,0.6411089240234444,84417,84417,Barrow,Barrow,13,13,Georgia,GA
13015,13CS005,816,768,863,1038,222,175,270,119,0.533996413214361,0.9546974584833621,1.4042627586448249,0.5324575334893552,1007,951,1064,1334,327,270,383,182,0.9802053616737729,1.630070390665849,2.2189949065590735,0.5557090651164251,108452,108452,Bartow,Bartow,13,15,Georgia,GA
13021,13CS006,1461,1395,1527,1827,366,300,432,199,0.6675055722463237,1.0858815713607852,1.5466257971582378,0.5425306795945987,1789,1711,1868,2309,520,441,598,332,0.8866102594688872,1.4910298999000668,2.0907379410222653,0.6377378694045857,153002,153002,Bibb,Bibb,13,21,Georgia,GA
13023,13CS007,137,132,143,175,38,32,43,30,0.17502631807529873,0.6019187716312707,1.0295254499510818,0.774399845941211,168,161,174,197,29,23,36,43,-1.8568031219698482,-1.2594015703605577,-0.6347190199992759,1.4142762879134108,12936,12936,Bleckley+Dodge+Pulaski+Twiggs,Bleckley,13,23,Georgia,GA
13091,13CS007,192,183,201,289,97,88,106,67,1.0410141086854785,1.4733308071032334,1.8821817964197674,0.6822579057925788,234,224,245,319,85,74,95,64,0.5821065555997661,1.1977743480072147,1.805018506778955,0.7480313386292368,20580,20580,Bleckley+Dodge+Pulaski+Twiggs,Dodge,13,91,Georgia,GA
13235,13CS007,100,98,101,111,11,10,13,22,-1.0474671058815135,-0.9556409356886932,-0.8494805389265488,1.7802139252544082,122,120,123,172,50,49,52,34,1.5706205897054684,1.739179923240662,1.8978460050763881,0.6644187952348669,11174,11174,Bleckley+Dodge+Pulaski+Twiggs,Pulaski,13,235,Georgia,GA
13289,13CS007,94,93,95,131,37,36,38,19,2.0769033085385007,2.1797403540786835,2.2841336664599274,0.503234223300028,115,114,116,161,46,45,47,26,2.781432765397646,2.9314243345299014,3.0822764090707944,0.5542619967660871,8139,8139,Bleckley+Dodge+Pulaski+Twiggs,Twiggs,13,289,Georgia,GA
13025,13CS008,180,172,188,207,27,19,35,29,-0.5153243695385105,-0.0984957162833815,0.345916495910048,1.0293679616438496,222,212,232,294,72,62,82,67,-0.28587918406007934,0.31155997748045544,0.9445279945299974,0.9165301628675526,19156,19156,Brantley+Pierce+Ware,Brantley,13,25,Georgia,GA
13229,13CS008,190,182,199,252,62,53,70,37,0.8392527614352135,1.279272112819978,1.6909695755617904,0.5908185369579899,235,225,245,346,111,101,121,78,1.414569903045891,2.067818018713111,2.7029805725043343,0.6943201573442769,19476,19476,Brantley+Pierce+Ware,Pierce,13,229,Georgia,GA
13299,13CS008,407,391,422,505,98,83,114,72,0.3102802096501043,0.7279608019570686,1.1816768708807242,0.7255857435822525,499,481,518,650,151,132,169,144,-0.3927049928699208,0.213650302981395,0.873702782539007,0.9497849104607012,35820,35820,Brantley+Pierce+Ware,Ware,13,299,Georgia,GA
13027,13CS009,175,168,181,200,25,19,32,28,-0.6256532512014112,-0.17697535143805493,0.2171464095171222,1.0609008872071177,214,206,222,230,16,8,24,35,-2.1726427000108846,-1.4789533346448773,-0.8108065619341893,2.081863967142656,15451,15451,Brooks+Thomas,Brooks,13,27,Georgia,GA
13275,13CS009,460,441,479,539,79,60,98,76,-0.3952948909872185,0.060061700612997704,0.47435000645178077,0.953077436353268,566,543,589,691,125,102,148,85,0.4874131254906437,1.0779653750515175,1.6755778147634774,0.6759622823400236,44404,44404,Brooks+Thomas,Thomas,13,275,Georgia,GA
13029,13CS010,258,240,275,295,37,20,55,19,0.00906106789502145,0.4496656724334538,0.8782093949982832,0.49745021676410883,318,297,339,368,50,29,71,54,-0.7301680627949364,-0.14277901400882217,0.49403443676840086,1.0590861262327689,40135,40135,Bryan+Liberty,Bryan,13,29,Georgia,GA
13179,13CS010,323,296,350,384,61,34,88,35,-0.023986965483197738,0.4189810898022757,0.8148325623232299,0.565583854772313,400,368,433,599,199,166,231,102,1.2406498194328368,1.85771991447708,2.460713528562842,0.5103312485801816,62893,62893,Bryan+Liberty,Liberty,13,179,Georgia,GA
13031,13CS011,482,448,517,559,77,42,111,53,-0.11952342953633965,0.2826226593816188,0.7342375208134482,0.6836918152606747,596,554,638,748,152,110,194,146,-0.5595278100054949,0.09596599369235928,0.7297158728381815,0.9532153624139393,80185,80185,Bulloch,Bulloch,13,31,Georgia,GA
13033,13CS012,208,198,218,248,40,30,50,25,0.20678364585171213,0.6836908800496347,1.105826760529008,0.6078542963934179,256,244,268,286,30,18,42,52,-1.7705399478205988,-1.1844550515013383,-0.5261713772955765,1.6788014126411523,22560,22560,Burke+Emanuel+Jenkins+Screven,Burke,13,33,Georgia,GA
13107,13CS012,253,243,263,304,51,41,61,47,-0.2424427774182237,0.18744651975784712,0.603462416518614,0.9053043945425383,310,298,322,407,97,85,109,82,0.16743875260772365,0.7994775720470025,1.4666391013961835,0.8366584656196259,22561,22561,Burke+Emanuel+Jenkins+Screven,Emanuel,13,107,Georgia,GA
13165,13CS012,87,86,88,110,23,22,24,26,-0.4195412935301996,-0.30326703124965726,-0.20334177967374203,1.0691060688498613,106,105,108,133,27,25,28,20,0.7372952468449105,0.9030777334859349,1.056410806164441,0.7246382456561574,8739,8739,Burke+Emanuel+Jenkins+Screven,Jenkins,13,165,Georgia,GA
13251,13CS012,153,147,159,181,28,22,34,17,0.3547305876720991,0.7599778320764466,1.1677267886395937,0.5900623584403827,188,181,195,251,63,56,70,43,1.082836141491144,1.7232200425853168,2.3549067767543037,0.6706685893695297,13973,13973,Burke+Emanuel+Jenkins+Screven,Screven,13,251,Georgia,GA
13035,13CS013,241,230,252,290,49,38,60,41,-0.08715786327124964,0.3264758149553273,0.7729207441055194,0.8132528253047703,294,281,307,360,66,53,79,55,-0.17312505675386816,0.49237511094780884,1.178706333026072,0.8247577641206791,25129,25129,Butts+Lamar+Monroe,Butts,13,35,Georgia,GA
13171,13CS013,186,178,194,236,50,42,58,28,0.7328152803576059,1.1513806718574848,1.5936216410204915,0.5480495966891719,227,217,237,306,79,69,89,55,0.8905074881662483,1.4874515695966024,2.1546694039324468,0.6894432978785553,19109,19109,Butts+Lamar+Monroe,Lamar,13,171,Georgia,GA
13207,13CS013,246,234,258,303,57,45,69,43,0.09623118246730925,0.5049654371162094,0.9032112495773144,0.7404387307950951,301,287,316,372,71,56,85,65,-0.37376836267569946,0.2567799450763631,0.8724435647978404,0.9038366011143413,27829,27829,Butts+Lamar+Monroe,Monroe,13,207,Georgia,GA
13007,13CS014,29,29,30,38,9,8,9,5,1.1542402912925143,1.2594553853195258,1.3601808668061688,0.510088158278513,36,36,37,45,9,8,9,3,2.079714256296766,2.2269363206093074,2.392196436785995,0.31234687740241485,3015,3015,Calhoun and Nearby Counties,Baker,13,7,Georgia,GA
13037,13CS014,57,56,57,70,13,13,14,2,1.703030515835768,1.8108202748738418,1.9245585481669962,0.1405518665390521,71,70,72,67,-4,-5,-3,2,-1.2940416923219071,-1.1322172846837208,-0.985034182664666,-0.6982257534936328,6204,6204,Calhoun and Nearby Counties,Calhoun,13,37,Georgia,GA
13061,13CS014,36,35,38,37,1,-1,2,5,-1.948327844891923,-1.5237582066205106,-1.0832219511578525,3.125346000583497,45,43,46,57,12,11,14,2,3.725056565943339,4.361187598339099,4.960956179233895,0.1486930444108134,2886,2886,Calhoun and Nearby Counties,Clay,13,61,Georgia,GA
13099,13CS014,133,128,137,172,39,35,44,35,0.008593674441245001,0.40898841545851305,0.869884288374284,0.8681840368883154,162,157,167,194,32,27,37,23,0.3996204860184429,1.0285668800738843,1.6698706517153092,0.7020539925092555,10118,10118,Calhoun and Nearby Counties,Early,13,99,Georgia,GA
13177,13CS014,206,193,219,267,61,48,74,32,0.5461652840861491,0.9478937775591478,1.3900556575834366,0.518690496415064,257,242,273,310,53,37,68,43,-0.22167940821588245,0.39233350712014875,0.9944188727293071,0.8014569750077716,30124,30124,Calhoun and Nearby Counties,Lee,13,177,Georgia,GA
13201,13CS014,77,77,78,95,18,17,18,3,2.4678294257557143,2.570514464657627,2.6785786891631296,0.16203183359992568,96,95,97,128,32,31,33,20,2.416028676734062,2.568048659407505,2.7229467106949654,0.6041909542673403,5648,5648,Calhoun and Nearby Counties,Miller,13,201,Georgia,GA
13239,13CS014,29,28,30,33,4,3,5,5,-0.8258921106563768,-0.37762925349065846,0.05545354690504956,0.9698624337082982,35,34,36,51,16,15,17,5,5.018051481461255,5.597257439700585,6.191906131282234,0.2994140235161031,2288,2288,Calhoun and Nearby Counties,Quitman,13,239,Georgia,GA
13243,13CS014,78,77,79,104,26,25,27,25,0.05782450079202795,0.16664999366786998,0.2703566927095131,0.9214167643436652,97,96,98,115,18,17,19,6,2.0281643747049554,2.187884595605745,2.3365624605424555,0.31066738942804295,6754,6754,Calhoun and Nearby Counties,Randolph,13,243,Georgia,GA
13273,13CS014,98,97,99,136,38,37,39,31,0.7066548359324429,0.8056210837705101,0.9133071211491837,0.796938642571685,122,121,123,135,13,12,14,15,-0.42093132032558456,-0.25575557081875416,-0.088538902898978325,1.05800985269181,8552,8552,Calhoun and Nearby Counties,Terrell,13,273,Georgia,GA
13039,13CS015,333,309,357,357,24,0,48,22,-0.4072527699143316,0.03919557106778966,0.4928375586316883,0.8709912955870567,415,386,443,529,114,86,143,82,0.11818577226518692,0.7056636283952029,1.322707291195769,0.7109245331942113,55036,55036,Camden+Charlton,Camden,13,39,Georgia,GA
13049,13CS015,101,99,102,141,40,39,42,17,1.6459679836552632,1.7486547908238674,1.8509486662593861,0.4112890714015,124,122,126,178,54,52,56,45,0.6460520741203507,0.7973566075955478,0.9497401754912436,0.8198595769306293,13341,13341,Camden+Charlton,Charlton,13,49,Georgia,GA
13043,13CS016,133,128,138,174,41,36,46,35,0.1327570557099662,0.5423421851341012,0.9686008849729799,0.8328176395559949,161,155,167,232,71,65,77,42,2.557949042892451,3.1762528807414268,3.7680430578649142,0.5832078038954641,10898,10898,Candler+Evans+Tattnall+Toombs,Candler,13,43,Georgia,GA
13109,13CS016,98,96,99,126,28,27,30,11,1.5292905804956491,1.637689664139684,1.7405991938013092,0.373715197547969,119,118,120,179,60,59,61,33,2.900410026721172,3.0470328449916284,3.20390169184794,0.5403988482982541,10651,10651,Candler+Evans+Tattnall+Toombs,Evans,13,109,Georgia,GA
13267,13CS016,206,196,217,242,36,25,46,34,-0.37870617675513607,0.05754469163763321,0.4742467048713491,0.9314524335220093,251,238,264,346,95,82,108,74,0.38871910720668057,1.0044236364581869,1.6220325566976745,0.7682634336448851,25337,25337,Candler+Evans+Tattnall+Toombs,Tattnall,13,267,Georgia,GA
13279,13CS016,261,250,273,364,103,91,114,47,1.665197109246793,2.080942651225345,2.484855837362362,0.4530444069145915,317,303,331,455,138,124,152,96,1.2666238640759528,1.9054677644338163,2.5023841672132403,0.688953448137085,26898,26898,Candler+Evans+Tattnall+Toombs,Toombs,13,279,Georgia,GA
13045,13CS017,969,917,1022,1159,190,137,242,126,0.11529652137634712,0.5246734366090504,0.9521013144084309,0.6609730340170644,1191,1129,1254,1487,296,233,358,207,0.2958672444532566,0.8950067149382879,1.5029870170607575,0.6979651076399601,120748,120748,Carroll+Heard,Carroll,13,45,Georgia,GA
13149,13CS017,114,113,116,135,21,19,22,4,1.2948098527058856,1.399341120327888,1.5088108717585804,0.1849102831693307,140,139,142,178,38,36,39,28,0.8447113056005104,1.0049331499316194,1.1580181498889497,0.7194676291290715,11887,11887,Carroll+Heard,Heard,13,149,Georgia,GA
13047,13CS018,569,539,598,645,76,47,106,60,-0.20927992360903552,0.2379857002143314,0.6694296340535932,0.77477629494089,696,661,731,898,202,167,237,151,0.27844621066301756,0.8987531334260014,1.5088805794680533,0.7437721971955273,67756,67756,Catoosa,Catoosa,13,47,Georgia,GA
13051,13CS019,2097,1972,2221,2425,328,204,453,193,0.030558245790205545,0.4668721171457265,0.8914470332210342,0.586322389955753,2581,2432,2731,3192,611,461,760,396,0.272488415041467,0.8973406320725278,1.4902524630390426,0.6474817183843505,289884,289884,Chatham,Chatham,13,51,Georgia,GA
13055,13CS020,276,265,286,336,60,50,71,36,0.540781419996147,0.9719722474160534,1.4369574880583709,0.585553156927295,335,323,348,380,45,32,57,48,-0.8146582003298114,-0.1752617914920719,0.46189149622338127,1.0545812574598037,24845,24845,Chattooga+Dade+Walker,Chattooga,13,55,Georgia,GA
13083,13CS020,161,154,168,207,46,39,53,2,2.324302827903653,2.7194648815466174,3.1707399946211856,0.04267995058982459,196,188,205,245,49,40,57,31,0.7084639185138544,1.3202023139789003,1.9343497150091464,0.625809412704025,16084,16084,Chattooga+Dade+Walker,Dade,13,83,Georgia,GA
13295,13CS020,726,695,756,830,104,74,135,63,0.17969122656936173,0.5807271105066989,1.0006275511675955,0.5974041991218325,885,849,921,996,111,75,147,156,-1.349968256528577,-0.7681072307406549,-0.16722085039113624,1.389729615466722,69914,69914,Chattooga+Dade+Walker,Walker,13,295,Georgia,GA
13057,13CS021,1431,1317,1545,1630,199,85,313,116,-0.09234773499148878,0.32310771662748033,0.7536337819997718,0.580038155464428,1777,1640,1914,2235,458,321,595,260,0.27148607521726814,0.8887288449150905,1.5811084207986759,0.566942646376644,261891,261891,Cherokee+Pickens,Cherokee,13,57,Georgia,GA
13227,13CS021,300,286,315,334,34,19,48,23,-0.08908571339551345,0.3226271152120038,0.7114128713403153,0.666116765700399,368,351,385,468,100,83,117,86,-0.12478315315836729,0.49658811845785794,1.1352431021863227,0.8524936790498848,32848,32848,Cherokee+Pickens,Pickens,13,227,Georgia,GA
13059,13CS022,677,622,732,698,21,-34,76,50,-0.6420724117739304,-0.21893630195620692,0.18064506666688532,2.268533668597339,846,780,912,961,115,49,181,86,-0.3468839256586149,0.26285467164388043,0.8596568911389231,0.7391896519951144,128053,128053,Clarke+Madison+Oconee,Clarke,13,59,Georgia,GA
13195,13CS022,262,249,275,282,20,7,33,26,-0.6318265754769681,-0.20232440836467938,0.27012996366084274,1.222106331447775,323,307,338,399,76,61,92,50,0.4254172103112306,1.0569119999035423,1.695159790790923,0.6454630964573581,30147,30147,Clarke+Madison+Oconee,Madison,13,195,Georgia,GA
13219,13CS022,244,226,262,292,48,30,66,27,0.1063544563400491,0.5319331995791148,0.9490781176304974,0.5511286912684534,304,283,325,350,46,25,67,29,-0.11648984500801246,0.5004521330347206,1.110848401128654,0.6185873949178811,40641,40641,Clarke+Madison+Oconee,Oconee,13,219,Georgia,GA
13063,13CS023,1515,1390,1641,1920,405,279,530,204,0.25751349284049974,0.6926129413133041,1.1139230134724494,0.5030240608224033,1884,1733,2035,2613,729,578,880,432,0.6019444657458469,1.2312519127491928,1.8539795417962301,0.5915252902471259,292505,292505,Clayton,Clayton,13,63,Georgia,GA
13067,13CS024,3827,3499,4155,4574,747,419,1075,451,-0.01878180385842824,0.3835597868124965,0.8399637151001561,0.6032030131529998,4764,4369,5158,5622,858,464,1253,629,-0.22676980243401473,0.3749212379804259,0.9664387484252106,0.7318257476830513,761845,761845,Cobb,Cobb,13,67,Georgia,GA
13071,13CS025,421,401,440,525,104,85,124,55,0.6170595743045696,1.07426024687071,1.4982084436935854,0.522755882598704,517,494,541,640,123,99,146,108,-0.22183349195323915,0.38393924593970613,1.0078496003304358,0.8730444423298256,45558,45558,Colquitt+Mitchell,Colquitt,13,71,Georgia,GA
13205,13CS025,220,210,229,288,68,59,78,50,0.4189175630344746,0.8365473649147254,1.2489305378234654,0.7220848396308034,269,258,280,287,18,7,29,35,-1.5786964634229204,-0.9512671052696697,-0.3255893072684486,1.873991606463257,21744,21744,Colquitt+Mitchell,Mitchell,13,205,Georgia,GA
13073,13CS026,861,792,930,1012,151,82,220,101,-0.12280143258480578,0.31550906286048497,0.7429999634487101,0.6647028728560226,1072,990,1155,1352,280,197,362,175,0.15944051765706324,0.7845712093609505,1.475339214035277,0.623615647465173,158482,158482,Columbia,Columbia,13,73,Georgia,GA
13077,13CS027,944,879,1009,1100,156,91,221,95,-0.02081807070860997,0.4197814601284099,0.8076895551560971,0.6054489079188291,1168,1090,1246,1574,406,328,484,247,0.6670184879499217,1.2719459417321324,1.865565361590432,0.6070286307734436,149481,149481,Coweta,Coweta,13,77,Georgia,GA
13079,13CS028,131,126,136,140,9,4,14,5,-0.1496275313757429,0.32311742427201556,0.7516661363860817,0.5050426577203336,161,154,167,213,52,46,59,30,1.5377566299793293,2.1784272724509557,2.769279896032619,0.562932604638431,12298,12298,Crawford+Peach+Pike+Upson,Crawford,13,79,Georgia,GA
13225,13CS028,274,262,286,319,45,33,57,36,-0.121116746689159,0.3026145392984198,0.7270761357764004,0.7898885450992397,338,323,352,407,69,55,84,68,-0.5866484252031677,0.0627653853427649,0.6823912890695883,0.9657712686730723,27802,27802,Crawford+Peach+Pike+Upson,Peach,13,225,Georgia,GA
13231,13CS028,175,166,183,190,15,7,24,32,-1.3706533479809149,-0.8702894829378146,-0.46153533590361573,1.9611063450147708,215,205,225,262,47,37,57,55,-1.0931244796952346,-0.5220875393515396,0.14373989049512406,1.152264955732475,19023,19023,Crawford+Peach+Pike+Upson,Pike,13,231,Georgia,GA
13293,13CS028,327,316,339,421,94,82,105,55,1.0651132117755995,1.4580221439570442,1.9116079398582149,0.5806327587689101,401,387,414,548,147,134,161,97,1.7436768453141054,2.289567044213252,2.875459797119647,0.6532259149174733,26454,26454,Crawford+Peach+Pike+Upson,Upson,13,293,Georgia,GA
13081,13CS029,216,207,226,318,102,92,111,45,2.1459127224244345,2.5574545673057103,2.9911679007498218,0.43720950757262755,265,254,277,346,81,69,92,66,0.17136548623420025,0.7892382863668341,1.4218637438587471,0.8080325387688113,22237,22237,Crisp+Dooly+Turner+Wilcox,Crisp,13,81,Georgia,GA
13093,13CS029,105,104,106,170,65,64,66,20,3.2883122253794905,3.386743429182106,3.495082310805504,0.3028553398321778,129,128,131,173,44,42,45,25,1.525029559416968,1.6782978269578024,1.8373289821637089,0.560347218049351,13306,13306,Crisp+Dooly+Turner+Wilcox,Dooly,13,93,Georgia,GA
13287,13CS029,103,102,103,117,14,14,15,25,-1.4511880828751762,-1.3466311739054377,-1.2429360952680448,1.6275768439880798,126,125,127,134,8,7,9,15,-1.1909732467112186,-1.0386474876603462,-0.87952913330318,1.6418301033769958,7909,7909,Crisp+Dooly+Turner+Wilcox,Turner,13,287,Georgia,GA
13315,13CS029,83,82,84,117,34,33,35,25,0.9525665950181929,1.0581816172529088,1.166814724417366,0.712747131125309,102,101,103,171,69,68,70,17,7.142352200440055,7.292040572358339,7.463184604722475,0.2427464722969867,8563,8563,Crisp+Dooly+Turner+Wilcox,Wilcox,13,315,Georgia,GA
13085,13CS030,223,212,235,230,7,-5,18,18,-0.8918227424169628,-0.439504712504245,0.009121683065751706,2.3081959581569893,274,260,288,315,41,27,55,56,-1.3189384435823441,-0.7003239745068636,-0.062373758457000314,1.3484708432508563,26517,26517,Dawson+Lumpkin+White,Dawson,13,85,Georgia,GA
13187,13CS030,260,245,274,287,27,13,42,20,-0.18522915596600553,0.21887011532838244,0.6499453290498357,0.7036041333251635,319,301,337,422,103,85,121,67,0.6293025200451392,1.271287298545395,1.8933049626525373,0.6451104992867769,33898,33898,Dawson+Lumpkin+White,Lumpkin,13,187,Georgia,GA
13311,13CS030,265,251,278,336,71,58,85,33,0.8178820644897822,1.2626647302366023,1.6716914944062222,0.45543242379801047,324,308,341,447,123,106,139,67,1.5241189236680048,2.175437663005253,2.8130664143578974,0.5424614066600092,30806,30806,Dawson+Lumpkin+White,White,13,311,Georgia,GA
13087,13CS031,272,261,284,367,95,83,106,39,1.6496313582471316,2.109059677677514,2.5474547606530704,0.40739540249893846,334,320,348,395,61,47,75,51,-0.1374840567619625,0.46032116804673057,1.0904060206248312,0.8224721231762767,26480,26480,Decatur+Grady+Seminole,Decatur,13,87,Georgia,GA
13131,13CS031,221,211,232,273,52,41,62,38,0.11918935560013302,0.5581416044542391,0.9987463277478014,0.72271556298579,272,260,285,347,75,62,87,49,0.6442563452036115,1.2752214469425454,1.8621625533010455,0.6479816687730426,24548,24548,Decatur+Grady+Seminole,Grady,13,131,Georgia,GA
13253,13CS031,107,106,108,125,18,17,19,14,0.3770787936817092,0.49028325153476265,0.5936687071603762,0.7397729029498779,131,130,132,163,32,31,33,28,0.39547457343909254,0.5524947515044306,0.7062694820682098,0.8557755788416466,8078,8078,Decatur+Grady+Seminole,Seminole,13,253,Georgia,GA
13089,13CS032,3965,3637,4293,4797,832,504,1160,479,0.024322692471671854,0.4786216704338325,0.9042281261931252,0.5750873419660644,4932,4538,5325,5842,910,517,1304,564,-0.0910916819323313,0.5684511858451567,1.2390446712226282,0.6187801292205514,760797,760797,DeKalb,DeKalb,13,89,Georgia,GA
13095,13CS033,791,754,828,1089,298,261,335,173,0.967034083365928,1.43342219356722,1.8673019854652724,0.5787931906514749,970,925,1014,1203,233,189,278,149,0.5842025855583363,1.1806368981939201,1.7608975412062406,0.6356020127580441,87280,87280,Dougherty,Dougherty,13,95,Georgia,GA
13097,13CS034,864,800,928,1034,170,106,234,108,-0.02944367575449197,0.41880432746461227,0.8514231717888645,0.6317755253009535,1070,993,1146,1295,225,149,302,164,-0.1334539503439024,0.5180308887527665,1.1053577601600937,0.7243506595211766,147225,147225,Douglas,Douglas,13,97,Georgia,GA
13103,13CS035,424,396,453,470,46,17,74,31,-0.17664133274057048,0.24283661255414143,0.6814569694324724,0.6633136792349009,525,491,559,655,130,96,164,143,-0.9315911905332716,-0.23257422137454503,0.37389833345814444,1.0915861967583278,64935,64935,Effingham,Effingham,13,103,Georgia,GA
13105,13CS036,221,213,230,296,75,66,83,27,2.0732160353303244,2.484102399145198,2.899554370490383,0.3565104879360265,270,260,280,331,61,51,71,39,0.6925312504729346,1.3619455774177391,2.0316754835375934,0.6303105149016142,19259,19259,Elbert+Franklin+Hart+Stephens,Elbert,13,105,Georgia,GA
13119,13CS036,264,254,274,323,59,49,69,33,0.6919528361835255,1.0901021913082474,1.5358415777287213,0.5528939738904497,323,311,335,368,45,33,57,43,-0.5172774177253628,0.09335797859185212,0.7535430687851882,0.9307601546935749,23398,23398,Elbert+Franklin+Hart+Stephens,Franklin,13,119,Georgia,GA
13147,13CS036,261,250,273,324,63,51,74,36,0.5827079715004432,1.0076656823386256,1.4552541796569622,0.5650620560432053,320,306,333,407,87,74,101,52,0.9840663362665942,1.5981387889900787,2.2211222378101754,0.5894699569440885,26318,26318,Elbert+Franklin+Hart+Stephens,Hart,13,147,Georgia,GA
13257,13CS036,318,307,330,330,12,0,23,42,-1.5709504710354802,-1.1731587875347163,-0.7135970734715364,3.329009797544492,388,375,402,488,100,86,113,69,0.822417959906716,1.4309936009312538,1.9911165983119483,0.684437637340413,26054,26054,Elbert+Franklin+Hart+Stephens,Stephens,13,257,Georgia,GA
13111,13CS037,295,283,306,352,57,46,69,26,0.7599638445017126,1.2091249431720148,1.6659543530249643,0.4456773198995894,357,343,371,468,111,97,125,79,0.8747945077694594,1.4550192038902163,2.1108323608893764,0.7051581253798942,26257,26257,Fannin+Rabun+Towns+Union,Fannin,13,111,Georgia,GA
13241,13CS037,184,177,191,234,50,43,57,24,1.1283261141505534,1.505102280562345,1.9161467585417322,0.47092503003968056,223,214,232,285,62,53,71,46,0.49540629642242234,1.1061330792673914,1.74223130211354,0.7287396954011734,17181,17181,Fannin+Rabun+Towns+Union,Rabun,13,241,Georgia,GA
13281,13CS037,165,160,170,181,16,11,21,26,-1.262572112254282,-0.8234140115997848,-0.3707943714066988,1.5361207525262475,200,193,206,248,48,42,55,41,0.10245347063399421,0.7129473824025143,1.371249775355844,0.8322588061339478,12108,12108,Fannin+Rabun+Towns+Union,Towns,13,281,Georgia,GA
13291,13CS037,284,273,294,361,77,67,88,31,1.423010188230467,1.856301726155812,2.2903726291333575,0.3954709469486406,344,331,357,435,91,78,104,64,0.657341364782939,1.3220926411691745,1.953150688512841,0.6951213616015328,24919,24919,Fannin+Rabun+Towns+Union,Union,13,291,Georgia,GA
13113,13CS038,771,721,821,868,97,47,147,70,-0.21928880507058984,0.2397986113621907,0.6578130382890047,0.7127295874018029,951,891,1010,1186,235,176,295,145,0.3206978129898335,0.9534879246142633,1.5751036434803498,0.6134277397048423,115135,115135,Fayette,Fayette,13,113,Georgia,GA
13115,13CS039,965,923,1007,1143,178,136,220,107,0.31874278707982096,0.7276529060724275,1.152658834691004,0.5976208702408601,1183,1132,1234,1448,265,214,316,207,0.05199009529487569,0.7153405718332678,1.337570039491657,0.7779656816799445,98441,98441,Floyd,Floyd,13,115,Georgia,GA
13117,13CS040,1079,972,1187,1196,117,9,224,71,-0.23177244038047393,0.19409816075202563,0.5907588183538242,0.6035721184513326,1348,1218,1477,1692,344,215,474,201,0.08124334148261299,0.6754587762013108,1.2929443576107953,0.5821492013817344,247217,247217,Forsyth,Forsyth,13,117,Georgia,GA
13121,13CS041,5895,5432,6358,7006,1111,648,1574,687,-0.02093036541495353,0.3983483608471658,0.8494119910777915,0.6177550868946146,7312,6756,7869,8332,1020,463,1576,877,-0.46381247507656564,0.14174327615775137,0.793704534628432,0.8592998687630434,1070179,1070179,Fulton,Fulton,13,121,Georgia,GA
13123,13CS042,312,298,325,363,51,38,65,33,0.14285132837895548,0.5861285244493132,0.9841942748073271,0.6287135872068936,382,366,399,503,121,104,137,93,0.4797633706740398,1.0479457041937628,1.7016227281299794,0.7636612646843278,31743,31743,Gilmer+Murray,Gilmer,13,123,Georgia,GA
13213,13CS042,327,310,344,406,79,62,96,41,0.47729836812685655,0.9474735647180637,1.3938454366398754,0.5120119576778617,402,382,423,544,142,121,162,92,0.854941249252343,1.5111095973285829,2.122311685675069,0.6449613741858196,40011,40011,Gilmer+Murray,Murray,13,213,Georgia,GA
13127,13CS043,758,721,794,945,187,151,224,107,0.5157585572448488,0.9397317861649027,1.378381242776329,0.5679967282663668,929,884,973,1141,212,168,257,189,-0.2462086198137451,0.29786989362728566,0.9573333556362842,0.8853830876259514,85427,85427,Glynn+McIntosh,Glynn,13,127,Georgia,GA
13191,13CS043,133,126,139,148,15,9,22,12,-0.17892717385842347,0.25377545623572023,0.6931809059735708,0.7302891773755622,162,155,170,226,64,56,71,25,2.599019043558643,3.2326819382401184,3.841973426343078,0.3869547169587116,14333,14333,Glynn+McIntosh,McIntosh,13,191,Georgia,GA
13129,13CS044,491,466,516,593,102,77,127,61,0.2539088483022841,0.680797803898379,1.1298343489735965,0.5920543209147291,605,575,636,773,168,137,198,122,0.2707301392039236,0.9473864044745742,1.5265193800055976,0.7234806103023563,58352,58352,Gordon,Gordon,13,129,Georgia,GA
13135,13CS045,3805,3400,4210,4746,941,536,1346,531,0.01668006967267412,0.42934212202533156,0.8652633124284765,0.5636949701955231,4770,4283,5257,5974,1204,717,1691,761,-0.06287198558425135,0.565676515226074,1.2098682721109804,0.6314663264573431,939577,939577,Gwinnett,Gwinnett,13,135,Georgia,GA
13139,13CS046,1352,1264,1441,1728,376,287,464,183,0.4978492573035628,0.9340958647544442,1.412827081463317,0.4860389203006019,1670,1563,1776,2026,356,250,463,332,-0.4717350859758081,0.13921230449539648,0.7400214522016425,0.9288354877285113,205260,205260,Hall,Hall,13,139,Georgia,GA
13141,13CS047,92,91,92,159,67,67,68,40,3.132394969136686,3.2310212901967965,3.3345752200104535,0.5846241144941983,112,111,113,167,55,54,56,30,3.372176917086413,3.5355818562943684,3.6937054608499325,0.535827341646047,8483,8483,Hancock+Jasper+Morgan+Putnam,Hancock,13,141,Georgia,GA
13159,13CS047,138,132,145,144,6,-1,12,16,-1.1628469480875268,-0.7246416302500185,-0.3042495166409053,2.4281458260896667,169,161,176,225,56,49,64,53,-0.3425980978927951,0.24015375307022901,0.8863846247921808,0.9290630455693186,14322,14322,Hancock+Jasper+Morgan+Putnam,Jasper,13,159,Georgia,GA
13211,13CS047,171,163,180,209,38,29,46,12,0.907412401477295,1.3333815633226835,1.7433231207580167,0.30888933324073536,209,199,219,293,84,74,94,38,2.239865369779414,2.821234843958145,3.459545476873065,0.44837039535025824,19404,19404,Hancock+Jasper+Morgan+Putnam,Morgan,13,211,Georgia,GA
13237,13CS047,212,203,222,258,46,36,55,30,0.24646266350645699,0.6985001837790301,1.1143940263341507,0.6444747008344782,259,248,271,366,107,95,118,51,2.3969698126156667,2.9855472000875793,3.5880617634059155,0.47393722740055794,22265,22265,Hancock+Jasper+Morgan+Putnam,Putnam,13,237,Georgia,GA
13143,13CS048,314,300,327,392,78,65,92,50,0.5038821665230635,0.9636779237645673,1.3445826573883566,0.6290628644586044,381,365,397,444,63,47,79,68,-0.7660577330575623,-0.22534979512245285,0.39976360232293395,1.0653305190169726,30092,30092,Haralson+Polk,Haralson,13,143,Georgia,GA
13233,13CS048,420,402,438,504,84,66,102,46,0.43342403034224164,0.896574038503426,1.3325403867079075,0.5410936287805079,510,488,533,660,150,127,172,88,1.1172257941940276,1.7188137375221184,2.3295057091044833,0.5845061230812838,42709,42709,Haralson+Polk,Polk,13,233,Georgia,GA
13145,13CS049,259,244,275,284,25,9,40,29,-0.5449736736658459,-0.12877099060282687,0.2898194577321762,1.123536688879277,321,303,340,345,24,5,42,58,-1.7576105530080504,-1.1393702727068538,-0.542306977982391,2.337750895453393,35560,35560,Harris+Meriwether+Talbot,Harris,13,145,Georgia,GA
13199,13CS049,238,229,247,284,46,37,55,19,0.8610393536993751,1.2606034148299663,1.6919390213454666,0.4053667555710366,291,280,302,400,109,98,120,68,1.6969574708423645,2.287661384340717,2.8675615237035097,0.6203665487079887,21134,21134,Harris+Meriwether+Talbot,Meriwether,13,199,Georgia,GA
13263,13CS049,71,70,72,80,9,8,10,2,1.0097923005920197,1.1268422701039291,1.2298021400383274,0.2011810014914568,87,86,88,97,10,9,11,20,-2.1370272741320435,-1.982281745931903,-1.822444311135302,1.852260447119115,6169,6169,Harris+Meriwether+Talbot,Talbot,13,263,Georgia,GA
13151,13CS050,1410,1307,1513,1751,341,238,444,151,0.3886691659355432,0.7967637655865324,1.2174141762630009,0.44123794951589945,1747,1624,1871,2208,461,337,584,326,0.076410813754747,0.6686544533574493,1.2907806685056977,0.7062960866492999,236533,236533,Henry,Henry,13,151,Georgia,GA
13153,13CS051,1071,1002,1139,1304,233,165,302,106,0.3520578044067641,0.7916254044203154,1.2314735072462972,0.4524307909836663,1324,1242,1407,1701,377,294,459,247,0.4125939514053467,0.9754277412204371,1.6166911948056477,0.6541164713855437,158545,158545,Houston,Houston,13,153,Georgia,GA
13157,13CS052,573,540,606,680,107,74,140,77,-0.011445707206195872,0.4067201910890369,0.8227048332685459,0.7136838983275077,703,664,743,858,155,115,194,139,-0.38111525029657134,0.25328071352736453,0.8651271902765393,0.8933710694817556,74342,74342,Jackson,Jackson,13,157,Georgia,GA
13003,13CS053,72,71,73,80,8,7,9,11,-0.4746028804228025,-0.36841706666742213,-0.2583629768434021,1.2296659771974616,88,87,90,139,51,49,52,28,3.0973089301500947,3.258627516894092,3.4084538213571833,0.5429710316698356,8321,8321,Lanier and Nearby Counties,Atkinson,13,3,Georgia,GA
13019,13CS053,195,187,203,227,32,24,40,30,-0.30354828483798196,0.1135734532426318,0.538304823912136,0.9083648167595104,238,228,248,286,48,38,58,37,0.036835592063678355,0.6259409729395036,1.2710469450890567,0.7605052180020543,19390,19390,Lanier and Nearby Counties,Berrien,13,19,Georgia,GA
13065,13CS053,70,69,71,92,22,21,23,13,1.2813629383435559,1.3888614226005565,1.488730300189203,0.5607278786069949,86,85,86,116,30,30,31,19,1.9229759668945665,2.074457148207861,2.2401309891002685,0.6040732610658436,6614,6614,Lanier and Nearby Counties,Clinch,13,65,Georgia,GA
13075,13CS053,167,160,175,213,46,38,53,32,0.3689132115678671,0.7832366013428783,1.2127916964917402,0.6839928287073117,205,196,214,229,24,15,33,29,-0.890401830212417,-0.3077529110218234,0.31285433456692674,1.1409342770582838,17262,17262,Lanier and Nearby Counties,Cook,13,75,Georgia,GA
13101,13CS053,22,22,23,36,14,13,14,4,2.3432088089362684,2.454428441037655,2.560129289999182,0.2709522376710222,27,27,28,42,15,14,15,4,3.0346202406716194,3.1870416684288068,3.34080258331028,0.25683272436369686,3979,3979,Lanier and Nearby Counties,Echols,13,101,Georgia,GA
13173,13CS053,82,81,84,84,2,0,3,10,-0.8975644178746347,-0.7952171965399719,-0.6945682600914178,3.93635509428904,101,100,103,114,13,11,14,3,0.9430188612200975,1.0899945320332396,1.2435557789503784,0.21911743130229683,10646,10646,Lanier and Nearby Counties,Lanier,13,173,Georgia,GA
13185,13CS054,801,750,852,989,188,137,239,107,0.28810155782310903,0.6837647990483452,1.1018693776809563,0.5657614669205921,991,930,1052,1237,246,185,307,156,0.2782496965404735,0.89403637953403,1.5542466296609638,0.6316645504141033,117878,117878,Lowndes,Lowndes,13,185,Georgia,GA
13053,13CS055,39,38,40,35,-4,-5,-3,4,-0.8595080676760105,-0.751116775519435,-0.6502275510302719,-1.2781739698987733,49,48,51,39,-10,-12,-9,9,-2.296998057001819,-2.1426560153156737,-1.9861977599326552,-0.9685051826068999,10808,10808,Marion and Nearby Counties,Chattahoochee,13,53,Georgia,GA
13193,13CS055,142,136,147,147,5,-0,11,11,-0.8782538372046146,-0.4467377944563576,-0.021876693646224334,1.743114817698109,173,167,180,174,1,-6,7,23,-2.6815173904123664,-2.034805299330203,-1.4796356033565348,11.970573141103122,12842,12842,Marion and Nearby Counties,Macon,13,193,Georgia,GA
13197,13CS055,74,73,74,87,13,13,14,3,1.1250221313380093,1.233542545414724,1.3447560934866332,0.2080360775344897,91,90,92,126,35,34,36,30,0.5832978984615611,0.7348916028423531,0.8975926033023941,0.8293090341066631,8456,8456,Marion and Nearby Counties,Marion,13,197,Georgia,GA
13249,13CS055,35,34,35,40,5,5,6,6,-0.20146305043104382,-0.1004261122361454,0.007737653716622696,0.9258454758746847,43,42,43,58,15,15,16,2,2.8725665388206236,3.0303793892918547,3.1858181140020956,0.1235233569546317,5230,5230,Marion and Nearby Counties,Schley,13,249,Georgia,GA
13259,13CS055,59,59,60,59,-0,-1,0,12,-1.9358236519617067,-1.8393945517190766,-1.7277903523661657,15.795788779126157,73,72,74,78,5,4,6,12,-1.4366205319451038,-1.2794379131504334,-1.1223158998930474,2.034913035131054,6666,6666,Marion and Nearby Counties,Stewart,13,259,Georgia,GA
13261,13CS055,308,296,321,342,34,21,46,69,-1.6601317076372055,-1.2103245110780831,-0.7719208844749483,1.9957467898963082,378,362,393,431,53,38,69,58,-0.8302211885352703,-0.17702417802057072,0.4864696479007155,1.066043437271403,29351,29351,Marion and Nearby Counties,Sumter,13,261,Georgia,GA
13269,13CS055,84,84,85,98,14,13,14,17,-0.5318797549194811,-0.41994143998023037,-0.3204334114651303,1.1643153665116277,104,103,105,138,34,33,35,15,2.675775342856868,2.8385994197377262,2.9908345133275924,0.4276360160853561,8061,8061,Marion and Nearby Counties,Taylor,13,269,Georgia,GA
13307,13CS055,23,22,23,27,4,4,5,8,-1.4905809174735734,-1.3919093996557814,-1.2924276367265808,1.481535045979531,28,28,28,25,-3,-3,-3,3,-2.8922216909257417,-2.739993189311115,-2.6033078104015597,-1.5831474975137028,2582,2582,Marion and Nearby Counties,Webster,13,307,Georgia,GA
13215,13CS056,1702,1617,1786,1981,279,195,364,190,0.028638777565410587,0.4456024573944447,0.8704601657518198,0.6781505322516768,2090,1989,2192,2562,472,370,573,369,0.03068022718154155,0.632634220079332,1.2276532600287953,0.7804399034837967,196227,196227,Muscogee,Muscogee,13,215,Georgia,GA
13217,13CS057,787,739,836,999,212,163,260,104,0.549705523491562,0.979143170736412,1.40575868037376,0.4891610197853867,973,915,1032,1249,276,217,334,199,0.17194631448252337,0.8111652143279799,1.420317356130213,0.7195338074452318,112478,112478,Newton,Newton,13,217,Georgia,GA
13223,13CS058,863,788,937,1046,183,109,258,106,0.008392698584441938,0.4512543831005728,0.8634985519652773,0.5758165014266129,1077,987,1167,1288,211,121,301,188,-0.430109367317295,0.1550127061190029,0.7916891372013128,0.8868222844139323,170992,170992,Paulding,Paulding,13,223,Georgia,GA
13245,13CS059,1743,1656,1830,2116,373,286,460,236,0.2243399032018317,0.676347114779815,1.1339393462148175,0.6311580245007605,2137,2032,2241,2656,519,415,624,391,0.15326708421382554,0.7682583093252981,1.3686875880552007,0.7516799152396392,202406,202406,Richmond,Richmond,13,245,Georgia,GA
13247,13CS060,638,599,677,777,139,100,178,71,0.2742655987407182,0.7577572743384435,1.1505555841812414,0.5082670692121659,790,743,837,1008,218,171,265,151,0.2788616133962359,0.878868970699766,1.4765803959622668,0.6906679298442528,90764,90764,Rockdale,Rockdale,13,247,Georgia,GA
13255,13CS061,661,632,690,839,178,149,207,94,0.8231124847377359,1.239540930593872,1.6589391528105262,0.5265438357151214,809,774,844,1101,292,257,327,205,0.9426808561197593,1.5711808797057176,2.1683012052825603,0.7002392654048749,67076,67076,Spalding,Spalding,13,255,Georgia,GA
13133,13CS062,194,186,202,212,18,10,26,23,-0.7023454168625953,-0.25424785459618093,0.18299500273833624,1.1966369104551031,238,229,248,275,37,27,46,33,-0.4064994656257754,0.23520230144785031,0.8444069627108202,0.8785727572272443,18556,18556,Taliaferro and Nearby Counties,Greene,13,133,Georgia,GA
13181,13CS062,81,80,82,96,15,14,16,17,-0.4038100635298016,-0.2901347115573655,-0.18392634543110012,1.0845145005944798,100,99,101,122,22,21,23,17,0.6121813308583467,0.767838256746993,0.9242805641055539,0.7351944233391261,7995,7995,Taliaferro and Nearby Counties,Lincoln,13,181,Georgia,GA
13189,13CS062,216,207,225,238,22,13,31,23,-0.47473513339200285,-0.05717641417275143,0.388302231047272,1.0095857308007212,265,254,276,309,44,33,55,37,-0.26803527441112945,0.4014378717439766,0.970659298622939,0.8289108206671532,21252,21252,Taliaferro and Nearby Counties,McDuffie,13,189,Georgia,GA
13221,13CS062,145,139,152,151,6,-1,12,2,-0.1846153666940248,0.24445491707104747,0.668375610576241,0.3022215459883214,179,171,187,194,15,7,23,20,-1.0408487221484413,-0.3883047660104063,0.22690931865070882,1.251721966149811,15289,15289,Taliaferro and Nearby Counties,Ogelthorpe,13,221,Georgia,GA
13265,13CS062,21,21,21,23,2,2,2,5,-2.0080429521590903,-1.9008767262571131,-1.7931489660405608,1.6375793021110274,26,25,26,37,11,11,12,2,7.03263126775127,7.206668629525015,7.367488541356794,0.16213433510032038,1554,1554,Taliaferro and Nearby Counties,Taliaferro,13,265,Georgia,GA
13301,13CS062,66,66,67,89,23,22,23,6,3.069930592822486,3.169879338405032,3.2778000472509543,0.2543685088045495,81,81,82,86,5,4,5,13,-2.084082657848091,-1.9306117534431009,-1.771551837432881,2.323848102394863,5225,5225,Taliaferro and Nearby Counties,Warren,13,301,Georgia,GA
13317,13CS062,136,132,140,135,-1,-5,3,11,-1.6395519029370598,-1.2306158466841521,-0.7735018966344405,59.18526888158833,166,161,171,179,13,8,18,21,-1.5741786963885482,-0.958087776728549,-0.31953225752256015,1.4631659092999605,9738,9738,Taliaferro and Nearby Counties,Wilkes,13,317,Georgia,GA
13277,13CS063,386,368,403,450,64,47,82,69,-0.4956350762635222,-0.12505004429642214,0.2768973129757185,1.0587935626534901,478,457,499,545,67,46,88,79,-0.9539899742251765,-0.3644360324704026,0.23410039082671694,1.1662611461137928,40680,40680,Tift+Worth,Tift,13,277,Georgia,GA
13321,13CS063,207,198,216,240,33,24,42,40,-0.7608808560208293,-0.35192590300335796,0.07636910880483322,1.1750778713949006,256,245,266,314,58,48,69,41,0.44072377732750634,1.0473560673956335,1.6445731622449251,0.690023517549081,20096,20096,Tift+Worth,Worth,13,321,Georgia,GA
13285,13CS064,606,576,636,789,183,153,213,100,0.7381180938514085,1.1822380843969245,1.6079026688628388,0.5432431761886122,743,707,779,941,198,162,234,161,0.025130022410689346,0.633285401708281,1.2882303214430415,0.80866844511642,70124,70124,Troup,Troup,13,285,Georgia,GA
13297,13CS065,778,737,820,904,126,84,167,91,-0.06943601293254428,0.3578633938402552,0.8189480088352515,0.719294924132396,957,907,1008,1239,282,231,332,213,0.24245277661769576,0.8769286483307501,1.5036508196465193,0.7539308801320053,95675,95675,Walton,Walton,13,297,Georgia,GA
13009,13CS066,400,381,420,498,98,78,117,45,0.751718957868073,1.1717200976882851,1.5819441706413782,0.4564598339601712,494,470,517,620,126,103,150,88,0.38879602337547003,1.0230412123225983,1.6823041684130533,0.6910407923802414,45045,45045,Washington and Nearby Counties,Baldwin,13,9,Georgia,GA
13125,13CS066,33,33,34,38,5,4,5,10,-1.8792511481593854,-1.7723512109940855,-1.662912293864384,1.742126526289563,41,40,41,51,10,10,11,4,2.337542255065231,2.4917383285512185,2.650884026725836,0.35852979349929903,2969,2969,Washington and Nearby Counties,Glascock,13,125,Georgia,GA
13163,13CS066,188,182,195,257,69,62,75,33,1.8878014492967723,2.3295462440310057,2.766036953102954,0.47283438559973173,230,222,238,278,48,40,56,47,-0.5511178609718448,0.07013695690266479,0.6664117875097896,0.962691648206112,15312,15312,Washington and Nearby Counties,Jefferson,13,163,Georgia,GA
13167,13CS066,91,90,92,124,33,32,34,24,0.7918749357285,0.9055331633244963,1.00841849328622,0.7112358496028344,112,111,114,142,30,28,31,25,0.4324936859050602,0.5856400948990323,0.748887247304561,0.8134312487407377,9700,9700,Washington and Nearby Counties,Johnson,13,167,Georgia,GA
13169,13CS066,222,210,235,263,41,28,53,18,0.3475317967703698,0.7963740058821822,1.2282272313838516,0.4322895598761089,275,260,290,384,109,94,124,60,1.4648794539960497,2.0382701225689943,2.634064185748754,0.546726815489313,28730,28730,Washington and Nearby Counties,Jones,13,169,Georgia,GA
13303,13CS066,200,191,209,271,71,62,80,53,0.42693695224467837,0.8754864733668577,1.3243361215144736,0.7378465495742714,246,235,256,312,66,56,77,58,-0.1453084347379973,0.490517916095674,1.1079940613007815,0.8635961503848312,20268,20268,Washington and Nearby Counties,Washington,13,303,Georgia,GA
13319,13CS066,103,102,104,130,27,26,28,13,1.5238660960726664,1.6257391206345226,1.7264740123876694,0.4572344320164794,126,125,127,190,64,63,65,26,4.987931628058187,5.150079245910778,5.303756026592388,0.3994996961567536,8884,8884,Washington and Nearby Counties,Wilkinson,13,319,Georgia,GA
13175,13CS067,483,463,503,642,159,139,179,103,0.7162664442480278,1.1760056436492017,1.6116405699616356,0.6437293350317083,592,567,616,809,217,193,242,116,1.9312328705790105,2.5660580492626828,3.2080202995586258,0.5312683764743404,47544,47544,Wheeler and Nearby Counties,Laurens,13,175,Georgia,GA
13209,13CS067,80,79,81,101,21,20,22,14,0.6737725142370027,0.7825793249681348,0.8951799365578385,0.6334414299308578,98,97,100,151,53,51,54,30,2.835002635706431,2.9869395792045617,3.145872518522528,0.5594762898745502,9091,9091,Wheeler and Nearby Counties,Montgomery,13,209,Georgia,GA
13271,13CS067,143,136,149,192,49,43,56,33,0.5824543699071001,1.031376572318323,1.4844021078648229,0.6549480165914277,175,167,183,184,9,1,17,32,-2.3812321725310914,-1.7587520632126261,-1.142077853410052,3.2429642162554106,15800,15800,Wheeler and Nearby Counties,Telfair,13,271,Georgia,GA
13283,13CS067,66,66,67,93,27,26,27,13,1.8681401691330728,1.9726507040439336,2.086851723043677,0.472534902524773,82,81,83,132,50,49,51,33,2.8662367599835457,3.0068332336979475,3.1651556369020106,0.6441822079072216,6844,6844,Wheeler and Nearby Counties,Treutlen,13,283,Georgia,GA
13309,13CS067,56,55,56,68,12,12,13,12,-0.06437161097439308,0.04847531567700097,0.1427180508785019,0.8970618679372755,69,68,70,78,9,8,10,12,-0.5704125121273881,-0.41397777340578473,-0.2557246451165821,1.1632832772747965,7820,7820,Wheeler and Nearby Counties,Wheeler,13,309,Georgia,GA
13313,13CS068,740,696,785,916,176,131,220,138,-0.04611019415851707,0.3639313473482763,0.7676509715601404,0.7811978014873723,913,860,967,1136,223,169,276,199,-0.38028608987814244,0.29041701469942005,0.9004569725254981,0.8895604155618723,104087,104087,Whitfield,Whitfield,13,313,Georgia,GA
15001,15CS001,1520,1432,1607,1531,11,-76,99,47,-0.5981246817037986,-0.14989060324319536,0.28215384821311756,3.8958018213061676,1871,1766,1976,2054,183,78,288,107,-0.1887576942467611,0.4605561935526489,1.0634519310733295,0.5810233365444067,202655,202655,Hawaii (county),Hawaii (county),15,1,Hawaii,HI
15003,15CS002,6472,6057,6887,6909,437,22,852,275,-0.27468673901113216,0.15828646497503987,0.5960636130895189,0.6275696608275179,7985,7488,8483,8764,779,281,1276,470,-0.23505380007428142,0.38867287890066765,1.041214935253624,0.6029371112490046,969464,969464,Honolulu,Honolulu,15,3,Hawaii,HI
15005,15CS003,1,1,1,1,0,0,0,1,-8.78839172826075,-8.364389235415825,-7.946567689948175,0.7866180309788499,1,1,1,3,2,2,2,3,-12.90470319662263,-12.330672025675558,-11.6988612515019,0.9661201139159942,87,87,Kalawao+Maui,Kalawao,15,5,Hawaii,HI
15009,15CS003,1008,935,1080,1026,18,-54,91,16,-0.4068202252777962,0.013471193809414962,0.44956557246324275,0.8207101602028433,1248,1162,1335,1389,141,54,227,84,-0.21291366588289903,0.3972668090030567,1.0024177545480686,0.5929985081218361,167774,167774,Kalawao+Maui,Maui,15,9,Hawaii,HI
15007,15CS004,497,466,528,487,-10,-41,21,3,-0.5891597201184389,-0.1727357644090224,0.2622576008645077,-0.3336162671809986,613,576,650,590,-23,-60,14,18,-1.3078274143365145,-0.6936199150966387,-0.06186064757639156,-0.8159337722495136,72049,72049,Kauai,Kauai,15,7,Hawaii,HI
16001,16CS001,2852,2640,3064,3261,409,197,621,315,-0.22172590647269508,0.19373259013770622,0.668741045895791,0.7686260794270207,3537,3282,3793,4152,615,359,870,451,-0.25201387371493056,0.3914997734866589,1.0192062013514598,0.73247794365183,487096,487096,Ada,Ada,16,1,Idaho,ID
16005,16CS002,648,609,686,704,56,18,95,59,-0.46508355056967304,-0.025870322041199968,0.36435187066785213,1.0286940532160658,800,754,846,939,139,93,185,126,-0.4754915296698092,0.16515214831684205,0.8044615263706033,0.9002341259479772,88227,88227,Bannock+Bear Lake+Caribou+Franklin,Bannock,16,5,Idaho,ID
16007,16CS002,51,51,52,69,18,17,18,6,1.8079236626353805,1.9177726063776126,2.0238349462598832,0.31929939243392624,63,62,64,79,16,15,17,11,0.8294318460575949,0.9779890576329934,1.1362906424595438,0.6467387687714086,6136,6136,Bannock+Bear Lake+Caribou+Franklin,Bear Lake,16,7,Idaho,ID
16029,16CS002,59,58,60,74,15,14,16,7,1.0364414061486922,1.1434256409213819,1.247410868713798,0.43354685488889233,72,71,73,78,6,5,7,15,-1.7377960177220602,-1.5712445090773057,-1.414517650794677,2.2747396901664927,7138,7138,Bannock+Bear Lake+Caribou+Franklin,Caribou,16,29,Idaho,ID
16041,16CS002,95,94,97,91,-4,-6,-3,5,-0.7620979417524116,-0.6585537147299028,-0.551633073699358,-1.5467024533427387,117,116,119,134,17,15,18,16,-0.10755001587599669,0.05127152083598344,0.20049821749346636,0.9114671292125699,14030,14030,Bannock+Bear Lake+Caribou+Franklin,Franklin,16,41,Idaho,ID
16009,16CS003,109,108,110,102,-7,-8,-6,4,-1.299010721342447,-1.1910725480526567,-1.0888455296451693,-0.6507360493009642,133,132,135,158,25,23,26,23,0.06646319408825702,0.21705104857810162,0.3851014333262424,0.8952170009746647,9356,9356,Benewah+Latah+Nez Perce,Benewah,16,9,Idaho,ID
16057,16CS003,186,169,204,213,27,9,44,2,0.17902630415239384,0.6117727958159622,1.035574857295572,0.07191788816174945,230,209,251,303,73,52,94,29,0.673388300323559,1.304549251089323,1.935150114326583,0.3924956722709408,40563,40563,Benewah+Latah+Nez Perce,Latah,16,57,Idaho,ID
16069,16CS003,430,413,448,463,33,15,50,37,-0.5142773856775104,-0.09971799663017504,0.3001373811382016,1.0939583175445704,523,502,544,609,86,65,107,58,0.18707559121405415,0.8338271336749625,1.4811708035001014,0.6653921150829635,40665,40665,Benewah+Latah+Nez Perce,Nez Perce,16,69,Idaho,ID
16011,16CS004,344,323,364,406,62,42,83,43,-0.027739839203751872,0.41950643414122946,0.8306175068623987,0.6795097951450764,424,400,449,504,80,55,104,75,-0.5142140713970947,0.13397664848169655,0.7300910416153129,0.928811302613287,46951,46951,Bingham+Oneida+Power,Bingham,16,11,Idaho,ID
16071,16CS004,38,37,38,39,1,1,2,4,-0.6979572128326965,-0.5868815169353403,-0.48682950824181936,1.7113007987261903,46,46,47,63,17,16,17,6,2.704669976234052,2.8554571502846846,3.0074640831051407,0.3385480792952347,4508,4508,Bingham+Oneida+Power,Oneida,16,71,Idaho,ID
16077,16CS004,54,53,55,63,9,8,10,3,0.6924493611959807,0.7959317863922885,0.9031773003356989,0.29707028791030665,66,65,67,88,22,21,23,12,1.359274732121508,1.5153119263497794,1.6621696950001765,0.5298812352696503,7639,7639,Bingham+Oneida+Power,Power,16,77,Idaho,ID
16015,16CS005,53,52,54,57,4,3,5,3,0.04867113882373526,0.16345746702427977,0.27373009307989116,0.5640678897004567,65,64,66,93,28,27,29,3,3.596344101125673,3.759228949060648,3.9285591268159967,0.10356509294279156,7970,7970,Boise+Gem+Payette+Washington,Boise,16,15,Idaho,ID
16045,16CS005,195,187,203,227,32,24,40,17,0.37957629279403526,0.8245740801296079,1.2114486758352294,0.5089859870044691,238,229,248,304,66,56,75,37,1.249514993928882,1.8619604914074688,2.498082386468481,0.5546656461498086,18394,18394,Boise+Gem+Payette+Washington,Gem,16,45,Idaho,ID
16075,16CS005,212,202,223,220,8,-3,18,25,-1.103332092772854,-0.7144819913966677,-0.2707221444809589,2.8400481495009164,261,248,274,338,77,64,90,47,0.8287288956779675,1.4946428119866073,2.064052098491568,0.6013778890200588,24351,24351,Boise+Gem+Payette+Washington,Payette,16,75,Idaho,ID
16087,16CS005,104,103,105,138,34,33,35,13,1.916118084946016,2.026538923521887,2.128434741119538,0.3748836321592247,128,127,129,163,35,34,36,28,0.6481695358969289,0.8103488404094483,0.9733002198686387,0.7802674935346362,10224,10224,Boise+Gem+Payette+Washington,Washington,16,87,Idaho,ID
16017,16CS006,410,390,430,414,4,-16,24,18,-0.7223050333724367,-0.3099605956875078,0.12580755630429036,3.529277217426714,503,478,527,618,115,91,140,120,-0.7440844284323114,-0.12673201939782208,0.4706276011211105,1.030983005008421,46209,46209,Bonner+Boundary+Shoshone,Bonner,16,17,Idaho,ID
16021,16CS006,101,100,103,113,12,10,13,1,0.7557344151430502,0.8608760094834071,0.9700602412119457,0.07831120553568942,124,123,126,179,55,53,56,41,1.1448464929227269,1.3136868287786088,1.4623938075121943,0.7360156007838305,12472,12472,Bonner+Boundary+Shoshone,Boundary,16,21,Idaho,ID
16079,16CS006,163,157,168,158,-5,-10,1,24,-2.663626789715137,-2.2380854309342215,-1.8368806342517683,-6.357953343108845,198,191,205,246,48,41,55,42,-0.06982238739845964,0.5471449164358048,1.1658245369359757,0.8586174154744999,12886,12886,Bonner+Boundary+Shoshone,Shoshone,16,79,Idaho,ID
16019,16CS007,817,765,870,942,125,72,177,111,-0.31124309444947984,0.12775274169916967,0.5475717804082681,0.8813589965193238,1011,948,1074,1104,93,30,156,115,-0.8556861023786867,-0.20157390770477096,0.4361051311634151,1.2240738656503933,120473,120473,Bonneville,Bonneville,16,19,Idaho,ID
16027,16CS008,1440,1338,1542,1649,209,107,311,209,-0.4279587948752496,-0.010060157137772405,0.48094158994147274,0.9960818380571332,1784,1661,1906,2131,347,225,470,334,-0.5269284358254785,0.059699199450998455,0.6918945815908722,0.9584241315146671,233096,233096,Canyon,Canyon,16,27,Idaho,ID
16003,16CS009,38,37,38,41,3,3,4,3,-0.036647535293084385,0.07354144650775676,0.17626414103779126,0.6931824554999984,46,46,47,55,9,8,9,4,1.1757954730539992,1.3273873957739273,1.4943991559855263,0.40760403658037897,4341,4341,Central Idaho,Adams,16,3,Idaho,ID
16035,16CS009,92,91,93,104,12,11,13,4,0.8308415224300363,0.9355423021389846,1.0404633984766851,0.30239538200601146,112,111,114,132,20,18,21,16,0.32306902941834625,0.49631465458565416,0.645477697776668,0.7753636726394358,8796,8796,Central Idaho,Clearwater,16,35,Idaho,ID
16037,16CS009,44,42,46,40,-4,-6,-2,2,-1.9528096099843069,-1.4715495152448588,-1.0661772873663002,-0.6103121388577165,54,52,56,69,15,13,17,4,2.542995479390214,3.168414212129607,3.7896836363596207,0.24595165704586752,4263,4263,Central Idaho,Custer,16,37,Idaho,ID
16049,16CS009,170,163,177,181,11,4,18,16,-0.7631646313340964,-0.311906832458096,0.12152568507018986,1.347446703904615,207,198,216,257,50,41,59,30,0.8212857943786114,1.4398701574293404,2.036675972949535,0.5865256877933487,16706,16706,Central Idaho,Idaho (county),16,49,Idaho,ID
16059,16CS009,91,90,92,109,18,17,19,11,0.7789673769541884,0.880742269969588,0.9881564527695851,0.5751753755148281,111,110,112,148,37,36,38,13,3.386540020909302,3.5431265310282343,3.7044289471225866,0.3440228684938911,8062,8062,Central Idaho,Lemhi,16,59,Idaho,ID
16061,16CS009,40,38,42,47,7,5,9,8,-0.7172144600690917,-0.2601897573864649,0.1480703599596703,0.9976474215405348,49,47,51,67,18,16,20,12,1.4054844677240004,2.0142044711195206,2.625070066238775,0.6166105331954773,3842,3842,Central Idaho,Lewis,16,61,Idaho,ID
16085,16CS009,76,75,77,83,7,6,8,4,0.15989220116481317,0.2673932185466603,0.37083666046819136,0.4936297575869462,93,92,95,101,8,6,9,1,0.5443258437773932,0.6851272544716432,0.8519562983485727,0.11480519618794464,11588,11588,Central Idaho,Valley,16,85,Idaho,ID
16039,16CS010,186,174,198,209,23,11,35,11,0.009169773280831958,0.4239341926465765,0.8268614321434853,0.46353958668789064,230,216,244,239,9,-5,23,43,-2.116578024137515,-1.4951320427492731,-0.8933709315356835,4.362242661281191,27404,27404,Elmore+Gooding+Owyhee,Elmore,16,39,Idaho,ID
16047,16CS010,119,117,120,169,50,49,52,20,1.8616350468406058,1.9652084469692763,2.0740416947480385,0.38992796533742197,146,144,148,170,24,22,26,26,-0.29809714022514167,-0.13705071832450402,0.030044471187078023,1.0284822422326265,15427,15427,Elmore+Gooding+Owyhee,Gooding,16,47,Idaho,ID
16073,16CS010,89,87,90,118,29,28,31,17,0.9282144141343843,1.035530423424824,1.1395407817685916,0.5591799460056975,109,107,110,140,31,30,33,19,1.078248088698305,1.2202241950730257,1.3768315699697646,0.5899949845609757,11952,11952,Elmore+Gooding+Owyhee,Owyhee,16,73,Idaho,ID
16023,16CS011,25,25,26,31,6,5,6,1,1.6747358049206287,1.7851918141973249,1.884339853085339,0.14957242596420853,31,31,31,45,14,14,14,4,4.373459998643543,4.525657233144948,4.6934811112346555,0.2677502684402688,2631,2631,Jefferson and Nearby Counties,Butte,16,23,Idaho,ID
16033,16CS011,6,5,6,6,0,0,1,6,-6.659114041193867,-6.540453618509627,-6.4382970294943975,4.065127671802291,7,7,7,10,3,3,3,4,-1.313899617958813,-1.1411531006600861,-0.9949447468868565,0.9536817836789908,844,844,Jefferson and Nearby Counties,Clark,16,33,Idaho,ID
16043,16CS011,93,92,95,111,18,16,19,13,0.23499682783686293,0.34923081239996173,0.44904075980713104,0.7014905595812116,115,113,117,164,49,47,51,5,3.861283581836309,4.014082114486879,4.1633954386220395,0.1000780110188958,13152,13152,Jefferson and Nearby Counties,Fremont,16,43,Idaho,ID
16051,16CS011,160,147,174,176,16,2,29,16,-0.4106044964029867,-0.017922711722841364,0.4220538357808487,0.9635744941548579,198,182,214,251,53,37,69,37,0.03819506631975523,0.6087952402945883,1.2995200116803736,0.6849366615541425,30194,30194,Jefferson and Nearby Counties,Jefferson,16,51,Idaho,ID
16065,16CS011,137,120,154,164,27,10,44,15,-0.11117918836667892,0.3002532835637575,0.7199517482603812,0.5341848872784231,171,150,192,234,63,42,84,20,0.6559125108687387,1.2735303881193707,1.8883970062220907,0.31311040773053167,40252,40252,Jefferson and Nearby Counties,Madison,16,65,Idaho,ID
16081,16CS011,46,45,48,37,-9,-11,-8,7,-1.4367042286209817,-1.3226026489157472,-1.2155976627857976,-0.8529067020187378,57,56,59,70,13,11,14,7,0.39121375174163775,0.547445484270807,0.7015329127046359,0.5171167233540502,12265,12265,Jefferson and Nearby Counties,Teton,16,81,Idaho,ID
16055,16CS012,1360,1286,1433,1387,27,-46,101,115,-0.9627479642019376,-0.5258254225802151,-0.11273757270288555,4.03778299735816,1679,1590,1767,2018,339,251,428,310,-0.3964692369351335,0.22012420707687766,0.8634417899901409,0.9105539160309388,167728,167728,Kootenai,Kootenai,16,55,Idaho,ID
16013,16CS013,107,105,110,121,14,11,16,15,-0.1641544845355152,-0.05902169784198984,0.03313162180568013,1.0340805012114445,134,130,137,156,22,19,26,11,0.4468971238774731,0.599447692240165,0.7419078886706785,0.46813188567096703,23184,23184,Lincoln and Nearby Counties,Blaine,16,13,Idaho,ID
16025,16CS013,11,10,11,12,1,1,2,0,0.6739100096007856,1.1055146982427493,1.551321353085103,0,13,13,14,7,-6,-7,-6,7,-15.01365849535355,-14.410649496368674,-13.735215905659244,-1.3280481529416723,1107,1107,Lincoln and Nearby Counties,Camas,16,25,Idaho,ID
16031,16CS013,182,172,193,192,10,-1,20,18,-0.7558058128745723,-0.3303006709657573,0.07347239239105273,1.6620836245338049,225,213,238,234,9,-4,21,25,-1.4336929184055796,-0.7896946574338999,-0.18302822374419397,2.516974425968763,24146,24146,Lincoln and Nearby Counties,Cassia,16,31,Idaho,ID
16053,16CS013,155,145,166,158,3,-8,13,17,-1.0132259401056216,-0.5853675691466916,-0.11724461531061064,4.4900163782581455,193,180,205,243,50,38,63,39,-0.07729542816636727,0.5518403048256104,1.179393224442552,0.7599943559877187,24524,24524,Lincoln and Nearby Counties,Jerome,16,53,Idaho,ID
16063,16CS013,34,34,35,39,5,4,5,4,0.007243006597962081,0.11376627761219837,0.21352231257859466,0.7159428609255619,42,42,43,38,-4,-5,-4,2,-1.616361693724812,-1.4607412958022474,-1.2960425608124495,-0.5728109563670161,5339,5339,Lincoln and Nearby Counties,Lincoln,16,63,Idaho,ID
16067,16CS013,172,163,181,178,6,-3,15,23,-1.2315434898444542,-0.786250059344785,-0.3726791842209325,3.1826972059783465,212,201,223,228,16,5,27,29,-1.3157441117891175,-0.7173733777905974,-0.18457011270172033,1.6938531313764684,21038,21038,Lincoln and Nearby Counties,Minidoka,16,67,Idaho,ID
16083,16CS014,679,641,717,838,159,121,197,98,0.25319447938226775,0.6903754411986213,1.1470641738012393,0.6114042191736028,835,789,881,986,151,105,197,130,-0.34286546847806304,0.28938482041914865,0.876761722927891,0.8551251231226589,87662,87662,Twin Falls,Twin Falls,16,83,Idaho,ID
17001,17CS001,675,647,703,745,70,42,98,71,-0.44179793352722363,-0.028659447677721592,0.42318704030021165,1.0034046913812658,825,791,858,936,111,78,145,103,-0.4761987218215372,0.1387299563555933,0.7606641676334895,0.9166440837425219,65144,65144,Adams,Adams,17,1,Illinois,IL
17005,17CS002,147,140,154,165,18,11,25,11,0.010553683272875643,0.41310441334644593,0.8329328091689343,0.5926637504198974,179,171,188,219,40,31,48,28,0.21044665583270641,0.8544936164909188,1.4665825905904415,0.6897734041932715,16376,16376,Bond+Effingham+Fayette,Bond,17,5,Illinois,IL
17049,17CS002,304,290,319,379,75,60,89,44,0.4787231232434025,0.896114474359754,1.3171738815285585,0.5809624498789558,371,353,388,430,59,42,77,53,-0.3763660065412038,0.22003991743971202,0.8065494597360614,0.8782224929202634,34091,34091,Bond+Effingham+Fayette,Effingham,17,49,Illinois,IL
17051,17CS002,190,181,199,226,36,27,45,34,-0.3270476410546365,0.07507125597731486,0.49520799626596385,0.9254537090448641,232,221,243,244,12,1,23,30,-1.602771083136869,-1.0168085380702414,-0.3518137385895595,2.2609128481427803,21304,21304,Bond+Effingham+Fayette,Fayette,17,51,Illinois,IL
17007,17CS003,356,333,379,401,45,22,68,57,-0.643884775780846,-0.23504777312775388,0.22921913514818382,1.2378364622514713,439,412,466,501,62,35,89,37,-0.059932469128652924,0.5686937006016624,1.1538108764913042,0.5884172842589084,53071,53071,Boone,Boone,17,7,Illinois,IL
17009,17CS004,49,49,50,60,11,10,11,2,1.225122927379333,1.326622788194798,1.4359955360144987,0.17002464884424687,61,60,61,67,6,6,7,8,-0.4413644025831407,-0.28371278733867483,-0.13547603781198378,1.0755769548636827,6589,6589,Brown and Nearby Counties,Brown,17,9,Illinois,IL
17013,17CS004,43,43,44,59,16,15,16,5,2.177139344399032,2.2800886852811386,2.388809274672761,0.2994594900266591,53,53,54,68,15,14,15,2,3.12812684018652,3.2886684397229295,3.4420848476771986,0.12618589955440584,4688,4688,Brown and Nearby Counties,Calhoun,17,13,Illinois,IL
17017,17CS004,118,117,119,140,22,21,23,27,-0.5097186460615709,-0.40924588298474895,-0.3072359746983699,1.1709892939551452,145,143,146,149,4,3,6,16,-1.3249541942755072,-1.1675823602444038,-1.0018924088078185,3.0126770475455684,12051,12051,Brown and Nearby Counties,Cass,17,17,Illinois,IL
17149,17CS004,177,170,184,217,40,33,47,39,-0.35539134089278873,0.0724083135744771,0.49377217921225003,0.9520863332159933,216,209,224,236,20,12,27,32,-1.5389600735473203,-0.9836890065078211,-0.34103463448887406,1.5547149229384565,15434,15434,Brown and Nearby Counties,Pike,17,149,Illinois,IL
17169,17CS004,77,77,78,80,3,2,3,4,-0.3076933063510331,-0.20267804560799346,-0.10539469135780176,1.107615046734616,95,94,96,108,13,12,14,3,1.6448460875584332,1.7934949968559728,1.9489948490884306,0.21162999203309055,6791,6791,Brown and Nearby Counties,Schuyler,17,169,Illinois,IL
17171,17CS004,51,50,51,59,8,8,9,4,0.7533478738620059,0.8583059480693029,0.9730165714309248,0.4314544901002956,62,62,63,69,7,6,7,6,0.041666470068319396,0.18474304042523962,0.3433340822711526,0.7702891870684783,4964,4964,Brown and Nearby Counties,Scott,17,171,Illinois,IL
17011,17CS005,338,324,351,417,79,66,93,57,0.2431541485233795,0.6871994241939811,1.1023669804597287,0.7086486873695202,413,396,430,447,34,17,51,51,-1.1847571863833493,-0.6126453976020546,-0.035835690005977534,1.4558311790027059,32488,32488,Bureau+Marshall+Putnam+Stark,Bureau,17,11,Illinois,IL
17123,17CS005,144,139,149,148,4,-1,9,6,-0.5586504548020661,-0.1443375208574293,0.2276724494352212,1.1187260355486006,175,169,181,184,9,3,15,17,-1.3996625077706497,-0.8316036176621259,-0.24548249423844348,1.707905492125309,11399,11399,Bureau+Marshall+Putnam+Stark,Marshall,17,123,Illinois,IL
17155,17CS005,50,49,50,42,-8,-8,-7,6,-2.5174361803207703,-2.410321424640008,-2.3086796828858023,-0.8779509514092515,61,60,62,71,10,9,11,8,0.2503923681350242,0.40543520516877635,0.5665394411456449,0.7324934835237972,5733,5733,Bureau+Marshall+Putnam+Stark,Putnam,17,155,Illinois,IL
17175,17CS005,62,62,63,77,15,14,15,12,0.37921656089019545,0.48163544780606937,0.5903121581429298,0.7712332742501263,76,76,77,97,21,20,21,4,3.6136991957130746,3.766660498461432,3.911918868088244,0.1849805171543709,5291,5291,Bureau+Marshall+Putnam+Stark,Stark,17,175,Illinois,IL
17015,17CS006,157,151,163,216,59,53,65,26,1.867719556109185,2.2966866485164394,2.723523087913675,0.4341583031446457,191,184,199,214,23,15,30,13,0.20342810851409754,0.8043430377853233,1.4164306140103162,0.5491352038752801,14298,14298,Carroll+Jo Daviess+Stephenson,Carroll,17,15,Illinois,IL
17085,17CS006,201,191,210,247,46,37,56,23,0.6754880003466346,1.0883455761159768,1.5441232561211302,0.48511089182124595,245,234,256,259,14,3,25,18,-0.8552716401621524,-0.21888499678168571,0.3835556537873554,1.2034936968970533,21230,21230,Carroll+Jo Daviess+Stephenson,Jo Daviess,17,85,Illinois,IL
17177,17CS006,457,438,476,573,116,97,135,64,0.7559647321049082,1.1828048767867188,1.590494707240424,0.5487451789288272,557,535,580,653,96,73,118,93,-0.568817311107652,0.05326342181207021,0.720666533887948,0.9606536528573649,44146,44146,Carroll+Jo Daviess+Stephenson,Stephenson,17,177,Illinois,IL
17019,17CS007,1143,1053,1233,1277,134,44,224,66,-0.12978924137471684,0.3312123975199886,0.7431131436974818,0.4902636724140076,1421,1313,1529,1643,222,114,330,128,-0.11459367360306988,0.5333121493200053,1.2585016669272495,0.5732215708246099,209437,209437,Champaign,Champaign,17,19,Illinois,IL
17021,17CS008,354,340,368,418,64,50,78,61,-0.34243183618894235,0.10347928790546454,0.540706534449736,0.9379310073321757,432,416,449,501,69,52,85,40,0.4158081141083864,1.074535531297637,1.6899931611909633,0.5730291571826965,32280,32280,Christian+Shelby,Christian,17,21,Illinois,IL
17173,17CS008,204,195,214,234,30,20,39,30,-0.4491669308339996,-0.02583131038914894,0.39964028922883427,0.9832862606728234,250,239,261,321,71,60,82,48,0.7051639023059659,1.261891212948032,1.8435741229010438,0.6691880402684101,21489,21489,Christian+Shelby,Shelby,17,173,Illinois,IL
17023,17CS009,162,155,168,191,29,23,36,18,0.2899057906819292,0.7325637715166446,1.1469918357872064,0.5982996332799451,196,188,204,234,38,30,46,30,0.03965476398512431,0.6327214265249994,1.2544665689467938,0.7697575147675088,15383,15383,Clark+Crawford+Cumberland+Jasper,Clark,17,23,Illinois,IL
17033,17CS009,185,177,193,195,10,2,18,29,-1.4212609321779914,-0.9983645028627901,-0.5571724320033468,2.540564091702448,224,214,233,240,16,7,26,27,-1.3369220997244808,-0.715549099724757,-0.0909202020883139,1.5588710565331991,18614,18614,Clark+Crawford+Cumberland+Jasper,Crawford,17,33,Illinois,IL
17035,17CS009,96,95,97,103,7,6,8,20,-1.3558125884647896,-1.2482380171881229,-1.1474465637824356,2.615692905357463,118,116,119,157,39,38,41,19,2.106191524062504,2.261316948776266,2.42272018439991,0.4727559233903602,10698,10698,Clark+Crawford+Cumberland+Jasper,Cumberland,17,35,Illinois,IL
17079,17CS009,84,83,85,87,3,2,4,13,-1.1827225043914364,-1.0768022741345806,-0.9653420047278853,3.5019451215020467,103,102,104,124,21,20,22,13,0.8391365156404511,0.9995815118746062,1.1405246251663586,0.5927516811395356,9554,9554,Clark+Crawford+Cumberland+Jasper,Jasper,17,79,Illinois,IL
17025,17CS010,155,150,161,176,21,15,26,29,-1.022465942284651,-0.6298363126635838,-0.18124500784815586,1.3304292771276127,189,183,196,182,-7,-14,-1,19,-3.0277630299958718,-2.423944510628238,-1.8336054441432534,-2.961377343258798,13136,13136,Clay+Hamilton+Wayne+White,Clay,17,25,Illinois,IL
17065,17CS010,87,87,88,107,20,19,20,11,0.957772938274173,1.0563927059809128,1.1678177273664858,0.533745898258306,107,106,108,103,-4,-5,-3,18,-3.444681399728775,-3.2948183673659095,-3.137948050369425,-5.495057890575259,8113,8113,Clay+Hamilton+Wayne+White,Hamilton,17,65,Illinois,IL
17191,17CS010,172,165,179,215,43,36,50,32,0.2761452823335779,0.7048646849377015,1.12723258090563,0.7233440897694219,210,202,218,242,32,24,40,29,-0.37409566246495474,0.2254968373479816,0.8254211622510906,0.8779116814089932,16127,16127,Clay+Hamilton+Wayne+White,Wayne,17,191,Illinois,IL
17193,17CS010,187,181,193,215,28,22,34,31,-0.6355449594329732,-0.2236797509181944,0.19674048218821374,1.0676780377497013,227,221,234,253,26,19,32,22,-0.3016565099943655,0.3183432161735847,0.9706134369778345,0.8277803859696161,13486,13486,Clay+Hamilton+Wayne+White,White,17,193,Illinois,IL
17027,17CS011,296,280,312,347,51,35,67,41,-0.15072530552665891,0.2762558096191563,0.685071701973371,0.784108922533239,361,341,380,364,3,-16,23,35,-1.6568812673265156,-1.038352168332989,-0.40514005289305155,8.099411921782142,37422,37422,Clinton+Marion,Clinton,17,27,Illinois,IL
17121,17CS011,434,418,450,567,133,117,149,51,1.8000143436194966,2.2105260854715656,2.6358660961413767,0.37968351987296106,526,507,545,593,67,48,86,67,-0.6219320920549856,-0.001188736786571125,0.634297891339196,0.9838781557617379,37199,37199,Clinton+Marion,Marion,17,121,Illinois,IL
17029,17CS012,428,407,450,524,96,74,117,50,0.4920609455347236,0.9129253620382628,1.3472993372445459,0.5168463628969497,524,498,550,597,73,47,99,64,-0.3653770603718425,0.1999280239057295,0.785439413085681,0.8670859440802896,50611,50611,Coles,Coles,17,29,Illinois,IL
17031,17CS013,34162,31963,36361,44691,10529,8330,12728,7636,0.14115281762392642,0.5726926168803791,1.0174862788246257,0.7251614112499715,42106,39468,44745,47065,4959,2320,7597,4196,-0.45790595374140824,0.2021089436680587,0.7995654757283761,0.8460230518876722,5129892,5129892,Cook,Cook,17,31,Illinois,IL
17037,17CS014,625,580,670,753,128,83,173,56,0.2693112942115255,0.6876995621802842,1.133682551885707,0.43371249989811095,773,720,827,892,119,65,172,69,-0.0421403109458748,0.5546093109069532,1.1773820775987243,0.5773883122079344,104864,104864,DeKalb,DeKalb,17,37,Illinois,IL
17039,17CS015,170,163,177,205,35,28,42,21,0.4977587726333808,0.9022265618408801,1.3478361432838386,0.5838322822105811,208,200,216,230,22,14,30,21,-0.5225347208929542,0.08392987227961185,0.669001704913802,0.9141561810193157,15517,15517,De Witt+Logan+Mason+Menard,De Witt,17,39,Illinois,IL
17107,17CS015,295,283,307,351,56,44,68,47,-0.1032751807719364,0.3172258690066138,0.7116639066277669,0.825175986053697,362,347,376,332,-30,-44,-15,30,-3.0943798414664037,-2.503346619178979,-1.9189164628574045,-1.0456668325850165,28529,28529,De Witt+Logan+Mason+Menard,Logan,17,107,Illinois,IL
17125,17CS015,157,152,163,193,36,30,41,33,-0.22518241997233787,0.21556623273851405,0.6332895082043145,0.900647972223723,192,185,199,222,30,23,37,20,0.276200045630033,0.8706251365137816,1.4780654607194688,0.6501944123888298,13298,13298,De Witt+Logan+Mason+Menard,Mason,17,125,Illinois,IL
17129,17CS015,106,104,107,111,5,4,7,12,-0.6410854266151857,-0.5425514448545636,-0.4365395278689539,1.8657562561837557,130,128,131,162,32,31,34,14,1.6318438812123552,1.7862179264761084,1.9465748767431885,0.4228261974788055,12144,12144,De Witt+Logan+Mason+Menard,Menard,17,129,Illinois,IL
17041,17CS016,167,159,176,200,33,24,41,29,-0.23409637641293696,0.182892836798479,0.6190824809609026,0.865346561943994,206,195,216,247,41,31,52,17,0.8798893687964316,1.4993454926792324,2.1508112436649323,0.4001508410409496,19475,19475,Douglas+Edgar+Moultrie+Piatt,Douglas,17,41,Illinois,IL
17045,17CS016,195,188,202,242,47,40,54,36,0.25921549786984643,0.6588191055772521,1.0871691918289128,0.7482115569965911,237,229,246,278,41,32,49,42,-0.7079154217001242,-0.1049274057119493,0.5539712012965886,1.0087837200389635,17039,17039,Douglas+Edgar+Moultrie+Piatt,Edgar,17,45,Illinois,IL
17139,17CS016,164,158,170,183,19,13,25,20,-0.4944193140180125,-0.11069851265591793,0.32140051391313995,1.002624869919593,200,193,207,216,16,9,23,19,-0.9047848499796664,-0.24983162129336942,0.2971445838374082,1.1189361990627507,14415,14415,Douglas+Edgar+Moultrie+Piatt,Moultrie,17,139,Illinois,IL
17147,17CS016,149,142,156,162,13,6,20,2,0.24001212126808283,0.6682073629719352,1.1013799247184641,0.1425046095187351,182,174,191,210,28,19,36,10,0.6691406450376871,1.2830319909113912,1.8932098626440599,0.35061723213631246,16376,16376,Douglas+Edgar+Moultrie+Piatt,Piatt,17,147,Illinois,IL
17043,17CS017,5321,4927,5716,6490,1169,774,1563,821,-0.05316445398077595,0.3804892760696099,0.8082366495044966,0.7019943221027725,6590,6116,7064,6991,401,-73,875,393,-0.6187523098831177,0.009192756636317998,0.608531801033688,0.9772054809673082,920561,920561,DuPage,DuPage,17,43,Illinois,IL
17047,17CS018,62,61,63,81,19,18,20,10,1.2857189858243199,1.3882822492006917,1.4839722422286978,0.5036920463561603,76,75,77,90,14,13,15,18,-0.9145427741012955,-0.7549594879185759,-0.5909954810820244,1.2004680693839087,6385,6385,Edwards+Lawrence+Richland+Wabash,Edwards,17,47,Illinois,IL
17101,17CS018,165,159,172,180,15,8,21,30,-1.403134179314692,-0.9924790626627067,-0.5486819599424716,1.905013323065875,200,192,208,197,-3,-11,5,20,-2.387952330287746,-1.758789486229432,-1.1418209440137495,-10.078908469883867,15582,15582,Edwards+Lawrence+Richland+Wabash,Lawrence,17,101,Illinois,IL
17159,17CS018,171,164,178,222,51,44,58,29,0.9865484201349736,1.3990029974568732,1.8797093384800214,0.5589424184958972,207,199,215,265,58,50,66,41,0.6889105662511025,1.2970911049639093,1.923491447222727,0.6976190126569048,15514,15514,Edwards+Lawrence+Richland+Wabash,Richland,17,159,Illinois,IL
17185,17CS018,122,117,127,139,17,12,22,15,-0.261771092649499,0.1680873763142438,0.6267073878376291,0.838797323175212,148,142,153,161,13,8,19,15,-0.8026039868712667,-0.17478052543931624,0.42261349239545537,1.0499313053941115,11295,11295,Edwards+Lawrence+Richland+Wabash,Wabash,17,185,Illinois,IL
17053,17CS019,166,160,172,203,37,31,43,24,0.6095647128763806,0.9990515006304059,1.4291124268110973,0.6314058589059852,202,195,209,237,35,28,42,20,0.713466751318842,1.397859518762052,1.9537799586874707,0.5573302815443587,12962,12962,Ford+Iroquois+Livingston,Ford,17,53,Illinois,IL
17075,17CS019,316,305,328,381,65,53,76,44,0.3361817272210059,0.7609391345172969,1.2290485098320112,0.6705096407539227,385,371,399,418,33,19,47,43,-1.093228896972218,-0.45790354531880245,0.1543945943204652,1.275706660793496,26934,26934,Ford+Iroquois+Livingston,Iroquois,17,75,Illinois,IL
17105,17CS019,372,357,387,420,48,33,63,54,-0.60733012735016,-0.16504672785860994,0.2529673749915749,1.099751672735315,454,436,473,482,28,9,46,64,-1.8857315433093365,-1.2466203006365426,-0.6295398669638569,2.2231210552259877,35497,35497,Ford+Iroquois+Livingston,Livingston,17,105,Illinois,IL
17055,17CS020,432,416,449,518,86,69,102,60,0.2565533355264712,0.66116229677512794,1.092310937231258,0.6936354927974161,527,508,547,643,116,96,135,88,0.2564442021875032,0.8758731956463282,1.477938211327362,0.7549225975539495,38334,38334,Franklin+Gallatin+Saline,Franklin,17,55,Illinois,IL
17059,17CS020,62,61,62,68,6,6,7,1,0.9855816009961856,1.0907243153653456,1.2016362615584917,0.13781554567332635,76,75,76,91,15,15,16,1,3.413034042957721,3.5657010734497114,3.72925672074399,0.06133260218582814,4816,4816,Franklin+Gallatin+Saline,Gallatin,17,59,Illinois,IL
17165,17CS020,305,295,315,330,25,15,35,41,-1.0934580838424366,-0.6615630608919308,-0.25575998838677577,1.560196467295505,371,359,383,423,52,40,64,53,-0.655473135904085,-0.03162585805097318,0.5592128157269447,0.9935350752975579,23391,23391,Franklin+Gallatin+Saline,Saline,17,165,Illinois,IL
17057,17CS021,393,378,407,450,57,43,72,31,0.3604484670501919,0.7697813874804925,1.2265815391356933,0.5328392147722408,480,463,497,515,35,18,52,55,-1.3020611360999896,-0.7076531733960889,-0.03511174147460965,1.5315377073513923,34011,34011,Fulton+McDonough,Fulton,17,57,Illinois,IL
17109,17CS021,266,253,279,318,52,39,65,31,0.26258298464227237,0.7181442821250166,1.146600777964769,0.5842810110681729,327,312,342,323,-4,-19,11,32,-2.0935986873113364,-1.455941676645019,-0.888245551828837,-11.405686424273792,29585,29585,Fulton+McDonough,McDonough,17,109,Illinois,IL
17061,17CS022,144,139,150,163,19,13,24,26,-0.9973667248998357,-0.5585989753383657,-0.11024381955453245,1.309103962114585,177,170,183,181,4,-2,11,19,-1.9932642773057698,-1.3605204336206134,-0.7661074906156481,3.5196574790458497,12830,12830,Greene+Jersey+Morgan,Greene,17,61,Illinois,IL
17083,17CS022,235,226,244,271,36,27,45,36,-0.4100806670884021,0.015263299074311648,0.41419688237767166,0.9681437374608264,288,277,300,317,29,17,40,29,-0.6438180033311455,0.0029996260514439667,0.5856239576416065,0.977764045137735,21646,21646,Greene+Jersey+Morgan,Jersey,17,83,Illinois,IL
17137,17CS022,345,330,359,414,69,55,84,54,0.04922042151626098,0.4606828774059627,0.8754737658509211,0.7675027316789677,424,406,441,437,13,-4,31,31,-1.240401245508555,-0.6398441956540999,-0.017448176795844057,2.1383539818529957,33563,33563,Greene+Jersey+Morgan,Morgan,17,137,Illinois,IL
17063,17CS023,359,337,381,466,107,85,129,44,0.8025300955045468,1.2299765959138806,1.6322770831663103,0.40833303293184864,444,417,470,527,83,57,110,55,-0.013041546599740717,0.6560304153060763,1.2987926973317896,0.6518188794916506,51015,51015,Grundy,Grundy,17,63,Illinois,IL
17067,17CS024,176,168,183,235,59,52,67,32,1.1190207035989448,1.5618350388725348,2.022171473200831,0.529262756019288,216,207,225,238,22,13,31,24,-0.7673014524708547,-0.13163990333032435,0.48166146143644956,1.044646128020835,17584,17584,Hancock+Henderson+Mercer+Warren,Hancock,17,67,Illinois,IL
17071,17CS024,72,72,73,95,23,22,23,15,1.0421589685231587,1.1493893415447074,1.2596749164448038,0.6345929264340505,89,88,90,109,20,19,21,10,1.6466209709867234,1.80544884196439,1.9645658530398973,0.47653239528923247,6636,6636,Hancock+Henderson+Mercer+Warren,Henderson,17,71,Illinois,IL
17131,17CS024,169,163,176,192,23,16,29,16,7.03968505427084e-4,0.4449280289920945,0.8785465742511489,0.6739771013188409,208,200,216,206,-2,-10,6,16,-1.9997712024562306,-1.3622854454891014,-0.7740166617088476,-20.963109518413443,15380,15380,Hancock+Henderson+Mercer+Warren,Mercer,17,131,Illinois,IL
17187,17CS024,163,156,170,218,55,48,62,31,1.0014104818042853,1.4442736783551509,1.8892451807708597,0.5524629015912802,201,192,209,215,14,6,23,28,-1.6017162877963467,-0.9939701662052076,-0.32548913826136555,1.8390670444332602,16766,16766,Hancock+Henderson+Mercer+Warren,Warren,17,187,Illinois,IL
17073,17CS025,448,427,469,583,135,114,156,64,1.0651291998180659,1.454448902101576,1.8898168270159148,0.47169140042256613,547,522,572,601,54,29,79,41,-0.3143293396674879,0.2950052571016025,0.9277684392775027,0.7510059200615922,48716,48716,Henry,Henry,17,73,Illinois,IL
17077,17CS026,406,382,430,535,129,105,153,68,0.6004992854932463,1.0625048808440172,1.4694186428568394,0.5226898604312592,501,472,530,611,110,81,139,64,0.369381886956575,0.9661580930953171,1.5836203699968188,0.5776754556977809,56774,56774,Jackson,Jackson,17,77,Illinois,IL
17081,17CS027,375,359,391,486,111,95,127,65,0.8097765338408802,1.2407627234720178,1.6540748618455459,0.5780991463611851,458,439,477,549,91,72,110,67,0.15969446862199124,0.7743644864411038,1.3939027328422327,0.7297854594250597,37468,37468,Jefferson+Washington,Jefferson,17,81,Illinois,IL
17189,17CS027,138,132,144,149,11,5,17,17,-0.8857550878294779,-0.4488540930739798,-3.9792683212007293e-4,1.4346130617950938,169,162,176,167,-2,-9,5,21,-2.613866430051638,-1.9831387624595607,-1.4137794177267358,-21.248770962658316,13858,13858,Jefferson+Washington,Washington,17,189,Illinois,IL
17089,17CS028,2804,2576,3033,3584,780,551,1008,513,0.06538973788193755,0.5136008179070953,0.9365880285779383,0.6571237535632515,3484,3210,3759,3905,421,146,695,326,-0.4398688990587332,0.20184397405344856,0.8000750708779611,0.7733019411866066,531758,531758,Kane,Kane,17,89,Illinois,IL
17091,17CS029,966,919,1013,1149,183,136,230,124,0.11602792418958109,0.5296064713234612,0.985253974853044,0.6747556918814179,1184,1127,1240,1378,194,138,251,132,0.07952955636763957,0.6869046115619561,1.295557735791869,0.6755088215894163,109163,109163,Kankakee,Kankakee,17,91,Illinois,IL
17093,17CS030,525,469,581,630,105,49,161,74,-0.23952326378320166,0.23839309509207496,0.6498751074762875,0.6995711063038892,659,592,727,781,122,54,189,61,-0.023958362115904006,0.5545149661963267,1.1739749610852954,0.4979578947982601,129624,129624,Kendall,Kendall,17,93,Illinois,IL
17095,17CS031,564,543,585,694,130,109,151,106,0.04448399838932463,0.49315683045332287,0.9203820357549948,0.8078502091433213,687,662,713,729,42,16,67,73,-1.3645038053761998,-0.7558834154605165,-0.14457145663034032,1.7159736904560297,49412,49412,Knox,Knox,17,95,Illinois,IL
17097,17CS032,3955,3656,4253,4865,910,612,1209,699,-0.11709618505647196,0.298822877837754,0.7237842876176046,0.7670844905651134,4904,4546,5262,5213,309,-49,667,373,-0.7198151825586391,-0.12802380441132066,0.49655840234334403,1.2038412577529276,695659,695659,Lake,Lake,17,97,Illinois,IL
17099,17CS033,1105,1059,1152,1295,190,143,236,180,-0.33216470082255584,0.09508535590198479,0.5352028754365429,0.9444325391635215,1350,1295,1406,1434,84,28,139,129,-1.1004923357872025,-0.5063834074489659,0.10477207989314959,1.5205622704361983,108123,108123,La Salle,La Salle,17,99,Illinois,IL
17103,17CS034,319,305,334,387,68,53,82,64,-0.3349464533867538,0.10354446120894173,0.5379254144684822,0.9331117193829952,392,375,410,420,28,10,45,39,-1.0198336446160574,-0.397397780578881,0.20154453382455678,1.3521189565664908,33888,33888,Lee+Whiteside,Lee,17,103,Illinois,IL
17195,17CS034,566,542,589,706,140,117,164,148,-0.5501972775431001,-0.16632309849582172,0.2885115650471757,1.0472686313556636,693,665,722,757,64,35,92,79,-0.9346075085451975,-0.34082301093194,0.2517304554388327,1.2205125854804773,54982,54982,Lee+Whiteside,Whiteside,17,195,Illinois,IL
17111,17CS035,1816,1684,1947,2165,349,218,481,234,-0.035368673118773175,0.36346934870176856,0.7955663194777417,0.6680092008676142,2248,2090,2406,2536,288,130,446,183,-0.1805565422975353,0.4216865826405666,1.0545138834535035,0.6325004963087293,306793,306793,McHenry,McHenry,17,111,Illinois,IL
17113,17CS036,1027,953,1101,1220,193,119,267,110,0.033675215103943466,0.47499176242568564,0.932883786595095,0.5673670564374261,1272,1184,1361,1411,139,50,227,145,-0.6828246477043199,-0.057028514719474316,0.5494912438166504,1.03866804165637,171265,171265,McLean,McLean,17,113,Illinois,IL
17115,17CS037,1040,996,1085,1242,202,157,246,142,0.17550290938984803,0.5626916950422937,0.9897820052276296,0.7004804573222672,1273,1220,1326,1433,160,107,213,136,-0.34013470093778175,0.3004364680913694,0.8754289523693849,0.8456567614567383,103597,103597,Macon,Macon,17,115,Illinois,IL
17117,17CS038,468,449,488,568,100,80,119,66,0.3129131902203519,0.7276343871510325,1.1849365176589954,0.6561790847663802,572,549,595,646,74,51,97,70,-0.5466596089110144,0.14085977804183086,0.7327558278295652,0.9300052250994303,44866,44866,Macoupin+Montgomery,Macoupin,17,117,Illinois,IL
17135,17CS038,299,287,311,360,61,49,73,29,0.6656560590134154,1.1361516563322556,1.5343674225151562,0.4695704040665217,365,351,380,459,94,79,108,69,0.42287587787998615,1.084148722036483,1.6619243117568288,0.7271421257524577,28253,28253,Macoupin+Montgomery,Montgomery,17,135,Illinois,IL
17119,17CS039,2446,2333,2559,2909,463,350,576,294,0.2321057504081865,0.650053458506414,1.0584681240682257,0.6337468454427637,3000,2865,3136,3374,374,238,509,319,-0.40980087442178115,0.22402202563124818,0.8947592920820379,0.8514051260962069,263203,263203,Madison,Madison,17,119,Illinois,IL
17133,17CS040,263,248,278,302,39,24,54,45,-0.6170090702755495,-0.17518635058542364,0.25824087642160154,1.119970956561172,324,307,342,358,34,16,51,35,-0.6506811578834222,-0.05445298795450863,0.5245616066914589,1.013171530113012,34738,34738,Monroe+St. Clair,Monroe,17,133,Illinois,IL
17163,17CS040,2187,2076,2298,2685,498,387,609,324,0.2453190642841741,0.6684840806137687,1.098855824409256,0.6498344228454161,2691,2557,2824,3066,375,242,509,295,-0.2974743036379372,0.3651880055833516,0.9866357663439445,0.7838688432426695,259121,259121,Monroe+St. Clair,St. Clair,17,163,Illinois,IL
17141,17CS041,439,417,460,518,79,58,101,52,0.13316920025558163,0.5598153302774469,0.9806056778084145,0.6460875109143345,538,512,564,592,54,28,80,49,-0.5430202648703085,0.12619303508736,0.6902238491353581,0.8944258494016405,50512,50512,Ogle,Ogle,17,141,Illinois,IL
17143,17CS042,1514,1437,1590,1770,256,180,333,146,0.2002562079224031,0.6158619418606724,1.0301197905164787,0.5676591227852514,1851,1760,1943,2148,297,205,388,211,-0.003181419867134829,0.6064930260142681,1.1408983800367638,0.7090086838537135,178648,178648,Peoria+Woodford,Peoria,17,143,Illinois,IL
17203,17CS042,324,308,341,383,59,42,75,46,-0.07271413918307484,0.3438887342394523,0.7329356438529612,0.770527898346055,397,377,416,421,24,5,44,58,-1.666246948803879,-1.0525370851182556,-0.4702057585883077,2.294437815903876,38244,38244,Peoria+Woodford,Woodford,17,203,Illinois,IL
17145,17CS043,195,187,204,232,37,28,45,29,-0.07622924780592939,0.37224913145555855,0.8251359795221949,0.771330519686795,238,228,249,301,63,52,73,40,0.7291227219023667,1.2991638234411353,1.932569470586609,0.6269985376469315,20822,20822,Perry+Randolph,Perry,17,145,Illinois,IL
17157,17CS043,306,293,320,362,56,42,69,51,-0.2674596995423456,0.13976085566513977,0.57731348774721,0.9008585087443516,373,357,390,444,71,54,87,50,0.1782024423329094,0.7748180931624984,1.4668223977163577,0.6976816416557101,31569,31569,Perry+Randolph,Randolph,17,157,Illinois,IL
17161,17CS044,1337,1276,1397,1652,315,255,376,192,0.44214142324501016,0.8925483841626273,1.3200932516613908,0.6068447236282036,1637,1564,1710,1776,139,66,212,160,-0.7738036030443687,-0.15478271659184126,0.4249128617164444,1.141648098052109,141413,141413,Rock Island,Rock Island,17,161,Illinois,IL
17167,17CS045,1667,1583,1750,1899,232,149,316,190,-0.2133393803025621,0.21204273371751178,0.6622401178756829,0.8149808462238601,2044,1944,2145,2118,74,-27,174,141,-1.0437186144935835,-0.43898098257619933,0.18171936323257923,1.8903281024349194,194465,194465,Sangamon,Sangamon,17,167,Illinois,IL
17003,17CS046,75,74,75,99,24,24,25,11,2.2361683897106372,2.3403622632388426,2.449324427879248,0.4355580796396253,92,91,92,103,11,11,12,12,-0.28798852489798665,-0.15408270372192204,0.004470042983685312,0.9773765511516244,5668,5668,Southern Illinois,Alexander,17,3,Illinois,IL
17069,17CS046,54,53,54,62,8,8,9,10,-0.5269948671797468,-0.4225256443215357,-0.3148230742686527,1.0652787840197615,66,65,66,83,17,17,18,11,1.7996030914671866,1.9565720593189795,2.109574623996659,0.6029600583548191,3831,3831,Southern Illinois,Hardin,17,69,Illinois,IL
17087,17CS046,130,124,135,140,10,5,16,16,-0.8898127063006097,-0.45732422066205636,-0.02252986504278409,1.4049187569616268,160,153,166,175,15,9,22,32,-2.2881698980042375,-1.593427291965822,-0.9869554281996696,1.9452946229733188,12371,12371,Southern Illinois,Johnson,17,87,Illinois,IL
17127,17CS046,176,170,182,200,24,18,30,23,-0.3316741302325226,0.07947702589814518,0.5262283293038335,0.9184927907516329,215,208,222,239,24,17,31,29,-1.0491467038479354,-0.4579663874074696,0.08150271414887617,1.1803002833347476,13715,13715,Southern Illinois,Massac,17,127,Illinois,IL
17151,17CS046,44,43,44,42,-2,-2,-1,6,-2.0106633698829635,-1.9013972892287758,-1.7942052022361528,-6.5259816015193675,54,53,55,71,17,16,18,12,1.276620353760057,1.4391834631338642,1.5869698174186855,0.667167364039226,4162,4162,Southern Illinois,Pope,17,151,Illinois,IL
17153,17CS046,67,67,68,68,1,-0,1,7,-1.3351924193152045,-1.2332072566902714,-1.1268071954508423,4.611222409366654,83,82,84,107,24,23,25,16,1.6881852175456458,1.8615473141478394,2.018925092766597,0.635685421771995,5264,5264,Southern Illinois,Pulaski,17,153,Illinois,IL
17181,17CS046,193,186,201,231,38,30,45,22,0.48735635010479,0.9452887973885741,1.3588051892881006,0.5711789569341366,237,229,246,278,41,32,49,32,0.01843003024154042,0.6063247065045543,1.2398197246737042,0.7681257254739584,16612,16612,Southern Illinois,Union,17,181,Illinois,IL
17179,17CS047,1181,1125,1237,1421,240,184,296,112,0.5459737962252612,0.9762641140966127,1.3808577364020134,0.46472754990390147,1444,1377,1512,1718,274,206,341,165,0.38651198402444464,0.9839864178789364,1.6149547372339228,0.6004561955030288,131402,131402,Tazewell,Tazewell,17,179,Illinois,IL
17183,17CS048,808,776,840,928,120,88,152,84,0.03868960629331921,0.4760312887409266,0.8939627791679393,0.6943419161826467,986,948,1025,1186,200,161,238,157,0.10350840674881384,0.6854422930690622,1.2762792577783484,0.7821592720729614,75369,75369,Vermilion,Vermilion,17,183,Illinois,IL
17197,17CS049,3987,3690,4283,4966,979,683,1276,644,0.04547039381401739,0.47627411424608107,0.9298485925290324,0.6569715119944015,4947,4591,5303,5524,577,221,933,461,-0.3674484643693942,0.19395895798288265,0.8026719550262026,0.7973233920496237,689572,689572,Will,Will,17,197,Illinois,IL
17199,17CS050,632,604,661,744,112,83,140,76,0.1055467283501901,0.546638927632204,0.9686951054620412,0.6737180105762921,772,738,807,889,117,82,151,97,-0.24814984390836978,0.36309421706736666,0.9293345148725559,0.8251670748029029,66542,66542,Williamson,Williamson,17,199,Illinois,IL
17201,17CS051,2512,2391,2633,2933,421,300,542,323,-0.07226384732356904,0.3342387151660174,0.7594762005801987,0.7657833075178913,3079,2934,3224,3540,461,316,606,303,0.049356198404109,0.6599605288767653,1.327301311420912,0.6559507805829317,281978,281978,Winnebago,Winnebago,17,201,Illinois,IL
18001,18CS001,271,256,287,336,65,49,80,43,0.19996559415801382,0.592875027404643,1.0283894950370875,0.6535879748042861,333,315,352,382,49,30,67,55,-0.8062195388236253,-0.24213440654498197,0.4131700269781718,1.1104670947283377,35751,35751,Adams+Wells,Adams,18,1,Indiana,IN
18179,18CS001,260,248,273,315,55,42,67,46,-0.11059515366037828,0.30375089647110987,0.7409671003969975,0.8273940814409015,319,304,333,363,44,30,59,54,-1.0109306580536082,-0.404806590190844,0.19860242355620844,1.1920562634748666,28136,28136,Adams+Wells,Wells,18,179,Indiana,IN
18003,18CS002,2930,2766,3095,3470,540,375,704,428,-0.15518901808417782,0.2909856373377645,0.7192531906271373,0.79153150534354,3608,3411,3806,3911,303,105,500,387,-0.8780319309414779,-0.25031037977324067,0.3453378237996085,1.2748194513500521,380331,380331,Allen,Allen,18,3,Indiana,IN
18005,18CS003,646,610,683,726,80,43,116,101,-0.672117057308931,-0.2462680296333952,0.19622956366222033,1.2544333364856795,792,748,835,892,100,57,144,87,-0.4210732732626957,0.1777754530025647,0.8132140085239167,0.8584705233543525,84223,84223,Bartholomew+Brown,Bartholomew,18,5,Indiana,IN
18013,18CS003,144,137,150,172,28,22,35,18,0.24695488593551237,0.6667556454918017,1.065415782438748,0.6162515012509787,175,168,183,204,29,21,36,23,-0.18576844011930696,0.4420721987685935,1.0830257748553436,0.7765220953471175,15085,15085,Bartholomew+Brown,Brown,18,13,Indiana,IN
18007,18CS004,74,73,75,95,21,20,22,11,1.0389597432142479,1.138485626006065,1.2469626994597474,0.5008119103357976,91,90,92,106,15,14,16,11,0.38548156825262087,0.5415798037757799,0.6992009592362547,0.6888514640188255,8754,8754,Benton+Jasper+Newton,Benton,18,7,Indiana,IN
18073,18CS004,280,266,295,350,70,55,84,34,0.615425555033214,1.0753605393685255,1.473592935019897,0.48143163604133166,345,327,362,425,80,63,98,75,-0.45546593895406096,0.17937219512763258,0.7616632346994029,0.9219617751407779,33484,33484,Benton+Jasper+Newton,Jasper,18,73,Indiana,IN
18111,18CS004,148,142,154,163,15,9,21,23,-0.9742685609761945,-0.5343159261096118,-0.09691156392776654,1.401682999212007,180,173,188,223,43,35,50,31,0.3796173851681215,0.9729827141211487,1.6365106534340172,0.712249649401387,13945,13945,Benton+Jasper+Newton,Newton,18,111,Indiana,IN
18009,18CS005,143,138,148,173,30,25,35,22,0.228543201777822,0.6439822093856139,1.0502797644550463,0.7179813584771738,176,169,182,204,28,22,35,35,-1.2637762396444379,-0.6654585626585056,-0.026625188238013145,1.1866540346949128,11785,11785,Blackford+Jay+Randolph,Blackford,18,9,Indiana,IN
18075,18CS005,199,190,208,226,27,18,36,34,-0.7585804219189556,-0.3407623178283913,0.05395182554512925,1.2066124992897547,245,234,255,297,52,42,63,38,0.18454893462654423,0.8549113523366203,1.5427061020505721,0.7114612240347343,20434,20434,Blackford+Jay+Randolph,Jay,18,75,Indiana,IN
18135,18CS005,260,249,270,327,67,57,78,56,0.06101541332193893,0.47042723687560506,0.8812350461137469,0.8188217064627524,318,306,331,415,97,84,109,54,1.4639865584001137,2.0998348530931294,2.7240277717632613,0.5527361066041457,24390,24390,Blackford+Jay+Randolph,Randolph,18,135,Indiana,IN
18011,18CS006,477,448,507,511,34,4,63,76,-1.0354661593534396,-0.6265064298038795,-0.19978145437195624,2.191662367425585,588,552,624,640,52,16,88,54,-0.6557028145305452,-0.038018578175945464,0.63252951232036,1.0140656227168081,68512,68512,Boone,Boone,18,11,Indiana,IN
18015,18CS007,162,153,170,165,3,-5,12,18,-1.163416234297955,-0.7212226081025919,-0.2820646826993027,4.039685309573781,197,186,207,235,38,28,49,34,-0.37208359362183724,0.25557230748684934,0.8436513466186834,0.8650474651540694,20218,20218,Carroll+Clinton,Carroll,18,15,Indiana,IN
18023,18CS007,310,296,323,387,77,64,91,35,0.8814169502564649,1.3059077167691264,1.7475773098350398,0.4462695482632349,376,359,393,433,57,40,74,49,-0.3153331120338115,0.30131473185996677,0.950215651380103,0.843370497931587,32260,32260,Carroll+Clinton,Clinton,18,23,Indiana,IN
18017,18CS008,355,339,371,450,95,79,111,75,0.10614552287914777,0.5445066000305289,0.9295854520345741,0.7805609142403415,435,415,454,495,60,41,80,63,-0.7205622199674259,-0.08793064826499379,0.5446726087693147,1.0256229891711013,37518,37518,Cass+White,Cass,18,17,Indiana,IN
18181,18CS008,252,242,263,279,27,16,37,31,-0.57512977004054,-0.17602087234360803,0.2175256422331574,1.1124973994297143,308,296,321,515,207,194,219,52,7.075035587386865,7.649736894919566,8.299060118561389,0.2503301842331958,24184,24184,Cass+White,White,18,181,Indiana,IN
18019,18CS009,1099,1048,1151,1253,154,102,205,129,-0.20470290834772875,0.2078578718266033,0.6397091385857113,0.8340751177235513,1348,1286,1410,1536,188,126,250,181,-0.5282896205747768,0.07013794351831525,0.6789899818858135,0.9574401610675721,118639,118639,Clark+Scott,Clark,18,19,Indiana,IN
18143,18CS009,275,265,285,333,58,48,68,38,0.45599741769662794,0.8534434260254848,1.2614031682564262,0.641713773960083,335,323,347,437,102,90,114,55,1.7218939220122833,2.3644067892743794,3.0122846914290893,0.5349816937446348,23827,23827,Clark+Scott,Scott,18,143,Indiana,IN
18021,18CS010,256,245,267,317,61,50,72,32,0.7068250062910366,1.106068348696097,1.536354499590525,0.5144274663532256,310,297,324,350,40,26,53,36,-0.49765733861662376,0.17650276192248843,0.8420858077359643,0.8830355671846071,26278,26278,Clay+Sullivan+Vermillion+Vigo,Clay,18,21,Indiana,IN
18153,18CS010,194,185,203,225,31,22,40,28,-0.23265029188123548,0.13745427670863622,0.5691256407557751,0.8695471645380585,235,225,246,274,39,28,49,30,-0.15203708014114603,0.5130393694258101,1.151442304833459,0.7528198113295812,20591,20591,Clay+Sullivan+Vermillion+Vigo,Sullivan,18,153,Indiana,IN
18165,18CS010,174,167,180,195,21,15,28,26,-0.7319055621501965,-0.28657077241722473,0.11281882337680334,1.1583909049431045,210,202,218,233,23,15,31,27,-0.9181983061310407,-0.3297435498131058,0.25567250093138477,1.1260862101397167,15425,15425,Clay+Sullivan+Vermillion+Vigo,Vermillion,18,165,Indiana,IN
18167,18CS010,958,912,1004,1144,186,140,232,138,0.01750399172165694,0.4631715840323373,0.8842796031795589,0.7380734865588428,1163,1108,1218,1348,185,130,240,128,0.05829374508918888,0.6403746340982206,1.2727948066553967,0.6876019201237915,106812,106812,Clay+Sullivan+Vermillion+Vigo,Vigo,18,167,Indiana,IN
18025,18CS011,106,105,107,124,18,17,19,11,0.578673118752121,0.6822382620660657,0.7857862929796413,0.5719968391621055,130,129,131,166,36,35,37,26,0.9810546811585458,1.133540663883189,1.3024264752555037,0.7023012644212933,10608,10608,Crawford+Harrison+Perry,Crawford,18,25,Indiana,IN
18061,18CS011,360,342,377,403,43,26,61,41,-0.4368532632162382,0.06963589072474988,0.46782587707489576,0.9311190081223497,443,422,464,542,99,78,120,72,0.15107468094470308,0.7940832899898644,1.4115596957777719,0.7199162995301627,40606,40606,Crawford+Harrison+Perry,Harrison,18,61,Indiana,IN
18123,18CS011,190,182,199,210,20,11,28,25,-0.6797480172376933,-0.26568161206512975,0.1540010620798419,1.2102023447360206,234,224,243,244,10,1,20,32,-1.970234571567864,-1.3317101232849566,-0.6855893404662045,2.786708907885951,19172,19172,Crawford+Harrison+Perry,Perry,18,123,Indiana,IN
18027,18CS012,293,278,307,336,43,29,58,70,-1.2398478456482052,-0.8063492809516661,-0.3559462581215679,1.5823545511917076,360,343,377,343,-17,-34,0,38,-2.557508459385956,-1.9846297565436872,-1.355224034774655,-2.3566271880797665,33466,33466,Daviess+Knox+Martin,Daviess,18,27,Indiana,IN
18083,18CS012,376,361,392,477,101,85,116,68,0.4443636044542101,0.911972059996567,1.3083455779328415,0.6688748594510283,461,442,480,503,42,23,61,43,-0.6184121353204529,-0.04451943505523113,0.5729270967105009,1.001345072797282,36569,36569,Daviess+Knox+Martin,Knox,18,83,Indiana,IN
18101,18CS012,93,92,94,95,2,1,3,10,-0.8690655819855105,-0.7660860072218696,-0.6637845842083162,3.088636128669573,114,113,115,128,14,13,15,5,0.9025161418650348,1.0661856673878412,1.2196277810771587,0.33389395959098067,10137,10137,Daviess+Knox+Martin,Martin,18,101,Indiana,IN
18029,18CS013,428,407,450,474,46,24,67,58,-0.665643874457462,-0.2533856872988597,0.18907622660906645,1.2450500594992162,526,500,551,616,90,65,116,84,-0.5035198390056174,0.16577598303139152,0.8034923607758973,0.919942780720205,49678,49678,Dearborn+Ohio+Ripley+Switzerland,Dearborn,18,29,Indiana,IN
18115,18CS013,57,56,57,66,9,9,10,16,-1.2319724222509014,-1.1182828874243567,-1.0166720794854174,1.5395643694397285,69,69,70,89,20,19,20,2,3.4209517423057196,3.5727101284363334,3.7239734107168583,0.09725803701660636,5901,5901,Dearborn+Ohio+Ripley+Switzerland,Ohio,18,115,Indiana,IN
18137,18CS013,260,248,273,332,72,59,84,43,0.5877044841655876,1.0160624929424134,1.4453824057264955,0.5913212243054029,319,304,334,420,101,86,116,74,0.5389714426910263,1.1509080278926416,1.773199513749722,0.7241666109307171,28458,28458,Dearborn+Ohio+Ripley+Switzerland,Ripley,18,137,Indiana,IN
18155,18CS013,93,91,94,90,-3,-4,-1,6,-0.9098217980697836,-0.7979444349129371,-0.689615090463718,-3.774201378994724,114,112,115,116,2,1,4,12,-1.2398099060624124,-1.0735766095804649,-0.9210336471791929,3.6189166204112637,10777,10777,Dearborn+Ohio+Ripley+Switzerland,Switzerland,18,155,Indiana,IN
18031,18CS014,248,236,259,332,84,73,96,61,0.4394968504357276,0.8714589178825998,1.3031673198326685,0.714916539393042,304,291,318,331,27,13,40,38,-1.105585508819513,-0.5059593135344372,0.05348297171813726,1.3767838277409534,26519,26519,Decatur+Shelby,Decatur,18,31,Indiana,IN
18145,18CS014,407,387,426,492,85,66,105,62,0.07726393866296064,0.5150941922034142,0.9649433236629575,0.718083734312846,500,477,523,541,41,18,64,69,-1.3893359011685487,-0.744066708066422,-0.12890136452372167,1.644330348642336,44813,44813,Decatur+Shelby,Shelby,18,145,Indiana,IN
18033,18CS015,367,348,386,458,91,72,110,63,0.2403846241767877,0.6345423027420837,1.0524010538305293,0.6847079185691259,450,427,472,489,39,17,62,55,-1.0146627194302382,-0.45234951841865845,0.20297087639395803,1.3673405854408034,43606,43606,DeKalb+Steuben,DeKalb,18,33,Indiana,IN
18151,18CS015,279,264,294,306,27,12,42,32,-0.570895227476447,-0.14707004016374198,0.2517837296748885,1.1601977004401731,343,325,361,395,52,34,70,60,-0.8551226155546094,-0.23836813311861504,0.37477523449730227,1.1272760622988143,34789,34789,DeKalb+Steuben,Steuben,18,151,Indiana,IN
18035,18CS016,1116,1067,1164,1343,227,179,276,120,0.5287876471514232,0.9405835391437701,1.3488356162487696,0.5254839902657723,1370,1312,1429,1554,184,125,242,183,-0.5906944956529824,0.0017881503469197326,0.5927821652155463,0.990112315535781,113638,113638,Delaware,Delaware,18,35,Indiana,IN
18037,18CS017,350,332,368,412,62,44,80,55,-0.28337520193445964,0.1562069958267897,0.623760572507888,0.8735924776407943,428,406,450,534,106,84,128,62,0.6453069242855374,1.2289919721827902,1.8666567147373627,0.5809569386968269,42563,42563,Dubois+Pike+Spencer,Dubois,18,37,Indiana,IN
18125,18CS017,141,135,146,154,13,8,19,25,-1.3120522628856954,-0.9427951685613836,-0.5122296976844172,1.727827714654822,171,165,177,189,18,12,24,16,-0.45337649967332905,0.19654033248389752,0.7683542278864559,0.8436466230996035,12381,12381,Dubois+Pike+Spencer,Pike,18,125,Indiana,IN
18147,18CS017,173,164,181,195,22,14,31,12,0.07709773059756411,0.4989079799246803,0.9163518871465731,0.5146681642236648,211,201,222,280,69,58,79,43,0.8835729616750606,1.5261102244648261,2.1697057003300437,0.6152144373108377,20253,20253,Dubois+Pike+Spencer,Spencer,18,147,Indiana,IN
18039,18CS018,1484,1396,1573,1781,297,208,385,331,-0.6303199419941098,-0.16692166253853857,0.25847032002116366,1.111944926812757,1826,1720,1933,2089,263,156,369,219,-0.3609903173779274,0.25194659722494045,0.8985156581447389,0.8296952801566939,206223,206223,Elkhart,Elkhart,18,39,Indiana,IN
18041,18CS019,277,267,287,344,67,57,77,44,0.583466272414198,1.000476005775536,1.4472279773579426,0.6480388838362017,338,326,350,390,52,40,64,61,-1.0852052509946046,-0.47839282655215976,0.1169155056230372,1.154614532478422,22977,22977,Fayette+Franklin+Union,Fayette,18,41,Indiana,IN
18047,18CS019,187,177,197,249,62,52,72,30,1.0012423063498181,1.4145160416943727,1.8459623746614562,0.4752477879800263,230,218,242,262,32,20,44,36,-0.8426165435869419,-0.2134904903943537,0.3910902017062979,1.0922368625087742,22762,22762,Fayette+Franklin+Union,Franklin,18,47,Indiana,IN
18161,18CS019,64,64,65,94,30,29,30,1,3.903877364615128,4.0080299347967445,4.116357661088472,0.03272297203121419,79,78,80,89,10,9,11,19,-1.7142682470667343,-1.5530570909889776,-1.3915954132674038,1.7609857654753645,7128,7128,Fayette+Franklin+Union,Union,18,161,Indiana,IN
18043,18CS020,710,676,744,830,120,86,154,87,-1.8731037850742144e-4,0.43140547070917623,0.8447778284606121,0.7190074775521349,873,833,914,955,82,41,122,95,-0.834094884540272,-0.21563286386938213,0.41394311953757545,1.149924132422155,78741,78741,Floyd,Floyd,18,43,Indiana,IN
18045,18CS021,189,182,196,227,38,31,45,26,0.2541761011352497,0.7116230618817636,1.1343403436757096,0.6723970385806592,232,223,240,258,26,18,35,34,-1.231319523776056,-0.556407956346421,0.01625951187133594,1.2560938205566834,16461,16461,Fountain+Montgomery+Warren,Fountain,18,45,Indiana,IN
18107,18CS021,357,340,373,405,48,32,65,63,-0.8288659857727073,-0.38262898287806363,0.04883963880607509,1.284936210869174,439,419,459,487,48,28,68,63,-1.0896200901275621,-0.5008032043290859,0.1505235657131724,1.2913609060710927,38312,38312,Fountain+Montgomery+Warren,Montgomery,18,107,Indiana,IN
18171,18CS021,72,71,72,105,33,33,34,8,2.9835564322839456,3.0951327648159124,3.2050785074501187,0.23203391763809414,88,87,89,98,10,9,11,11,-0.29094537758018685,-0.13005267143676938,0.022504944461250034,0.9932619015751959,8234,8234,Fountain+Montgomery+Warren,Warren,18,171,Indiana,IN
18049,18CS022,209,200,217,237,28,20,37,31,-0.5436928559856766,-0.12802935217099928,0.31365645318448376,1.0533279550847297,255,245,266,293,38,27,48,41,-0.8086067156608636,-0.21609988695603255,0.39326632312705356,1.0626759055656956,20032,20032,Fulton+Miami+Wabash,Fulton,18,49,Indiana,IN
18103,18CS022,329,314,344,387,58,43,73,37,0.1573712212718827,0.6055349854992961,1.010187609553518,0.6259579379255692,404,385,422,519,115,97,134,77,0.6678535238353546,1.291503009907937,1.9329214827676966,0.6616437718569372,35421,35421,Fulton+Miami+Wabash,Miami,18,103,Indiana,IN
18169,18CS022,378,365,391,434,56,43,69,54,-0.36522788674971374,0.06827503801347964,0.5025671383622216,0.9453171444162478,461,445,477,530,69,53,85,62,-0.38175391425152616,0.27810637264511345,0.8918057778664938,0.8867570770428154,30926,30926,Fulton+Miami+Wabash,Wabash,18,169,Indiana,IN
18051,18CS023,313,299,328,382,69,54,83,71,-0.5037001882093738,-0.059381219131189815,0.3570120251991027,1.0172147243619318,383,366,401,400,17,-1,34,48,-1.7375857883586354,-1.106543917661333,-0.5180726113497609,2.7318670002014542,33757,33757,Gibson+Posey,Gibson,18,51,Indiana,IN
18129,18CS023,210,199,221,233,23,12,34,23,-0.45360229131100266,-0.0022606017171712166,0.4285383133510235,0.966109782916148,258,245,271,255,-3,-16,10,20,-1.744628916322237,-1.0741797803744981,-0.49328451831624903,-11.725425977164987,25353,25353,Gibson+Posey,Posey,18,129,Indiana,IN
18053,18CS024,713,685,741,892,179,151,207,120,0.4983835208692338,0.8859587299437791,1.3394437237490255,0.6673857198260038,872,838,906,1121,249,215,283,144,1.2962142400394063,1.9034199954188966,2.5787058370864786,0.575991655284536,65581,65581,Grant,Grant,18,53,Indiana,IN
18055,18CS025,336,322,350,367,31,17,45,55,-1.1804007922433553,-0.7510099336192845,-0.3002967240967583,1.7006626856599056,411,395,428,447,36,19,52,40,-0.7442388797871797,-0.16250970634949088,0.4855716242217995,1.0942428328598042,32153,32153,Greene+Owen+Parke+Putnam,Greene,18,55,Indiana,IN
18119,18CS025,203,201,205,259,56,54,58,23,1.4686348946210852,1.5735580739229966,1.680777093037738,0.40496214681800147,250,247,252,74,-176,-178,-173,21,-11.45905216728642,-11.305807092735249,-11.146242671645876,-0.12031850700708999,20861,20861,Greene+Owen+Parke+Putnam,Owen,18,119,Indiana,IN
18121,18CS025,147,140,154,150,3,-4,10,13,-1.0090399059312825,-0.5839234160144039,-0.1841887292286043,3.434615502448555,181,172,190,194,13,4,22,31,-1.9023504735588401,-1.2753853569389462,-0.6709345155838651,2.2340405794949634,16884,16884,Greene+Owen+Parke+Putnam,Parke,18,121,Indiana,IN
18133,18CS025,316,300,332,363,47,31,63,38,-0.17606440678592924,0.2574357823154355,0.6645238476150661,0.7897238329910655,389,370,408,441,52,33,71,51,-0.6128063262928215,0.04935919860600078,0.6667140571497976,0.9611069778514457,37526,37526,Greene+Owen+Parke+Putnam,Putnam,18,133,Indiana,IN
18057,18CS026,1615,1467,1762,1971,356,209,504,274,-0.19372025114597538,0.2377551805498223,0.6533500490257884,0.7665955167715335,2021,1844,2199,2310,289,111,466,168,-0.2129080085865413,0.4343659722711313,1.0540281041726356,0.5800961955539354,340573,340573,Hamilton,Hamilton,18,57,Indiana,IN
18059,18CS027,598,563,632,659,61,27,96,81,-0.6677649688694322,-0.23678369906176183,0.22024336330459077,1.296837764881196,734,693,775,917,183,142,224,104,0.6054574458609284,1.1916298472512012,1.833424328076641,0.5655346536125159,78740,78740,Hancock,Hancock,18,59,Indiana,IN
18063,18CS028,1089,1014,1163,1288,199,125,274,189,-0.3746307899764292,0.05732854617516559,0.4966742281236467,0.9429869615741817,1349,1259,1438,1457,108,19,198,157,-0.9686420161687481,-0.345212396883875,0.328002201051412,1.437664037911646,171310,171310,Hendricks,Hendricks,18,63,Indiana,IN
18065,18CS029,506,485,526,622,116,96,137,63,0.6770337456440033,1.1154941586781277,1.531290338905693,0.5375622459129723,617,592,642,734,117,92,142,109,-0.4025545243211008,0.17531954871523675,0.7766143013315862,0.9232799811166248,48028,48028,Henry+Rush,Henry,18,65,Indiana,IN
18139,18CS029,169,162,176,183,14,7,21,17,-0.6058695153220549,-0.173482624577254,0.25087606097120224,1.1185122854136427,206,197,215,220,14,5,23,21,-1.107811248054671,-0.5184291306330746,0.0958991035594683,1.4058577668362424,16623,16623,Henry+Rush,Rush,18,139,Indiana,IN
18067,18CS030,913,877,949,1064,151,115,187,137,-0.2738269888938851,0.16353242443500438,0.5835984505463961,0.9015604372194829,1116,1074,1159,1332,216,173,258,184,-0.13293411824259768,0.43651101078395765,1.140443010969132,0.8491362717642899,82690,82690,Howard+Tipton,Howard,18,67,Indiana,IN
18159,18CS030,162,155,168,186,24,18,31,36,-1.1910058822599188,-0.7947904059706654,-0.35213817726777163,1.4320151772184668,198,190,206,230,32,24,40,36,-0.9489025684587944,-0.32922161532945343,0.34064589751928576,1.0949701247247754,15172,15172,Howard+Tipton,Tipton,18,159,Indiana,IN
18069,18CS031,355,339,370,426,71,56,87,44,0.30189760654468706,0.7501937708935236,1.153573219878291,0.6094917399265632,434,416,453,521,87,68,105,71,-0.13685284817044852,0.49973019027971854,1.1129570568242628,0.810528689454938,36482,36482,Huntington+Whitley,Huntington,18,69,Indiana,IN
18183,18CS031,277,262,292,305,28,13,43,27,-0.42052269746190657,0.03845510779063603,0.4757558711995769,0.9280920900512427,341,323,359,384,43,25,61,40,-0.521152750684866,0.10579213226107574,0.7287433223225598,0.9092377682789047,34080,34080,Huntington+Whitley,Whitley,18,183,Indiana,IN
18071,18CS032,413,394,432,474,61,42,80,50,-0.1672887743977138,0.2485648691224842,0.6695453465456531,0.8056836896476647,505,482,527,567,62,40,85,48,-0.23212102456317824,0.40627470130859833,1.0025631936721493,0.7565985640321369,44197,44197,Jackson+Washington,Jackson,18,71,Indiana,IN
18175,18CS032,272,260,285,293,21,8,33,19,-0.34078682243400554,0.06614191969021516,0.4961003428834769,0.8783997067662209,333,318,347,397,64,50,79,44,0.2416379159621815,0.8638788164136175,1.4521006746888852,0.6740836672799184,28126,28126,Jackson+Washington,Washington,18,175,Indiana,IN
18077,18CS033,322,308,336,382,60,46,74,45,-0.010483448874144975,0.4493217041014258,0.876179839279673,0.7376536467858478,394,377,411,427,33,16,50,75,-2.210673276189624,-1.5579132869785788,-0.948006092075701,2.2070954782559062,32200,32200,Jennings+Jefferson,Jefferson,18,77,Indiana,IN
18079,18CS033,262,250,274,300,38,26,50,30,-0.1299847470261065,0.30069026717700875,0.6945203990395254,0.7683270586238461,321,307,335,345,24,10,38,32,-0.9537939163904096,-0.35149851166794716,0.22225434785830914,1.2734126849036769,27601,27601,Jennings+Jefferson,Jennings,18,79,Indiana,IN
18081,18CS034,1200,1131,1269,1462,262,193,331,223,-0.20100813102811457,0.24907655216445038,0.6639595422431834,0.8482852169703585,1477,1394,1560,1742,265,182,348,199,-0.1502160326244292,0.49163835409535706,1.1142619387958899,0.7480389573980851,159280,159280,Johnson,Johnson,18,81,Indiana,IN
18085,18CS035,619,585,653,679,60,26,94,67,-0.5467822784946775,-0.07744069852948317,0.3456948668079669,1.095273202800544,761,720,802,922,161,120,202,97,0.395318624827793,0.9418597063655763,1.5734090095502957,0.5996528678483847,79250,79250,Kosciusko,Kosciusko,18,85,Indiana,IN
18087,18CS036,250,232,267,308,58,41,76,72,-0.7723611256639982,-0.33557543883267665,0.08334078512546579,1.2129496514541478,311,290,332,313,2,-19,23,32,-1.5513879225428187,-0.9130542903447175,-0.28015145904805383,11.000403803782076,39916,39916,LaGrange+Noble,LaGrange,18,87,Indiana,IN
18113,18CS036,399,378,419,437,38,18,59,47,-0.6524098238581745,-0.1730974378910569,0.26560258052847624,1.1956466563354966,492,467,517,552,60,35,85,59,-0.5899868203966804,0.01151078997822476,0.6698079823733049,0.9645925638694626,47876,47876,LaGrange+Noble,Noble,18,113,Indiana,IN
18089,18CS037,4298,4088,4507,5247,949,740,1159,627,0.2268740400588894,0.6559337985082546,1.1052034718589667,0.659771333896873,5280,5028,5532,6026,746,494,998,617,-0.29118499004620685,0.30795557176346805,0.9792190131174137,0.8260750876417593,486782,486782,Lake,Lake,18,89,Indiana,IN
18091,18CS038,1039,992,1086,1271,232,185,279,130,0.44382775908196553,0.9399862234499561,1.3527631897390675,0.5583877257456153,1271,1214,1328,1366,95,38,152,107,-0.7736596246742895,-0.1379061584328652,0.4854608708473387,1.1142462455395825,109885,109885,LaPorte,LaPorte,18,91,Indiana,IN
18093,18CS039,467,447,487,545,78,58,98,82,-0.5108854379698193,-0.10256996332171192,0.34005390702677,1.0384181679238451,570,547,594,733,163,139,186,108,0.8328960913817892,1.4557877693440802,2.095162272780031,0.6602169910091242,45451,45451,Lawrence+Orange,Lawrence,18,93,Indiana,IN
18117,18CS039,202,193,210,264,62,54,71,35,0.9947786374920481,1.4032481369170426,1.82376967159318,0.5516822761665452,246,236,256,309,63,53,73,39,0.8466398429934576,1.4547506389147176,2.079879363522622,0.6106854775397309,19654,19654,Lawrence+Orange,Orange,18,117,Indiana,IN
18095,18CS040,1298,1243,1354,1558,260,204,315,227,-0.1478854247172028,0.2462386903160004,0.6722762138270328,0.871268690141533,1590,1523,1657,1948,358,291,425,261,0.30431337049703544,0.9126171444456016,1.5487591144475157,0.7262701965264777,129526,129526,Madison,Madison,18,95,Indiana,IN
18097,18CS041,7089,6673,7505,8757,1668,1252,2084,1268,0.044069834133121925,0.4114362856379013,0.8464208099999121,0.7597055650158805,8718,8219,9217,10193,1475,976,1974,1003,-0.03239914785059508,0.577650826512745,1.206581992094427,0.6796872200998123,964810,964810,Marion,Marion,18,97,Indiana,IN
18099,18CS042,393,373,413,515,122,102,142,74,0.613835846446079,1.0435362159954091,1.4623786119399989,0.6013820785452069,483,460,507,540,57,33,80,71,-0.9557808050709965,-0.3811380823645376,0.22423714296280933,1.2325071276511472,46160,46160,Marshall+Pulaski+Starke,Marshall,18,99,Indiana,IN
18131,18CS042,145,139,150,163,18,13,24,28,-1.2251484740114245,-0.7805574901534507,-0.3332034434206877,1.450075226743384,177,170,183,211,34,28,41,33,-0.5292900024946791,0.1141420007271778,0.7491440711027748,0.9387056921253397,12383,12383,Marshall+Pulaski+Starke,Pulaski,18,131,Indiana,IN
18149,18CS042,233,224,243,296,63,53,72,49,0.1842492516890522,0.5817272916683752,1.0155445000442909,0.7712984428522572,286,274,298,374,88,76,100,42,1.7586612444848373,2.396505610063953,3.022242968936547,0.4728068061278968,23027,23027,Marshall+Pulaski+Starke,Starke,18,149,Indiana,IN
18105,18CS043,845,781,908,1017,172,109,236,113,-0.04064949265368733,0.4049132388068834,0.8099749526323103,0.6516289092897191,1045,969,1122,1159,114,37,190,116,-0.623627710171054,-0.028781690143528785,0.5918149861761883,1.0107654698323285,148195,148195,Monroe,Monroe,18,105,Indiana,IN
18109,18CS044,617,586,647,720,103,73,134,93,-0.33335945943181994,0.1427379251938136,0.5749382173402229,0.8922537381673503,759,722,796,901,142,105,179,112,-0.16212644475060048,0.505050864501297,1.1179200252384751,0.7832907100826466,70530,70530,Morgan,Morgan,18,109,Indiana,IN
18127,18CS045,1320,1247,1394,1602,282,208,355,180,0.15713269185740972,0.5993667730336356,1.0097582844337663,0.6369982103347427,1627,1539,1715,1904,277,189,365,192,-0.0887423253256289,0.6017690670502249,1.198533319485497,0.6902028204014474,170758,170758,Porter,Porter,18,127,Indiana,IN
18141,18CS046,2336,2219,2452,2802,466,350,583,372,-0.09727068259299247,0.3521644338272858,0.7733590384002019,0.7960046821014581,2866,2726,3007,3110,244,103,384,250,-0.63330468301491,-0.029001228683983072,0.5899001283879833,1.0224763026475638,271607,271607,St. Joseph,St. Joseph,18,141,Indiana,IN
18157,18CS047,1079,995,1163,1164,85,1,169,83,-0.40869639931410073,-0.005930704418314456,0.40498271174204936,0.9653953550314823,1338,1236,1439,1491,153,52,255,167,-0.7071289518663569,-0.08453078576458936,0.5373168135567195,1.082467070268424,195395,195395,Tippecanoe,Tippecanoe,18,157,Indiana,IN
18163,18CS048,1716,1637,1794,2038,322,244,401,247,-0.013475269735421668,0.4180307408815677,0.8469356424160878,0.7643300904234537,2103,2009,2197,2334,231,137,325,219,-0.5165925974624387,0.0800795630731368,0.6838377406893795,0.9445610926058369,181930,181930,Vanderburgh,Vanderburgh,18,163,Indiana,IN
18173,18CS049,524,497,551,661,137,110,164,85,0.38669700409400204,0.8355114055399773,1.24244628544143,0.6150085804695218,646,613,679,722,76,43,109,73,-0.5487569954352278,0.05956835988846017,0.6888304319113472,0.9461523485778167,63025,63025,Warrick,Warrick,18,173,Indiana,IN
18177,18CS050,757,729,786,935,178,149,206,131,0.293463522001208,0.7214522132762257,1.1148921152401883,0.7335721592034442,925,891,959,1027,102,68,136,113,-0.8651375473775692,-0.18620790872940174,0.397457346400512,1.0988020440484059,65874,65874,Wayne,Wayne,18,177,Indiana,IN
19005,19CS001,154,148,160,169,15,9,21,27,-1.3232774711276754,-0.8891863016100892,-0.43361641180222443,1.709977261085117,188,181,195,169,-19,-26,-12,20,-4.055914074806945,-3.447277560037177,-2.816705023991092,-1.1061386788859124,13659,13659,Allamakee+Clayton+Winneshiek,Allamakee,19,5,Iowa,IA
19043,19CS001,168,160,175,197,29,22,37,43,-1.2304151851745286,-0.7899664349475756,-0.34398790587002903,1.4286793082189886,205,196,214,223,18,9,27,16,-0.4922838831874198,0.13476359824125483,0.7540812610414442,0.8508810998428328,17424,17424,Allamakee+Clayton+Winneshiek,Clayton,19,43,Iowa,IA
19191,19CS001,165,156,173,161,-4,-12,5,22,-1.7313626684027579,-1.2913671106058358,-0.855381080494077,-7.686304741598036,202,192,212,202,-0,-10,10,16,-1.57613473224377,-0.9832240918539652,-0.33385790895903655,19.557995127642663,19938,19938,Allamakee+Clayton+Winneshiek,Winneshiek,19,191,Iowa,IA
19001,19CS002,86,85,87,98,12,11,13,16,-0.6882676616396832,-0.5828283514610786,-0.47066043225098364,1.2438118872766053,105,104,106,130,25,24,26,19,0.8009999335486261,0.9629398650627674,1.1150706337395633,0.740045444081763,7084,7084,Audubon and Nearby Counties,Adair,19,1,Iowa,IA
19009,19CS002,71,70,72,68,-3,-4,-2,4,-1.3735394901238476,-1.2767732374367886,-1.1730971185275336,-1.9942177401402614,87,86,88,82,-5,-6,-4,4,-2.0710767240205605,-1.9226059895938006,-1.7643171642870108,-1.0535001877070649,5487,5487,Audubon and Nearby Counties,Audubon,19,9,Iowa,IA
19029,19CS002,169,163,174,205,36,31,42,41,-0.7854952629212094,-0.35780638262482095,0.07405510039567025,1.0933754588376516,205,199,212,203,-2,-9,4,25,-3.1991438949203936,-2.518772174568664,-1.9399069176986308,-21.244015828751852,12820,12820,Audubon and Nearby Counties,Cass,19,29,Iowa,IA
19077,19CS002,105,104,107,133,28,26,29,20,0.5883048169847823,0.7075463309027777,0.8195537446784853,0.6992856701780963,129,128,130,127,-2,-3,-1,14,-1.9634932600962522,-1.794249276205707,-1.627053036513637,-13.421841646978795,10739,10739,Audubon and Nearby Counties,Guthrie,19,77,Iowa,IA
19165,19CS002,126,125,127,162,36,35,37,28,0.6032351307100329,0.7023773461277293,0.8101181270356307,0.7553968163018339,154,153,156,150,-4,-6,-3,13,-1.945512274066856,-1.7892030506482848,-1.6291319436623224,-4.226910314104334,11459,11459,Audubon and Nearby Counties,Shelby,19,165,Iowa,IA
19011,19CS003,211,200,222,267,56,45,67,41,0.12394410464752335,0.5834829040489424,0.983178412412543,0.7216690066599571,260,247,274,235,-25,-39,-12,14,-2.466498075585292,-1.8594924418812961,-1.2422032820916689,-0.5719268230469033,25490,25490,Benton+Iowa (county)+Keokuk+Washington,Benton,19,11,Iowa,IA
19095,19CS003,167,160,174,195,28,21,35,22,-0.027154724273782852,0.37559675778779494,0.8174461667431479,0.7508444896168235,205,196,213,214,9,1,18,14,-0.9576582262792681,-0.342420155773217,0.27160303301523236,1.3436861026104308,16143,16143,Benton+Iowa (county)+Keokuk+Washington,Iowa (county),19,95,Iowa,IA
19107,19CS003,101,100,102,128,27,26,28,26,-0.017086492638452213,0.08662275283806901,0.20045840262588213,0.9323201005586101,124,123,126,156,32,30,33,18,1.4701086390823066,1.6315557855585148,1.785050584398038,0.5492307000011962,10147,10147,Benton+Iowa (county)+Keokuk+Washington,Keokuk,19,107,Iowa,IA
19183,19CS003,212,203,222,263,51,41,60,32,0.4450785005124657,0.847504513635376,1.2930326682250919,0.6198319113134819,261,250,272,265,4,-7,15,34,-2.2464719517695078,-1.648189602404978,-1.0446152353629061,6.8140656252802785,22014,22014,Benton+Iowa (county)+Keokuk+Washington,Washington,19,183,Iowa,IA
19013,19CS004,1049,993,1106,1302,253,196,309,239,-0.3435934722462914,0.1027538827627672,0.5173365890822654,0.9426858419787852,1293,1225,1360,1449,156,89,224,141,-0.4728029502434441,0.14294007561098823,0.7485876539994359,0.8974484870019201,130963,130963,Black Hawk,Black Hawk,19,13,Iowa,IA
19015,19CS005,249,237,260,284,35,24,47,15,0.34193476577777093,0.7812325699105946,1.2179908879405066,0.41270986512595026,303,290,317,334,31,17,44,27,-0.4701580023283697,0.17204223573688157,0.7752954826773171,0.8535150232122357,26313,26313,Boone+Carroll+Greene,Boone,19,15,Iowa,IA
19027,19CS005,197,189,206,239,42,33,50,36,-0.1151726865432167,0.27485588263164373,0.6825754307036459,0.8444751474692376,240,230,251,281,41,30,51,10,1.2206026637074217,1.8312117516579072,2.4195171036538983,0.24071079520723765,20033,20033,Boone+Carroll+Greene,Carroll,19,27,Iowa,IA
19073,19CS005,100,99,101,85,-15,-16,-14,4,-2.228497998924409,-2.124213341843516,-2.0215336182240335,-0.2902674484770977,122,121,123,130,8,7,9,10,-0.4271113322888941,-0.2580761706015889,-0.11535501476623349,1.1045654813615362,8845,8845,Boone+Carroll+Greene,Greene,19,73,Iowa,IA
19017,19CS006,205,194,216,272,67,56,78,44,0.4753654373794848,0.9049037413649081,1.3518911884586033,0.6463659491082291,253,240,267,254,1,-13,14,23,-1.7083851054294794,-1.074916160225673,-0.420488455088508,14.952257063684149,25229,25229,Bremer+Butler+Grundy,Bremer,19,17,Iowa,IA
19023,19CS006,165,158,171,153,-12,-18,-5,22,-2.7690024888813465,-2.331370291493042,-1.926692614431042,-2.0947379892070606,202,194,209,199,-3,-10,5,21,-2.6222496694119246,-1.9600676547588607,-1.3706963630559892,-13.740187152785824,14374,14374,Bremer+Butler+Grundy,Butler,19,23,Iowa,IA
19075,19CS006,124,122,125,142,18,17,20,26,-0.7282034064286954,-0.6209653750461552,-0.5242704778128944,1.3410072498655967,152,151,154,147,-5,-7,-4,3,-0.9668387740945401,-0.8008788780912547,-0.6352375100784037,-0.7239552438319384,12223,12223,Bremer+Butler+Grundy,Grundy,19,75,Iowa,IA
19019,19CS007,178,169,188,191,13,3,22,22,-0.8491096436477721,-0.44501258038116287,-0.022589360686511253,1.617277285461353,219,208,230,223,4,-7,15,20,-1.5334670528896506,-0.9006511457029109,-0.28398195319703773,3.9149109560669753,21206,21206,Buchanan+Delaware+Fayette,Buchanan,19,19,Iowa,IA
19055,19CS007,147,140,154,187,40,33,47,32,0.05023146802459625,0.47724089632647554,0.8954434465578615,0.7767791917939469,180,171,189,188,8,-1,17,23,-1.6456036331604054,-1.039567671907485,-0.41614081804732833,2.498430011895544,17007,17007,Buchanan+Delaware+Fayette,Delaware,19,55,Iowa,IA
19065,19CS007,209,200,217,250,41,33,50,26,0.3646285164213363,0.7926552583234631,1.2428793917371168,0.6129249532483111,254,244,264,273,19,9,29,30,-1.2856737297305423,-0.6874567217698813,-0.08933855912165349,1.5147055173213484,19443,19443,Buchanan+Delaware+Fayette,Fayette,19,65,Iowa,IA
19031,19CS008,155,147,163,181,26,18,34,18,0.012361378948521335,0.429590304346321,0.8916920945223333,0.6676835681698164,190,180,199,213,23,14,33,5,0.5781160519375234,1.1812247591689877,1.801608949567063,0.2043653454649294,18518,18518,Cedar+Clinton+Jackson+Jones,Cedar,19,31,Iowa,IA
19045,19CS008,470,450,490,531,61,41,81,71,-0.6653763153347556,-0.23375890507994765,0.19414089525480846,1.15358033536783,573,549,597,609,36,12,60,47,-0.9169001890653837,-0.295177734834036,0.2921058946061337,1.278439521515842,46489,46489,Cedar+Clinton+Jackson+Jones,Clinton,19,45,Iowa,IA
19097,19CS008,189,180,197,223,34,26,43,32,-0.3086673290622659,0.14003072342931386,0.5441223340481953,0.9047145754483137,230,220,240,269,39,29,49,27,0.10563944150978459,0.7540282124170032,1.3757865746238482,0.6725693478892544,19304,19304,Cedar+Clinton+Jackson+Jones,Jackson,19,97,Iowa,IA
19105,19CS008,172,163,181,210,38,29,47,48,-0.9281622077657576,-0.5013066062441238,-0.04809205193827037,1.2408050478219177,211,200,221,241,30,20,41,14,0.2670326328471525,0.9224918667142604,1.5870833589508315,0.44734597313989155,20627,20627,Cedar+Clinton+Jackson+Jones,Jones,19,105,Iowa,IA
19033,19CS009,441,423,459,533,92,74,110,67,0.13778112139029283,0.5829349028393531,0.9951744111123004,0.7209101570107451,540,518,562,601,61,39,83,63,-0.6546765923676995,-0.057240887219755676,0.5362605225114441,1.0152828121255728,42321,42321,Cerro Gordo+Hancock+Winnebago,Cerro Gordo,19,33,Iowa,IA
19081,19CS009,99,98,101,120,21,19,22,20,-0.056744392170247585,0.05480171637146173,0.15756776790707105,0.9269793451868661,122,121,124,154,32,30,33,16,1.6392222998427652,1.7952478464345447,1.9492651590835066,0.48718567557043496,10599,10599,Cerro Gordo+Hancock+Winnebago,Hancock,19,81,Iowa,IA
19189,19CS009,108,107,109,137,29,28,30,24,0.39941032837556917,0.5031547450240315,0.6134165218247662,0.7950348468747499,132,131,134,126,-6,-8,-5,11,-2.166358317772248,-2.018176973606546,-1.8519189621134302,-2.064122373342232,10324,10324,Cerro Gordo+Hancock+Winnebago,Winnebago,19,189,Iowa,IA
19049,19CS010,464,423,506,557,93,51,134,63,-0.10682135656046984,0.31631858929633394,0.7380780630641681,0.6717158908029248,580,530,630,585,5,-45,55,46,-1.161388615992942,-0.5223288078925401,0.13147819910833325,7.703434789094369,95019,95019,Dallas,Dallas,19,49,Iowa,IA
19051,19CS011,80,79,81,91,11,10,12,20,-1.1074905792485914,-1.0035207403819488,-0.8946299256903848,1.6729771811867644,99,97,100,82,-17,-18,-15,2,-2.621581915273542,-2.4747062752316515,-2.3207796295433525,-0.12825573214347757,9025,9025,Davis+Jefferson+Van Buren+Wapello,Davis,19,51,Iowa,IA
19101,19CS011,157,149,165,178,21,13,29,25,-0.6648700192674444,-0.20725995563258412,0.21266310556398235,1.1374036513863226,193,184,203,183,-10,-20,-1,15,-2.2687954259138445,-1.6790943750204983,-1.0665151203273677,-1.5812839971534405,18250,18250,Davis+Jefferson+Van Buren+Wapello,Jefferson,19,101,Iowa,IA
19177,19CS011,80,79,81,80,0,-1,1,13,-1.9506085168425822,-1.8401834343070533,-1.729685529663752,12.710865469929923,98,97,99,91,-7,-8,-6,4,-2.0585988255997107,-1.9131091938519575,-1.7447201796285101,-0.6408278260405106,7054,7054,Davis+Jefferson+Van Buren+Wapello,Van Buren,19,177,Iowa,IA
19179,19CS011,355,340,370,456,101,86,116,95,-0.27131766897160975,0.18724295858968493,0.5760246536793336,0.9282612598657604,435,417,453,468,33,15,51,60,-1.5082341924398535,-0.9183109239271132,-0.28991830421147924,1.7538627463339362,35082,35082,Davis+Jefferson+Van Buren+Wapello,Wapello,19,179,Iowa,IA
19057,19CS012,390,374,407,434,44,27,60,42,-0.4043207586158855,0.03291450996845356,0.46455282870110604,0.9385669498944139,478,458,498,548,70,50,90,63,-0.39054520262108555,0.2028103361135104,0.8509474661360868,0.8842325419348479,38908,38908,Des Moines+Henry+Lee,Des Moines,19,57,Iowa,IA
19087,19CS012,184,176,193,246,62,53,70,35,0.9159760403859374,1.3530201294363808,1.7442137920804008,0.5588256209938228,226,216,236,250,24,14,34,23,-0.5620220838558974,0.04894123402334769,0.6552249094167137,0.9236592780427537,19778,19778,Des Moines+Henry+Lee,Henry,19,87,Iowa,IA
19111,19CS012,365,350,379,439,74,60,89,33,0.7912273852263795,1.2323275414400257,1.6887797505556312,0.4389788896021549,446,429,463,509,63,46,80,75,-1.0185588834883044,-0.4310902396350584,0.19203322806390263,1.1735529873677046,33574,33574,Des Moines+Henry+Lee,Lee,19,111,Iowa,IA
19061,19CS013,783,741,825,867,84,42,126,151,-1.1432086296887753,-0.6839375378422563,-0.2438397258769668,1.77619405310541,963,912,1013,1050,87,37,138,100,-0.7349262297742863,-0.14335972399637087,0.47162797780477095,1.1307676564368128,97498,97498,Dubuque,Dubuque,19,61,Iowa,IA
19069,19CS014,104,103,105,135,31,30,32,18,1.1967128791934307,1.3087049403062911,1.415330670249539,0.5605764003291965,128,126,129,168,40,39,42,16,2.753687228507182,2.9065076136955708,3.074593198478794,0.3871560011012006,10036,10036,Franklin+Hamilton+Hardin+Wright,Franklin,19,69,Iowa,IA
19079,19CS014,159,152,165,176,17,11,24,33,-1.5099309237589722,-1.0476424581658175,-0.6262562996280454,1.8055583187174642,195,187,203,193,-2,-10,6,22,-2.574971971107067,-1.9363295479326628,-1.3019778241720734,-23.98168690862814,14763,14763,Franklin+Hamilton+Hardin+Wright,Hamilton,19,79,Iowa,IA
19083,19CS014,186,178,193,215,29,22,37,28,-0.34004534344589366,0.08006612512362825,0.5359851754500243,0.9212111811908057,228,219,236,280,52,44,61,15,2.085177213893699,2.702604112748504,3.3135921523828626,0.2807483997686896,16712,16712,Franklin+Hamilton+Hardin+Wright,Hardin,19,83,Iowa,IA
19197,19CS014,153,148,159,161,8,2,13,23,-1.6442469062782104,-1.2349785472050872,-0.8005488976674404,2.6736487791294596,188,181,194,189,1,-5,8,25,-2.9043677776682024,-2.263563129422449,-1.6164193385147483,11.045972550652714,12495,12495,Franklin+Hamilton+Hardin+Wright,Wright,19,197,Iowa,IA
19071,19CS015,79,78,80,70,-9,-10,-8,5,-2.1782436875263764,-2.0755757508189068,-1.97254046700224,-0.609886449940004,97,96,98,97,-0,-1,1,12,-2.2532809769217756,-2.1081505554544573,-1.9526720903075356,12.067791516337808,6839,6839,Fremont+Harrison+Mills+Pottawattamie,Fremont,19,71,Iowa,IA
19085,19CS015,162,156,168,235,73,67,79,61,0.4025561803290728,0.8426356616240963,1.2833990250879876,0.8256391846164026,198,190,205,193,-5,-12,3,20,-2.7081387516146442,-2.1096202609719072,-1.4934608382044943,-5.680229068102027,13990,13990,Fremont+Harrison+Mills+Pottawattamie,Harrison,19,85,Iowa,IA
19129,19CS015,115,114,117,136,21,19,22,16,0.1990385940622632,0.3086156221727155,0.4119635400010999,0.7408198675524772,142,140,144,156,14,12,16,15,-0.22402749586449955,-0.06588291674174836,0.08127825750215799,0.9897405556712399,14975,14975,Fremont+Harrison+Mills+Pottawattamie,Mills,19,129,Iowa,IA
19155,19CS015,806,765,846,994,188,148,229,111,0.42055779260283904,0.8274599669231839,1.2555423214443087,0.5862139835796988,988,939,1036,1137,149,101,198,117,-0.2458957965489052,0.4185268193687634,1.0478278643186347,0.7775059696130399,93373,93373,Fremont+Harrison+Mills+Pottawattamie,Pottawattamie,19,155,Iowa,IA
19099,19CS016,332,316,348,388,56,40,72,58,-0.4884874934289896,-0.06999307865689679,0.37730575356267493,1.0218947619439342,406,387,426,448,42,22,61,29,-0.23617755018292336,0.4143039477351993,1.0552792310725525,0.6797425905588875,37161,37161,Jasper+Poweshiek,Jasper,19,99,Iowa,IA
19157,19CS016,183,175,191,194,11,3,19,25,-1.199402921933009,-0.7594024020724743,-0.3421962283881451,2.124963643580325,224,214,233,245,21,12,31,25,-0.8419651450130786,-0.258293787088227,0.3682303883170785,1.1159274911089765,18426,18426,Jasper+Poweshiek,Poweshiek,19,157,Iowa,IA
19103,19CS017,653,587,719,727,74,8,140,53,-0.2922418423042928,0.14374620593160953,0.5388135705620845,0.7055261522744256,817,737,896,902,85,6,165,59,-0.4295108885942698,0.19132981334322557,0.8378539508287778,0.6851732039568996,153005,153005,Johnson,Johnson,19,103,Iowa,IA
19113,19CS018,1552,1454,1650,1921,369,271,467,266,-0.00776724913328525,0.4597897692587614,0.8482985036492453,0.718432369810039,1912,1794,2029,2074,162,45,280,177,-0.6976061783153564,-0.07083234182087143,0.5480747912584626,1.0843816449781176,227496,227496,Linn,Linn,19,113,Iowa,IA
19115,19CS019,94,93,96,111,17,15,18,30,-1.314860204994298,-1.211687577335942,-1.1044468888667256,1.7015314040379952,116,115,117,122,6,5,7,20,-1.6670789556964412,-1.5176587791833875,-1.3682665564890988,2.8371888368747427,11039,11039,Louisa+Muscatine,Louisa,19,115,Iowa,IA
19139,19CS019,352,334,370,431,79,61,97,79,-0.41992450610315635,-0.006242169538334234,0.43208844028355187,0.9858849758789894,432,410,454,484,52,30,74,45,-0.3913711451960052,0.19100714159342866,0.7697536154047978,0.8513026585333062,42497,42497,Louisa+Muscatine,Muscatine,19,139,Iowa,IA
19007,19CS020,149,143,154,180,31,26,37,40,-1.1059122380550277,-0.705301787442488,-0.2926620737973352,1.2434497217444067,180,174,187,187,7,0,13,16,-1.5249821752922244,-0.8898919948538628,-0.2990559628089684,2.0939192527367974,12485,12485,Lucas and Nearby Counties,Appanoose,19,7,Iowa,IA
19039,19CS020,94,93,95,100,6,5,7,4,0.07869638709233022,0.18415338723601274,0.2949725554399263,0.5926963838543259,115,114,117,158,43,41,44,22,2.479208667470187,2.6476040775875047,2.8061599534716226,0.5038282443294361,9370,9370,Lucas and Nearby Counties,Clarke,19,39,Iowa,IA
19053,19CS020,72,71,73,76,4,3,5,2,0.14442204671890826,0.26453657081397736,0.3714011022095635,0.3954116806876145,88,87,89,99,11,10,12,15,-0.7809879120173232,-0.628976139833006,-0.4676657225911472,1.258819327353048,7817,7817,Lucas and Nearby Counties,Decatur,19,53,Iowa,IA
19117,19CS020,94,93,95,98,4,3,5,11,-0.9690433302109331,-0.8579561588726836,-0.7551881549389842,2.3632532338530363,115,114,117,125,10,8,11,12,-0.4906064705457027,-0.3342774495094876,-0.1767102848333452,1.130756864276808,8543,8543,Lucas and Nearby Counties,Lucas,19,117,Iowa,IA
19135,19CS020,86,85,86,101,15,15,16,16,-0.1919750987143307,-0.07729407962810256,0.02599840428006642,0.9750647456470729,105,104,106,109,4,3,5,17,-2.144843339007974,-1.9675802917184502,-1.8163871673490584,3.1943568081463396,7718,7718,Lucas and Nearby Counties,Monroe,19,135,Iowa,IA
19185,19CS020,73,72,74,94,21,20,22,17,0.5088406827653564,0.6182053693973006,0.7200737404334486,0.7744318561252604,89,88,90,86,-3,-4,-2,7,-2.08505263373011,-1.9311089797169507,-1.7865636119124897,-3.0096787455153495,6414,6414,Lucas and Nearby Counties,Wayne,19,185,Iowa,IA
19119,19CS021,94,92,95,112,18,17,20,35,-1.51989047047885,-1.4108950629922092,-1.3001946102768693,1.806733335260912,115,113,116,94,-21,-22,-19,3,-2.5556236124164604,-2.4014569263811896,-2.2390921319776536,-0.15324823282092284,11785,11785,Lyon+O'Brien+Osceola+Sioux,Lyon,19,119,Iowa,IA
19141,19CS021,167,161,173,220,53,47,59,50,-0.1505393698309195,0.2342280423335812,0.6676250756743812,0.9205949440730388,202,195,209,183,-19,-26,-12,11,-3.199969676034882,-2.62633406227543,-2.066447841851374,-0.6041122888396501,13747,13747,Lyon+O'Brien+Osceola+Sioux,O'Brien,19,141,Iowa,IA
19143,19CS021,60,59,60,71,11,11,12,10,0.13815930635008533,0.23868772435352942,0.35620753023675433,0.8040165920258919,73,72,74,91,18,17,19,4,2.69990213566792,2.8522888149271184,3.000450270051458,0.20832157708021962,5972,5972,Lyon+O'Brien+Osceola+Sioux,Osceola,19,143,Iowa,IA
19167,19CS021,209,194,224,279,70,55,85,63,-0.2190400156515976,0.20570775147596151,0.6197501088627599,0.8854141033796241,257,239,275,257,0,-18,18,13,-1.0793098328222086,-0.4358096430290149,0.1592560728279682,9.559457645021546,34989,34989,Lyon+O'Brien+Osceola+Sioux,Sioux,19,167,Iowa,IA
19121,19CS022,142,135,149,122,-20,-27,-13,10,-2.2893125102989234,-1.8563157723156833,-1.4431325027306845,-0.5174386667700512,174,166,183,180,6,-3,14,15,-1.2949843677000668,-0.6741260642754676,-0.09824807816828761,2.2956561980352572,16376,16376,Madison+Warren,Madison,19,121,Iowa,IA
19181,19CS022,379,356,401,423,44,22,67,48,-0.470024480237274,-0.06838519137291374,0.3576851447429053,1.0560505225570906,466,439,493,534,68,41,95,62,-0.5324356626386813,0.15325445817501465,0.7799467821293897,0.8949718306242347,51847,51847,Madison+Warren,Warren,19,181,Iowa,IA
19123,19CS023,207,197,216,250,43,34,53,38,-0.1700123168926585,0.24935647208659026,0.6759313259152623,0.85599215474549,254,242,266,274,20,8,32,34,-1.3487682742440503,-0.7530039393262662,-0.10797862894863723,1.618355930570547,22404,22404,Mahaska+Marion,Mahaska,19,123,Iowa,IA
19125,19CS023,295,281,310,329,34,19,48,51,-0.9665338055793815,-0.5191941164921005,-0.10826615003054235,1.47542151524993,363,346,381,370,7,-11,24,45,-2.010709199182946,-1.3972832282409218,-0.7636677770695337,5.991802893289757,33233,33233,Mahaska+Marion,Marion,19,125,Iowa,IA
19127,19CS024,404,387,421,467,63,46,80,60,-0.35629255618988953,0.060380238648016456,0.48972268594139956,0.9427497876385991,495,474,515,531,36,16,57,26,-0.268335973613894,0.3025896002612105,0.9033916847363492,0.7001398910684161,39482,39482,Marshall+Tama,Marshall,19,127,Iowa,IA
19171,19CS024,176,169,183,222,46,39,53,56,-0.9947639333731306,-0.5880657108131273,-0.155159657127043,1.1879471820987584,215,206,224,216,1,-8,10,20,-1.9233776035943269,-1.3425415122718158,-0.7644727350318121,10.055085659643245,16861,16861,Marshall+Tama,Tama,19,171,Iowa,IA
19037,19CS025,115,113,116,133,18,17,20,11,0.5171550683685973,0.6251112618459668,0.7283912620244267,0.5658052576902216,141,139,142,146,5,4,7,13,-0.9307684686258401,-0.770995751265382,-0.6139238503964387,2.0608024770462987,11898,11898,Mitchell and Nearby Counties,Chickasaw,19,37,Iowa,IA
19067,19CS025,154,147,160,202,48,42,55,30,0.7396041721844031,1.1793846788058169,1.629787249696674,0.6090057928462547,189,181,197,199,10,2,18,17,-1.1529833003347543,-0.49700988259417056,0.14106883436152193,1.4811684851856188,15582,15582,Mitchell and Nearby Counties,Floyd,19,67,Iowa,IA
19089,19CS025,99,98,100,99,0,-1,1,15,-1.7489613559774586,-1.63118351026125,-1.5282063429456174,14.249610962672877,121,120,123,133,12,10,13,7,0.4537270718580744,0.6019788365398725,0.7496108869106871,0.5552123193738915,9158,9158,Mitchell and Nearby Counties,Howard,19,89,Iowa,IA
19131,19CS025,117,116,118,129,12,11,13,37,-2.474048269994866,-2.3658415324665754,-2.2578169819381664,2.8576690462002965,144,142,145,150,6,5,8,2,0.3509393113605644,0.49824094708913835,0.6571966872232967,0.26944853656007867,10599,10599,Mitchell and Nearby Counties,Mitchell,19,131,Iowa,IA
19195,19CS025,72,71,73,59,-13,-14,-12,5,-2.501438261722753,-2.3951586573645405,-2.29110342748987,-0.4262422525986455,88,87,89,99,11,10,12,6,0.6456926901735015,0.7906315435323041,0.9544678351771063,0.503627340459041,7387,7387,Mitchell and Nearby Counties,Worth,19,195,Iowa,IA
19041,19CS026,162,155,169,187,25,18,32,16,0.16045565030822245,0.5684430918289761,1.0202187569118089,0.6107529922674534,197,189,205,198,1,-7,9,20,-2.074471875409334,-1.4304079017593265,-0.7752922808355827,11.057427982157172,16045,16045,Palo Alto and Nearby Counties,Clay,19,41,Iowa,IA
19059,19CS026,178,170,185,197,19,12,27,28,-0.9093714628799935,-0.49924011152814063,-0.07391025759104546,1.3659353402348475,217,208,226,216,-1,-10,8,27,-2.538148484026917,-1.9068175125425508,-1.2766875884740585,99.95591087302664,17398,17398,Palo Alto and Nearby Counties,Dickinson,19,59,Iowa,IA
19063,19CS026,103,102,104,132,29,28,30,32,-0.40441990310033143,-0.2972488170716058,-0.203104815004752,1.0585511565032617,126,125,127,131,5,4,6,14,-1.3227080225201222,-1.1746890177010807,-1.0152531970188095,2.334210334883772,9170,9170,Palo Alto and Nearby Counties,Emmet,19,63,Iowa,IA
19109,19CS026,152,146,158,175,23,17,29,44,-1.8173953997507648,-1.4076811749941833,-0.9930944201694563,1.8221490828023423,185,177,193,219,34,26,42,30,-0.297042897315534,0.31494343681567566,0.9389996890541082,0.8577222480858959,14732,14732,Palo Alto and Nearby Counties,Kossuth,19,109,Iowa,IA
19147,19CS026,108,107,109,119,11,10,12,11,-0.08277891409587333,0.015000378931781902,0.11648793752658913,0.9053386950006319,132,131,133,139,7,6,8,22,-2.2098202262687927,-2.048665586558559,-1.8981418277206643,2.8015753653310016,8861,8861,Palo Alto and Nearby Counties,Palo Alto,19,147,Iowa,IA
19021,19CS027,159,151,168,175,16,7,24,31,-1.1936956078474523,-0.7561116208236205,-0.3227973591261471,1.8340059234469506,196,186,206,184,-12,-22,-2,14,-2.250933370686514,-1.5616351450557995,-0.9352737753784147,-1.2840887963166259,19724,19724,Pocahontas and Nearby Counties,Buena Vista,19,21,Iowa,IA
19025,19CS027,113,112,114,111,-2,-3,-1,4,-0.7514221992484839,-0.6438889394171092,-0.534664567562565,-3.4600073249245997,138,137,140,145,7,5,8,10,-0.5885911680016257,-0.431648318056458,-0.2798315956636554,1.327650327832382,9556,9556,Pocahontas and Nearby Counties,Calhoun,19,25,Iowa,IA
19091,19CS027,97,96,98,106,9,8,10,20,-1.262821967529914,-1.1570523727748718,-1.0420589193059662,1.9911893980698756,119,118,120,129,10,9,11,10,-0.12723402178878465,0.03143006072550529,0.189410762506935,0.8894531583661323,9488,9488,Pocahontas and Nearby Counties,Humboldt,19,91,Iowa,IA
19151,19CS027,80,79,81,95,15,14,16,15,-0.08953035857149498,0.012828907436638682,0.11174411620021253,0.9321514841246188,98,97,99,111,13,12,14,10,0.434267255227965,0.5855996982974868,0.7487429558645815,0.7028271062602571,6622,6622,Pocahontas and Nearby Counties,Pocahontas,19,151,Iowa,IA
19161,19CS027,114,113,115,128,14,13,15,15,-0.20958701081718953,-0.10236904861451987,-7.382906956570354e-4,0.9984297661778132,139,138,141,151,12,10,13,12,-0.22136116937390496,-0.06117670330272922,0.08955544371416585,0.9579633450461628,9645,9645,Pocahontas and Nearby Counties,Sac,19,161,Iowa,IA
19187,19CS027,365,349,380,469,104,89,120,68,0.5871005011039012,1.0016504702607503,1.4007295466318503,0.6466317499095618,447,428,465,510,63,45,82,47,-0.052842309936631554,0.5538833903238148,1.1492961103331123,0.7309067102648876,35962,35962,Pocahontas and Nearby Counties,Webster,19,187,Iowa,IA
19153,19CS028,3163,2950,3375,3754,591,379,804,437,-0.13958837337507318,0.3120186201482409,0.7523819292921242,0.7380649750892623,3909,3654,4165,4340,431,175,686,380,-0.5008596830227674,0.11545535325167906,0.726978240577412,0.8804328722677816,492385,492385,Polk,Polk,19,153,Iowa,IA
19163,19CS029,1314,1240,1389,1594,280,205,354,178,0.15141163029499927,0.5853930420428728,1.0200315216435176,0.63385378593649,1616,1527,1706,1820,204,114,293,133,-0.10488777338709943,0.49816878752510396,1.106926747274086,0.6497955610275665,173323,173323,Scott,Scott,19,163,Iowa,IA
19169,19CS030,479,436,521,477,-2,-44,41,35,-0.8032128195044601,-0.37531285236267253,0.028703713352095997,-58.147420404717174,597,547,648,627,30,-21,80,26,-0.6251935067528626,0.04858477736809815,0.7026711776136904,0.8470671535240767,97773,97773,Story,Story,19,169,Iowa,IA
19003,19CS031,37,36,37,40,3,3,4,5,-0.5347179392787978,-0.4314009745768402,-0.3234236607215845,1.12233530359205,45,44,45,62,17,17,18,6,3.6028000254646986,3.756579091547531,3.9008214533174197,0.32855326281389213,3596,3596,Taylor and Nearby Counties,Adams,19,3,Iowa,IA
19137,19CS031,136,132,140,169,33,29,37,30,-0.12789516545327914,0.30478496360559604,0.7129364819542623,0.8803700310848902,166,161,171,159,-7,-12,-2,15,-3.2427774783921723,-2.6711933816754465,-2.0234741280633726,-2.5198126300409958,9924,9924,Taylor and Nearby Counties,Montgomery,19,137,Iowa,IA
19145,19CS031,176,169,182,189,13,7,20,15,-0.5474140797933578,-0.10924507082170834,0.33830651737177364,1.0514750134257036,215,207,223,219,4,-4,12,18,-1.7268835828644835,-1.0986996512161233,-0.5030800737665629,3.6678847817356885,15106,15106,Taylor and Nearby Counties,Page,19,145,Iowa,IA
19159,19CS031,67,66,67,93,26,26,27,8,3.703302809011086,3.807264201190332,3.9225996085765873,0.29179775977605266,81,81,82,87,6,5,6,16,-2.7301186481322666,-2.573552110598103,-2.417092484401617,2.414844677991906,4839,4839,Taylor and Nearby Counties,Ringgold,19,159,Iowa,IA
19173,19CS031,65,64,65,79,14,14,15,5,1.4295951871863908,1.5312678874443848,1.631013076981246,0.3244925603573753,79,78,80,105,26,25,27,11,2.7532206511573523,2.9120567869187273,3.0700488292592993,0.4082478277712328,6148,6148,Taylor and Nearby Counties,Taylor,19,173,Iowa,IA
19175,19CS031,130,125,135,151,21,16,26,23,-0.6173252578391897,-0.1736878351494931,0.25923365243048896,1.0525375782283095,160,153,166,172,12,6,19,13,-0.6830091769963561,-0.05484775244556969,0.5871096659120506,0.9668829441713849,12196,12196,Taylor and Nearby Counties,Union,19,175,Iowa,IA
19035,19CS032,146,141,151,152,6,1,11,25,-2.1278186115657123,-1.6910387933943112,-1.293092314356909,3.6010980171883165,177,172,183,172,-5,-11,0,17,-2.994777854357457,-2.4024340999797826,-1.7750721189172718,-3.8302435239864234,11214,11214,West Central Iowa,Cherokee,19,35,Iowa,IA
19047,19CS032,152,145,160,169,17,9,24,23,-0.8322983947001339,-0.3880725728397314,0.04597064467461946,1.3137148784902248,186,178,195,158,-28,-37,-20,20,-4.0400920636598405,-3.4266635420266867,-2.7740890824711113,-0.733354663397293,16874,16874,West Central Iowa,Crawford,19,47,Iowa,IA
19093,19CS032,86,85,86,117,31,31,32,31,-0.06292875994710304,0.03937409422348231,0.14179808394651672,0.9607851947744193,105,104,106,96,-9,-10,-8,6,-2.8067126991055438,-2.656153058851063,-2.4913155093133943,-0.740138185605338,6827,6827,West Central Iowa,Ida,19,93,Iowa,IA
19133,19CS032,117,116,118,154,37,36,38,17,2.189399553102289,2.300448433087106,2.409326035013789,0.4494622583080956,144,142,145,157,13,12,15,22,-1.345903760605803,-1.1931633481065633,-1.0340223862592168,1.5242592171514593,8614,8614,West Central Iowa,Monona,19,133,Iowa,IA
19149,19CS032,207,196,218,262,55,44,66,64,-0.8096576471992661,-0.3524232258303798,0.07155267710499194,1.1449638075662614,254,241,267,250,-4,-17,9,19,-1.7704187200959352,-1.0747528254948233,-0.42129133254681156,-7.448012784876275,25208,25208,West Central Iowa,Plymouth,19,149,Iowa,IA
19193,19CS032,832,788,877,1064,232,187,276,175,0.08068429037161808,0.544476737477825,1.002657591952931,0.7523809587850612,1019,966,1073,1084,65,11,118,91,-0.894419084883073,-0.3162052291308382,0.31215688773381,1.3868964283093126,103134,103134,West Central Iowa,Woodbury,19,193,Iowa,IA
20001,20CS001,141,136,147,129,-12,-18,-7,4,-1.7609853078102649,-1.332713837112524,-0.8941351857330295,-0.34803155811958253,172,165,178,199,27,21,34,27,-0.616328018644171,0.04006823425659553,0.664928895063308,0.9523614228468423,12402,12402,Allen+Anderson+Franklin+Osage,Allen,20,1,Kansas,KS
20003,20CS001,89,88,89,90,1,1,2,5,-0.5525468133249483,-0.45300101275083976,-0.3401335370931896,2.047676234149471,108,107,109,103,-5,-6,-4,21,-4.128600241474019,-3.9741235829269557,-3.813072484042915,-4.934102553963707,7920,7920,Allen+Anderson+Franklin+Osage,Anderson,20,3,Kansas,KS
20059,20CS001,229,218,240,269,40,29,51,21,0.3003940882316102,0.7347433902774086,1.1827224829584098,0.5128420581179182,279,266,292,338,59,46,72,40,0.287192995928891,0.8931510137174116,1.558276137154045,0.6644801658999899,25653,25653,Allen+Anderson+Franklin+Osage,Franklin,20,59,Kansas,KS
20139,20CS001,164,157,171,230,66,59,73,23,2.281978742919852,2.7224975092242887,3.1413177912470442,0.34312493509501524,199,191,207,232,33,25,41,23,0.14178088071566503,0.7409577887021189,1.3723275909391348,0.6762398072662333,15849,15849,Allen+Anderson+Franklin+Osage,Osage,20,139,Kansas,KS
20011,20CS002,164,158,170,181,17,11,23,17,-0.43469807113917736,0.017504793727103066,0.45219358877111265,0.9414533179297796,198,191,206,213,15,7,22,34,-2.17354293763628,-1.6034148510448298,-0.988963811243326,2.1692407837784105,14472,14472,Bourbon+Linn+Miami,Bourbon,20,11,Kansas,KS
20107,20CS002,94,93,95,122,28,27,29,5,2.2607027038236964,2.364212113161852,2.4732900515041383,0.17300394676989023,115,114,116,166,51,50,52,24,3.180636999566667,3.3461435315587114,3.5023453242319977,0.46169711412445347,9689,9689,Bourbon+Linn+Miami,Linn,20,107,Kansas,KS
20121,20CS002,255,240,270,292,37,22,52,23,0.014881771124544987,0.4238982361633597,0.8238744988414787,0.6050090509077567,310,292,328,419,109,91,127,61,1.044076670632691,1.6781580882609344,2.3021257440685496,0.5546447492864127,34282,34282,Bourbon+Linn+Miami,Miami,20,121,Kansas,KS
20005,20CS003,153,146,160,146,-7,-14,0,3,-1.0522090187248434,-0.6126255168110879,-0.19787751327030306,-0.5120615841552012,187,179,195,218,31,23,39,26,-0.2223422793643814,0.38308412084750626,0.9791930517851983,0.8072440645906024,16087,16087,Brown and Nearby Counties,Atchison,20,5,Kansas,KS
20013,20CS003,111,110,112,147,36,35,37,31,0.42187243000490343,0.5333580183178681,0.6364716939780171,0.8362860027399199,137,135,138,157,20,19,22,11,1.0423343442670165,1.1930846068376564,1.3522253836943907,0.5118961378506848,9516,9516,Brown and Nearby Counties,Brown,20,13,Kansas,KS
20043,20CS003,76,76,77,92,16,15,16,10,0.6408199454264795,0.745709845414009,0.8461624062403228,0.6014475975566997,94,93,95,111,17,16,18,17,-0.17768012833094704,-0.024335596167717518,0.1352207065839497,0.9523906574837897,7547,7547,Brown and Nearby Counties,Doniphan,20,43,Kansas,KS
20085,20CS003,130,124,135,125,-5,-10,1,12,-1.7053717378998652,-1.258260969841204,-0.8688545544599224,-3.132655459393386,159,152,165,159,0,-6,7,14,-1.8608710157143993,-1.2352894991991257,-0.6712121875344835,10.502281550153878,13167,13167,Brown and Nearby Counties,Jackson,20,85,Kansas,KS
20087,20CS003,164,156,172,180,16,8,24,23,-0.8266028836209955,-0.37339700061191916,0.07893904117259344,1.3581615826204492,201,191,211,204,3,-7,13,27,-2.1385095371090195,-1.4942026645168203,-0.8677044231068247,6.582173815551533,19110,19110,Brown and Nearby Counties,Jefferson,20,87,Kansas,KS
20117,20CS003,114,113,115,123,9,8,10,24,-1.6911547709370172,-1.576843876330165,-1.4728328786646887,2.4679085620061505,141,139,142,132,-9,-10,-7,14,-2.9679102410590184,-2.803105409859139,-2.6513781666595766,-1.840949258506004,9675,9675,Brown and Nearby Counties,Marshall,20,117,Kansas,KS
20131,20CS003,113,112,114,158,45,44,46,42,0.19954927262149103,0.3088127197524408,0.41794800591257514,0.9103198883185812,139,138,140,123,-16,-17,-15,7,-2.8633797393134297,-2.7104779224012487,-2.5539547263111424,-0.46774732962075005,10150,10150,Brown and Nearby Counties,Nemaha,20,131,Kansas,KS
20015,20CS004,559,530,588,638,79,50,108,38,0.1957293986065245,0.602109547269655,1.0838876334243737,0.47360331073862094,687,652,721,790,103,69,138,101,-0.6481946463005163,0.040361882024438266,0.64807731826139,0.9696269379112934,66957,66957,Butler+Harvey,Butler,20,15,Kansas,KS
20079,20CS004,348,333,362,380,32,18,47,40,-0.6779965271068376,-0.22054553734008428,0.1962732982937262,1.195864027950236,425,408,443,512,87,69,104,61,0.31915878754853844,0.9138395142044765,1.538483901966211,0.6950157894929401,34379,34379,Butler+Harvey,Harvey,20,79,Kansas,KS
20009,20CS005,243,232,254,306,63,52,74,36,0.6225250332170024,1.0358574347034957,1.462778913119254,0.5633676977211748,296,283,309,368,72,59,85,50,0.40177424534275685,1.0074843644481162,1.6584924292681307,0.6844715755618741,25821,25821,Central Kansas,Barton,20,9,Kansas,KS
20051,20CS005,205,193,218,259,54,41,66,57,-0.5719097262221913,-0.09534057642018054,0.32549071440414323,1.0399616569567351,251,236,266,235,-16,-31,-1,18,-2.0470285600243465,-1.4347407609929475,-0.766222877614116,-1.1783627713873022,28660,28660,Central Kansas,Ellis,20,51,Kansas,KS
20053,20CS005,69,69,70,92,23,22,23,17,0.8243442601026006,0.9305183214684601,1.0320016684205044,0.7191765145934058,85,84,86,83,-2,-3,-1,8,-2.0995281083390642,-1.9383632826004966,-1.789084481036737,-9.763524015891111,6068,6068,Central Kansas,Ellsworth,20,53,Kansas,KS
20113,20CS005,307,295,320,356,49,36,61,48,-0.4064795117604096,0.026187058431386627,0.43116608171746185,0.9684319651704416,374,359,388,422,48,34,63,46,-0.5518106999637162,0.09691988550779321,0.6945873581867091,0.9343189202311871,28527,28527,Central Kansas,McPherson,20,113,Kansas,KS
20159,20CS005,101,100,102,107,6,5,7,10,-0.49788614331284003,-0.39066624700630986,-0.2823418126197823,1.3665934691021064,123,122,124,144,21,20,22,15,0.5826493629015094,0.7373973097422569,0.880745188961258,0.6870591054330724,9450,9450,Central Kansas,Rice,20,159,Kansas,KS
20167,20CS005,76,76,77,120,44,43,44,19,3.484541427258865,3.5999259084280557,3.705006943111405,0.4259188469237828,93,93,94,85,-8,-9,-8,13,-3.914686145504646,-3.761864245644328,-3.591024939471548,-1.7505468785645961,6841,6841,Central Kansas,Russell,20,167,Kansas,KS
20017,20CS006,28,28,29,21,-7,-8,-7,1,-3.3392554377626875,-3.236718139888761,-3.129284174002809,-0.15715989455156887,35,34,35,32,-3,-3,-2,5,-3.756269987460293,-3.5871436504644154,-3.442399445667177,-2.893168762402405,2585,2585,Chase+Coffey+Lyon+Marion,Chase,20,17,Kansas,KS
20031,20CS006,84,83,85,89,5,4,6,8,-0.5085798353429402,-0.3994730688819272,-0.2952169629251719,1.399483584619501,103,102,104,111,8,7,9,15,-1.2272836061002383,-1.068526440623836,-0.9012455321997549,1.7123424968962937,8149,8149,Chase+Coffey+Lyon+Marion,Coffey,20,31,Kansas,KS
20111,20CS006,246,232,260,323,77,63,91,68,-0.1696174788979684,0.26214377753285634,0.6665153342321416,0.8720845389402936,303,286,320,320,17,0,34,30,-1.1099041234833384,-0.4679933798283686,0.17434068516158624,1.6529385527647245,33149,33149,Chase+Coffey+Lyon+Marion,Lyon,20,111,Kansas,KS
20115,20CS006,147,142,152,133,-14,-19,-9,10,-2.409923065859508,-2.0142708218562912,-1.5563447789991134,-0.7900022987695251,178,172,185,222,44,37,50,29,0.9011467670583575,1.4943145871750017,2.082510676246238,0.6516240933916273,11756,11756,Chase+Coffey+Lyon+Marion,Marion,20,115,Kansas,KS
20021,20CS007,233,224,241,271,38,30,47,26,0.1953100615764006,0.6351662310096877,1.047584259847182,0.6582797883788356,285,275,295,310,25,15,35,43,-1.7229828663410087,-1.0949116467941706,-0.5428457868712152,1.6685004695488268,19837,19837,Cherokee+Crawford,Cherokee,20,21,Kansas,KS
20037,20CS007,377,360,394,484,107,90,124,53,0.9734733600444443,1.3864220860672676,1.8336558979593034,0.49108832968003213,465,445,485,518,53,33,73,63,-0.9817577356633227,-0.30994055097258305,0.30299886246258145,1.1746973352290224,38732,38732,Cherokee+Crawford,Crawford,20,37,Kansas,KS
20027,20CS008,83,82,84,90,7,6,8,17,-1.3589313067291098,-1.2488293058125166,-1.1462590068065257,2.1353620808873197,101,100,102,113,12,11,13,10,0.12112710494931983,0.27134904071733784,0.42418593446844416,0.7801696901156321,8016,8016,Cloud and Nearby Counties,Clay,20,27,Kansas,KS
20029,20CS008,114,113,115,128,14,13,15,21,-0.9374460645485218,-0.8315481149758716,-0.734199436828243,1.4264145066340144,139,138,140,157,18,17,19,17,-0.061288631363141256,0.10703596445019359,0.25996800735909836,0.9040051184903595,8722,8722,Cloud and Nearby Counties,Cloud,20,29,Kansas,KS
20089,20CS008,31,31,31,31,-0,-0,0,1,-0.5040235528433349,-0.40426527720921396,-0.290055185552413,1.1722423889552707,38,38,38,59,21,21,21,11,4.082905798681962,4.238177071717999,4.388202082110165,0.49883826926189323,2848,2848,Cloud and Nearby Counties,Jewell,20,89,Kansas,KS
20105,20CS008,30,30,30,39,9,9,9,5,1.2650247523631721,1.373300227249889,1.4778884198415865,0.49602225788062226,36,36,37,40,4,3,4,4,-0.3522611489442481,-0.18665500248321512,-0.02197367268742942,0.8808647301343691,2973,2973,Cloud and Nearby Counties,Lincoln,20,105,Kansas,KS
20123,20CS008,69,69,70,76,7,6,7,4,0.3406321822234795,0.44435585599264904,0.5451332540807282,0.5243748606804963,85,84,85,97,12,12,13,12,-0.05253996204635413,0.09624954530012952,0.2613966158172333,0.8896764424198882,5930,5930,Cloud and Nearby Counties,Mitchell,20,123,Kansas,KS
20141,20CS008,49,48,49,48,-1,-1,-0,4,-1.5023503545416332,-1.387647456814948,-1.278677302644067,18.497535642756986,59,59,60,59,-0,-1,0,7,-2.7410749754283756,-2.5914306333023274,-2.4207676561686515,11.947729418782528,3438,3438,Cloud and Nearby Counties,Osborne,20,141,Kansas,KS
20143,20CS008,61,60,61,64,3,3,4,11,-1.417222158868886,-1.3143921204219255,-1.2104906269991176,2.456994308358609,74,73,74,75,1,1,2,10,-1.9999668934858355,-1.84013040846597,-1.6784908895814088,4.432538961657259,5713,5713,Cloud and Nearby Counties,Ottawa,20,143,Kansas,KS
20157,20CS008,68,67,68,65,-3,-3,-2,10,-2.930827657014825,-2.827368302620828,-2.727653420031564,-5.3252534022846705,83,82,83,86,3,3,4,7,-1.1173526955271207,-0.9649861351368257,-0.8104084144385209,1.6142892030872826,4552,4552,Cloud and Nearby Counties,Republic,20,157,Kansas,KS
20183,20CS008,47,47,47,43,-4,-4,-4,5,-2.601364942718765,-2.5020668272271678,-2.401060341254442,-1.7236955937648981,57,57,58,55,-2,-3,-2,2,-1.5518366794598617,-1.391393995068191,-1.2335630165213594,-1.7754174082965652,3560,3560,Cloud and Nearby Counties,Smith,20,183,Kansas,KS
20201,20CS008,59,59,60,66,7,6,7,10,-0.703222309380505,-0.6041659125877766,-0.5067497109232673,1.2972453510791606,72,72,73,83,11,10,11,10,0.015955003922151347,0.17092084008607814,0.3301593843719728,0.8503232109766274,5440,5440,Cloud and Nearby Counties,Washington,20,201,Kansas,KS
20041,20CS009,197,189,205,203,6,-2,14,23,-1.3682361669626328,-0.933022518952343,-0.5002530391223102,3.28118902452406,240,231,249,285,45,36,54,47,-0.7552061999958106,-0.1313203090189618,0.4865431745011473,1.022633511015266,18333,18333,Dickinson+Geary+Morris,Dickinson,20,41,Kansas,KS
20061,20CS009,174,160,188,214,40,26,54,26,-0.0275763989948802,0.44054011793478237,0.8523105042651902,0.6334137699505186,216,199,232,273,57,41,74,40,0.03270023333641702,0.6597842482493556,1.2622118221609004,0.6841681794824318,32086,32086,Dickinson+Geary+Morris,Geary,20,61,Kansas,KS
20127,20CS009,66,66,67,77,11,10,11,14,-0.6634197920082922,-0.5586748919481073,-0.44908087595079,1.1791707099517086,81,80,82,75,-6,-7,-5,2,-1.8280407934131666,-1.6705143237242566,-1.5173018602033288,-0.4163275971399652,5596,5596,Dickinson+Geary+Morris,Morris,20,127,Kansas,KS
20045,20CS010,639,586,691,729,90,38,143,53,-0.13854266995187423,0.29789370591787284,0.7102953586150447,0.5808347507707171,793,730,856,848,55,-8,118,40,-0.4737581615918819,0.1668184438787819,0.7942565184875143,0.7139631741580764,122378,122378,Douglas,Douglas,20,45,Kansas,KS
20019,20CS011,43,41,44,41,-2,-3,-0,5,-2.57485719450917,-2.111353177355195,-1.6716362932135684,-6.256318019471793,52,51,54,65,13,11,14,10,0.44101835991803495,1.0456883027867956,1.6742001711150396,0.7240789333015336,3214,3214,Elk and Nearby Counties,Chautauqua,20,19,Kansas,KS
20035,20CS011,371,356,386,429,58,43,73,63,-0.5499399502372966,-0.14139288944082753,0.26707773957272535,1.0642146746324674,453,435,471,504,51,33,69,64,-1.0796683468625166,-0.47211024146298963,0.08013847065589019,1.2379664273965179,34719,34719,Elk and Nearby Counties,Cowley,20,35,Kansas,KS
20049,20CS011,33,32,34,36,3,2,4,2,-0.10246437589513324,0.2961248936085665,0.7296313752150413,0.5322859691098956,41,39,42,50,9,8,11,5,1.5762265648839255,2.150117691435567,2.7063221226508944,0.47652351496347456,2507,2507,Elk and Nearby Counties,Elk,20,49,Kansas,KS
20073,20CS011,81,81,82,87,6,5,6,5,0.010358682234763082,0.11714549008361948,0.22098531464336676,0.7471978469345476,99,98,100,124,25,24,26,13,2.249408555414406,2.4009259077816325,2.5664985187225886,0.5015147718144315,5946,5946,Elk and Nearby Counties,Greenwood,20,73,Kansas,KS
20205,20CS011,92,91,92,112,20,20,21,6,1.6049430927571442,1.7073489950796488,1.816193171763222,0.27979809965798536,112,111,113,155,43,42,44,26,2.3008017365984674,2.467158876313421,2.631684571807511,0.5858509446440578,8475,8475,Elk and Nearby Counties,Wilson,20,205,Kansas,KS
20207,20CS011,40,39,41,51,11,10,12,2,2.499941169742715,2.911014492064978,3.3472333992453955,0.16764060746399256,49,47,50,55,6,5,8,1,1.4438137423734245,2.0816938248405448,2.67180393417626,0.13727677952935435,3062,3062,Elk and Nearby Counties,Woodson,20,207,Kansas,KS
20091,20CS012,3528,3267,3789,3992,464,203,725,479,-0.45229712056921667,-0.02238950187727688,0.410923034086655,1.0309414444381018,4377,4063,4691,4819,442,128,756,420,-0.6321741479017468,0.03936306488836606,0.6442124750048249,0.9480287050945184,604728,604728,Johnson,Johnson,20,91,Kansas,KS
20099,20CS013,222,214,231,241,19,10,27,28,-0.945036127656149,-0.4607366553259623,-0.047662687165785575,1.4177407477042803,272,262,282,303,31,21,41,39,-1.0891933117322476,-0.4536307018512701,0.13836777365249234,1.204886888140761,19655,19655,Labette+Montgomery+Neosho,Labette,20,99,Kansas,KS
20125,20CS013,367,353,380,412,45,32,59,41,-0.277139245107583,0.14277058351567926,0.5370448458238182,0.8825438206715288,448,431,464,542,94,78,111,79,-0.05050011173836342,0.5816708047715966,1.2237309453302825,0.8285689706452332,31674,31674,Labette+Montgomery+Neosho,Montgomery,20,125,Kansas,KS
20133,20CS013,174,167,181,192,18,11,25,17,-0.3673074393497473,0.05554511784397265,0.5008836684570447,0.8985015378337194,213,205,221,241,28,20,36,39,-1.4500809447233176,-0.8532202523679374,-0.20135101379842793,1.3471860821118644,15912,15912,Labette+Montgomery+Neosho,Neosho,20,133,Kansas,KS
20103,20CS014,551,516,586,669,118,83,153,63,0.20583763238429015,0.6686738216698666,1.0805694051459935,0.5291410317513904,679,637,722,793,114,71,156,88,-0.22618661007073393,0.3614774284208196,1.0484688791936079,0.7683782578576713,82051,82051,Leavenworth,Leavenworth,20,103,Kansas,KS
20023,20CS015,31,31,31,48,17,17,17,12,1.8942791841093727,1.9947658340834329,2.09766730510666,0.6587428341073158,38,37,38,41,3,3,4,6,-1.3936052482902397,-1.2314376778749723,-1.0665130696680496,1.3872346049605162,2614,2614,Northwest Kansas,Cheyenne,20,23,Kansas,KS
20039,20CS015,39,39,40,35,-4,-5,-4,5,-3.4107630575410828,-3.3037606713143624,-3.186305853257759,-1.5391796027208056,48,48,48,58,10,10,10,10,-0.15811162046442567,0.007914411835019385,0.16726971067661842,0.9080575340943247,2799,2799,Northwest Kansas,Decatur,20,39,Kansas,KS
20063,20CS015,28,28,29,47,19,18,19,20,-0.6404909590721066,-0.5321203277633185,-0.4318465748582788,1.0207105689852858,35,34,35,44,9,9,10,4,2.205919806657113,2.3627366842585857,2.521353160603243,0.39160897523497196,2647,2647,Northwest Kansas,Gove,20,63,Kansas,KS
20065,20CS015,30,30,30,28,-2,-2,-2,5,-2.9783628396026747,-2.872593325006229,-2.7604172486189875,-5.280576998267241,37,36,37,40,3,3,4,2,0.5250940458790219,0.6755288044346134,0.8275670204591649,0.4587113688825898,2419,2419,Northwest Kansas,Graham,20,65,Kansas,KS
20109,20CS015,28,28,28,39,11,11,11,4,2.3966260267821093,2.4997440785087806,2.6049373453099682,0.3363373698586086,34,34,35,50,16,15,16,3,5.302533690527556,5.461622708050984,5.6298651033724205,0.18107590944074436,2758,2758,Northwest Kansas,Logan,20,109,Kansas,KS
20137,20CS015,56,56,57,76,20,19,20,22,-0.5739408813540233,-0.46316546101621897,-0.3610707321777641,1.0731321387677542,69,68,70,56,-13,-14,-12,2,-3.5766323609625386,-3.409927983798602,-3.263089008048572,-0.16397610488278216,5354,5354,Northwest Kansas,Norton,20,137,Kansas,KS
20147,20CS015,61,61,62,65,4,3,4,15,-2.2252686273968942,-2.120353777179666,-2.0191213983260794,3.0450931363946254,75,74,75,77,2,2,3,16,-3.3254010438122927,-3.1622652962292874,-3.0122917055063447,4.9222276175052775,5220,5220,Northwest Kansas,Phillips,20,147,Kansas,KS
20153,20CS015,35,35,35,32,-3,-3,-3,4,-2.8508320031506367,-2.738541682987992,-2.6365707415938338,-2.155074659244289,43,42,43,37,-6,-6,-5,3,-4.282137402258318,-4.134236406094354,-3.9757954985392217,-0.6495809869395597,2500,2500,Northwest Kansas,Rawlins,20,153,Kansas,KS
20163,20CS015,55,55,56,59,4,3,4,10,-1.3945472319869139,-1.2930073973925378,-1.1934871325525132,2.1410006470569414,68,67,68,73,5,5,6,3,0.39843939722283356,0.5550860149185203,0.7114796004711245,0.4786785363799521,4891,4891,Northwest Kansas,Rooks,20,163,Kansas,KS
20179,20CS015,25,25,25,44,19,19,19,10,3.416332625200111,3.514743283050132,3.614678809589382,0.5038149594112656,31,30,31,40,9,9,10,2,3.2521941796483267,3.4306762928493177,3.571924120979176,0.19638583510114416,2518,2518,Northwest Kansas,Sheridan,20,179,Kansas,KS
20181,20CS015,59,58,59,51,-8,-8,-7,11,-3.2710388407618862,-3.1699517029273525,-3.06571078672704,-1.6699035321771962,72,71,73,62,-10,-11,-9,4,-2.976890814201279,-2.8183673836312706,-2.6717041019148846,-0.4554693301874818,5867,5867,Northwest Kansas,Sherman,20,181,Kansas,KS
20193,20CS015,69,68,70,69,0,-1,1,10,-1.3921515333839563,-1.2850434562519433,-1.1808044755933425,9.110417786792901,84,83,85,72,-12,-13,-11,14,-4.281956438394249,-4.124051328276279,-3.9511278299880357,-1.2182630497350182,7703,7703,Northwest Kansas,Thomas,20,193,Kansas,KS
20195,20CS015,36,36,37,45,9,8,9,2,2.254122376912354,2.3607745277639274,2.458506940434459,0.20981147543440967,45,44,45,45,0,0,1,4,-1.7157256191613763,-1.5606019303101815,-1.4066188343759765,2.8622278534953742,2770,2770,Northwest Kansas,Trego,20,195,Kansas,KS
20199,20CS015,14,14,14,15,1,1,1,5,-2.8306518660344726,-2.719669711346834,-2.617877556361677,2.7079438231249764,17,17,18,19,2,1,2,3,-1.2273823471867151,-1.0662646154285056,-0.9003110716550817,1.1324307161813365,1526,1526,Northwest Kansas,Wallace,20,199,Kansas,KS
20025,20CS016,27,27,27,33,6,6,6,7,-0.6763773954275363,-0.5593192510626132,-0.45763167925645104,1.0173714359578356,34,33,34,31,-3,-3,-2,3,-3.505075325609528,-3.3422211661875716,-3.1749797731309286,-1.9549742544565312,1988,1988,Pawnee and Nearby Counties,Clark,20,25,Kansas,KS
20033,20CS016,25,25,25,29,4,4,4,2,0.9203418902787591,1.0331912251453819,1.1454866750506887,0.4203004325917192,31,31,31,32,1,1,1,4,-2.402292430778334,-2.2405891000686697,-2.082218245614675,2.1861300948623708,1698,1698,Pawnee and Nearby Counties,Comanche,20,33,Kansas,KS
20047,20CS016,36,36,37,69,33,32,33,11,7.7215951368909055,7.815049560248317,7.923723759769958,0.3269182036842819,45,45,45,60,15,15,15,2,5.481340045789238,5.645531339304381,5.797620175338614,0.12484592420522227,2769,2769,Pawnee and Nearby Counties,Edwards,20,47,Kansas,KS
20057,20CS016,214,199,228,253,39,25,54,41,-0.48102367945251656,-0.04109011188384637,0.3698223778121967,1.0150168918794265,266,249,283,276,10,-7,27,56,-2.2778386149116288,-1.6479145800198314,-1.0951932899840962,5.072021178391781,33241,33241,Pawnee and Nearby Counties,Ford,20,57,Kansas,KS
20083,20CS016,22,22,23,20,-2,-3,-2,2,-2.6022941453213373,-2.4913372186774665,-2.3900292062295323,-1.4145453815703544,28,28,28,41,13,13,13,5,5.43690392648863,5.595316289520394,5.761920857015236,0.3508947664552773,1770,1770,Pawnee and Nearby Counties,Hodgman,20,83,Kansas,KS
20097,20CS016,25,25,25,29,4,4,4,3,0.30637085842754336,0.4103804678323447,0.5151148448151962,0.5980544616850643,31,31,31,37,6,6,6,4,0.7943080454332796,0.9406440536678846,1.08711983625314,0.5770405710278413,2464,2464,Pawnee and Nearby Counties,Kiowa,20,97,Kansas,KS
20135,20CS016,39,39,40,55,16,15,16,14,0.4692067437104283,0.5768350511482747,0.6802871846282873,0.8432036094539244,49,48,49,53,4,4,5,3,0.40984705549152867,0.5704950966653484,0.736033500746524,0.5644307096726253,2776,2776,Pawnee and Nearby Counties,Ness,20,135,Kansas,KS
20145,20CS016,74,73,74,82,8,8,9,3,0.7363771460907678,0.843450597182804,0.9413328462778184,0.3202375201793906,91,90,92,85,-6,-7,-5,13,-3.788788968840543,-3.633566040298789,-3.4927328847536705,-2.443924792767213,6376,6376,Pawnee and Nearby Counties,Pawnee,20,145,Kansas,KS
20165,20CS016,50,50,51,58,8,7,8,13,-1.941099344937173,-1.838387070518625,-1.7250967233280399,1.5228792522576255,62,62,63,60,-2,-3,-2,1,-1.4420496992063094,-1.2895827840411103,-1.1409980572486502,-0.8329863176198204,2974,2974,Pawnee and Nearby Counties,Rush,20,165,Kansas,KS
20149,20CS017,162,152,173,180,18,7,28,16,-0.38988410347016,0.07239185793925992,0.4773397667008921,0.8564425792669543,200,187,213,225,25,12,38,34,-1.0558498543737989,-0.44768592111467653,0.1635599966501334,1.298179727224094,24574,24574,Pottawatomie+Riley+Wabaunsee,Pottawatomie,20,149,Kansas,KS
20161,20CS017,312,281,344,348,36,4,67,22,-0.2523641524897101,0.18744515865428457,0.6376203636900014,0.6006139295044499,389,352,427,431,42,4,79,32,-0.48387182896871084,0.1816184764247963,0.8382188059068342,0.7515046205560675,72945,72945,Pottawatomie+Riley+Wabaunsee,Riley,20,161,Kansas,KS
20197,20CS017,54,54,55,57,3,2,3,6,-0.6020303036165517,-0.49780261544612125,-0.3917675367019759,1.6843179086823155,67,66,68,92,25,24,26,10,2.506506706097061,2.6545258275865513,2.8089611783993997,0.38070168087598444,6898,6898,Pottawatomie+Riley+Wabaunsee,Wabaunsee,20,197,Kansas,KS
20155,20CS018,612,585,639,746,134,107,161,94,0.214209922393719,0.6387254398398686,1.075596209299604,0.6959639843502189,748,716,780,825,77,45,109,75,-0.5728232935317021,0.02870147380209977,0.6573593982918319,0.9614444676099619,61892,61892,Reno,Reno,20,155,Kansas,KS
20169,20CS019,477,453,500,545,68,45,92,77,-0.5836290954874217,-0.1630722163500516,0.23140356667149548,1.1092568673954062,586,558,614,736,150,122,178,130,-0.19959437874930147,0.4362463211396256,1.0520904026448505,0.8602795080496097,54051,54051,Saline,Saline,20,169,Kansas,KS
20055,20CS020,192,177,208,275,83,67,98,59,0.2195941176244668,0.6463361125469019,1.0822110451252933,0.7060145759324998,239,221,258,324,85,66,103,45,0.6645947073367444,1.3243552429700478,1.877293003929347,0.5245866039278265,36170,36170,Scott and Nearby Counties,Finney,20,55,Kansas,KS
20071,20CS020,20,19,20,24,4,4,5,3,1.0488616008957377,1.1527485088792215,1.2696687469712755,0.5565231403712841,24,24,24,27,3,3,3,3,-0.08453703116570732,0.06679675430197973,0.22869918430720823,0.7375604551993877,1205,1205,Scott and Nearby Counties,Greeley,20,71,Kansas,KS
20075,20CS020,20,20,20,20,-0,-0,0,3,-1.4062611347750227,-1.2986831522855897,-1.194944360419319,3.816336801263301,25,24,25,27,2,2,3,7,-2.455335397270189,-2.3031696045459533,-2.1425786535297524,2.156238847553943,2478,2478,Scott and Nearby Counties,Hamilton,20,75,Kansas,KS
20093,20CS020,28,27,28,29,1,1,2,7,-1.5890959320205442,-1.483435686961971,-1.3743590698450199,2.917513879235745,34,33,34,48,14,14,15,2,3.713995302273543,3.8640420838335183,4.012127215768814,0.1318060625933774,3781,3781,Scott and Nearby Counties,Kearny,20,93,Kansas,KS
20101,20CS020,24,24,24,26,2,2,2,6,-2.679662200828336,-2.5743906236524943,-2.4719015158740465,1.9496066734300355,29,29,29,33,4,4,4,5,-1.1116344684015271,-0.9427242682907016,-0.7925598666232714,1.041684884584739,1523,1523,Scott and Nearby Counties,Lane,20,101,Kansas,KS
20171,20CS020,43,42,43,55,12,12,13,16,-0.8638696435134671,-0.7553574684860761,-0.6492451164304643,1.1981150835718666,52,52,53,72,20,19,20,12,1.76836430308967,1.9374543184004953,2.092450369034093,0.5768150962886966,4825,4825,Scott and Nearby Counties,Scott,20,171,Kansas,KS
20203,20CS020,19,19,19,31,12,12,12,5,3.1971654488338825,3.3015401691951194,3.4048828062247143,0.386645067982682,23,23,24,30,7,6,7,7,-0.3506174162932812,-0.19003141153355757,-0.036529177659374405,0.9131998042443628,2100,2100,Scott and Nearby Counties,Wichita,20,203,Kansas,KS
20173,20CS021,3889,3665,4112,4833,944,721,1168,497,0.44728095427623316,0.8612199063521297,1.3144136201724572,0.5257813340542993,4785,4517,5054,5621,836,567,1104,611,-0.13394091764213306,0.5160675716911192,1.153366800285474,0.7301781536239288,517966,517966,Sedgwick,Sedgwick,20,173,Kansas,KS
20177,20CS022,1626,1550,1701,1914,288,213,364,239,-0.13689092724025814,0.2807862668354228,0.7159661208065219,0.82580315430698,1993,1902,2084,2153,160,69,251,238,-1.1590557643947321,-0.5320278707944592,0.05548919618317606,1.4772827760123348,176428,176428,Shawnee,Shawnee,20,177,Kansas,KS
20007,20CS023,51,51,52,66,15,14,15,3,2.5811627500944065,2.688088918311053,2.7943135555874243,0.18912159048159263,63,63,64,66,3,2,3,5,-0.736596907116164,-0.587253646035964,-0.43903420409274185,1.2987894332854901,4416,4416,South Central Kansas,Barber,20,7,Kansas,KS
20077,20CS023,77,76,77,94,17,17,18,14,0.4966282794954963,0.6023016030462859,0.707602678417913,0.7662909042627679,94,94,95,78,-16,-17,-16,7,-5.376408406614051,-5.220422496268825,-5.071603759717171,-0.4518774194338452,5398,5398,South Central Kansas,Harper,20,77,Kansas,KS
20095,20CS023,149,146,152,212,63,60,66,31,4.144727638471011,4.525391997729273,4.9836102817680015,0.485712487989997,182,178,186,265,83,79,87,35,7.599984618923563,8.176552493453594,8.830279322392544,0.4168008383515052,7022,7022,South Central Kansas,Kingman,20,95,Kansas,KS
20151,20CS023,101,100,102,124,23,22,24,25,-0.34435454686207706,-0.23907699942930521,-0.13139443393311853,1.049424705669342,125,124,126,129,4,3,5,6,-0.4187099272801718,-0.2655026288780698,-0.12047702378852251,1.2067619350985348,9119,9119,South Central Kansas,Pratt,20,151,Kansas,KS
20185,20CS023,51,50,51,59,8,8,9,8,-0.032790938709756634,0.07521840676278903,0.18125020335135222,0.8581879943040571,63,62,63,81,18,18,19,16,0.5924316909365299,0.7411985723287784,0.8877216178708394,0.8212048713617683,4066,4066,South Central Kansas,Stafford,20,185,Kansas,KS
20191,20CS023,233,223,242,270,37,28,47,42,-0.6303698164401742,-0.19951511212420434,0.23327111290182848,1.0974935835821833,289,278,301,322,33,21,44,30,-0.50829129732366,0.15020971419489582,0.7751300869548398,0.8920351436454282,22713,22713,South Central Kansas,Sumner,20,191,Kansas,KS
20067,20CS024,50,49,50,60,10,10,11,16,-0.9100944883485506,-0.8071000460909191,-0.7016431067174532,1.419536957969938,62,61,63,59,-3,-4,-2,16,-3.3106389220931183,-3.1585325763876644,-3.0041180541735275,-9.402856053788263,7111,7111,Southwest Kansas,Grant,20,67,Kansas,KS
20069,20CS024,47,47,48,55,8,7,8,10,-0.5018368904967623,-0.3993991245091916,-0.28760771397338813,1.1607582976714164,59,58,59,66,7,7,8,11,-0.8817047632659167,-0.7395738452690978,-0.5871797553592341,1.3185003581160981,5978,5978,Southwest Kansas,Gray,20,69,Kansas,KS
20081,20CS024,27,26,27,25,-2,-2,-1,5,-1.7732981565268118,-1.6720177823857636,-1.5707204117637437,-8.15162711651992,33,33,34,35,2,1,2,3,-0.4752809123733354,-0.31589474626910286,-0.1559636331585644,1.0160290091996258,3960,3960,Southwest Kansas,Haskell,20,81,Kansas,KS
20119,20CS024,42,42,43,56,14,13,14,5,2.0562642787010206,2.163254583427409,2.2728188044110382,0.3399010883405918,52,52,53,58,6,5,6,7,-0.4929193191571332,-0.33763400229396606,-0.1780235106481495,1.0183447804507402,4026,4026,Southwest Kansas,Meade,20,119,Kansas,KS
20129,20CS024,30,30,31,36,6,5,6,1,1.7297045940553175,1.8364762199940166,1.945787703769962,0.15031800806151002,37,37,38,44,7,6,7,5,0.6262870969963514,0.7806826493782807,0.9521373906704305,0.6532406632821953,2537,2537,Southwest Kansas,Morton,20,129,Kansas,KS
20175,20CS024,114,112,116,141,27,25,29,38,-0.6290011179597131,-0.5236413517423636,-0.41246052401831707,1.3617726984946512,142,140,145,163,21,18,23,14,0.2146162272029753,0.369001710931993,0.5360935086092656,0.6484622499393815,21261,21261,Southwest Kansas,Seward,20,175,Kansas,KS
20187,20CS024,17,17,18,16,-1,-2,-1,2,-1.7739023187655603,-1.667200138898899,-1.5678956346477508,-6.560177185829376,21,21,22,19,-2,-3,-2,4,-4.02773324902227,-3.8714183448121617,-3.723972860531372,-2.8846932916272205,1980,1980,Southwest Kansas,Stanton,20,187,Kansas,KS
20189,20CS024,41,40,42,46,5,4,6,5,-0.09397238600096373,0.00801474669021412,0.11516829316296817,0.8269261941219999,51,50,51,53,2,2,3,10,-1.8659615006838735,-1.711243727774093,-1.561233203209679,3.063034798845011,5398,5398,Southwest Kansas,Stevens,20,189,Kansas,KS
20209,20CS025,1192,1121,1263,1474,282,211,353,213,-0.03293986115941498,0.41768452553839597,0.832550979478868,0.7527995978353779,1469,1383,1554,1648,179,94,265,174,-0.5977638739966874,0.03778794577825064,0.6725942926584151,0.9641525196275083,165699,165699,Wyandotte,Wyandotte,20,209,Kansas,KS
21001,21CS001,180,172,189,268,88,79,96,44,1.8235023633625995,2.243409180467632,2.673261214933987,0.49709769089706013,221,211,232,270,49,38,59,40,-0.10129500347441817,0.5354116497769621,1.144147228299755,0.8079604206436456,19507,19507,Adair and Nearby Counties,Adair,21,1,Kentucky,KY
21045,21CS001,170,163,177,210,40,33,47,25,0.4607394994504856,0.9067413534351246,1.3450156778031988,0.6150454579048874,208,200,217,242,34,25,42,39,-0.9976621235804354,-0.4063594685047216,0.24079377753908332,1.1220592701347007,16146,16146,Adair and Nearby Counties,Casey,21,45,Kentucky,KY
21087,21CS001,127,126,128,141,14,13,15,16,-0.317359612760806,-0.2116770171768301,-0.09791571059382621,1.0873495767232753,156,155,157,164,8,7,9,28,-2.3523973324026097,-2.1973305271552297,-2.0321082208064616,3.1271860214451412,10968,10968,Adair and Nearby Counties,Green,21,87,Kentucky,KY
21207,21CS001,218,210,226,272,54,46,62,33,0.7572940343303556,1.1738395641791104,1.593411710064581,0.5986043801872943,266,257,275,310,44,35,53,35,-0.027515619138758707,0.6227683093561471,1.226205058550015,0.7770655975343655,17966,17966,Adair and Nearby Counties,Russell,21,207,Kentucky,KY
21217,21CS001,266,255,277,311,45,34,56,28,0.23392714998101344,0.6703281269421677,1.095138215543904,0.6057329738124382,325,312,339,445,120,106,133,66,1.8966092346162007,2.5153598294057318,3.106774347038577,0.5465873350651395,25723,25723,Adair and Nearby Counties,Taylor,21,217,Kentucky,KY
21005,21CS002,204,194,214,246,42,32,52,13,0.8340938744702944,1.2770128756678913,1.6872662754751702,0.3034597267573636,250,238,261,290,40,29,52,47,-0.9769569749371461,-0.3609894305619798,0.24831356263474702,1.135938320824707,22755,22755,Anderson+Franklin,Anderson,21,5,Kentucky,KY
21073,21CS002,483,461,505,528,45,23,67,40,-0.3292136028550304,0.08167139571734883,0.5172853035240987,0.8740087575211427,590,564,617,754,164,137,190,79,1.3632519365020932,1.9902180494662336,2.6236429258734653,0.479370264582667,50983,50983,Anderson+Franklin,Franklin,21,73,Kentucky,KY
21003,21CS003,210,201,219,231,21,12,30,30,-0.8460787485018908,-0.42216041694921563,-0.029471563683394226,1.3520108120516174,256,245,267,288,32,21,43,47,-1.5137666805663987,-0.8412242906955073,-0.22873767655180124,1.4332776383586707,21313,21313,Barren and Nearby Counties,Allen,21,3,Kentucky,KY
21009,21CS003,446,427,465,507,61,42,80,45,-0.060778568371494646,0.35853288288651863,0.8272803429606095,0.722608963240878,544,521,567,653,109,86,132,111,-0.6687203315573389,-0.06994149476700576,0.5574320215905032,1.0113667410001448,44233,44233,Barren and Nearby Counties,Barren,21,9,Kentucky,KY
21099,21CS003,193,184,201,227,34,26,43,31,-0.2851703727935053,0.17820131362486996,0.5747709281954124,0.8765365110101686,235,225,245,269,34,24,44,45,-1.3186265091056737,-0.6823529906518815,-0.07436687293387752,1.290610375797449,19014,19014,Barren and Nearby Counties,Hart,21,99,Kentucky,KY
21169,21CS003,116,115,117,148,32,31,33,14,1.6940876364334045,1.8052031984607764,1.9013673485197304,0.422121172916595,142,140,143,160,18,17,20,34,-2.045110985979421,-1.8809438702987893,-1.7237691948530849,1.7680043355246842,10073,10073,Barren and Nearby Counties,Metcalfe,21,169,Kentucky,KY
21171,21CS003,141,136,146,152,11,6,16,37,-2.8751514048092495,-2.462011697720059,-2.016226387108549,3.092999305368131,171,166,177,185,14,8,19,37,-3.203168735614167,-2.630013772965157,-2.0335056818236303,2.5182036621506847,10610,10610,Barren and Nearby Counties,Monroe,21,171,Kentucky,KY
21011,21CS004,145,140,150,150,5,-0,10,10,-0.8010422443802734,-0.40835871345852615,0.01188280072094124,1.642910180527591,176,170,183,220,44,37,50,19,1.748517114847965,2.3939411194198827,2.9817083739777788,0.4243261237547857,12511,12511,Bath+Clark+Montgomery+Rowan,Bath,21,11,Kentucky,KY
21049,21CS004,362,346,378,396,34,18,50,17,0.024363506872223502,0.4648709206428536,0.8983388557716442,0.4843497095955786,441,423,460,518,77,58,95,31,0.8815465608802369,1.5104998427035614,2.119467180138601,0.3997055351698163,36356,36356,Bath+Clark+Montgomery+Rowan,Clark,21,49,Kentucky,KY
21173,21CS004,269,257,281,306,37,25,49,20,0.16244337401763795,0.5848995627364773,1.0315194859384142,0.531513622411275,329,314,343,428,99,85,114,67,0.7565016795881059,1.3984766145699778,1.9965362364411932,0.6675109403398212,28192,28192,Bath+Clark+Montgomery+Rowan,Montgomery,21,173,Kentucky,KY
21205,21CS004,198,187,209,230,32,21,43,11,0.4426911056451013,0.8557344833134019,1.2759678300915631,0.3324097810537058,242,230,255,327,85,72,97,45,1.332184305572301,1.9521444161916361,2.5220543862769937,0.5253702881534447,24587,24587,Bath+Clark+Montgomery+Rowan,Rowan,21,205,Kentucky,KY
21013,21CS005,336,325,347,362,26,15,37,40,-1.0070240334225817,-0.5506030220239218,-0.1359197289349393,1.4783564345444096,410,397,423,541,131,118,144,80,1.7799036519283276,2.354602537074799,3.012557097039043,0.6069161554600296,25799,25799,Bell+Harlan,Bell,21,13,Kentucky,KY
21095,21CS005,352,341,363,471,119,108,130,31,2.9968671005459835,3.4191788730251913,3.8272216926407756,0.25836947398715937,430,416,443,587,157,144,171,87,2.6506441882950442,3.2764122696362605,3.8808700443772794,0.5495127061971071,25796,25796,Bell+Harlan,Harlan,21,95,Kentucky,KY
21015,21CS006,822,763,880,911,89,31,148,91,-0.4723221576214376,-0.015612167918326243,0.43854735479615964,1.0064699281131926,1018,948,1088,1167,149,79,219,160,-0.7023698734603159,-0.09298337121881138,0.4990934796509666,1.0679397157183819,134389,134389,Boone,Boone,21,15,Kentucky,KY
21017,21CS007,201,193,210,202,1,-8,9,1,-0.435795349118639,-0.026776515092670098,0.42720887292539517,0.6226460627095016,247,237,257,333,86,76,96,37,2.313758746881787,2.985090039648925,3.6228688222467813,0.4255082093605869,19827,19827,Bourbon+Fleming+Lewis+Nicholas,Bourbon,21,17,Kentucky,KY
21069,21CS007,159,153,165,179,20,14,26,17,-0.20907801959620292,0.20136289691705225,0.6694532219800938,0.8063987230290114,195,187,202,208,13,6,21,29,-1.8680489469937962,-1.2676294457609216,-0.6609537719941411,2.011131290781588,14586,14586,Bourbon+Fleming+Lewis+Nicholas,Fleming,21,69,Kentucky,KY
21135,21CS007,159,153,165,174,15,9,21,29,-1.4987158538905099,-1.0614333557596387,-0.619218096798407,1.8100835981413168,194,187,201,228,34,27,41,39,-1.0627731217655267,-0.46061911806362077,0.11974131557228732,1.120995564253247,13289,13289,Bourbon+Fleming+Lewis+Nicholas,Lewis,21,135,Kentucky,KY
21181,21CS007,84,83,85,77,-7,-8,-6,4,-1.653271155871766,-1.5501646503985707,-1.4328309298602124,-0.6467598174698853,103,102,104,116,13,12,14,21,-1.4878184077021905,-1.3379211511244946,-1.1806640983122514,1.5090032120009067,7242,7242,Bourbon+Fleming+Lewis+Nicholas,Nicholas,21,181,Kentucky,KY
21019,21CS008,553,533,573,641,88,68,108,50,0.3824362163070489,0.8206235445278207,1.251678005266427,0.5593931345057442,678,654,702,788,110,86,134,78,0.23992404718407023,0.8152862864787273,1.3811215656536184,0.7056536109135699,46704,46704,Boyd+Carter+Greenup,Boyd,21,19,Kentucky,KY
21043,21CS008,292,281,303,304,12,1,23,22,-0.7888023538343304,-0.3659133387873072,0.06863554513153104,1.6915974160482878,359,345,373,430,71,57,85,56,0.08448119197375241,0.6620756361095909,1.3212243841628686,0.7789523031694356,26673,26673,Boyd+Carter+Greenup,Carter,21,43,Kentucky,KY
21089,21CS008,415,400,430,498,83,68,98,37,0.8674696331350062,1.2983944822896223,1.7331824591913534,0.4425019302466262,510,492,528,575,65,47,83,66,-0.6625063086367247,-0.020739575475084187,0.5421339310295554,0.9981372481349019,35039,35039,Boyd+Carter+Greenup,Greenup,21,89,Kentucky,KY
21021,21CS009,299,286,312,339,40,27,53,45,-0.63835371422073806,-0.18837166726873794,0.2488871741329594,1.1077183543105977,369,353,384,441,72,57,88,55,0.07424467566092012,0.6893870145060672,1.333007078922435,0.7503541629168337,30153,30153,Boyle+Lincoln+Mercer,Boyle,21,21,Kentucky,KY
21137,21CS009,264,253,274,309,45,35,56,37,-0.0953201072262742,0.3358667663160513,0.7552451937242886,0.803821822447783,324,311,337,433,109,96,122,64,1.5526321115354145,2.2179869630844817,2.822220761478142,0.5819274157062287,24497,24497,Boyle+Lincoln+Mercer,Lincoln,21,137,Kentucky,KY
21167,21CS009,249,239,258,260,11,2,21,25,-1.0859222435856486,-0.6469982920004099,-0.19887531082329404,2.0503458252295017,305,294,316,350,45,34,56,51,-0.9466452308184337,-0.3316004371598701,0.30596232277201635,1.1105273711736208,21908,21908,Boyle+Lincoln+Mercer,Mercer,21,167,Kentucky,KY
21023,21CS010,82,81,83,90,8,7,9,8,-0.08922010391091102,0.012780900632581572,0.11325829378180276,0.8780739613197069,100,99,101,139,39,38,40,22,2.2429560449288766,2.403535702340704,2.5421508609884986,0.5552842083127602,8312,8312,Bracken and Nearby Counties,Bracken,21,23,Kentucky,KY
21097,21CS010,200,192,208,209,9,1,17,11,-0.5222361640813686,-0.0845743798542304,0.34213484327358884,1.0716809894116837,245,236,255,296,51,41,60,43,-0.12982431366047495,0.4693205066734988,1.1467516796453199,0.8334688838400129,18872,18872,Bracken and Nearby Counties,Harrison,21,97,Kentucky,KY
21161,21CS010,202,195,210,197,-5,-13,2,21,-1.9747403225448017,-1.5377642443338857,-1.1278796066063963,-4.902026894428909,248,239,257,272,24,15,33,44,-2.011782488895598,-1.3892795984596429,-0.7839558488978433,1.745974818552031,17043,17043,Bracken and Nearby Counties,Mason,21,161,Kentucky,KY
21191,21CS010,147,141,153,153,6,-0,12,8,-0.5598511762210306,-0.14431420907650053,0.30976936298760877,1.127161686194537,181,173,188,209,28,21,36,23,-0.13942931449308035,0.4582951402954768,1.0935986207551311,0.7836290121645947,14574,14574,Bracken and Nearby Counties,Pendleton,21,191,Kentucky,KY
21201,21CS010,26,26,27,39,13,12,13,1,5.279819255043518,5.379028378546597,5.488822268023272,0.07387335535629645,32,32,33,39,7,6,7,7,-0.377968314390359,-0.21815245910822254,-0.06522789276646598,0.9196402217727221,2144,2144,Bracken and Nearby Counties,Robertson,21,201,Kentucky,KY
21027,21CS011,205,196,213,249,44,36,53,15,0.9897254527057905,1.4332116774013979,1.8652742110990568,0.3299931569975408,249,238,260,353,104,93,115,44,2.891189909462041,3.537788148396159,4.126474924487813,0.4187255574099058,20498,20498,Breckinridge+Grayson+Hancock+Meade,Breckinridge,21,27,Kentucky,KY
21085,21CS011,281,269,292,314,33,22,45,40,-0.6716995908475458,-0.23127960854502636,0.16139799231472565,1.1595762905555032,341,327,355,447,106,92,120,65,1.2665485004387869,1.831299068565634,2.4604940088935847,0.6076828498053084,26454,26454,Breckinridge+Grayson+Hancock+Meade,Grayson,21,85,Kentucky,KY
21091,21CS011,74,73,75,102,28,27,29,4,2.6063299800778115,2.7111863480200897,2.8248341446519465,0.13942811073226702,91,90,92,114,23,22,24,8,1.865960595032483,2.040844689186499,2.192440684765258,0.3362397433565132,8727,8727,Breckinridge+Grayson+Hancock+Meade,Hancock,21,91,Kentucky,KY
21163,21CS011,225,213,238,243,18,5,30,13,-0.2433487232945314,0.15534644644375473,0.5607800281865237,0.7008656917789462,275,261,290,356,81,66,95,63,0.13191515952770175,0.7344072829670653,1.3791589803445814,0.770945705574275,28612,28612,Breckinridge+Grayson+Hancock+Meade,Meade,21,163,Kentucky,KY
21029,21CS012,568,533,603,699,131,96,166,63,0.4267274267731805,0.8343528298134528,1.2895511390885432,0.47733642118037883,699,656,741,850,151,109,194,103,0.08340204700249315,0.722455661111307,1.299694175126317,0.6762124342633322,81961,81961,Bullitt+Spencer,Bullitt,21,29,Kentucky,KY
21215,21CS012,148,139,156,157,9,1,18,12,-0.5951307520593805,-0.1310202135614287,0.30793725901536084,1.1536785180872144,181,171,191,213,32,22,42,26,-0.2461506884580738,0.34483907416071574,0.9500310668168492,0.7960633875900686,19420,19420,Bullitt+Spencer,Spencer,21,215,Kentucky,KY
21031,21CS013,149,144,155,170,21,15,26,20,-0.37991325843584073,0.06174907279577312,0.5109201786562338,0.9127339063684484,182,176,189,189,7,0,13,30,-2.7819103463467685,-2.1624621492684986,-1.482503712368237,3.790266003472778,12795,12795,Butler+McLean+Muhlenberg+Ohio,Butler,21,31,Kentucky,KY
21149,21CS013,101,100,102,128,27,26,28,16,1.1314742596127507,1.2344506694119821,1.3409453845499149,0.5659568154701039,124,122,125,145,21,20,23,21,-0.09510901197932606,0.04558261111126863,0.2101757032058076,0.9388662070981068,9126,9126,Butler+McLean+Muhlenberg+Ohio,McLean,21,149,Kentucky,KY
21177,21CS013,329,316,342,364,35,22,48,42,-0.6557066786108562,-0.22749397422926182,0.20563281246545656,1.1623133284578093,402,387,418,481,79,63,94,61,0.06906912854847354,0.6831618528239869,1.3344507673095045,0.7669839555565348,30588,30588,Butler+McLean+Muhlenberg+Ohio,Muhlenberg,21,177,Kentucky,KY
21183,21CS013,248,238,258,260,12,2,22,29,-1.125899450777121,-0.7149462476275179,-0.2996127670120538,2.2660214398898613,304,292,316,371,67,55,79,46,0.4531627445404119,1.0524853414870372,1.6638690981128523,0.6767419345716676,23983,23983,Butler+McLean+Muhlenberg+Ohio,Ohio,21,183,Kentucky,KY
21035,21CS014,345,328,362,404,59,42,76,40,0.02639602831849436,0.4636697223772133,0.9261024838885952,0.6681811454564417,425,404,445,509,84,64,105,40,0.7338909223977,1.382120495143271,1.9795528700574128,0.46828725158292717,39168,39168,Calloway+Marshall,Calloway,21,35,Kentucky,KY
21157,21CS014,374,361,388,385,11,-3,24,35,-1.24551089567559,-0.7882865697002466,-0.38554758433938935,2.970115237595153,457,441,473,510,53,37,69,48,-0.4216754555783736,0.19071950760850728,0.781619640363802,0.8925238363845308,31134,31134,Calloway+Marshall,Marshall,21,157,Kentucky,KY
21037,21CS015,752,711,792,817,65,25,106,58,-0.3721313529152769,0.07533763774068847,0.48670382976246185,0.8727672278096641,924,875,972,956,32,-16,81,84,-1.2923068450065682,-0.6368661999953766,-0.0416599569017758,2.516569603008831,93916,93916,Campbell,Campbell,21,37,Kentucky,KY
21047,21CS016,527,496,558,668,141,110,172,72,0.5671823357403916,0.9721230374154959,1.4059211452273555,0.5069101174410068,652,615,689,834,182,145,219,102,0.7608657352159125,1.3525181372771342,1.932402908427141,0.556587199008845,71536,71536,Christian,Christian,21,47,Kentucky,KY
21051,21CS017,234,225,242,236,2,-6,11,21,-1.3669007311795478,-0.9406928333892828,-0.5151733915603586,6.099997352365955,288,278,298,389,101,91,111,43,2.96405057866719,3.533143488287576,4.111054466784864,0.42064978972427675,19795,19795,Clay+Jackson+Leslie+Owsley,Clay,21,51,Kentucky,KY
21109,21CS017,158,153,164,173,15,9,20,23,-1.099668506148671,-0.6101698706656513,-0.22278864856724304,1.473094631932937,195,189,202,224,29,22,35,42,-1.8099830788221931,-1.2198929923557627,-0.6113929143867012,1.4201893862258386,13326,13326,Clay+Jackson+Leslie+Owsley,Jackson,21,109,Kentucky,KY
21131,21CS017,149,144,153,132,-17,-21,-12,3,-2.4282681697728914,-1.9992918114154568,-1.6024099103033005,-0.19273279184693895,182,177,187,206,24,19,29,29,-1.1959710043345726,-0.5804293057701956,0.018623920926533054,1.1486195766488445,9779,9779,Clay+Jackson+Leslie+Owsley,Leslie,21,131,Kentucky,KY
21189,21CS017,62,62,63,91,29,28,29,12,3.756228823498698,3.868335604626633,3.9699957749514976,0.40109590632064374,76,76,77,83,7,6,7,7,-0.237849739091476,-0.08317495271178518,0.06502051487503648,0.9095690694759302,4379,4379,Clay+Jackson+Leslie+Owsley,Owsley,21,189,Kentucky,KY
21053,21CS018,112,111,114,145,33,31,34,21,1.038408960223223,1.137311652367452,1.2425680032079012,0.6257972545208044,138,136,139,157,19,18,21,21,-0.37133044280663524,-0.21940724229472583,-0.05514163354933943,1.0408193897526647,10162,10162,Clinton+Cumberland+McCreary+Wayne,Clinton,21,53,Kentucky,KY
21057,21CS018,86,85,87,97,11,10,12,4,0.9694421776360196,1.0771963506838285,1.18412677026386,0.33108560214467886,105,104,106,111,6,5,7,11,-1.1124401755585986,-0.9451412456179649,-0.7976411832669764,1.6150976793768985,6583,6583,Clinton+Cumberland+McCreary+Wayne,Cumberland,21,57,Kentucky,KY
21147,21CS018,190,183,198,198,8,0,15,11,-0.6511804569904133,-0.20736546336524114,0.2484057497051186,1.2933467946930761,232,223,241,286,54,45,63,57,-0.8981228526512747,-0.24429390912752488,0.4063259235980179,1.041958309040975,17181,17181,Clinton+Cumberland+McCreary+Wayne,McCreary,21,147,Kentucky,KY
21231,21CS018,203,194,211,258,55,47,64,26,1.0135720656080243,1.4559064059243587,1.8891248629765554,0.4602865317328763,248,237,258,334,86,76,97,46,1.8352378699721266,2.3791129204719503,3.0115622324410105,0.5262061681281703,20249,20249,Clinton+Cumberland+McCreary+Wayne,Wayne,21,231,Kentucky,KY
21059,21CS019,936,892,980,1034,98,54,142,92,-0.38534363378165964,0.06549664498045818,0.48310571405059427,0.9313888998184056,1148,1096,1201,1308,160,107,212,191,-1.010928475652317,-0.3580781097167893,0.20955703175861237,1.188291860310093,101731,101731,Daviess,Daviess,21,59,Kentucky,KY
21061,21CS020,136,131,141,140,4,-1,9,19,-1.657402008816278,-1.2320268462705204,-0.7918022686460668,3.8119199738409106,166,159,172,187,21,15,28,29,-1.3977249211301275,-0.7478767599029994,-0.15453997960293825,1.3025327087266858,12185,12185,Edmonson+Warren,Edmonson,21,61,Kentucky,KY
21227,21CS020,917,859,975,1081,164,106,222,95,0.08469262384741627,0.5217278580954703,0.9813641187281343,0.5768243315973433,1129,1059,1198,1334,205,136,275,158,-0.19717705569772956,0.4139766129961132,1.0293889686210045,0.7655006898083458,133489,133489,Edmonson+Warren,Warren,21,227,Kentucky,KY
21063,21CS021,68,67,68,65,-3,-3,-2,3,-0.8578028031267643,-0.7528190709601892,-0.6405989839427862,-1.881685521931129,84,83,85,114,30,29,31,15,2.3238706963952325,2.4884757299528166,2.654074247702023,0.47728997078485424,7438,7438,Elliott+Johnson+Lawrence+Magoffin,Elliott,21,63,Kentucky,KY
21115,21CS021,267,257,276,302,35,26,45,17,0.38764887787949637,0.8260166845852847,1.2777290527686296,0.47036928891159485,327,316,339,435,108,96,119,68,1.5500954316773359,2.1714198221654932,2.7394096285862664,0.6247463606183514,22110,22110,Elliott+Johnson+Lawrence+Magoffin,Johnson,21,115,Kentucky,KY
21127,21CS021,182,176,189,182,-0,-7,6,14,-1.3474775717105203,-0.9215749039713679,-0.5351550804550583,20.187410713302288,224,216,232,272,48,40,56,37,0.2617846050872902,0.8616233489670823,1.5232379411587487,0.7526050416863155,15412,15412,Elliott+Johnson+Lawrence+Magoffin,Lawrence,21,127,Kentucky,KY
21153,21CS021,147,142,152,152,5,0,10,10,-0.8010705815550206,-0.3861772101145225,0.018151940092879827,1.596880802153702,180,174,186,214,34,28,40,24,0.3864756087193432,1.0118430725366174,1.6067465527670857,0.6815495019350469,12114,12114,Elliott+Johnson+Lawrence+Magoffin,Magoffin,21,153,Kentucky,KY
21065,21CS022,172,166,178,195,23,17,29,11,0.39487145892632164,0.8515599147747092,1.2559560653589605,0.45735118152380877,210,203,217,271,61,54,68,27,2.281533990296961,2.881787055975763,3.474253229383709,0.4357970969224491,14129,14129,Estill+Madison+Rockcastle,Estill,21,65,Kentucky,KY
21151,21CS022,717,676,757,833,116,76,157,63,0.12253004411039008,0.568431211035489,1.0096377271577142,0.5369780834305588,886,837,935,1070,184,135,233,142,-0.07003876140572801,0.5422200797793525,1.1650959736656494,0.7674497759800654,93585,93585,Estill+Madison+Rockcastle,Madison,21,151,Kentucky,KY
21203,21CS022,174,167,181,192,18,11,25,13,-0.12550402421868498,0.2802983978397411,0.7036912593880174,0.693032978678481,214,205,222,316,102,94,111,39,3.9448309398580155,4.541706108250354,5.177964374870975,0.37701354346737553,16742,16742,Estill+Madison+Rockcastle,Rockcastle,21,203,Kentucky,KY
21067,21CS023,2103,1963,2242,2478,375,236,515,142,0.2925579206699347,0.7303097252498354,1.144001755866992,0.3772938346330591,2593,2425,2761,2828,235,67,403,229,-0.5791080215700977,0.017266379369057023,0.649060032759497,0.97068864130687,324261,324261,Fayette,Fayette,21,67,Kentucky,KY
21071,21CS024,449,434,464,541,92,77,107,46,0.8893755132647551,1.2878788003469628,1.7222888274696886,0.49472106928567716,547,529,565,675,128,110,146,110,-0.03063892957891648,0.617184525455668,1.2206233790676686,0.8527686037342672,35290,35290,Floyd+Martin,Floyd,21,71,Kentucky,KY
21159,21CS024,129,124,134,140,11,6,16,6,0.04616197562071338,0.4443331194094842,0.8864336806111623,0.49898529162558963,157,152,163,184,27,21,32,29,-0.8540271993825757,-0.25522673033259236,0.4186973932161444,1.0471317315536475,11163,11163,Floyd+Martin,Martin,21,159,Kentucky,KY
21079,21CS025,161,153,168,203,42,35,50,22,0.7227373054544737,1.1379340828431115,1.5821268120596401,0.5097422943876886,197,188,206,241,44,35,53,33,0.09499582499281999,0.7231970120430157,1.3289792612123137,0.7363834398130867,17699,17699,Garrard+Jessamine,Garrard,21,79,Kentucky,KY
21113,21CS025,421,398,444,454,33,10,56,49,-0.712303747663812,-0.29505737118559927,0.14529121969732642,1.4313785909713908,518,490,546,595,77,49,105,51,-0.04276332762963396,0.5736877902519161,1.210070968420842,0.6505215258425366,54031,54031,Garrard+Jessamine,Jessamine,21,113,Kentucky,KY
21093,21CS026,832,784,880,1003,171,123,219,84,0.37333851716933447,0.7851319368186515,1.1915417394473131,0.48801430022495995,1029,972,1087,1394,365,307,422,223,0.9244918422747589,1.5394000791159808,2.1380554640752707,0.6093767433539209,111111,111111,Hardin+Larue,Hardin,21,93,Kentucky,KY
21123,21CS026,156,150,163,162,6,-1,12,6,-0.48141659528906267,-0.01801152264537499,0.3939644587786823,0.9052451638484871,192,184,199,223,31,24,39,34,-0.853003693107343,-0.21922403837156695,0.4005391341206479,1.0509455708455953,14409,14409,Hardin+Larue,Larue,21,123,Kentucky,KY
21101,21CS027,430,411,449,543,113,94,132,60,0.7025794078127364,1.1631900601933995,1.5854079650621855,0.5271307301074006,525,502,548,631,106,83,129,71,0.3413945211589888,0.945946671518089,1.5445208590588513,0.6613154261421483,45053,45053,Henderson+Union,Henderson,21,101,Kentucky,KY
21225,21CS027,152,146,159,142,-10,-17,-4,13,-2.0580117579016557,-1.6186822995909078,-1.1987325452001756,-1.371870025469121,186,178,193,245,59,52,67,40,0.9757449331561286,1.591141775307736,2.170342759298309,0.6644916570832888,14474,14474,Henderson+Union,Union,21,225,Kentucky,KY
21103,21CS028,165,158,172,164,-1,-8,6,3,-0.6576605777551513,-0.23222891650190022,0.22535282253004824,32.053873631354854,202,193,210,230,28,20,37,29,-0.6501989104631342,-0.06948755454074101,0.5569573391133059,0.9872205485710933,16065,16065,Henry+Shelby,Henry,21,103,Kentucky,KY
21211,21CS028,340,319,361,416,76,55,97,39,0.3337827291263763,0.7452056057922476,1.1915400675875518,0.5070833035090604,420,394,446,507,87,61,113,77,-0.3751814322268297,0.25268942581769277,0.8764408915678696,0.8755063474403704,49267,49267,Henry+Shelby,Shelby,21,211,Kentucky,KY
21107,21CS029,497,478,516,613,116,97,135,95,0.052728473984957266,0.4619609850987793,0.8681139911573577,0.8120222383583362,601,578,625,755,154,130,177,103,0.7209246832672892,1.3372155615956276,1.951335474257487,0.6665988094297789,44661,44661,Hopkins+Webster,Hopkins,21,107,Kentucky,KY
21233,21CS029,147,141,152,174,27,22,33,23,-0.08285265317300522,0.3442507941268528,0.7517298751755764,0.8100761642717391,177,171,184,205,28,21,34,28,-0.6063553911275937,-0.03713916090193814,0.6104441245409581,0.9780405136548243,12936,12936,Hopkins+Webster,Webster,21,233,Kentucky,KY
21111,21CS030,6804,6474,7134,8138,1334,1004,1664,753,0.3167139830773897,0.7555588361815561,1.194811847315355,0.5639473290612137,8335,7938,8731,9544,1209,813,1606,907,-0.14278684627192975,0.4709799443847795,1.0987679604048186,0.74933882822184406,767646,767646,Jefferson,Jefferson,21,111,Kentucky,KY
21117,21CS031,1325,1253,1398,1390,65,-8,137,109,-0.6812731573279923,-0.26067730878572165,0.1374575586074985,1.6595023958281752,1626,1540,1713,1751,125,38,211,197,-1.1722535670366465,-0.5410878622318194,0.07852179592089571,1.567599304432991,167590,167590,Kenton,Kenton,21,117,Kentucky,KY
21119,21CS032,173,167,179,197,24,18,30,11,0.5065831966367073,0.9093747304673603,1.3060910002654351,0.43903875765114203,213,205,220,268,55,48,63,34,1.1191874018760084,1.719503251324193,2.3205993058844414,0.6053189250982329,14716,14716,Knott+Letcher+Perry,Knott,21,119,Kentucky,KY
21133,21CS032,284,275,293,324,40,31,49,24,0.30723609265767843,0.7265153319565618,1.165629378562615,0.5872604703793063,349,338,360,421,72,61,83,61,0.021391946731087495,0.6163270524951573,1.225486479008382,0.8338791171915855,21415,21415,Knott+Letcher+Perry,Letcher,21,133,Kentucky,KY
21193,21CS032,368,357,379,436,68,57,79,33,0.9532038205500639,1.3672101019964182,1.7874988272740981,0.4764714612325559,451,438,464,594,143,130,156,87,2.0324876112468786,2.6251471838313183,3.2719228036237276,0.6033998502087004,25657,25657,Knott+Letcher+Perry,Perry,21,193,Kentucky,KY
21121,21CS033,346,333,360,411,65,51,78,30,0.7111673043159121,1.0998217189101462,1.5165405907524074,0.45687057005753773,422,406,438,520,98,82,114,84,-0.04414134557124,0.5450241185096683,1.1342884540618206,0.8448887029102496,31097,31097,Knox+Whitley,Knox,21,121,Kentucky,KY
21235,21CS033,427,411,442,474,47,32,63,25,0.1775082244574127,0.6147831993732609,1.0535532330783202,0.5183501095459678,519,501,538,635,116,97,134,108,-0.3764553681631519,0.24845193277430358,0.8883929235892178,0.9264364696662745,36399,36399,Knox+Whitley,Whitley,21,235,Kentucky,KY
21125,21CS034,574,547,600,687,113,87,140,27,0.9806991115131193,1.4076717984996359,1.8465369910748257,0.23640471909130498,705,673,736,936,231,200,263,142,1.149737102419913,1.774798900321234,2.414729518400253,0.610863834136027,61007,61007,Laurel,Laurel,21,125,Kentucky,KY
21141,21CS035,281,269,292,317,36,25,48,40,-0.5612694132114673,-0.1357714912126595,0.3367397632319449,1.0686163254862824,344,330,358,386,42,28,56,41,-0.5708832682405185,0.04754937143608994,0.7001500295371129,0.9465092893067301,27238,27238,Logan+Simpson+Todd,Logan,21,141,Kentucky,KY
21213,21CS035,186,178,195,222,36,27,44,24,0.1870200836881436,0.6112746753838075,1.0704464879597444,0.6574820178925536,228,219,238,264,36,26,45,55,-1.8694921537988125,-1.2450328053088595,-0.6638673023708508,1.504602786589543,18574,18574,Logan+Simpson+Todd,Simpson,21,213,Kentucky,KY
21219,21CS035,120,118,121,121,1,0,3,13,-1.0426416144072266,-0.9351855545274069,-0.8262904097012586,5.358438210499373,147,145,149,183,36,34,38,20,1.3900353948821957,1.5536028534988162,1.6965678057022535,0.5410629006112088,12372,12372,Logan+Simpson+Todd,Todd,21,219,Kentucky,KY
21033,21CS036,147,141,152,145,-2,-7,4,14,-1.6358010548867983,-1.2125550879779665,-0.8021862704744337,-19.85017675008035,179,173,186,209,30,23,36,30,-0.6272289646223057,-0.009821960504466471,0.5636423289544613,0.9716648949997343,12713,12713,Lyon and Nearby Counties,Caldwell,21,33,Kentucky,KY
21055,21CS036,108,107,109,112,4,3,5,12,-1.0118176070664202,-0.9063400817766072,-0.8063474359744655,2.4013301501248674,132,131,134,157,25,23,26,23,0.06943641671767678,0.21910928084579978,0.37255709217576444,0.8984582316153497,8824,8824,Lyon and Nearby Counties,Crittenden,21,55,Kentucky,KY
21139,21CS036,108,107,109,154,46,45,47,19,2.8597821048119343,2.958210826418551,3.0627303924341187,0.4047466159166868,132,131,134,174,42,40,43,27,1.7582798345280193,1.9106004956248777,2.0520527672422344,0.6352852821251732,9103,9103,Lyon and Nearby Counties,Livingston,21,139,Kentucky,KY
21143,21CS036,100,100,101,112,12,11,12,12,-0.15624820613113713,-0.04771197498996946,0.05191667856584498,0.9533171070511354,123,122,124,139,16,15,17,13,0.2734488391742554,0.41487210241858274,0.5844657282962619,0.7690335318559812,8205,8205,Lyon and Nearby Counties,Lyon,21,143,Kentucky,KY
21221,21CS036,159,153,165,196,37,31,43,6,1.6688072487331238,2.0953242311844527,2.5497742949818187,0.15792916306227348,195,187,202,258,63,56,71,25,2.515371222334728,3.150244983450132,3.7353044564753386,0.3880607626017151,14712,14712,Lyon and Nearby Counties,Trigg,21,221,Kentucky,KY
21145,21CS037,683,655,711,795,112,84,140,76,0.09985318685692524,0.5571446098919646,0.9822385975795253,0.6731899563156735,833,800,867,1006,173,139,206,109,0.5551830788232676,1.1807019448943947,1.776811122585452,0.6280107737692663,65631,65631,McCracken,McCracken,21,145,Kentucky,KY
21155,21CS038,186,178,194,232,46,38,54,27,0.5533453502337059,0.9845649370595374,1.3934930707427893,0.5762897054252452,228,218,238,256,28,18,38,30,-0.7850015077130637,-0.14265003414569252,0.4858545880587064,1.0472783288308902,19269,19269,Marion+Nelson+Washington,Marion,21,155,Kentucky,KY
21179,21CS038,385,365,405,441,56,36,76,36,-0.016763300996916,0.4210188753955928,0.8490468025090141,0.6348384511111765,474,450,498,615,141,117,165,87,0.7756407039824694,1.3875547484716682,2.0138117746198074,0.6141076461325073,46316,46316,Marion+Nelson+Washington,Nelson,21,179,Kentucky,KY
21229,21CS038,132,126,137,150,18,13,24,27,-1.1485258220647436,-0.7041638117879403,-0.3011143386855892,1.3870167122060009,161,155,167,151,-10,-16,-4,18,-3.4144662908290444,-2.75816069198151,-2.1606907018949015,-2.005245702868835,12118,12118,Marion+Nelson+Washington,Washington,21,229,Kentucky,KY
21185,21CS039,372,344,401,424,52,23,80,50,-0.37600920860952974,0.009938847784882618,0.4436705260370362,0.949189409871361,462,428,497,484,22,-13,56,37,-0.8987281915354577,-0.2975184747769214,0.3025976610616055,1.624323813531071,66893,66893,Oldham,Oldham,21,185,Kentucky,KY
21041,21CS040,118,117,119,122,4,3,5,13,-0.9646597533963768,-0.8680171080186972,-0.7676682338634411,2.7370406036084654,144,143,146,151,7,5,8,23,-1.9937825926472086,-1.8438586538718433,-1.6945654607120988,3.035083946094779,10688,10688,Owen and Nearby Counties,Carroll,21,41,Kentucky,KY
21077,21CS040,87,86,88,100,13,12,14,11,0.14632763863383844,0.24767791546006335,0.35304273179611073,0.7765354005182247,106,105,107,119,13,12,14,23,-1.5315072705378614,-1.3780727409804978,-1.2208478793235704,1.655459945281673,8816,8816,Owen and Nearby Counties,Gallatin,21,77,Kentucky,KY
21081,21CS040,211,200,222,227,16,5,27,13,-0.3252247048205103,0.12703013827359116,0.5600218972343055,0.7485011187455826,256,243,269,321,65,52,78,36,0.7600195122871752,1.3779419141406084,1.9985963582664308,0.5461694859311138,25231,25231,Owen and Nearby Counties,Grant,21,81,Kentucky,KY
21187,21CS040,103,101,104,133,30,29,32,11,1.6731274982590938,1.772840071772507,1.8730076694196078,0.3503118099140793,125,124,127,160,35,33,36,18,1.6650929797408116,1.8208886663787298,1.9846426101798633,0.5056077141224624,10939,10939,Owen and Nearby Counties,Owen,21,187,Kentucky,KY
21223,21CS040,87,86,88,98,11,10,12,11,-0.0845527854062963,0.024029838543394296,0.12887406966807236,0.9017679496552072,106,105,107,147,41,40,42,25,2.1049635108311557,2.2439210728661596,2.4037956159325002,0.5959438680911311,8509,8509,Owen and Nearby Counties,Trimble,21,223,Kentucky,KY
21195,21CS041,669,645,694,781,112,87,136,47,0.7054999485846752,1.1386937854890202,1.5436673957824145,0.41763181077060035,818,788,847,1068,250,221,280,160,1.2594402945296381,1.8855486386556102,2.4714779486064353,0.6367253276207955,57560,57560,Pike,Pike,21,195,Kentucky,KY
21199,21CS042,715,687,743,814,99,71,127,66,0.06984848930966323,0.5049954522609335,0.9464319641739867,0.6585747548679631,872,838,905,1040,168,135,202,165,-0.5352602916253908,0.0703964961679921,0.7088476009608312,0.9742522434401137,65363,65363,Pulaski,Pulaski,21,199,Kentucky,KY
21209,21CS043,382,357,407,389,7,-18,32,23,-0.6911272168896655,-0.27560559284780756,0.16477011554707632,2.880994119547189,473,442,503,557,84,54,115,51,0.08819980555678542,0.6950381036312252,1.2916457295749326,0.5978540669570377,57659,57659,Scott+Woodford,Scott,21,209,Kentucky,KY
21239,21CS043,219,208,231,237,18,6,29,6,0.018364334381769182,0.4310097000641961,0.8386524166599211,0.3178906099446907,269,255,283,301,32,18,46,31,-0.6282258042171472,0.024151464326617654,0.676158608630448,0.9435998673149777,26700,26700,Scott+Woodford,Woodford,21,239,Kentucky,KY
21007,21CS044,91,90,92,96,5,4,6,6,-0.2769812088978917,-0.16906918912852914,-0.05774709009568435,1.055960809283131,113,112,114,134,21,20,22,24,-0.5471067254644708,-0.4093160776954746,-0.2514017118154835,1.0723867817804358,7797,7797,Southwest Kentucky,Ballard,21,7,Kentucky,KY
21039,21CS044,62,61,62,69,7,7,8,4,0.6403882815692149,0.7412242493277486,0.8425582259587365,0.47063006367312576,76,75,76,107,31,31,32,10,5.2616413457803,5.419285307606521,5.588948819014634,0.3099775325380612,4709,4709,Southwest Kentucky,Carlisle,21,39,Kentucky,KY
21075,21CS044,80,80,81,111,31,30,31,19,1.8284065175825372,1.9397107005582324,2.0456452230367392,0.6018305368037508,99,98,100,125,26,25,27,14,2.2359903465453472,2.4116269458193043,2.565987103225862,0.5187934536816693,5974,5974,Southwest Kentucky,Fulton,21,75,Kentucky,KY
21083,21CS044,397,382,413,471,74,58,89,66,-0.2307185920450546,0.19768038074928784,0.6310474095690509,0.8855600951050588,488,469,507,577,89,70,108,52,0.6074149122115686,1.1912338497530632,1.8158630168018397,0.5763450597893451,37023,37023,Southwest Kentucky,Graves,21,83,Kentucky,KY
21105,21CS044,55,55,56,76,21,20,21,7,3.0502745962946034,3.1439161357031598,3.249552778882001,0.3220470260202645,68,68,69,72,4,3,4,11,-2.09767116781195,-1.9485107352994306,-1.7952536678627447,2.238222474387845,4365,4365,Southwest Kentucky,Hickman,21,105,Kentucky,KY
21025,21CS045,164,158,169,183,19,14,25,7,0.5836271834980419,0.9933858246486157,1.4232631802644542,0.34229073947203575,200,194,207,276,76,69,82,47,2.0693363331435033,2.730947963610737,3.3710477290931387,0.6136999841222219,12586,12586,Wolfe and Nearby Counties,Breathitt,21,25,Kentucky,KY
21129,21CS045,94,93,95,124,30,29,31,16,1.795517385844775,1.8999442868082206,2.002871605695916,0.5176763195069866,116,115,117,148,32,31,33,22,1.5450346919432367,1.702712415915133,1.8755945692326197,0.6580381099130881,7339,7339,Wolfe and Nearby Counties,Lee,21,129,Kentucky,KY
21165,21CS045,77,76,77,80,3,3,4,5,-0.36872120833158795,-0.26184114619802545,-0.15307377741483927,1.1589714664880753,94,93,95,127,33,32,34,22,1.8294256657296515,1.9815987047372494,2.145502252334688,0.6521512228200356,6491,6491,Wolfe and Nearby Counties,Menifee,21,165,Kentucky,KY
21175,21CS045,140,135,146,138,-2,-8,3,7,-1.155767954277949,-0.7163152332225826,-0.29763022065602857,-5.396974775267162,173,166,179,182,9,3,16,19,-1.4876451079875292,-0.8848676334714474,-0.28653081659019686,1.8314232418728684,13232,13232,Wolfe and Nearby Counties,Morgan,21,175,Kentucky,KY
21197,21CS045,159,153,164,163,4,-1,10,5,-0.4999098410020681,-0.05331807540261404,0.37907944574542923,0.9239806705053148,194,188,201,217,23,16,29,19,-0.24533680708284814,0.3404423012509073,0.9660333083751139,0.8023683346910152,12268,12268,Wolfe and Nearby Counties,Powell,21,197,Kentucky,KY
21237,21CS045,92,91,93,102,10,9,11,4,0.7110527146772418,0.8013278637928691,0.9050628690666538,0.372286771805377,113,112,114,164,51,50,52,11,6.525364210113556,6.679333559360292,6.833504083509277,0.21277106945903734,7132,7132,Wolfe and Nearby Counties,Wolfe,21,237,Kentucky,KY
22001,22CS001,565,539,592,770,205,178,231,134,0.7166653443507377,1.1305144176462856,1.594322020450496,0.6517071860104593,697,665,729,880,183,151,215,83,1.3322565823422234,1.9255033075467343,2.5098885761981338,0.45159988354582475,62087,62087,Acadia +Jefferson Davis,Acadia,22,1,Louisiana,LA
22053,22CS001,333,320,346,365,32,19,45,56,-1.1922410753638735,-0.7538362868870955,-0.3753976335350689,1.6964438635801034,409,393,425,514,105,89,121,66,0.8968266422124007,1.4909298813757874,2.09549613033217,0.6221433244925694,31346,31346,Acadia +Jefferson Davis,Jefferson Davis,22,53,Louisiana,LA
22003,22CS002,227,216,238,320,93,82,104,53,1.0838017559556072,1.5477475181081417,1.9634875867374446,0.5660594797802113,279,266,292,337,58,45,71,39,0.2733731729289532,0.8992713067636435,1.5215529609007792,0.6620831260708714,25530,25530,Allen+Evangeline,Allen,22,3,Louisiana,LA
22039,22CS002,323,309,338,416,93,78,107,57,0.6268821823477061,1.073180552069643,1.492786450901199,0.6082652102155243,396,379,413,486,90,73,107,78,-0.16440489698067556,0.42767315009892926,1.0561097707494294,0.8589394368519225,33346,33346,Allen+Evangeline,Evangeline,22,39,Louisiana,LA
22005,22CS003,662,607,717,841,179,124,234,116,0.06831245558611879,0.4917737738308232,0.8691935355598186,0.6447146869191773,824,757,890,992,168,102,235,115,-0.09568821407760211,0.48792444671491253,1.1338035928425585,0.6802625612266439,127576,127576,Ascension,Ascension,22,5,Louisiana,LA
22007,22CS004,186,176,195,226,40,31,50,24,0.31873152964518514,0.7537580172749696,1.1700260831093512,0.5786386546803441,228,217,239,323,95,84,106,31,2.9068881664786823,3.5336012972668764,4.153578242086053,0.32272564102338247,21796,21796,Assumption+St.James+St.John the Baptist,Assumption,22,7,Louisiana,LA
22093,22CS004,172,163,181,210,38,29,47,38,-0.3833402695206915,0.029705671413810027,0.45586679481150405,0.9681951792823692,211,200,222,251,40,29,51,21,0.44033926691214004,1.077357288307069,1.705716304065294,0.514454692175244,20912,20912,Assumption+St.James+St.John the Baptist,St. James,22,93,Louisiana,LA
22095,22CS004,350,332,368,440,90,72,108,91,-0.4725137067128457,-0.02325022244065899,0.3922320390342918,1.0018310397140533,431,409,453,472,41,19,63,43,-0.6813057686733052,-0.07237831784822148,0.5876031830656715,1.0216206179830005,42696,42696,Assumption+St.James+St.John the Baptist,St. John the Baptist,22,95,Louisiana,LA
22009,22CS005,414,397,431,526,112,95,129,71,0.5696779886577824,1.0479099992647178,1.4624591789159145,0.6269875410738375,508,488,529,623,115,94,135,75,0.5970982770502175,1.187572785076823,1.8033048761240245,0.6479315563651715,40066,40066,Avoyelles+East Feliciana+Pointe Coupee+West Feliciana,Avoyelles,22,9,Louisiana,LA
22037,22CS005,213,205,221,278,65,57,73,67,-0.5274796424768182,-0.1220061661970003,0.25731533180816185,1.0184382349168537,261,251,271,293,32,22,42,38,-1.0380276301277989,-0.38659854998932164,0.19299123696712733,1.1596450671870082,19011,19011,Avoyelles+East Feliciana+Pointe Coupee+West Feliciana,East Feliciana,22,37,Louisiana,LA
22077,22CS005,219,210,228,281,62,53,71,45,0.37959129068321257,0.790199230477784,1.1965766419197508,0.7144304452199867,269,258,280,325,56,45,67,27,1.0012525003180164,1.6101901218129924,2.2665532663522976,0.4738554368635041,21649,21649,Avoyelles+East Feliciana+Pointe Coupee+West Feliciana,Pointe Coupee,22,77,Louisiana,LA
22125,22CS005,121,119,123,149,28,26,30,26,0.02100614215837326,0.12532823165315074,0.22864794987897882,0.8981904957056812,149,147,151,166,17,15,19,14,0.05306236799397123,0.2085284361765623,0.35604325857900604,0.7936172196786108,15526,15526,Avoyelles+East Feliciana+Pointe Coupee+West Feliciana,West Feliciana,22,125,Louisiana,LA
22011,22CS006,333,317,349,423,90,74,106,54,0.5335271929331504,0.9336650951179899,1.3942751644700622,0.5944629267705482,409,390,429,467,58,38,77,75,-1.1581733123853915,-0.5554785976515846,0.06780786267317078,1.2791969675232164,37746,37746,Beauregard +Vernon,Beauregard,22,11,Louisiana,LA
22115,22CS006,344,324,365,463,119,98,139,63,0.7631136546201692,1.146669195695694,1.5953852678314409,0.5267038773019952,425,400,449,489,64,40,89,75,-0.8909006172664101,-0.28006690042376664,0.35031165616871496,1.1491921347164855,48186,48186,Beauregard +Vernon,Vernon,22,115,Louisiana,LA
22013,22CS007,164,158,170,223,59,53,65,44,0.7103476088081389,1.1428940492507655,1.549462992764089,0.7323493939901289,200,193,206,262,62,56,69,30,2.3376150509110287,2.9492804099881256,3.5669279608455895,0.4740511945147653,13129,13129,Bienville+Natchitoches+Red River,Bienville,22,13,Louisiana,LA
22069,22CS007,343,327,359,424,81,65,97,51,0.37044139468362614,0.7795275260007969,1.196731762035226,0.622526728037691,421,401,440,529,108,89,128,72,0.515116759523573,1.139606152817575,1.737833235742458,0.6597845888305992,37961,37961,Bienville+Natchitoches+Red River,Natchitoches,22,69,Louisiana,LA
22081,22CS007,89,88,90,139,50,49,51,27,2.604588483451954,2.7120328530744855,2.8099918172898843,0.5333284803758871,110,108,111,135,25,24,27,19,0.7822060730207997,0.9322921774201489,1.0905368521603713,0.718041233675409,8341,8341,Bienville+Natchitoches+Red River,Red River,22,81,Louisiana,LA
22015,22CS008,925,870,980,1132,207,152,262,169,-0.16299483326714412,0.29500375830108494,0.7369421688018274,0.8117686547072419,1140,1074,1205,1375,235,170,301,142,0.27263146024473867,0.8689404240122193,1.4835187667485554,0.6009411973717426,127334,127334,Bossier,Bossier,22,15,Louisiana,LA
22017,22CS009,2271,2169,2373,3042,771,669,873,463,0.8746272851766009,1.2799057196548724,1.714377781812329,0.599912256876128,2779,2657,2902,3375,596,473,718,409,0.3498014200552196,0.9189417181545518,1.5200418474611601,0.6854605983228227,239201,239201,Caddo,Caddo,22,17,Louisiana,LA
22019,22CS010,1752,1665,1840,2226,474,386,561,269,0.5806461552041415,0.9969074815457861,1.4289442593377584,0.5666446628231053,2146,2041,2251,2448,302,197,407,327,-0.8032124717054355,-0.14933134469707,0.4532756024752051,1.080825598123544,203735,203735,Calcasieu,Calcasieu,22,19,Louisiana,LA
22023,22CS011,45,44,45,61,16,16,17,3,1.8191596800456376,1.9229982088651227,2.0223372453006165,0.17215432042937942,55,54,56,52,-3,-4,-2,3,-1.1676692412065544,-1.0090781489713339,-0.8547747293365131,-1.5844271249742685,6990,6990,Cameron +Vermilion,Cameron,22,23,Louisiana,LA
22113,22CS011,495,469,520,639,144,119,170,65,0.9279411673878704,1.325418112311821,1.760600222684048,0.4467442396890854,608,578,639,775,167,136,197,84,1.1087299075205779,1.666530981550657,2.2481059501840592,0.5008121900283766,59492,59492,Cameron +Vermilion,Vermilion,22,113,Louisiana,LA
22021,22CS012,107,105,108,125,18,17,20,23,-0.5591814240999059,-0.4579093161320139,-0.3524604156274928,1.1818393499150577,130,129,132,158,28,26,29,16,1.2302890129375872,1.3921406809002062,1.5610562451867862,0.5611957993230975,9901,9901,Catahoula and Nearby Parishes,Caldwell,22,21,Louisiana,LA
22025,22CS012,102,101,103,140,38,37,39,22,1.6061394249391905,1.7179713792157443,1.8232017865934984,0.5629210208967522,125,124,126,145,20,19,21,25,-0.7790476018166537,-0.6162378955994587,-0.45900670808048755,1.1803575279650476,9362,9362,Catahoula and Nearby Parishes,Catahoula,22,25,Louisiana,LA
22029,22CS012,202,193,210,258,56,48,65,43,0.27815332853263397,0.6901193464104488,1.1355539375794728,0.7488056775488139,245,235,255,295,50,40,60,30,0.6448355311050897,1.2655737528033955,1.8815665874021315,0.5875714137645663,19147,19147,Catahoula and Nearby Parishes,Concordia,22,29,Louisiana,LA
22059,22CS012,145,138,151,175,30,24,37,25,-0.09632173808113963,0.363841551148685,0.7695471577363668,0.7959558697822512,176,169,184,197,21,13,28,19,-0.48201664986039994,0.10305718714741652,0.7566223544450008,0.8791446800695256,14956,14956,Catahoula and Nearby Parishes,La Salle,22,59,Louisiana,LA
22107,22CS012,47,46,47,71,24,24,25,6,4.195020102967672,4.306252604715781,4.407441941572725,0.2368416984371297,57,57,58,85,28,27,28,6,6.004524182948297,6.157355430260006,6.3154172985968815,0.2079764631003378,4260,4260,Catahoula and Nearby Parishes,Tensas,22,107,Louisiana,LA
22027,22CS013,163,156,170,202,39,32,46,40,-0.5250989061038727,-0.043770178552241294,0.3314760122065934,1.0003420343439788,198,190,206,202,4,-4,12,23,-2.098185256917885,-1.50115398620047,-0.8952728170346035,5.097407631722539,15630,15630,Claiborne+Webster,Claiborne,22,27,Louisiana,LA
22119,22CS013,428,412,444,564,136,120,152,77,1.1448029533878654,1.5780473856351056,1.9809510539571793,0.5616803772662975,521,501,540,696,175,156,195,74,2.5624694664848415,3.1769097643590736,3.7988357581585213,0.419580998398953,38165,38165,Claiborne+Webster,Webster,22,119,Louisiana,LA
22031,22CS014,263,251,275,310,47,35,59,53,-0.6510045365736582,-0.2126278898057198,0.19780721181048538,1.0990747698763959,322,308,336,373,51,37,65,57,-0.878936854299494,-0.24594574509538045,0.36676965501101066,1.095127333159354,27528,27528,De Soto+Sabine,De Soto,22,31,Louisiana,LA
22085,22CS014,237,226,247,339,102,92,113,48,1.8545569674736475,2.2828317570584,2.7111220179733198,0.46406838768721437,289,277,302,372,83,70,95,51,0.9792049768486613,1.590062573703757,2.2430255733954914,0.609377897801427,23857,23857,De Soto+Sabine,Sabine,22,85,Louisiana,LA
22033,22CS015,3277,3088,3466,4176,899,710,1088,523,0.40206929745674436,0.8522621734380147,1.3051722172713363,0.5809688915904629,4032,3805,4259,5048,1016,789,1243,538,0.6741220196904761,1.290873881410205,1.882389145894544,0.5290357591408542,440745,440745,East Baton Rouge,East Baton Rouge,22,33,Louisiana,LA
22043,22CS016,187,177,197,235,48,38,58,38,-1.1204662972082868e-4,0.45114128635692785,0.8665481741710278,0.7759538590638095,229,218,241,282,53,41,64,33,0.407611908204086,1.0469867185263315,1.6275991195746948,0.6161763822426832,22311,22311,Grant+Jackson+Winn,Grant,22,43,Louisiana,LA
22049,22CS016,162,155,168,200,38,32,45,17,0.9404440481550385,1.364531637770815,1.8012711000235047,0.4321204700574786,197,189,205,223,26,18,34,16,0.06969207235674664,0.7443908171118682,1.3887013189766357,0.6005617339778366,15683,15683,Grant+Jackson+Winn,Jackson,22,49,Louisiana,LA
22127,22CS016,150,144,156,210,60,54,66,29,1.845721237474066,2.2691665380012505,2.681274150414109,0.47340474540214195,183,176,190,210,27,20,34,21,-0.0798489707028812,0.5630982127534765,1.1677209339783665,0.7426681960417367,13910,13910,Grant+Jackson+Winn,Winn,22,127,Louisiana,LA
22045,22CS017,616,586,646,802,186,156,216,81,1.0795754391643255,1.517119048724971,1.9217364363013025,0.4336166503348847,756,720,792,924,168,132,204,100,0.5869370612276916,1.1570173379612003,1.793786145364668,0.5914589977266491,69368,69368,Iberia,Iberia,22,45,Louisiana,LA
22047,22CS018,276,262,289,393,117,104,131,56,1.501710525767442,1.8901254123491262,2.3014925430572073,0.4729811670135609,335,319,352,430,95,78,111,54,0.9349009065716682,1.500693570594802,2.137258897133442,0.5653594620754413,32349,32349,Iberville+West Baton Rouge,Iberville,22,47,Louisiana,LA
22121,22CS018,182,171,194,249,67,55,78,40,0.5501307337523709,1.0071948138500055,1.4483770541187306,0.5892153790068254,223,209,237,283,60,46,74,26,0.9500036247700916,1.53875515911942,2.104273089076788,0.42649346423524687,26651,26651,Iberville+West Baton Rouge,West Baton Rouge,22,121,Louisiana,LA
22051,22CS019,3599,3413,3785,4495,896,710,1082,592,0.2782643769861859,0.6950272908313138,1.1170529927250519,0.6602724107892528,4424,4201,4647,5070,646,423,869,415,0.04482044174138745,0.625625529899798,1.2206463871126543,0.6415435494580144,433367,433367,Jefferson,Jefferson,22,51,Louisiana,LA
22055,22CS020,1561,1455,1667,1930,369,263,475,134,0.5456310010180733,0.9570537112794691,1.3911844708195902,0.3618764805915518,1931,1803,2058,2411,480,353,608,184,0.840192790082473,1.4423246561596004,2.0506205717891564,0.38229733311170755,245515,245515,Lafayette,Lafayette,22,55,Louisiana,LA
22057,22CS021,768,726,810,953,185,143,227,132,0.13785609614604602,0.5414366783450485,0.9679764877787853,0.7096637105847104,945,895,996,1211,266,215,316,150,0.7878941617793758,1.4286040759427958,2.0443508807952706,0.5620753968164924,97609,97609,Lafourche,Lafourche,22,57,Louisiana,LA
22061,22CS022,333,313,353,437,104,84,124,68,0.30926861859861215,0.7713292812985587,1.1777696319826025,0.6470010701960434,412,388,436,490,78,54,102,33,0.5362073012350024,1.1750509680490684,1.8221122178956777,0.41636155001949493,46726,46726,Lincoln+Union,Lincoln,22,61,Louisiana,LA
22111,22CS022,235,225,244,351,116,107,126,52,2.481215957676322,2.907431870796995,3.3548525698142013,0.4433991197489204,288,276,299,348,60,49,72,34,0.7969742587783626,1.4408252853348795,2.035728861864329,0.5548687550017364,22110,22110,Lincoln+Union,Union,22,111,Louisiana,LA
22063,22CS023,960,898,1022,1142,182,120,244,119,0.011152210191645901,0.4387429401079885,0.8831261717933248,0.6509042677206978,1185,1111,1259,1585,400,326,474,250,0.6046757351715221,1.2513917689066405,1.8822537420533376,0.62378267953167,142468,142468,Livingston,Livingston,22,63,Louisiana,LA
22035,22CS024,70,69,71,82,12,11,13,19,-1.182761256579401,-1.0713516752954344,-0.9698438847909968,1.4853301076889351,86,85,87,116,30,29,31,19,1.7694491170340245,1.9192470543706404,2.0786487734287156,0.6171245443738214,6729,6729,Northeast Louisiana,East Carroll,22,35,Louisiana,LA
22041,22CS024,228,220,237,286,58,49,66,55,-0.28176404497075247,0.1567492997077426,0.5774503706277105,0.933811172645187,279,269,289,313,34,24,44,46,-1.3089480351210956,-0.7244553337168939,-0.11848133411890002,1.3104051128060432,19882,19882,Northeast Louisiana,Franklin,22,41,Louisiana,LA
22065,22CS024,109,108,110,118,9,8,10,18,-0.9037152902009489,-0.8063782402644196,-0.6972174211464136,1.750189414656235,134,132,135,146,12,11,14,32,-2.312978153789135,-2.162878636674902,-2.0185341308003264,2.378893360055354,10844,10844,Northeast Louisiana,Madison,22,65,Louisiana,LA
22067,22CS024,302,291,312,405,103,93,114,44,1.9680316025345985,2.4075879835283396,2.839969565983196,0.4221991652890604,368,356,381,501,133,120,145,62,2.8376717275993126,3.457715767836729,4.060046442335682,0.4630907605119307,24584,24584,Northeast Louisiana,Morehouse,22,67,Louisiana,LA
22083,22CS024,198,189,206,250,52,44,61,45,-0.06134581363370878,0.3578000606938776,0.7948856726610644,0.8419454356322685,243,232,253,302,59,49,70,42,0.4673110845137143,1.0616235550372224,1.669547119779243,0.6942807684001365,20092,20092,Northeast Louisiana,Richland,22,83,Louisiana,LA
22123,22CS024,131,127,136,156,25,20,29,35,-1.404132022155373,-0.9684055655354272,-0.526445054436048,1.3620560928150456,160,155,166,159,-1,-7,4,17,-2.6003039906428924,-2.007902045170018,-1.4017555841505438,-82.95277556092265,10798,10798,Northeast Louisiana,West Carroll,22,123,Louisiana,LA
22071,22CS025,2831,2663,2999,3765,934,766,1102,548,0.5721516445635212,0.9875794284855824,1.452772019647944,0.5861576601561613,3488,3287,3689,3997,509,308,710,261,0.179352228639342,0.778865005586704,1.3496038158347965,0.5118964789069074,390465,390465,Orleans,Orleans,22,71,Louisiana,LA
22073,22CS026,1339,1274,1405,1726,387,321,452,274,0.31426612462115316,0.7358748440384831,1.1663488585009933,0.7064509272552,1645,1566,1723,2049,404,326,483,282,0.3353197630727901,0.9442919350208391,1.553223356724024,0.6955693148411162,153000,153000,Ouachita,Ouachita,22,73,Louisiana,LA
22075,22CS027,159,149,169,209,50,40,60,20,0.8393021109078765,1.2787953104065781,1.7151561453222939,0.3952629903912889,196,184,208,222,26,14,38,20,-0.3542383629437884,0.2809744176315535,0.8918916673176666,0.7511749449688975,23201,23201,Plaquemines+St. Bernard,Plaquemines,22,75,Louisiana,LA
22087,22CS027,328,307,348,379,51,31,72,42,-0.2517628623480018,0.20779892756088844,0.6300257242048514,0.8004883902438809,404,379,429,488,84,59,109,47,0.3349477917612069,0.9225928546751713,1.5396262309976687,0.5534949554058555,47382,47382,Plaquemines+St. Bernard,St. Bernard,22,87,Louisiana,LA
22079,22CS028,1253,1198,1309,1626,373,317,428,211,0.8049815751101304,1.238982673377177,1.708600539138695,0.5648158322681686,1535,1469,1602,1967,432,365,498,241,1.2010387920761727,1.7741486392242938,2.3808721272609548,0.5567891824005224,129286,129286,Rapides,Rapides,22,79,Louisiana,LA
22089,22CS029,367,344,390,463,96,73,119,57,0.27576691614955423,0.7495897636023272,1.1673675234330152,0.5882950334525773,454,427,482,495,41,13,68,43,-0.6396017070516018,-0.04780410833868806,0.5165733535038163,1.0322000315278197,53043,53043,St. Charles,St. Charles,22,89,Louisiana,LA
22091,22CS030,121,117,126,136,15,10,19,3,0.7680577215895505,1.1648481002854736,1.561603959733341,0.19109622713170918,148,143,153,170,22,17,27,19,-0.3074975902119881,0.32313393258892736,0.982565788711925,0.8346143028538685,10118,10118,St. Helena +Tangipahoa +Washington,St. Helena,22,91,Louisiana,LA
22105,22CS030,1124,1065,1183,1323,199,140,258,155,-0.12862106200415402,0.32660653744292467,0.7380268602052865,0.7749058627446076,1388,1317,1458,1767,379,309,450,286,0.16175555400075645,0.8613726234445478,1.4484836446066816,0.7521002583000959,135645,135645,St. Helena +Tangipahoa +Washington,Tangipahoa,22,105,Louisiana,LA
22117,22CS030,514,495,534,630,116,96,135,79,0.36542104729248376,0.80386980875595615,1.2449168052988278,0.677808904485265,629,606,653,754,125,101,148,110,-0.2141871058206769,0.37382785863345575,0.994618005813531,0.875742728468821,45998,45998,St. Helena +Tangipahoa +Washington,Washington,22,117,Louisiana,LA
22097,22CS031,850,815,885,1109,259,224,294,168,0.6884041820946516,1.120150735104476,1.514053794970082,0.6450901750836666,1040,998,1082,1249,209,167,251,122,0.6811243506151412,1.2830974483429167,1.8645570477567621,0.5810971266721396,81881,81881,St. Landry,St. Landry,22,97,Louisiana,LA
22099,22CS032,421,398,444,580,159,136,182,82,1.0277636844582663,1.4277242360555975,1.871160204586574,0.5127999622573437,518,490,545,629,111,84,139,62,0.48900989481964885,1.111926951700394,1.7431863073809566,0.5521806865453335,53271,53271,St. Martin,St. Martin,22,99,Louisiana,LA
22101,22CS033,459,439,480,589,130,109,150,87,0.44251933974708346,0.8863348824009674,1.27424864213831,0.6659114198447065,562,537,587,716,154,129,179,112,0.4481531180687673,1.0331402247902528,1.5857016590162198,0.7237019895916904,48892,48892,St. Mary,St. Mary,22,101,Louisiana,LA
22103,22CS034,1986,1873,2099,2355,369,256,482,259,-0.02436815442544116,0.42484559028877367,0.8492257694489056,0.7003621943823045,2450,2314,2586,2939,489,353,625,307,0.21659569343182408,0.8346677717571953,1.4205998197301783,0.6270245115259905,262196,262196,St. Tammany,St. Tammany,22,103,Louisiana,LA
22109,22CS035,877,830,924,1054,177,130,224,117,0.14136070215773872,0.5501301759878001,0.9692093555245176,0.656576675288441,1079,1022,1136,1388,309,252,366,171,0.9230750398818444,1.4947633804226383,2.101828231760367,0.5511939356082441,110300,110300,Terrebonne,Terrebonne,22,109,Louisiana,LA
23001,23CS001,1021,974,1068,1032,11,-36,58,23,-0.5316940741791748,-0.1139385017784142,0.2740093594727953,1.929066792288964,1254,1198,1310,1480,226,170,282,150,0.2187697155397293,0.8523790042443483,1.4339879255269956,0.661720756586689,108438,108438,Androscoggin,Androscoggin,23,1,Maine,ME
23003,23CS002,731,703,760,796,65,36,93,21,0.2385780093528252,0.6253089285589494,1.0890734982808628,0.31968303625516603,891,856,925,1107,216,182,251,94,1.5744992717546265,2.1823711683230127,2.8490561517758186,0.4329893695886012,66972,66972,Aroostook,Aroostook,23,3,Maine,ME
23005,23CS003,2358,2230,2487,2469,111,-18,239,106,-0.42862193332792287,0.003931284731286934,0.4264466540764307,0.9505170736858329,2900,2746,3054,3101,201,47,355,171,-0.5086457077642281,0.14570546472927753,0.7219566275963624,0.8453646968712036,296910,296910,Cumberland,Cumberland,23,5,Maine,ME
23007,23CS004,300,287,313,285,-15,-28,-2,4,-1.0578902460191313,-0.6221646287412316,-0.2144044711070866,-0.28517897398359426,368,352,383,410,42,27,58,40,-0.5290973590945386,0.0906167813294172,0.7623541824321216,0.9270089252572818,30021,30021,Franklin+Oxford,Franklin,23,7,Maine,ME
23017,23CS004,584,559,609,608,24,-1,49,32,-0.5369364571006339,-0.1271473835159072,0.28789850360850716,1.2925164288973563,717,687,747,849,132,102,162,91,0.23826091455809228,0.8682475442606445,1.4469567821250322,0.6822169698879818,57994,57994,Franklin+Oxford,Oxford,23,17,Maine,ME
23009,23CS005,530,506,554,575,45,21,69,27,-0.09950159443354821,0.3362582252299062,0.7806132724157249,0.5866334613313194,648,620,677,753,105,76,133,44,0.7291751365468413,1.3394147694267853,1.923531087470903,0.41587926065247466,55094,55094,Hancock+Washington,Hancock,23,9,Maine,ME
23029,23CS005,367,353,380,429,62,49,76,2,1.4707102612397036,1.924009928301183,2.3255565384792187,0.03149867288603227,447,431,463,530,83,67,99,38,1.065701520354048,1.7119357508344095,2.299356551630952,0.4524975517211895,31364,31364,Hancock+Washington,Washington,23,29,Maine,ME
23011,23CS006,1145,1092,1198,1193,48,-5,101,34,-0.30744597238581944,0.1110527427073433,0.540313743805432,0.6986829245685445,1402,1339,1466,1629,227,163,290,124,0.42369320530765026,0.9892047240174469,1.5764035119084872,0.5449989400599045,122538,122538,Kennebec,Kennebec,23,11,Maine,ME
23013,23CS007,430,412,447,390,-40,-57,-22,5,-1.528630629913984,-1.1169619239885993,-0.7070251511585675,-0.12983124501025226,525,504,545,539,14,-6,35,19,-0.7242795157348346,-0.13183641507017455,0.4840736785758471,1.2480574582934172,39858,39858,Knox+Waldo,Knox,23,13,Maine,ME
23027,23CS007,359,342,377,388,29,11,46,20,-0.21056508203963123,0.2108006756151738,0.6425755384531686,0.6743531449190968,441,420,461,529,88,68,109,32,1.0703049388720411,1.6895360001464972,2.2766592057637576,0.3577292855218578,39825,39825,Knox+Waldo,Waldo,23,27,Maine,ME
23015,23CS008,351,336,366,384,33,18,48,3,0.46636808457975387,0.855477374132739,1.2881205505749216,0.08795037860428037,427,409,445,453,26,8,44,18,-0.3161422377453577,0.26621976223210464,0.8512392882887305,0.671167809048023,34722,34722,Lincoln+Sagadahoc,Lincoln,23,15,Maine,ME
23023,23CS008,312,296,327,302,-10,-25,6,3,-0.786420160775664,-0.3595804909764949,0.08906273406241925,-0.3354189850857496,381,362,399,437,56,38,75,21,0.5507562528292995,1.1838400384814236,1.7951273727693742,0.36560737370112717,36052,36052,Lincoln+Sagadahoc,Sagadahoc,23,23,Maine,ME
23019,23CS009,1429,1364,1494,1529,100,35,165,34,0.03821138520009882,0.41879581354472095,0.8566687920907468,0.3371715371454513,1754,1676,1832,1999,245,167,323,211,-0.3000994066829972,0.27191365495763575,0.855066068408023,0.8573359724366366,151753,151753,Penobscot+Piscataquis,Penobscot,23,19,Maine,ME
23021,23CS009,211,204,219,203,-8,-16,-1,4,-1.1432919110726791,-0.7318654212587967,-0.2932034605839108,-0.5457377959829207,258,249,267,302,44,35,53,36,-0.05229880858035593,0.5528822046516234,1.1670505831277997,0.80213203928704,16928,16928,Penobscot+Piscataquis,Piscataquis,23,21,Maine,ME
23025,23CS010,525,503,547,559,34,12,56,19,-0.15181741377759433,0.29841384256548514,0.7115613929994015,0.5385822336977,641,614,667,774,133,107,160,65,0.9620904981022321,1.6600292010703916,2.2447273624543667,0.4834804327761477,50690,50690,Somerset,Somerset,23,25,Maine,ME
23031,23CS011,1834,1744,1924,1901,67,-23,157,82,-0.4827707193637075,-0.06528060653442819,0.35269938632912573,1.201120461005649,2252,2144,2360,2365,113,5,221,176,-0.964187020714684,-0.3762792899556541,0.22350871886220058,1.5397978793629972,208431,208431,York,York,23,31,Maine,ME
24001,24CS001,762,732,792,995,233,203,263,161,0.6008099457274694,1.0392538545697985,1.4652215525849972,0.6871922357949852,930,894,966,1055,125,89,161,140,-0.8816776451433587,-0.25481584672130053,0.39185512981119386,1.1104336130270314,70331,70331,Allegany+Garrett,Allegany,24,1,Maryland,MD
24023,24CS001,285,272,297,376,91,79,104,49,1.0691365843401035,1.445449438586932,1.8767211301933362,0.5305817451020741,348,333,363,396,48,33,63,56,-0.9333555478689645,-0.34763184378353873,0.240984633663669,1.1458721729680619,28967,28967,Allegany+Garrett,Garrett,24,23,Maryland,MD
24003,24CS002,3835,3585,4086,4228,393,142,643,356,-0.36587289003871204,0.0672081923392125,0.5333095025921406,0.904231215326787,4743,4441,5044,4996,253,-48,555,412,-0.9612224791427448,-0.31020367215249056,0.30940795967719664,1.6188858259203416,581096,581096,Anne Arundel,Anne Arundel,24,3,Maryland,MD
24510,24CS003,5416,5164,5669,6749,1333,1080,1585,684,0.6310478831479815,1.1089433604549408,1.5289470578957074,0.5127657532552846,6637,6335,6940,7522,885,582,1187,604,-0.030778472684745213,0.5758530406841661,1.1498955241648916,0.6820127046098713,591072,591072,Baltimore (city),Baltimore (city),24,510,Maryland,MD
24005,24CS004,7112,6756,7467,8384,1272,917,1628,889,0.04989301685587959,0.47398871165827455,0.9110224479683179,0.6980849536732625,8725,8299,9152,9456,731,304,1157,863,-0.7543579397604294,-0.20917087254625855,0.40585246056824226,1.1797631713124361,827467,827467,Baltimore (county),Baltimore (county),24,5,Maryland,MD
24009,24CS005,614,574,654,711,97,57,137,52,0.07127918653466034,0.4809782107422954,0.9019294638600689,0.5316270105837719,760,712,808,858,98,50,146,61,-0.1411731974204597,0.4740068265617523,1.0906400133052536,0.6149166513096401,92832,92832,Calvert,Calvert,24,9,Maryland,MD
24011,24CS006,294,280,308,347,53,39,67,15,0.7121773834394924,1.1538092161699858,1.5650751199391162,0.2776475523184822,362,345,379,436,74,57,91,58,-0.003006831023830484,0.6057868206730005,1.2058381268679337,0.7722370598533023,33502,33502,Caroline+Dorchester+Talbot,Caroline,24,11,Maryland,MD
24019,24CS006,348,334,361,379,31,18,45,27,-0.3065186216677725,0.12549793790692712,0.5991726663764844,0.8366282055290314,426,409,442,493,67,51,84,57,-0.2571293755247395,0.3660566622398861,1.0002470270000925,0.8376544364580035,31859,31859,Caroline+Dorchester+Talbot,Dorchester,24,19,Maryland,MD
24041,24CS006,386,370,402,458,72,56,88,1,1.4807542754962442,1.8965659087092617,2.34443106445801,0.013764379130576123,473,454,493,555,82,62,101,52,0.33803836349646477,0.9456611868441712,1.5954250307126472,0.6301415743098512,37097,37097,Caroline+Dorchester+Talbot,Talbot,24,41,Maryland,MD
24013,24CS007,1383,1310,1455,1557,174,102,247,178,-0.45225911980740546,0.009269489068369701,0.3995276429738887,1.0157675796586403,1701,1614,1788,1885,184,97,271,132,-0.27842759117899524,0.3801548250207079,0.9797440817686022,0.7129087095880842,168906,168906,Carroll,Carroll,24,13,Maryland,MD
24015,24CS008,866,821,910,1040,174,130,219,93,0.35121090470824784,0.7922225247857554,1.2648803805413416,0.5299417786959046,1067,1013,1120,1248,181,128,235,144,-0.11981520225137184,0.407600495608195,1.0136528891507712,0.7906426268482493,103228,103228,Cecil,Cecil,24,15,Maryland,MD
24017,24CS009,978,908,1049,1223,245,174,315,153,0.13475252443845903,0.5575742142921948,0.9809483589854316,0.6230870580909255,1216,1131,1301,1473,257,172,342,160,0.09412512421706018,0.7370753830462349,1.359483724994774,0.6198309303667051,164026,164026,Charles,Charles,24,17,Maryland,MD
24021,24CS010,1672,1559,1786,1873,201,87,314,189,-0.4014476139842136,0.03173737423529394,0.4812904188967953,0.9377172915984505,2068,1931,2205,2208,140,3,277,205,-0.8939319794721893,-0.2924181953930952,0.30271285153275634,1.4519261472699843,262506,262506,Frederick,Frederick,24,21,Maryland,MD
24025,24CS011,1883,1773,1994,2163,280,169,390,158,0.023485613001575305,0.47425383230789675,0.9298966303979294,0.5632199080957795,2320,2187,2453,2605,285,152,418,231,-0.40116561963558706,0.25023234448646153,0.8915583663508724,0.8080908462958727,256099,256099,Harford,Harford,24,25,Maryland,MD
24027,24CS012,1503,1362,1644,1734,231,90,372,178,-0.2489529935423475,0.16708942003366561,0.5656162254889309,0.7671301584236256,1880,1710,2049,1993,113,-56,283,93,-0.5433572346018044,0.07960667037667674,0.6775698868347969,0.8129254747703222,326888,326888,Howard,Howard,24,27,Maryland,MD
24029,24CS013,221,213,229,285,64,56,72,34,1.1430795697573817,1.538614453103016,1.9544729977695836,0.5248174542522994,271,261,281,315,44,34,54,23,0.6779837483969448,1.318506277954845,1.9092462145456506,0.508859412420508,19328,19328,Kent+Queen Anne's,Kent,24,29,Maryland,MD
24035,24CS013,388,366,410,392,4,-18,26,27,-0.8784267409160721,-0.44360254235125,-0.004463116453865773,5.002360787051409,481,454,507,522,41,15,68,48,-0.7880166763753648,-0.15077283048575202,0.464099648246124,1.1308223726938862,50828,50828,Kent+Queen Anne's,Queen Anne's,24,35,Maryland,MD
24031,24CS014,5363,4911,5816,6588,1225,772,1677,1118,-0.366461492414721,0.09063667755228381,0.514966091972014,0.9120542187880138,6664,6121,7208,7006,342,-202,885,565,-0.8882824875828523,-0.2726993385320352,0.359935071925613,1.6491352013575924,1051415,1051415,Montgomery,Montgomery,24,31,Maryland,MD
24033,24CS015,5224,4833,5615,7260,2036,1645,2427,1249,0.42359803373873117,0.8776451996418159,1.276983995015269,0.6131333869701686,6489,6020,6959,7618,1129,659,1598,734,-0.17501832365845196,0.5195013120225433,1.1054193117513176,0.6497829194686161,910750,910750,Prince George's,Prince George's,24,33,Maryland,MD
24037,24CS016,723,674,772,855,132,83,181,88,-0.02197266648098311,0.3860917388834341,0.8163603936410726,0.6615999813691541,897,837,956,1050,153,94,213,89,0.049539001391322376,0.6804329310938162,1.2792504085072929,0.5760971576385773,114149,114149,St. Mary's,St. Mary's,24,37,Maryland,MD
24039,24CS017,227,216,238,300,73,62,84,17,1.743441497789094,2.1827655824705006,2.6371908366218677,0.23002164379596549,278,265,291,312,34,21,47,31,-0.4878752546438718,0.13802251403384297,0.7514226094159853,0.8924150625434603,25544,25544,Somerset+Worcester,Somerset,24,39,Maryland,MD
24047,24CS017,549,526,571,614,65,43,88,53,-0.17783855603514337,0.24457048927571548,0.6861534523202314,0.8013278791867916,671,644,698,743,72,45,99,70,-0.6069565059867702,0.05406987335442782,0.6740068124192633,0.9578013477172994,52320,52320,Somerset+Worcester,Worcester,24,47,Maryland,MD
24043,24CS018,1378,1313,1444,1660,282,216,347,143,0.49281882502045116,0.9071405014195982,1.3490425795728518,0.5061789625519957,1695,1617,1773,2018,323,245,401,272,-0.20242023627545028,0.4061372256131503,1.0088474070431632,0.8389937257694112,151099,151099,Washington,Washington,24,43,Maryland,MD
24045,24CS019,865,820,910,1033,168,123,213,83,0.403215524239286,0.8292114561000502,1.2334200076329762,0.491194290747273,1065,1011,1118,1253,188,135,242,151,-0.22279571970638531,0.43897150238251137,1.053183756077587,0.7976061912837429,103999,103999,Wicomico,Wicomico,24,45,Maryland,MD
25001,25CS001,2507,2416,2599,2625,118,26,209,197,-0.831737621549949,-0.3716591751022631,0.06992529839134169,1.6598673033383815,3055,2945,3165,3313,258,148,368,199,-0.33935910291548815,0.32168724897395357,0.9168303207311304,0.7682338576043216,213023,213023,Barnstable+Dukes+Nantucket,Barnstable,25,1,Massachusetts,MA
25007,25CS001,140,133,148,143,3,-5,10,7,-0.6561507822824824,-0.23524587897248603,0.18338623486967467,1.7614555258827724,172,163,181,171,-1,-10,8,6,-1.0394755501973336,-0.46553216750704557,0.1484874704393812,28.672378892456553,17461,17461,Barnstable+Dukes+Nantucket,Dukes,25,7,Massachusetts,MA
25019,25CS001,63,62,65,64,1,-1,2,8,-0.7613219182760472,-0.6621976989905263,-0.5476402201926774,5.29727361240236,78,77,80,91,13,11,14,3,0.9001335496143851,1.036665743688921,1.191573467040918,0.21655063193726581,11349,11349,Barnstable+Dukes+Nantucket,Nantucket,25,19,Massachusetts,MA
25003,25CS002,1300,1247,1354,1386,86,32,139,121,-0.7327490054953821,-0.2898891806887505,0.17003409108473203,1.395933510012065,1591,1527,1655,1759,168,104,232,128,-0.24425235097127718,0.38045587079541643,0.9500135922106783,0.7576954910759177,124948,124948,Berkshire,Berkshire,25,3,Massachusetts,MA
25005,25CS003,4674,4430,4918,5477,803,559,1047,777,-0.35796146236436077,0.05394484932619945,0.48824208542129677,0.9661740969533512,5739,5446,6031,6242,503,211,796,669,-0.9377780005540115,-0.35103156650416667,0.24805993721899133,1.326583416226734,565791,565791,Bristol,Bristol,25,5,Massachusetts,MA
25009,25CS004,5984,5644,6324,7072,1088,748,1428,1242,-0.6027568912200796,-0.19983684720666534,0.21783392054882514,1.140557689176715,7364,6955,7772,7483,119,-289,528,631,-1.3908573682675611,-0.7745976585808336,-0.1486086506092677,5.244758375622215,790366,790366,Essex,Essex,25,9,Massachusetts,MA
25011,25CS005,602,572,632,705,103,73,133,70,0.06367489950551242,0.4614368461322851,0.8868567817571151,0.6718252078711225,737,701,774,717,-20,-57,16,26,-1.4181501902344882,-0.7884533297707034,-0.19029961460714567,-1.333433994933885,70272,70272,Franklin,Franklin,25,11,Massachusetts,MA
25013,25CS006,3892,3692,4091,4817,925,726,1125,751,-0.06377284364221887,0.3755350132310018,0.8159910255513246,0.8107380875061497,4779,4539,5019,5143,364,124,604,448,-0.8082552921731719,-0.2040503692493268,0.37397337141035253,1.2276736503410486,465014,465014,Hampden,Hampden,25,13,Massachusetts,MA
25015,25CS007,1106,1036,1175,1246,140,71,210,149,-0.47999909975100546,-0.045674109245452454,0.37690846032577957,1.053433599160488,1366,1283,1450,1404,38,-46,121,93,-1.063808083955028,-0.40372394264520306,0.2041188317307534,2.3989339813866835,161515,161515,Hampshire,Hampshire,25,15,Massachusetts,MA
25017,25CS008,9914,9222,10607,11522,1608,915,2300,2117,-0.7649110518867609,-0.31543554169609844,0.11812158394500337,1.3160287108476265,12245,11414,13077,12198,-47,-879,784,823,-1.2355958027609528,-0.6454323015067337,-0.03092852969933541,-17.8134194240238,1610478,1610478,Middlesex,Middlesex,25,17,Massachusetts,MA
25021,25CS009,5043,4738,5348,5757,714,409,1019,926,-0.7516053620320662,-0.30738758791445375,0.15621774235953023,1.2950218036459198,6203,5836,6569,6181,-22,-388,345,374,-1.323067276265191,-0.669681414841708,-0.05486554385703135,-17.958245379718928,708099,708099,Norfolk,Norfolk,25,21,Massachusetts,MA
25023,25CS010,4077,3852,4303,4799,722,496,947,741,-0.4795883810213406,-0.03261589831204028,0.3990415002396932,1.0253317622581137,5013,4743,5284,5436,423,152,693,412,-0.5787579144428622,0.027225139474895747,0.636848048184256,0.9721693114477024,522631,522631,Plymouth,Plymouth,25,23,Massachusetts,MA
25025,25CS011,4091,3746,4436,5128,1037,692,1382,1089,-0.4666090585820525,-0.06561755109327404,0.3515073134603064,1.0489078333823614,5070,4656,5484,5137,67,-347,481,393,-1.0936476488735258,-0.45435550594610896,0.14348238454802859,5.774061471242795,804110,804110,Suffolk,Suffolk,25,25,Massachusetts,MA
25027,25CS012,6231,5875,6588,6985,754,397,1110,1135,-0.8549709640117978,-0.46687689448311515,-0.04945565038602196,1.5038634452077397,7660,7232,8088,7791,131,-297,559,665,-1.4056614640981746,-0.7570742703498061,-0.16704791116634954,5.03171549100055,829279,829279,Worcester,Worcester,25,27,Massachusetts,MA
26001,26CS001,162,157,166,176,14,10,19,20,-0.966128053517944,-0.5463128191738548,-0.11212948648554304,1.3155421486985994,196,191,201,226,30,25,35,35,-1.1899854264114267,-0.5797204033404273,0.06379938988756971,1.1268243961249134,10475,10475,Alcona+Alpena+Presque Isle,Alcona,26,1,Michigan,MI
26007,26CS001,320,308,332,343,23,11,35,20,-0.31500350021242834,0.12013887409255802,0.5132898597575484,0.8250763407094586,388,374,403,477,89,74,103,72,0.1012782804786043,0.7226227822873199,1.279635034082622,0.8009653258754612,28327,28327,Alcona+Alpena+Presque Isle,Alpena,26,7,Michigan,MI
26141,26CS001,167,161,172,170,3,-2,9,11,-1.016390307590474,-0.5940285102449195,-0.19290794291707714,2.526573554545787,202,196,209,211,9,2,15,33,-2.8790239965467777,-2.2949311289076677,-1.6936514144696209,3.3370786835818493,12628,12628,Alcona+Alpena+Presque Isle,Presque Isle,26,141,Michigan,MI
26003,26CS002,95,94,96,78,-17,-18,-16,6,-2.695127959668411,-2.59228781414291,-2.49338866759795,-0.36454213692538645,117,116,118,113,-4,-5,-3,3,-1.1164002566601912,-0.9634027991331099,-0.7980997707258388,-0.9200204722739274,9052,9052,Alger+Delta+Schoolcraft,Alger,26,3,Michigan,MI
26041,26CS002,391,376,407,502,111,95,126,63,0.935631252598731,1.3352545697946288,1.7929770411399,0.5649938194705304,481,462,499,555,74,56,93,51,0.18290859777297713,0.7948873427433312,1.3961697923130354,0.6772300290617261,35689,35689,Alger+Delta+Schoolcraft,Delta,26,41,Michigan,MI
26153,26CS002,94,93,95,110,16,15,17,2,1.649790116370947,1.7527366269562685,1.858075330772473,0.11654944984881685,115,114,116,131,16,15,17,5,1.4504592075118719,1.607322291856198,1.7554972246550589,0.29707327649777965,8091,8091,Alger+Delta+Schoolcraft,Schoolcraft,26,153,Michigan,MI
26005,26CS003,892,841,943,1042,150,99,201,73,0.2034833920500307,0.6523055712769376,1.062994836263937,0.4835070435975129,1097,1036,1159,1279,182,120,243,168,-0.5385684881365307,0.13547074632070738,0.7311497849543371,0.9202299230576119,118412,118412,Allegan,Allegan,26,5,Michigan,MI
26009,26CS004,232,222,243,259,27,16,37,5,0.478328533282966,0.9162258195621721,1.3742690661470112,0.18171531268545535,285,273,297,332,47,35,59,36,-0.062106084117589076,0.5786300140496081,1.1515785795520221,0.7454452316857657,23396,23396,Antrim+Charlevoix+Kalkaska+Otsego,Antrim,26,9,Michigan,MI
26029,26CS004,246,235,258,242,-4,-16,7,12,-1.070336525157063,-0.6272910439768169,-0.19918606200685848,-3.4444465863458706,302,288,315,376,74,61,88,36,1.1168060092994263,1.765951789421921,2.3796821068614613,0.4797382382679966,26162,26162,Antrim+Charlevoix+Kalkaska+Otsego,Charlevoix,26,29,Michigan,MI
26079,26CS004,181,173,189,209,28,20,36,13,0.4440728218071836,0.85118162830677,1.2792248554251335,0.44489997751510607,221,212,231,251,30,20,39,26,-0.3778463505295673,0.22629501154016668,0.7928323560609981,0.846382242364406,17992,17992,Antrim+Charlevoix+Kalkaska+Otsego,Kalkaska,26,79,Michigan,MI
26137,26CS004,234,224,245,276,42,31,52,19,0.5026812020457082,0.9318585518896274,1.337984276345589,0.4436553696285849,287,274,300,366,79,66,92,59,0.3752495721612962,0.9655676010239331,1.588630474305868,0.7380247229114373,24706,24706,Antrim+Charlevoix+Kalkaska+Otsego,Otsego,26,137,Michigan,MI
26011,26CS005,172,165,178,204,32,26,39,15,0.7166327985804726,1.1624330075171212,1.6189942383598308,0.45105665796753935,209,202,217,254,45,37,52,20,1.3682883460720818,1.9512471047445847,2.621208262923668,0.4393850626974874,14948,14948,Arenac+Iosco+Ogemaw,Arenac,26,11,Michigan,MI
26069,26CS005,350,340,361,405,55,44,65,43,0.048126703738822676,0.46404512842822515,0.8839688272276457,0.7725793734093405,426,413,439,499,73,60,86,56,0.15902579800381872,0.81018232977052,1.3953241262176457,0.7561652061696584,25201,25201,Arenac+Iosco+Ogemaw,Iosco,26,69,Michigan,MI
26129,26CS005,278,269,287,294,16,7,25,28,-1.002111301003934,-0.5839067516362421,-0.15926407711083962,1.674745458837534,339,328,349,385,46,36,57,52,-0.9188858582430781,-0.3148886642556707,0.27759781388505766,1.0982005829224255,20929,20929,Arenac+Iosco+Ogemaw,Ogemaw,26,129,Michigan,MI
26015,26CS006,493,466,520,534,41,14,68,39,-0.38582091524015866,0.051120540638551315,0.446350666901799,0.9255432262386802,605,573,637,769,164,132,196,78,1.0631626442477633,1.6904743150983643,2.2577495501447613,0.47370426519739484,61723,61723,Barry,Barry,26,15,Michigan,MI
26017,26CS007,1076,1032,1120,1312,236,192,280,148,0.4535515211705309,0.8391017745142088,1.2659057560620763,0.6248415676906203,1318,1265,1371,1559,241,188,294,219,-0.35283763036089305,0.25782824670719434,0.8808150186799074,0.9037617530930845,102724,102724,Bay,Bay,26,17,Michigan,MI
26019,26CS008,180,172,187,226,46,39,54,24,0.8178605307704095,1.2620890152996218,1.699914199413877,0.5057574951698524,220,211,230,241,21,11,30,24,-0.8258930980806437,-0.22599515728608244,0.3630402039335055,1.1077325754186451,17802,17802,Benzie+Manistee+Mason,Benzie,26,19,Michigan,MI
26101,26CS008,278,267,289,343,65,54,76,21,1.3629606786508484,1.786852786572562,2.2330454090434655,0.31759728580509033,340,327,353,373,33,20,46,43,-1.1499151418422355,-0.49838753607423913,0.09523400842817883,1.273305088924088,24669,24669,Benzie+Manistee+Mason,Manistee,26,101,Michigan,MI
26105,26CS008,295,283,308,349,54,41,66,21,0.7001958055549883,1.1107702622857951,1.5476672941665466,0.38352555615576045,362,347,377,441,79,64,94,46,0.705249390568116,1.362572200987737,1.9419696934359427,0.5759423754139812,29158,29158,Benzie+Manistee+Mason,Mason,26,105,Michigan,MI
26021,26CS009,1477,1411,1543,1652,175,109,241,170,-0.3950238757055083,0.030544307999056573,0.4506083624802157,0.966610745127005,1804,1725,1883,2005,201,122,280,204,-0.6088689825908852,-0.04195521958556069,0.5938229427820645,1.0117563030665506,153216,153216,Berrien,Berrien,26,21,Michigan,MI
26023,26CS010,408,389,426,468,60,42,79,71,-0.6530403424395432,-0.24182576271137532,0.15362231374119883,1.1553258361509715,501,479,524,565,64,41,86,75,-0.9599278678385301,-0.30753986475309103,0.3160499051583653,1.1581135797022837,43436,43436,Branch+Hillsdale,Branch,26,23,Michigan,MI
26059,26CS010,427,408,447,545,118,98,137,63,0.785600663844614,1.1964051997023264,1.629400945292613,0.5313553755019792,526,502,549,651,125,102,149,108,-0.18119023681004087,0.4464588755510494,1.0804849819825082,0.8561908246480777,45594,45594,Branch+Hillsdale,Hillsdale,26,59,Michigan,MI
26025,26CS011,1322,1265,1380,1625,303,245,360,158,0.6708924233309023,1.0999036783918263,1.5143820406522586,0.5203947784997609,1618,1549,1687,1841,223,154,292,229,-0.7134971935180795,-0.07829972528892373,0.5575649812876565,1.0238785376877035,133712,133712,Calhoun,Calhoun,26,25,Michigan,MI
26027,26CS012,452,430,474,560,108,86,130,66,0.4141133246321812,0.8035067081232379,1.2334605744372036,0.6046196987033267,553,526,580,633,80,53,107,65,-0.30356023998375864,0.3407118550070423,0.9230229050135911,0.8031775940261571,51737,51737,Cass,Cass,26,27,Michigan,MI
26031,26CS013,281,270,292,343,62,51,73,39,0.4873151808176428,0.8978655667503682,1.363850972409432,0.6181393346272942,344,331,357,443,99,86,112,52,1.559616778377106,2.2492340944286324,2.8657858650375627,0.5197250572290151,25345,25345,Cheboygan+Emmet,Cheboygan,26,31,Michigan,MI
26047,26CS013,319,305,333,374,55,41,69,32,0.2733051217122302,0.6973613917283399,1.0821528098755642,0.5701004826839382,392,374,409,387,-5,-22,13,28,-1.8266794345078088,-1.1553511787239927,-0.5552123604312933,-7.750166792813994,33339,33339,Cheboygan+Emmet,Emmet,26,47,Michigan,MI
26033,26CS014,310,294,326,308,-2,-18,14,22,-1.1128792301204407,-0.6394845778884106,-0.22963000942456274,-18.80466110500785,384,364,403,451,67,48,87,50,-0.013886978330417223,0.5530847212548969,1.2212022021808095,0.7302454849597333,37150,37150,Chippewa+Luce+Mackinac,Chippewa,26,33,Michigan,MI
26095,26CS014,62,62,63,65,3,2,3,4,-0.34186833180763326,-0.22857727126616578,-0.13412290660143822,1.1078835339380189,77,76,78,82,5,4,6,6,-0.30820557267329646,-0.15850907490276697,0.008451529429034831,0.9676600533421735,6208,6208,Chippewa+Luce+Mackinac,Luce,26,95,Michigan,MI
26097,26CS014,146,141,150,140,-6,-10,-1,8,-1.6671413062125837,-1.260336695726827,-0.8407905040961134,-1.719561167621009,178,173,184,195,17,11,22,14,-0.29714330022262864,0.3460759196810693,0.9432601733119699,0.7879052895135633,10820,10820,Chippewa+Luce+Mackinac,Mackinac,26,97,Michigan,MI
26035,26CS015,391,377,404,434,43,30,57,42,-0.36636772962006625,0.03987066791169635,0.4778431641445946,0.9454310916422918,477,461,493,557,80,64,96,65,-0.021707306921345912,0.5694543300927567,1.1550794297630071,0.8048221531845717,30837,30837,Clare+Gladwin,Clare,26,35,Michigan,MI
26051,26CS015,315,304,325,390,75,65,86,36,1.1215606282767923,1.5546154162445425,1.950834190367081,0.47093615819070833,385,372,398,480,95,82,108,59,1.1264054252240938,1.7065123576911598,2.3766851622663006,0.6122981716311547,25428,25428,Clare+Gladwin,Gladwin,26,51,Michigan,MI
26037,26CS016,529,495,564,638,109,74,143,48,0.317993212174797,0.7502571347859116,1.1806363656062373,0.43785612233040655,653,612,694,771,118,77,159,90,-0.23826910009004648,0.4054059575393445,1.0331907635905815,0.7568450854223535,79672,79672,Clinton,Clinton,26,37,Michigan,MI
26039,26CS017,166,160,172,155,-11,-17,-5,2,-1.381337741816902,-0.9507403579638232,-0.5063896898336349,-0.19814743487151226,203,196,210,219,16,9,23,12,-0.2158320988594932,0.3649502708154399,0.9867775088866075,0.6968188967163857,13999,13999,Crawford+Montmorency+Oscoda+Roscommon,Crawford,26,39,Michigan,MI
26119,26CS017,145,141,149,159,14,10,18,16,-0.6419697324347441,-0.19666625898008538,0.2231482306311289,1.0636513408779724,176,172,181,200,24,19,28,26,-0.8937231937128162,-0.3076885340933204,0.3103006975173514,1.0543912013153718,9318,9318,Crawford+Montmorency+Oscoda+Roscommon,Montmorency,26,119,Michigan,MI
26135,26CS017,107,106,108,148,41,40,42,13,3.2460397387233764,3.3564360748513553,3.463599113111231,0.30948095839990464,131,130,132,172,41,40,42,33,0.9514277749920378,1.1078217801244505,1.269344966999826,0.791202090642685,8339,8339,Crawford+Montmorency+Oscoda+Roscommon,Oscoda,26,135,Michigan,MI
26143,26CS017,351,341,362,389,38,27,48,29,-0.06484969348881894,0.38544048041242895,0.8400644180928821,0.7482722400230585,428,415,440,468,40,28,53,61,-1.6083362818864368,-1.0099273800050197,-0.4222879119429183,1.4700479919564942,23986,23986,Crawford+Montmorency+Oscoda+Roscommon,Roscommon,26,143,Michigan,MI
26043,26CS018,264,254,275,339,75,64,85,68,-0.14727562095885016,0.2725122004495162,0.706512817796926,0.8996521873450827,324,311,337,360,36,23,49,30,-0.3463320700808592,0.30642595821842744,0.8943352827649745,0.8100353736661844,25243,25243,Dickinson+Iron+Menominee,Dickinson,26,43,Michigan,MI
26071,26CS018,166,162,171,204,38,33,42,28,0.44777317100282865,0.8570954183497856,1.2768074526827558,0.7265131904768051,203,197,209,197,-6,-12,-0,25,-3.9768559000446357,-3.35686101770648,-2.762966565256939,-5.191794871754434,11058,11058,Dickinson+Iron+Menominee,Iron,26,71,Michigan,MI
26109,26CS018,243,233,253,248,5,-5,15,22,-1.1386510730817245,-0.767774829507486,-0.31226731788618256,3.741244945278167,298,286,309,326,28,17,40,33,-0.8601762214765526,-0.2591106953647439,0.41029285444950014,1.1294368792976037,22704,22704,Dickinson+Iron+Menominee,Menominee,26,109,Michigan,MI
26045,26CS019,896,849,943,1071,175,128,222,80,0.452325127588327,0.8654973616994003,1.3111189821010398,0.4544282635184772,1103,1046,1160,1330,227,170,284,183,-0.12518994443488754,0.4646247914224852,1.0825887790520077,0.8031481428416959,110131,110131,Eaton,Eaton,26,45,Michigan,MI
26049,26CS020,3911,3736,4085,4701,790,616,965,497,0.32528870721285225,0.7158559319106447,1.1566525290340504,0.6279987094292326,4794,4585,5003,5635,841,632,1050,670,-0.1429868217301439,0.5223274812770063,1.1045104670909645,0.7954611752845135,405324,405324,Genesee,Genesee,26,49,Michigan,MI
26055,26CS021,776,736,817,899,123,82,163,37,0.45408230067432154,0.9224828263715872,1.3609857334531492,0.2993082096184481,957,908,1005,1121,164,116,213,113,0.06262030234693021,0.6854760090668257,1.267128299004469,0.6834143218007297,93265,93265,Grand Traverse+Leelanau,Grand Traverse,26,55,Michigan,MI
26089,26CS021,209,199,218,243,34,25,44,10,0.6819638828289466,1.1224272123115113,1.5432978694779433,0.2840328796816188,256,245,268,316,60,48,71,28,1.1009928746258433,1.7530347191503564,2.396364168374894,0.4612660856116525,21713,21713,Grand Traverse+Leelanau,Leelanau,26,89,Michigan,MI
26057,26CS022,396,378,413,484,88,71,106,54,0.45482237862858127,0.8502746905325492,1.2636416404661872,0.6056249124838633,485,464,505,528,43,23,64,48,-0.7289261927764737,-0.1447422337437467,0.5118472796925704,1.0815977931331708,40515,40515,Gratiot+Isabella,Gratiot,26,57,Michigan,MI
26073,26CS022,422,392,452,512,90,60,120,33,0.40188041561014964,0.8095106090519537,1.2458292098963242,0.3629192109497083,524,488,560,685,161,125,197,101,0.433790065003807,1.0405877654465956,1.687941222178183,0.6222557046012855,69580,69580,Gratiot+Isabella,Isabella,26,73,Michigan,MI
26063,26CS023,375,361,388,424,49,36,63,46,-0.305451709780511,0.10425065150895509,0.5198970636792231,0.913320429431003,455,439,471,529,74,58,90,71,-0.4881767242166938,0.1234276109110327,0.7255242097197011,0.9506529773875699,30799,30799,Huron+Sanilac,Huron,26,63,Michigan,MI
26151,26CS023,421,403,439,492,71,53,89,64,-0.24859318841839825,0.169078585669722,0.6044111180984335,0.8893072634732921,513,492,534,644,131,110,152,99,0.321455581360503,0.9472862347454518,1.5298016661932587,0.7488910924782446,41023,41023,Huron+Sanilac,Sanilac,26,151,Michigan,MI
26065,26CS024,1885,1760,2010,2244,359,234,484,157,0.2723559675663166,0.7092357358844718,1.1326592640219741,0.43560119893646515,2328,2177,2478,2847,519,369,670,345,0.08945529469875958,0.7280458068766889,1.3338532918494128,0.6629609571158102,291086,291086,Ingham,Ingham,26,65,Michigan,MI
26067,26CS025,458,431,486,520,62,34,89,31,0.025544886375802874,0.46474797659029904,0.9358531536491785,0.494563794295871,565,531,598,628,63,30,97,82,-0.9843333757952671,-0.3642841502131065,0.30461271585427635,1.276179471256159,64612,64612,Ionia,Ionia,26,67,Michigan,MI
26075,26CS026,1462,1394,1530,1706,244,176,312,175,0.036628826966578557,0.45049510250486297,0.8609369995566704,0.7141358071291042,1790,1709,1871,2158,368,287,449,229,0.4308667994814623,1.0835678279797285,1.6743131607089354,0.620146158716516,157758,157758,Jackson,Jackson,26,75,Michigan,MI
26077,26CS027,1869,1754,1983,2161,292,178,407,185,-0.04469677896198858,0.40100397226520784,0.8468081812658248,0.6305224835415949,2302,2164,2439,2657,355,218,493,249,-0.19849345310326738,0.4872250473930038,1.0943511188791366,0.6989227160256714,265721,265721,Kalamazoo,Kalamazoo,26,77,Michigan,MI
26081,26CS028,4188,3904,4471,4822,634,351,918,442,-0.1446648761100993,0.2783649969694524,0.7471697681282455,0.6955879986085991,5171,4831,5511,5808,637,297,977,542,-0.4486477460317122,0.17761240541841783,0.78286093714462,0.8498149785910168,657595,657595,Kent,Kent,26,81,Michigan,MI
26085,26CS029,148,143,153,175,27,22,32,3,1.619260375127797,2.05255485610149,2.4747239226272324,0.10705009997788499,180,174,186,194,14,8,20,20,-1.188026529686795,-0.6105948063849919,-0.010312861000914797,1.3305459814760738,11683,11683,Lake+Missaukee+Wexford,Lake,26,85,Michigan,MI
26113,26CS029,150,144,157,167,17,10,23,7,0.2402414476657154,0.6514149056348101,1.0875391373374745,0.3909732552636511,184,176,191,204,20,13,28,30,-1.4018197541573585,-0.7561440603763311,-0.0930358840645475,1.4021800864292557,15109,15109,Lake+Missaukee+Wexford,Missaukee,26,113,Michigan,MI
26165,26CS029,308,294,323,329,21,6,35,12,-0.1514898491356757,0.2550885854914653,0.6773410627534528,0.5496898129218676,377,360,395,507,130,112,147,66,1.6538170084381543,2.2693798071568025,2.88053688428425,0.5057204406774545,33691,33691,Lake+Missaukee+Wexford,Wexford,26,165,Michigan,MI
26087,26CS030,761,723,799,874,113,75,151,96,-0.2264368566123361,0.18294921546252407,0.626050679311674,0.8436132381147089,937,891,982,1206,269,224,315,210,0.17549985490067563,0.8156142176552652,1.4188522493859608,0.7764492995431952,87736,87736,Lapeer,Lapeer,26,87,Michigan,MI
26091,26CS031,896,854,939,1037,141,98,183,75,0.23021607104105485,0.6552910940773029,1.0720518879429053,0.5297843457273236,1097,1047,1148,1308,211,160,261,188,-0.33002756849680176,0.2769749169669756,0.8815108735212613,0.8873982666378313,98223,98223,Lenawee,Lenawee,26,91,Michigan,MI
26093,26CS032,1266,1183,1349,1499,233,150,316,80,0.36234186865911966,0.8005480521476628,1.231518502951495,0.34209383414599426,1564,1465,1663,1911,347,248,446,226,0.10767802793628806,0.7617058492222493,1.4468698720493436,0.6494746986893952,192173,192173,Livingston,Livingston,26,93,Michigan,MI
26099,26CS033,7472,7098,7847,9309,1837,1462,2211,1407,0.07523691425388485,0.5069362531251353,0.9391068169880352,0.7656766131732871,9164,8714,9614,10657,1493,1043,1943,1448,-0.5604951863023958,0.08046753985210946,0.7068022950444626,0.9692014092806912,871723,871723,Macomb,Macomb,26,99,Michigan,MI
26103,26CS034,584,556,612,600,16,-12,44,44,-0.8574243606612144,-0.4152556171846871,0.01462466728582484,2.5930864922637626,715,681,749,793,78,44,112,41,0.06728326859794892,0.6786511443512008,1.2663779689030725,0.51783712840835,66333,66333,Marquette,Marquette,26,103,Michigan,MI
26107,26CS035,352,333,371,412,60,41,79,13,0.6473711333144817,1.0648017522156117,1.4886428752029819,0.21425756856717015,434,412,457,474,40,17,62,59,-1.1478953594045251,-0.5317671256325937,0.08322762525812549,1.4500683603986204,43718,43718,Mecosta+Osceola,Mecosta,26,107,Michigan,MI
26133,26CS035,216,206,226,223,7,-3,17,17,-0.8110972585874658,-0.40769581382567516,0.028032522149888457,2.047589292412099,265,253,277,285,20,8,32,47,-1.9741285152363983,-1.3897716097311847,-0.7644508378021238,2.2295714431428073,23424,23424,Mecosta+Osceola,Osceola,26,133,Michigan,MI
26111,26CS036,648,612,684,767,119,83,155,37,0.5700689519944233,0.9940147172312437,1.4080579096928543,0.30827304107053294,797,754,840,938,141,98,184,103,-0.0313980651832527,0.5467620034757643,1.160556987286125,0.7237038900815207,83424,83424,Midland,Midland,26,111,Michigan,MI
26115,26CS037,1298,1233,1363,1530,232,167,297,123,0.27510528311303956,0.7216379512474068,1.156273064760682,0.5275027058479091,1594,1517,1672,1929,335,257,412,207,0.39804070581925766,0.9967959456008951,1.614229539297643,0.6167521817597255,150477,150477,Monroe,Monroe,26,115,Michigan,MI
26117,26CS038,546,519,573,620,74,47,101,70,-0.3568847437810351,0.07721118871146979,0.48097411955221314,0.9344497410963059,673,640,706,819,146,113,179,90,0.39661888822171387,1.0634178715812188,1.6521545149336925,0.611565021131694,63611,63611,Montcalm,Montcalm,26,117,Michigan,MI
26121,26CS039,1502,1427,1577,1878,376,301,451,247,0.3004312551547227,0.7483815555752541,1.1739884464400658,0.6546944206710353,1843,1753,1933,2150,307,217,397,230,-0.12310566889614008,0.54571842220835,1.175128069918397,0.7465810398039139,173744,173744,Muskegon,Muskegon,26,121,Michigan,MI
26123,26CS040,435,414,457,488,53,31,74,30,0.025308637154574473,0.464876328396516,0.9129710480862949,0.5597061435570442,531,506,557,641,110,84,135,82,0.03344730314820839,0.7131842499450458,1.269969786227627,0.7395345762543194,49161,49161,Newaygo+Oceana,Newaygo,26,123,Michigan,MI
26127,26CS040,231,220,243,284,53,41,64,41,0.01532189659379679,0.4317372431358578,0.8853994898555968,0.7647055793915992,282,269,296,330,48,34,61,37,-0.1630139801508132,0.4946972833939065,1.10957430199607,0.7617287637948426,26669,26669,Newaygo+Oceana,Oceana,26,127,Michigan,MI
26013,26CS041,90,89,91,105,15,14,16,27,-1.549163367311158,-1.4484694116232844,-1.3405578656071924,1.6755781714957347,111,109,112,114,3,2,5,18,-2.290613917837384,-2.126495722376315,-1.9728001014199323,4.039611921977913,8211,8211,Northwest Upper Peninsula,Baraga,26,13,Michigan,MI
26053,26CS041,164,158,170,207,43,37,49,38,-0.04248381778894443,0.37240427632122175,0.7930404745238882,0.860571324428664,201,194,208,211,10,3,17,20,-1.501966603231046,-0.8437792204076697,-0.2448444042501638,1.8043828077386066,13917,13917,Northwest Upper Peninsula,Gogebic,26,53,Michigan,MI
26061,26CS041,306,291,321,333,27,12,42,27,-0.42265523197436494,-0.014100854817908015,0.43315412297287353,0.9762760154379807,378,360,397,381,3,-16,21,46,-2.070320887753226,-1.4642103032204101,-0.8629821779122416,12.806446644002591,35466,35466,Northwest Upper Peninsula,Houghton,26,61,Michigan,MI
26083,26CS041,25,24,26,26,1,0,2,4,-1.8242397070448906,-1.3816009366934718,-0.9456510003402409,1.9336422019442745,31,30,32,35,4,3,5,2,0.7196461670120327,1.359239345322459,1.945063006178559,0.3732146636074741,2099,2099,Northwest Upper Peninsula,Keweenaw,26,83,Michigan,MI
26131,26CS041,81,80,81,115,34,34,35,20,2.4267402789775296,2.5326977921771654,2.633358301206446,0.5647029397542498,99,98,100,101,2,1,3,13,-2.4382202553000902,-2.2908880529152804,-2.14184479872458,4.134766015806244,5689,5689,Northwest Upper Peninsula,Ontonagon,26,131,Michigan,MI
26125,26CS042,9038,8499,9577,10946,1908,1369,2447,1401,-0.06371431551861212,0.43080857857691585,0.8398112266909512,0.7338839112540083,11119,10472,11767,12421,1302,654,1949,1189,-0.4849998378396681,0.11169388762257666,0.7497326250974435,0.9127852756673038,1255948,1255948,Oakland,Oakland,26,125,Michigan,MI
26139,26CS043,1747,1621,1874,2147,400,273,526,221,0.1608389314645028,0.6105664303558666,1.0319547403960563,0.5517745755241638,2168,2016,2320,2544,376,224,528,290,-0.2745485264210225,0.3577262205908404,0.9638826472827696,0.7696778538038523,292783,292783,Ottawa,Ottawa,26,139,Michigan,MI
26145,26CS044,1814,1732,1896,2310,496,414,578,328,0.421897280269366,0.8869305558935078,1.2862928662216888,0.6597630089740436,2221,2123,2319,2583,362,264,460,337,-0.44823110183076126,0.1553609190930281,0.8006124966047278,0.928929914557986,190227,190227,Saginaw,Saginaw,26,145,Michigan,MI
26147,26CS045,1523,1455,1592,1776,253,184,321,154,0.19490280185141354,0.6289304275873041,1.0783592268575126,0.6071485965117558,1865,1783,1947,2356,491,409,573,411,-0.03134225778562044,0.6133029436971073,1.2385099581296346,0.8354698378644965,159320,159320,St. Clair,St. Clair,26,147,Michigan,MI
26149,26CS046,568,542,595,639,71,44,97,59,-0.209434172323863,0.1916245398505508,0.5907527733397765,0.8237277596025647,697,665,728,792,95,64,127,89,-0.45755737193073986,0.12921810685739832,0.7350934666611277,0.9236401528105265,60835,60835,St. Joseph,St. Joseph,26,149,Michigan,MI
26155,26CS047,632,602,661,728,96,67,126,49,0.26729370262956337,0.6934111303366292,1.1137606032271619,0.5027555178581004,775,740,810,879,104,69,139,118,-0.866994094909528,-0.2554661096644409,0.36298237242781584,1.1243261303896777,67929,67929,Shiawassee,Shiawassee,26,155,Michigan,MI
26157,26CS048,526,503,548,647,121,99,144,90,0.1736482620305083,0.6076730197034603,0.9974378627344398,0.737202454123718,646,619,673,794,148,121,175,118,0.09920358630523905,0.6768297304156733,1.3443900424561837,0.791494377003715,52328,52328,Tuscola,Tuscola,26,157,Michigan,MI
26159,26CS049,659,626,691,767,108,76,141,90,-0.14750607278578126,0.22634011856979971,0.6505013413440615,0.8243490084081738,807,768,846,979,172,133,211,117,0.2683017688718615,0.8720248736388202,1.4620853862584176,0.6763250315426329,75544,75544,Van Buren,Van Buren,26,159,Michigan,MI
26161,26CS050,1981,1824,2139,2311,330,172,487,179,-0.011288540120923281,0.4038877293981649,0.8512545695900399,0.5415070680196469,2465,2275,2654,2630,165,-24,355,172,-0.6707195300949169,-0.013850049801232936,0.6135327296104486,1.0338731382318396,367505,367505,Washtenaw,Washtenaw,26,161,Michigan,MI
26163,26CS051,15326,14577,16075,19800,4474,3725,5223,3079,0.37666808919675365,0.7872460881335471,1.2437905050255234,0.6880482443474885,18775,17876,19674,21672,2897,1998,3796,2477,-0.3375013962587898,0.2790689433193932,0.8911454124333517,0.8546697057006759,1746147,1746147,Wayne,Wayne,26,163,Michigan,MI
27001,27CS001,193,186,200,225,32,25,39,29,-0.23027584345963314,0.19452976491309842,0.6143256159940156,0.8782050451205042,236,227,244,248,12,4,21,20,-1.2273098367223516,-0.5747543083367214,0.10893776379005413,1.4889914678306535,15844,15844,Aitkin+Itasca,Aitkin,27,1,Minnesota,MN
27061,27CS001,448,428,467,469,21,2,41,36,-0.7692568585190801,-0.3277586816468118,0.11720748340288786,1.6006757496971697,548,525,572,684,136,112,159,64,1.2784901373513746,1.880140698956054,2.479884248826988,0.46865693622186383,45243,45243,Aitkin+Itasca,Itasca,27,61,Minnesota,MN
27003,27CS002,1926,1771,2081,2359,433,278,588,331,-0.16161166993851722,0.2924707185540716,0.7325774196654142,0.7625722398641229,2396,2211,2582,2762,366,180,551,307,-0.3935645669673257,0.19989103152437288,0.7951689976778392,0.8375182617309866,358531,358531,Anoka,Anoka,27,3,Minnesota,MN
27005,27CS003,322,307,337,386,64,49,79,40,0.2939179970206761,0.7003031500067447,1.1452436871399139,0.613952817514637,398,380,415,410,12,-5,30,43,-1.7051051532774382,-1.0521138904960148,-0.4680436598560391,3.203494256016832,34459,34459,Becker+Hubbard+Mahnomen+Norman,Becker,27,5,Minnesota,MN
27057,27CS003,194,185,203,229,35,26,44,37,-0.5200347949901445,-0.09541452055737723,0.2982284519176281,1.0309741553987741,240,229,252,236,-4,-16,7,15,-1.6803107315807293,-1.064265773869243,-0.43458178463981856,-4.570571158558339,21679,21679,Becker+Hubbard+Mahnomen+Norman,Hubbard,27,57,Minnesota,MN
27087,27CS003,56,56,57,68,12,11,12,3,1.4391472046500837,1.551457428748308,1.6578698198888246,0.2388587596672215,69,69,70,88,19,18,19,10,1.7296236114007524,1.8951148929576278,2.04853102639091,0.5080971816840966,5512,5512,Becker+Hubbard+Mahnomen+Norman,Mahnomen,27,87,Minnesota,MN
27107,27CS003,83,82,83,66,-17,-17,-16,5,-3.5019089635028497,-3.3928618307576803,-3.29093223209333,-0.32039924284578464,101,100,102,85,-16,-17,-15,3,-3.7850540263183325,-3.630138416618374,-3.463009311827266,-0.19674821785723218,6367,6367,Becker+Hubbard+Mahnomen+Norman,Norman,27,107,Minnesota,MN
27007,27CS004,352,332,373,461,109,88,129,40,1.019795875326853,1.4445327496780962,1.9041969884269132,0.36423060665874285,433,409,458,507,74,49,98,56,-0.14861003446207902,0.45518963514345523,1.1202000157400924,0.7468107547330585,47304,47304,Beltrami+Clearwater,Beltrami,27,7,Minnesota,MN
27029,27CS004,84,84,85,92,8,7,8,10,-0.38232505092066976,-0.28170160801564065,-0.18059364285223162,1.173254231820458,104,102,105,125,21,20,23,15,0.7295680251929941,0.8693772765872488,1.0220618402162116,0.668335889964451,8916,8916,Beltrami+Clearwater,Clearwater,27,29,Minnesota,MN
27009,27CS005,324,306,342,397,73,55,91,72,-0.4123620458888139,0.01798624129456762,0.4614769193961193,0.973265771539027,399,377,420,407,8,-13,30,51,-1.872636696357819,-1.2631763259647557,-0.6147264474331393,5.394101639374746,40946,40946,Benton+Stearns,Benton,27,9,Minnesota,MN
27145,27CS005,938,868,1007,1187,249,180,319,185,-0.049696846911537265,0.3947752785410526,0.8409851147185124,0.7393310297628665,1164,1081,1248,1277,113,29,196,121,-0.6517630818786502,-0.06851422176946254,0.5439409362914096,1.0641258309484318,161477,161477,Benton+Stearns,Stearns,27,145,Minnesota,MN
27013,27CS006,429,399,458,456,27,-2,57,27,-0.40841523102093114,0.015957647230412885,0.4453577322209959,0.9544802371389083,528,493,563,593,65,30,100,41,-0.18058363838404584,0.4210553608368206,0.9996385906354733,0.6202416351112245,68027,68027,Blue Earth+Faribault+Martin+Watonwan,Blue Earth,27,13,Minnesota,MN
27043,27CS006,159,153,164,159,0,-5,6,11,-1.1999239897239267,-0.781723125844195,-0.32988640646851364,8.042562447417646,193,186,200,184,-9,-16,-2,17,-2.9133142369815648,-2.289288556625943,-1.6541601385041358,-2.150008459284511,13642,13642,Blue Earth+Faribault+Martin+Watonwan,Faribault,27,43,Minnesota,MN
27091,27CS006,210,202,218,215,5,-3,13,23,-1.3117144233143778,-0.9160604202496256,-0.5077706743041797,3.8009325237905567,256,245,266,302,46,36,57,25,0.7334699200150382,1.331035261274468,1.942486374438585,0.5267104372067797,19576,19576,Blue Earth+Faribault+Martin+Watonwan,Martin,27,91,Minnesota,MN
27165,27CS006,100,99,101,134,34,33,35,10,2.1281204109631284,2.23723690373749,2.3410679975459634,0.2840482124119217,122,121,124,128,6,4,7,15,-1.1671866866672669,-1.0111077303919345,-0.8584318390163992,2.1731122590012184,10824,10824,Blue Earth+Faribault+Martin+Watonwan,Watonwan,27,165,Minnesota,MN
27015,27CS007,248,237,258,268,20,10,31,30,-0.8207359901280384,-0.38827894092774207,0.0284856296041032,1.4103862120981046,305,292,317,342,37,25,50,30,-0.2851365246915465,0.3667418810296483,0.9786791549766107,0.781730902786485,24915,24915,Brown+Le Sueur+Nicollet,Brown,27,15,Minnesota,MN
27079,27CS007,211,199,223,216,5,-7,17,19,-0.9181856463651298,-0.48044002919189066,-0.05595952912765516,3.1989125820572935,262,247,277,284,22,7,37,32,-0.9931147943139219,-0.41569576481188136,0.1628667373337999,1.380882713245882,28808,28808,Brown+Le Sueur+Nicollet,Le Sueur,27,79,Minnesota,MN
27103,27CS007,224,209,239,238,14,-1,29,30,-0.873075572630778,-0.46242982240796643,-0.05325756876981351,2.0055622601975083,279,262,297,297,18,-0,35,20,-0.7154383373375164,-0.0842407983822622,0.5210209041879356,1.0713475557080094,34382,34382,Brown+Le Sueur+Nicollet,Nicollet,27,103,Minnesota,MN
27019,27CS008,473,427,519,510,37,-9,83,36,-0.3953684259604802,0.00408806276050388,0.4505316331236754,0.9401420825626634,592,537,647,674,82,27,137,53,-0.295366124240606,0.3237432009107357,0.9790853467850338,0.6359599914213304,105727,105727,Carver,Carver,27,19,Minnesota,MN
27021,27CS009,288,275,301,310,22,9,35,24,-0.4987849580889325,-0.07572376221402521,0.37976716177276604,1.0541509567898109,354,338,369,428,74,59,90,40,0.7508210922981435,1.366243420093281,2.0112838376035516,0.5300731191348349,29750,29750,Cass+Crow Wing,Cass,27,21,Minnesota,MN
27035,27CS009,603,575,632,619,16,-13,44,68,-1.220232646917965,-0.8053672163476846,-0.37400586901425914,4.093341872510689,741,707,775,815,74,40,108,67,-0.5336683075857362,0.12261486311534628,0.7350660350209492,0.8889441018611972,65380,65380,Cass+Crow Wing,Crow Wing,27,35,Minnesota,MN
27025,27CS010,389,364,413,412,23,-1,48,27,-0.5153210356022129,-0.0711210061390132,0.38052345455814596,1.1148729343634094,481,452,510,544,63,34,92,64,-0.6413972261602989,-0.016974481059299863,0.5889683900550767,1.0016087291508093,56648,56648,Chisago+Isanti,Chisago,27,25,Minnesota,MN
27059,27CS010,294,276,312,314,20,2,38,31,-0.6893387839053648,-0.27750185493140406,0.1641799864935996,1.4709863933998581,364,343,385,435,71,50,92,57,-0.2307963590808446,0.4007063050535641,1.0139389105136725,0.7908549478309153,40856,40856,Chisago+Isanti,Isanti,27,59,Minnesota,MN
27027,27CS011,419,391,447,489,70,42,98,83,-0.6081841311821499,-0.21369056055544255,0.22277741996798317,1.1740542083868253,517,483,550,537,20,-13,54,32,-0.8518303177761984,-0.20491886486052646,0.446169184026799,1.507289990198778,64545,64545,Clay,Clay,27,27,Minnesota,MN
27037,27CS012,2296,2111,2482,2746,450,264,635,285,-0.04229163821722461,0.3704631776118545,0.7700890023233553,0.632485915975481,2858,2635,3081,3236,378,155,601,333,-0.5231719044055541,0.11832487270820082,0.7711325868937179,0.8794498797091456,430434,430434,Dakota,Dakota,27,37,Minnesota,MN
27039,27CS013,139,137,142,133,-6,-9,-4,7,-0.7454024512623768,-0.6361858451663639,-0.5294711005108848,-1.297782496972304,172,169,175,163,-9,-12,-6,11,-1.281225992034735,-1.1297166479511889,-0.9792781780170604,-1.4112020730491994,20981,20981,Dodge+Steele+Waseca,Dodge,27,39,Minnesota,MN
27147,27CS013,273,257,288,299,26,11,42,4,0.16290858989076826,0.5992312577185368,1.0360099757832317,0.14617365759933054,338,319,356,382,44,26,63,33,-0.2280409366373482,0.3723702712368507,0.9854188347863677,0.7265769105072105,36649,36649,Dodge+Steele+Waseca,Steele,27,147,Minnesota,MN
27161,27CS013,159,151,167,162,3,-5,11,18,-1.2234983386847935,-0.805757528657703,-0.3956700363538872,4.332047611416083,196,186,206,188,-8,-18,2,14,-2.0172998796132027,-1.408743229243612,-0.823478100020275,-2.0220595059050748,18555,18555,Dodge+Steele+Waseca,Waseca,27,161,Minnesota,MN
27041,27CS014,379,363,396,433,54,37,70,52,-0.38256248387816333,0.043910864519471696,0.47470553269969057,0.947858841806473,463,443,483,447,-16,-36,4,46,-2.583723896868239,-1.9444785540488274,-1.2925108092167361,-3.043257551594314,38178,38178,Douglas+Morrison+Todd,Douglas,27,41,Minnesota,MN
27097,27CS014,275,261,289,323,48,34,62,43,-0.2605533742354092,0.14346085150358348,0.5759085677711284,0.8745077595106556,337,319,354,415,78,61,96,34,0.9604495168776306,1.6213578691554564,2.2171218999614415,0.42769120559136664,33270,33270,Douglas+Morrison+Todd,Morrison,27,97,Minnesota,MN
27153,27CS014,185,174,196,214,29,18,40,31,-0.5474515727096628,-0.06979503300431247,0.325455442537597,1.0343354453776263,227,214,240,252,25,12,38,28,-0.7782894606104521,-0.14198278549190924,0.41535782721427206,1.0823069026832628,24728,24728,Douglas+Morrison+Todd,Todd,27,153,Minnesota,MN
27045,27CS015,198,188,207,206,8,-1,18,5,-0.2572744680465737,0.15393344632432357,0.5713172555162204,0.5313505145740104,241,230,252,248,7,-4,18,14,-0.9761377507935347,-0.3930046218468137,0.2552014837202836,1.6839110608821621,21104,21104,Fillmore+Houston+Winona,Fillmore,27,45,Minnesota,MN
27055,27CS015,164,156,172,179,15,7,23,12,-0.2577488765320935,0.17771477455454687,0.61907474214273706,0.7340123831307398,199,190,209,201,2,-8,11,6,-0.9324300876053867,-0.27332615865101734,0.3201674363113957,2.3611964784367587,18652,18652,Fillmore+Houston+Winona,Houston,27,55,Minnesota,MN
27169,27CS015,362,340,383,389,27,6,49,41,-0.7040884737964774,-0.266721658332003,0.14303259552931352,1.447421190892838,442,416,468,430,-12,-38,14,20,-1.3622485482148516,-0.7655113884424134,-0.17298567987437743,-1.7694320209881336,50586,50586,Fillmore+Houston+Winona,Winona,27,169,Minnesota,MN
27047,27CS016,306,293,319,326,20,7,33,17,-0.33563358766201984,0.07662066928667643,0.5356171992264223,0.8168988640627343,374,358,389,391,17,2,33,24,-0.8901683125357442,-0.26631515460570143,0.32346301788651494,1.3143426497386852,30376,30376,Freeborn+Mower,Freeborn,27,47,Minnesota,MN
27099,27CS016,354,337,371,354,-0,-17,17,30,-1.2038342695650186,-0.7243605141245878,-0.32167405591044707,38.61064266367645,434,413,454,446,12,-8,33,21,-0.9452572775782864,-0.2834843004753594,0.2682569031623542,1.5604898928197781,40086,40086,Freeborn+Mower,Mower,27,99,Minnesota,MN
27049,27CS017,417,397,437,482,65,45,85,42,0.07244236643374949,0.4823616386709239,0.9395558311822525,0.6376492360494247,512,488,536,566,54,30,78,43,-0.3496646562900135,0.311144923848393,0.8904812154228758,0.7787965893969051,46361,46361,Goodhue+Wabasha,Goodhue,27,49,Minnesota,MN
27157,27CS017,169,160,179,194,25,15,34,6,0.4651642913708622,0.849950670371725,1.3066964783720094,0.2341057196455244,209,197,220,219,10,-1,22,10,-0.6033449008732344,0.014255369658108561,0.6154578675026742,0.8770142115561905,21587,21587,Goodhue+Wabasha,Wabasha,27,157,Minnesota,MN
27053,27CS018,7578,7032,8124,9067,1489,943,2035,1286,-0.23447991461385623,0.17455801424638867,0.5917951198477075,0.8630656325979834,9373,8718,10028,9900,527,-128,1182,683,-0.7287994999586588,-0.142790505719533,0.4483593643254968,1.2930564540240943,1266513,1266513,Hennepin,Hennepin,27,53,Minnesota,MN
27065,27CS019,145,138,152,181,36,29,43,19,0.6376478198705945,1.0412097944468488,1.458298799713438,0.5108058892670255,177,168,185,213,36,28,45,29,-0.07057380015803069,0.5368710678352833,1.0877052226906487,0.7818414177616488,16382,16382,Kanabec+Mille Lacs+Pine,Kanabec,27,65,Minnesota,MN
27095,27CS019,258,246,269,306,48,37,60,42,-0.1556366767632456,0.23725817820063236,0.6593515310451201,0.8511938344049584,314,301,328,377,63,49,76,47,0.1003149810588272,0.7211352974501998,1.3642371873308707,0.7354136420110329,26158,26158,Kanabec+Mille Lacs+Pine,Mille Lacs,27,95,Minnesota,MN
27115,27CS019,253,240,266,302,49,36,62,18,0.6215002797500268,1.0550209359131753,1.484665081067478,0.36059226349804624,309,294,324,392,83,68,98,38,1.231038928218644,1.8145798984145514,2.3984147386220878,0.4532552296189636,29400,29400,Kanabec+Mille Lacs+Pine,Pine,27,115,Minnesota,MN
27067,27CS020,333,314,352,406,73,54,92,69,-0.32797997158291126,0.09759199093760905,0.5092345758771264,0.9320847466622731,409,387,431,438,29,7,51,48,-1.1881980895100386,-0.5444435508135294,0.08045664678296603,1.6083318149448271,43134,43134,Kandiyohi+Renville,Kandiyohi,27,67,Minnesota,MN
27129,27CS020,156,150,162,174,18,12,24,34,-1.5449497947983775,-1.118541866798748,-0.6781492355011959,1.8035502773344672,190,183,198,203,13,5,20,10,-0.3728936515098008,0.2182759960409293,0.7956578547236515,0.7362757115812469,14489,14489,Kandiyohi+Renville,Renville,27,129,Minnesota,MN
27085,27CS021,287,272,303,376,89,73,104,39,0.9849764981900743,1.3843336735283178,1.8382935562522431,0.43461141418376653,351,333,370,417,66,47,84,43,0.1921883689148445,0.7469031964561823,1.4150126066846633,0.6432006898494279,35778,35778,McLeod+Meeker+Sibley,McLeod,27,85,Minnesota,MN
27093,27CS021,193,183,203,226,33,23,43,29,-0.26668358311218604,0.13767883417239968,0.6081196914512553,0.8598515686151527,236,224,248,244,8,-4,20,27,-1.606349310278483,-1.00029303562202,-0.37977075593960596,3.1184878200372363,23239,23239,McLeod+Meeker+Sibley,Meeker,27,93,Minnesota,MN
27143,27CS021,122,120,123,93,-29,-30,-27,3,-2.254819924215204,-2.1471816447810657,-2.0450230558469626,-0.10783679807886691,149,147,151,169,20,18,22,12,0.4568385914810953,0.6188812496372169,0.7698360232134128,0.5812090934390053,14804,14804,McLeod+Meeker+Sibley,Sibley,27,143,Minnesota,MN
27069,27CS022,51,50,51,74,23,23,24,19,0.9142751058309343,1.0206967104642128,1.1247995889955862,0.7806931513602682,62,62,63,61,-1,-2,-1,5,-1.8912584120212488,-1.7446047244838723,-1.5950777626218346,-25.861608147651193,4256,4256,Northwest Minnesota,Kittson,27,69,Minnesota,MN
27077,27CS022,39,38,39,45,6,6,7,7,-0.2532186433545093,-0.13707826897758144,-0.026792072958935046,0.9346626534861808,47,47,48,50,3,2,3,3,-0.2677822030643205,-0.11136622567547125,0.052309436196741055,0.8205282580693596,3744,3744,Northwest Minnesota,Lake of the Woods,27,77,Minnesota,MN
27089,27CS022,74,73,75,87,13,12,14,15,-0.302725600270044,-0.20238914465946664,-0.10411638158679427,1.0620184200130376,91,90,92,97,6,5,7,12,-0.9403872640813982,-0.7843600998819454,-0.6281899184650273,1.7416210028572174,9335,9335,Northwest Minnesota,Marshall,27,89,Minnesota,MN
27113,27CS022,116,114,117,121,5,4,7,13,-0.6704438045105707,-0.5661593294139388,-0.46463252433741203,2.1456982527135278,143,141,145,155,12,10,14,13,-0.22992335305612,-0.0779580941118965,0.0825274351742459,0.9923240251594921,13988,13988,Northwest Minnesota,Pennington,27,113,Minnesota,MN
27119,27CS022,300,287,314,349,49,35,62,60,-0.7845415210603087,-0.3552050361715226,0.05490547391999795,1.2103668963283212,369,353,385,378,9,-7,25,35,-1.6268398941695672,-1.0230996819784492,-0.38281023120727,3.6328160713052617,31151,31151,Northwest Minnesota,Polk,27,119,Minnesota,MN
27125,27CS022,29,29,29,27,-2,-2,-2,0,-0.5937721509880822,-0.4793690294325273,-0.3761194334761731,-0,36,35,36,43,7,7,8,8,-0.37550650340567315,-0.2209444365990126,-0.06580957615178527,0.9682639796060867,4038,4038,Northwest Minnesota,Red Lake,27,125,Minnesota,MN
27135,27CS022,119,117,120,174,55,54,57,17,2.4306423496244656,2.5306505010406437,2.641501882517663,0.3016465925955343,146,144,148,169,23,21,25,15,0.4389032937494034,0.6010236368968193,0.7648717210353274,0.634015275558684,15151,15151,Northwest Minnesota,Roseau,27,135,Minnesota,MN
27109,27CS023,950,882,1019,1055,105,36,173,57,-0.15237845151417928,0.3058908872094386,0.7014584421828255,0.5394471522944992,1177,1095,1259,1261,84,2,166,51,-0.40123767722880743,0.22997711907966778,0.8753271118999909,0.5989345906826766,158650,158650,Olmsted,Olmsted,27,109,Minnesota,MN
27111,27CS024,571,546,596,675,104,79,129,53,0.42687261224003625,0.8771020170971038,1.3117845508080495,0.5048724616790536,697,667,728,779,82,51,112,82,-0.6331293327912961,0.015174115141845326,0.5977516727831428,0.991324529338206,58708,58708,Otter Tail+Wadena+Wilkin,Otter Tail,27,111,Minnesota,MN
27159,27CS024,179,173,185,170,-9,-15,-3,11,-1.8580747277679843,-1.4460869999562143,-1.0125596986318077,-1.3839865263403286,218,211,225,221,3,-4,10,29,-2.9029530668132835,-2.2505517326073385,-1.6483410959141445,6.822286519165669,13722,13722,Otter Tail+Wadena+Wilkin,Wadena,27,159,Minnesota,MN
27167,27CS024,68,68,69,76,8,7,8,12,-0.8154056932934083,-0.7124214928664306,-0.6036433522278577,1.3986580517266858,84,83,85,88,4,3,5,11,-1.465975769764238,-1.3091357586145111,-1.1495340150260092,2.106972095042714,6197,6197,Otter Tail+Wadena+Wilkin,Wilkin,27,167,Minnesota,MN
27123,27CS025,3655,3419,3890,4354,699,464,935,630,-0.26324638689693575,0.13883420173839991,0.5482980925761338,0.8994806804809015,4507,4224,4790,4968,461,178,744,357,-0.4368883692664108,0.20391345636375321,0.8378618413482464,0.772807861540883,548912,548912,Ramsey,Ramsey,27,123,Minnesota,MN
27131,27CS026,446,417,475,508,62,33,91,52,-0.239162407998015,0.14159162589909427,0.5669397796464782,0.820884319925792,551,517,586,614,63,28,97,73,-0.8047288220542174,-0.18766534508613864,0.39697105693646595,1.1495319017341794,67044,67044,Rice,Rice,27,131,Minnesota,MN
27017,27CS027,322,307,338,367,45,29,60,41,-0.3089970314034417,0.11194849226632612,0.49729275551337176,0.8939418289559641,394,376,413,470,76,57,94,34,0.7706223765414263,1.383355917958477,1.9724281128767631,0.4424390743167853,35853,35853,St. Louis and Nearby Counties,Carlton,27,17,Minnesota,MN
27031,27CS027,44,43,45,48,4,3,5,1,0.4619974748610847,0.5614076481381409,0.6703242602382145,0.19815469282922737,54,53,55,49,-5,-6,-4,4,-2.146259112911386,-1.9959130722173293,-1.8429312353435245,-0.9982070786689629,5416,5416,St. Louis and Nearby Counties,Cook,27,31,Minnesota,MN
27071,27CS027,125,124,126,147,22,21,23,3,1.4726630497902382,1.5731065311060946,1.6789436919573562,0.12943735373503898,153,151,155,186,33,31,35,22,0.9342128190799807,1.080709522680564,1.239053231639328,0.6479719934926524,12142,12142,St. Louis and Nearby Counties,Koochiching,27,71,Minnesota,MN
27075,27CS027,132,128,137,135,3,-2,7,12,-1.2901017070041223,-0.8742892859031474,-0.4525785976759864,3.1959996004124784,161,156,167,168,7,1,12,6,-0.5198672967212292,0.09838419039078973,0.7849716259404182,0.7508727169540356,10631,10631,St. Louis and Nearby Counties,Lake,27,75,Minnesota,MN
27137,27CS027,1755,1670,1841,2079,324,238,409,220,0.10341936183380503,0.5205285378748135,0.9563169605963625,0.6777722227831703,2149,2046,2251,2368,219,117,322,185,-0.4232540642623519,0.19903165052883792,0.8573683223372537,0.8399404486691302,198931,198931,St. Louis and Nearby Counties,St. Louis,27,137,Minnesota,MN
27139,27CS028,626,561,691,740,114,49,179,64,-0.09854461464901593,0.3271002445584127,0.7724661797254873,0.5559140891598555,783,705,861,911,128,50,206,109,-0.45200749388271266,0.1475563637978784,0.761475741985924,0.8462435189752536,149706,149706,Scott,Scott,27,139,Minnesota,MN
27141,27CS029,491,448,533,595,104,62,147,57,0.05483098166032815,0.48815554967312286,0.9529579815124961,0.5426192701984001,612,560,663,727,115,64,167,87,-0.2264337682877132,0.3368114358925455,0.937643802577699,0.7469688013436587,98002,98002,Sherburne,Sherburne,27,141,Minnesota,MN
27033,27CS030,133,128,138,150,17,12,22,16,-0.39377667254999527,0.0992120811849425,0.5126482071782962,0.8858949206487358,163,157,168,166,3,-2,9,16,-1.9419819005065992,-1.352475800457672,-0.7355536145104561,3.668795382541915,11236,11236,Southwest Minnesota,Cottonwood,27,33,Minnesota,MN
27063,27CS030,90,89,91,96,6,5,7,11,-0.6099750207334885,-0.5074072340329351,-0.3988844116745495,1.561176643756033,111,110,112,106,-5,-6,-4,8,-1.7306259388181071,-1.5688680117471228,-1.4053015940650408,-2.1010597607730688,9786,9786,Southwest Minnesota,Jackson,27,63,Minnesota,MN
27101,27CS030,82,81,83,58,-24,-25,-23,5,-3.6430093082831254,-3.5432532909442442,-3.429653158344733,-0.21771912057059778,101,100,102,109,8,7,9,1,0.8936231295339606,1.050531127829219,1.2010349447818711,0.10943166655934683,8180,8180,Southwest Minnesota,Murray,27,101,Minnesota,MN
27105,27CS030,157,147,166,201,44,35,54,43,-0.3693932599382155,0.07396605533827798,0.5125338631715897,0.9455594080200945,194,182,205,185,-9,-20,3,18,-2.0808229185192566,-1.469308844039541,-0.8215864098311958,-2.3856047316591003,21543,21543,Southwest Minnesota,Nobles,27,105,Minnesota,MN
27117,27CS030,101,100,102,106,5,4,6,17,-1.3776491964835715,-1.266347836768242,-1.1679351757052807,2.6537618843022024,124,122,125,128,4,3,6,11,-1.0286633095850088,-0.876437392071284,-0.7103947795525893,2.058782378131806,9139,9139,Southwest Minnesota,Pipestone,27,117,Minnesota,MN
27133,27CS030,99,98,100,119,20,19,21,13,0.6852553803669885,0.7919772965699423,0.9043699496859761,0.6068211571203791,121,120,122,122,1,-0,2,16,-2.11038603233532,-1.9631989414482116,-1.806636961152544,9.03643047203083,9320,9320,Southwest Minnesota,Rock,27,133,Minnesota,MN
27011,27CS031,65,65,66,67,2,1,2,3,-0.402136381849193,-0.2977866968707834,-0.18835070105120993,1.1897387218713982,80,80,81,76,-4,-5,-4,1,-1.4841668544828914,-1.3209129191713997,-1.1675453449883255,-0.2899740047039267,4949,4949,Stevens and Nearby Counties,Big Stone,27,11,Minnesota,MN
27023,27CS031,142,137,147,155,13,8,18,28,-1.7178884107354304,-1.2983064443914416,-0.8497293265240693,2.0455871986699865,175,168,181,172,-3,-9,4,4,-1.231293341945928,-0.6753557596086378,-0.050753158639621196,-2.636348788311457,11757,11757,Stevens and Nearby Counties,Chippewa,27,23,Minnesota,MN
27051,27CS031,59,59,60,73,14,13,14,6,1.194515311574277,1.3002997440447204,1.4004169053750053,0.4056894632776779,73,72,74,78,5,4,6,1,0.63922904519862,0.8025265463821954,0.9619354265632559,0.16653711187527334,5997,5997,Stevens and Nearby Counties,Grant,27,51,Minnesota,MN
27121,27CS031,112,111,114,109,-3,-5,-2,8,-1.119236722192725,-1.0166380552564223,-0.9104460953838933,-3.297317293584148,139,137,140,148,9,8,11,8,-0.004340594882213546,0.1501184124954426,0.3185108554995541,0.7675144195430751,11241,11241,Stevens and Nearby Counties,Pope,27,121,Minnesota,MN
27149,27CS031,75,74,76,80,5,4,6,7,-0.310765315212232,-0.21156570179805467,-0.1048647734567738,1.1757049159238986,93,92,94,74,-19,-20,-18,4,-2.9522073610181456,-2.8038178640272378,-2.658198109563714,-0.2237694579337647,9798,9798,Stevens and Nearby Counties,Stevens,27,149,Minnesota,MN
27151,27CS031,101,100,102,123,22,21,23,17,0.46749920462048156,0.5823423903207157,0.6872124223788697,0.7271467821897172,124,123,125,94,-30,-31,-29,15,-5.97481603395342,-5.821642971001071,-5.683267837642719,-0.5191627828448532,9245,9245,Stevens and Nearby Counties,Swift,27,151,Minnesota,MN
27155,27CS031,47,47,47,56,9,9,9,9,-0.09308251202253,0.018873118495375686,0.13457814692500433,0.8938333631456993,58,57,58,61,3,3,4,6,-1.128749092554521,-0.9726656311369928,-0.807534493400483,1.3671007634037986,3242,3242,Stevens and Nearby Counties,Traverse,27,155,Minnesota,MN
27163,27CS032,1476,1361,1590,1715,239,125,354,172,-0.1678233782425577,0.2542361415397115,0.6820470735443351,0.7154589591997239,1833,1696,1970,2017,184,47,321,182,-0.6221980044958049,-2.9929261778787424e-4,0.5905095987191461,0.984720597504508,263764,263764,Washington,Washington,27,163,Minnesota,MN
27171,27CS033,742,681,802,824,82,22,143,92,-0.47757598639559634,-0.07137492839271642,0.33954357116469414,1.1024733284429418,925,852,997,1097,172,100,245,146,-0.3998869885847731,0.22883197419440285,0.8664019785042346,0.8421169781847466,139253,139253,Wright,Wright,27,171,Minnesota,MN
27073,27CS034,70,69,71,94,24,23,25,16,1.0944783947158678,1.1999325512947403,1.3056735248614868,0.6427103208469541,86,85,87,102,16,15,17,2,2.440492840317712,2.5901175280366586,2.758311882992025,0.11600102404117768,6586,6586,Yellow Medicine and Nearby Counties,Lac Qui Parle,27,73,Minnesota,MN
27081,27CS034,68,67,68,65,-3,-3,-2,5,-1.4925330543384019,-1.378187736831225,-1.276176238189427,-2.877586705881783,83,82,84,101,18,17,19,6,2.451800512198037,2.61963259605286,2.771702436926991,0.3125891676914236,5598,5598,Yellow Medicine and Nearby Counties,Lincoln,27,81,Minnesota,MN
27083,27CS034,189,178,200,226,37,26,48,25,0.04109729535574906,0.49195758058681743,0.9400027280346249,0.6524709191208286,231,218,244,247,16,3,29,37,-1.6174535498994653,-1.0061132586190793,-0.4001190034456094,2.2126694573870243,25451,25451,Yellow Medicine and Nearby Counties,Lyon,27,83,Minnesota,MN
27127,27CS034,154,148,161,178,24,17,30,21,-0.2138407724786752,0.1976503185633633,0.6205019514041196,0.8415418899037729,188,180,196,187,-1,-9,7,18,-2.1046610917090405,-1.4819986891828691,-0.8776232206915111,95.75388028046339,15125,15125,Yellow Medicine and Nearby Counties,Redwood,27,127,Minnesota,MN
27173,27CS034,91,90,92,91,0,-1,1,14,-1.5420622633248067,-1.4343134843364937,-1.3264224229407626,12.465745866219736,111,110,113,109,-2,-4,-1,16,-2.413970344174411,-2.2642239239063144,-2.1044395638287834,-12.777565490372032,9671,9671,Yellow Medicine and Nearby Counties,Yellow Medicine,27,173,Minnesota,MN
28001,28CS001,339,326,352,414,75,62,88,61,0.021203272258646155,0.4488276586602808,0.8873583911362039,0.8033718747295737,413,398,429,467,54,38,69,60,-0.8519810120510385,-0.25637417853460404,0.3809841252724574,1.0972325937423555,30544,30544,Adams+Amite+Wilkinson,Adams,28,1,Mississippi,MS
28005,28CS001,146,141,151,167,21,16,26,23,-0.5944039833333645,-0.1513620830071166,0.25880421718717983,1.041367441752841,178,171,184,224,46,40,53,31,0.8488832034893057,1.4854467066288755,2.1006127815430107,0.656824815570836,12252,12252,Adams+Amite+Wilkinson,Amite,28,5,Mississippi,MS
28157,28CS001,104,103,105,119,15,14,16,19,-0.5816677540548943,-0.4709481733769059,-0.35813694409858143,1.1869408972300046,128,126,129,123,-5,-6,-3,15,-2.9097915567256014,-2.760336979559573,-2.610455277278789,-4.2067791695282155,8513,8513,Adams+Amite+Wilkinson,Wilkinson,28,157,Mississippi,MS
28003,28CS002,400,384,416,463,63,47,79,41,0.1300513194970464,0.6048370086860629,1.039215040534831,0.6398412223345237,488,469,507,541,53,34,72,67,-1.070901229846162,-0.4492505949727527,0.1586069464537258,1.2423750364444452,36979,36979,Alcorn+Prentiss+Tishomingo,Alcorn,28,3,Mississippi,MS
28117,28CS002,267,257,278,342,75,64,85,45,0.7706239595426627,1.1844221327139466,1.6319506989136774,0.5948233109721461,326,313,339,367,41,28,54,40,-0.6454054266876248,-0.004523719857403152,0.6366667638036086,0.961588434667953,25049,25049,Alcorn+Prentiss+Tishomingo,Prentiss,28,117,Mississippi,MS
28141,28CS002,246,237,254,308,62,54,71,44,0.513786610735942,0.9454975074238959,1.3479674497615934,0.6936825190040316,299,289,309,392,93,83,103,39,2.7287471856001027,3.3733405375545775,3.979366655158971,0.41453794936239385,19329,19329,Alcorn+Prentiss+Tishomingo,Tishomingo,28,141,Mississippi,MS
28007,28CS003,223,215,231,272,49,41,57,33,0.4387108759843248,0.8756370839085913,1.2789060301215704,0.660401322191818,271,262,280,305,34,25,43,33,-0.5624558065491667,0.06551375647844035,0.6607098143166301,0.9473372059041593,18103,18103,Attala+Choctaw+Leake+Webster,Attala,28,7,Mississippi,MS
28019,28CS003,92,91,93,108,16,15,17,10,0.6477000098287039,0.7508734348770522,0.8517846779316737,0.584965864186061,113,111,114,115,2,1,4,13,-1.7197155115339657,-1.5539314639418456,-1.388753363886079,3.754961015685223,8138,8138,Attala+Choctaw+Leake+Webster,Choctaw,28,19,Mississippi,MS
28079,28CS003,200,190,210,270,70,60,80,62,-0.07045931506564608,0.34486145753575453,0.7798697103930807,0.874567204790096,245,233,257,316,71,59,83,38,1.1451953731179336,1.7442547425938344,2.33344892500622,0.5261389235900568,22793,22793,Attala+Choctaw+Leake+Webster,Leake,28,79,Mississippi,MS
28155,28CS003,132,128,136,152,20,16,24,20,-0.41952475970052927,0.011557950905166547,0.43568210348100667,0.9487357600075764,160,155,165,203,43,38,48,23,1.779579187229569,2.4335181795408487,3.0531163718746406,0.5260545133276071,9691,9691,Attala+Choctaw+Leake+Webster,Webster,28,155,Mississippi,MS
28009,28CS004,94,93,95,119,25,24,26,18,0.7399027559069531,0.8487080783436847,0.958695163719596,0.6910221138153948,115,114,116,131,16,15,17,24,-1.3220632285018519,-1.1698976455635606,-1.017033105153601,1.4180121341985918,8308,8308,Benton+Marshall+Tippah,Benton,28,9,Mississippi,MS
28093,28CS004,352,337,367,437,85,70,100,46,0.6714979368408976,1.0960018693900988,1.5539735506471604,0.5353320270970072,431,413,449,580,149,131,167,72,2.02312289913929,2.626365495429462,3.24276414089008,0.4794505358501812,35302,35302,Benton+Marshall+Tippah,Marshall,28,93,Mississippi,MS
28139,28CS004,231,221,240,285,54,45,64,43,0.1015566404919043,0.5280425173374643,0.9497702405644626,0.7759060304044334,282,270,293,334,52,41,64,45,-0.1967199180581157,0.38586224561919513,0.9712496604138144,0.8417729141132612,21907,21907,Benton+Marshall+Tippah,Tippah,28,139,Mississippi,MS
28011,28CS005,331,318,344,473,142,129,155,87,1.4207262864030192,1.8002786528268704,2.2147847521288737,0.6097098829697918,406,391,422,491,85,69,100,50,0.7650391461524546,1.3573937040732427,2.002213323087959,0.5823479799842561,30476,30476,Bolivar+Sunflower,Bolivar,28,11,Mississippi,MS
28133,28CS005,258,247,268,367,109,99,120,55,1.7612831035390601,2.1838657853984,2.6020951860683144,0.49803408216507844,316,303,329,396,80,67,93,43,1.1597502632370977,1.765001902122003,2.3615484252486256,0.532331482768367,24968,24968,Bolivar+Sunflower,Sunflower,28,133,Mississippi,MS
28013,28CS006,153,147,159,209,56,50,62,19,2.178272076172816,2.600815239310043,3.0578435285812313,0.3314018292950543,186,179,194,231,45,37,52,32,0.44670842147424217,1.0380200783065934,1.6557937030210503,0.6995455096016182,14313,14313,Calhoun+Chickasaw+Grenada,Calhoun,28,13,Mississippi,MS
28017,28CS006,170,163,178,210,40,32,47,34,-0.08023097469836925,0.3417183041439394,0.7293436992573461,0.8346795813497845,208,199,217,248,40,31,49,33,-0.12572873108057414,0.49577956842836923,1.0952522416221517,0.8056522369202958,16995,16995,Calhoun+Chickasaw+Grenada,Chickasaw,28,17,Mississippi,MS
28043,28CS006,251,242,260,329,78,69,87,48,1.008207152336659,1.4397756017409553,1.851090654906482,0.6103650041021764,306,295,317,350,44,33,55,39,-0.3403495963309503,0.27106585246600096,0.923897722534626,0.868517388743301,20681,20681,Calhoun+Chickasaw+Grenada,Grenada,28,43,Mississippi,MS
28015,28CS007,95,94,96,141,46,45,47,20,2.547106532095778,2.6520961617294927,2.764524942031071,0.42438599704280294,117,116,118,155,38,37,39,24,1.5723941650894742,1.7250002893740368,1.885022723311033,0.6130930280399397,9846,9846,Carroll+Leflore+Montgomery,Carroll,28,15,Mississippi,MS
28083,28CS007,304,292,316,477,173,161,185,91,2.5070216219547543,2.932104013757701,3.3479181287756936,0.521613610830878,371,357,386,442,71,56,85,39,0.7441329800033285,1.3395933081613869,1.9502584398591345,0.5453323314574785,28057,28057,Carroll+Leflore+Montgomery,Leflore,28,83,Mississippi,MS
28097,28CS007,132,127,136,184,52,48,57,35,1.3710187969700656,1.7751210204705252,2.226169864409064,0.6559645351384498,160,155,165,169,9,4,14,26,-2.7877459223467205,-2.146580975014458,-1.5800173888474933,2.7282698121490503,9722,9722,Carroll+Leflore+Montgomery,Montgomery,28,97,Mississippi,MS
28021,28CS008,90,89,91,113,23,22,24,20,0.2460881674546285,0.344002921433482,0.45015872682338703,0.830017737254284,110,109,111,130,20,19,21,20,-0.15577000646895758,-0.007678192376732711,0.1568819027853412,0.9533199583263894,8962,8962,Claiborne+Jefferson+Warren,Claiborne,28,21,Mississippi,MS
28063,28CS008,71,71,72,97,26,25,26,17,1.112048892581268,1.2173030920574586,1.3256357230511742,0.640178984713427,87,87,88,103,16,15,16,20,-0.9205204791131743,-0.7607581218435943,-0.5991335926640055,1.2064849998144367,7012,7012,Claiborne+Jefferson+Warren,Jefferson,28,63,Mississippi,MS
28149,28CS008,431,411,450,581,150,131,170,87,0.9623238704904274,1.399799528613218,1.8178996718624898,0.5747816684872326,524,501,548,653,129,105,152,98,0.19644389410339988,0.814992701843069,1.4186958643037848,0.7564267625688579,45212,45212,Claiborne+Jefferson+Warren,Warren,28,149,Mississippi,MS
28023,28CS009,180,174,187,237,57,50,63,45,0.37239114721674854,0.7536453907315025,1.2032079902629642,0.778269939709976,218,211,226,254,36,28,43,35,-0.5675978207761059,0.05286569854777894,0.6609559017646678,0.9578471308915921,15420,15420,Clarke+Jasper+Wayne,Clarke,28,23,Mississippi,MS
28061,28CS009,166,159,173,209,43,36,50,22,0.8662154241590853,1.27980687773216,1.7164898952420486,0.5024319070849118,202,194,211,317,115,106,123,37,5.07988855821415,5.727407066142904,6.329277322358578,0.3191830769901418,16353,16353,Clarke+Jasper+Wayne,Jasper,28,61,Mississippi,MS
28153,28CS009,189,181,198,224,35,26,43,29,-0.14419624808899414,0.30034581100101054,0.7079561247618766,0.813606627768816,231,220,241,301,70,60,81,39,1.280990311426097,1.8827249277325682,2.439662939215581,0.5467000195001568,20241,20241,Clarke+Jasper+Wayne,Wayne,28,153,Mississippi,MS
28025,28CS010,192,183,200,241,49,41,58,29,0.6030526971689903,1.0554137179875989,1.4618380675396911,0.5775862681875407,234,224,244,287,53,43,63,41,0.17483628348334126,0.7323420241067168,1.3882575701143505,0.7541375450515936,19350,19350,Clay+Oktibbeha,Clay,28,25,Mississippi,MS
28105,28CS010,275,253,296,397,122,101,144,73,0.5545331325287803,0.9881469707810203,1.444130263330383,0.5910953335665743,338,313,364,428,90,64,115,61,0.10456722460101137,0.6851306529756569,1.327035719377622,0.674016253763819,49646,49646,Clay+Oktibbeha,Oktibbeha,28,105,Mississippi,MS
28027,28CS011,237,228,247,333,96,86,105,58,1.3289675114116941,1.7130828900420356,2.143518258321077,0.6002565193078189,291,280,302,389,98,87,109,53,1.8394600918256243,2.467367571721143,3.0808913642972424,0.5367293585284542,21874,21874,Coahoma+Quitman+Tallahatchie+Tunica,Coahoma,28,27,Mississippi,MS
28119,28CS011,79,78,79,123,44,44,45,13,4.523944385989079,4.636874761553512,4.742218864656004,0.28596137104730046,97,96,98,130,33,32,34,19,2.3908909573300594,2.541571943791048,2.700778638896686,0.5527213285680828,6788,6788,Coahoma+Quitman+Tallahatchie+Tunica,Quitman,28,119,Mississippi,MS
28135,28CS011,141,135,146,181,40,35,46,31,0.2999352107865493,0.6891436900358192,1.0791865668190728,0.7472351961620284,173,166,180,192,19,12,26,24,-1.027065576854208,-0.41055221717001406,0.1898821943554841,1.1899644027285885,13838,13838,Coahoma+Quitman+Tallahatchie+Tunica,Tallahatchie,28,135,Mississippi,MS
28143,28CS011,92,91,93,117,25,24,26,15,0.9452750317733414,1.0613440261286133,1.1573104704850945,0.5753332044704437,113,112,115,163,50,48,51,21,3.4650438461251616,3.612658488489427,3.7777335788378226,0.4146084185473042,9514,9514,Coahoma+Quitman+Tallahatchie+Tunica,Tunica,28,143,Mississippi,MS
28029,28CS012,271,259,283,364,93,81,105,42,1.4115101022575873,1.8235151122681634,2.254128184641742,0.4446787882594376,330,315,344,399,69,55,84,46,0.3898521589286743,1.0069544931406818,1.5987315225948302,0.6536787360741247,28030,28030,Copiah+Franklin+Lincoln,Copiah,28,29,Mississippi,MS
28037,28CS012,84,83,85,103,19,18,20,14,0.5793978419037561,0.6910585565608389,0.7929305036652996,0.6894277117563399,103,102,104,141,38,37,39,16,3.322836350266027,3.498488176928217,3.65099813145798,0.4064821843208211,7679,7679,Copiah+Franklin+Lincoln,Franklin,28,37,Mississippi,MS
28085,28CS012,354,339,368,474,120,106,135,74,0.9354356694787586,1.3761567225000888,1.8215156468515514,0.6092123342262789,430,413,448,536,106,88,123,54,1.2126512311987707,1.8006672174727203,2.4239742273266476,0.5060389523645388,34038,34038,Copiah+Franklin+Lincoln,Lincoln,28,85,Mississippi,MS
28031,28CS013,220,212,228,298,78,70,86,50,1.0719922375902273,1.5048322921095858,1.938575557154546,0.633852022799436,267,257,277,302,35,25,45,30,-0.2914758361621848,0.3039582387344794,0.9191131985818164,0.8327776109525689,18544,18544,Covington+Simpson+Smith,Covington,28,31,Mississippi,MS
28127,28CS013,258,247,270,350,92,80,103,58,0.821266125316876,1.2705464440987095,1.6609246245592908,0.6250591494950142,314,300,328,400,86,72,100,58,0.6441652664141339,1.270215801141822,1.8612311140992004,0.6653797608899737,26730,26730,Covington+Simpson+Smith,Simpson,28,127,Mississippi,MS
28129,28CS013,153,147,160,164,11,4,17,16,-0.7476802900021426,-0.32073459964755746,0.10542496894028089,1.3723747790528127,186,178,195,221,35,26,43,32,-0.41551944213528874,0.1965395214853837,0.7832637188394009,0.8991374028232448,15815,15815,Covington+Simpson+Smith,Smith,28,129,Mississippi,MS
28033,28CS014,1261,1180,1342,1497,236,155,317,152,0.02512519888598887,0.4579856690974084,0.8585213091472006,0.6421681043260249,1558,1461,1655,2081,523,426,620,275,0.9709529375538771,1.5900617157597055,2.22964949020037,0.5245921908598704,186589,186589,De Soto,De Soto,28,33,Mississippi,MS
28035,28CS015,658,626,690,780,122,90,154,92,-0.02054882311925871,0.39188552611255245,0.846328078684402,0.7490974240557212,809,770,847,1029,220,182,259,141,0.6888744889988907,1.2661189650910813,1.8773087577101952,0.6367203020628593,75024,75024,Forrest,Forrest,28,35,Mississippi,MS
28039,28CS016,245,235,256,269,24,13,34,37,-0.9585476468440365,-0.5569246573469611,-0.15367752368442647,1.5090605510619628,299,287,312,382,83,70,95,42,1.3922710921916372,2.0082598185189218,2.6058344927962436,0.5019464223164912,24431,24431,George+Greene+Perry+Stone,George,28,39,Mississippi,MS
28041,28CS016,118,117,120,141,23,21,24,22,-0.04014820278712098,0.06446229138992055,0.16394389843155505,0.921199570728391,145,143,147,143,-2,-4,-0,17,-1.8321100958932364,-1.6666931602500439,-1.5039723089797634,-20.62747243199517,13531,13531,George+Greene+Perry+Stone,Greene,28,41,Mississippi,MS
28111,28CS016,130,125,135,177,47,42,52,25,1.421769155052174,1.8375053205553242,2.253296678755675,0.5225583750451376,158,152,164,195,37,31,43,26,0.4717949019776452,1.0703879710247122,1.6801053764134757,0.6905490503543054,11941,11941,George+Greene+Perry+Stone,Perry,28,111,Mississippi,MS
28131,28CS016,168,160,176,217,49,41,57,14,1.497449467866635,1.9282880460628555,2.3826783508898335,0.2782479304472209,205,195,214,282,77,68,87,47,1.3347005836267332,1.9873215488055418,2.604846879706918,0.6015264218400174,18319,18319,George+Greene+Perry+Stone,Stone,28,131,Mississippi,MS
28045,28CS017,444,423,464,522,78,58,99,54,0.06067969200853666,0.5167182187337318,0.9483930772441072,0.681299061003313,543,519,568,654,111,86,135,78,0.1826472963168824,0.8254826569609224,1.40486106970437,0.6986204602631375,47809,47809,Hancock+Harrison,Hancock,28,45,Mississippi,MS
28047,28CS017,1808,1718,1898,2084,276,186,366,145,0.19704587518547192,0.626104914591206,1.0610244202388648,0.5239249393342368,2217,2109,2324,2850,633,526,741,348,1.0226935500507432,1.637293370871596,2.2671385459302664,0.5485830647953248,208252,208252,Hancock+Harrison,Harrison,28,47,Mississippi,MS
28049,28CS018,1826,1728,1924,2460,634,536,732,268,1.2060917250670056,1.5930403321317066,2.037740379161961,0.4220486321003622,2245,2128,2363,2873,628,510,745,329,0.8972604935521955,1.5586957630984304,2.1544851312593747,0.5234311737805707,230272,230272,Hinds,Hinds,28,49,Mississippi,MS
28057,28CS019,253,243,263,301,48,38,58,43,-0.21663315556000642,0.19671254922635312,0.6286674919150101,0.881500131496107,310,298,322,357,47,35,59,56,-1.0893636698506814,-0.48273686396920734,0.18548859336353718,1.1684436839041963,23314,23314,Itawamba+Monroe,Itawamba,28,57,Mississippi,MS
28095,28CS019,378,363,393,495,117,102,132,76,0.733816762513607,1.1530137690857627,1.5779615508331537,0.6438614758635958,463,445,481,550,87,69,105,84,-0.49255296450283365,0.12668418223027067,0.7176603473323804,0.9534319675085426,35221,35221,Itawamba+Monroe,Monroe,28,95,Mississippi,MS
28059,28CS020,1220,1158,1282,1424,204,142,266,142,-0.025324017886626554,0.42884991569409187,0.8143048661110669,0.692911065192408,1501,1427,1575,1820,319,245,393,207,0.32010159885502293,0.9488662665516403,1.545621543217039,0.6469536926977938,143560,143560,Jackson,Jackson,28,59,Mississippi,MS
28065,28CS021,139,134,144,145,6,1,11,21,-1.813342484313137,-1.3733023864847114,-0.9633723465310461,3.037431059585944,169,164,175,197,28,22,33,17,0.5529553177896422,1.1670359694018628,1.7677369614940561,0.5939928301602514,11006,11006,Jefferson Davis+Lawrence+Marion,Jefferson Davis,28,65,Mississippi,MS
28077,28CS021,147,142,153,176,29,23,34,17,0.547567204843011,0.9474233608130711,1.355113594778708,0.5697447056749588,180,173,186,202,22,16,29,27,-1.1147789408559865,-0.44138233212211064,0.1980710086092372,1.1526744299526581,12554,12554,Jefferson Davis+Lawrence+Marion,Lawrence,28,77,Mississippi,MS
28091,28CS021,275,265,286,397,122,111,132,66,1.8494635102874117,2.2776025914013256,2.7256127540746196,0.5373306122668833,336,324,349,407,71,58,83,39,0.9629137922275616,1.5471642155327126,2.1193979373159144,0.5437096984065882,24478,24478,Jefferson Davis+Lawrence+Marion,Marion,28,91,Mississippi,MS
28067,28CS022,665,636,695,763,98,68,127,86,-0.2548870067985883,0.17177650354284946,0.5988311010924424,0.8729885647985889,813,778,848,1047,234,199,269,138,1.0861426115290342,1.6928042585100336,2.283423511504038,0.5881448754010822,68162,68162,Jones,Jones,28,67,Mississippi,MS
28069,28CS023,88,87,89,106,18,17,19,20,-0.35281631523985396,-0.24766647218917248,-0.14322412240578752,1.0772802598209072,109,107,110,133,24,23,26,19,0.520690522442889,0.6720244841898642,0.8308229935768523,0.7472285999780178,9672,9672,Kemper+Neshoba+Noxubee+Winston,Kemper,28,69,Mississippi,MS
28099,28CS023,336,324,349,497,161,148,173,121,0.9500936306738405,1.3829288211000867,1.7787047100587918,0.7470934394395033,410,395,425,470,60,45,75,65,-0.8607687142031271,-0.19559206503311924,0.40473438876083423,1.0614197101927363,29084,29084,Kemper+Neshoba+Noxubee+Winston,Neshoba,28,99,Mississippi,MS
28103,28CS023,104,103,105,143,39,38,40,18,1.9059210981456869,2.02255274316568,2.1240219502481374,0.4512971493991741,128,126,129,149,21,20,23,19,0.1058024653416936,0.2626218163383299,0.4239542041477361,0.8525978027692873,10346,10346,Kemper+Neshoba+Noxubee+Winston,Noxubee,28,103,Mississippi,MS
28159,28CS023,193,186,201,258,65,57,72,49,0.42388283432415946,0.8663160039363965,1.3134642506828027,0.744608177094715,236,227,245,298,62,53,71,39,0.9592908831303957,1.5639483841558948,2.144575893026061,0.6169691047449528,17931,17931,Kemper+Neshoba+Noxubee+Winston,Winston,28,159,Mississippi,MS
28071,28CS024,333,310,356,409,76,53,99,56,-0.03882954939662313,0.36662536913827276,0.8009742951873549,0.727630301116452,411,383,439,523,112,84,140,46,0.8688782940068723,1.4823955130464366,2.121963272730606,0.40590765571632426,54309,54309,Lafayette+Yalobusha,Lafayette,28,71,Mississippi,MS
28161,28CS024,160,155,165,212,52,47,57,25,1.8457798393842446,2.250245839624165,2.674720742985141,0.47070203628749474,194,188,200,196,2,-4,8,16,-2.0534059568536285,-1.4084109123925521,-0.7572622904915104,5.52681342253798,12053,12053,Lafayette+Yalobusha,Yalobusha,28,161,Mississippi,MS
28073,28CS025,385,357,413,484,99,71,127,53,0.28227799965516154,0.7110492654808441,1.1458000049955457,0.5299732804457604,474,441,507,577,103,70,136,86,-0.28199539445364646,0.3225117266701231,0.9610287066145019,0.8280613048797328,63746,63746,Lamar,Lamar,28,73,Mississippi,MS
28075,28CS026,712,680,744,1032,320,288,352,151,1.8596661925626734,2.2869454376768847,2.7217484705222805,0.47027106883991776,870,832,908,1068,198,160,236,140,0.3304037884464421,0.9370387648135793,1.5350128463802402,0.7039245720872375,74257,74257,Lauderdale+Newton,Lauderdale,28,75,Mississippi,MS
28101,28CS026,220,211,229,276,56,47,65,39,0.3652400350588324,0.8037368837145095,1.2214850521814373,0.6881979952323638,269,258,280,324,55,44,66,45,-0.012370212341118195,0.5833591867091807,1.1591528263781103,0.8033634785557564,20937,20937,Lauderdale+Newton,Newton,28,101,Mississippi,MS
28081,28CS027,780,743,817,969,189,152,226,116,0.4367888542853574,0.8556891994497118,1.3050940186906987,0.6103626422077926,954,910,998,1167,213,169,257,141,0.4089935457577283,0.9892184000419562,1.5955281225201237,0.6592967211742,85587,85587,Lee,Lee,28,81,Mississippi,MS
28087,28CS028,547,522,572,694,147,122,172,88,0.5653212280612783,1.0072667352388123,1.4726170997761803,0.5945784133569113,672,642,702,747,75,45,105,87,-0.8298420612454238,-0.251957346637353,0.3811895761037602,1.1442589328746782,58491,58491,Lowndes,Lowndes,28,87,Mississippi,MS
28089,28CS029,882,836,928,1018,136,90,182,121,-0.27517816160256553,0.13783052178623945,0.5580798794545485,0.8847993803346497,1084,1029,1139,1174,90,35,145,131,-1.0867523638925505,-0.49929289832410967,0.11971234857137239,1.440525975012564,106558,106558,Madison,Madison,28,89,Mississippi,MS
28107,28CS030,334,319,349,403,69,54,84,67,-0.3467498016161609,0.05319455575080044,0.4854819135283299,0.9576175156954202,408,390,425,499,91,74,109,61,0.4696131212960886,1.0674062458880245,1.7034134102073344,0.6618837133890952,33996,33996,Panola+Tate,Panola,28,107,Mississippi,MS
28137,28CS030,257,245,269,377,120,108,132,55,1.850682809996481,2.2991384034408218,2.737545288870378,0.4537293839786607,314,300,329,413,99,84,113,62,0.916988732592782,1.5400880776724888,2.1347588203601067,0.6229380154187185,28402,28402,Panola+Tate,Tate,28,137,Mississippi,MS
28109,28CS031,589,565,613,712,123,99,147,84,0.25651012741582746,0.6961547604282086,1.151518381964606,0.6793968833994745,722,693,751,932,210,181,239,154,0.5992941934108881,1.2076634619849465,1.820148802252171,0.7288926452871289,55804,55804,Pearl River,Pearl River,28,109,Mississippi,MS
28113,28CS032,436,419,453,543,107,90,124,59,0.829932058568616,1.2178226137012838,1.644098438952975,0.5464793233870648,531,511,551,639,108,88,128,78,0.253390161147745,0.9006239834245116,1.6224914509169805,0.7175438973785366,39164,39164,Pike+Walthall,Pike,28,113,Mississippi,MS
28147,28CS032,158,152,164,200,42,36,48,33,0.2206927463593473,0.6451226738039071,1.0538827053831836,0.7628596920015994,192,185,200,229,37,29,44,30,-0.03394139306352792,0.5712501418595594,1.1986978529608892,0.7965334641278503,14307,14307,Pike+Walthall,Walthall,28,147,Mississippi,MS
28115,28CS033,266,252,280,386,120,106,134,38,2.1064421624493237,2.5518553529234564,2.9912212124941453,0.31293080044619376,326,309,343,458,132,115,149,63,1.9512737263964448,2.5513756459110155,3.1863191901110817,0.47376928144495434,32355,32355,Pontotoc+Union,Pontotoc,28,115,Mississippi,MS
28145,28CS033,269,256,281,294,25,13,38,40,-0.9495382051834232,-0.5050785760562816,-0.05564978664844751,1.5188838832540934,329,314,344,379,50,35,65,46,-0.42749053486428024,0.15611455525095583,0.8207122145342052,0.9009021871692515,28776,28776,Pontotoc+Union,Union,28,145,Mississippi,MS
28121,28CS034,1047,980,1114,1391,344,277,411,140,0.891210801223783,1.3220965743417674,1.7353957957289468,0.40546272092291474,1296,1215,1376,1608,312,232,393,209,0.17324899463730836,0.8007576891091746,1.3836224273199502,0.6674970682738672,155606,155606,Rankin+Scott,Rankin,28,121,Mississippi,MS
28123,28CS034,258,246,270,302,44,32,56,43,-0.3630717037265674,0.030564576616587173,0.46563192831212813,0.9531754743461055,316,302,331,398,82,67,96,51,0.6700405694745578,1.317199682597007,1.8894177634580096,0.617570552491091,28144,28144,Rankin+Scott,Scott,28,123,Mississippi,MS
28151,28CS035,476,458,495,687,211,192,229,97,2.196783048270163,2.608486939977197,3.057558890927902,0.4581011833620056,583,561,605,713,130,108,152,45,1.6981434460088407,2.311014339194747,2.956450517193685,0.34427391424696774,43500,43500,Washington,Washington,28,151,Mississippi,MS
28051,28CS036,178,171,185,260,82,75,89,62,0.7729503711321428,1.1725866472750657,1.5976772337784133,0.7476001215466396,217,209,226,299,82,73,90,27,3.2746614441983963,3.876726157338814,4.50813727701761,0.32710311374786333,16907,16907,Yazoo and Nearby Counties,Holmes,28,51,Mississippi,MS
28053,28CS036,84,83,85,117,33,32,34,25,0.8709088593141712,0.9852604085821655,1.0815137571242288,0.7388736222630066,104,103,105,143,39,38,40,14,3.6095086444862283,3.7673989503694436,3.9090927165634772,0.3501372626710568,7961,7961,Yazoo and Nearby Counties,Humphreys,28,53,Mississippi,MS
28055,28CS036,13,13,13,13,0,0,0,1,-0.7240474490055636,-0.6149779527396146,-0.5107880100483422,0.828501267810741,16,16,16,13,-3,-3,-3,1,-3.728580562200446,-3.57481392886592,-3.435865409486217,-0.5479647540865562,1281,1281,Yazoo and Nearby Counties,Issaquena,28,55,Mississippi,MS
28125,28CS036,51,51,52,75,24,23,24,14,2.1959805607105523,2.3076803717955547,2.4116998211707132,0.5646945780169336,63,63,64,76,13,12,13,7,1.5002865173141693,1.6436810482461328,1.8118744889559837,0.5058826421071366,4249,4249,Yazoo and Nearby Counties,Sharkey,28,125,Mississippi,MS
28163,28CS036,247,236,259,307,60,48,71,38,0.3545876899408519,0.7577397335640724,1.19725931018434,0.625194508357178,301,287,315,360,59,45,73,33,0.5405236671960469,1.086936442042603,1.6746680704939938,0.5478713511529818,28566,28566,Yazoo and Nearby Counties,Yazoo,28,163,Mississippi,MS
29003,29CS001,155,147,163,175,20,12,28,18,-0.2988060765875248,0.10652279897700241,0.5042860674939069,0.8577774054673211,190,181,199,191,1,-8,10,16,-1.6770113264047022,-1.0097692114745938,-0.40047139761981393,7.608962656671566,17652,17652,Andrew+Atchison+Holt+Nodaway,Andrew,29,3,Missouri,MO
29005,29CS001,63,62,63,87,24,24,25,11,2.5375127084346536,2.640191263049549,2.744878874855437,0.4317160252669139,77,76,77,95,18,18,19,3,3.4836524449543727,3.639820678797956,3.7963618718770586,0.1539115885898678,5104,5104,Andrew+Atchison+Holt+Nodaway,Atchison,29,5,Missouri,MO
29087,29CS001,48,47,48,64,16,16,17,18,-0.49668368965499254,-0.39591448182672373,-0.291621543998187,1.0404746344899154,58,58,59,83,25,24,25,5,5.287293691307949,5.44098086455474,5.590206536969111,0.19539913352476038,4322,4322,Andrew+Atchison+Holt+Nodaway,Holt,29,87,Missouri,MO
29147,29CS001,166,156,175,156,-10,-19,-0,20,-1.7760602724575771,-1.3665282493113593,-0.9194547287552315,-2.3148300594675275,203,192,215,168,-35,-47,-24,15,-3.3750255323374083,-2.7504671663227747,-2.1198048166436925,-0.4358128135551357,21945,21945,Andrew+Atchison+Holt+Nodaway,Nodaway,29,147,Missouri,MO
29007,29CS002,257,246,268,325,68,57,79,42,0.621285445916801,1.0353407615546184,1.4455069101624172,0.6102339640661288,315,302,328,330,15,2,28,38,-1.720993405939716,-1.1078327091149378,-0.4930043217044871,2.396835974551651,24909,24909,Audrain+Callaway,Audrain,29,7,Missouri,MO
29027,29CS002,356,337,376,452,96,76,115,38,0.8603897347505306,1.270994255640002,1.7325582099954893,0.393633813301346,440,417,463,501,61,38,84,57,-0.5351499233343526,0.13279690285495316,0.7286958713310949,0.9181172271354846,44814,44814,Audrain+Callaway,Callaway,29,27,Missouri,MO
29009,29CS003,374,359,389,437,63,48,78,52,-0.13990446835879233,0.32022532238704926,0.73714122102234,0.8135675772577103,458,440,477,501,43,24,61,51,-0.8912990045724548,-0.2654491869842978,0.33448401552649537,1.1637903603740243,35801,35801,Barry+Lawrence+McDonald,Barry,29,9,Missouri,MO
29109,29CS003,413,397,430,453,40,23,56,56,-0.8418178889833212,-0.4282045335694758,0.009766245677452668,1.3714357683311684,506,486,525,578,72,53,92,59,-0.253745104682315,0.41769322679287463,1.0279104434231046,0.8030462440534206,38241,38241,Barry+Lawrence+McDonald,Lawrence,29,109,Missouri,MO
29119,29CS003,207,197,217,260,53,43,63,29,0.6173998321674894,1.0530794807891872,1.5004392255429087,0.5360335290172175,254,242,266,304,50,38,62,39,-0.05787626056920719,0.5702932649596334,1.1992922891908997,0.7673978112587575,22907,22907,Barry+Lawrence+McDonald,McDonald,29,119,Missouri,MO
29015,29CS004,264,255,272,308,44,36,53,24,0.6221118234490419,1.0340362470546172,1.4735731675919121,0.5312616812968843,320,309,330,365,45,35,56,42,-0.4700752667713151,0.21985443288154083,0.8298260220224188,0.903906879229228,19540,19540,Benton+Henry+St. Clair,Benton,29,15,Missouri,MO
29083,29CS004,255,245,264,301,46,37,56,33,0.16942392076072874,0.6293415410124493,1.0493783457158588,0.6976543170322237,309,297,320,340,31,20,43,34,-0.811385254431443,-0.15606641656398365,0.4804702372894563,1.0573556777936062,22015,22015,Benton+Henry+St. Clair,Henry,29,83,Missouri,MO
29185,29CS004,120,119,121,140,20,19,21,16,0.28236094481100943,0.37861308553064965,0.4852868971740067,0.7756882365458246,147,146,148,152,5,4,6,12,-1.0481857129570256,-0.8860232194625707,-0.7354709133981937,2.020730187583561,9550,9550,Benton+Henry+St. Clair,St. Clair,29,185,Missouri,MO
29017,29CS005,128,123,133,166,38,33,43,15,1.4574298935798629,1.8664903979834593,2.276719953333496,0.38743248299884137,156,150,162,160,4,-2,10,15,-1.6798242636473584,-1.0579561719403185,-0.47652717997841815,2.8733205210184716,12129,12129,Bollinger+Madison+Stoddard+Wayne,Bollinger,29,17,Missouri,MO
29123,29CS005,148,143,153,174,26,21,31,22,-0.06234927965705639,0.35321968782812213,0.7734935310470953,0.8096509466577951,179,173,186,215,36,29,42,26,0.37147233716202027,0.9853668709488294,1.5868203829217742,0.7076805105877689,12116,12116,Bollinger+Madison+Stoddard+Wayne,Madison,29,123,Missouri,MO
29207,29CS005,329,316,341,380,51,39,64,49,-0.35018329689545213,0.07336578793886832,0.5131394542882903,0.9388571191866809,399,384,414,447,48,33,63,65,-1.2631560942409747,-0.7185780116583846,-0.06169873720317555,1.3250548317442856,29056,29056,Bollinger+Madison+Stoddard+Wayne,Stoddard,29,207,Missouri,MO
29223,29CS005,159,154,165,188,29,23,34,21,0.21909615483717662,0.6145361126097569,1.047284234539822,0.7016788327781444,193,186,199,242,49,43,56,17,2.359176522503373,3.018351182764529,3.6458152194742626,0.3379020569954432,12848,12848,Bollinger+Madison+Stoddard+Wayne,Wayne,29,223,Missouri,MO
29019,29CS006,996,917,1075,1164,168,89,247,83,0.04295642838254143,0.48344526174260966,0.882044244675523,0.4915630929525796,1241,1147,1336,1365,124,29,218,94,-0.39644913454370917,0.20889023358674402,0.800956922070894,0.7522607141664494,181879,181879,Boone,Boone,29,19,Missouri,MO
29021,29CS007,782,744,819,954,172,135,210,105,0.3212365062254501,0.7737500041523003,1.2246095465676414,0.6059831396462784,957,912,1002,1116,159,114,204,89,0.3465277494792314,0.9776062221813446,1.5888914756410342,0.5566582460621725,86928,86928,Buchanan,Buchanan,29,21,Missouri,MO
29023,29CS008,485,466,503,575,90,72,109,53,0.43897094583643076,0.8873125176297288,1.2739626776278166,0.5800684460868211,591,569,613,704,113,91,135,76,0.42781645754955816,1.0665783898108487,1.6424488981112233,0.6682760839343753,42409,42409,Butler+Carter+Ripley,Butler,29,23,Missouri,MO
29035,29CS008,70,70,71,79,9,8,9,2,1.034186258570719,1.137912050698778,1.248159923882609,0.20381245596058523,86,85,87,102,16,15,17,13,0.41714937263994123,0.5735358352159843,0.7381370592345476,0.7703588027139312,5985,5985,Butler+Carter+Ripley,Carter,29,35,Missouri,MO
29181,29CS008,161,155,167,185,24,18,30,18,0.02971651041625453,0.4460157093433108,0.8642271372377912,0.7178984910493713,196,189,203,236,40,33,47,38,-0.4578402435850621,0.15281926210205193,0.7878639253801613,0.9329596404667604,13325,13325,Butler+Carter+Ripley,Ripley,29,181,Missouri,MO
29029,29CS009,430,410,450,549,119,99,139,73,0.5357764758530489,0.9970371227006682,1.4079404333723227,0.6095984225465425,526,502,550,663,137,113,161,74,1.0150065184238068,1.6472006390358342,2.288539431229399,0.5346734073264516,46296,46296,Camden+Miller+Moniteau+Morgan,Camden,29,29,Missouri,MO
29131,29CS009,249,238,260,298,49,38,60,38,0.014446153535834881,0.4215807120050829,0.8681486727466468,0.7578590289769014,304,291,317,364,60,47,73,36,0.5168538534818626,1.1128269317760002,1.7223264634496205,0.5889313806468145,25684,25684,Camden+Miller+Moniteau+Morgan,Miller,29,131,Missouri,MO
29135,29CS009,138,131,145,165,27,20,34,21,-0.05771494565408332,0.39086727186629017,0.8205324672028443,0.7455763495399056,168,160,176,172,4,-4,12,14,-1.3829363340567633,-0.7977408245991142,-0.2106959219715232,2.946706796083214,15720,15720,Camden+Miller+Moniteau+Morgan,Moniteau,29,135,Missouri,MO
29141,29CS009,254,245,262,305,51,43,60,31,0.5571493454719405,0.9919473837343832,1.4326671155578279,0.5910051101999508,308,298,319,324,16,5,26,36,-1.8209286810877825,-1.1629159534351312,-0.517509042141335,2.1577150757017685,20718,20718,Camden+Miller+Moniteau+Morgan,Morgan,29,141,Missouri,MO
29031,29CS010,693,659,727,943,250,216,284,113,1.2944850386122668,1.7383442587723834,2.1430826149790443,0.4507556528796484,850,809,891,920,70,29,111,70,-0.6413680670868029,0.009316289540958884,0.5748997151804963,0.9821307144946975,79196,79196,Cape Girardeau+Perry,Cape Girardeau,29,31,Missouri,MO
29157,29CS010,176,168,184,213,37,29,45,22,0.36763609319191953,0.7739383401893161,1.2142596023204903,0.5806599725173415,216,206,225,223,7,-2,17,11,-0.8671254307521405,-0.2234288507853993,0.415848487303275,1.2989588424495808,19176,19176,Cape Girardeau+Perry,Perry,29,157,Missouri,MO
29033,29CS011,93,92,94,123,30,29,31,30,-0.15059469189194769,-0.043734121143302405,0.06736501941572233,0.979495555823565,114,113,116,109,-5,-7,-4,10,-2.2855662063549733,-2.1419520941727863,-1.986564480987621,-2.254962384114944,8638,8638,Carroll+Lafayette+Ray,Carroll,29,33,Missouri,MO
29107,29CS011,339,325,353,383,44,30,58,42,-0.36186990371171845,0.05778398163795277,0.4978320888787205,0.9372305773855768,414,397,431,469,55,38,72,40,-0.0767054761887256,0.5233297051122664,1.117018616239876,0.7179864001430122,32871,32871,Carroll+Lafayette+Ray,Lafayette,29,107,Missouri,MO
29177,29CS011,224,214,233,284,60,51,70,23,1.182712409738081,1.6289477096595948,2.0478769232360845,0.3746538051525129,273,261,285,353,80,68,92,53,0.8062069118301978,1.4103014118992474,2.0440905922586565,0.6551060255740624,22979,22979,Carroll+Lafayette+Ray,Ray,29,177,Missouri,MO
29037,29CS012,857,811,903,956,99,53,145,69,-0.16528490560599413,0.29646560860025484,0.7207929648773997,0.6884226017537971,1056,1001,1111,1244,188,133,243,151,-0.16322595889623492,0.41117414727187107,1.0339189677254985,0.7983934033232002,106179,106179,Cass,Cass,29,37,Missouri,MO
29043,29CS013,610,571,649,708,98,59,137,82,-0.24142451845469218,0.16835398799189574,0.623701168587771,0.8257091270957838,753,707,800,950,197,150,243,135,0.18675737985338506,0.8075652855619047,1.4465303254538846,0.6834061667969898,89639,89639,Christian,Christian,29,43,Missouri,MO
29047,29CS014,1606,1497,1715,1878,272,163,381,209,-0.2009949313522875,0.23939604007009493,0.6849201586894763,0.765756411871811,1984,1853,2115,2206,222,91,353,265,-0.8362529163336845,-0.20201446035296944,0.4129699150946879,1.1873152996317056,251747,251747,Clay,Clay,29,47,Missouri,MO
29051,29CS015,573,540,606,751,178,145,211,125,0.26873324824235245,0.6972191111234487,1.1079818228908471,0.6993131713210371,706,667,746,772,66,26,105,88,-0.9461550926462591,-0.35311630192697885,0.2721255054121484,1.3177876728119584,76531,76531,Cole,Cole,29,51,Missouri,MO
29055,29CS016,260,250,270,306,46,36,56,27,0.35074863060009887,0.7959436127718879,1.2302217529081934,0.5759828291255968,318,305,330,377,59,47,72,55,-0.3681400701822144,0.19786011128178557,0.8434785191488954,0.9112961643603313,23807,23807,Crawford+Iron+Reynolds+Washington,Crawford,29,55,Missouri,MO
29093,29CS016,136,132,141,155,19,14,23,12,0.20765141160119388,0.6542934520793171,1.0800884862531328,0.6147161214628667,166,161,171,189,23,18,28,19,-0.1530684301115845,0.4750706558849557,1.1069590564580836,0.7948051324392882,10130,10130,Crawford+Iron+Reynolds+Washington,Iron,29,93,Missouri,MO
29179,29CS016,74,73,74,79,5,5,6,6,-0.21127929207867374,-0.11574544246497226,-0.00732376296123537,0.9538925994698548,90,90,91,111,21,20,21,13,1.2999942032656056,1.448093107125465,1.6086016476909686,0.6034595071670198,6250,6250,Crawford+Iron+Reynolds+Washington,Reynolds,29,179,Missouri,MO
29221,29CS016,249,239,260,322,73,62,83,44,0.7774340042279888,1.1828558506488747,1.579077934482759,0.5964040646807528,305,292,317,400,95,83,108,55,1.3649195207381444,1.9458962542326448,2.5698378671981192,0.5714850838221026,24685,24685,Crawford+Iron+Reynolds+Washington,Washington,29,221,Missouri,MO
29059,29CS017,185,178,193,265,80,72,87,27,2.659746458457215,3.082660479760311,3.527201315540409,0.3345002008276825,226,217,235,301,75,66,84,31,2.4456662990385474,3.0759778568916074,3.678856549442511,0.40890267989446366,17082,17082,Dallas+Hickory+Polk,Dallas,29,59,Missouri,MO
29085,29CS017,146,142,151,149,3,-2,7,27,-2.998736939568593,-2.5714491743730687,-2.1136948039112875,7.512486975926888,178,173,183,197,19,14,24,12,0.25333845335756,0.9155096552247366,1.5331984835169803,0.5948026507426892,9534,9534,Dallas+Hickory+Polk,Hickory,29,85,Missouri,MO
29167,29CS017,316,302,330,364,48,34,62,41,-0.19244525213578256,0.22215051447134498,0.6602046005016239,0.833998063841574,386,369,403,429,43,26,60,44,-0.6267963819510268,-0.02116987053175812,0.5687342077418445,1.0009384149054554,32337,32337,Dallas+Hickory+Polk,Polk,29,167,Missouri,MO
29025,29CS018,87,86,88,92,5,4,6,5,-0.10608234676555027,0.0019149204810725918,0.11337832167818748,0.8342755100978054,107,105,108,136,29,28,31,17,1.5023939441677228,1.6553484014119826,1.8108034412775773,0.5577523056511355,9044,9044,DeKalb and Nearby Counties,Caldwell,29,25,Missouri,MO
29049,29CS018,214,205,223,270,56,47,65,43,0.2118982068978415,0.6175618377483023,1.07120897898819,0.7582997407194325,262,252,273,245,-17,-28,-7,26,-3.1203986735568674,-2.546034570547713,-1.8700892150166697,-1.609766584591449,20484,20484,DeKalb and Nearby Counties,Clinton,29,49,Missouri,MO
29061,29CS018,77,76,78,99,22,21,23,14,0.8998275358950608,1.010709530638659,1.120747992039229,0.599307119564977,94,93,95,106,12,11,13,11,0.01539331806694978,0.1682101110434274,0.32431175703489357,0.8366360270320312,8277,8277,DeKalb and Nearby Counties,Daviess,29,61,Missouri,MO
29063,29CS018,94,93,95,139,45,44,46,22,2.0209230692679414,2.1274919022824115,2.2252201758140138,0.47717924122460287,115,114,116,130,15,14,16,12,0.18205006131938767,0.32598713163688564,0.4997917370074368,0.7518230526649393,10861,10861,DeKalb and Nearby Counties,DeKalb,29,63,Missouri,MO
29075,29CS018,75,74,76,92,17,16,18,13,0.5246845452314586,0.6243543302159866,0.7364886081436706,0.7186928685029766,92,91,92,105,13,13,14,2,1.9336075228878784,2.087665506373771,2.2516776614130465,0.1390484327266935,6531,6531,DeKalb and Nearby Counties,Gentry,29,75,Missouri,MO
29081,29CS018,94,93,95,105,11,10,12,15,-0.5948992653036156,-0.49195624756404194,-0.3856058571393075,1.2600928735083388,115,114,116,111,-4,-5,-3,2,-1.026299142412547,-0.8763979700269632,-0.7219594234787713,-0.6474125568601963,8336,8336,DeKalb and Nearby Counties,Harrison,29,81,Missouri,MO
29227,29CS018,26,25,26,25,-1,-1,-0,6,-3.4053477958279204,-3.296552628444282,-3.1904821814045348,12.180071697463532,31,31,31,32,1,1,1,5,-2.699213583784161,-2.5375052630840176,-2.393088254604739,2.7416829625286,1974,1974,DeKalb and Nearby Counties,Worth,29,227,Missouri,MO
29065,29CS019,169,163,176,232,63,56,69,28,1.779585890988386,2.221317817037973,2.6616660522430218,0.4405745112070535,206,198,214,266,60,52,68,45,0.5163488172528795,1.1245152188937089,1.7108339059021282,0.7431245790704812,15520,15520,Dent+Phelps,Dent,29,65,Missouri,MO
29161,29CS019,395,376,414,509,114,95,133,73,0.4791858541257785,0.9217668915986457,1.3365712932468314,0.6364428171231025,483,460,506,599,116,93,139,80,0.3309059412409186,0.9358767754847239,1.6090914366721514,0.6856986727948082,44518,44518,Dent+Phelps,Phelps,29,161,Missouri,MO
29067,29CS020,168,163,174,177,9,3,14,24,-1.5774971552409969,-1.1480089867823888,-0.7092664776906275,2.473841642280861,207,200,214,228,21,14,28,40,-2.3242054902357245,-1.7414755131994344,-1.056529059428116,1.806233257609953,13288,13288,Douglas+Ozark+Texas+Wright,Douglas,29,67,Missouri,MO
29153,29CS020,107,106,108,140,33,32,34,11,2.313997724930174,2.4175887807865544,2.522418135577128,0.3231269875972526,131,130,133,188,57,55,58,39,2.160582987171488,2.3135147103202756,2.469437353517804,0.6771334004025465,9125,9125,Douglas+Ozark+Texas+Wright,Ozark,29,153,Missouri,MO
29215,29CS020,271,260,282,346,75,64,86,19,1.7700180267837367,2.2209046824300067,2.6644424625725933,0.25021669892573095,334,321,347,441,107,94,120,47,2.2717446971045674,2.852507495350438,3.4713553156647166,0.43503466736938406,25270,25270,Douglas+Ozark+Texas+Wright,Texas,29,215,Missouri,MO
29229,29CS020,221,213,229,204,-17,-25,-9,27,-2.8002764124484156,-2.381968703207237,-1.9624429859703965,-1.693166543353484,272,262,281,290,18,9,28,43,-2.1751990469600955,-1.6164742463861652,-0.9825183873578236,2.2262913829811444,18327,18327,Douglas+Ozark+Texas+Wright,Wright,29,229,Missouri,MO
29069,29CS021,363,350,375,455,92,80,105,55,0.877096479035181,1.2947718765859397,1.6933121385612375,0.5893975385029989,443,428,458,518,75,60,90,47,0.562070755978495,1.1467947937387117,1.7388568691798623,0.6162806618062079,29050,29050,Dunklin+Pemiscot,Dunklin,29,69,Missouri,MO
29155,29CS021,189,182,196,261,72,65,79,32,2.140000561506512,2.5374553771918325,2.942274938298592,0.4393439780597962,231,223,239,292,61,53,69,27,2.007965764703815,2.584435027159084,3.185442177052021,0.43502344738942217,15754,15754,Dunklin+Pemiscot,Pemiscot,29,155,Missouri,MO
29071,29CS022,915,870,960,1087,172,127,217,134,-0.048478208864031654,0.36393768322014997,0.7889094816160778,0.774970612321738,1125,1071,1179,1325,200,146,254,144,0.04371522463490943,0.6523098465367514,1.2777677437078572,0.7152637133236672,104114,104114,Franklin,Franklin,29,71,Missouri,MO
29073,29CS023,180,174,187,240,60,53,66,37,1.0885449864713586,1.5396605222094852,1.9817642057110554,0.6103503506520139,220,212,227,247,27,20,35,42,-1.8144313549713282,-1.196771309899855,-0.561607024750143,1.4846992702275223,14627,14627,Gasconade+Montgomery+Warren,Gasconade,29,73,Missouri,MO
29139,29CS023,150,146,155,162,12,7,16,15,-0.7188822312727646,-0.29919977458406694,0.1253850049839369,1.191862555431199,183,177,189,185,2,-4,8,17,-2.1708929471206684,-1.5722055194014928,-0.9139267799362114,5.456412979995884,11398,11398,Gasconade+Montgomery+Warren,Montgomery,29,139,Missouri,MO
29219,29CS023,277,261,292,315,38,23,54,18,0.14735653398090204,0.5544793659118924,0.9805241637238756,0.4578908830951221,341,322,360,461,120,101,139,65,1.2335956580694492,1.790750195633023,2.4368075938948164,0.5381975778099559,36082,36082,Gasconade+Montgomery+Warren,Warren,29,219,Missouri,MO
29077,29CS024,2523,2396,2650,2927,404,277,531,359,-0.2980901112054494,0.16157358493201632,0.6032220671676515,0.8871057076405238,3096,2944,3248,3554,458,306,610,388,-0.3809310388793296,0.2766427786038178,0.9180323367390646,0.8453156270934101,294123,294123,Greene,Greene,29,77,Missouri,MO
29079,29CS025,107,106,108,137,30,29,31,31,-0.2410564736196537,-0.13412109112914375,-0.030855101565692232,1.0097578046281923,131,130,133,152,21,19,22,26,-0.8061708951480218,-0.6642246365616552,-0.5087245927537489,1.2026979961082656,9703,9703,Grundy and Nearby Counties,Grundy,29,79,Missouri,MO
29115,29CS025,144,139,150,162,18,12,23,14,-0.1266495661827849,0.3072848689129778,0.734379933888816,0.7563559991264023,175,169,181,186,11,5,17,38,-3.3536895693273414,-2.7390334511198264,-2.123974928316994,3.1676243901937107,11874,11874,Grundy and Nearby Counties,Linn,29,115,Missouri,MO
29117,29CS025,154,148,160,169,15,9,21,30,-1.4050468788278312,-1.0094441287631044,-0.6133283057148213,1.852777324039438,186,179,193,220,34,27,41,40,-1.1270222679634012,-0.4789268683338442,0.15272297666550344,1.1439920772666725,14745,14745,Grundy and Nearby Counties,Livingston,29,117,Missouri,MO
29129,29CS025,38,37,38,59,21,21,22,10,3.007314915085924,3.1226983013084495,3.2215969898902737,0.4503018166323132,46,46,47,52,6,5,6,5,0.06614542970589836,0.23698701466415553,0.3958523070517054,0.7452324464371507,3594,3594,Grundy and Nearby Counties,Mercer,29,129,Missouri,MO
29171,29CS025,59,59,60,59,-0,-1,0,5,-1.2317777287246583,-1.1273595835048171,-1.0144050559409676,7.127319737716208,73,72,73,88,15,15,16,6,2.2636392851108584,2.4116082184219203,2.564677308136824,0.364673411298214,4688,4688,Grundy and Nearby Counties,Putnam,29,171,Missouri,MO
29211,29CS025,58,57,59,72,14,13,15,12,0.2201677566582884,0.32297424298915817,0.43845822324002187,0.8018669745103979,71,70,72,86,15,14,16,11,0.6081347528839623,0.7678241662503675,0.9279634012700332,0.6932300164677743,6049,6049,Grundy and Nearby Counties,Sullivan,29,211,Missouri,MO
29091,29CS026,441,423,458,539,98,81,116,80,0.0233838146558769,0.45407018684949746,0.8971510973454091,0.8040361613166676,538,517,559,637,99,78,120,83,-0.10108770459637025,0.4981964934971357,1.1288070828636252,0.8277470954610547,40158,40158,Howell+Oregon+Shannon,Howell,29,91,Missouri,MO
29149,29CS026,136,131,140,140,4,-0,9,10,-0.9698559585829777,-0.5623740626703985,-0.1264551871589458,1.9433282429700562,165,160,171,178,13,7,18,14,-0.7409834950074409,-0.13538624929076534,0.4476032435907863,1.0139508014928362,10473,10473,Howell+Oregon+Shannon,Oregon,29,149,Missouri,MO
29203,29CS026,83,82,84,121,38,37,39,13,2.930573113840923,3.031614603780874,3.136984197989274,0.3346183594510317,102,101,103,119,17,16,18,15,0.10644158012662551,0.2545218990340042,0.40900760549923665,0.8461041411633474,8188,8188,Howell+Oregon+Shannon,Shannon,29,203,Missouri,MO
29095,29CS027,5457,5153,5760,6353,896,593,1200,518,0.06840491389966417,0.5409002976709053,0.9230101074567791,0.5772474399595774,6703,6338,7067,7785,1082,718,1447,862,-0.2189084975073281,0.3613033146764207,1.0203731861760466,0.795753939699811,705006,705006,Jackson,Jackson,29,95,Missouri,MO
29097,29CS028,1055,1002,1107,1291,236,184,289,175,0.09370336334966095,0.4825451278924532,0.9288797660163851,0.7375074910514676,1296,1233,1359,1531,235,172,298,214,-0.3669303745523266,0.22042934869640457,0.8446759756055002,0.9074547858339376,121403,121403,Jasper,Jasper,29,97,Missouri,MO
29099,29CS029,1814,1716,1911,2088,274,177,372,200,-0.0777257935559086,0.33604883595550755,0.7573292783446356,0.7269655359879547,2233,2116,2350,2487,254,137,371,265,-0.6711934062920177,-0.05419954331516364,0.5510480952897107,1.0373671777398272,225877,225877,Jefferson,Jefferson,29,99,Missouri,MO
29101,29CS030,356,333,380,420,64,40,87,46,-0.09906667101321445,0.33644565054294473,0.7214741386973612,0.7110234180626753,438,410,466,565,127,99,155,57,0.97107660209370394,1.5528162087790882,2.2087959177055088,0.4437523802220369,54200,54200,Johnson,Johnson,29,101,Missouri,MO
29105,29CS031,378,363,394,408,30,14,45,52,-1.0170867602981346,-0.6311595715798252,-0.21177458769032861,1.6945748872356465,463,445,482,566,103,84,121,74,0.332338914657697,0.9627814886105193,1.5398277753468999,0.7145785974211265,35880,35880,Laclede+Webster,Laclede,29,105,Missouri,MO
29225,29CS031,318,301,335,362,44,27,61,50,-0.5748663349993625,-0.1480150291053731,0.26735025496346826,1.1111305133948535,392,372,413,507,115,94,135,63,0.9441632228644794,1.5679721264152024,2.1724211638673623,0.5443121987117328,39734,39734,Laclede+Webster,Webster,29,225,Missouri,MO
29113,29CS032,447,421,473,480,33,7,59,51,-0.729683345234988,-0.3125530705089198,0.11324463780819505,1.5066787642576418,548,517,579,602,54,23,85,54,-0.6275185328185546,-0.01873689170433198,0.5924097431232469,0.9887274830706851,59490,59490,Lincoln+Pike,Lincoln,29,113,Missouri,MO
29163,29CS032,167,159,174,204,37,30,45,23,0.38959414822075167,0.8181453251495411,1.2168850120452415,0.5991025346132594,203,194,212,210,7,-2,16,27,-1.9850806876959455,-1.370570016663605,-0.7025762459525334,3.3804262693266787,17626,17626,Lincoln+Pike,Pike,29,163,Missouri,MO
29125,29CS033,87,86,88,125,38,37,39,13,2.711834847511622,2.814495380758066,2.9307057891744206,0.3359712811588718,107,106,108,133,26,25,27,11,1.8636539367978888,2.0272974288168353,2.1711480625560378,0.4107266404904213,8769,8769,Maries+Osage+Pulaski,Maries,29,125,Missouri,MO
29151,29CS033,113,112,115,119,6,4,7,10,-0.42748009592827657,-0.3210277149003129,-0.218592411832707,1.4987025486992074,139,138,141,165,26,24,27,21,0.2401018983221034,0.4025340510725245,0.5578272673815592,0.7904191633143023,13585,13585,Maries+Osage+Pulaski,Osage,29,151,Missouri,MO
29169,29CS033,287,264,309,342,55,33,78,39,-0.12144572059581406,0.2963161822736237,0.7733524344288462,0.692592462476978,357,330,384,455,98,71,125,50,0.4770908980175206,1.0879387556606939,1.6926527737613404,0.5063571227304923,52665,52665,Maries+Osage+Pulaski,Pulaski,29,169,Missouri,MO
29127,29CS034,295,283,307,310,15,3,27,39,-1.3025319274297507,-0.8293916162250481,-0.4289575776400156,2.436042106051182,362,347,376,395,33,19,48,50,-1.2922117939481657,-0.6927569741757356,-0.09672133779590583,1.4515766717078897,28493,28493,Marion+Monroe+Ralls+Shelby,Marion,29,127,Missouri,MO
29137,29CS034,88,87,89,114,26,25,27,16,1.048478205209671,1.1528497248452483,1.2626134244492706,0.5931092326199796,108,107,109,120,12,11,13,17,-0.8134446483230641,-0.6552813819675267,-0.4983006938442946,1.277947062607127,8646,8646,Marion+Monroe+Ralls+Shelby,Monroe,29,137,Missouri,MO
29173,29CS034,84,83,85,128,44,43,45,14,2.817130945787974,2.9278277873749126,3.0374016179057617,0.31008480961087825,103,101,104,136,33,32,35,12,2.3137441744956955,2.47810272968094,2.637212514581223,0.35029335088169383,10295,10295,Marion+Monroe+Ralls+Shelby,Ralls,29,173,Missouri,MO
29205,29CS034,67,67,68,84,17,16,17,7,1.5156606152026477,1.6164573877409496,1.7137510158169478,0.3984139677040014,82,82,83,87,5,4,5,6,-0.45888808911087364,-0.2913422662582715,-0.1363825199420568,1.0811146357642791,5921,5921,Marion+Monroe+Ralls+Shelby,Shelby,29,205,Missouri,MO
29133,29CS035,151,145,156,185,34,29,40,24,0.36323788259720863,0.79045336511511,1.2218418075048998,0.6822446247911813,185,178,191,221,36,30,43,26,0.367316373664208,0.959133523649254,1.5275371590291238,0.6985360762133105,12993,12993,Mississippi+New Madrid+Scott,Mississippi,29,133,Missouri,MO
29143,29CS035,204,197,211,289,85,78,92,37,2.3996895046562825,2.8376075520578636,3.2539218085194035,0.4304816379635261,250,242,259,296,46,37,54,24,0.9529990205114351,1.539818096966592,2.1239155179789604,0.5130769585869013,16902,16902,Mississippi+New Madrid+Scott,New Madrid,29,143,Missouri,MO
29201,29CS035,386,369,402,469,83,67,100,60,0.19509930770303885,0.6133790045228602,1.0439039181870424,0.7106172652240227,476,456,496,584,108,88,128,49,1.1899966709043874,1.8555948772556148,2.4158501300703557,0.44902173144630414,38363,38363,Mississippi+New Madrid+Scott,Scott,29,201,Missouri,MO
29145,29CS036,562,537,588,642,80,54,105,80,-0.4364125588328046,-0.0032614042091539943,0.3854566876749454,0.9927197803993152,689,659,719,815,126,96,156,115,-0.38404154329983026,0.2529613807937437,0.8614660537561206,0.9044437785605055,58380,58380,Newton,Newton,29,145,Missouri,MO
29159,29CS037,392,374,410,492,100,82,118,51,0.7503146708740032,1.1721681971630185,1.5533687320374703,0.5059887650730718,481,459,503,512,31,9,53,47,-1.0924674385488922,-0.440353505091763,0.16692175911132057,1.4787562088980115,42447,42447,Pettis+Saline,Pettis,29,159,Missouri,MO
29195,29CS037,216,206,225,255,39,30,49,42,-0.5215518780473881,-0.12830186443100733,0.3329575184719387,1.0402768984237165,264,253,276,325,61,49,72,36,0.6885058081244196,1.2887604152910344,1.9162707963239134,0.5846932625988961,22840,22840,Pettis+Saline,Saline,29,195,Missouri,MO
29165,29CS038,644,598,690,740,96,50,142,67,-0.13839158052852882,0.27759962248944836,0.7193710470364134,0.6893665068556845,797,742,852,893,96,41,151,96,-0.6426534163260003,-0.0067987377592015775,0.59755511274002715,0.9914503601103325,105478,105478,Platte,Platte,29,165,Missouri,MO
29041,29CS039,80,79,81,115,35,34,36,17,2.304325119218891,2.4074208224748403,2.5100389570621306,0.4740095497261133,98,97,99,117,19,18,20,12,0.9201318492264301,1.0752776672817208,1.2438889416539862,0.6107950074162696,7420,7420,Randolph and Nearby Counties,Chariton,29,41,Missouri,MO
29053,29CS039,166,159,174,173,7,-1,14,18,-1.070750301216009,-0.6484352181767947,-0.22511156696310516,2.292929456491971,203,194,212,227,24,15,33,36,-1.437366237751786,-0.8588636587998956,-0.26013181600225843,1.4529265600459103,17371,17371,Randolph and Nearby Counties,Cooper,29,53,Missouri,MO
29089,29CS039,91,90,92,92,1,0,2,1,-0.08868352538335007,0.024608542448422265,0.12488589607204698,0.44916409115860984,112,110,113,145,33,32,35,14,2.169027602277067,2.330057639499086,2.478626844467988,0.4069560958936606,9990,9990,Randolph and Nearby Counties,Howard,29,89,Missouri,MO
29121,29CS039,174,168,181,235,61,54,67,15,2.6260752411290564,3.047340065061733,3.490966723857957,0.24228653975945963,213,205,220,225,12,5,20,17,-0.9284810987455601,-0.3946785537646293,0.24335601991977054,1.2767042391830214,15104,15104,Randolph and Nearby Counties,Macon,29,121,Missouri,MO
29175,29CS039,243,233,254,280,37,26,47,41,-0.5959324318224746,-0.18147793548876484,0.2793794872069791,1.092123657263616,298,285,310,353,55,43,68,38,0.2101116425378077,0.8376283574784158,1.478143785685259,0.676751758609424,24660,24660,Randolph and Nearby Counties,Randolph,29,175,Missouri,MO
29183,29CS040,2587,2412,2761,3221,634,460,809,396,0.14529405711047144,0.5937941484099246,1.0167977372065673,0.6232435196272373,3191,2982,3401,3634,443,233,652,298,-0.22019645406920746,0.43294051283191715,1.0545337009721714,0.6718368053113563,403533,403533,St. Charles,St. Charles,29,183,Missouri,MO
29186,29CS040,168,160,175,176,8,1,16,10,-0.5007109641360127,-0.08971870894548793,0.33824503837971737,1.0558548502326457,205,195,214,246,41,32,51,26,0.41118085953046746,1.0240973147299957,1.5989562685761425,0.6151063267091743,17943,17943,St. Charles,Ste. Genevieve,29,186,Missouri,MO
29187,29CS040,657,628,686,827,170,141,199,103,0.6182700414377377,1.0010570225447135,1.431375798274574,0.6019307199619837,802,767,836,1021,219,185,254,123,1.1653792096123026,1.7329970728174207,2.367599264000071,0.5581420126284737,66752,66752,St. Charles,St. Francois,29,187,Missouri,MO
29510,29CS042,2492,2364,2621,3132,640,511,768,330,0.586361786283349,1.0442202449984264,1.4764333204365774,0.515191464670268,3060,2906,3213,3359,299,146,453,265,-0.4593237497478392,0.12832745863721734,0.7365798722776337,0.8819748991092637,299536,299536,St. Louis (city),St. Louis (city),29,510,Missouri,MO
29189,29CS043,8721,8293,9148,10649,1928,1501,2356,1364,0.12852759858917076,0.565503700921262,0.9954317112188069,0.7070049378257726,10703,10190,11217,11350,647,133,1160,933,-0.9444098545155577,-0.3438099177443839,0.253301028456545,1.4401055513149301,994864,994864,St. Louis (county),St. Louis (county),29,189,Missouri,MO
29001,29CS044,194,183,205,196,2,-9,13,11,-0.7607788365917004,-0.3598239938060479,0.04007818489806198,4.028568814384318,240,227,253,290,50,37,63,35,0.1375389094888881,0.6974467874715302,1.3179785186828328,0.6870403810036286,25464,25464,Scotland and Nearby Counties,Adair,29,1,Missouri,MO
29045,29CS044,67,67,68,82,15,14,15,17,-0.43258603802811674,-0.3260533125354578,-0.21428077134274182,1.0779003536144152,82,81,83,102,20,19,21,12,1.324117180586876,1.4624123074211293,1.6321723469957596,0.5625752907834987,6815,6815,Scotland and Nearby Counties,Clark,29,45,Missouri,MO
29103,29CS044,38,37,38,45,7,7,8,3,0.9513474747341758,1.0541847339261778,1.1633758753958732,0.3670851869437441,46,45,46,67,21,21,22,6,4.4192089318615455,4.572322361880966,4.734920798597701,0.2721243199767986,3950,3950,Scotland and Nearby Counties,Knox,29,103,Missouri,MO
29111,29CS044,99,98,100,109,10,9,11,7,0.21535254759980343,0.32432307365429647,0.4284790780574349,0.6286092697204626,120,119,121,155,35,34,36,14,2.3909397301205386,2.5565390311012917,2.7212030357413437,0.39001623502515764,9797,9797,Scotland and Nearby Counties,Lewis,29,111,Missouri,MO
29197,29CS044,44,43,44,51,7,7,8,5,0.40486325057893185,0.5113791534007558,0.6284080222222637,0.5998091446419984,53,52,54,64,11,10,12,23,-3.3141004984090117,-3.1475085158199283,-2.9973415808557093,1.9231920563719014,4591,4591,Scotland and Nearby Counties,Schuyler,29,197,Missouri,MO
29199,29CS044,47,46,47,51,4,4,5,6,-0.43725856000746594,-0.3337478674419722,-0.22654621077499568,1.1172869387178335,57,56,57,69,12,12,13,11,0.17478240101474893,0.3354759141795128,0.4976498881399616,0.8235606608211501,4909,4909,Scotland and Nearby Counties,Scotland,29,199,Missouri,MO
29209,29CS045,354,340,368,386,32,18,46,47,-0.8577388372351235,-0.4660629570353102,-0.01810864436435205,1.4368301070682565,434,417,450,498,64,48,81,66,-0.6854026726788707,-0.07590884305065429,0.5490096362237188,1.010204501384489,32195,32195,Stone+Taney,Stone,29,209,Missouri,MO
29213,29CS045,527,503,551,622,95,71,119,72,-0.04161887278729998,0.4078482662799027,0.8374686192871952,0.7475393680249146,646,617,675,793,147,118,176,103,0.3682811980275824,0.9271829414852785,1.5902073544690447,0.6954606410036376,56077,56077,Stone+Taney,Taney,29,213,Missouri,MO
29011,29CS046,129,124,134,132,3,-2,8,16,-1.5957404934359842,-1.1418334355660873,-0.7010297712128409,4.136623037128113,156,150,162,167,11,5,17,26,-2.195593899219982,-1.5934114667342685,-0.9533649451492421,2.248648978662369,11644,11644,Vernon and Nearby Counties,Barton,29,11,Missouri,MO
29013,29CS046,176,169,183,191,15,8,22,16,-0.4703162661491043,-0.04138644709862181,0.4100744534856596,0.9720502901079549,213,205,221,244,31,23,39,42,-1.4490035115025173,-0.8189507654561676,-0.19348374735346113,1.3081617508876606,16225,16225,Vernon and Nearby Counties,Bates,29,13,Missouri,MO
29039,29CS046,181,175,187,157,-24,-30,-18,13,-3.004199559718786,-2.59194014979183,-2.152839059288904,-0.5620050965014228,219,212,227,236,17,9,24,34,-2.0977860119336253,-1.4442749034292401,-0.8192129830544875,1.9249295994303603,14310,14310,Vernon and Nearby Counties,Cedar,29,39,Missouri,MO
29057,29CS046,91,90,91,111,20,20,21,28,-1.1202604740140045,-1.0201764815772063,-0.9062182204775089,1.3135753138409179,111,110,112,119,8,7,9,10,-0.46589400451087565,-0.30592228588927994,-0.1549268550028051,1.1053915009346365,7556,7556,Vernon and Nearby Counties,Dade,29,57,Missouri,MO
29217,29CS046,204,195,213,251,47,38,56,37,0.08946758626808188,0.4999378548663507,0.9115946045674581,0.7677897480339488,247,237,258,340,93,82,103,44,2.2398780860245138,2.8653812699459977,3.462686806691126,0.4684788783793239,20543,20543,Vernon and Nearby Counties,Vernon,29,217,Missouri,MO
30001,30CS001,76,75,77,94,18,17,19,4,1.3899040637110271,1.4934327055097756,1.6025139017303212,0.20859915191307088,93,92,94,122,29,28,30,18,1.2328982814999518,1.3909534606610412,1.5443579651343684,0.6003993386136701,9478,9478,Beaverhead+Gallatin+Madison,Beaverhead,30,1,Montana,MT
30031,30CS001,659,601,716,705,46,-11,104,40,-0.40640056848614525,0.040226785564742074,0.49442812797908936,0.8481122701169544,816,747,885,876,60,-9,129,80,-0.8228294694029895,-0.18958944000769154,0.4592203957291814,1.3175925920752218,132118,132118,Beaverhead+Gallatin+Madison,Gallatin,30,31,Montana,MT
30057,30CS001,77,76,78,91,14,13,15,5,0.8992552962063673,0.9984753792633967,1.1029664374008812,0.3371392212309981,95,93,96,105,10,9,12,14,-0.6462319696252727,-0.48892323500129825,-0.3444968126295881,1.2282956546188013,8836,8836,Beaverhead+Gallatin+Madison,Madison,30,57,Montana,MT
30013,30CS002,756,721,791,908,152,117,187,137,-0.28966331515491606,0.18288219783334503,0.5921727086103915,0.8983016067524837,927,885,969,1029,102,60,144,114,-0.8014714858285064,-0.17849650710121737,0.4691884551022605,1.1050710522869307,81373,81373,Cascade,Cascade,30,13,Montana,MT
30023,30CS003,104,103,105,133,29,28,30,3,2.753734286034964,2.8505849449693,2.9573814181330493,0.09912876982245301,127,126,128,125,-2,-3,-1,14,-2.226526406170383,-2.062333741891163,-1.8957006958674623,-17.058187301963386,9206,9206,Deer Lodge and Nearby Counties,Deer Lodge,30,23,Montana,MT
30039,30CS003,28,27,28,25,-3,-3,-2,5,-2.424101325857055,-2.316956443202803,-2.2040375443720204,-2.924351529013605,34,34,34,39,5,5,5,4,0.2275835249201236,0.38448919153370115,0.5287449351458072,0.6597141939560306,3328,3328,Deer Lodge and Nearby Counties,Granite,30,39,Montana,MT
30077,30CS003,67,66,67,81,14,14,15,2,1.710498186289489,1.8209628862955718,1.9186857384982186,0.12944839483334347,81,81,82,82,1,-0,1,14,-2.509690726199952,-2.3538530858653735,-2.2059584029650896,8.885330656801116,6839,6839,Deer Lodge and Nearby Counties,Powell,30,77,Montana,MT
30081,30CS003,418,399,437,478,60,41,79,35,0.11514089609559555,0.5588884305217199,0.9789555297222116,0.575270228883326,513,490,537,665,152,128,175,106,0.6099967768738841,1.2086159922745863,1.8641159799812261,0.6941936822293326,44504,44504,Deer Lodge and Nearby Counties,Ravalli,30,81,Montana,MT
30093,30CS003,363,348,378,402,39,24,54,54,-0.8523090667242654,-0.43295637164943623,0.03319295416780096,1.3510936403696772,444,426,462,536,92,74,110,51,0.7984350555746442,1.400120064604146,2.0635853211652186,0.5501525324502952,35017,35017,Deer Lodge and Nearby Counties,Silver Bow,30,93,Montana,MT
30003,30CS004,134,128,140,197,63,57,69,61,-0.27326449725971724,0.13957430753726768,0.5956761174135075,0.9540077755476362,164,157,171,165,1,-6,8,24,-2.673093249360836,-2.108359130275604,-1.4965748029079862,11.172561234063942,13171,13171,Eastern Montana,Big Horn,30,3,Montana,MT
30011,30CS004,14,14,14,17,3,3,3,3,-0.017123992589465665,0.0768946093384974,0.1846677763597004,0.7317723165180149,17,17,17,12,-5,-5,-5,6,-10.837077604687272,-10.67660166127514,-10.526869797688775,-1.4820749855685205,1241,1241,Eastern Montana,Carter,30,11,Montana,MT
30017,30CS004,115,114,117,119,4,2,5,12,-0.8355746726557949,-0.7330711618728016,-0.6214959694610773,2.5622525870689716,142,140,143,158,16,15,18,28,-1.3727335708058253,-1.2238016083716114,-1.0643506837886634,1.6046215071371304,11332,11332,Eastern Montana,Custer,30,17,Montana,MT
30019,30CS004,17,17,17,25,8,8,8,6,0.9153918631234284,1.0273844619652206,1.1328374706134716,0.6904429240155906,21,21,21,20,-1,-1,-1,4,-3.991228712358342,-3.8252808713747624,-3.67456700952839,-16.584857878547787,1643,1643,Eastern Montana,Daniels,30,19,Montana,MT
30021,30CS004,76,76,77,115,39,38,39,20,2.045522937580047,2.1501671083633043,2.255538816850968,0.5062035351169009,94,93,95,139,45,44,46,22,3.0451018889514883,3.2086728009000733,3.366914488012389,0.47841430543783003,8603,8603,Eastern Montana,Dawson,30,21,Montana,MT
30025,30CS004,25,25,25,29,4,4,4,4,-0.14595210270708164,-0.04251966668166642,0.06500097155925007,0.8209725787252942,31,31,31,34,3,3,3,4,-0.5428231936825866,-0.38055887268623184,-0.21453859929019176,0.9727909435684008,2856,2856,Eastern Montana,Fallon,30,25,Montana,MT
30033,30CS004,13,13,13,12,-1,-1,-1,3,-3.3199238575724768,-3.2140177023488543,-3.1018552668238346,-37.645185487857276,16,16,16,19,3,3,3,5,-2.088928430370804,-1.9437578980920873,-1.7791397459047396,1.2669547150345792,1270,1270,Eastern Montana,Garfield,30,33,Montana,MT
30055,30CS004,16,16,16,13,-3,-3,-3,4,-4.402722140568046,-4.305787285517418,-4.195729359065478,-1.9028177025155184,20,20,20,25,5,5,5,3,1.4551532642158986,1.6190906995395504,1.7797028607279437,0.4817579168695752,1649,1649,Eastern Montana,McCone,30,55,Montana,MT
30071,30CS004,44,44,44,46,2,2,2,12,-2.6386783359780823,-2.538239991406978,-2.440823523135267,4.000297927598844,54,53,54,67,13,13,14,13,-0.13821418674152022,0.014543310228901835,0.17147151750547668,0.9263444669902445,3940,3940,Eastern Montana,Phillips,30,71,Montana,MT
30075,30CS004,17,16,17,15,-2,-2,-1,2,-2.255528139763292,-2.153487598128079,-2.0465350031688336,-3.1876268754681663,20,20,21,22,2,1,2,1,0.2563137367354558,0.421402882597273,0.5846266235989797,0.38697675436283546,1685,1685,Eastern Montana,Powder River,30,75,Montana,MT
30079,30CS004,15,14,15,18,3,3,4,3,-0.1663680091309838,0.2530818262431644,0.7134109169075903,0.7002928661968988,18,17,18,12,-6,-6,-5,5,-12.95146597892314,-12.303631084776683,-11.660724586220997,-1.0156793450734205,1065,1065,Eastern Montana,Prairie,30,79,Montana,MT
30083,30CS004,77,76,78,95,18,17,19,15,0.1680500244328607,0.272086250323317,0.37973624820692464,0.7883232296547763,95,93,96,128,33,32,35,16,1.7115027886351448,1.8700477878057027,2.0277374010247735,0.4688205062228281,10985,10985,Eastern Montana,Richland,30,83,Montana,MT
30085,30CS004,125,121,130,167,42,37,46,45,-0.695563714497918,-0.3022668159676892,0.17264080923077982,1.0536061594656463,153,147,159,192,39,33,45,22,1.2721954692071769,1.8515171600497593,2.503287598809726,0.5491573424052458,11001,11001,Eastern Montana,Roosevelt,30,85,Montana,MT
30087,30CS004,77,76,78,123,46,45,47,35,1.1043423386387825,1.203006604822516,1.3143698999499474,0.7485506021330531,95,94,96,126,31,30,32,21,1.1837600597438698,1.3550002855858956,1.5073815602221114,0.6555268351037702,8905,8905,Eastern Montana,Rosebud,30,87,Montana,MT
30091,30CS004,38,37,38,29,-9,-9,-8,6,-4.566921030584339,-4.452125454947499,-4.334777949508568,-0.7841170007726159,46,46,47,61,15,14,15,2,4.521835991490574,4.67089067619268,4.822302497651167,0.1263531816064546,3294,3294,Eastern Montana,Sheridan,30,91,Montana,MT
30103,30CS004,10,9,10,5,-5,-5,-4,5,-14.217942288609674,-13.775331968378428,-13.380049535828896,-1.39273031657534,12,11,12,4,-8,-8,-7,4,-20.792242725672768,-20.123129374548196,-19.480277592192458,-0.5993241128005989,696,696,Eastern Montana,Treasure,30,103,Montana,MT
30105,30CS004,75,75,76,91,16,15,16,17,-0.29418324450542643,-0.18021310671962493,-0.07870413407279658,1.0204971156487204,92,92,93,102,10,9,10,13,-0.7302153604266391,-0.562965944877091,-0.41778015337772945,1.2355181276467608,7377,7377,Eastern Montana,Valley,30,105,Montana,MT
30109,30CS004,13,13,13,19,6,6,6,6,-0.39917286996658163,0.02962760361555693,0.44163365229401946,0.853645024503948,16,15,16,20,4,4,5,3,0.9436019296582954,1.5837088450296928,2.1543468221839106,0.5739152953322525,948,948,Eastern Montana,Wibaux,30,109,Montana,MT
30029,30CS005,819,773,864,941,122,77,168,62,0.13626889524347072,0.5747283092398627,1.0029385776599848,0.5034617909962342,1006,951,1061,1250,244,189,299,150,0.4791617991690315,1.0899120231536223,1.7079629870058224,0.6120642019289391,104701,104701,Flathead,Flathead,30,29,Montana,MT
30043,30CS006,90,88,91,136,46,45,48,7,3.0919090312411237,3.1969636997465884,3.3079078256857297,0.1481041934456495,110,109,112,177,67,65,68,18,4.60764622721855,4.767564120403616,4.921571506623947,0.2657673984587382,12273,12273,Jefferson+Lewis and Clark,Jefferson,30,43,Montana,MT
30049,30CS006,545,515,575,604,59,29,89,49,-0.28471633932732776,0.1422501789037984,0.5623773571279596,0.8144049566124305,668,632,705,782,114,77,150,99,-0.36464837985224346,0.22876596849634412,0.8831255493647548,0.8637457163041079,69849,69849,Jefferson+Lewis and Clark,Lewis and Clark,30,49,Montana,MT
30047,30CS007,270,257,284,319,49,35,62,23,0.38925919509569934,0.818862314706796,1.252239396967742,0.46460113174553813,330,314,346,397,67,51,83,62,-0.43528635433085927,0.19681791357239808,0.8438385737507536,0.9063466044930188,30753,30753,Lake+Lincoln+Mineral+Sanders,Lake,30,47,Montana,MT
30053,30CS007,215,206,224,239,24,15,33,12,0.1935085828546669,0.6097875316926926,1.001772184519007,0.4784542545492655,261,251,272,331,70,59,80,50,0.5095923852234244,1.1879762669967036,1.8081008005937744,0.7063478129678152,20201,20201,Lake+Lincoln+Mineral+Sanders,Lincoln,30,53,Montana,MT
30061,30CS007,48,48,49,54,6,5,6,5,0.022511889267576326,0.12447705573110046,0.23470418289038886,0.7606070182727449,59,58,60,84,25,24,26,13,3.0501716707687114,3.2101995933964127,3.3551460724453,0.5009800845523089,4473,4473,Lake+Lincoln+Mineral+Sanders,Mineral,30,61,Montana,MT
30089,30CS007,142,137,148,163,21,15,26,14,0.1131987226736059,0.5394325710389718,1.0279563252330015,0.6459910584490646,173,167,179,233,60,54,66,39,1.5105772709617082,2.1033964620972267,2.6759384444233176,0.637946522462305,12034,12034,Lake+Lincoln+Mineral+Sanders,Sanders,30,89,Montana,MT
30063,30CS008,789,737,841,835,46,-6,98,56,-0.5227939953443884,-0.07581521249350932,0.34653867508724895,1.196249951673579,972,910,1035,1090,118,55,180,94,-0.40904909502739123,0.2310558034200796,0.8639454266178395,0.7925262177284171,120718,120718,Missoula,Missoula,30,63,Montana,MT
30005,30CS009,57,56,58,89,32,31,33,24,1.0905559635065427,1.1939912142302922,1.2927213852633281,0.7290569958435845,70,69,71,76,6,5,7,7,-0.328897233301158,-0.1656612518653337,-0.01815743060241241,0.9865304763700512,6647,6647,North Central Montana,Blaine,30,5,Montana,MT
30015,30CS009,49,48,50,64,15,14,16,1,2.351078278572051,2.455874707525761,2.5526104065676933,0.062624741997341,60,59,61,72,12,11,13,4,1.513479276775608,1.6789145042351765,1.830318754368406,0.3087788371068476,5688,5688,North Central Montana,Chouteau,30,15,Montana,MT
30027,30CS009,144,139,148,150,6,2,11,15,-1.2276201090056946,-0.7876896272564353,-0.34267813628852734,2.046573861199366,175,169,181,172,-3,-9,3,23,-3.4233880719993994,-2.7973969186374754,-2.192886097201713,-12.941114222584392,11062,11062,North Central Montana,Fergus,30,27,Montana,MT
30035,30CS009,134,128,140,160,26,20,32,42,-1.5425180257302604,-1.1550408015122033,-0.7305651870048077,1.54551203958193,163,156,170,183,20,13,27,21,-0.7233663519220342,-0.11155426356895269,0.4804122148941017,1.0130279426595603,13656,13656,North Central Montana,Glacier,30,35,Montana,MT
30041,30CS009,142,135,149,158,16,9,23,34,-1.5402740424764743,-1.0969041290087231,-0.6987850153212211,2.041359367705822,174,166,182,205,31,23,39,29,-0.4686528005703107,0.12102540848248519,0.7775407239805276,0.9075891225950576,16437,16437,North Central Montana,Hill,30,41,Montana,MT
30045,30CS009,16,16,16,16,-0,-0,-0,8,-4.210359233396554,-4.108108675867306,-4.003626086832191,10.284779757943348,20,20,20,24,4,4,4,2,1.1317425987122807,1.2708497748217067,1.426112885157727,0.3902259843445214,2003,2003,North Central Montana,Judith Basin,30,45,Montana,MT
30051,30CS009,15,15,16,18,3,2,3,5,-1.1553070795220015,-1.0457448038488024,-0.9433972004935229,1.42444290077627,19,19,19,15,-4,-4,-4,5,-4.696457161063075,-4.545162988930887,-4.381838167120502,-1.6606103025796217,2379,2379,North Central Montana,Liberty,30,51,Montana,MT
30069,30CS009,7,7,7,3,-4,-4,-4,3,-13.915870968680048,-13.508957018134572,-13.088017658712731,-1.1044280547823149,8,8,8,8,-0,-0,0,8,-20.290697905739485,-19.688783848357254,-19.012645273873414,9.595367450199541,498,498,North Central Montana,Petroleum,30,69,Montana,MT
30073,30CS009,61,61,62,67,6,5,6,1,0.7085152022645267,0.8167999260574521,0.9126273147673603,0.14776978079531344,75,74,76,69,-6,-7,-5,6,-2.598183460965134,-2.4562187999228104,-2.2923933306822373,-1.225547088070567,5826,5826,North Central Montana,Pondera,30,73,Montana,MT
30099,30CS009,56,55,57,65,9,8,10,2,1.050375543962745,1.1559002761100767,1.2532248069619991,0.19714653311685512,68,68,69,92,24,23,24,14,1.7140074325144785,1.8682167814480066,2.0091912147768305,0.568670513328979,6191,6191,North Central Montana,Teton,30,99,Montana,MT
30101,30CS009,43,42,43,48,5,5,6,2,0.6114252224011641,0.7155482173481807,0.8222210214396034,0.31384227501939094,52,52,53,75,23,22,23,9,3.3753235330117066,3.5272290313001182,3.686324916694309,0.37791325948946314,4699,4699,North Central Montana,Toole,30,101,Montana,MT
30007,30CS010,54,53,55,43,-11,-12,-10,9,-3.2765088188106555,-3.161188937167152,-3.0578539470944124,-0.9064135420712712,66,65,67,92,26,25,27,20,1.04124197821462,1.1991438426761631,1.3371998350368568,0.7333824130551989,6303,6303,South Central Montana,Broadwater,30,7,Montana,MT
30009,30CS010,91,89,92,104,13,12,15,7,0.5003680916602969,0.5883142818579696,0.7029038256633283,0.4860389656937708,110,109,112,109,-1,-3,-0,18,-2.3119756608972772,-2.154295940407298,-2.0064204680060946,-42.32867093758137,10794,10794,South Central Montana,Carbon,30,9,Montana,MT
30037,30CS010,11,11,12,12,1,0,1,4,-4.4337541461007115,-4.03213426475588,-3.600101293488073,2.3977700879552364,14,13,14,17,3,3,4,4,-1.7450403945246933,-1.1066394544424936,-0.5110990650969012,0.9463457314359356,827,827,South Central Montana,Golden Valley,30,37,Montana,MT
30059,30CS010,19,19,20,18,-1,-2,-1,5,-3.5629425419889533,-3.4578853820254314,-3.3525275530945144,-14.314721116847595,24,23,24,19,-5,-5,-4,3,-5.109544515783562,-4.948566687355927,-4.7891959254603265,-0.8394070380308154,1837,1837,South Central Montana,Meagher,30,59,Montana,MT
30065,30CS010,50,49,50,60,10,10,11,5,1.021287088012073,1.1158735047737136,1.2259168261790494,0.44666680871516834,61,60,61,92,31,31,32,17,3.536470940445856,3.702809767367258,3.857086108425645,0.5259682995673947,4644,4644,South Central Montana,Musselshell,30,65,Montana,MT
30095,30CS010,76,75,77,95,19,18,20,7,1.1542008821071539,1.2536365412107033,1.3572818927188883,0.3459644983255094,92,91,94,133,41,39,42,20,2.380866141779412,2.5347630733331,2.6891184221733604,0.48035208664924245,9761,9761,South Central Montana,Stillwater,30,95,Montana,MT
30097,30CS010,31,31,32,46,15,14,15,4,2.7619938699436073,2.8655028901867254,2.976919197270625,0.2562694736231762,38,38,39,42,4,3,4,8,-1.536487045046981,-1.379019820303453,-1.2397474405684064,1.6880054227840884,3703,3703,South Central Montana,Sweet Grass,30,97,Montana,MT
30107,30CS010,23,23,23,32,9,9,9,2,3.1411561613701853,3.2502358610432767,3.3510446214647227,0.20194260266323627,28,28,28,31,3,3,3,2,0.32944825069932854,0.4890425736128593,0.6467255081274418,0.5178005263412804,2125,2125,South Central Montana,Wheatland,30,107,Montana,MT
30111,30CS011,1357,1287,1427,1579,222,152,292,173,-0.11899112317752576,0.299849624786587,0.7189858329705039,0.7763537480387237,1668,1584,1752,1942,274,190,358,238,-0.34391908282811773,0.25828227977404106,0.9399665072354836,0.8651644555691577,162033,162033,Yellowstone,Yellowstone,30,111,Montana,MT
31007,31CS001,11,10,11,3,-8,-8,-7,3,-14.470640338720784,-14.013713635741897,-13.612052714278136,-0.44207712046215714,13,13,14,4,-9,-10,-9,4,-21.229758799616302,-20.59524145573896,-19.98466820416788,-0.4884798184131453,769,769,Banner and Nearby Counties,Banner,31,7,Nebraska,NE
31033,31CS001,81,80,82,107,26,25,27,13,1.375622238803513,1.4734178185480487,1.5794931609191376,0.47516245661862877,99,98,101,136,37,35,38,15,2.707241240021607,2.8560208006474426,3.0255764529299807,0.39941481163526465,9053,9053,Banner and Nearby Counties,Cheyenne,31,33,Nebraska,NE
31105,31CS001,48,47,50,56,8,6,9,3,0.8961747932933907,1.3478851758375607,1.7596230828910409,0.3421008944223069,59,57,60,50,-9,-10,-7,6,-5.580717290124643,-4.935404816529555,-4.392548286018644,-0.7849009552419057,3554,3554,Banner and Nearby Counties,Kimball,31,105,Nebraska,NE
31123,31CS001,49,49,50,69,20,19,20,12,1.5372208557749698,1.6442415440418265,1.7502436120447284,0.5823163737993298,61,60,61,73,12,12,13,14,-0.6227403513248744,-0.4626055557942555,-0.2997015901333216,1.058357314951656,4624,4624,Banner and Nearby Counties,Morrill,31,123,Nebraska,NE
31157,31CS001,358,343,373,460,102,87,117,96,-0.27846265744166393,0.15324813782629415,0.5817310547069432,0.9342544955816042,439,421,457,465,26,8,44,48,-1.3838853942408613,-0.7413298595468801,-0.10529300198287121,1.7642477032210735,35464,35464,Banner and Nearby Counties,Scotts Bluff,31,157,Nebraska,NE
31019,31CS002,315,294,337,385,70,48,91,58,-0.22012178916864306,0.23159888563491926,0.6688939161369772,0.8224838163321933,389,363,415,424,35,9,61,35,-0.5964310750304604,-0.006644117873438047,0.5626450707452293,0.981306068383995,49944,49944,Buffalo+Kearney+Sherman,Buffalo,31,19,Nebraska,NE
31099,31CS002,63,63,64,61,-2,-3,-2,3,-0.928570622101919,-0.8315228769305311,-0.7217495532864437,-2.0251552297129662,77,77,78,63,-14,-15,-14,5,-3.688415741266863,-3.5286191097771478,-3.370830393053936,-0.3708399132766573,6626,6626,Buffalo+Kearney+Sherman,Kearney,31,99,Nebraska,NE
31163,31CS002,34,34,34,43,9,9,9,1,2.5803102266470255,2.6772777104957144,2.7801866168181237,0.10002190454246215,41,41,42,39,-2,-3,-2,5,-3.1480823682021093,-3.0046097229554376,-2.851416701738627,-3.38100386617599,2985,2985,Buffalo+Kearney+Sherman,Sherman,31,163,Nebraska,NE
31021,31CS003,78,78,79,94,16,15,16,11,0.628827432073719,0.731261044071559,0.8326716451453677,0.6574072074393035,96,95,97,72,-24,-25,-23,5,-5.502230723958379,-5.3444913450767135,-5.182789874619929,-0.21829542410281905,6487,6487,Burt+Dakota+Thurston+Washington,Burt,31,21,Nebraska,NE
31043,31CS003,146,138,155,210,64,55,72,68,-0.6167215732708949,-0.20965857095111892,0.2112606218835667,1.0510960097893085,179,169,190,157,-22,-33,-12,11,-2.613943830012128,-1.9969270635917638,-1.3483630536877766,-0.5168102437426821,20088,20088,Burt+Dakota+Thurston+Washington,Dakota,31,43,Nebraska,NE
31173,31CS003,71,70,72,84,13,12,14,10,0.31233814798187076,0.41381122489253414,0.5180084886810287,0.7130283284020744,87,86,88,102,15,14,16,18,-0.6749391846757906,-0.5180018077983499,-0.35448020919433193,1.1331909799672375,7228,7228,Burt+Dakota+Thurston+Washington,Thurston,31,173,Nebraska,NE
31177,31CS003,163,154,172,177,14,5,23,19,-0.6695836488112688,-0.2520666285112416,0.1767360966514769,1.2975809719722977,200,189,211,201,1,-10,12,17,-1.5386242555261251,-0.9175821977794346,-0.3085866500353182,8.944852609095413,20774,20774,Burt+Dakota+Thurston+Washington,Washington,31,177,Nebraska,NE
31027,31CS004,86,85,87,95,9,8,10,20,-1.4263796375531894,-1.324980841701968,-1.2137296337918613,2.0287152487022984,105,104,106,87,-18,-19,-17,12,-4.4775215178849,-4.329518221708251,-4.1768707901933375,-0.6909084538024246,8418,8418,Cuming and Nearby Counties,Cedar,31,27,Nebraska,NE
31037,31CS004,66,65,68,65,-1,-3,-0,21,-2.21610792231519,-2.10449210226369,-1.997736931585959,-52.24333734005715,82,80,83,65,-17,-18,-15,4,-2.4670515746201853,-2.3133452061483295,-2.1494836492255116,-0.25781231111421665,10640,10640,Cuming and Nearby Counties,Colfax,31,37,Nebraska,NE
31039,31CS004,80,79,81,104,24,23,25,12,1.2863359991371996,1.3876114007889637,1.4952886544265993,0.47547846517643677,98,96,99,121,23,22,25,5,2.340536729971605,2.5040987723171595,2.6611198040641777,0.20522740870408585,8810,8810,Cuming and Nearby Counties,Cuming,31,39,Nebraska,NE
31051,31CS004,52,51,52,64,12,12,13,14,-0.4105589816541748,-0.3021139418609623,-0.1983787518721572,1.0528501805810049,63,63,64,64,1,-0,1,4,-0.8629802298745815,-0.6985109758636037,-0.5422853962305338,2.329371192633397,5619,5619,Cuming and Nearby Counties,Dixon,31,51,Nebraska,NE
31167,31CS004,37,37,38,55,18,17,18,6,1.88382077235425,1.9897475257694193,2.092953490333724,0.3198927180539314,46,45,46,43,-3,-3,-2,4,-1.5080493406139048,-1.3644788229177351,-1.2151479887680499,-2.330435212443141,5910,5910,Cuming and Nearby Counties,Stanton,31,167,Nebraska,NE
31179,31CS004,60,59,61,67,7,6,8,3,0.31850138555894403,0.4250995240816982,0.5338787252804559,0.374945151430155,74,72,75,72,-2,-3,-0,2,-0.6082100185389322,-0.4628104926874743,-0.3106698526918436,-3.1110788893415084,9446,9446,Cuming and Nearby Counties,Wayne,31,179,Nebraska,NE
31053,31CS005,372,356,387,451,79,64,95,57,0.19983189732012255,0.6093661653249153,1.0458418800567466,0.709684380330177,452,433,470,488,36,18,55,41,-0.7613819550148178,-0.14853152089847899,0.46953666606133776,1.0943139785981155,36352,36352,Dodge+Saunders,Dodge,31,53,Nebraska,NE
31155,31CS005,192,182,201,234,42,33,52,18,0.6429507592376326,1.117558966096322,1.5826565636714651,0.4171100905797586,234,223,245,251,17,6,28,23,-0.9280573409148177,-0.322928962462263,0.3127842559144999,1.2793703674119867,21714,21714,Dodge+Saunders,Saunders,31,155,Nebraska,NE
31055,31CS006,3599,3352,3846,4168,569,322,816,488,-0.2875654059371332,0.13497989975259408,0.5342802490674567,0.8562666661187385,4439,4143,4736,4692,253,-44,549,384,-0.9382051099085766,-0.29260405261255024,0.3585646626475015,1.5147829995607764,572307,572307,Douglas,Douglas,31,55,Nebraska,NE
31029,31CS007,44,44,45,46,2,1,2,7,-1.4545799376331758,-1.353481077051427,-1.2478937947349091,2.5395031881735264,55,54,55,60,5,5,6,5,-0.005535376155706011,0.14590160059156407,0.2986207676523739,0.7727316731030014,3876,3876,Frontier and Nearby Counties,Chase,31,29,Nebraska,NE
31047,31CS007,187,177,197,228,41,31,51,36,-0.25561893376218037,0.19554995023285457,0.6303859610393545,0.8640013482161291,231,219,244,241,10,-3,22,29,-1.6316431394850164,-1.008898363088278,-0.40891671187177536,2.7536104960467793,23546,23546,Frontier and Nearby Counties,Dawson,31,47,Nebraska,NE
31057,31CS007,21,21,21,20,-1,-1,-1,3,-2.378528965746447,-2.265512374578723,-2.161780272273666,15.976105953628894,26,25,26,25,-1,-1,-0,3,-2.7498288839991076,-2.5882478348556566,-2.4397491892038348,7.98450657213837,1680,1680,Frontier and Nearby Counties,Dundy,31,57,Nebraska,NE
31063,31CS007,18,17,18,19,1,1,2,1,0.03399528485478928,0.1352100875845134,0.2460035802080427,0.4238909281595726,22,22,22,31,9,9,9,7,0.7878825918906143,0.9484512282419587,1.0964677896606414,0.6957590716210333,2613,2613,Frontier and Nearby Counties,Frontier,31,63,Nebraska,NE
31073,31CS007,21,20,21,29,8,8,9,4,2.099702422234697,2.1989120965064175,2.304666071286494,0.4275863547609255,25,25,26,22,-3,-4,-3,9,-7.724279709820458,-7.560871563433994,-7.4045287223857414,-3.633838503245157,1981,1981,Frontier and Nearby Counties,Gosper,31,73,Nebraska,NE
31085,31CS007,9,8,9,5,-4,-4,-3,5,-9.438833711846314,-9.337341636771065,-9.225513254850954,-1.9811057027547743,11,10,11,2,-9,-9,-8,2,-14.003699206849738,-13.849939995749143,-13.687057598665902,-0.265385752570564,913,913,Frontier and Nearby Counties,Hayes,31,85,Nebraska,NE
31087,31CS007,33,33,33,44,11,11,11,4,2.415086743471929,2.5228289846850482,2.6353563142884995,0.3339753414449804,41,40,41,45,4,4,5,6,-0.8798614447504747,-0.7291659297394808,-0.5773467083502363,1.1271398353348958,2765,2765,Frontier and Nearby Counties,Hitchcock,31,87,Nebraska,NE
31145,31CS007,114,113,115,119,5,4,6,4,-0.013793418013108122,0.08799937187788431,0.19584277271942147,0.6695208201148911,141,139,142,171,30,29,32,12,1.9032051819835847,2.0671644970084855,2.2115295384487,0.38292767200946265,10681,10681,Frontier and Nearby Counties,Red Willow,31,145,Nebraska,NE
31079,31CS008,477,451,504,549,72,45,98,111,-1.0702349770132313,-0.6313942911404808,-0.1885105893538268,1.5275196687339314,585,553,616,624,39,8,71,53,-0.8359270029609908,-0.2583495085658853,0.31476255002673975,1.313716393109481,61276,61276,Hall,Hall,31,79,Nebraska,NE
31093,31CS009,64,63,64,70,6,6,7,14,-1.2780700237053402,-1.1758545440945793,-1.0771152573463192,1.887094544538964,78,78,79,93,15,14,15,6,1.4372876754615804,1.5836015834313868,1.7258826959792244,0.386619904615679,6450,6450,Howard+Merrick+Nance+Platte,Howard,31,93,Nebraska,NE
31121,31CS009,74,73,75,90,16,15,17,17,-0.23186048950423443,-0.13050408174168898,-0.019807915438262345,1.0019073936286222,91,90,92,95,4,3,5,4,-0.21633987227032736,-0.06738644921153887,0.09110445988343084,0.8762674691906882,7814,7814,Howard+Merrick+Nance+Platte,Merrick,31,121,Nebraska,NE
31125,31CS009,46,45,46,52,6,6,7,3,0.8573294349844256,0.9576479914037969,1.0642629307272393,0.4084104460097392,56,56,57,49,-7,-8,-7,4,-3.962783834468554,-3.8246764867836918,-3.6604451202999466,-0.6501212288901795,3503,3503,Howard+Merrick+Nance+Platte,Nance,31,125,Nebraska,NE
31141,31CS009,258,243,272,305,47,33,62,51,-0.5282048456557572,-0.11226802562644883,0.3127931779636483,1.0529854129202123,318,301,336,344,26,8,43,32,-0.8327605181823003,-0.219320890905727,0.3592161637838009,1.1973721896603113,33393,33393,Howard+Merrick+Nance+Platte,Platte,31,141,Nebraska,NE
31109,31CS010,1960,1823,2098,2179,219,81,356,148,-0.1938840214903991,0.21623219862450518,0.6503246844811312,0.6742494341831549,2424,2259,2590,2551,127,-39,292,179,-0.801939125696209,-0.21586099819506172,0.45146294295140826,1.4031257754918938,319339,319339,Lancaster,Lancaster,31,109,Nebraska,NE
31049,31CS011,19,19,20,18,-1,-2,-1,7,-4.768975752886844,-4.660264789783278,-4.551526794402248,-16.889157058068044,24,24,24,35,11,11,11,3,5.287211784978277,5.452432278565204,5.607849028447458,0.2459205873312862,1806,1806,Lincoln and Nearby Counties,Deuel,31,49,Nebraska,NE
31101,31CS011,79,78,80,78,-1,-2,-0,1,-0.39702671155589997,-0.2843542916958067,-0.19060900238835257,-3.261127475916634,97,96,98,132,35,34,36,15,2.7891219614919316,2.9548553685036842,3.1133365931242096,0.4200475864831033,8005,8005,Lincoln and Nearby Counties,Keith,31,101,Nebraska,NE
31111,31CS011,315,300,330,406,91,76,106,55,0.6098696094743901,1.0398291934740962,1.4571374859142276,0.5981495462046412,385,367,403,501,116,98,134,60,1.325956466959262,1.9454977133955011,2.5372020268205273,0.5137536520664544,34644,34644,Lincoln and Nearby Counties,Lincoln,31,111,Nebraska,NE
31113,31CS011,10,9,10,12,2,2,3,6,-5.161996615224879,-4.731511596077794,-4.302796335645899,1.7305750976487213,12,11,12,6,-6,-6,-5,6,-19.16974207997783,-18.59269528207574,-17.984993407113805,-1.303895277518653,749,749,Lincoln and Nearby Counties,Logan,31,113,Nebraska,NE
31117,31CS011,6,6,6,2,-4,-4,-4,2,-12.93231851524895,-12.509624258042313,-12.121545239599063,-0.6519925726777119,7,7,8,8,1,0,1,8,-18.84898597817205,-18.201815989757666,-17.582265905107135,4.882978316855187,485,485,Lincoln and Nearby Counties,McPherson,31,117,Nebraska,NE
31135,31CS011,29,29,29,28,-1,-1,-1,11,-4.303043314883047,-4.19277236387969,-4.087115467092465,-179.42126723604017,36,35,36,36,0,-0,1,3,-1.2580817205695254,-1.1060440892223615,-0.9443621617475887,2.214418542720077,2877,2877,Lincoln and Nearby Counties,Perkins,31,135,Nebraska,NE
31005,31CS012,7,6,7,8,1,1,2,8,-14.52570188644094,-14.076543523197344,-13.620709357019111,3.2970789508803398,8,8,8,6,-2,-2,-2,6,-21.170532588237275,-20.546937102283543,-19.889736181013518,-6.027314476794403,467,467,Northwest Nebraska,Arthur,31,5,Nebraska,NE
31009,31CS012,6,6,7,4,-2,-3,-2,4,-14.554794522944315,-14.123964892937487,-13.727869264346683,-2.7740774971681788,8,8,8,3,-5,-5,-5,3,-21.277092670333886,-20.631440560176753,-20.06026292848321,-0.7810365769414267,456,456,Northwest Nebraska,Blaine,31,9,Nebraska,NE
31013,31CS012,98,97,99,112,14,13,15,5,0.7556541722405433,0.8581931690314143,0.969771729379375,0.32754030415722046,119,117,120,130,11,10,13,15,-0.5568456322323755,-0.4077263893974029,-0.2545939067041737,1.2172576163685214,10748,10748,Northwest Nebraska,Box Butte,31,13,Nebraska,NE
31017,31CS012,31,30,31,40,9,9,10,7,0.6640406865628485,0.7676509651070769,0.8717624489641908,0.6808547543691782,37,37,38,50,13,12,13,4,3.3437289824657674,3.506676901624182,3.6660165084277314,0.292157435425071,2972,2972,Northwest Nebraska,Brown,31,17,Nebraska,NE
31031,31CS012,54,53,55,70,16,15,17,10,0.9510146155969897,1.0526704721550064,1.1520024200449832,0.5855309125852127,65,65,66,79,14,13,14,10,0.5601742610794177,0.7284270158448932,0.8873597785270391,0.6886466597394109,5767,5767,Northwest Nebraska,Cherry,31,31,Nebraska,NE
31041,31CS012,102,101,103,126,24,23,25,15,0.7664956502974949,0.8689391523283498,0.9876511644758773,0.5916409571176268,123,122,125,144,21,19,22,14,0.5810837682427504,0.7320043947275129,0.9041006091584481,0.6492303584043173,10725,10725,Northwest Nebraska,Custer,31,41,Nebraska,NE
31045,31CS012,73,72,74,90,17,16,18,16,0.04497812049765282,0.14903482680566363,0.2577360953746498,0.8750914985037102,88,87,89,107,19,18,20,4,1.9222524269108967,2.0852550920851303,2.225134914307267,0.2029311539437976,8475,8475,Northwest Nebraska,Dawes,31,45,Nebraska,NE
31069,31CS012,26,25,27,24,-2,-3,-1,2,-2.604616663872169,-2.193620816949563,-1.7535966158281386,-1.9698493334222331,32,31,33,36,4,3,5,6,-1.7731536187480454,-1.1145621395756893,-0.494427830102819,1.129984509972154,1832,1832,Northwest Nebraska,Garden,31,69,Nebraska,NE
31075,31CS012,9,9,9,14,5,5,5,4,1.0355110251433974,1.144610312953786,1.252133238679053,0.6990497886693414,11,11,11,7,-4,-4,-4,7,-21.597802579665867,-21.43966932994941,-21.280833208164808,-2.138541211483674,631,631,Northwest Nebraska,Grant,31,75,Nebraska,NE
31091,31CS012,12,12,12,10,-2,-2,-2,2,-6.554682194485672,-6.454795695179316,-6.342626440368231,-1.5980445690350111,15,15,15,15,0,0,0,7,-12.705058399552804,-12.552332950992781,-12.395005635950302,6.30381818677375,659,659,Northwest Nebraska,Hooker,31,91,Nebraska,NE
31103,31CS012,11,10,11,6,-5,-5,-4,6,-14.323758199131388,-13.886562294534494,-13.439246562011652,-1.6073860876788844,13,13,13,3,-10,-10,-10,3,-20.805164150069924,-20.199676508060087,-19.55842040292885,-0.33249611720604205,774,774,Northwest Nebraska,Keya Paha,31,103,Nebraska,NE
31115,31CS012,11,11,11,8,-3,-3,-3,8,-16.444415880707165,-16.335404181705933,-16.23000906264837,-4.711055512520486,13,13,13,1,-12,-12,-12,1,-23.970669938889888,-23.812687599199318,-23.655904316355514,-0.0909073925610073,655,655,Northwest Nebraska,Loup,31,115,Nebraska,NE
31149,31CS012,19,19,20,15,-4,-5,-4,6,-8.036403994549055,-7.585923551656703,-7.144580563929686,-1.7599560231173004,24,23,24,24,0,-0,1,3,-2.883294031974036,-2.295858531469638,-1.726097131668283,2.183555265493015,1373,1373,Northwest Nebraska,Rock,31,149,Nebraska,NE
31161,31CS012,63,63,64,86,23,22,23,16,1.1743816684665482,1.2777220651446286,1.3857378898060766,0.6766529430250721,77,76,78,71,-6,-7,-5,13,-4.533910891271639,-4.380008765194208,-4.230399220231833,-2.619595901020258,5196,5196,Northwest Nebraska,Sheridan,31,161,Nebraska,NE
31165,31CS012,9,9,9,10,1,1,1,6,-4.226945653070117,-4.119651995579372,-4.01213984363782,2.7852063169948504,11,11,11,13,2,2,2,8,-6.010278446884371,-5.856205000015751,-5.691303841353994,2.4520759764804385,1176,1176,Northwest Nebraska,Sioux,31,165,Nebraska,NE
31171,31CS012,10,10,11,7,-3,-4,-3,7,-14.670087385811385,-14.246869693367147,-13.800081295268907,-2.9145085363992185,13,12,13,6,-7,-7,-6,6,-21.47812274297139,-20.863913163649816,-20.22836857955774,-1.0564294220727064,730,730,Northwest Nebraska,Thomas,31,171,Nebraska,NE
31059,31CS013,68,67,68,71,3,3,4,13,-1.905658886107037,-1.8050003561855292,-1.7048736779524511,3.178567424339929,83,83,84,82,-1,-2,-1,2,-0.900649142190475,-0.741262061227382,-0.5730487345771955,-5.265552642327413,5499,5499,Saline and Nearby Counties,Fillmore,31,59,Nebraska,NE
31067,31CS013,232,222,241,252,20,11,30,25,-0.6554131696289544,-0.2169482971948234,0.224013898500308,1.174446796733748,283,272,294,330,47,36,58,30,0.3316007302468204,0.9052171736830719,1.5526635060906073,0.6284961208416191,21496,21496,Saline and Nearby Counties,Gage,31,67,Nebraska,NE
31095,31CS013,89,88,90,96,7,6,8,3,0.4526629079552709,0.560675751024271,0.6693920271797656,0.3767180169973579,109,108,110,123,14,13,15,10,0.47283597502767677,0.6289355871890029,0.802570671871961,0.6801142365018775,7053,7053,Saline and Nearby Counties,Jefferson,31,95,Nebraska,NE
31129,31CS013,52,52,53,70,18,17,18,12,1.2347570099555094,1.3460725970852006,1.4397755873355849,0.6462562065285496,64,64,65,62,-2,-3,-2,5,-2.2943137040123673,-2.124783007540112,-1.9807163535459298,-3.673851209189247,4144,4144,Saline and Nearby Counties,Nuckolls,31,129,Nebraska,NE
31151,31CS013,124,123,126,102,-22,-24,-21,2,-1.8070909928052583,-1.7078409499493232,-1.601412786999942,-0.09468960507385515,153,151,155,133,-20,-22,-18,8,-2.535479534893599,-2.3789357643656226,-2.2142678016514954,-0.4216908773231457,14108,14108,Saline and Nearby Counties,Saline,31,151,Nebraska,NE
31169,31CS013,66,66,67,65,-1,-2,-1,3,-0.9664902832765097,-0.8565911375933716,-0.7474333978010593,-13.964800975235015,81,81,82,95,14,13,14,8,1.2389995571799532,1.3981356204271944,1.554068138187958,0.5419504948416173,4939,4939,Saline and Nearby Counties,Thayer,31,169,Nebraska,NE
31153,31CS014,905,824,986,1136,231,150,312,116,0.15859537974434273,0.6199375774169777,1.0164183175759427,0.49960597695751924,1130,1032,1228,1298,168,70,266,105,-0.2512270843737294,0.38815017557814857,1.0275512815372865,0.6211677958895419,187711,187711,Sarpy,Sarpy,31,153,Nebraska,NE
31001,31CS015,266,253,280,337,71,57,84,47,0.3199379854097016,0.7546570617746593,1.1887041717217774,0.655603254220588,326,310,342,363,37,21,53,32,-0.4278937824177003,0.18488923357342238,0.8320254062600178,0.8383971310958724,31314,31314,South Central Nebraska,Adams,31,1,Nebraska,NE
31035,31CS015,59,58,60,74,15,14,16,12,0.38013724467811355,0.4788410191780318,0.5840130224027585,0.7515079533351733,72,71,73,83,11,10,12,11,-0.12537025523467213,0.022503552962795773,0.17420450972496473,0.9069581394368813,6218,6218,South Central Nebraska,Clay,31,35,Nebraska,NE
31061,31CS015,33,32,33,40,7,7,8,6,0.2921206361403914,0.4112643876858855,0.514144416234432,0.7307163406552752,40,40,40,65,25,25,25,7,7.224480932833913,7.3701683036784145,7.53109860802541,0.26835069464921696,2943,2943,South Central Nebraska,Franklin,31,61,Nebraska,NE
31065,31CS015,53,52,53,57,4,4,5,7,-0.6367149413481219,-0.5414048818717909,-0.4326258466671846,1.2795070398207735,64,63,65,79,15,14,16,10,1.1442677632561662,1.299574999731789,1.4434789239009358,0.6228435930363332,4675,4675,South Central Nebraska,Furnas,31,65,Nebraska,NE
31083,31CS015,34,34,35,37,3,2,3,3,-0.1996497982442827,-0.10250710911705803,0.00954119106110252,0.8190535998954884,42,41,42,62,20,20,21,2,6.367954205996192,6.524110751439074,6.6805130965898725,0.09435093814079275,3347,3347,South Central Nebraska,Harlan,31,83,Nebraska,NE
31137,31CS015,94,93,95,98,4,3,5,12,-1.021557429049721,-0.9087427519936551,-0.7947641805995943,2.4907010760143167,115,113,116,141,26,25,28,11,1.8939318493840838,2.0455051307197674,2.2030955772767093,0.40228650710323494,8997,8997,South Central Nebraska,Phelps,31,137,Nebraska,NE
31181,31CS015,49,48,49,54,5,5,6,7,-0.5870202368914732,-0.4835096819781225,-0.3874725486269945,1.1054421485145773,59,59,60,63,4,3,4,7,-1.2821409760682279,-1.1274791130745063,-0.9686447535387277,1.4687695584836662,3446,3446,South Central Nebraska,Webster,31,181,Nebraska,NE
31025,31CS016,199,188,210,266,67,56,78,17,1.4635774913055766,1.9120300952882325,2.3601938405099174,0.24990191362599518,244,230,257,265,21,8,35,22,-0.6118021934270307,-0.008004746485304349,0.5683270629195822,0.9779993266453928,26205,26205,Southeast Nebraska,Cass,31,25,Nebraska,NE
31097,31CS016,56,56,57,51,-5,-6,-5,4,-1.9809170650828112,-1.876577781808038,-1.770734532037226,-0.8920790141352039,69,69,70,67,-2,-3,-2,6,-2.110429466655762,-1.9698742640702132,-1.8141618407058528,-4.693428543407395,5053,5053,Southeast Nebraska,Johnson,31,97,Nebraska,NE
31127,31CS016,71,70,72,81,10,9,11,14,-0.6482326015082991,-0.543500644042934,-0.43168255618903123,1.2490774374680231,87,86,88,90,3,2,4,10,-1.3375176472994723,-1.1857481111234784,-1.0238048252138228,2.439893667777106,6985,6985,Southeast Nebraska,Nemaha,31,127,Nebraska,NE
31131,31CS016,154,147,161,148,-6,-13,1,4,-1.0493938332935095,-0.6150013466183558,-0.19756068691035927,-0.831262960660592,187,179,196,193,6,-3,14,14,-1.2124615600980801,-0.6374848108968981,-6.459322141499093e-4,2.1237542238033154,15981,15981,Southeast Nebraska,Otoe,31,131,Nebraska,NE
31133,31CS016,34,33,36,43,9,7,10,4,1.355945709107133,1.7319831298342334,2.1666037146464823,0.417638857372089,42,40,43,41,-1,-2,1,6,-3.6801026229242506,-3.0655596805240704,-2.4349344020615535,21.57140164096859,2623,2623,Southeast Nebraska,Pawnee,31,133,Nebraska,NE
31147,31CS016,97,97,98,129,32,31,32,18,1.6214197623335014,1.7302518360649428,1.8284071377621542,0.5537171714677865,119,118,120,131,12,11,13,12,-0.21919209387379898,-0.07211974520876191,0.08111400946044006,0.9580178572289003,7828,7828,Southeast Nebraska,Richardson,31,147,Nebraska,NE
31003,31CS017,62,61,63,75,13,12,14,10,0.36846737993255074,0.4730769936420646,0.5860044008845539,0.7135653077143816,76,75,76,82,6,6,7,7,-0.25786987756796836,-0.10941621700859237,0.052803900574448996,0.9416571830246383,6295,6295,Wheeler and Nearby Counties,Antelope,31,3,Nebraska,NE
31011,31CS017,54,54,55,62,8,7,8,5,0.3865350484995659,0.4996294944845266,0.6089326231300827,0.5841861960194206,66,66,67,82,16,15,16,5,2.3334439396466227,2.4878250139936036,2.640740113450934,0.3004449972533181,5143,5143,Wheeler and Nearby Counties,Boone,31,11,Nebraska,NE
31015,31CS017,27,26,28,33,6,5,7,6,-0.5064820798537782,-0.0647295202435544,0.3234946682515497,0.8747947482697741,33,32,34,38,5,4,6,2,1.2986792935031197,1.9234126290224096,2.4762751389488162,0.33185657910957306,1880,1880,Wheeler and Nearby Counties,Boyd,31,15,Nebraska,NE
31071,31CS017,29,28,29,23,-6,-6,-5,1,-3.721407649970423,-3.3337470812495034,-2.8863915625557466,-0.2214713262151686,35,34,36,40,5,4,6,4,0.20735388428726004,0.8202139566576734,1.3854494024870772,0.6324258540148558,1964,1964,Wheeler and Nearby Counties,Garfield,31,71,Nebraska,NE
31077,31CS017,25,24,25,27,2,2,3,7,-2.0796466707701406,-1.9664602414200971,-1.862472402110937,2.0686030465670857,30,30,30,28,-2,-2,-2,5,-3.7338945629901366,-3.5836300875306977,-3.43288544764238,-4.9749267258188175,2348,2348,Wheeler and Nearby Counties,Greeley,31,77,Nebraska,NE
31089,31CS017,105,104,106,112,7,6,8,17,-1.0914778134824428,-0.9833529454683259,-0.8764881728721258,2.09557349251414,128,127,129,123,-5,-6,-4,5,-1.3351558858658008,-1.1713395036886651,-1.0087796520192978,-1.2985359796381815,10031,10031,Wheeler and Nearby Counties,Holt,31,89,Nebraska,NE
31107,31CS017,89,88,89,104,15,15,16,12,0.31124466049619604,0.4190444036592418,0.5301593167542402,0.7281766897892282,108,107,109,122,14,13,15,12,0.15185001601677459,0.3087064489391793,0.4614262082114476,0.794502387958641,8323,8323,Wheeler and Nearby Counties,Knox,31,107,Nebraska,NE
31119,31CS017,315,300,330,327,12,-3,27,41,-1.2527160947179719,-0.8221222472176065,-0.4183019689072145,3.213322082485153,387,369,405,356,-31,-49,-13,24,-2.520334553846621,-1.8639688763676132,-1.180021794423253,-0.8119059203967157,34956,34956,Wheeler and Nearby Counties,Madison,31,119,Nebraska,NE
31139,31CS017,61,60,62,64,3,2,4,17,-2.0741801457346787,-1.9695769323800314,-1.873772390519358,4.378288857466166,75,74,75,82,7,7,8,4,0.41703906631190546,0.5849925969921507,0.7373710778127057,0.4724326335037084,7156,7156,Wheeler and Nearby Counties,Pierce,31,139,Nebraska,NE
31175,31CS017,44,44,45,41,-3,-4,-3,6,-2.3772948905259064,-2.270041692833759,-2.1626338516427963,-2.5645918426677987,54,54,55,73,19,18,19,4,4.217696191551487,4.365674700902301,4.534305317356737,0.20043290981079276,4111,4111,Wheeler and Nearby Counties,Valley,31,175,Nebraska,NE
31183,31CS017,11,11,12,6,-5,-6,-5,6,-15.11805386456984,-14.659213090622334,-14.23364633003391,-1.3340471397839766,14,14,14,5,-9,-9,-9,5,-22.018115077044634,-21.433820458028524,-20.824789234036732,-0.6246261013391956,784,784,Wheeler and Nearby Counties,Wheeler,31,183,Nebraska,NE
31023,31CS018,91,90,92,90,-1,-2,0,11,-1.5842448850725532,-1.4780088664099154,-1.3687570933369737,52.16528131971013,111,110,112,109,-2,-3,-1,6,-1.37468296124405,-1.2158836484103894,-1.0632351528411113,-5.526903785735385,7978,7978,York and Nearby Counties,Butler,31,23,Nebraska,NE
31081,31CS018,72,71,73,101,29,28,30,20,0.9150908413338094,1.020370209255649,1.1296324351192588,0.6566911006953716,88,87,89,112,24,23,25,1,2.8530495573758228,3.0052380307359785,3.1601367960812423,0.03965680750649496,9265,9265,York and Nearby Counties,Hamilton,31,81,Nebraska,NE
31143,31CS018,50,50,51,90,40,39,40,10,5.660291416192544,5.768741084191859,5.872870758640489,0.24483816183675222,61,61,62,63,2,1,2,3,-0.48989519530734194,-0.3297178009601929,-0.16817200038293015,1.16850792769914,5174,5174,York and Nearby Counties,Polk,31,143,Nebraska,NE
31159,31CS018,153,146,161,155,2,-6,9,23,-1.6675065305703738,-1.2149090221090508,-0.8036735263263404,8.185661951398084,186,177,195,177,-9,-18,-0,19,-2.5475646073878235,-1.9530779662027815,-1.3710022724476476,-2.345879014606326,17263,17263,York and Nearby Counties,Seward,31,159,Nebraska,NE
31185,31CS018,140,134,146,137,-3,-9,3,10,-1.3363260973045916,-0.9383149331926751,-0.5167622487363115,-5.6793110797121,169,163,176,179,10,3,16,11,-0.7122697989849675,-0.14441133592274316,0.4715242824865481,1.0462686776562424,13570,13570,York and Nearby Counties,York,31,185,Nebraska,NE
32005,32CS001,447,426,468,522,75,54,96,43,0.23383119714626355,0.6419270678508577,1.1070108553016451,0.5685449458162672,548,522,573,660,112,87,138,53,0.8899930518343532,1.4415371900550997,2.115842081086342,0.4678808492545486,49036,49036,Carson City (city)+Douglas,Douglas,32,5,Nevada,NV
32510,32CS001,680,655,704,786,106,82,131,68,0.27313500739849095,0.6874142056480731,1.1423951570287274,0.6328461601437123,828,799,857,985,157,128,186,110,0.3784268376703062,1.0034007045393654,1.6224260856011952,0.6960120105545312,55952,55952,Carson City (city)+Douglas,Carson City (city),32,510,Nevada,NV
32003,32CS002,15367,14372,16362,18083,2716,1721,3711,2428,-0.3247878831491042,0.11783474622698831,0.5681115357136827,0.8937606615389634,19142,17946,20339,22825,3683,2486,4879,3895,-0.7497675121794206,-0.10721636362043402,0.5692157675818057,1.0573420943744674,2292584,2292584,Clark+Nye,Clark,32,3,Nevada,NV
32023,32CS002,700,680,721,783,83,62,103,66,-0.10297116595717273,0.34325585372877093,0.7945117275560691,0.7873572006975583,856,831,881,1087,231,206,256,187,0.49720606017871116,1.1008068675656737,1.766599816042171,0.805980389088552,47349,47349,Clark+Nye,Nye,32,23,Nevada,NV
32001,32CS003,250,239,261,325,75,64,86,46,0.715772429091856,1.1562663715157102,1.58135899373377,0.6046202981560443,306,293,319,388,82,69,95,50,0.9417938874331009,1.5119072485092182,2.1567778571844025,0.600599832500294,25179,25179,Lyon and Nearby Counties,Churchill,32,1,Nevada,NV
32009,32CS003,11,10,11,6,-5,-5,-4,6,-12.488854283031417,-12.047109490709868,-11.61091541546702,-1.6830780017534623,13,12,13,12,-1,-1,-0,8,-12.748304372082284,-12.176981324625984,-11.570651989915616,73.05422624390096,877,877,Lyon and Nearby Counties,Esmeralda,32,9,Nevada,NV
32019,32CS003,564,539,589,699,135,110,160,61,0.8817060373144558,1.2776796326319995,1.7004807267672941,0.4498895604735712,691,661,721,892,201,171,231,108,1.3410907782780253,1.9434000955839412,2.539694111864812,0.5341769462088418,57841,57841,Lyon and Nearby Counties,Lyon,32,19,Nevada,NV
32021,32CS003,62,62,63,78,16,15,16,2,2.937264579274424,3.045003015184835,3.153736526875539,0.11934655301889752,76,76,77,87,11,10,11,14,-1.0167766528477284,-0.8567590826476389,-0.6900036809595506,1.189651511268871,4517,4517,Lyon and Nearby Counties,Mineral,32,21,Nevada,NV
32029,32CS003,34,34,35,36,2,1,2,5,-0.8335091252348824,-0.7294805971089684,-0.6179418432746795,1.7030522857588806,42,41,42,48,6,6,7,1,1.2940918322977746,1.4506445384739757,1.6096691354884203,0.14126973701589832,4199,4199,Lyon and Nearby Counties,Storey,32,29,Nevada,NV
32007,32CS004,279,256,302,340,61,38,84,42,-0.0769483348991595,0.3536238850921414,0.802260526842838,0.6793345808450434,348,321,376,506,158,130,185,101,0.6679014008585422,1.2994871058188828,1.9434401627313846,0.6361153454429531,52932,52932,"Northern Nevada, excluding Washoe",Elko,32,7,Nevada,NV
32011,32CS004,14,13,14,11,-3,-3,-2,6,-4.269222875886209,-4.154911949885409,-4.054374743654709,-3.7068160334508695,17,17,17,28,11,11,11,1,5.736313630933016,5.889025169731641,6.04181627445128,0.0821141684195874,2073,2073,"Northern Nevada, excluding Washoe",Eureka,32,11,Nevada,NV
32013,32CS004,128,121,135,124,-4,-11,3,10,-1.2333028876902092,-0.8267483375330342,-0.4074366772162061,-3.373227001512922,158,149,167,207,49,40,58,36,0.2875344834707583,0.9402482694097577,1.5645376540998028,0.7174805100826189,16916,16916,"Northern Nevada, excluding Washoe",Humboldt,32,13,Nevada,NV
32015,32CS004,42,41,43,55,13,12,14,4,1.523417963080201,1.6273754790008053,1.7301414212607966,0.28588245594117445,52,51,53,70,18,17,19,12,1.1955167257229489,1.3484571475206089,1.5059933120397273,0.6243466655449547,5515,5515,"Northern Nevada, excluding Washoe",Lander,32,15,Nevada,NV
32017,32CS004,44,44,45,51,7,6,7,3,0.6196405590649896,0.7280440967360601,0.8321707182183627,0.38612436497162345,54,54,55,63,9,8,9,1,1.611186816712664,1.755706407709132,1.9029116963976056,0.1046039325204031,5171,5171,"Northern Nevada, excluding Washoe",Lincoln,32,17,Nevada,NV
32027,32CS004,47,46,47,54,7,7,8,11,-0.6660196374392089,-0.5621990484736541,-0.46333594400696565,1.327564172782396,58,57,59,86,28,27,29,19,1.5432105650546997,1.6969587021551293,1.854225618941979,0.6471182069077216,6605,6605,"Northern Nevada, excluding Washoe",Pershing,32,27,Nevada,NV
32033,32CS004,77,76,78,79,2,1,3,0,0.11769127979877204,0.2245748779411566,0.33088880159891687,0,95,93,96,105,10,9,12,18,-1.1346192568308429,-0.9696582466753324,-0.8254215213461399,1.5905598765048223,9473,9473,"Northern Nevada, excluding Washoe",White Pine,32,33,Nevada,NV
32031,32CS005,3439,3234,3644,3998,559,354,764,441,-0.15222499095442438,0.24820032775867312,0.6671904441480665,0.7878251612380048,4228,3982,4475,4847,619,372,865,522,-0.34099773377808834,0.2497965717460885,0.888680948410094,0.842318180603068,474340,474340,Washoe,Washoe,32,31,Nevada,NV
33001,33CS001,639,612,665,697,58,32,85,44,-0.20782292587425455,0.241641555266592,0.6682165249800364,0.7424443013952404,784,752,815,823,39,8,71,80,-1.442031947113291,-0.7923406329581842,-0.15192210882209436,1.982353447957791,61462,61462,Belknap+Carroll,Belknap,33,1,New Hampshire,NH
33003,33CS001,494,473,515,489,-5,-26,16,3,-0.5829343631007692,-0.15408767736285056,0.25082292307496756,-0.7830053765332936,607,581,632,611,4,-21,30,36,-1.3859486896020894,-0.776646827283442,-0.15329427909964688,6.678528352117324,48921,48921,Belknap+Carroll,Carroll,33,3,New Hampshire,NH
33005,33CS002,643,610,676,631,-12,-45,21,6,-0.679772810442787,-0.22790748228053875,0.19732479232660205,-0.5381316116313994,790,751,830,900,110,70,149,76,-0.06626081393254464,0.524958054522854,1.1424248906003522,0.6877777558045,76025,76025,Cheshire,Cheshire,33,5,New Hampshire,NH
33007,33CS003,382,368,395,402,20,7,34,20,-0.40296315717575476,0.010439977081513773,0.4273433231477924,0.9386081868359092,466,450,482,573,107,91,123,62,1.1012634375050037,1.7297083611775224,2.2940714535878963,0.5734793067346592,31318,31318,Coos+Grafton,Coos,33,7,New Hampshire,NH
33009,33CS003,739,700,778,734,-5,-44,34,11,-0.5672970717688862,-0.18717717700984565,0.23350103879839126,-2.522943810185319,911,864,958,935,24,-23,71,44,-0.9077206825546249,-0.24717130042204835,0.35911292189385613,1.7783104101024791,90503,90503,Coos+Grafton,Grafton,33,9,New Hampshire,NH
33011,33CS004,2977,2797,3157,3420,443,263,623,412,-0.3681406098160338,0.07524527468374728,0.48273243792712,0.9282006795252665,3668,3451,3884,3961,293,77,510,297,-0.614858430194166,-0.023704305772480234,0.6233950152465839,1.0093375435087726,418153,418153,Hillsborough,Hillsborough,33,11,New Hampshire,NH
33013,33CS005,1226,1160,1291,1280,54,-11,120,58,-0.45922429927802433,-0.017679935499965133,0.3893477376828705,1.045292746191649,1506,1427,1585,1560,54,-25,133,101,-0.9479821855281598,-0.3672593627601257,0.25177045670105636,1.8357337114492853,152029,152029,Merrimack+Sullivan,Merrimack,33,13,New Hampshire,NH
33019,33CS005,391,372,410,405,14,-5,33,3,-0.20329696607903008,0.24444369211775027,0.6728253126383381,0.20085338883696865,479,457,501,516,37,15,59,45,-0.822963680580277,-0.23111619186586202,0.4210071089666843,1.1863310479289975,43265,43265,Merrimack+Sullivan,Sullivan,33,19,New Hampshire,NH
33015,33CS006,2202,2068,2336,2461,259,125,393,183,-0.1827069840621707,0.23973750606749802,0.687247419095795,0.7042449963280828,2715,2554,2876,2969,254,93,415,256,-0.6411074055158811,-0.010786148228893103,0.6475291705929463,1.0042076947728595,310339,310339,Rockingham,Rockingham,33,15,New Hampshire,NH
33017,33CS007,1003,947,1060,1019,16,-41,72,26,-0.49705747231678366,-0.08278314305901903,0.33458034718736873,1.5595807300181599,1237,1169,1305,1338,101,33,169,114,-0.7325553303502118,-0.13678083270198577,0.49440677920890946,1.116263599926666,131056,131056,Strafford,Strafford,33,17,New Hampshire,NH
34001,34CS001,2332,2219,2445,2830,498,385,611,286,0.3762333947230195,0.8249283833707215,1.2200012136048826,0.5728785519523497,2862,2727,2998,3402,540,404,675,413,-0.08477535437859358,0.5659631276190984,1.166830569996105,0.7640624693871536,263358,263358,Atlantic,Atlantic,34,1,New Jersey,NJ
34003,34CS002,6174,5773,6574,8114,1940,1540,2341,1962,-0.4575345014351156,-0.022986775253022784,0.39330880408887614,1.0106898338590908,7619,7138,8100,7612,-7,-488,474,626,-1.4137196320841212,-0.8183294541042134,-0.24318758973569177,-103.30488937095676,931480,931480,Bergen,Bergen,34,3,New Jersey,NJ
34005,34CS003,3513,3321,3705,4075,562,370,754,523,-0.3170349675556396,0.08410951277320682,0.4741973980984398,0.9286313635751986,4317,4086,4547,4556,239,9,470,341,-0.8553847050583199,-0.2639842845718411,0.3819123167704104,1.4190026231956814,446342,446342,Burlington,Burlington,34,5,New Jersey,NJ
34007,34CS004,4145,3927,4363,5018,873,655,1091,700,-0.06890373327678301,0.3393942890558044,0.7738356292566934,0.801173690401202,5101,4839,5363,5642,541,279,803,516,-0.511501516495644,0.07376353689060178,0.6957621020818476,0.9524665728018377,506630,506630,Camden,Camden,34,7,New Jersey,NJ
34009,34CS005,1091,1052,1131,1224,133,93,172,112,-0.1611325923666142,0.21590830665210417,0.6642692599548821,0.8364426214900258,1332,1285,1380,1436,104,56,151,97,-0.5372114817699783,0.07116711588539992,0.7041588281458364,0.9269573565025766,91955,91955,Cape May,Cape May,34,9,New Jersey,NJ
34011,34CS006,1315,1252,1378,1630,315,252,378,180,0.5042615772709699,0.915777228496874,1.3368093362492535,0.5695073077355418,1613,1537,1689,1920,307,231,383,239,-0.03175546620005355,0.5457433226710773,1.1717211279275885,0.7766040640548071,148167,148167,Cumberland,Cumberland,34,11,New Jersey,NJ
34013,34CS007,5109,4764,5453,7733,2624,2280,2969,2055,0.268922827380388,0.7177375673738303,1.1256209166289977,0.7827446191253589,6306,5892,6719,6760,454,41,868,721,-1.0388674059250231,-0.4058072136368117,0.2274103966180827,1.5838855078954905,801470,801470,Essex,Essex,34,13,New Jersey,NJ
34015,34CS008,2333,2207,2459,2802,469,343,595,343,-0.01079943670862163,0.4429461225946699,0.8697676298389899,0.729983208334069,2874,2723,3026,3183,309,157,460,321,-0.6863820442031362,-0.027482865309808105,0.5207319882142223,1.0358405335304313,292427,292427,Gloucester,Gloucester,34,15,New Jersey,NJ
34017,34CS009,3219,2930,3508,5136,1917,1628,2206,1511,0.15031813215260798,0.6036822793663581,1.0372080636059857,0.7877999797164187,4006,3659,4353,4532,526,179,873,635,-0.8160415332272631,-0.1979880793670545,0.3956300262162402,1.2051937753200874,673045,673045,Hudson,Hudson,34,17,New Jersey,NJ
34019,34CS010,770,716,824,925,155,101,209,144,-0.33773358889495886,0.08934061983374796,0.5260769236441906,0.9238925059464171,952,887,1016,996,44,-20,109,66,-0.8015341477648246,-0.21117093402322937,0.38567224101839837,1.4565176316126578,125033,125033,Hunterdon,Hunterdon,34,19,New Jersey,NJ
34021,34CS011,2479,2321,2637,3247,768,610,926,607,0.023383029822281652,0.4483528200556145,0.8411105638854623,0.7896886061701459,3058,2868,3248,3438,380,190,570,296,-0.35437872838282136,0.2699429885460929,0.8779045711221262,0.7767500765277808,367710,367710,Mercer,Mercer,34,21,New Jersey,NJ
34023,34CS012,5070,4716,5424,6749,1679,1325,2033,1445,-0.15493003378211417,0.2836223544782137,0.6901200168934833,0.8600510002930406,6270,5845,6695,6779,509,84,934,741,-0.9832913733968578,-0.3409575481117822,0.27449917973508464,1.453613941429242,823703,823703,Middlesex,Middlesex,34,23,New Jersey,NJ
34025,34CS013,4725,4459,4991,5879,1154,888,1420,937,-0.07318138489875255,0.34303067961700046,0.7856445787739914,0.811270172457798,5822,5503,6141,6320,498,179,817,647,-0.8588988661180974,-0.2728934132743994,0.30814944125438165,1.296565959512639,619143,619143,Monmouth,Monmouth,34,25,New Jersey,NJ
34027,34CS014,3284,3073,3496,4288,1004,792,1215,829,-0.07443406517502549,0.3626412222794845,0.7577158020715542,0.8250527461915027,4057,3803,4310,4197,140,-113,394,314,-1.0347788150320054,-0.4293374378582355,0.17877330462516708,2.220528007927477,491373,491373,Morris,Morris,34,27,New Jersey,NJ
34029,34CS015,6344,6080,6608,7343,999,735,1263,1136,-0.6324379788421463,-0.22807705711233628,0.2174670126047953,1.1356203327314909,7754,7436,8071,8281,527,210,845,891,-1.3396677053982546,-0.7378645856486905,-0.08300811332024426,1.6867383681081825,610306,610306,Ocean,Ocean,34,29,New Jersey,NJ
34031,34CS016,3174,2959,3389,4800,1626,1411,1841,1352,0.1465815656784304,0.5546114855629015,0.9736226973766361,0.8309226665248771,3922,3663,4180,4211,289,31,548,514,-1.1410007708704188,-0.5378480301101195,0.06822240725709934,1.7716281961794262,501231,501231,Passaic,Passaic,34,31,New Jersey,NJ
34033,34CS017,630,603,656,789,159,133,186,94,0.5950445932564382,1.041936854883283,1.4789331517304007,0.5858742992400321,771,739,803,911,140,108,172,98,0.20815880743588128,0.8015962418780178,1.3814673708997485,0.6946262166597778,62387,62387,Salem,Salem,34,33,New Jersey,NJ
34035,34CS018,2059,1917,2200,2624,565,424,707,525,-0.3496110434554143,0.11099770376815273,0.5460920403443589,0.9268162681297631,2546,2376,2716,2636,90,-80,260,218,-1.0795399863348125,-0.48283148010657834,0.20863714440963332,2.3855353172870393,329720,329720,Somerset,Somerset,34,35,New Jersey,NJ
34037,34CS019,1053,993,1113,1321,268,208,328,217,-0.05553189485734964,0.35699783935020574,0.8274093877974155,0.8065116420552455,1299,1227,1371,1477,178,106,250,122,-0.14063587063532873,0.4643858540239287,1.0964126720512672,0.6815517679402405,140415,140415,Sussex,Sussex,34,37,New Jersey,NJ
34039,34CS020,3397,3158,3636,5073,1676,1437,1915,1389,0.07651624799031918,0.5226763584637664,0.9055461530706564,0.8281506922350855,4198,3911,4484,4416,218,-68,505,480,-1.209304138081223,-0.5483502151856485,-0.0022632819375500704,2.1868310546089047,556135,556135,Union,Union,34,39,New Jersey,NJ
34041,34CS021,871,825,916,1062,191,146,237,150,-0.0471084384013262,0.38804877303956,0.831088426502521,0.7804116691776573,1069,1015,1124,1192,123,68,177,106,-0.44396545871274173,0.19328957692963963,0.8213369935590936,0.8559581111265002,105525,105525,Warren,Warren,34,41,New Jersey,NJ
35001,35CS001,4965,4672,5258,6092,1127,834,1420,602,0.33506138767037447,0.7694049802046241,1.2056791469838162,0.5336822602481974,6125,5773,6477,7313,1188,836,1540,797,0.08703293468694402,0.6704415085878491,1.3255901566964607,0.6702683137350857,680359,680359,Bernalillo,Bernalillo,35,1,New Mexico,NM
35003,35CS002,37,36,39,38,1,-1,2,4,-1.3886467479741291,-0.9634195251794029,-0.5253795136683294,2.434822488253405,46,44,48,71,25,23,27,10,4.504677383671677,5.13655626263446,5.800646111109911,0.3806111330489445,3555,3555,Catron+Cibola+Sierra+Socorro,Catron,35,3,New Mexico,NM
35006,35CS002,215,203,226,321,106,95,118,69,0.9696894261741658,1.4096527172083049,1.8326783057225877,0.64371900639663,263,250,277,390,127,113,140,85,1.2477603077152448,1.8786717884138708,2.4886521045839913,0.6647791343049643,26545,26545,Catron+Cibola+Sierra+Socorro,Cibola,35,6,New Mexico,NM
35051,35CS002,207,203,212,264,57,52,61,42,0.9222411963552103,1.354631605666073,1.7837402514470793,0.7291385851918831,251,246,257,275,24,18,29,29,-1.1567614661636387,-0.5675368311213019,0.003272917389239652,1.1677537135298417,10878,10878,Catron+Cibola+Sierra+Socorro,Sierra,35,51,New Mexico,NM
35053,35CS002,151,143,158,194,43,36,51,48,-0.7031183837324303,-0.274204454284505,0.17059113530181688,1.0795632440051297,184,176,193,220,36,27,44,30,-0.18299778642149306,0.41811928195231984,1.0464326806393365,0.8133921935478018,16583,16583,Catron+Cibola+Sierra+Socorro,Socorro,35,53,New Mexico,NM
35005,35CS003,567,539,594,734,167,140,195,106,0.5255311804376829,0.9476813090042271,1.3580569824947404,0.6295563635516167,696,663,730,842,146,112,179,142,-0.5544904212696002,0.07219007532871627,0.7001467537083006,0.9685722981230009,64638,64638,Chaves,Chaves,35,5,New Mexico,NM
35009,35CS004,352,331,373,400,48,27,69,57,-0.6050215584868931,-0.1838726457321642,0.26687305441183007,1.158093785638355,434,408,459,551,117,92,143,102,-0.2332969993780448,0.387511990738855,1.0122085359779676,0.8609915996061877,48962,48962,Curry+Roosevelt,Curry,35,9,New Mexico,NM
35041,35CS004,140,132,148,162,22,14,30,40,-1.4233999020125654,-0.9920247167563276,-0.5510772911572533,1.7589199181043544,173,163,182,219,46,37,56,47,-0.6370307305250514,-0.05277498846165112,0.52839370868729,0.9906844216941537,18438,18438,Curry+Roosevelt,Roosevelt,35,41,New Mexico,NM
35013,35CS005,1397,1302,1493,1984,587,491,682,329,0.7220718395751972,1.1612658282732433,1.6247806968388434,0.5599354553683373,1731,1617,1846,2307,576,461,690,323,0.7982767825363875,1.4011783395182964,2.039085756051799,0.5601772676437484,219863,219863,Do�a Ana,Do�a Ana,35,13,New Mexico,NM
35015,35CS006,503,478,528,534,31,6,56,77,-1.1934508572451992,-0.772782153889207,-0.3369884427664918,2.3840367330471492,618,588,648,785,167,137,197,149,-0.2717889211888167,0.3582710088371398,0.9924342009258454,0.8879505197700975,58404,58404,Eddy,Eddy,35,15,New Mexico,NM
35017,35CS007,292,281,304,374,82,70,93,23,1.7514656365207388,2.179772506934878,2.6561932916181394,0.277542271153168,359,345,373,424,65,51,79,58,-0.30631557228699596,0.3437069860837997,0.8908815464495918,0.8732436774721714,26968,26968,Grant+Hidalgo+Luna,Grant,35,17,New Mexico,NM
35023,35CS007,45,45,46,47,2,1,2,6,-1.176374868374286,-1.0732419413174268,-0.9677848737433783,2.3710256571235546,56,55,57,61,5,4,6,7,-0.7125964696443017,-0.565340826553068,-0.39556050636125045,1.1594780109630183,4163,4163,Grant+Hidalgo+Luna,Hidalgo,35,23,New Mexico,NM
35029,35CS007,259,249,270,337,78,67,88,59,0.3509532787302153,0.7811213678316029,1.2336140005186098,0.7506623352691807,318,306,331,421,103,90,115,57,1.6312546554785798,2.2742114860629563,2.912830776270846,0.5505457445619388,23829,23829,Grant+Hidalgo+Luna,Luna,35,29,New Mexico,NM
35011,35CS008,21,21,21,28,7,7,7,7,-0.27663181041791257,-0.16986535512524925,-0.06025747432746306,0.9078918389017662,26,26,26,38,12,12,12,6,3.9773985178387914,4.134414989132617,4.285630808005503,0.46514964312627083,1713,1713,Guadalupe and Nearby Counties,De Baca,35,11,New Mexico,NM
35019,35CS008,41,40,41,55,14,14,15,5,2.0728235395079446,2.1847482247751717,2.2783684281749923,0.3262199918654892,50,49,51,58,8,7,9,4,0.9685599146335355,1.1259113005318921,1.2867288930529583,0.4436981564787568,4277,4277,Guadalupe and Nearby Counties,Guadalupe,35,19,New Mexico,NM
35027,35CS008,202,193,211,208,6,-3,15,18,-1.0571689739653078,-0.6062603017729048,-0.15999564718149592,2.5927366130015197,248,238,259,317,69,58,79,40,1.159312013255512,1.7384925057553318,2.3556276957063536,0.5750340072221329,19817,19817,Guadalupe and Nearby Counties,Lincoln,35,27,New Mexico,NM
35037,35CS008,99,99,100,140,41,40,41,10,3.6156296637797043,3.7185520919800275,3.8231781257407524,0.2404712798315527,122,121,123,173,51,50,52,39,1.6210459595358697,1.7663325288569562,1.9258331043047325,0.74867626661771,8224,8224,Guadalupe and Nearby Counties,Quay,35,37,New Mexico,NM
35057,35CS008,146,139,152,151,5,-1,12,10,-0.71395079693674,-0.31412572737389605,0.12753211679835422,1.5834249657071613,179,171,187,234,55,47,63,45,0.19120411202434953,0.7480108145821236,1.383504027286859,0.8083658932937436,15460,15460,Guadalupe and Nearby Counties,Torrance,35,57,New Mexico,NM
35025,35CS009,487,456,517,604,117,87,148,134,-0.6539928029383243,-0.22625226826556846,0.17008175236636916,1.1311719686006363,603,566,640,742,139,102,176,163,-0.9849470608013923,-0.41509829479612437,0.24218828192082867,1.1650664952226018,71418,71418,Lea,Lea,35,25,New Mexico,NM
35028,35CS010,117,115,119,116,-1,-3,1,5,-0.4301021934686583,-0.31995972424357416,-0.21805684801791575,-21.762286179856186,144,142,147,139,-5,-8,-3,10,-1.0979476843185723,-0.9482854618619252,-0.7847748895746725,-2.3535009760127505,19416,19416,Los Alamos+Santa Fe,Los Alamos,35,28,New Mexico,NM
35049,35CS010,1053,987,1118,1215,162,97,228,87,0.07886305228909589,0.49558174779604314,0.9288433670924382,0.5323324605541125,1297,1219,1376,1582,285,206,363,133,0.5977066320375284,1.203694345771501,1.7659299836900897,0.46583837908621767,151366,151366,Los Alamos+Santa Fe,Santa Fe,35,49,New Mexico,NM
35031,35CS011,560,553,568,1056,496,488,503,374,1.6019087954290356,1.7099344192209116,1.8112718502627634,0.7530168033834977,690,680,699,1008,318,309,328,179,2.1909534951587393,2.3513233888253167,2.4907464153587626,0.5603305895528611,71206,71206,McKinley,McKinley,35,31,New Mexico,NM
35007,35CS012,120,119,122,150,30,28,31,30,-0.1382192292770281,-0.0323777179516299,0.07633046101733527,0.9800267298504431,148,146,150,176,28,26,30,32,-0.5683005596144309,-0.40707944821959335,-0.24347307966571485,1.1052095341691357,12009,12009,Northeast New Mexico,Colfax,35,7,New Mexico,NM
35021,35CS012,9,9,9,12,3,3,3,5,-3.570009456224435,-3.466134813603324,-3.3601105176667283,1.3185370611177305,11,11,11,14,3,3,3,2,1.1983005228092132,1.3428317401157808,1.5026829189172124,0.538420620851342,637,637,Northeast New Mexico,Harding,35,21,New Mexico,NM
35033,35CS012,44,42,45,43,-1,-2,1,4,-1.4190780590719003,-1.0037344905745993,-0.5605486974395575,8.008380664389433,53,51,55,56,3,1,5,8,-1.9961599468864584,-1.3467380351772917,-0.765575224190875,2.0858419727306527,4485,4485,Northeast New Mexico,Mora,35,33,New Mexico,NM
35047,35CS012,244,232,255,264,20,9,32,10,-0.020001941358854167,0.377103212175991,0.8005922915398215,0.4698911636768994,298,284,312,391,93,79,107,45,1.5043011710126466,2.104780677466619,2.7097629629731093,0.47974529877330013,27257,27257,Northeast New Mexico,San Miguel,35,47,New Mexico,NM
35059,35CS012,39,37,41,48,9,7,11,3,1.0302093482472658,1.4559367714950704,1.8773759729618549,0.30348451501295653,48,46,50,55,7,5,9,6,-0.24845141379915223,0.3846752838934699,0.9556902420199643,0.7315549784377994,4036,4036,Northeast New Mexico,Union,35,59,New Mexico,NM
35035,35CS013,542,512,571,640,98,69,128,45,0.38522325324886225,0.789440886263604,1.2105926946937298,0.45285553223221964,665,630,700,850,185,150,220,122,0.47167398884576683,1.0838083096630482,1.7446150871930053,0.6556557457490846,67737,67737,Otero,Otero,35,35,New Mexico,NM
35039,35CS014,353,337,370,438,85,68,101,45,0.6109564030992312,1.015881212465191,1.4583556515603744,0.5263045383034436,433,413,452,594,161,142,181,70,2.189805896750163,2.8457914810616374,3.4797861576982103,0.43086492637568735,38732,38732,Rio Arriba+Taos,Rio Arriba,35,39,New Mexico,NM
35055,35CS014,268,254,282,344,76,62,90,44,0.5568023505505311,0.9788592027425045,1.3969082790465617,0.5746436466592383,329,312,346,422,93,76,110,36,1.4772279759899578,2.0815506881809545,2.708896150830565,0.38430914784260745,32686,32686,Rio Arriba+Taos,Taos,35,55,New Mexico,NM
35043,35CS015,1025,961,1089,1237,212,148,276,153,-0.008688982698603999,0.4012382543835995,0.8499421705053535,0.7191143402233697,1270,1193,1347,1536,266,189,343,177,0.12950823041742124,0.7104632177313668,1.322965200663361,0.6628953229053587,147820,147820,Sandoval,Sandoval,35,43,New Mexico,NM
35045,35CS016,918,865,971,1336,418,365,471,327,0.3125843354648247,0.7140957176492203,1.17971322095866,0.7809680095207847,1135,1072,1199,1696,561,497,624,369,1.1989107303261288,1.8568753072944004,2.4613675162437425,0.6568668674787471,123729,123729,San Juan,San Juan,35,45,New Mexico,NM
35061,35CS017,606,573,639,740,134,101,167,73,0.3657433024599494,0.7792507503563517,1.1940795456101352,0.5410613530707251,748,707,788,954,206,166,247,142,0.38208610945351096,1.015618240177394,1.64176713936823,0.6844711211845695,77212,77212,Valencia,Valencia,35,61,New Mexico,NM
36001,36CS001,2318,2187,2449,2634,316,185,447,209,-0.07681548267935409,0.37130806878145306,0.815994351599305,0.659088012812278,2847,2690,3004,3188,341,184,498,256,-0.28669903964972415,0.34061865567056043,0.9872282778571487,0.7487098897077635,304294,304294,Albany+Greene,Albany,36,1,New York,NY
36039,36CS001,442,422,463,461,19,-2,39,28,-0.6111317082071103,-0.18145624875609928,0.2368876566227847,1.418459597336413,541,517,565,653,112,88,136,67,0.5459650618727395,1.1417626257063929,1.742338371392933,0.5929536606886652,47197,47197,Albany+Greene,Greene,36,39,New York,NY
36003,36CS002,412,393,432,474,62,42,81,69,-0.5883643112703055,-0.14914200288316706,0.28200143043480025,1.0978682823534869,506,483,530,562,56,32,79,81,-1.2538255514671335,-0.6463532732416757,-0.0899783642689169,1.430252249477907,45778,45778,Allegany+Steuben,Allegany,36,3,New York,NY
36101,36CS002,863,822,903,972,109,69,150,123,-0.5917646716637032,-0.1331317163277695,0.2829702417869524,1.1141097652494545,1060,1011,1108,1267,207,159,256,145,0.17549204783801256,0.7983652340143343,1.4221365126568999,0.6957557253852831,95048,95048,Allegany+Steuben,Steuben,36,101,New York,NY
36005,36CS003,8030,7426,8633,14136,6106,5503,6710,4277,0.892693505385584,1.2957449343300627,1.755046837180155,0.7003182198866086,9944,9220,10668,11761,1817,1093,2541,1456,-0.27745628215906604,0.2865547202725349,0.9258965540625841,0.8009820567215632,1411085,1411085,Bronx,Bronx,36,5,New York,NY
36007,36CS004,1771,1689,1852,2054,283,202,365,211,-0.06228365122975372,0.39839928890187004,0.798431863481586,0.7424267140900468,2169,2072,2267,2510,341,243,438,298,-0.35008599098842,0.26699045012899936,0.9015840292399256,0.8723783493469691,190188,190188,Broome,Broome,36,7,New York,NY
36009,36CS005,714,681,746,789,75,43,108,53,-0.1411696135319301,0.2929777661187898,0.7103091964408165,0.6952977864338027,873,834,913,1156,283,243,322,161,1.3051148355421494,1.917348410897711,2.5527435933749403,0.5676324035474302,76077,76077,Cattaraugus+Wyoming,Cattaraugus,36,9,New York,NY
36121,36CS005,319,302,336,373,54,37,71,28,0.2414212897233451,0.6564130100653953,1.0787952292323288,0.506845603303309,391,371,412,428,37,16,57,54,-1.1418808304941237,-0.5130299348768688,0.0907712592196143,1.425719977243215,39694,39694,Cattaraugus+Wyoming,Wyoming,36,121,New York,NY
36011,36CS006,643,611,676,759,116,83,148,29,0.704248698790322,1.1420160371866934,1.5835232513354667,0.2487649155360094,788,749,827,940,152,113,191,111,0.0476745153356508,0.6372927743881291,1.193136476804478,0.7248781434904052,76275,76275,Cayuga,Cayuga,36,11,New York,NY
36013,36CS007,1267,1213,1321,1291,24,-30,78,41,-0.5585136488063386,-0.1408626563068386,0.3305333216854523,1.6456844251114566,1549,1484,1614,1873,324,259,389,286,-0.2247541516917696,0.38724383965947,0.9716082397081881,0.8796487567952953,126384,126384,Chautauqua,Chautauqua,36,13,New York,NY
36015,36CS008,853,818,889,942,89,53,124,100,-0.5581594506067652,-0.1405228265685416,0.3027967870710768,1.1139891853738209,1046,1003,1088,1138,92,50,135,123,-1.0518351271532562,-0.4455831303825307,0.1769611212493091,1.3173426520602851,83078,83078,Chemung,Chemung,36,15,New York,NY
36017,36CS009,485,465,505,519,34,14,54,29,-0.3189833206256868,0.11887744677234154,0.5742811133272521,0.8202851388037289,591,566,615,698,107,83,132,83,-0.027942054600444157,0.6046534492933101,1.2552528002575538,0.7657169979036922,47024,47024,Chenango+Cortland,Chenango,36,17,New York,NY
36023,36CS009,377,357,397,425,48,28,68,28,-0.011629454047629896,0.42379379097439906,0.8531897388317121,0.569455609298926,462,437,486,556,94,70,119,54,0.45065732040895723,1.0207442072685284,1.577537940926147,0.5663654004482623,47311,47311,Chenango+Cortland,Cortland,36,23,New York,NY
36019,36CS010,620,586,654,676,56,22,90,10,0.1402769176448389,0.5758863737592337,0.9671096973819159,0.17555429117103066,765,724,806,866,101,60,142,57,0.0631539967597464,0.6650508951666994,1.2747115275117424,0.5591887501138246,79926,79926,Clinton,Clinton,36,19,New York,NY
36021,36CS011,570,545,596,579,9,-17,34,44,-1.0141586623647931,-0.5915810970139459,-0.17912424649421865,4.6079053692170016,697,667,728,762,65,34,95,65,-0.6468586556664345,3.762637898077312e-4,0.6360037810489282,0.9923488562061612,59562,59562,Columbia,Columbia,36,21,New York,NY
36025,36CS012,449,431,468,476,27,8,45,23,-0.35471651285693756,0.07776387914455181,0.4978082025436669,0.8348924354067447,551,529,574,673,122,99,144,70,0.7582177382210341,1.4211678307704398,2.024255260952706,0.5713941928159532,44182,44182,Delaware+Schoharie,Delaware,36,25,New York,NY
36095,36CS012,256,243,270,258,2,-12,15,2,-0.48156652808426087,-0.0038684511764221514,0.4361591390781859,0.7053194447347783,316,300,332,357,41,25,57,33,-0.3411779175532193,0.2704883156171103,0.9246716075113316,0.7929613185731723,31085,31085,Delaware+Schoharie,Schoharie,36,95,New York,NY
36027,36CS013,2163,2037,2289,2497,334,208,460,264,-0.18349385430598797,0.2556075246681646,0.6710155443977135,0.7879624077275617,2668,2517,2820,3136,468,316,619,335,-0.08940455290980047,0.5381196517929213,1.1714396909382987,0.7145308527961751,293667,293667,Dutchess,Dutchess,36,27,New York,NY
36029,36CS014,8239,7844,8634,9465,1226,831,1621,1189,-0.39289538061248835,0.045252894439838494,0.5018502013101613,0.9690577705712371,10085,9611,10559,10896,811,337,1285,1200,-1.1127731380243702,-0.5066889299547708,0.1431508640380954,1.4773804494955838,918158,918158,Erie,Erie,36,29,New York,NY
36031,36CS015,362,346,378,403,41,25,57,3,0.6044138098376094,1.0328860350138716,1.4681236275461162,0.07102699389945283,443,424,462,490,47,28,66,33,-0.1744242987696202,0.4717694269724036,1.096246893357267,0.6816572611796506,36947,36947,Essex+Franklin,Essex,36,31,New York,NY
36033,36CS015,398,376,419,413,15,-6,37,11,-0.36626011196398905,0.08896267513394847,0.523162194622345,0.6673323437893504,489,463,514,546,57,32,83,37,-0.15901943777366398,0.5066789134524414,1.09216496247795,0.6326365620077914,50045,50045,Essex+Franklin,Franklin,36,33,New York,NY
36035,36CS016,511,488,534,565,54,31,77,48,-0.3092513355073149,0.10725265900074972,0.5239736608429706,0.8710499848945272,626,599,654,803,177,149,204,117,0.7445462375214462,1.3681977850423852,1.9725053316132157,0.6585622448313957,53118,53118,Fulton+Hamilton,Fulton,36,35,New York,NY
36041,36CS016,50,50,51,64,14,13,14,2,2.5268463102349616,2.6273713087470023,2.7306129791846465,0.1373754558615365,62,61,63,79,17,16,18,4,3.391207017932636,3.5502389077547867,3.7037926819911275,0.22206295680194185,4399,4399,Fulton+Hamilton,Hamilton,36,41,New York,NY
36037,36CS017,530,505,554,607,77,53,102,57,-0.07319696521280718,0.3443667932645246,0.7744780233730383,0.7262373104029469,651,621,680,734,83,54,113,121,-1.4258260382377026,-0.7963114603318971,-0.19163353579694503,1.4357960621773618,57239,57239,Genesee+Orleans,Genesee,36,37,New York,NY
36073,36CS017,354,337,371,418,64,47,81,49,-0.022039824867460815,0.3721819428425621,0.7737297795261886,0.7560138918624951,436,415,456,487,51,31,72,52,-0.6224700839665392,-0.020307904821898107,0.5531007322878051,0.9943488317190716,40196,40196,Genesee+Orleans,Orleans,36,73,New York,NY
36043,36CS018,566,540,593,609,43,16,69,35,-0.3069066898137695,0.1129986086046132,0.5425141323054636,0.8038737872283963,691,659,722,834,143,112,175,139,-0.5364208114564386,0.08445025592722356,0.7020121681975005,0.9642454035431112,61185,61185,Herkimer,Herkimer,36,43,New York,NY
36045,36CS019,764,718,811,793,29,-18,75,13,-0.2957430848729026,0.15207612322069836,0.5436351713499599,0.4399914659745449,947,891,1002,1081,134,79,190,119,-0.42080633447930776,0.18292311708554623,0.7864470386852052,0.8788277937925882,109290,109290,Jefferson+Lewis,Jefferson,36,45,New York,NY
36049,36CS019,220,209,232,205,-15,-27,-4,6,-1.230338010258788,-0.8088118199595848,-0.40056555443998165,-0.42050946572077136,272,258,285,304,32,19,46,40,-0.9637501656527858,-0.33822425983839,0.2032392102571195,1.1992795171750392,26270,26270,Jefferson+Lewis,Lewis,36,49,New York,NY
36047,36CS020,13338,12245,14431,22012,8674,7581,9767,6645,0.38234745338588366,0.788075438320034,1.2406425961542047,0.7659964491368976,16551,15240,17862,18745,2194,883,3505,2754,-0.8977509458025491,-0.24651554382728658,0.3186803710381248,1.2546706629914535,2552581,2552581,Kings,Kings,36,47,New York,NY
36051,36CS021,487,461,514,482,-5,-32,21,33,-1.02602405142682,-0.6206479570552403,-0.1812348747444896,-7.548942775336464,601,569,633,678,77,45,109,74,-0.5687318327327914,0.0333555741805896,0.6598111856549423,0.9467129668806978,62687,62687,Livingston,Livingston,36,51,New York,NY
36053,36CS022,503,472,533,612,109,79,140,70,0.09443331530374639,0.5364677800015522,0.9709509814139756,0.63490137156989,618,582,654,716,98,62,134,71,-0.16547961020219243,0.4575956044233636,1.0504286106625051,0.7169822758547615,70710,70710,Madison,Madison,36,53,New York,NY
36055,36CS023,5717,5398,6036,6541,824,505,1143,654,-0.2253218333145461,0.2152607291630263,0.6638486714343332,0.792572100618684,7032,6650,7415,8101,1069,686,1451,896,-0.3207813228927829,0.2671808181698124,0.8917496388948297,0.8377681020212914,741895,741895,Monroe,Monroe,36,55,New York,NY
36057,36CS024,489,468,511,560,71,49,92,33,0.3197520950055522,0.7670177108218125,1.2066239046007063,0.4613496859454223,597,572,622,737,140,115,165,116,-0.0462532759475748,0.57784327079137,1.1974620486525336,0.8227033910212466,49278,49278,Montgomery,Montgomery,36,57,New York,NY
36059,36CS025,9255,8673,9836,12307,3052,2471,3634,2756,-0.17631469153520735,0.23164442293800214,0.658628723922275,0.9026724203012444,11395,10697,12093,12164,769,71,1467,1300,-1.0829681431634341,-0.4857756274153219,0.13689704782192402,1.6875760995038396,1354098,1354098,Nassau,Nassau,36,59,New York,NY
36061,36CS026,8436,7742,9130,12306,3870,3176,4564,2787,0.24031991626453392,0.6660167309170709,1.063497993147863,0.7199418028291128,10460,9628,11293,11300,840,7,1672,1124,-0.8248438227918005,-0.21606411655331287,0.41203423717728926,1.3370820862748771,1623852,1623852,New York (county),New York (county),36,61,New York,NY
36063,36CS027,2011,1921,2101,2390,379,289,469,234,0.25649364652264944,0.7031481374442259,1.1139161862186762,0.6157152075922551,2460,2352,2567,2967,507,400,615,372,0.2019847043945984,0.7707690403389307,1.3945286379489772,0.7319036247028609,209077,209077,Niagara,Niagara,36,63,New York,NY
36065,36CS028,2169,2071,2267,2455,286,188,384,246,-0.2367687533730413,0.17976255715092418,0.588445087158209,0.8563922566986663,2656,2538,2773,3040,384,267,502,471,-1.0453104418573114,-0.46227633429319115,0.1704798844493151,1.2225632513950142,227868,227868,Oneida,Oneida,36,65,New York,NY
36067,36CS029,3672,3475,3870,4339,667,469,864,474,-0.018177076120650608,0.42210650406149797,0.8515672053111003,0.7098028627903136,4507,4270,4744,5172,665,428,902,514,-0.19979721529247327,0.4019930285867629,1.0144198610892807,0.7716023841069822,460180,460180,Onondaga,Onondaga,36,67,New York,NY
36069,36CS030,927,879,974,935,8,-39,56,74,-1.0591881529206995,-0.6028570078382668,-0.16607024901588222,7.87326713369237,1137,1080,1194,1193,56,-1,113,103,-1.1080498495841025,-0.51066745361997,0.10731738917633514,1.8071700950883967,110029,110029,Ontario,Ontario,36,69,New York,NY
36071,36CS031,2365,2199,2531,3006,641,475,807,594,-0.3061058891854161,0.10983739249232816,0.5475472541209457,0.9249958692284294,2921,2722,3120,3163,242,43,441,393,-1.097215166052453,-0.4753020916616962,0.15214897045375406,1.6174486200660056,385068,385068,Orange,Orange,36,71,New York,NY
36075,36CS032,925,875,975,981,56,6,106,48,-0.3611807692245826,0.07556920867895389,0.5019727613198306,0.84589595121678,1139,1079,1199,1328,189,129,249,138,-0.11488140324496998,0.5188042529140507,1.0932076798662904,0.7273934217570814,116689,116689,Oswego,Oswego,36,75,New York,NY
36077,36CS033,518,493,543,571,53,28,78,19,0.1811089053093655,0.576641543903551,0.9721494970373613,0.351586729872738,636,606,667,735,99,68,129,85,-0.37585716394513735,0.28109807642682255,0.8636980504654264,0.8516630684711038,59078,59078,Otsego,Otsego,36,77,New York,NY
36079,36CS034,605,563,648,777,172,129,214,116,0.1113907579567428,0.5764737809952954,1.0067131063083787,0.6709494623109383,746,696,797,753,7,-44,57,53,-1.1499631514538426,-0.5619220909309299,0.14561792611528138,7.034496111027215,98520,98520,Putnam,Putnam,36,79,New York,NY
36081,36CS035,12087,11128,13045,20419,8332,7374,9291,6559,0.38344530236527724,0.7869507538900214,1.2110339118112643,0.7870660458014352,14983,13834,16133,17198,2215,1065,3364,2511,-0.7624092440847874,-0.18854372941356817,0.4633425876555949,1.1332922127516258,2242225,2242225,Queens,Queens,36,81,New York,NY
36083,36CS036,1248,1180,1316,1393,145,77,213,78,-0.0013475827205222978,0.4294693349974147,0.903301431888188,0.533527996142751,1532,1450,1613,1786,254,173,336,167,0.043031621961610915,0.6773858208135184,1.2607399449644896,0.6539124317852862,158617,158617,Rensselaer,Rensselaer,36,83,New York,NY
36085,36CS037,3172,2967,3376,4420,1248,1044,1453,1125,-0.14599371114501716,0.26125554652162575,0.6860298621109997,0.9004541793275727,3911,3666,4157,4367,456,210,701,594,-0.9715544520451308,-0.34354673158785415,0.25460163570542266,1.30113148441422,475802,475802,Richmond,Richmond,36,85,New York,NY
36087,36CS038,1916,1776,2056,2791,875,735,1015,819,-0.2688126552193563,0.16447662326034057,0.606068080235449,0.9349475484537969,2373,2205,2542,2476,103,-66,271,273,-1.2366036963193363,-0.628848956354331,-0.04222349931647739,2.629925376468464,326299,326299,Rockland,Rockland,36,87,New York,NY
36089,36CS039,848,802,894,939,91,45,137,47,-0.03219111819565329,0.4055679193024442,0.829324653220703,0.5100538028946286,1046,990,1101,1261,215,160,271,139,0.22414622347864757,0.8257489566086729,1.4657126332209516,0.6425585832964565,107524,107524,St. Lawrence,St. Lawrence,36,89,New York,NY
36091,36CS040,1636,1537,1735,1689,53,-46,152,64,-0.4610600243316124,-0.047285797814708694,0.37820669185997546,1.1792845639158016,2016,1897,2135,2364,348,229,467,252,-0.1072214093925385,0.508230389326818,1.1532191094367683,0.7221129586459423,229911,229911,Saratoga,Saratoga,36,91,New York,NY
36093,36CS041,1322,1255,1389,1453,131,64,198,88,-0.1682302130118632,0.27458920842650153,0.7271719995480664,0.6673533001710273,1620,1540,1700,1851,231,151,311,188,-0.320071275814546,0.3479381255631306,0.9457817592720378,0.8109959901653438,155469,155469,Schenectady,Schenectady,36,93,New York,NY
36097,36CS042,175,167,182,192,17,10,25,11,-0.0801752639828967,0.3383418742725147,0.7666789891793451,0.6070076796190712,214,205,223,259,45,36,54,17,1.2163565102028675,1.850818227454245,2.4578734407710217,0.37244008279041424,17759,17759,Schuyler+Seneca+Yates,Schuyler,36,97,New York,NY
36099,36CS042,312,298,327,324,12,-3,26,30,-0.9480103645605471,-0.530926798886324,-0.10012082112173928,2.3408132281765077,383,366,401,410,27,9,44,52,-1.5261794243556521,-0.8858090336026979,-0.28725770354200086,1.8794591658013493,34106,34106,Schuyler+Seneca+Yates,Seneca,36,99,New York,NY
36123,36CS042,232,221,243,256,24,13,35,16,-0.12346338672077141,0.31761504401085167,0.7287420513562743,0.6425323342580599,285,272,298,279,-6,-19,7,25,-2.12236579444417,-1.4672021414424445,-0.9304572589312095,-5.114532523536489,24851,24851,Schuyler+Seneca+Yates,Yates,36,123,New York,NY
36103,36CS043,10511,9877,11146,13547,3036,2401,3670,2805,-0.25316561894901934,0.14982809832356916,0.5752706311111239,0.9236991454142383,12957,12195,13718,14310,1353,592,2115,1770,-0.9356993652697183,-0.3424147304974657,0.299007083617117,1.3071222397552829,1476637,1476637,Suffolk,Suffolk,36,103,New York,NY
36105,36CS044,626,593,658,739,113,81,146,63,0.22056900475425203,0.6539122972345801,1.104674957899431,0.5509291435582709,769,730,808,875,106,67,145,81,-0.21315886144357493,0.39288569659329514,0.9900188834206725,0.7563332975742946,75656,75656,Sullivan,Sullivan,36,105,New York,NY
36107,36CS045,400,379,420,492,92,72,113,57,0.289285374669492,0.7352675340955217,1.1526914072290648,0.6112101330104899,491,466,516,559,68,43,93,59,-0.38715334958217945,0.22030099107297077,0.8223414492941359,0.8542136259171751,48089,48089,Tioga,Tioga,36,107,New York,NY
36109,36CS046,590,546,633,584,-6,-49,38,22,-0.7207025617848867,-0.260870509710877,0.16979048224670362,-4.670694480707946,730,677,782,759,29,-23,82,54,-0.8945720070299669,-0.2869046670409932,0.30135379500485165,1.7718139520705192,101591,101591,Tompkins,Tompkins,36,109,New York,NY
36111,36CS047,1474,1397,1550,1664,190,114,267,149,-0.16315029914636575,0.23278490862175366,0.6451599937127601,0.7790589182789026,1808,1716,1900,2042,234,142,326,209,-0.4493952441962851,0.15132248116981842,0.7647560629208419,0.89031019777454,177843,177843,Ulster,Ulster,36,111,New York,NY
36113,36CS048,616,589,644,671,55,27,82,37,-0.11901796609402318,0.28620767256339924,0.7219366811382497,0.6624224659713465,755,722,788,883,128,95,161,71,0.4094848261224876,1.0636698782875593,1.7410365945161521,0.5496946459355692,63887,63887,Warren,Warren,36,113,New York,NY
36115,36CS049,548,522,574,627,79,53,105,16,0.6278377024181444,1.0397824396195035,1.4390534797634609,0.19976202036774274,674,643,705,781,107,76,138,91,-0.2810723852271562,0.31942680712640026,0.9225700056235061,0.84391232777212,60934,60934,Washington,Washington,36,115,New York,NY
36117,36CS050,755,716,793,832,77,39,116,50,-0.11661218009638254,0.29698630206863447,0.7421897846074952,0.6389347461714265,927,881,973,1039,112,66,158,106,-0.5634480860893231,0.08823797877529561,0.6678146429237067,0.9372684749238779,89617,89617,Wayne,Wayne,36,117,New York,NY
36119,36CS051,6097,5682,6513,8319,2222,1806,2637,1926,-0.11091498121530875,0.2960725258685514,0.7207373169902394,0.8665914346725598,7531,7032,8030,8014,483,-16,982,930,-1.181883416949437,-0.5799286697417816,0.09975375308801097,1.921815941050592,967357,967357,Westchester,Westchester,36,119,New York,NY
37001,37CS001,1513,1440,1587,1726,213,139,286,149,-0.051179447580474616,0.38125830221886714,0.8049451048196208,0.6974796709637255,1856,1768,1945,1881,25,-64,113,173,-1.7068102395130205,-1.04237046420031,-0.44277726736780154,6.719840717784514,170078,170078,Alamance,Alamance,37,1,North Carolina,NC
37003,37CS002,343,327,359,440,97,81,113,44,0.9311606569701326,1.4188660881518484,1.853129352690874,0.4491564720589442,419,400,439,586,167,147,186,97,1.611293855834034,2.2389899593931113,2.798217449985201,0.5784195874192898,37427,37427,Alexander+Catawba,Alexander,37,3,North Carolina,NC
37035,37CS002,1449,1380,1518,1706,257,188,326,174,0.09377615672507084,0.5088757535266158,0.9598441801943102,0.6752213468777155,1773,1690,1856,2029,256,173,339,320,-1.0714585985285512,-0.4737181392253024,0.13578739735744413,1.243801518136231,159756,159756,Alexander+Catawba,Catawba,37,35,North Carolina,NC
37005,37CS003,124,122,125,129,5,4,7,4,0.015611901169658647,0.11520063179284466,0.22406230415686565,0.6311066744020762,152,150,153,160,8,7,10,14,-0.7885381751089395,-0.6362270398020213,-0.4797828147613643,1.5420814045078328,11159,11159,Alleghany+Ashe+Avery+Watauga,Alleghany,37,5,North Carolina,NC
37009,37CS003,294,283,306,343,49,37,60,34,0.12304640180358546,0.5303814404972406,0.9479281434351078,0.6837768147052457,361,347,375,412,51,37,65,57,-0.8974020275224068,-0.2624956266061386,0.3762319090588848,1.089096661413638,27195,27195,Alleghany+Ashe+Avery+Watauga,Ashe,37,9,North Carolina,NC
37011,37CS003,185,177,192,187,2,-5,10,19,-1.389773368955761,-0.9710605150644088,-0.49691321495643154,6.11602218631015,227,218,236,239,12,3,21,32,-1.9387647512407749,-1.3556569343099254,-0.735811913882902,2.4351798315069098,17527,17527,Alleghany+Ashe+Avery+Watauga,Avery,37,11,North Carolina,NC
37189,37CS003,319,295,344,361,42,17,66,24,-0.12254353801409198,0.3170866155814486,0.7546812923272915,0.5624025987749612,399,370,428,422,23,-6,52,39,-0.9671656179027246,-0.32768784898705405,0.2843635259608183,1.6285173494530492,56342,56342,Alleghany+Ashe+Avery+Watauga,Watauga,37,189,North Carolina,NC
37007,37CS004,259,248,269,286,27,17,38,34,-0.7124466767291503,-0.27458066342512033,0.15546188711460815,1.1939846813176094,315,303,328,384,69,56,81,73,-0.8298235584815696,-0.2200710734468259,0.40342242036530557,1.0488934362614917,23771,23771,Anson+Richmond,Anson,37,7,North Carolina,NC
37153,37CS004,474,455,493,575,101,82,120,57,0.594745988901347,0.9963669744418671,1.4594211439759799,0.5568141852707031,576,553,599,694,118,95,141,104,-0.2716601247059623,0.391970467660114,0.9969639387850853,0.8759894031983958,44584,44584,Anson+Richmond,Richmond,37,153,North Carolina,NC
37013,37CS005,513,492,533,571,58,38,79,65,-0.5644772094555552,-0.15598024647279451,0.2948719848050902,1.0952434130668014,626,601,650,602,-24,-48,1,80,-3.269535716764349,-2.64695357325046,-2.0078023605774877,-3.522896416021423,47086,47086,Beaufort+Martin+Pamlico,Beaufort,37,13,North Carolina,NC
37117,37CS005,256,247,266,341,85,75,94,30,2.0245358304916428,2.4522788679196568,2.864219813597981,0.3502337351656074,312,301,324,345,33,21,44,54,-1.767171755600657,-1.1190657547908482,-0.5769528556069805,1.600527110485837,22337,22337,Beaufort+Martin+Pamlico,Martin,37,117,North Carolina,NC
37137,37CS005,154,148,159,152,-2,-7,4,1,-0.6393951319676062,-0.2070610763453527,0.23479662699226694,-1.6572975253280917,187,181,194,187,-0,-7,6,21,-2.6441245438124557,-2.035182496658946,-1.4166770682174017,28.15515683950896,12677,12677,Beaufort+Martin+Pamlico,Pamlico,37,137,North Carolina,NC
37017,37CS006,351,337,365,421,70,56,84,27,0.8790479278094333,1.3086998773230032,1.7398727863375387,0.38003384360365694,429,412,446,518,89,72,106,87,-0.5473597136157743,0.05336085700723,0.664024750210705,0.9717091465859609,32884,32884,Bladen+Columbus,Bladen,37,17,North Carolina,NC
37047,37CS006,590,566,614,753,163,139,187,85,1.0222595406798665,1.4178898624363319,1.852226389753498,0.5185450586742086,721,693,749,836,115,87,143,154,-1.460065461026504,-0.8325634323934192,-0.2152197715958211,1.3286106515027705,55161,55161,Bladen+Columbus,Columbus,37,47,North Carolina,NC
37019,37CS007,1409,1345,1473,1530,121,57,185,84,-0.17309924984905797,0.243432130559793,0.7046051551315816,0.6901530765141913,1732,1655,1809,1926,194,117,271,203,-0.7014155155149396,-0.09520038034020237,0.5248856826517398,1.0387914464572399,145509,145509,Brunswick,Brunswick,37,19,North Carolina,NC
37021,37CS008,2343,2230,2457,2542,199,85,312,158,-0.28224647399056746,0.1639237180085758,0.5632748699326657,0.7910006275591156,2885,2748,3021,3016,131,-5,268,264,-1.244661669220399,-0.6003008307219669,-0.004143660539213191,1.9930014630359256,262644,262644,Buncombe+Madison,Buncombe,37,21,North Carolina,NC
37115,37CS008,226,217,235,239,13,4,22,14,-0.47011857648616084,-0.05901316989018754,0.3901321067166938,0.9951970417588226,277,266,288,282,5,-6,16,40,-2.584943724557742,-1.9441827876418405,-1.3342241072368837,6.794451524045574,21680,21680,Buncombe+Madison,Madison,37,115,North Carolina,NC
37023,37CS009,884,845,923,1016,132,93,171,85,0.09505116425977593,0.538738115486296,0.9602379170950155,0.6379488125598993,1081,1035,1128,1194,113,66,159,178,-1.4881159778362592,-0.8581633967154996,-0.2672130831866249,1.5643067625515177,90422,90422,Burke,Burke,37,23,North Carolina,NC
37025,37CS010,1431,1336,1526,1580,149,54,244,127,-0.3408696371601903,0.10377294458037217,0.49033810998980903,0.8468668009923979,1763,1649,1877,1870,107,-7,221,272,-1.5317697009871412,-0.9060740874794097,-0.26343180203262884,2.5172522866030076,218481,218481,Cabarrus,Cabarrus,37,25,North Carolina,NC
37027,37CS011,834,799,870,976,142,106,177,108,-0.03930171148024426,0.40202495843832814,0.849881031297939,0.756999125309021,1022,980,1064,1152,130,88,172,173,-1.2331469595713476,-0.6279716511060307,-0.010272428473927524,1.320723892966412,82202,82202,Caldwell,Caldwell,37,27,North Carolina,NC
37029,37CS012,79,78,80,95,16,15,17,6,0.786094107696454,0.8910428397054914,0.9958871675722538,0.3596317032907717,97,96,99,105,8,6,9,10,-0.42746854859912126,-0.26590264079975456,-0.10172968609039318,1.159160305033939,10859,10859,Camden+Currituck+Pasquotank,Camden,37,29,North Carolina,NC
37053,37CS012,210,197,222,262,52,40,65,13,0.963606477651905,1.3874720710597561,1.796188810245539,0.24422971794109768,258,243,273,301,43,28,58,27,0.10640955132398461,0.6711902035940458,1.2799998531336014,0.6124986393557167,28389,28389,Camden+Currituck+Pasquotank,Currituck,37,53,North Carolina,NC
37139,37CS012,369,351,386,442,73,56,91,41,0.40066590534850527,0.7881028021044969,1.2349294732657987,0.5505339243804247,450,429,471,531,81,60,102,56,0.1271115312309128,0.738962129032005,1.3995747421397928,0.6832118044281612,40138,40138,Camden+Currituck+Pasquotank,Pasquotank,37,139,North Carolina,NC
37031,37CS013,727,697,757,754,27,-3,57,31,-0.44513630408515126,-0.042461471114231555,0.38563106386857365,1.0915752980566702,892,856,928,973,81,45,117,79,-0.5635249446305267,0.04753519834078873,0.6387040329217216,0.9619596579760775,69532,69532,Carteret,Carteret,37,31,North Carolina,NC
37033,37CS014,236,226,246,279,43,33,53,16,0.7920649805472174,1.2044923967431174,1.6194856593990274,0.3634543625148873,290,278,301,347,57,46,69,44,0.08783008388454075,0.696255084146789,1.2855312303160975,0.7539624731435954,22529,22529,Caswell+Person,Caswell,37,33,North Carolina,NC
37145,37CS014,392,375,409,449,57,40,74,26,0.3441472466931777,0.7812628872876886,1.1936170230629102,0.4477648890740092,482,462,503,515,33,12,53,76,-1.8820295626797574,-1.303061827861484,-0.7109105758060573,2.2628091666737773,39748,39748,Caswell+Person,Person,37,145,North Carolina,NC
37037,37CS015,639,606,671,727,88,56,121,51,0.02593738081251467,0.4842603594569697,0.9103959197567502,0.5719986061939376,786,747,825,795,9,-30,48,55,-1.395222570021765,-0.7201670902928256,-0.0835552333390898,5.684409915050045,74973,74973,Chatham,Chatham,37,37,North Carolina,NC
37039,37CS016,348,335,360,351,3,-9,16,28,-1.3106864998839332,-0.862276303014634,-0.4274053451266723,6.895554008938988,429,414,444,531,102,87,117,94,-0.3326493246048762,0.3192184175301777,0.944432001373553,0.916816638327535,28860,28860,Cherokee+Clay+Graham+Swain,Cherokee,37,39,North Carolina,NC
37043,37CS016,138,137,139,111,-27,-28,-26,5,-2.9068172475724037,-2.8083377090149746,-2.7128272266566036,-0.192652650639825,170,168,171,184,14,13,16,42,-3.0870737621643016,-2.9386296393459834,-2.7904573452717103,2.772775539995401,11372,11372,Cherokee+Clay+Graham+Swain,Clay,37,43,North Carolina,NC
37075,37CS016,90,89,91,113,23,22,24,10,1.4055545437040666,1.5063914204731526,1.6136305188358673,0.4209376481783947,111,110,112,110,-1,-2,-0,15,-2.4728116145713783,-2.306581977724294,-2.1534914402425804,-50.42375048766744,8472,8472,Cherokee+Clay+Graham+Swain,Graham,37,75,North Carolina,NC
37173,37CS016,174,168,180,211,37,31,43,10,1.4719014527643688,1.9120786830662513,2.3016814417052656,0.2624037536621785,214,207,221,242,28,21,35,30,-0.8000027369303611,-0.17055845032177633,0.428296521478965,1.038446505853519,14257,14257,Cherokee+Clay+Graham+Swain,Swain,37,173,North Carolina,NC
37045,37CS017,1061,1019,1104,1263,202,159,244,162,-0.014668037611959228,0.40338970639788474,0.872123364514558,0.7995834302453171,1298,1247,1349,1316,18,-33,69,218,-3.059177055071952,-2.4489659151991012,-1.7943579314800417,11.519574300618956,98410,98410,Cleveland,Cleveland,37,45,North Carolina,NC
37049,37CS018,933,890,977,1121,188,144,231,102,0.41281883404123304,0.8420471353469341,1.2539834574748951,0.5403437985509434,1143,1091,1195,1114,-29,-81,23,108,-2.2144631256606346,-1.6045721537771969,-1.0225311097381455,-3.8500289822629634,101698,101698,Craven,Craven,37,49,North Carolina,NC
37051,37CS019,2236,2091,2380,2594,358,214,503,148,0.2037478181656611,0.6029812042308018,1.0469232960659889,0.4117190585300674,2762,2589,2936,3245,483,309,656,444,-0.49131926963207606,0.1551194839051872,0.7782675780797774,0.9178982746647688,336457,336457,Cumberland,Cumberland,37,51,North Carolina,NC
37055,37CS020,317,301,333,324,7,-9,23,5,-0.3548119554837222,0.06735102240867478,0.4926990817117321,0.6308316885126951,392,373,411,393,1,-18,20,26,-1.3983912616518868,-0.8156313783109886,-0.19585852033404305,13.294657148010316,37269,37269,Dare+Hyde+Tyrrell+Washington,Dare,37,55,North Carolina,NC
37095,37CS020,53,52,53,49,-4,-4,-3,4,-1.6515364448386376,-1.5410472224018974,-1.43811507998024,-1.581372751674258,65,64,65,47,-18,-18,-17,4,-5.424400423407998,-5.2771856167553475,-5.116407898927144,-0.2420196608312072,4895,4895,Dare+Hyde+Tyrrell+Washington,Hyde,37,95,North Carolina,NC
37177,37CS020,37,36,37,39,2,2,3,2,-0.0211506127984864,0.08769738956853429,0.19465233332095028,0.5978118973562392,45,45,46,47,2,1,2,5,-1.115065335326264,-0.9713961636495986,-0.8147365460333351,1.7100224941833868,3797,3797,Dare+Hyde+Tyrrell+Washington,Tyrrell,37,177,North Carolina,NC
37187,37CS020,140,135,145,167,27,22,32,12,0.9075153818134871,1.2938134439725806,1.7081683898020386,0.4282138398050034,171,165,177,197,26,20,32,33,-1.3491646543026268,-0.741142441567317,-0.1363188850416988,1.2310725162558254,11572,11572,Dare+Hyde+Tyrrell+Washington,Washington,37,187,North Carolina,NC
37057,37CS021,1582,1509,1654,1849,267,195,340,137,0.3481348615778693,0.78790015540393,1.1857197865988987,0.5104768035096903,1937,1850,2025,2256,319,231,406,349,-0.8013310968806583,-0.2131642227071236,0.4050876655522251,1.0917017724891058,168653,168653,Davidson,Davidson,37,57,North Carolina,NC
37059,37CS022,414,395,433,438,24,5,43,34,-0.6644077772303034,-0.23942871167410573,0.2355494668895731,1.365397280290307,507,484,529,548,41,19,64,84,-1.8011035811773695,-1.2020597599071048,-0.560072177869199,1.980403799360608,42944,42944,Davie+Yadkin,Davie,37,59,North Carolina,NC
37197,37CS022,377,361,393,433,56,40,72,40,0.012018736046215717,0.43624429520315394,0.8492477971293604,0.7000776597260772,460,441,480,472,12,-8,31,66,-2.358985165838951,-1.7280581151126932,-1.1395400589008262,5.134461206567881,37620,37620,Davie+Yadkin,Yadkin,37,197,North Carolina,NC
37061,37CS023,461,435,486,596,135,110,161,74,0.6222801496126131,1.0490186311983196,1.472169503214337,0.542160335360636,565,534,595,678,113,83,144,107,-0.5150797657616336,0.13244770156447674,0.7345616593803007,0.935103159754147,58799,58799,Duplin,Duplin,37,61,North Carolina,NC
37063,37CS024,1837,1696,1978,2037,200,59,341,138,-0.227223352278593,0.1958305886005674,0.6113260122282694,0.6869511994107532,2279,2109,2448,1984,-295,-464,-125,133,-2.2181361768394314,-1.5699184522938074,-0.9651620281699663,-0.4531242282775226,324776,324776,Durham,Durham,37,63,North Carolina,NC
37065,37CS025,567,545,589,680,113,91,135,85,0.10079125593720441,0.5414198060306152,0.9545885903731253,0.7468206062614232,695,669,722,629,-66,-93,-40,61,-3.6040028452749735,-2.9870585571053936,-2.3792287128300225,-0.933953336768449,51179,51179,Edgecombe,Edgecombe,37,65,North Carolina,NC
37067,37CS026,2991,2826,3156,3325,334,169,499,244,-0.22414474844385257,0.2060641492437006,0.6823565317834037,0.7284893525154219,3679,3481,3878,3903,224,25,422,409,-1.1465513413048276,-0.6004831586182227,0.07513305627616365,1.8201507767279457,382837,382837,Forsyth+Stokes,Forsyth,37,67,North Carolina,NC
37169,37CS026,481,461,500,554,73,54,93,35,0.4122095768637863,0.8506241745296732,1.2698441452369207,0.47039602827555876,587,564,611,637,50,26,73,76,-1.3089485224064958,-0.7039407459830059,-0.0892173177711461,1.5017835376075928,45679,45679,Forsyth+Stokes,Stokes,37,169,North Carolina,NC
37069,37CS027,561,530,592,593,32,1,63,43,-0.5358547394997837,-0.14581286011454772,0.2863377865000133,1.297224026343067,692,655,729,686,-6,-43,31,73,-1.950890008492991,-1.3416742491091538,-0.7135202871107726,-15.306640108113927,70643,70643,Franklin+Warren,Franklin,37,69,North Carolina,NC
37185,37CS027,214,206,223,262,48,39,56,14,1.3248390220481365,1.712461449656444,2.176784655326323,0.28686332263330155,261,251,272,275,14,3,24,29,-1.5283812294373533,-0.9443195864916208,-0.3194087609610157,1.9975332654260245,19621,19621,Franklin+Warren,Warren,37,185,North Carolina,NC
37071,37CS028,2068,1971,2166,2346,278,180,375,226,-0.19749453730513075,0.23388101920833534,0.6575742621328529,0.8113854840910313,2537,2420,2654,2769,232,115,349,452,-1.8090521621845075,-1.187118769127446,-0.6098157397465253,1.9393150968331774,225450,225450,Gaston,Gaston,37,71,North Carolina,NC
37015,37CS029,209,201,217,261,52,44,60,38,0.33585386874243794,0.7442259308055691,1.1656672439669202,0.7125222777674856,257,247,267,275,18,8,28,28,-1.2173083734456174,-0.6279274214110253,-0.046050010329341806,1.4658589963793534,18858,18858,Gates and Nearby Counties,Bertie,37,15,North Carolina,NC
37041,37CS029,168,162,174,194,26,20,32,22,-0.17001775033285796,0.27695128961521387,0.657459038438551,0.8275317361541563,207,200,214,222,15,8,22,21,-1.1321240418974234,-0.5122803611705364,0.11203453696500135,1.3106585085820723,13874,13874,Gates and Nearby Counties,Chowan,37,41,North Carolina,NC
37073,37CS029,114,113,115,126,12,11,13,18,-0.6322524933862794,-0.5243621202296156,-0.4281630022970537,1.3895716047864033,141,139,142,155,14,13,16,19,-0.6262033372289428,-0.46394730527212574,-0.3322377316012784,1.2258555812473722,11506,11506,Gates and Nearby Counties,Gates,37,73,North Carolina,NC
37091,37CS029,230,220,240,315,85,75,95,47,1.2092811043966596,1.6400873987391695,2.0560538601516822,0.5440956592438756,283,271,295,267,-16,-28,-4,30,-2.9632399247976027,-2.3611194243543796,-1.667937105339535,-1.95138395398046,23420,23420,Gates and Nearby Counties,Hertford,37,91,North Carolina,NC
37143,37CS029,157,152,163,182,25,19,30,15,0.2347730521999245,0.7297740746687791,1.1201982851040426,0.5863530503008583,194,187,201,188,-6,-13,1,26,-3.437077926485426,-2.814126096024433,-2.2089662988795458,-5.24301018115177,13615,13615,Gates and Nearby Counties,Perquimans,37,143,North Carolina,NC
37077,37CS030,478,452,504,594,116,90,142,48,0.7074334930813218,1.122088241609347,1.5151053489513913,0.4116717580194095,588,557,619,613,25,-6,56,67,-1.4883786266167707,-0.811062691992832,-0.24829541375300856,2.558823228656155,60411,60411,Granville+Vance,Granville,37,77,North Carolina,NC
37181,37CS030,450,431,469,566,116,97,135,71,0.5789167289820277,1.0046336483880964,1.455599563393262,0.6059236544221569,550,527,573,596,46,23,69,60,-0.979449380042504,-0.3757003939821369,0.26461660156407313,1.2742596104760628,44690,44690,Granville+Vance,Vance,37,181,North Carolina,NC
37079,37CS031,177,168,186,206,29,20,38,26,-0.2551040522350188,0.1595531927519362,0.5830979171312467,0.8564051974118547,218,207,228,229,11,1,22,21,-1.195595297750476,-0.5764855498304221,0.0644766341442784,1.691893214840544,20920,20920,Greene+Jones+Lenoir,Greene,37,79,North Carolina,NC
37103,37CS031,99,98,100,135,36,35,37,17,1.9293234749183443,2.0321192263521506,2.1334162849374647,0.4606558831374362,122,120,123,149,27,26,29,16,1.318925051254679,1.475325026727582,1.6274576985264346,0.5629401978473707,9302,9302,Greene+Jones+Lenoir,Jones,37,103,North Carolina,NC
37107,37CS031,615,591,639,733,118,94,142,78,0.2893405534797245,0.7286318464321782,1.168987616322668,0.6545796918128168,752,724,781,801,49,20,77,111,-1.9539805398206878,-1.3368838978781838,-0.7352442266210152,2.2351944255116263,55926,55926,Greene+Jones+Lenoir,Lenoir,37,107,North Carolina,NC
37081,37CS032,3932,3699,4164,4378,446,214,679,346,-0.2786671229006621,0.18422290971410973,0.622749318806334,0.7737057852213212,4847,4568,5127,5634,787,507,1066,547,-0.07197750078087066,0.5499665568440817,1.1169359686333347,0.6944446121886615,538976,538976,Guilford,Guilford,37,81,North Carolina,NC
37083,37CS033,551,530,572,696,145,124,166,53,1.4109298815297027,1.866024270122355,2.2729831912760154,0.3630158332158662,674,648,699,761,87,62,113,92,-0.7182902717179755,-0.09308042731833045,0.5239046967411752,1.040608651900237,49826,49826,Halifax+Northampton,Halifax,37,83,North Carolina,NC
37131,37CS033,219,211,227,305,86,78,94,43,1.8273744950892692,2.244804397677798,2.654645677185044,0.49312503431194216,267,257,277,307,40,30,50,45,-0.9181622677777231,-0.33445773864719114,0.3008056924138802,1.1008584181901335,19327,19327,Halifax+Northampton,Northampton,37,131,North Carolina,NC
37085,37CS034,895,836,954,1068,173,114,232,97,0.11883492622018522,0.5541775530453535,0.9792456940149075,0.5569142224820058,1105,1034,1175,1265,160,90,231,187,-0.9152418371929372,-0.24826313876850464,0.4214940134120281,1.1590487998635974,136541,136541,Harnett,Harnett,37,85,North Carolina,NC
37087,37CS035,704,676,731,806,102,75,130,72,0.0617823395330178,0.4772854074164927,0.8719487823092813,0.6961402259960238,860,828,893,868,8,-25,40,107,-2.5496891225297564,-1.8977868064571188,-1.2796527536045301,12.479493913794725,62702,62702,Haywood,Haywood,37,87,North Carolina,NC
37089,37CS036,1233,1182,1284,1298,65,14,116,98,-0.6965728252816079,-0.2863230879669697,0.13784928248008618,1.479495457545377,1505,1444,1566,1520,15,-46,76,149,-1.9684718836428359,-1.362289493833044,-0.8033243663216476,9.472495248256578,117804,117804,Henderson,Henderson,37,89,North Carolina,NC
37093,37CS037,314,290,338,410,96,72,120,40,0.5873194347407562,1.0174296082452632,1.4138068435538351,0.41211819333533106,392,364,421,449,57,28,85,77,-1.000450336601159,-0.4500668657531611,0.1653729478124755,1.335520717191562,55443,55443,Hoke+Scotland,Hoke,37,93,North Carolina,NC
37165,37CS037,341,326,356,484,143,128,158,56,2.020668146316835,2.488384768983063,2.943441091008973,0.3896387174417834,419,401,437,532,113,95,131,78,0.6371153848710678,1.225902316069202,1.799957081918084,0.6832473336101514,34718,34718,Hoke+Scotland,Scotland,37,165,North Carolina,NC
37097,37CS038,1405,1325,1485,1614,209,129,289,134,-0.0549156890798726,0.40180039712940985,0.834597793342768,0.6381954768995183,1728,1632,1824,1757,29,-67,125,302,-2.4253374259421654,-1.7945213082946776,-1.1960226804898038,10.140214273945357,183493,183493,Iredell,Iredell,37,97,North Carolina,NC
37099,37CS039,344,326,363,381,37,18,55,31,-0.298690986172385,0.12403380236919778,0.554912805142772,0.8254639823139863,423,400,446,396,-27,-50,-4,50,-2.7458721024707997,-2.106110039924158,-1.4617427357294566,-1.9211910062901623,43860,43860,Jackson+Macon+Transylvania,Jackson,37,99,North Carolina,NC
37113,37CS039,410,395,426,463,53,37,68,16,0.5909208066731949,1.0226428351429238,1.4558975849544111,0.2986770871003251,501,482,519,577,76,58,95,90,-1.0896002987976752,-0.4398132202592293,0.1881480297529671,1.1620578536179482,35839,35839,Jackson+Macon+Transylvania,Macon,37,113,North Carolina,NC
37175,37CS039,367,352,382,369,2,-13,17,14,-0.7952197171057044,-0.3598322206925441,0.06682261449240638,5.0153357466650705,448,430,466,490,42,24,60,47,-0.7835298825471831,-0.20730438040364718,0.43901658966303736,1.1007909705763332,34365,34365,Jackson+Macon+Transylvania,Transylvania,37,175,North Carolina,NC
37101,37CS040,1400,1307,1493,1536,136,43,229,121,-0.39155283523553214,0.06933587227763349,0.47544052383186525,0.8846386010035683,1730,1618,1842,1894,164,52,276,249,-1.1621087436512283,-0.4846171903854295,0.15048669435850262,1.5095861042783951,212478,212478,Johnston,Johnston,37,101,North Carolina,NC
37105,37CS041,524,498,551,646,122,95,148,46,0.7657161844454752,1.2209282532030832,1.64090668141206,0.37511442660253697,642,610,675,674,32,-1,64,85,-1.6599338342364955,-1.026689597781912,-0.42246864078318297,2.607955843544113,62014,62014,Lee,Lee,37,105,North Carolina,NC
37109,37CS042,737,699,774,850,113,76,151,74,0.026175431753610985,0.4586424233436714,0.8921503725725008,0.6466288284027228,903,857,948,849,-54,-99,-8,174,-3.728186988891008,-3.121827134359921,-2.528854186293804,-3.2965428207608416,87240,87240,Lincoln,Lincoln,37,109,North Carolina,NC
37111,37CS043,459,439,478,541,82,63,102,64,-0.027810289399842075,0.41031743008390414,0.8286082895866175,0.7688834331846658,564,540,588,598,34,10,58,110,-2.633660279614817,-1.9631037436127983,-1.4007693143460027,3.1323023986660044,45783,45783,McDowell+Mitchell+Yancey,McDowell,37,111,North Carolina,NC
37121,37CS043,200,194,206,214,14,8,20,26,-1.2319335429960578,-0.7912849651938606,-0.3851840709496205,1.7260817069193113,244,237,252,249,5,-3,12,36,-3.139825586911285,-2.523106699994827,-1.9362342891731374,6.213004868264275,14908,14908,McDowell+Mitchell+Yancey,Mitchell,37,121,North Carolina,NC
37199,37CS043,203,195,210,234,31,24,39,19,0.24581703426942672,0.6908230639367299,1.129544955861166,0.5866057751041392,248,239,258,288,40,30,49,50,-1.3248008537146083,-0.6955994460090672,-0.07645412027938124,1.2334497939258469,18076,18076,McDowell+Mitchell+Yancey,Yancey,37,199,North Carolina,NC
37119,37CS044,5601,5115,6086,6552,951,466,1437,611,-0.14291597325069985,0.29354968210735893,0.7358972601836749,0.6415508609091524,6968,6385,7552,7610,642,58,1225,847,-0.8381806768541082,-0.2078867417182768,0.4241433937351401,1.318225828831615,1119809,1119809,Mecklenburg,Mecklenburg,37,119,North Carolina,NC
37123,37CS045,265,253,276,314,49,38,61,38,-0.033211851416412856,0.4275034638187874,0.8281299417904677,0.75410552645958,325,310,339,384,59,45,74,65,-0.8751610613375904,-0.2455002886073519,0.394738942614502,1.074806092301727,27221,27221,Montgomery+Moore,Montgomery,37,123,North Carolina,NC
37125,37CS045,1030,985,1074,1118,88,44,133,97,-0.5049848526183225,-0.09085815696138816,0.3182305286960217,1.0863270732520536,1264,1211,1318,1307,43,-11,96,149,-1.8826344827844488,-1.2437885294592568,-0.6057797383656216,3.410058356216494,102077,102077,Montgomery+Moore,Moore,37,125,North Carolina,NC
37127,37CS046,932,891,973,1058,126,85,167,115,-0.3088756641860909,0.11767933242811277,0.5244909119936959,0.9069326586536757,1143,1094,1192,1183,40,-9,89,133,-1.7744679017097966,-1.2165889216720893,-0.5216013314355358,3.2816584647449365,94508,94508,Nash,Nash,37,127,North Carolina,NC
37129,37CS047,1750,1648,1852,1952,202,100,304,88,0.08058516151690756,0.49497679454740795,0.886958972060888,0.4333992139101313,2154,2032,2276,2278,124,2,246,205,-0.9972927243326639,-0.4120830719224874,0.2130724589736459,1.638411578894955,235249,235249,New Hanover,New Hanover,37,129,North Carolina,NC
37133,37CS048,1076,989,1164,1205,129,41,216,79,-0.19143621294201857,0.24223491599388217,0.6829682301326968,0.6091027025277106,1340,1235,1446,1527,187,81,292,220,-0.7868447761258124,-0.18685692450551364,0.46002148689468286,1.1712012609794868,203273,203273,Onslow,Onslow,37,133,North Carolina,NC
37135,37CS049,718,654,782,754,36,-28,100,52,-0.528418462239928,-0.10567462265053912,0.34826059875061016,1.3954263494662447,894,817,971,887,-7,-84,70,51,-1.0812914760374714,-0.4705678587479237,0.1543531298921603,-9.16781175044834,148561,148561,Orange,Orange,37,135,North Carolina,NC
37141,37CS050,536,509,564,579,43,15,70,31,-0.23795678624469957,0.17491357664472296,0.6302548173882865,0.7102998947501468,660,626,693,745,85,52,119,88,-0.6755974877039576,-0.04802154906647787,0.554702366799764,1.018538033532417,63723,63723,Pender,Pender,37,141,North Carolina,NC
37147,37CS051,1141,1062,1220,1393,252,173,331,126,0.2292915692228429,0.68550131501701,1.1564837475975756,0.49784147692848085,1412,1317,1506,1608,196,102,291,180,-0.4386309148694166,0.10444746208349016,0.7326313339254851,0.9119995406588929,181952,181952,Pitt,Pitt,37,147,North Carolina,NC
37149,37CS052,262,253,271,275,13,4,22,17,-0.6073569771334774,-0.18232993919083262,0.22970341084749557,1.219418729757372,320,309,331,344,24,13,35,53,-2.3060905709822412,-1.6385919103338427,-1.0715118813074602,2.0983291449018426,20851,20851,Polk+Rutherford,Polk,37,149,North Carolina,NC
37161,37CS052,738,709,767,889,151,122,180,115,0.11931326132490523,0.548349877860728,0.9513046332212602,0.7568028091455872,901,867,936,1058,157,122,191,210,-1.528835466365334,-0.9581266243600755,-0.36846737710129734,1.3314114833500628,67050,67050,Polk+Rutherford,Rutherford,37,161,North Carolina,NC
37151,37CS053,1346,1284,1408,1564,218,156,280,137,0.12120350347962329,0.560910022254614,0.9900401671651907,0.6257541117669277,1652,1578,1727,1988,336,261,410,294,-0.33323048397417304,0.342871679560164,0.977066623076565,0.8728498757329367,143938,143938,Randolph,Randolph,37,151,North Carolina,NC
37155,37CS054,1194,1138,1250,1529,335,279,391,194,0.663331776471424,1.0985659575287996,1.5288761194222487,0.5767046486651358,1466,1399,1533,1872,406,339,473,300,0.38362580348439507,0.981150379777705,1.5970375148248068,0.7372449694692146,130256,130256,Robeson,Robeson,37,155,North Carolina,NC
37157,37CS055,999,960,1039,1204,205,165,244,104,0.6749655037744309,1.0982158532755986,1.5105069339898507,0.5058745983117849,1223,1176,1270,1475,252,205,299,167,0.5300173907817128,1.1383915156707813,1.6930528700110112,0.6593601458262945,91188,91188,Rockingham,Rockingham,37,157,North Carolina,NC
37159,37CS056,1407,1346,1469,1687,280,218,341,157,0.492209835378976,0.8709818081586325,1.2756932835607002,0.5596984107378448,1721,1647,1794,2073,352,279,426,349,-0.6286834862517767,0.038614263936285,0.6145645490915921,0.9882505294887409,142100,142100,Rowan,Rowan,37,159,North Carolina,NC
37163,37CS057,593,565,620,647,54,27,82,57,-0.4598209813515803,-0.045072994643136396,0.38701373194551525,1.031629023503158,725,692,758,813,88,55,121,118,-1.1773981071594364,-0.5613065271123983,0.026288456261280735,1.3280947776818555,63376,63376,Sampson,Sampson,37,163,North Carolina,NC
37167,37CS058,627,600,655,718,91,63,118,74,-0.1680887943422714,0.2589040180253573,0.6888529943412597,0.8079211643701808,767,734,799,861,94,62,127,138,-1.4352525487366246,-0.8413025860562591,-0.1840526196895837,1.446641872694113,62892,62892,Stanly,Stanly,37,167,North Carolina,NC
37171,37CS059,810,779,841,919,109,78,140,86,-0.1306336206836096,0.31573507559348424,0.7222078094324742,0.781688326684423,992,955,1029,1034,42,5,79,169,-2.7279421684240854,-2.1474431431338488,-1.5128924836030346,3.9029727688360003,71717,71717,Surry,Surry,37,171,North Carolina,NC
37179,37CS060,1325,1220,1430,1448,123,18,228,117,-0.39372967111923957,0.02756899122427733,0.46029994427103815,0.9411873890192785,1646,1520,1773,1909,263,136,389,292,-0.7753271359390563,-0.144334070938987,0.4718565583862386,1.1068056336153191,241917,241917,Union,Union,37,179,North Carolina,NC
37183,37CS061,5147,4660,5633,5693,546,60,1033,449,-0.3746420257313168,0.10113250923052616,0.5227480109434675,0.8205030641065362,6436,5851,7020,6581,145,-439,730,525,-1.0211555957311313,-0.4111439089431955,0.2227081529114501,3.5848682868403325,1120910,1120910,Wake,Wake,37,183,North Carolina,NC
37191,37CS062,1094,1040,1147,1316,222,169,276,149,0.18817898519963538,0.5948383544184371,1.03652235538477,0.6672827344913331,1348,1284,1412,1422,74,10,138,191,-1.7562303401805917,-1.1454152551017573,-0.518675340215197,2.551474073344973,123930,123930,Wayne,Wayne,37,191,North Carolina,NC
37193,37CS063,708,679,738,827,119,89,148,77,0.16990885476472825,0.6217373933746491,1.0125753194002354,0.6436076930065754,866,831,901,987,121,86,156,157,-1.3013121329956931,-0.6213213370737497,-0.031464078968618275,1.2871350624293754,68191,68191,Wilkes,Wilkes,37,193,North Carolina,NC
37195,37CS064,768,732,803,942,174,139,210,110,0.3480201652160302,0.7929165915160725,1.2237118133745115,0.6271209011233009,944,902,987,1123,179,136,221,136,0.02417053582342777,0.6273781237564409,1.2088603416194956,0.7564308353761978,81860,81860,Wilson,Wilson,37,195,North Carolina,NC
38005,38CS001,57,56,57,91,34,34,35,15,2.7438270350157907,2.8471875862506617,2.9497754689414437,0.42391065843376713,70,69,70,89,19,19,20,4,2.5602686471282525,2.731177848066698,2.8921085282535004,0.19518868573451031,6806,6806,Benson and Nearby Counties,Benson,38,5,North Dakota,ND
38027,38CS001,37,36,38,32,-5,-6,-4,4,-4.386511580061618,-3.9273045576861807,-3.5065875834752633,-1.0769311689906607,45,43,46,47,2,1,4,5,-2.004808826045223,-1.381799929807491,-0.7819919957833878,1.4526398489106571,2215,2215,Benson and Nearby Counties,Eddy,38,27,North Dakota,ND
38031,38CS001,36,35,36,52,16,16,17,21,-1.5686853025432912,-1.4581729040067377,-1.349545054450037,1.210471822132623,44,43,44,40,-4,-4,-3,3,-2.6723938581212447,-2.5044501822215555,-2.360605148751935,-1.1251660682610931,3195,3195,Benson and Nearby Counties,Foster,38,31,North Dakota,ND
38039,38CS001,32,32,32,30,-2,-2,-2,5,-3.2444108594572616,-3.1327796363391758,-3.0297880748111754,-5.304853616906261,39,39,39,22,-17,-17,-17,1,-9.953682014135754,-9.79196851439186,-9.64183982494024,-0.06225840110342495,2213,2213,Benson and Nearby Counties,Griggs,38,39,North Dakota,ND
38069,38CS001,43,43,43,53,10,10,10,21,-2.90114402606359,-2.7889060563230026,-2.683888436199204,1.9218637256579756,53,52,53,56,3,3,4,4,-0.38759991892223594,-0.23484549128243418,-0.08406409970612934,0.9448862071940125,3968,3968,Benson and Nearby Counties,Pierce,38,69,North Dakota,ND
38071,38CS001,115,113,116,150,35,34,37,20,1.243368720605629,1.3519212558038474,1.450955701473588,0.5482009011407479,140,139,142,120,-20,-22,-19,16,-3.95829490917112,-3.814742716418234,-3.6578979729263783,-0.8258532319904425,11446,11446,Benson and Nearby Counties,Ramsey,38,71,North Dakota,ND
38079,38CS001,126,120,132,159,33,27,39,21,0.42910545214338947,0.8416258553385391,1.266568816590808,0.6188633121149073,155,148,162,187,32,25,39,13,0.9974354512678612,1.5755568713959907,2.2363082059038915,0.39545250822210753,14227,14227,Benson and Nearby Counties,Rolette,38,79,North Dakota,ND
38095,38CS001,23,23,23,35,12,12,12,4,3.5820064503030147,3.687711408626149,3.8008127863824455,0.31003628171642444,28,28,29,30,2,1,2,4,-1.4578348311664062,-1.2889143034362764,-1.1306500522384118,1.480303010274919,2142,2142,Benson and Nearby Counties,Towner,38,95,North Dakota,ND
38103,38CS001,52,52,53,60,8,7,8,8,-0.18917696901284664,-0.08703639723434901,0.012590282090401191,0.9224110490669866,64,64,64,52,-12,-12,-12,3,-4.942998275854888,-4.794662007317325,-4.635777943258827,-0.2726619301707339,3759,3759,Benson and Nearby Counties,Wells,38,103,North Dakota,ND
38017,38CS002,1007,927,1086,1197,190,111,270,153,-0.22044287732723422,0.1901376575725203,0.6675300897996307,0.7991254572734681,1251,1156,1346,1230,-21,-116,74,104,-1.4618682024363239,-0.8148716737712699,-0.2276041493648505,-5.240565885372614,182932,182932,Cass,Cass,38,17,North Dakota,ND
38003,38CS003,107,106,109,151,44,42,45,26,1.5883233503271819,1.6789673498252327,1.7860090087160343,0.5840094388558352,131,130,133,149,18,16,19,12,0.48455612711351126,0.6321433678227842,0.7811193241516302,0.6479847607714753,10409,10409,LaMoure and Nearby Counties,Barnes,38,3,North Dakota,ND
38021,38CS003,57,56,57,82,25,25,26,35,-2.1325815790766405,-2.0291589355779576,-1.9265953113467864,1.3322643713151185,69,69,70,64,-5,-6,-5,5,-2.7404875388308194,-2.5939316081025683,-2.442680496432145,-1.1504682338662204,4790,4790,LaMoure and Nearby Counties,Dickey,38,21,North Dakota,ND
38045,38CS003,36,36,37,50,14,13,14,14,-0.12601333164124978,-0.018761010711569867,0.07944946901053547,0.9382329465730406,44,44,45,31,-13,-14,-13,2,-4.64644366436644,-4.503225971505049,-4.346550886105864,-0.1642799135150441,4042,4042,LaMoure and Nearby Counties,LaMoure,38,45,North Dakota,ND
38073,38CS003,66,66,67,73,7,6,7,5,0.19499682297895962,0.30498328344491216,0.41294252786435215,0.6591251763202198,81,80,82,67,-14,-15,-13,4,-4.362758405189523,-4.186532382404798,-4.038795157212929,-0.3040461863814214,5199,5199,LaMoure and Nearby Counties,Ransom,38,73,North Dakota,ND
38077,38CS003,125,124,127,136,11,9,12,20,-0.6884774210136754,-0.5760851939987405,-0.4652323468255275,1.7179894640305067,154,152,156,115,-39,-41,-37,3,-3.2454438477483483,-3.086487008596979,-2.927882278234073,-0.07969712625348468,16174,16174,LaMoure and Nearby Counties,Richland,38,77,North Dakota,ND
38081,38CS003,31,30,31,38,7,7,8,5,0.44421486922627446,0.5532545393374688,0.657552360669198,0.6118554465608608,38,37,38,44,6,6,7,4,0.5286658976203528,0.6712917665901416,0.8393847076655612,0.5540658367907227,3935,3935,LaMoure and Nearby Counties,Sargent,38,81,North Dakota,ND
38093,38CS003,202,193,211,244,42,33,51,65,-1.5451698415281363,-1.1169937034238198,-0.6760463524912912,1.5049162467370503,248,237,258,242,-6,-16,5,15,-1.8304014409809783,-1.2107701081217512,-0.5964230103329172,-3.1018251528928213,20613,20613,LaMoure and Nearby Counties,Stutsman,38,93,North Dakota,ND
38009,38CS004,69,68,70,68,-1,-2,-0,21,-3.6208371271956623,-3.5070621591986195,-3.3966682303466578,-380.21233710820036,85,84,86,63,-22,-23,-21,4,-5.168478284363904,-4.998694162079272,-4.846297146144313,-0.1886112846398347,6290,6290,McHenry and Nearby Counties,Bottineau,38,9,North Dakota,ND
38049,38CS004,54,53,55,80,26,25,27,11,2.496974380258005,2.600415451306749,2.715610578939145,0.4090067540903993,67,66,68,72,5,4,6,4,0.07834665621169162,0.2323251760584892,0.37262338588716315,0.6574328152115629,5729,5729,McHenry and Nearby Counties,McHenry,38,49,North Dakota,ND
38055,38CS004,93,92,94,114,21,20,22,22,-0.2598808221716888,-0.14981632800206168,-0.04348699711837324,1.019494943409442,115,114,117,108,-7,-9,-6,10,-2.3828933748655277,-2.2176263535869842,-2.0555698718146225,-1.550374787410886,9430,9430,McHenry and Nearby Counties,McLean,38,55,North Dakota,ND
38075,38CS004,24,24,24,30,6,6,6,12,-2.662653913336353,-2.5514255219211717,-2.4489474773920703,1.6878390279142343,30,29,30,28,-2,-2,-1,4,-3.01595365810236,-2.8600550612074342,-2.7129789995049207,-7.9418975882528144,2307,2307,McHenry and Nearby Counties,Renville,38,75,North Dakota,ND
38083,38CS004,10,10,10,18,8,8,8,3,3.629520749769766,3.7349814231213996,3.845969690584173,0.3406334817238403,13,12,13,18,5,5,6,3,2.0298944177835865,2.194564809210799,2.350511636424856,0.47215897308699817,1287,1287,McHenry and Nearby Counties,Sheridan,38,83,North Dakota,ND
38101,38CS004,405,376,435,638,233,203,262,159,0.6323658389861935,1.076313802753482,1.5123317322891516,0.6801695482841693,504,469,540,541,37,1,72,50,-0.8792692007420068,-0.24242254210366984,0.43568626763886764,1.3330674527420903,68456,68456,McHenry and Nearby Counties,Ward,38,101,North Dakota,ND
38019,38CS005,39,39,40,40,1,0,1,4,-1.0188396130167434,-0.9205678601005862,-0.8206032304452646,2.5533314836692167,48,48,49,48,-0,-1,0,3,-1.261389997742641,-1.1114224097465766,-0.9516124248864898,5.523281979190623,3725,3725,Northeast North Dakota,Cavalier,38,19,North Dakota,ND
38035,38CS005,437,407,467,486,49,19,79,66,-0.6631206256596666,-0.24431032245301143,0.1893185435832146,1.318752120362454,543,507,579,513,-30,-66,6,37,-1.7359581293223352,-1.138506312705329,-0.5414805107408941,-1.2739748902572867,69591,69591,Northeast North Dakota,Grand Forks,38,35,North Dakota,ND
38063,38CS005,45,44,45,52,7,7,8,11,-1.4094825434011282,-1.3032150507637115,-1.1940863036102671,1.3238870945596757,55,54,55,41,-14,-14,-13,6,-8.538590301768984,-8.371401766477451,-8.212814888109664,-0.47121032753543696,2828,2828,Northeast North Dakota,Nelson,38,63,North Dakota,ND
38067,38CS005,66,66,67,77,11,10,11,10,-0.025807355865360114,0.07276723794888683,0.1713143649444584,0.8689236506206932,82,81,83,79,-3,-4,-2,5,-1.5427088042231447,-1.390006998674129,-1.2360137787079306,-2.8347691893510145,6714,6714,Northeast North Dakota,Pembina,38,67,North Dakota,ND
38091,38CS005,15,15,16,13,-2,-3,-2,5,-3.973703028052085,-3.8714475954547347,-3.7634871595243706,-3.735847022689301,19,19,19,25,6,6,6,1,3.0629206775528175,3.2253002785629175,3.3797953450458427,0.14099128863219035,1896,1896,Northeast North Dakota,Steele,38,91,North Dakota,ND
38097,38CS005,81,80,82,87,6,5,7,14,-1.0725351819228324,-0.9662005689799315,-0.8638661910414026,1.9267618532753457,99,98,100,90,-9,-10,-8,2,-1.8364556871312694,-1.6848601755238588,-1.5318267919115063,-0.24218949483274996,8004,8004,Northeast North Dakota,Traill,38,97,North Dakota,ND
38099,38CS005,121,120,122,128,7,6,8,22,-1.5243491050438647,-1.4164008643179666,-1.319652244905619,2.717498541634264,148,147,150,112,-36,-38,-35,11,-5.571301720075263,-5.4144878096824565,-5.256995939220045,-0.3102900128141283,10517,10517,Northeast North Dakota,Walsh,38,99,North Dakota,ND
38007,38CS006,8,8,8,4,-4,-4,-4,4,-8.638980528118637,-8.534255036553795,-8.433537586031171,-1.4164581813779615,10,9,10,3,-7,-7,-6,3,-12.661876852184907,-12.491774088723504,-12.327300444320366,-0.540911596283866,917,917,Northwest North Dakota,Billings,38,7,North Dakota,ND
38013,38CS006,15,15,16,19,4,3,4,3,0.2323153834796874,0.3349094805677166,0.4433812061879235,0.6363979923139703,19,18,19,20,1,1,2,5,-2.224474415887116,-2.0652845339299484,-1.9142767436405648,2.138216207120674,2126,2126,Northwest North Dakota,Burke,38,13,North Dakota,ND
38023,38CS006,23,23,23,18,-5,-5,-5,3,-3.6522314441349715,-3.5450674574077885,-3.438995761122742,-0.7488953596243603,28,28,28,28,-0,-0,0,4,-2.3010501233352443,-2.157740689874901,-2.0031984908265157,4.2364528881384,2258,2258,Northwest North Dakota,Divide,38,23,North Dakota,ND
38025,38CS006,29,29,30,34,5,4,5,4,0.06253350608902701,0.16328792914388388,0.26557863439282664,0.6974609511750623,36,35,36,38,2,2,3,5,-0.8984074740541527,-0.7407232905018907,-0.5896208838921956,1.533447018662986,4434,4434,Northwest North Dakota,Dunn,38,25,North Dakota,ND
38033,38CS006,10,10,10,12,2,2,2,1,0.39098781469156346,0.5039882319520566,0.6011593570951826,0.3471759885817721,12,12,13,19,7,6,7,3,2.3262801699983804,2.484423336671229,2.637648984563433,0.39295421669525965,1752,1752,Northwest North Dakota,Golden Valley,38,33,North Dakota,ND
38053,38CS006,68,66,70,90,22,20,24,11,0.615259947210987,0.7262153787974633,0.8368199145380127,0.4790876589426215,83,81,85,91,8,6,10,17,-0.8888719943487584,-0.7407883859558521,-0.5737804847875251,1.942560815773412,15123,15123,Northwest North Dakota,McKenzie,38,53,North Dakota,ND
38061,38CS006,81,80,83,108,27,25,28,18,0.7093965821050939,0.8097810986598709,0.9132472782700011,0.6531126628840112,99,98,101,89,-10,-12,-9,16,-3.1593149652821144,-3.012905333271211,-2.857646862302263,-1.7025647801287351,10505,10505,Northwest North Dakota,Mountrail,38,61,North Dakota,ND
38089,38CS006,204,191,218,258,54,40,67,45,-0.162502511740346,0.27210016188121594,0.6939178287044133,0.8254581208799869,252,235,268,245,-7,-23,10,28,-1.8899538764990402,-1.3000998340086038,-0.6433853670761017,-4.922499494191268,31743,31743,Northwest North Dakota,Stark,38,89,North Dakota,ND
38105,38CS006,214,198,231,193,-21,-38,-5,31,-1.7749761292055952,-1.3698915470528918,-0.9244550730087372,-1.5357941037868108,265,245,285,220,-45,-65,-25,30,-2.977970263352059,-2.348616916187758,-1.711317132222487,-0.6882324001990203,38232,38232,Northwest North Dakota,Williams,38,105,North Dakota,ND
38015,38CS007,648,607,690,871,223,181,264,161,0.20457739424748453,0.6351287810714157,1.0921759506242352,0.7196196999070215,804,754,853,841,37,-12,87,87,-1.2317235014898251,-0.6233046765483093,-0.011477467145287303,2.2598197700585154,95981,95981,South Central North Dakota,Burleigh,38,15,North Dakota,ND
38029,38CS007,38,38,39,52,14,13,14,11,0.7541668546573486,0.8594431724398448,0.9653766083959994,0.7452357243335295,47,46,47,42,-5,-5,-4,7,-4.591988909039156,-4.4337624676194105,-4.281734914082615,-1.8004212059792528,3215,3215,South Central North Dakota,Emmons,38,29,North Dakota,ND
38043,38CS007,19,19,19,24,5,5,5,3,0.7003379816299162,0.8028741542130193,0.9122117069024733,0.5009205695341964,23,23,24,33,10,9,10,6,1.5799736509651456,1.7365935255336415,1.904282500132082,0.5667237338078454,2471,2471,South Central North Dakota,Kidder,38,43,North Dakota,ND
38047,38CS007,22,22,22,25,3,3,3,4,-0.6246847950699796,-0.5204241561073782,-0.40829474835408414,0.9933167264054666,27,27,27,25,-2,-2,-2,2,-2.694227543330205,-2.538669733051855,-2.3945280536387616,-2.1176516031354664,1863,1863,South Central North Dakota,Logan,38,47,North Dakota,ND
38051,38CS007,39,38,39,51,12,12,13,4,3.2672453727447768,3.377884723190537,3.4853433896790835,0.3007305131494139,47,47,48,40,-7,-8,-7,3,-5.211670411324681,-5.0607364000046795,-4.903203772893899,-0.47181706934583434,2459,2459,South Central North Dakota,McIntosh,38,51,North Dakota,ND
38001,38CS008,28,27,29,24,-4,-5,-3,3,-3.5722967262393417,-3.1793236953896193,-2.7595421163007567,-0.9982388799476957,34,33,35,38,4,3,5,2,0.3996595376365016,1.03050088621296,1.629333352868647,0.41066050292404854,2211,2211,Southwest North Dakota,Adams,38,1,North Dakota,ND
38011,38CS008,29,28,29,41,12,12,13,6,2.0002134023973395,2.1130598171357784,2.2216697531592136,0.44883885427862985,35,35,36,34,-1,-2,-1,5,-2.6227916505135815,-2.4665071393382605,-2.3005422968122304,-24.929701592814155,3015,3015,Southwest North Dakota,Bowman,38,11,North Dakota,ND
38037,38CS008,28,27,29,37,9,8,10,5,1.159182064830517,1.6259267822407277,2.032545710859414,0.5192039068007496,35,33,36,44,9,8,11,4,2.3117326730873886,2.920466963471145,3.5372962258904996,0.38281028598819566,2248,2248,Southwest North Dakota,Grant,38,37,North Dakota,ND
38041,38CS008,24,24,25,38,14,13,14,8,2.1598994982868716,2.2733673409085444,2.390859519769606,0.5459487047520527,30,30,30,23,-7,-7,-7,6,-6.399981042443141,-6.23289802962146,-6.0778636896138245,-1.0131296950208422,2486,2486,Southwest North Dakota,Hettinger,38,41,North Dakota,ND
38057,38CS008,65,64,66,60,-5,-6,-4,6,-1.4867004693314063,-1.3808973931025703,-1.265025854909705,-1.3850462558686063,80,79,82,87,7,5,8,10,-0.6728247243649862,-0.5053274216498429,-0.35501988892855996,1.330534710241052,8206,8206,Southwest North Dakota,Mercer,38,57,North Dakota,ND
38059,38CS008,266,252,279,326,60,47,74,61,-0.4503549947723675,-0.020376472177559182,0.3978702779301805,0.9966609979965978,327,311,344,353,26,9,42,32,-0.850467365005535,-0.23651931856890201,0.3299841106362544,1.2028757960421605,31385,31385,Southwest North Dakota,Morton,38,59,North Dakota,ND
38065,38CS008,11,11,11,16,5,5,5,2,1.4885287754825822,1.5854779283623626,1.6957346837626557,0.3290925598320864,14,13,14,13,-1,-1,-0,5,-3.577676218197106,-3.419549149112605,-3.2670118582986927,10.56201020140987,1941,1941,Southwest North Dakota,Oliver,38,65,North Dakota,ND
38085,38CS008,35,35,36,53,18,17,18,3,3.363649843017873,3.467817592304196,3.5797658557481253,0.1608737454206247,44,43,44,51,7,7,8,5,0.5447784561801291,0.6962704348639459,0.860482902715193,0.5898956378847126,4223,4223,Southwest North Dakota,Sioux,38,85,North Dakota,ND
38087,38CS008,10,9,10,4,-6,-6,-5,4,-13.13953678569804,-12.732160155980269,-12.31317410498576,-0.8782762701204817,12,11,12,2,-10,-10,-9,2,-19.245248646662766,-18.61435288070407,-18.031917841106836,-0.23115575616476453,751,751,Southwest North Dakota,Slope,38,87,North Dakota,ND
39001,39CS001,306,294,318,347,41,29,53,30,-0.020912628854143342,0.40003138940464594,0.8235691134738984,0.7183903051505723,375,361,389,515,140,126,154,95,1.389349436571843,1.975682956209968,2.5708382473266638,0.6727165436022668,27595,27595,Adams+Brown,Adams,39,1,Ohio,OH
39015,39CS001,455,436,473,544,89,71,108,30,0.9378755744455097,1.367540582467233,1.7967959521979533,0.33159483799804945,557,535,579,681,124,102,146,118,-0.44991165549311213,0.16725867745533354,0.8036648846023855,0.9445066775659117,43448,43448,Adams+Brown,Brown,39,15,Ohio,OH
39003,39CS002,968,925,1012,1178,210,166,253,172,-0.03026982050860469,0.36481674570740924,0.7983274214998409,0.8170422150111467,1187,1135,1240,1359,172,119,224,215,-1.1081273489919097,-0.5190841591510251,0.1184041489666657,1.2445526891813794,102254,102254,Allen,Allen,39,3,Ohio,OH
39005,39CS003,497,474,520,570,73,50,96,69,-0.34787230154108323,0.07337844897790463,0.4884356791732473,0.9345933094024227,610,582,637,724,114,87,142,104,-0.32755737061564816,0.22914579959167497,0.8742285927990407,0.9011710791832591,53395,53395,Ashland,Ashland,39,5,Ohio,OH
39007,39CS004,1026,984,1067,1111,85,44,127,125,-0.8133540984375662,-0.4195242671935072,0.019095705509907846,1.4520664273278205,1255,1205,1305,1539,284,234,334,229,0.08773297510958522,0.6594950498026869,1.3149958052127246,0.8032358601774372,96848,96848,Ashtabula,Ashtabula,39,7,Ohio,OH
39009,39CS005,434,406,462,494,60,32,88,25,0.13643374063119457,0.5224459090350441,0.930511054073526,0.40994099603333845,541,507,575,648,107,73,141,77,-0.05682117347016285,0.5350747256820705,1.1448019269976029,0.7122179933439375,65540,65540,Athens+Hocking,Athens,39,9,Ohio,OH
39073,39CS005,273,261,285,328,55,43,67,42,0.010735385667127749,0.4591728353130625,0.8655386947569098,0.7539512787862719,336,322,351,434,98,83,112,68,0.6250272568942089,1.2553926373515985,1.867127295134828,0.6899910293501577,28180,28180,Athens+Hocking,Hocking,39,73,Ohio,OH
39011,39CS006,411,391,430,541,130,111,150,66,1.0039299815365825,1.4341448162116721,1.8480292358194315,0.5019734807429693,502,478,525,609,107,84,131,86,-0.09694044140760516,0.5621688265334829,1.171972433465395,0.7948184415043257,45639,45639,Auglaize+Mercer,Auglaize,39,11,Ohio,OH
39107,39CS006,346,329,364,456,110,92,127,75,0.43320267579128213,0.8366832527872496,1.2327249415413757,0.6784958840200498,424,403,445,459,35,14,56,37,-0.6398260612986955,-0.07171059807611742,0.6134499560321957,1.0278658818821969,41263,41263,Auglaize+Mercer,Mercer,39,107,Ohio,OH
39013,39CS007,738,710,767,879,141,112,169,98,0.1942023235802938,0.6415152926880617,1.036301003380919,0.6923750842071207,902,867,936,1106,204,170,239,166,0.10232610797399429,0.68317394365885,1.2955489589545661,0.8078377477505955,66543,66543,Belmont,Belmont,39,13,Ohio,OH
39017,39CS008,2971,2805,3137,3648,677,511,843,399,0.2856581272559016,0.7164148152511354,1.1550314906038446,0.5885339322322266,3657,3457,3856,4219,562,363,762,547,-0.5647306770780962,0.07170664746236477,0.6745916139041476,0.9709360764119468,384455,384455,Butler,Butler,39,17,Ohio,OH
39019,39CS009,277,265,288,331,54,43,66,27,0.5708098210376895,1.0219026340728332,1.4669404994622703,0.4866238194603779,340,326,354,398,58,44,72,81,-1.6283532346626808,-1.025466448574296,-0.40164310882419085,1.3730833369997117,26948,26948,Carroll+Harrison+Tuscarawas,Carroll,39,19,Ohio,OH
39067,39CS009,175,168,181,198,23,17,30,17,-0.021784870385205962,0.42471495088129413,0.8526468632988969,0.6982750195642493,214,206,222,288,74,66,82,46,1.6087385464226227,2.2284648949787726,2.8104165002784147,0.61465727197604,15037,15037,Carroll+Harrison+Tuscarawas,Harrison,39,67,Ohio,OH
39157,39CS009,938,898,977,1157,219,180,259,178,-0.013528385718766005,0.4568671999979157,0.8676516418465633,0.8076791447012607,1153,1106,1201,1374,221,173,268,266,-1.2086322357657993,-0.6019094747163117,-0.011685353723091521,1.1991097328906457,91903,91903,Carroll+Harrison+Tuscarawas,Tuscarawas,39,157,Ohio,OH
39021,39CS010,352,336,369,432,80,63,96,36,0.7099988435736593,1.1238041677506374,1.554441770394411,0.4461072379932297,431,411,451,500,69,49,89,77,-0.864881312657165,-0.2406680997250208,0.4118039681693706,1.0977936639096482,38942,38942,Champaign+Logan+Madison+Shelby,Champaign,39,21,Ohio,OH
39091,39CS010,433,414,453,473,40,20,59,43,-0.49341915880786164,-0.0646014026862628,0.34776232934979734,1.0542644044181122,529,506,552,624,95,72,118,98,-0.6790168510842499,-0.08609643392315992,0.5188215240068207,1.0206359845999406,45482,45482,Champaign+Logan+Madison+Shelby,Logan,39,91,Ohio,OH
39097,39CS010,367,348,386,395,28,9,47,45,-0.8189851761837267,-0.3823849415643002,0.08844889794762151,1.5428570338087721,449,426,472,557,108,85,131,68,0.4718099684134914,1.0824874640435278,1.676788750143619,0.625085244187141,44707,44707,Champaign+Logan+Madison+Shelby,Madison,39,97,Ohio,OH
39149,39CS010,397,377,418,518,121,100,141,54,0.9354771090894639,1.3739937658628774,1.8211560200796704,0.4441844117866459,487,462,512,597,110,85,135,104,-0.5023172817069961,0.16649932720359414,0.7283761429263006,0.9344999529201594,48486,48486,Champaign+Logan+Madison+Shelby,Shelby,39,149,Ohio,OH
39023,39CS011,1484,1427,1542,1775,291,233,348,209,0.16121023165343823,0.6150134352869437,1.0472084665246906,0.7161832694335621,1809,1740,1878,2134,325,256,394,235,0.17758602036062132,0.8265013119993064,1.4332646901171968,0.7203036946102108,134014,134014,Clark,Clark,39,23,Ohio,OH
39025,39CS012,1591,1502,1680,1865,274,185,363,147,0.17826504957885833,0.6264349162062822,1.015594910091319,0.5345204216774644,1959,1851,2066,2407,448,341,556,288,0.28925207491629973,0.9046867039539696,1.5450333634091789,0.640873406583311,207100,207100,Clermont,Clermont,39,25,Ohio,OH
39027,39CS013,387,369,405,475,88,70,106,45,0.5742996132570186,1.0133640238944988,1.4647605240527628,0.5078060884054003,474,453,496,574,100,78,121,85,-0.20498596989980747,0.4060659056583773,1.010950726556236,0.8453598583134871,41968,41968,Clinton+Fayette+Highland,Clinton,39,27,Ohio,OH
39047,39CS013,318,305,330,336,18,6,31,31,-0.8521400103040278,-0.43521856265880393,-0.03036297784798252,1.5926504459758355,388,373,403,440,52,37,67,65,-1.1111601944020144,-0.5402220355381505,0.060048767450520006,1.2204039961032163,28525,28525,Clinton+Fayette+Highland,Fayette,39,47,Ohio,OH
39071,39CS013,431,412,450,486,55,36,74,41,-0.10536622367843353,0.3229341673861331,0.7533367254911413,0.7336551995384274,528,505,550,642,114,92,137,102,-0.2767243297064849,0.33640015405858953,0.9335740786190503,0.8831894632069288,43198,43198,Clinton+Fayette+Highland,Highland,39,71,Ohio,OH
39029,39CS014,1100,1057,1144,1284,184,140,227,161,-0.20173669849792805,0.21568994533948982,0.6594802674707853,0.8718231005323748,1345,1293,1397,1624,279,227,331,251,-0.2519390615786979,0.3356724419974862,0.944781892423773,0.8956403870668278,101512,101512,Columbiana,Columbiana,39,29,Ohio,OH
39031,39CS015,359,344,375,426,67,51,82,37,0.3738793811347814,0.8135655747336217,1.2374397045932959,0.5474295680439495,442,423,461,549,107,88,126,98,-0.3322660884676191,0.32416400374059207,0.9485687021872968,0.906319574349769,36507,36507,Coshocton+Holmes,Coshocton,39,31,Ohio,OH
39075,39CS015,294,275,313,372,78,59,97,75,-0.342060274543321,0.06905585998199948,0.49219235076414647,0.9514453353082425,366,343,389,418,52,29,75,77,-1.255756901483461,-0.7044185988538693,-0.013602958096238732,1.4497145919084702,44014,44014,Coshocton+Holmes,Holmes,39,75,Ohio,OH
39033,39CS016,482,464,500,584,102,84,120,75,0.26144420044029526,0.6480068317513566,1.0934370319240891,0.7298671403622262,590,568,611,722,132,111,154,100,0.308529135144242,0.9281392941412239,1.5330167473673915,0.7509294100866589,41372,41372,Crawford+Richland,Crawford,39,33,Ohio,OH
39139,39CS016,1256,1203,1308,1455,199,147,252,141,0.03530878029537978,0.484250195865199,0.8920958772876385,0.7033201898318274,1539,1476,1601,1785,246,184,309,281,-0.9696894006920338,-0.34783586868973204,0.30797702642508545,1.1371410071995378,121179,121179,Crawford+Richland,Richland,39,139,Ohio,OH
39035,39CS017,11667,11139,12196,13820,2153,1624,2681,1496,0.08888348271484028,0.5290238588597727,0.9724848916531211,0.6946828018767413,14280,13646,14914,15948,1668,1034,2302,1677,-0.6273758361789656,-0.005737065034135973,0.601361629420357,1.0046576047296238,1232369,1232369,Cuyahoga,Cuyahoga,39,35,Ohio,OH
39037,39CS018,536,514,558,607,71,49,93,98,-0.9523981821340142,-0.5282257320197061,-0.08183909758760582,1.3646656586606045,658,632,685,727,69,42,95,106,-1.4928191414684686,-0.8712238922693206,-0.26793721108771856,1.5154186501729592,51191,51191,Darke+Preble,Darke,39,37,Ohio,OH
39135,39CS018,413,395,430,486,73,56,91,70,-0.35973227489882625,0.08069758056742825,0.5394296160673642,0.9444946129106035,507,486,528,631,124,103,145,92,0.324773971703193,0.9364182097476239,1.556689609937201,0.7365652155308734,40843,40843,Darke+Preble,Preble,39,135,Ohio,OH
39039,39CS019,348,332,365,409,61,44,77,70,-0.6729603363364709,-0.22632319237291243,0.17114506514399064,1.134034077906848,428,409,448,486,58,38,77,65,-0.8763924810487845,-0.21197570442500518,0.3784374357048312,1.1024894965228416,37895,37895,Defiance+Williams,Defiance,39,39,Ohio,OH
39171,39CS019,365,349,381,368,3,-13,19,51,-1.7192360798361022,-1.3203639847248985,-0.8897477135621987,12.181594346354583,448,429,466,517,69,51,88,87,-1.1818416825747007,-0.5861681268313194,-0.0026496156371462205,1.2348205788018034,36682,36682,Defiance+Williams,Williams,39,171,Ohio,OH
39041,39CS020,1040,948,1131,1241,201,110,293,89,0.09557921985145255,0.5392651282209338,0.9666984512844504,0.4397887175344462,1301,1190,1411,1525,224,114,335,132,-0.10943355695203244,0.5321040223690967,1.1037501746739147,0.5859200709420689,211346,211346,Delaware,Delaware,39,41,Ohio,OH
39043,39CS021,811,779,843,1025,214,182,246,114,0.9403068673330718,1.3575691625035227,1.7659429534913782,0.5303903572556258,990,952,1028,1136,146,108,184,111,-0.056656223557784255,0.566986536452483,1.1915941281589124,0.7543512735339633,73987,73987,Erie,Erie,39,43,Ohio,OH
39045,39CS022,1215,1147,1284,1439,224,155,292,136,0.12353462004023488,0.547612990409737,0.9460600605062254,0.6048479563777596,1501,1419,1584,1816,315,232,397,221,0.102660628134321,0.7031445757772304,1.3007242091742746,0.6996390299567175,158539,158539,Fairfield,Fairfield,39,45,Ohio,OH
39049,39CS023,8665,8095,9234,10063,1398,829,1968,1033,-0.13776037699688695,0.2829593313921739,0.6657465777487656,0.7382861209188222,10691,10007,11375,11848,1157,473,1841,1056,-0.4628019253190729,0.09576339167112108,0.7151599592573733,0.9118884742525186,1321207,1321207,Franklin,Franklin,39,49,Ohio,OH
39051,39CS024,372,354,390,450,78,60,96,47,0.32208250740602157,0.7342810671336384,1.1236014866981408,0.5979041630089386,457,435,479,545,88,66,110,103,-1.064524081354472,-0.44441051814658306,0.18071194540169394,1.1590341222255764,42056,42056,Fulton+Henry,Fulton,39,51,Ohio,OH
39069,39CS024,250,238,261,315,65,54,77,50,0.16571415300188083,0.5749798606423068,1.0036936736064013,0.7539819757812387,306,292,320,370,64,50,78,45,0.22321930269373869,0.8255195232840425,1.423317267552511,0.6960019607833295,26926,26926,Fulton+Henry,Henry,39,69,Ohio,OH
39053,39CS025,330,317,342,381,51,39,64,30,0.250099088495764,0.7180940550634883,1.1587651709554223,0.5718744674015216,404,388,419,438,34,19,50,63,-1.7621408009117372,-1.1269678663445146,-0.5700503661531393,1.7792444600275152,29830,29830,Gallia+Meigs,Gallia,39,53,Ohio,OH
39105,39CS025,257,247,267,299,42,32,52,22,0.4654291277026492,0.8768914657529618,1.283137575282284,0.5130206722090697,315,303,326,379,64,53,76,49,0.15829992162037518,0.7995721312557026,1.429908835875488,0.748752671612869,22789,22789,Gallia+Meigs,Meigs,39,105,Ohio,OH
39055,39CS026,717,677,758,887,170,129,210,118,0.09014248407194703,0.5497735714156142,0.9434510873354031,0.6919820001352212,883,835,931,1094,211,163,259,109,0.6841310397793111,1.3341054640978236,1.9337753328317218,0.514504646355176,93401,93401,Geauga,Geauga,39,55,Ohio,OH
39057,39CS027,1335,1261,1408,1595,260,187,334,169,0.10057106489780178,0.5446447196503538,0.9569058846957953,0.6465573052479975,1645,1557,1733,1912,267,179,355,255,-0.5634942104460097,0.09273394805650412,0.7067464753985384,0.9525214213970987,169674,169674,Greene,Greene,39,57,Ohio,OH
39059,39CS028,411,394,428,458,47,30,64,38,-0.1930692576904542,0.224981011995267,0.6376315805319677,0.7907671638188349,503,483,523,656,153,133,173,74,1.8036455435872738,2.435746832831532,3.012424297555186,0.4805969739548461,38836,38836,Guernsey+Monroe+Noble,Guernsey,39,59,Ohio,OH
39111,39CS028,148,142,154,163,15,9,21,27,-1.2819153598233366,-0.8902921383947208,-0.4624056496375467,1.6992185001152655,181,174,188,235,54,47,61,37,0.8845710424207276,1.4749587926445804,2.0646678229255953,0.6739345045029498,13657,13657,Guernsey+Monroe+Noble,Monroe,39,111,Ohio,OH
39121,39CS028,122,120,123,135,13,12,15,32,-1.4069079374002733,-1.2987387649144961,-1.1915368698005584,2.2416740942606745,150,148,152,162,12,10,14,19,-0.7385872761779912,-0.58657221588843,-0.4375615360763357,1.4653809058015728,14415,14415,Guernsey+Monroe+Noble,Noble,39,121,Ohio,OH
39061,39CS029,6861,6509,7213,7950,1089,737,1441,802,-0.11679148870165439,0.3459602133607066,0.7795194296475624,0.7359694412809554,8410,7987,8832,9021,611,189,1034,928,-1.0597638922200887,-0.46432574826159745,0.11645742137369391,1.515256221339068,818375,818375,Hamilton,Hamilton,39,61,Ohio,OH
39063,39CS030,668,636,700,766,98,66,130,96,-0.3938494671661664,0.011931431348602814,0.4465663248170809,0.9696967760576111,819,780,858,920,101,62,140,136,-1.1626808957409769,-0.5593709188062045,0.0782179080623115,1.3276998827228608,75572,75572,Hancock,Hancock,39,63,Ohio,OH
39065,39CS031,273,260,287,340,67,53,80,47,0.20160503904197338,0.6335700595503202,1.0541036837449327,0.6920755046255542,335,319,352,486,151,134,167,80,2.142592096070461,2.6721792951159613,3.297569752587798,0.527756679570372,31411,31411,Hardin+Wyandot,Hardin,39,65,Ohio,OH
39175,39CS031,217,207,226,274,57,48,67,34,0.6524554157916848,1.0561017687030574,1.4635462141350155,0.583928109942069,265,254,277,304,39,27,50,49,-1.1583863808716788,-0.5566604307208887,0.04006763726932737,1.234216019309131,21761,21761,Hardin+Wyandot,Wyandot,39,175,Ohio,OH
39077,39CS032,524,499,549,652,128,103,153,79,0.43726652427972557,0.8378701652237036,1.2513078591533124,0.6122077191851588,645,615,675,733,88,58,118,107,-1.0059080799659588,-0.3823110130865828,0.18871408511782514,1.1982058108982891,58148,58148,Huron,Huron,39,77,Ohio,OH
39079,39CS033,372,358,386,405,33,19,47,36,-0.4684418253752253,-0.07526774340303206,0.3548507820319371,1.046458876851049,457,441,474,518,61,44,77,80,-1.3621644498592695,-0.7193075340188403,-0.08829943893218667,1.299297834543326,32422,32422,Jackson+Pike+Vinton,Jackson,39,79,Ohio,OH
39131,39CS033,322,310,334,363,41,29,53,14,0.5083830444961112,0.9905628431269992,1.3947931853184221,0.3319564580697427,396,381,410,481,85,71,100,74,-0.15407593757911833,0.5001332124659029,1.1453819886078835,0.8582284906034148,27747,27747,Jackson+Pike+Vinton,Pike,39,131,Ohio,OH
39163,39CS033,139,134,145,163,24,18,29,10,0.6245380144764859,1.059187717103823,1.4928746176207566,0.40544226698134095,172,165,178,226,54,48,61,35,1.156020010005531,1.790363286033998,2.397120639561691,0.6326839714352746,13005,13005,Jackson+Pike+Vinton,Vinton,39,163,Ohio,OH
39081,39CS034,782,754,810,867,85,57,113,91,-0.4985162408230445,-0.10929001849597168,0.3494358839452721,1.0599951270772334,953,919,986,1173,220,187,254,170,0.34090039356465596,0.92453008136886,1.519779474742688,0.7680603271837605,65263,65263,Jefferson,Jefferson,39,81,Ohio,OH
39083,39CS035,530,503,556,642,112,86,139,73,0.19165924277279345,0.6242672751469007,1.0776160994215105,0.6431929481691561,646,613,678,816,170,138,203,125,0.20469548489999795,0.8693482005083831,1.5142494990087867,0.7295126369537647,62316,62316,Knox+Morrow,Knox,39,83,Ohio,OH
39117,39CS035,279,264,294,320,41,26,56,26,-0.03749160301439325,0.4282361714945853,0.8462700966823108,0.6185572077972288,341,322,359,416,75,57,94,58,-0.008120167621828234,0.595819750771816,1.2683856404740923,0.7585527759213285,35371,35371,Knox+Morrow,Morrow,39,117,Ohio,OH
39085,39CS036,2160,2061,2259,2476,316,217,415,246,-0.10267336621272194,0.3191412096716819,0.7034794273341495,0.7759841761913033,2647,2528,2766,3086,439,320,558,359,-0.21902563398937175,0.4225638479599692,1.0423802640745812,0.8160249166486645,229668,229668,Lake,Lake,39,85,Ohio,OH
39087,39CS037,714,689,739,814,100,75,125,59,0.2479823805799309,0.699104049539914,1.141462058762546,0.5840328994236812,873,843,904,1078,205,174,235,137,0.7358209184160399,1.3815366972480605,1.9764539615757717,0.6656231743945136,59362,59362,Lawrence,Lawrence,39,87,Ohio,OH
39089,39CS038,1471,1395,1548,1618,147,70,223,156,-0.47421524149459154,-0.04586686651903537,0.358240632091348,1.0573707758600734,1810,1718,1902,2178,368,276,460,247,0.20254410757545957,0.8195922647518663,1.4689822575291642,0.6686405758862356,177560,177560,Licking,Licking,39,89,Ohio,OH
39093,39CS039,2751,2617,2886,3103,352,217,486,314,-0.3323921121438507,0.12048615015581161,0.5493727733534319,0.8906195213165248,3379,3218,3541,4042,663,501,824,497,-0.017506303883819765,0.6307986708459224,1.3245789963047911,0.7489019487692269,310963,310963,Lorain,Lorain,39,93,Ohio,OH
39095,39CS040,3917,3733,4101,4860,943,759,1127,591,0.40201049132125716,0.8120950550757049,1.2519520468451784,0.6260660354819576,4812,4590,5033,5496,684,463,906,602,-0.3349045780339634,0.2376884956032495,0.8201453344283514,0.8781942010359767,428640,428640,Lucas+Ottawa,Lucas,39,95,Ohio,OH
39123,39CS040,429,412,446,506,77,60,94,54,0.16491673365229875,0.574435525771281,1.01083110192853,0.6925343741519827,525,504,546,626,101,80,122,72,0.22812092811748227,0.8524228064467989,1.4671940613393895,0.7060217284624084,40416,40416,Lucas+Ottawa,Ottawa,39,123,Ohio,OH
39099,39CS041,2549,2451,2646,3285,736,639,834,476,0.7135410235199484,1.1514522707942862,1.5517883562061223,0.6455172919996387,3107,2990,3224,3615,508,391,625,459,-0.34703068309398777,0.270388262578903,0.9044312265921486,0.9018803298082383,226912,226912,Mahoning,Mahoning,39,99,Ohio,OH
39101,39CS042,660,632,688,709,49,21,77,111,-1.406593710897445,-0.9492824139541907,-0.515499254731622,2.2203367587338105,808,774,841,934,126,93,160,120,-0.47873995944307823,0.09489897135062489,0.6683780634284118,0.9443449787806072,64958,64958,Marion,Marion,39,101,Ohio,OH
39103,39CS043,1327,1249,1405,1593,266,188,344,182,0.04082955041139054,0.46020473303920983,0.8831266134621655,0.6810856141875156,1635,1541,1728,2003,368,275,462,245,0.21504925596520294,0.8129510957505311,1.4442108892616172,0.6637406426249249,180451,180451,Medina,Medina,39,103,Ohio,OH
39109,39CS044,978,932,1025,1096,118,71,164,130,-0.5559222046149199,-0.10982178582381559,0.3146176969096464,1.0960882558536746,1201,1145,1256,1465,264,209,320,257,-0.539523247417946,0.08231075530985711,0.6807517905383921,0.9686259221152171,107212,107212,Miami,Miami,39,109,Ohio,OH
39113,39CS045,5369,5140,5598,6341,972,743,1201,692,0.1196028449266426,0.5347978729991644,0.953930994628194,0.7111254497027124,6572,6297,6847,7357,785,510,1060,886,-0.8524761096385846,-0.22331207607789222,0.3405762394849701,1.1271685158075133,531919,531919,Montgomery,Montgomery,39,113,Ohio,OH
39115,39CS046,155,149,161,188,33,27,39,16,0.7552157477394303,1.1819590170207275,1.6105472431417682,0.4697784643041912,190,182,197,267,77,70,85,36,2.8207529182289313,3.4262537277494776,4.008580885283349,0.4596121993129433,14422,14422,Morgan+Perry,Morgan,39,115,Ohio,OH
39127,39CS046,318,302,333,372,54,39,70,36,0.046452333750259915,0.5129474403632428,0.964005075874708,0.6486613872365261,391,372,410,491,100,81,119,66,0.5195212572977198,1.118783294532591,1.7523771281210128,0.6542223753716356,36164,36164,Morgan+Perry,Perry,39,127,Ohio,OH
39119,39CS047,862,825,899,983,121,84,158,84,0.0010164427781375529,0.4372845014708225,0.8511291171402249,0.686981572895771,1055,1010,1099,1180,125,81,170,165,-1.1754052669284698,-0.5504793166836097,0.06807695039302263,1.3061736270062905,86033,86033,Muskingum,Muskingum,39,119,Ohio,OH
39125,39CS048,180,172,188,204,24,16,32,28,-0.6244299644014255,-0.23191806620131022,0.19135938620232051,1.1295015109316555,221,211,230,220,-1,-10,9,42,-3.3492539387695377,-2.762133399723859,-2.1660605705198908,155.28982534712358,18662,18662,Paulding+Putnam+Van Wert,Paulding,39,125,Ohio,OH
39137,39CS048,267,252,281,350,83,69,98,81,-0.3660259585609005,0.06487326943265881,0.47778665674462467,0.9627903954537961,328,311,346,381,53,35,70,56,-0.7625164424646699,-0.10551944730013763,0.4594442827772599,1.0411262573194402,33764,33764,Paulding+Putnam+Van Wert,Putnam,39,137,Ohio,OH
39161,39CS048,276,264,288,342,66,54,78,56,-0.08402437063067572,0.34889638963724695,0.7683553227902928,0.8330735637944959,338,323,352,402,64,50,79,66,-0.7081340507585229,-0.06203585845474001,0.5820190524296603,1.0100888054470514,28201,28201,Paulding+Putnam+Van Wert,Van Wert,39,161,Ohio,OH
39129,39CS049,530,505,555,627,97,72,122,83,-0.18414988212587452,0.22212886968868764,0.6803278720374705,0.8458782612520274,651,621,682,766,115,84,145,104,-0.3957977355671206,0.19042158546471943,0.7946370127284615,0.898493094882219,58578,58578,Pickaway,Pickaway,39,129,Ohio,OH
39133,39CS050,1291,1221,1361,1453,162,92,232,125,-0.16843363846353826,0.23298085462696677,0.6586564031958336,0.768133922118465,1587,1503,1671,1947,360,276,444,250,0.1857596708921455,0.8195871215230409,1.4391035054852628,0.6924624241305032,162491,162491,Portage,Portage,39,133,Ohio,OH
39141,39CS051,744,711,777,948,204,171,237,102,0.8958666577545036,1.337989622404595,1.7881647350354797,0.49703009583406543,911,871,950,1144,233,194,273,154,0.6033414686609485,1.2315982158489696,1.863043988625141,0.6577545003826922,76533,76533,Ross,Ross,39,141,Ohio,OH
39143,39CS052,582,557,607,633,51,26,76,87,-1.050995254520995,-0.6129884549926266,-0.18414598288752862,1.6702381792564536,713,683,743,859,146,116,176,115,-0.030242653954455637,0.6108376692636093,1.259429285623396,0.784200396660941,58450,58450,Sandusky,Sandusky,39,143,Ohio,OH
39145,39CS053,884,852,916,1092,208,176,240,66,1.489425497659959,1.901049848349062,2.34484779450652,0.3153539653207002,1082,1043,1120,1313,231,193,270,142,0.8265624480923839,1.4371299723048183,2.0515085627176735,0.6114636205249389,74758,74758,Scioto,Scioto,39,145,Ohio,OH
39147,39CS054,521,497,545,609,88,64,112,76,-0.2053953175516335,0.22709856695803804,0.6426485002792724,0.8539621072752154,638,610,667,774,136,107,164,129,-0.4582414314066917,0.1378413800934116,0.773463270083975,0.9424498388508101,55102,55102,Seneca,Seneca,39,147,Ohio,OH
39151,39CS055,3714,3554,3873,4484,770,611,930,643,-0.09929284098895637,0.3292801503186396,0.7881425115033759,0.8334741723119957,4550,4359,4741,5401,851,660,1042,796,-0.4171871376766729,0.18989414247241648,0.8427931183327741,0.9340628600301429,370327,370327,Stark,Stark,39,151,Ohio,OH
39153,39CS056,5001,4769,5233,5794,793,561,1025,651,-0.15680715642785167,0.26869147155963197,0.6629634577513743,0.8198066403866351,6123,5845,6402,7029,906,627,1184,805,-0.40746086714177143,0.23633490432886695,0.8616226958286456,0.8878002943011195,540002,540002,Summit,Summit,39,153,Ohio,OH
39155,39CS057,2180,2095,2264,2647,467,383,552,353,0.15081070352363277,0.5630564087133721,0.9933248974769094,0.7536964601629331,2661,2560,2763,3251,590,488,691,435,0.31547109281574176,0.9520583791853298,1.5672327647620974,0.7364984026239257,197540,197540,Trumbull,Trumbull,39,155,Ohio,OH
39159,39CS058,359,333,385,412,53,27,79,27,-0.017055488006940393,0.44379010264579527,0.8615222587536612,0.5006879711284113,445,414,476,493,48,17,79,56,-0.8230358662814112,-0.15874048490980633,0.4806159274198557,1.1466041055784586,59457,59457,Union,Union,39,159,Ohio,OH
39165,39CS059,1585,1483,1687,1888,303,201,405,208,-0.025854848883265058,0.40494026696791996,0.8624190217436869,0.6842589420239008,1963,1840,2087,2348,385,261,508,291,-0.13904983024977202,0.46904261491264315,1.1147518175524378,0.7545892523738977,236772,236772,Warren,Warren,39,165,Ohio,OH
39167,39CS060,636,611,662,696,60,34,85,80,-0.762700924215446,-0.33454231023637937,0.10288185260671281,1.3211662417269328,776,745,807,875,99,68,130,88,-0.4445500685834075,0.21468760969019957,0.8973063095620722,0.8807020755512562,59866,59866,Washington,Washington,39,167,Ohio,OH
39169,39CS061,1001,951,1051,1153,152,102,202,156,-0.4782530890264884,-0.02071813893218569,0.403823098506475,1.0188847726270824,1232,1172,1292,1494,262,202,322,208,-0.05646214025023293,0.5601851122180808,1.2355139231816519,0.7908129612103705,115770,115770,Wayne,Wayne,39,169,Ohio,OH
39173,39CS062,1005,949,1062,1197,192,135,248,145,-0.09125314210042228,0.3678213822037034,0.7797823986786948,0.7523993022142219,1237,1170,1305,1361,124,56,191,152,-0.8894664128974142,-0.25309381690151195,0.36259075684946823,1.2205238579815887,131099,131099,Wood,Wood,39,173,Ohio,OH
40001,40CS001,213,203,222,241,28,19,38,28,-0.39728266567267456,0.009607811102449794,0.4294093060146918,0.9504264937831501,259,248,270,343,84,73,95,61,0.6856995084425338,1.2471867757281438,1.8857458806875826,0.7178474859639683,22112,22112,Adair+Cherokee+Sequoyah,Adair,40,1,Oklahoma,OK
40021,40CS001,418,397,439,514,96,75,117,52,0.4542206649197712,0.8885292036786329,1.3074849730050284,0.5370468907468918,511,486,537,632,121,95,146,72,0.577346722355321,1.186254058572319,1.8406419987436615,0.5923818273266063,48902,48902,Adair+Cherokee+Sequoyah,Cherokee,40,21,Oklahoma,OK
40135,40CS001,441,423,459,560,119,101,137,54,1.130331445013941,1.5451505412001276,1.9948011965574617,0.44972959344108765,537,516,559,689,152,130,173,108,0.635672900423165,1.279209752674983,1.9235733433114468,0.7062244277580467,41574,41574,Adair+Cherokee+Sequoyah,Sequoyah,40,135,Oklahoma,OK
40005,40CS002,147,141,153,180,33,27,39,20,0.4835790647403484,0.922808277361469,1.3362423590983823,0.5950252953180711,179,172,187,195,16,8,23,33,-2.1676752658281297,-1.5084819093177704,-0.9018912912710547,1.9865881672216459,13810,13810,Atoka+Bryan+Coal,Atoka,40,5,Oklahoma,OK
40013,40CS002,457,436,478,524,67,46,88,68,-0.4091995255810776,-0.017487232661220264,0.40548933204987603,0.9948937904890455,557,532,582,713,156,131,181,110,0.5118837117502109,1.1327396610703324,1.7298847055648752,0.7009613291866342,48468,48468,Atoka+Bryan+Coal,Bryan,40,13,Oklahoma,OK
40029,40CS002,73,73,74,93,20,19,20,10,1.663499037302628,1.7641069034688037,1.8762767751442129,0.4811873189924397,89,89,90,93,4,3,4,6,-0.6860647970207849,-0.5291675420182492,-0.36872792585642095,1.3132702772191387,5543,5543,Atoka+Bryan+Coal,Coal,40,29,Oklahoma,OK
40009,40CS003,199,190,209,249,50,40,59,49,-0.39291647053260315,0.04209181364287631,0.4478130763713491,0.9683613605398538,245,234,256,298,53,42,64,46,-0.2825725371926583,0.3789756441819266,1.027386801276968,0.8546695551995864,21682,21682,Beckham+Custer+Roger Mills+Washita,Beckham,40,9,Oklahoma,OK
40039,40CS003,263,250,275,341,78,66,91,72,-0.2261408452833671,0.2205476222218586,0.6204997202099874,0.9089423277043933,323,309,338,332,9,-6,23,55,-2.543715262934467,-1.938609712203275,-1.2916516104697133,5.748229297397365,28803,28803,Beckham+Custer+Roger Mills+Washita,Custer,40,39,Oklahoma,OK
40129,40CS003,31,31,32,47,16,15,16,11,1.2403903657515623,1.3536729744314542,1.4554054966638483,0.6531061092618541,38,38,39,52,14,13,14,3,3.397814031731546,3.5554835024416014,3.7111575483737376,0.2052980449865713,3583,3583,Beckham+Custer+Roger Mills+Washita,Roger Mills,40,129,Oklahoma,OK
40149,40CS003,119,118,120,138,19,18,20,20,-0.18595642837729107,-0.08305324712219944,0.022603365176261533,0.994156394972202,146,145,148,162,16,14,17,27,-1.3732640775232199,-1.2200745001697841,-1.0749327274284497,1.5965201508454179,10896,10896,Beckham+Custer+Roger Mills+Washita,Washita,40,149,Oklahoma,OK
40015,40CS004,316,304,328,413,97,85,109,81,0.1084845764092656,0.568289663172345,0.9681151799533827,0.8268540535260864,387,372,402,437,50,35,65,73,-1.586793435974809,-0.9880431380535724,-0.33980424947742255,1.4346067975366883,28826,28826,Caddo+Grady,Caddo,40,15,Oklahoma,OK
40051,40CS004,489,465,513,608,119,95,143,92,0.06260672263712935,0.4851376838485962,0.8829379249409207,0.7668913466778111,603,574,632,747,144,115,173,114,0.05560926927284537,0.6555226094504298,1.2625845446235158,0.7853343552380005,55823,55823,Caddo+Grady,Grady,40,51,Oklahoma,OK
40017,40CS005,966,901,1032,1086,120,54,185,157,-0.6699174941188523,-0.27651848382661065,0.17492888887828767,1.300728537859934,1198,1119,1277,1355,157,78,236,186,-0.8998614103115362,-0.21665017962557562,0.42684326412251117,1.1783830473129915,150534,150534,Canadian,Canadian,40,17,Oklahoma,OK
40019,40CS006,484,463,505,590,106,85,127,51,0.7103372842609866,1.1334516527070548,1.5547727744176012,0.4770785266839851,587,562,612,814,227,202,252,153,1.2023596539937627,1.834731579371689,2.48989640768986,0.670417256917286,48338,48338,Carter+Johnston+Love+Marshall,Carter,40,19,Oklahoma,OK
40069,40CS006,127,123,132,125,-2,-7,2,19,-2.3238077158664234,-1.925928634079175,-1.499983822834669,-15.936915114757795,154,148,159,177,23,18,29,34,-1.7107608382914141,-1.162841119777328,-0.5505697585646948,1.3969623852168782,10959,10959,Carter+Johnston+Love+Marshall,Johnston,40,69,Oklahoma,OK
40085,40CS006,100,99,101,119,19,18,20,17,0.05293354636676474,0.16616869671203757,0.2765701731025122,0.8645326413996093,123,122,124,148,25,24,26,25,-0.16318602843266228,-0.006407556227357298,0.14521475880747903,0.9624713061474085,10199,10199,Carter+Johnston+Love+Marshall,Love,40,85,Oklahoma,OK
40095,40CS006,175,168,182,220,45,38,52,19,1.082928919046842,1.527487892717363,1.9958580699422543,0.4131991451067429,212,203,221,267,55,46,64,34,0.7924186278173588,1.4622724095915123,2.1060202936800785,0.6100108106750244,17016,17016,Carter+Johnston+Love+Marshall,Marshall,40,95,Oklahoma,OK
40023,40CS007,175,168,181,232,57,51,64,22,1.9879982721743685,2.415629093999513,2.84974443053839,0.37712987118956987,211,204,219,294,83,75,90,54,1.762153043637926,2.3788096346455885,2.984448969716289,0.6441556797403697,14644,14644,Choctaw+McCurtain+Pushmataha,Choctaw,40,23,Oklahoma,OK
40089,40CS007,343,329,357,476,133,119,147,84,1.06996873778108,1.5033163162366099,1.9243291414316281,0.6266929911268825,415,398,432,602,187,170,204,114,2.0393097326467315,2.656206678840603,3.2981876737317117,0.6066651034332877,32758,32758,Choctaw+McCurtain+Pushmataha,McCurtain,40,89,Oklahoma,OK
40127,40CS007,140,135,144,159,19,15,24,10,0.41563169009385514,0.8474433496595609,1.2723899581428215,0.4927375582013711,169,163,174,253,84,79,90,45,3.699999853303134,4.291740265183845,4.9372518141487935,0.5278104516060583,11005,11005,Choctaw+McCurtain+Pushmataha,Pushmataha,40,127,Oklahoma,OK
40027,40CS008,1774,1651,1898,2071,297,173,420,238,-0.2355495557623272,0.19492122348578486,0.6247375316018811,0.7993280212358254,2198,2050,2346,2565,367,219,515,309,-0.40337160058999244,0.24406984407853072,0.8343675724616765,0.839926790105905,285591,285591,Cleveland,Cleveland,40,27,Oklahoma,OK
40031,40CS009,882,830,934,1077,195,143,247,92,0.43382558382403547,0.8543176775731743,1.3200441827816207,0.4692500853334511,1084,1022,1147,1424,340,277,402,224,0.5034055593887862,1.1395228661065848,1.7362443684509206,0.6573465220458943,121172,121172,Comanche,Comanche,40,31,Oklahoma,OK
40033,40CS010,63,62,64,84,21,20,22,13,1.3009490497632952,1.3999188909268636,1.5103787578789376,0.5925563353814982,77,77,78,107,30,29,30,15,2.962077454158813,3.108297029397299,3.270985236154078,0.48894228784016935,5661,5661,Cotton+Jefferson+Stephens,Cotton,40,33,Oklahoma,OK
40067,40CS010,71,70,72,88,17,16,18,5,1.9034442225440922,2.008296387488437,2.1112989809509095,0.2777486714242351,87,86,88,97,10,9,11,12,-0.5611214615581274,-0.40385965525380046,-0.24309484211500726,1.0918440021640867,5972,5972,Cotton+Jefferson+Stephens,Jefferson,40,67,Oklahoma,OK
40137,40CS010,487,468,505,541,54,36,73,56,-0.4732495927843803,-0.04344569027289775,0.3639663227605215,1.0133247059183887,597,575,619,697,100,78,122,110,-0.8617186391790923,-0.2729418739181688,0.3458254964590406,1.0881828566675598,43192,43192,Cotton+Jefferson+Stephens,Stephens,40,137,Oklahoma,OK
40035,40CS011,172,166,178,196,24,18,30,19,-0.08547175706997917,0.34519139249784914,0.773887899450435,0.763397081378018,210,202,217,225,15,8,23,27,-1.5870020053706975,-0.9867638904742866,-0.39873537530794206,1.6422909186926977,14145,14145,Craig+Mayes,Craig,40,35,Oklahoma,OK
40097,40CS011,421,403,438,470,49,32,67,53,-0.48783586071541574,-0.10398829469149094,0.34591314653091904,1.0548807079887272,513,492,535,649,136,114,157,86,0.7957889101130589,1.4401821029542856,2.07573288366009,0.6295652337161977,41143,41143,Craig+Mayes,Mayes,40,97,Oklahoma,OK
40037,40CS012,730,700,761,801,71,40,101,100,-0.8429521481817094,-0.4157811780236369,0.030477579996399277,1.3966974717609377,892,855,929,1070,178,141,215,188,-0.7549707656238905,-0.14749279027328333,0.46231418332795815,1.0495806252977369,71413,71413,Creek,Creek,40,37,Oklahoma,OK
40041,40CS013,476,457,494,612,136,118,155,88,0.6981444363303071,1.1108006609592112,1.5500588026187803,0.6419189550110775,580,558,602,751,171,149,193,118,0.868181348665634,1.45600412107902,2.082017525662921,0.6868887057161951,43063,43063,Delaware+Ottawa,Delaware,40,41,Oklahoma,OK
40115,40CS013,366,353,380,408,42,28,55,53,-0.8029656203021701,-0.37647348987734974,0.04135171183541681,1.2468452346273373,446,430,462,566,120,104,136,74,1.177131481378555,1.8051481471881248,2.373924252672045,0.6108305540466804,31055,31055,Delaware+Ottawa,Ottawa,40,115,Oklahoma,OK
40047,40CS014,586,560,612,709,123,97,149,128,-0.5467176321527654,-0.08249756321490731,0.3593458403762646,1.0321048977011098,717,685,748,861,144,113,176,92,0.4339719410823765,1.0367331868131322,1.6275605738664336,0.6331600917749202,61139,61139,Garfield,Garfield,40,47,Oklahoma,OK
40049,40CS015,305,293,317,361,56,44,68,47,-0.12017319007127332,0.31288147109587583,0.757219501191775,0.8263341604275782,374,360,388,452,78,64,92,72,-0.3652533449289301,0.2625199791320169,0.8335101234225747,0.9130441510459364,27689,27689,Garvin+McClain+Murray,Garvin,40,49,Oklahoma,OK
40087,40CS015,343,325,361,389,46,28,64,62,-0.8470836794767028,-0.3790620006504844,0.03812833280298835,1.3168426323864428,424,403,446,437,13,-9,34,51,-1.8022252999536792,-1.1168697951953366,-0.5067455323357963,3.6922862799570293,40834,40834,Garvin+McClain+Murray,McClain,40,87,Oklahoma,OK
40099,40CS015,166,160,172,183,17,11,23,16,-0.37736358477320164,0.04032333213665997,0.45857344344186807,0.9108498857896449,204,196,211,242,38,31,46,42,-0.9130673890082681,-0.32560146479070984,0.33429764259748407,1.0658592321420715,14028,14028,Garvin+McClain+Murray,Murray,40,99,Oklahoma,OK
40053,40CS016,52,52,53,66,14,13,14,5,1.9135712625629944,2.018846426959763,2.128747651071991,0.33858303712997706,64,64,65,70,6,5,6,4,0.34072420221849337,0.5007477770403258,0.6612154951634451,0.5862442187230998,4346,4346,Grant+Kay,Grant,40,53,Oklahoma,OK
40071,40CS016,497,478,515,606,109,91,128,102,-0.26255241762695575,0.1787707115890928,0.6024860589840277,0.9232825534387636,608,586,630,680,72,50,94,90,-1.0895050229493817,-0.5021393794572898,0.08844503156900696,1.2330067784931455,43504,43504,Grant+Kay,Kay,40,71,Oklahoma,OK
40061,40CS017,149,143,154,152,3,-2,9,13,-1.2015530827065721,-0.7633753609965663,-0.3180528630421069,2.9367597801141887,181,174,187,196,15,9,22,34,-2.4215290158997442,-1.79414357569707,-1.106897842897972,2.1052776051315716,12662,12662,Haskell+Latimer+Pittsburg,Haskell,40,61,Oklahoma,OK
40077,40CS017,123,122,124,100,-23,-24,-22,10,-3.3344910546177213,-3.229671806540777,-3.1287562145935626,-0.4635605207449516,150,149,151,167,17,16,18,27,-1.3362443702778941,-1.1782203066313284,-1.021638653169265,1.4909621561785011,10081,10081,Haskell+Latimer+Pittsburg,Latimer,40,77,Oklahoma,OK
40121,40CS017,508,489,527,586,78,59,97,52,0.1689231191269488,0.5896257208008954,1.0068890659494232,0.658987010288573,619,596,641,810,191,169,214,136,0.9336097791862094,1.5263467796131958,2.1538938627964828,0.7069926906410461,43676,43676,Haskell+Latimer+Pittsburg,Pittsburg,40,121,Oklahoma,OK
40063,40CS018,165,159,170,183,18,13,24,26,-0.9947929275627109,-0.5701415095203015,-0.15341583162476558,1.3394749885933341,201,194,208,228,27,20,34,29,-0.8295046135859895,-0.19116014383383284,0.4225287052198743,1.0423053106699638,13192,13192,Hughes+Okfuskee+Pontotoc+Seminole,Hughes,40,63,Oklahoma,OK
40107,40CS018,160,155,165,174,14,9,19,28,-1.5870702832263044,-1.169225420794424,-0.7002421688721016,1.8372632557258615,195,189,201,191,-4,-10,2,30,-4.0485846917009605,-3.417630663082322,-2.8218287271248292,-10.459631301346406,11876,11876,Hughes+Okfuskee+Pontotoc+Seminole,Okfuskee,40,107,Oklahoma,OK
40123,40CS018,379,362,395,429,50,34,67,43,-0.22995266373893827,0.19055434928917028,0.6211700835820702,0.8377225276833404,466,446,485,596,130,111,150,79,0.985130128776365,1.592483891552957,2.1868450132940698,0.6012651784592266,38371,38371,Hughes+Okfuskee+Pontotoc+Seminole,Pontotoc,40,123,Oklahoma,OK
40133,40CS018,290,280,300,353,63,53,73,41,0.5108698981601295,0.9003727917445989,1.3368820039787186,0.6404914573084518,355,342,367,427,72,60,85,62,-0.0649698582202523,0.48673948523863897,1.114037288013882,0.8486524000796274,24291,24291,Hughes+Okfuskee+Pontotoc+Seminole,Seminole,40,133,Oklahoma,OK
40079,40CS019,541,520,563,630,89,67,110,59,0.14880003471895914,0.6019233035076113,1.0496775947451005,0.6558349061672231,662,636,688,796,134,108,160,104,0.12149238668014427,0.7068062540461081,1.3844260343884542,0.7708527601871153,49859,49859,Le Flore,Le Flore,40,79,Oklahoma,OK
40081,40CS020,334,319,349,382,48,33,63,50,-0.45664067748548476,-0.05108762885663526,0.38765754036540395,1.018913582263593,408,390,426,484,76,58,94,69,-0.3869889685646496,0.23338100938179712,0.9092237044952095,0.8923948144752449,34983,34983,Lincoln+Logan,Lincoln,40,81,Oklahoma,OK
40083,40CS020,336,315,357,366,30,9,51,31,-0.5023839231712622,-0.03338590000381443,0.38955426227977386,1.0086274823969015,414,388,439,509,95,70,121,84,-0.33439470706663527,0.2671130062477011,0.8888880583619991,0.8710466851720042,48373,48373,Lincoln+Logan,Logan,40,83,Oklahoma,OK
40091,40CS021,257,248,265,306,49,41,58,34,0.3196951072200513,0.7770440106180426,1.1947281345203735,0.6775982620409869,314,304,324,416,102,92,112,67,1.5383839027889676,2.1278164390366947,2.7146615017163427,0.6521872224389688,19612,19612,McIntosh+Okmulgee,McIntosh,40,91,Oklahoma,OK
40111,40CS021,442,425,458,538,96,80,113,57,0.5877326652727264,1.0391857792606403,1.4699067850015421,0.5854300226631268,541,522,561,668,127,107,146,103,0.11012809894649492,0.7297985690853318,1.3742751802364848,0.8077519942987186,38341,38341,McIntosh+Okmulgee,Okmulgee,40,111,Oklahoma,OK
40003,40CS022,51,51,52,66,15,14,15,5,1.6033085433976508,1.7132312855563216,1.8130801128346785,0.3178131323971664,63,63,64,53,-10,-11,-10,2,-2.7592655576322542,-2.603032474111044,-2.4522448911145722,-0.21412783829429355,5686,5686,Major and Nearby Counties,Alfalfa,40,3,Oklahoma,OK
40011,40CS022,111,110,112,135,24,23,25,17,0.5876962856816678,0.69120450355396,0.8041555246306044,0.6931557354072291,137,136,138,162,25,24,26,21,0.33093004103094575,0.4777120344577338,0.6400861915322437,0.8146490467724774,9453,9453,Major and Nearby Counties,Blaine,40,11,Oklahoma,OK
40043,40CS022,57,57,58,61,4,3,4,13,-2.0516255325228845,-1.9434884215388408,-1.8297893322942789,2.861099564330896,71,70,71,85,14,14,15,10,0.8956573340819967,1.0588043200020605,1.204366098328632,0.6546815840638223,4862,4862,Major and Nearby Counties,Dewey,40,43,Oklahoma,OK
40073,40CS022,143,137,150,152,9,2,15,33,-1.9567230063068712,-1.540192134222768,-1.093819841861079,3.4150217751252585,176,168,184,173,-3,-11,5,19,-2.2940501965499105,-1.6599460958989056,-1.0126369451379504,-9.451523380245414,15860,15860,Major and Nearby Counties,Kingfisher,40,73,Oklahoma,OK
40093,40CS022,88,87,88,99,11,11,12,20,-1.2371602680896,-1.1360927017748161,-1.0319838843007925,1.6192879995092704,108,107,109,120,12,11,13,14,-0.4565904478480358,-0.3033691540656819,-0.1529764010510623,1.0706500851288863,7609,7609,Major and Nearby Counties,Major,40,93,Oklahoma,OK
40151,40CS022,86,85,87,93,7,6,8,3,0.39173487950307906,0.4931048426289737,0.5941763078695589,0.35997455548900986,106,105,107,100,-6,-7,-5,21,-3.8202616251998327,-3.6640741982016536,-3.500600574170102,-4.459778718796774,8747,8747,Major and Nearby Counties,Woods,40,151,Oklahoma,OK
40101,40CS023,766,737,795,896,130,101,159,108,-0.09624469871009328,0.3183843025390522,0.7485876635972004,0.822259693693977,932,897,967,1147,215,180,250,185,-0.06383921928072032,0.5178422153705933,1.1335404335485264,0.8559638886595837,67894,67894,Muskogee,Muskogee,40,101,Oklahoma,OK
40103,40CS024,120,119,121,123,3,2,4,12,-0.9055652905059461,-0.8067111978939986,-0.6928212473958293,2.997562370054164,147,146,149,178,31,29,32,23,0.675799197393928,0.8322631642888526,0.9814692329168448,0.7259932848209514,11145,11145,Noble+Osage+Pawnee,Noble,40,103,Oklahoma,OK
40113,40CS024,394,374,414,442,48,28,68,43,-0.33163418288082785,0.09540647358266956,0.5086842810360634,0.8801570308410896,485,461,509,615,130,106,154,99,0.17071523632777072,0.7809725805113603,1.3965596257106883,0.7554739380373517,46817,46817,Noble+Osage+Pawnee,Osage,40,113,Oklahoma,OK
40117,40CS024,182,175,189,211,29,22,36,26,-0.2383820722122853,0.20038080396357522,0.6360947135323954,0.8613965277986305,222,214,231,258,36,27,44,31,-0.2639122610101237,0.3231326667436569,0.9317189486356177,0.8488894854445357,16380,16380,Noble+Osage+Pawnee,Pawnee,40,117,Oklahoma,OK
40105,40CS025,113,112,114,120,7,6,8,14,-0.8176359314258075,-0.7101869060967193,-0.6101056712067336,1.79396084217264,139,137,140,164,25,24,27,21,0.34962473214468437,0.5186822770937142,0.6627249019273623,0.7969770621538163,10103,10103,Nowata+Washington,Nowata,40,105,Oklahoma,OK
40147,40CS025,552,530,575,598,46,23,68,70,-0.8977762537230753,-0.4758491381169147,-0.039248541694279104,1.5040516695778554,676,649,703,786,110,83,137,135,-1.1960490104607575,-0.5852567748944908,0.022805353960231967,1.2203270973155549,51897,51897,Nowata+Washington,Washington,40,147,Oklahoma,OK
40109,40CS026,6309,5963,6654,7521,1212,867,1558,864,-0.026995486790815676,0.42997545155380734,0.8787613314836482,0.7120912180558587,7757,7342,8173,8922,1165,749,1580,1058,-0.49279322275353216,0.14884019126298423,0.761533510048017,0.9076892193266077,800262,800262,Oklahoma (county),Oklahoma (county),40,109,Oklahoma,OK
40007,40CS027,45,45,46,56,11,10,11,10,0.003690548159596016,0.11635585682189305,0.2161897101734092,0.8626762732284717,55,55,56,63,8,7,8,8,-0.2175665925033281,-0.06870808155281173,0.10212635494765994,0.9195571252952064,5266,5266,Oklahoma Panhandle,Beaver,40,7,Oklahoma,OK
40025,40CS027,23,23,23,22,-1,-1,-1,0,-0.5099682880569337,-0.40073733986026033,-0.29461669361032766,0,28,28,28,31,3,3,3,4,-0.6323426078810344,-0.4606789375621631,-0.2931151110027556,0.9584145871624162,2147,2147,Oklahoma Panhandle,Cimarron,40,25,Oklahoma,OK
40045,40CS027,43,43,43,44,1,1,1,6,-1.3971889399910369,-1.290955599697231,-1.1885987302892738,2.9643287582511646,52,52,53,50,-2,-3,-2,5,-2.434127146398264,-2.2851857585603637,-2.1265192809314653,-3.778771405805849,3850,3850,Oklahoma Panhandle,Ellis,40,45,Oklahoma,OK
40059,40CS027,33,32,33,51,18,18,19,7,3.0093808990024318,3.1127075531284834,3.2200041834241167,0.3604620623189956,40,39,40,38,-2,-2,-1,7,-2.9970754700838134,-2.843954917791638,-2.678648303341167,-10.34661146083123,3667,3667,Oklahoma Panhandle,Harper,40,59,Oklahoma,OK
40139,40CS027,150,147,152,159,9,7,12,38,-1.526439478684047,-1.414856873635239,-1.315744234364709,3.6260546622509358,182,179,185,161,-21,-24,-18,25,-2.9082584642935325,-2.751181701867805,-2.586796817397316,-1.2419704815558443,20125,20125,Oklahoma Panhandle,Texas,40,139,Oklahoma,OK
40153,40CS027,167,158,176,215,48,39,57,28,0.5620879661683839,1.019043654161,1.4280036436858436,0.5710599151229189,205,195,215,251,46,36,56,34,0.09591278727791881,0.70895384549344,1.3728410847265375,0.7234064171622919,20002,20002,Oklahoma Panhandle,Woodward,40,153,Oklahoma,OK
40119,40CS028,513,478,548,568,55,20,90,55,-0.4631159509925608,-0.00464527974143084,0.44358758411983273,0.9811053433061552,636,594,679,764,128,85,170,82,0.08350009867215573,0.6591065866638283,1.2861729788317622,0.6373876623813532,81713,81713,Payne,Payne,40,119,Oklahoma,OK
40125,40CS029,737,705,768,850,113,82,145,80,0.049077047437229626,0.46105758327409174,0.9049881557577192,0.6990826781876455,901,863,939,1139,238,200,276,146,0.9060752919847538,1.532378936097459,2.193675227019838,0.610651775313129,72826,72826,Pottawatomie,Pottawatomie,40,125,Oklahoma,OK
40131,40CS030,775,735,815,929,154,114,194,114,-0.02604347336013281,0.42285178217905445,0.8650061361029577,0.7347024409514581,950,902,998,1122,172,124,220,167,-0.5288345341026529,0.07116681250514614,0.6647603635152584,0.9652974980803013,92841,92841,Rogers,Rogers,40,131,Oklahoma,OK
40055,40CS031,59,58,59,73,14,14,15,19,-0.9455794649192135,-0.836381833520546,-0.7273475114169948,1.246452715825702,72,71,73,97,25,24,26,4,4.219250734020564,4.375705333710869,4.534292374578221,0.15518062872986135,5700,5700,Southwest Oklahoma,Greer,40,55,Oklahoma,OK
40057,40CS031,26,25,26,39,13,13,14,6,2.6997582991258224,2.8050790841813513,2.9195124790974964,0.41898665126195106,32,31,32,45,13,13,14,7,2.8006140939880546,2.9504874171957676,3.1182335155813936,0.48546912017136784,2608,2608,Southwest Oklahoma,Harmon,40,57,Oklahoma,OK
40065,40CS031,217,206,227,281,64,54,75,55,-0.008982657164798772,0.38130081040199687,0.7912317051336454,0.842549967734139,267,254,279,287,20,8,33,35,-1.3324666478058513,-0.749495120602395,-0.124403160409738,1.6480418893248925,24378,24378,Southwest Oklahoma,Jackson,40,65,Oklahoma,OK
40075,40CS031,129,125,133,160,31,27,35,27,0.004072516584383043,0.4466767808250033,0.8924936506420453,0.8486383871943648,157,153,162,140,-17,-22,-13,20,-5.784560757912757,-5.142080589649057,-4.560133654497713,-1.2124968653859187,8732,8732,Southwest Oklahoma,Kiowa,40,75,Oklahoma,OK
40141,40CS031,79,78,80,106,27,26,28,18,1.1068282380607362,1.2011284356885152,1.3173201179230603,0.6487523633225067,97,96,98,122,25,24,26,18,0.9344701570446874,1.103919267494918,1.2513590274990474,0.7020450506678385,7247,7247,Southwest Oklahoma,Tillman,40,141,Oklahoma,OK
40143,40CS032,5118,4835,5401,5987,869,586,1152,621,-0.029257829394418344,0.3729316166898003,0.8129693085166766,0.7136562885032343,6295,5956,6635,7784,1489,1149,1828,1169,-0.09536628082876103,0.580948470612973,1.171534418863741,0.7846938439298443,654426,654426,Tulsa,Tulsa,40,143,Oklahoma,OK
40145,40CS033,563,528,599,648,85,49,120,64,-0.2012749609206797,0.24173811611731436,0.6682249749504827,0.7475298230368389,696,653,739,906,210,167,253,169,-0.03772363804127887,0.5846433307587323,1.2246286541124005,0.8013313652861055,82074,82074,Wagoner,Wagoner,40,145,Oklahoma,OK
41001,41CS001,183,176,190,206,23,16,30,1,0.9125387416667856,1.349042180984228,1.7398008277329158,0.04225849838170248,224,216,232,274,50,42,58,31,0.7203659034141305,1.4192523899959748,2.0467475812400377,0.6068391271235369,16190,16190,Baker+Harney+Lake+Malheur,Baker,41,1,Oregon,OR
41025,41CS001,74,74,75,78,4,3,4,5,-0.30194666843158696,-0.19244129864240098,-0.08821329761700399,1.0909277284412957,91,90,92,124,33,32,34,30,0.3011871490479724,0.4552302365730506,0.6114655209193123,0.8880291943688252,7374,7374,Baker+Harney+Lake+Malheur,Harney,41,25,Oregon,OR
41037,41CS001,85,84,86,98,13,12,14,4,1.0596606729931666,1.1657287823547964,1.2641284036450349,0.2807019090454428,104,103,105,144,40,39,41,16,3.4906418062692843,3.648530000549108,3.8044563292760722,0.3887280274175101,7943,7943,Baker+Harney+Lake+Malheur,Lake,41,37,Oregon,OR
41045,41CS001,264,250,277,326,62,49,76,42,0.2284017161592475,0.6502232230039742,1.0856790383544153,0.6643425350162433,324,308,340,392,68,52,84,46,0.24976995900355503,0.866740817310228,1.4843622306457882,0.665474965252284,30817,30817,Baker+Harney+Lake+Malheur,Malheur,41,45,Oregon,OR
41003,41CS002,509,469,549,504,-5,-45,35,10,-0.5757489675462513,-0.16036410816678756,0.26341242213735533,-2.2844612319278497,632,584,680,741,109,61,157,23,0.4902135374765982,1.1103372591885545,1.756378759625056,0.20850954982340983,93166,93166,Benton,Benton,41,3,Oregon,OR
41005,41CS003,2985,2803,3166,3188,203,22,385,116,-0.20828378266092437,0.2087520407259594,0.6682757148347908,0.5674896146899634,3672,3454,3890,4003,331,113,549,302,-0.4941721125766092,0.08809995835428751,0.7325364229658432,0.9095154261840537,419614,419614,Clackamas,Clackamas,41,5,Oregon,OR
41007,41CS004,345,327,362,348,3,-14,21,5,-0.49360027809706825,-0.04139846686637324,0.3960395654682658,1.1174435817482902,420,399,441,542,122,101,143,29,2.0980685867666,2.7667900559927716,3.3887052099416564,0.2361922824082844,40298,40298,Clatsop+Lincoln+Tillamook,Clatsop,41,7,Oregon,OR
41041,41CS004,539,517,561,592,53,31,75,14,0.353646781449269,0.7744799309157216,1.2371896907045365,0.2587884232622537,655,629,682,729,74,47,100,34,0.2945178755762217,0.9225511894659717,1.555702019322979,0.4560059517047616,50316,50316,Clatsop+Lincoln+Tillamook,Lincoln,41,41,Oregon,OR
41057,41CS004,266,254,277,303,37,26,49,1,0.9157728727576671,1.3334464613789145,1.7646273797342031,0.026047045909958648,324,309,338,412,88,74,103,42,1.4102421390874285,2.050844143759356,2.6402137617903922,0.4693649635390828,27261,27261,Clatsop+Lincoln+Tillamook,Tillamook,41,57,Oregon,OR
41009,41CS005,404,381,426,447,43,21,66,22,-0.05407679222687033,0.4051336883001529,0.8227888252422804,0.4954420953751286,495,468,523,630,135,107,162,58,1.155420362488512,1.7273402336423482,2.3948309153598966,0.42763350458320865,52723,52723,Columbia+Washington,Columbia,41,9,Oregon,OR
41067,41CS005,2971,2712,3231,3194,223,-37,482,131,-0.2952442465058105,0.16349584848136983,0.5648267921636153,0.5858900827675481,3691,3379,4003,4150,459,147,771,243,-0.15419366370128762,0.43679625784465037,1.0438228294828218,0.5280937124208349,602008,602008,Columbia+Washington,Washington,41,67,Oregon,OR
41011,41CS006,781,753,809,777,-4,-32,24,10,-0.6360352558541393,-0.22987230740521358,0.23167278445531614,-3.3468456119682433,949,915,982,1138,189,156,223,98,1.0724392339585314,1.6849521865116899,2.3133682169579517,0.5153904977228648,64691,64691,Coos+Curry,Coos,41,11,Oregon,OR
41015,41CS006,333,323,343,393,60,50,70,5,1.9688597556881122,2.3920397098534565,2.841033412887001,0.08164743211673976,404,392,416,512,108,96,120,36,3.174229371950174,3.7372013825783137,4.371776874868973,0.33018668615515184,23116,23116,Coos+Curry,Curry,41,15,Oregon,OR
41017,41CS007,1377,1291,1464,1333,-44,-131,42,24,-0.7892660766310317,-0.3413519955086038,0.09461550180912018,-0.5562138896382142,1694,1589,1798,1820,126,22,231,167,-0.8257708230458207,-0.24389214694717387,0.3505102625039875,1.3104107495679815,199230,199230,Deschutes,Deschutes,41,17,Oregon,OR
41019,41CS008,1302,1254,1350,1421,119,71,167,35,0.3356635373536187,0.7659434829628605,1.1812648416240585,0.29225591262431705,1589,1532,1647,2052,463,405,520,244,1.727138213556458,2.358721889302493,2.97469826210628,0.5261102952942687,111108,111108,Douglas,Douglas,41,19,Oregon,OR
41027,41CS009,161,151,171,156,-5,-15,5,12,-1.182007050499948,-0.7573765768183248,-0.3195435898718676,-2.720451498440416,198,186,210,200,2,-10,14,17,-1.3877539602313036,-0.7451214510837044,-0.13124738988184015,5.2125672187289185,23319,23319,Hood River+Jefferson+Sherman+Wasco,Hood River,41,27,Oregon,OR
41031,41CS009,184,173,194,272,88,78,99,19,2.372982070030579,2.80458549039906,3.229983805917075,0.2125458854074101,225,212,238,327,102,89,115,37,2.5604623954476984,3.13533102947553,3.7606941444484865,0.3587317049617379,24734,24734,Hood River+Jefferson+Sherman+Wasco,Jefferson,41,31,Oregon,OR
41055,41CS009,16,15,17,16,-0,-1,1,2,-1.5912550357980038,-1.1680709327928263,-0.7246398813966201,2.1584443189222458,20,19,21,26,6,5,7,5,0.32352963961169967,0.9395505842038042,1.5439702645999915,0.6770332655881033,1795,1795,Hood River+Jefferson+Sherman+Wasco,Sherman,41,55,Oregon,OR
41065,41CS009,276,264,287,295,19,8,31,27,-0.6997281997121603,-0.2924933683489484,0.15388082265468386,1.320525224339181,335,322,349,374,39,25,52,28,-0.13192654482396482,0.48056169905599144,1.077960619296054,0.7029751838003315,26478,26478,Hood River+Jefferson+Sherman+Wasco,Wasco,41,65,Oregon,OR
41029,41CS010,2070,1975,2166,2242,172,76,267,68,0.05635760970109044,0.4590464949415003,0.9145306982206819,0.3940221526730281,2530,2416,2645,2925,395,280,509,292,-0.03455117528512887,0.5537930303629999,1.2097506265564915,0.7377830572144172,221244,221244,Jackson,Jackson,41,29,Oregon,OR
41033,41CS011,1067,1029,1105,1112,45,7,83,25,-0.2141361325591776,0.2167604203365158,0.6573855769138099,0.5467922773648155,1301,1255,1346,1583,282,237,328,224,0.18097090819385753,0.7818108230293463,1.4085817117843227,0.7913810661584059,87835,87835,Josephine,Josephine,41,33,Oregon,OR
41035,41CS012,711,681,740,779,68,39,98,25,0.23609863018837654,0.6281837625403653,1.0914998542465713,0.3610219041725152,871,836,907,1065,194,158,229,150,0.12902339446903568,0.7701764820630789,1.3825638722184064,0.7693161491213093,68508,68508,Klamath,Klamath,41,35,Oregon,OR
41039,41CS013,3182,3017,3347,3372,190,25,355,76,-0.12711763150328087,0.286158271709825,0.7374203538568598,0.39767287602606766,3908,3711,4106,4522,614,416,811,233,0.5451216247107351,1.2066073619625384,1.8006492299560484,0.3791101523386877,382448,382448,Lane,Lane,41,39,Oregon,OR
41043,41CS014,1170,1114,1226,1247,77,21,133,35,-0.11010519009641366,0.3243305250853246,0.7532681321895595,0.44959788234357917,1434,1366,1502,1721,287,219,355,152,0.6277602607148826,1.2317811820010849,1.8519641882221654,0.5278346044642407,130205,130205,Linn,Linn,41,43,Oregon,OR
41047,41CS015,2463,2313,2613,2685,222,72,372,182,-0.30219741401747224,0.11859444786713727,0.5172800363008022,0.8152211811193872,3031,2851,3212,3456,425,244,605,304,-0.2362403999532979,0.4330533150059487,1.019777547100645,0.7138508420478423,348243,348243,Marion,Marion,41,47,Oregon,OR
41051,41CS016,4986,4635,5337,5449,463,112,814,389,-0.3339752234107423,0.09338851973122826,0.5075520139409848,0.83817525210083,6158,5737,6580,6883,725,303,1146,422,-0.14969524913191157,0.436488775061718,1.0741662972987829,0.5815840750314977,813772,813772,Multnomah,Multnomah,41,51,Oregon,OR
41053,41CS017,629,591,666,669,40,3,78,25,-0.2458852879893837,0.1903255862016236,0.5990115344154772,0.6032465515634668,775,730,821,842,67,21,112,68,-0.6550818947045348,-0.012226890996437038,0.5652258609898269,1.0054780346331664,86640,86640,Polk,Polk,41,53,Oregon,OR
41013,41CS018,246,235,256,211,-35,-45,-24,2,-1.9268860416230595,-1.4903641072907845,-1.0405102050176223,-0.05951219647464361,302,289,315,321,19,6,32,46,-1.9337647311497022,-1.2736691592482743,-0.6131078331656474,2.267326467350679,24687,24687,Umatilla and Nearby Counties,Crook,41,13,Oregon,OR
41021,41CS018,17,17,18,14,-3,-4,-3,5,-4.462369076755126,-4.356849375238919,-4.256848553124333,-2.047265601545977,21,21,22,37,16,15,16,5,6.495796854204649,6.66005840025197,6.817406016672278,0.2985365119162969,1938,1938,Umatilla and Nearby Counties,Gilliam,41,21,Oregon,OR
41023,41CS018,77,76,78,85,8,7,9,5,0.31903947081241,0.4256948220635737,0.5300840367696561,0.5530289915146654,94,93,95,111,17,16,18,14,0.38689926351386583,0.5468124459926458,0.7084812192824201,0.7667353975829738,7172,7172,Umatilla and Nearby Counties,Grant,41,23,Oregon,OR
41049,41CS018,74,72,75,96,22,21,24,11,0.8674026736941461,0.9793202463995397,1.0758467541167087,0.47072795349433183,90,88,91,122,32,31,34,14,1.7263349837709405,1.8797732599317403,2.0336283694435195,0.42140362058844827,11646,11646,Umatilla and Nearby Counties,Morrow,41,49,Oregon,OR
41059,41CS018,578,545,612,709,131,97,164,60,0.4366685993687129,0.906013504495501,1.3243743808198951,0.45580831848878284,713,673,754,885,172,131,212,101,0.45049105447155013,1.1000020098333216,1.7502647689398771,0.5853237602907562,77747,77747,Umatilla and Nearby Counties,Umatilla,41,59,Oregon,OR
41061,41CS018,246,234,257,247,1,-10,13,5,-0.5751020833807767,-0.1336799620299881,0.2749280110082284,2.0924437613651925,301,287,315,373,72,58,86,49,0.35709565585816244,1.02297056013156,1.6158241137904852,0.6729399955638473,26657,26657,Umatilla and Nearby Counties,Union,41,61,Oregon,OR
41063,41CS018,75,74,76,61,-14,-15,-13,3,-2.47892325241567,-2.3665880461044355,-2.2586263882158493,-0.23103139945409135,91,90,92,103,12,11,13,1,1.628004930370927,1.785259944386456,1.9467139167849858,0.07899038726687632,7174,7174,Umatilla and Nearby Counties,Wallowa,41,63,Oregon,OR
41069,41CS018,15,14,15,17,2,2,3,6,-3.2909869075783815,-2.8536679674013254,-2.4143016497888445,1.9280038416229137,18,18,19,21,3,2,3,1,0.9343390065406695,1.5451271896619208,2.178719859820599,0.2669881305101347,1364,1364,Umatilla and Nearby Counties,Wheeler,41,69,Oregon,OR
41071,41CS019,826,780,872,883,57,11,103,37,-0.24886168070973583,0.19629907697320628,0.6222549841187434,0.6380552257284795,1013,958,1069,1251,238,182,293,102,0.9005974470083637,1.505349861805728,2.0900652050982615,0.4271031604701579,107234,107234,Yamhill,Yamhill,41,71,Oregon,OR
42001,42CS001,898,854,943,996,98,53,142,81,-0.25442909417817744,0.1626987138944296,0.5586288542437828,0.8223244590653211,1100,1047,1153,1232,132,79,185,172,-1.0598966071285663,-0.4828267807104346,0.16123867901738653,1.2944079730180242,102762,102762,Adams,Adams,42,1,Pennsylvania,PA
42003,42CS002,11571,11050,12093,12850,1279,757,1800,1108,-0.26820138730088217,0.13178722640890367,0.5768263409148733,0.8659032907295289,14146,13520,14772,15230,1084,458,1710,1390,-0.9207432751963084,-0.31052891613672784,0.2889213821431412,1.280992745139459,1213900,1213900,Allegheny,Allegheny,42,3,Pennsylvania,PA
42005,42CS003,715,688,743,785,70,42,97,43,-0.01396282482351976,0.4152184820338518,0.8539598027717542,0.6074533229950722,872,839,905,1096,224,191,257,185,0.12372619554282648,0.717948895352986,1.3822953869495198,0.8229643472812749,64475,64475,Armstrong,Armstrong,42,5,Pennsylvania,PA
42007,42CS004,1822,1752,1892,2109,287,217,357,243,-0.1619681504824328,0.26125490537504603,0.6974437767337244,0.8448975805023655,2224,2140,2308,2431,207,123,291,310,-1.3900452351798158,-0.752640060760983,-0.1453256666341844,1.4910445511237664,163381,163381,Beaver,Beaver,42,7,Pennsylvania,PA
42009,42CS005,482,462,503,635,153,132,173,98,0.7027103733681296,1.166432063611435,1.548876509008727,0.6367163272121784,586,562,611,709,123,98,147,138,-1.0074174010233945,-0.3719461010262392,0.27958228253374284,1.1147188159319525,47873,47873,Bedford+Fulton,Bedford,42,9,Pennsylvania,PA
42057,42CS005,145,139,152,146,1,-6,7,13,-1.2526504681201558,-0.8369995457856256,-0.4249258060537922,7.5240175089611245,177,169,184,237,60,53,68,44,0.7313139133403787,1.3612881283324703,1.9745324097970811,0.7176715075280619,14502,14502,Bedford+Fulton,Fulton,42,57,Pennsylvania,PA
42011,42CS006,3414,3233,3595,3927,513,332,694,575,-0.5584064871312583,-0.1485677900335788,0.24644780248601927,1.1193724260808227,4188,3971,4406,4822,634,416,851,678,-0.7510989639539446,-0.09970891796320167,0.48471606442151133,1.067870084150193,420642,420642,Berks,Berks,42,11,Pennsylvania,PA
42013,42CS007,1339,1287,1391,1613,274,222,326,193,0.20844492830287895,0.6564672286045652,1.0668142899554554,0.7023842311650269,1632,1570,1695,1855,223,160,285,302,-1.3891784757043812,-0.805682504092393,-0.1707834180389264,1.3484018079998046,121552,121552,Blair,Blair,42,13,Pennsylvania,PA
42015,42CS008,590,564,616,592,2,-24,28,57,-1.3011436171063293,-0.9288854411713502,-0.49663306231824045,21.98621664948065,724,692,755,837,113,82,145,106,-0.5334000871449023,0.1590831660794156,0.7338031143257974,0.9262327860792198,60342,60342,Bradford+Sullivan,Bradford,42,15,Pennsylvania,PA
42113,42CS008,81,80,81,88,7,7,8,3,0.6196373260055882,0.7327096415527691,0.8385291831617635,0.3599836171787967,99,98,100,131,32,31,33,23,1.7072844396014935,1.8564347107281778,2.009708574359737,0.6933949146655013,5940,5940,Bradford+Sullivan,Sullivan,42,113,Pennsylvania,PA
42017,42CS009,5205,4935,5475,6046,841,571,1111,875,-0.4720383873189491,-0.06414165911789188,0.3398324614819462,1.038972539430235,6390,6066,6715,6903,513,188,837,589,-0.7967081241196668,-0.13760805943246027,0.5016925987704841,1.1465094730631191,628284,628284,Bucks,Bucks,42,17,Pennsylvania,PA
42019,42CS010,1735,1654,1817,1973,238,156,319,226,-0.3637918288135528,0.06687525971992647,0.46591232308449876,0.9464846959347648,2129,2031,2226,2417,288,191,386,332,-0.8510913943280268,-0.2822877844616296,0.35209265129817674,1.1471219978027145,188656,188656,Butler,Butler,42,19,Pennsylvania,PA
42021,42CS011,1549,1494,1605,1844,295,239,350,280,-0.3318565170808754,0.1066260962210666,0.5408086987566357,0.9474404587911655,1887,1820,1953,2069,182,116,249,297,-1.6639092442258216,-1.0539877188950728,-0.417264683311724,1.6201452020148803,129509,129509,Cambria,Cambria,42,21,Pennsylvania,PA
42025,42CS012,677,650,705,827,150,122,177,93,0.4387053523634725,0.8770428097993749,1.3165968670121548,0.6171700751574448,823,790,856,995,172,139,205,143,-0.05638510291651464,0.5526396031353441,1.1972511843228304,0.8278544481697876,64107,64107,Carbon,Carbon,42,25,Pennsylvania,PA
42027,42CS013,842,773,912,1047,205,135,274,141,-0.05513124697228641,0.39701421796867664,0.8172488647208418,0.6856037869286505,1045,962,1129,1217,172,88,255,127,-0.2710565828149268,0.3276606117934606,0.936454343113243,0.7358299403930513,161845,161845,Centre,Centre,42,27,Pennsylvania,PA
42029,42CS014,3466,3240,3693,3919,453,226,679,555,-0.6250446290432342,-0.20000252511399502,0.22859188604517408,1.223415714384385,4278,4006,4550,4398,120,-152,392,351,-1.131707991197116,-0.5192570863701467,0.0703850521982476,2.9013093069251448,525767,525767,Chester,Chester,42,29,Pennsylvania,PA
42031,42CS015,350,334,367,451,101,84,117,48,0.9348258578759733,1.3667925871404454,1.7948164155879205,0.4724467884310682,429,409,449,596,167,147,187,116,0.9963935692430554,1.601096263529975,2.1810282842392357,0.6902809305868075,38418,38418,Clarion+Jefferson,Clarion,42,31,Pennsylvania,PA
42065,42CS015,463,444,481,526,63,45,82,58,-0.29608790647293465,0.13435989935559592,0.5324271956437053,0.9014068673490907,565,542,587,635,70,48,93,123,-2.068012429872513,-1.467609538961822,-0.867351208757277,1.7254629967779749,43219,43219,Clarion+Jefferson,Jefferson,42,65,Pennsylvania,PA
42033,42CS016,810,776,844,878,68,34,102,54,-0.23086851383478543,0.1608376783272281,0.6087046503879816,0.7856297523185463,992,952,1033,1195,203,162,243,206,-0.6775101393620162,-0.05078277285264452,0.5543858431135188,1.0108858517835269,78945,78945,Clearfield,Clearfield,42,33,Pennsylvania,PA
42035,42CS017,351,335,367,371,20,4,36,29,-0.6284997230505881,-0.24253130204780526,0.17480405459270593,1.3906129415490807,432,412,451,481,49,30,69,74,-1.3615845856382114,-0.798702221715869,-0.14169131478521108,1.468245171092134,38158,38158,Clinton+Potter+Tioga,Clinton,42,35,Pennsylvania,PA
42105,42CS017,182,175,189,188,6,-1,13,15,-0.9613603939710339,-0.5325841433137828,-0.11695039269125625,2.0615396318831305,223,214,231,297,74,66,83,63,0.26343022601168603,0.8266661606693287,1.4178466767192162,0.8348646884872114,16507,16507,Clinton+Potter+Tioga,Potter,42,105,Pennsylvania,PA
42117,42CS017,391,374,409,463,72,54,89,79,-0.5953586267224105,-0.16961480443923047,0.249837957189625,1.0840295826669126,480,459,501,596,116,95,137,103,-0.20646252180765653,0.36541905973165795,0.9903526202095769,0.8825474022092079,40547,40547,Clinton+Potter+Tioga,Tioga,42,117,Pennsylvania,PA
42037,42CS018,593,565,621,659,66,38,94,83,-0.6781503116370416,-0.26389056920934983,0.13731112146529992,1.2441905253196723,727,693,760,866,139,106,173,113,-0.13143771377119537,0.47269402972165897,1.0640526308677152,0.8046547104664564,64946,64946,Columbia,Columbia,42,37,Pennsylvania,PA
42039,42CS019,836,800,872,921,85,49,121,90,-0.48161913284066377,-0.06521351713060297,0.37482816453543605,1.0505042140680427,1022,978,1065,1215,193,150,237,153,-0.04425130109604132,0.5684523294349396,1.1425106492908976,0.7875229387601226,84119,84119,Crawford,Crawford,42,39,Pennsylvania,PA
42041,42CS020,2065,1955,2175,2361,296,186,406,321,-0.5333040168161297,-0.09487949253815658,0.32354658044561946,1.0796097321962246,2528,2396,2661,2784,256,123,388,365,-1.0970022090137759,-0.5108356407159897,0.15243182413581804,1.4225761582655716,254268,254268,Cumberland+Perry,Cumberland,42,41,Pennsylvania,PA
42099,42CS020,389,369,409,450,61,41,81,42,-0.03534249021920365,0.4065745616195713,0.8273986298300289,0.6796041627955204,476,452,500,580,104,80,128,102,-0.5198787457937333,0.08559912508591047,0.6890580365715896,0.9687584842698366,46278,46278,Cumberland+Perry,Perry,42,99,Pennsylvania,PA
42043,42CS021,2200,2079,2320,2589,389,269,510,329,-0.2431217244565551,0.20462058574373063,0.645013721626501,0.8432715588452128,2701,2556,2845,3169,468,324,613,386,-0.2804427820948648,0.36247917954956627,0.9464802937960903,0.8227601970398202,279030,279030,Dauphin,Dauphin,42,43,Pennsylvania,PA
42045,42CS022,4690,4447,4934,5578,888,644,1131,979,-0.586009212839496,-0.15781722333652554,0.2554501442427481,1.1017898699743762,5755,5462,6047,5904,149,-143,442,544,-1.4342403745119736,-0.8304445752865738,-0.17156595244678022,3.616410025555529,566609,566609,Delaware,Delaware,42,45,Pennsylvania,PA
42049,42CS023,2437,2321,2552,2777,340,225,456,259,-0.10399283620731095,0.29742774536305344,0.7414899020563959,0.7586172914199047,2986,2848,3125,3384,398,259,536,358,-0.44386392331396374,0.1852228974248685,0.846666484393973,0.8980543470077867,269069,269069,Erie,Erie,42,49,Pennsylvania,PA
42051,42CS024,1506,1451,1561,1679,173,118,228,164,-0.36674724806835,0.0780661323527008,0.4749341854913971,0.9439796771310345,1835,1769,1902,2251,416,349,482,378,-0.2630063246733264,0.34333497384690986,0.9460550667743212,0.9073665078928207,128882,128882,Fayette+Greene,Fayette,42,51,Pennsylvania,PA
42059,42CS024,373,358,389,401,28,12,43,34,-0.5985937557107309,-0.17103046122097273,0.23904841642997252,1.1887253809816014,456,437,474,538,82,64,101,68,-0.10661922125990508,0.47857657666303405,1.0813816577982778,0.8172156345924833,35878,35878,Fayette+Greene,Greene,42,59,Pennsylvania,PA
42055,42CS025,1360,1293,1427,1699,339,272,406,235,0.2471052351378147,0.6671569448864622,1.079454292586267,0.6916344379973669,1667,1586,1747,2035,368,288,449,289,0.007707136626720431,0.5991181255555657,1.1887876229804148,0.7822151480248131,155570,155570,Franklin,Franklin,42,55,Pennsylvania,PA
42061,42CS026,400,381,419,489,89,70,108,75,-0.10781092691496394,0.31874693238222046,0.7652038621020752,0.8309559016434811,489,466,512,567,78,55,101,101,-1.2062350677764513,-0.5983445688396123,0.02408956752135695,1.2712132994741256,44767,44767,Huntingdon+Juniata+Mifflin,Huntingdon,42,61,Pennsylvania,PA
42067,42CS026,217,206,228,295,78,67,89,64,0.1392360021607439,0.5668008939035961,0.9978637492307442,0.8109316109879722,265,253,278,355,90,77,102,73,0.23443470464806707,0.80900678520593,1.4709721533899505,0.8058387088377985,24701,24701,Huntingdon+Juniata+Mifflin,Juniata,42,67,Pennsylvania,PA
42087,42CS026,474,454,494,614,140,120,160,126,-0.1038866920614299,0.32475988022168,0.7335228123553011,0.8917209299496683,578,554,602,656,78,54,102,105,-1.3153936594431226,-0.6781448418617454,-0.11836286134332206,1.3266222437094062,46079,46079,Huntingdon+Juniata+Mifflin,Mifflin,42,87,Pennsylvania,PA
42063,42CS027,765,729,801,935,170,134,206,116,0.18140698343970468,0.6119194484661455,1.0705077913263357,0.6802112074946056,937,894,980,1115,178,135,221,159,-0.3248019213836378,0.26608791388413106,0.8876333238613345,0.8882405156537553,83873,83873,Indiana,Indiana,42,63,Pennsylvania,PA
42069,42CS028,2260,2170,2350,2524,264,174,354,267,-0.42045554629673404,-0.009664047756976308,0.4009676088055958,1.0075407858368557,2767,2659,2875,2904,137,29,245,315,-1.6314100526874327,-1.0062522955451567,-0.4239616684852305,2.2786511655446002,209467,209467,Lackawanna+Wyoming,Lackawanna,42,69,Pennsylvania,PA
42131,42CS028,274,263,286,278,4,-8,15,30,-1.4353048365472338,-0.9740661295422973,-0.5810754821748577,6.186136705935559,336,322,350,393,57,43,71,54,-0.44394044391710147,0.12233256964298952,0.7713479540114583,0.9279719141273471,26693,26693,Lackawanna+Wyoming,Wyoming,42,131,Pennsylvania,PA
42071,42CS029,4363,4128,4598,5188,825,590,1060,748,-0.2644766075508907,0.1468718086662522,0.554495376871054,0.9054296830753087,5354,5072,5636,5905,551,269,833,739,-1.0392311390563598,-0.418821255074949,0.20629142536334621,1.3385636290980754,545754,545754,Lancaster,Lancaster,42,71,Pennsylvania,PA
42073,42CS030,986,950,1023,1217,231,194,267,140,0.6369106525417058,1.0631245945381067,1.4878602866840127,0.6042977459722965,1203,1160,1247,1371,168,124,211,196,-1.0327754464044658,-0.3776258742489623,0.20290869390217153,1.163155131701064,85329,85329,Lawrence,Lawrence,42,73,Pennsylvania,PA
42075,42CS031,1308,1247,1369,1523,215,154,276,156,0.007190500956904088,0.41562081777752147,0.8843475474634959,0.7225088174411178,1602,1529,1675,1872,270,197,343,226,-0.2838882015152816,0.3540963415863399,0.9739145627878105,0.8349229898378057,141462,141462,Lebanon,Lebanon,42,75,Pennsylvania,PA
42077,42CS032,2934,2774,3093,3397,463,304,623,518,-0.6156736734935682,-0.14424671477439366,0.3159211530074985,1.1154555078696442,3603,3411,3794,3968,365,174,557,472,-0.9579924801131882,-0.3370754189169385,0.26118428345394373,1.288226482089305,369930,369930,Lehigh,Lehigh,42,77,Pennsylvania,PA
42079,42CS033,3464,3328,3601,3970,506,369,642,463,-0.2800950060541734,0.12772214881100918,0.5621676204049832,0.9135589134104471,4236,4072,4399,4572,336,173,500,534,-1.3579294738526793,-0.7558617933729461,-0.130661704666148,1.582862507520278,317248,317248,Luzerne,Luzerne,42,79,Pennsylvania,PA
42081,42CS034,1090,1041,1139,1268,178,129,227,130,-0.00765788358653562,0.4112612926567955,0.8635200503252362,0.7259333362498217,1336,1277,1394,1547,211,153,270,261,-1.1622098654971929,-0.5127273435297539,0.06417195797082782,1.2295630845339136,113426,113426,Lycoming,Lycoming,42,81,Pennsylvania,PA
42023,42CS035,51,51,52,57,6,5,6,5,0.01090547854133325,0.11528250931777147,0.21369378852041623,0.7673605714614208,63,63,64,75,12,11,12,3,2.253594503093777,2.409514498691565,2.582973457280242,0.2341295686912625,4385,4385,McKean and Nearby Counties,Cameron,42,23,Pennsylvania,PA
42047,42CS035,321,309,334,317,-4,-17,8,21,-1.2732057085300863,-0.8298799958344442,-0.39452521502509863,-6.200406514524787,392,377,408,467,75,59,90,57,0.1167987528121255,0.6987375156521046,1.2882132993714908,0.7548043264757863,29774,29774,McKean and Nearby Counties,Elk,42,47,Pennsylvania,PA
42053,42CS035,71,70,72,87,16,15,17,4,1.5810883327248324,1.6808397369018395,1.7889506176427823,0.23847578539989425,88,87,88,108,20,20,21,21,-0.2589561613208131,-0.09257988576292624,0.06384980551420293,0.9784455917110952,7003,7003,McKean and Nearby Counties,Forest,42,53,Pennsylvania,PA
42083,42CS035,436,418,453,444,8,-9,26,26,-0.8629285587456539,-0.4439279024904844,-0.032810574286276796,2.7864461696372884,532,511,553,630,98,77,119,97,-0.572278220750996,0.029964499513633062,0.6441870826118828,0.9817564585929278,40507,40507,McKean and Nearby Counties,McKean,42,83,Pennsylvania,PA
42123,42CS035,419,402,436,501,82,65,99,40,0.6538646925746018,1.0706175923178032,1.5025325936945184,0.48278738777754915,512,492,532,681,169,149,189,90,1.7795307231656223,2.4138080133186213,3.0471367171713832,0.5296353156883727,39063,39063,McKean and Nearby Counties,Warren,42,123,Pennsylvania,PA
42085,42CS036,1233,1187,1280,1446,213,166,259,170,-0.03243173219770182,0.39479803837819205,0.8278508551070273,0.7962032253141949,1507,1451,1563,1833,326,270,382,244,0.28514546388717654,0.896800966599577,1.5613783874535723,0.745309296814133,108983,108983,Mercer,Mercer,42,85,Pennsylvania,PA
42089,42CS037,1293,1220,1366,1540,247,174,320,213,-0.21781351371498858,0.19292698714145787,0.6526493379439186,0.8580201292319843,1588,1500,1676,1808,220,132,308,202,-0.5201932371820207,0.1277012401881191,0.7376667699381653,0.9154878753120695,170113,170113,Monroe,Monroe,42,89,Pennsylvania,PA
42091,42CS038,6573,6214,6931,7627,1054,696,1413,1168,-0.5535005670707029,-0.13763231684658284,0.29208782143780787,1.1067142542487938,8081,7651,8512,8365,284,-147,714,715,-1.267816073945903,-0.6380984099556154,0.007022471861520013,2.511363801772812,831844,831844,Montgomery,Montgomery,42,91,Pennsylvania,PA
42093,42CS039,196,188,204,217,21,13,29,28,-0.8349552410814826,-0.4002369033286329,-0.017902025399919162,1.2828730222159603,239,230,249,253,14,4,23,48,-2.8642345363219257,-2.316765657299219,-1.642203656106017,3.3087654730265226,18123,18123,Montour+Northumberland,Montour,42,93,Pennsylvania,PA
42097,42CS039,984,946,1023,1265,281,242,319,239,0.008990342695745479,0.47224849424572785,0.875335123045395,0.8486618103767014,1202,1155,1249,1269,67,20,114,206,-2.443998912943021,-1.8686409399740973,-1.2536209817768444,3.0287828517692628,90506,90506,Montour+Northumberland,Northumberland,42,97,Pennsylvania,PA
42095,42CS040,2608,2476,2739,3032,424,293,556,417,-0.36951575917400903,0.033121702975890996,0.45202723643295195,0.9800341892416409,3197,3039,3355,3542,345,187,503,381,-0.739857738939122,-0.1448476629777341,0.48423264054655635,1.102265702795117,305672,305672,Northampton,Northampton,42,95,Pennsylvania,PA
42101,42CS041,12098,11419,12778,15527,3429,2749,4108,2461,0.1878538308488776,0.6206488333482841,1.0309345138781194,0.7175819964027249,14850,14035,15666,16376,1526,710,2341,1576,-0.654744245915179,-0.06368453098277735,0.5826235525440903,1.0322339567467311,1581959,1581959,Philadelphia,Philadelphia,42,101,Pennsylvania,PA
42103,42CS042,457,433,481,525,68,44,92,45,-0.01905371454774629,0.4185762307566521,0.8550890770489836,0.6526530996574551,561,532,590,684,123,94,152,77,0.3442904701185032,0.9845257437215551,1.5939062963105302,0.6211125546947165,55928,55928,Pike,Pike,42,103,Pennsylvania,PA
42107,42CS043,1625,1564,1685,1916,291,231,352,239,-0.04384824865760169,0.37759211221087563,0.8050300172357164,0.8176314621965314,1980,1907,2052,2132,152,80,225,261,-1.5366007266150703,-0.919224861951428,-0.3464838972801766,1.7036446898331958,140976,140976,Schuylkill,Schuylkill,42,107,Pennsylvania,PA
42109,42CS044,308,291,325,361,53,36,70,42,-0.16572631831406948,0.2665330580372763,0.6934213248878013,0.778950378811612,380,359,401,428,48,27,69,79,-1.5116552211110483,-0.9216492605109702,-0.3731779279233985,1.616541593173838,40361,40361,Snyder+Union,Snyder,42,109,Pennsylvania,PA
42119,42CS044,317,298,336,390,73,54,92,42,0.25130145708900975,0.6879469492820389,1.1507805742667074,0.5673569494749021,392,369,415,483,91,68,114,78,-0.23162016661568857,0.3550814110500723,0.9842655779689623,0.8454729183418852,44413,44413,Snyder+Union,Union,42,119,Pennsylvania,PA
42111,42CS045,815,783,846,950,135,104,167,103,0.039599256506645725,0.43802729768785026,0.8836511003872026,0.7564727790256943,993,956,1031,1189,196,158,233,212,-0.8588544231211139,-0.26834381355018483,0.31768563253087556,1.0776874000984928,73223,73223,Somerset,Somerset,42,111,Pennsylvania,PA
42115,42CS046,409,392,426,465,56,39,73,37,0.07283170115659977,0.48065022782478467,0.9001112113085658,0.6519755825986236,499,479,520,575,76,55,96,56,-0.026472008588667027,0.5690523303410867,1.1530334053989468,0.7312954148630709,40143,40143,Susquehanna+Wayne,Susquehanna,42,115,Pennsylvania,PA
42127,42CS046,517,495,539,594,77,55,99,29,0.5507412826783009,0.9388960660800737,1.3499138524538845,0.3705417879960712,631,605,657,828,197,171,223,109,1.406873109026484,2.0672837319023647,2.701160689823184,0.5503157407075,51226,51226,Susquehanna+Wayne,Wayne,42,127,Pennsylvania,PA
42121,42CS047,539,517,560,635,96,75,118,58,0.37561397472891284,0.7384268311122308,1.181354989443173,0.5955885411797274,658,632,684,872,214,188,240,136,1.19158701308129,1.839616426553495,2.4610012520068287,0.6331861930237074,50647,50647,Venango,Venango,42,121,Pennsylvania,PA
42125,42CS048,2181,2092,2270,2308,127,38,216,135,-0.469132351509715,-0.030964930204563913,0.40681601933905664,1.0514931143179078,2663,2556,2770,2989,326,219,433,354,-0.8108656111551603,-0.17134667845912607,0.4803538610581498,1.0828086988171477,206840,206840,Washington,Washington,42,125,Pennsylvania,PA
42129,42CS049,3814,3665,3964,4253,439,289,588,425,-0.396482474718612,0.025361145059263353,0.4700068640307231,0.9665106905963975,4657,4478,4836,5195,538,359,717,589,-0.802778596815882,-0.17464239096418374,0.3934531050027644,1.0928765430835397,348168,348168,Westmoreland,Westmoreland,42,129,Pennsylvania,PA
42133,42CS050,3601,3407,3794,4231,630,437,824,424,0.02727689836347558,0.45608447247431677,0.8741918862531685,0.6715623163327469,4419,4187,4652,5251,832,599,1064,684,-0.22706648891431275,0.3797121769479716,1.047111901466219,0.8215008406202348,449802,449802,York,York,42,133,Pennsylvania,PA
44001,44CS001,440,419,461,495,55,34,76,63,-0.578774277339858,-0.16863265405338318,0.2541920777881215,1.1304676206336557,537,512,562,591,54,29,79,66,-0.9504481061193247,-0.3057564744224178,0.3208955963470415,1.2068948515226605,48453,48453,Bristol+Providence,Bristol,44,1,Rhode Island,RI
44007,44CS001,4805,4532,5079,5966,1161,887,1434,1192,-0.5129027696067423,-0.051194935000803285,0.3910988468790566,1.0262057670640774,5887,5558,6215,6213,326,-2,655,626,-1.1608696561814138,-0.5522551329800155,0.06110392795407679,1.9123598182210075,636842,636842,Bristol+Providence,Providence,44,7,Rhode Island,RI
44003,44CS002,1509,1439,1580,1691,182,111,252,205,-0.5819123116470524,-0.15344358091849666,0.30812233838628883,1.1222473330906342,1851,1766,1936,2092,241,156,326,163,-0.05504931638374729,0.5414792330173946,1.1642208610771583,0.6744854046862677,164405,164405,Kent,Kent,44,3,Rhode Island,RI
44005,44CS003,694,659,729,719,25,-10,60,38,-0.5720459330396617,-0.17729214805857657,0.2574305090818419,1.4658494442053396,851,808,893,884,33,-9,76,52,-0.8891600102625787,-0.2747955207986322,0.34627263907078487,1.5162579168829038,82207,82207,Newport,Newport,44,5,Rhode Island,RI
44009,44CS004,1025,971,1079,1163,138,84,192,87,-0.04819080803075229,0.39885061412329104,0.8557628272530526,0.6271530788989896,1261,1196,1326,1365,104,39,169,71,-0.2806030435500185,0.3294466906927043,0.9225350757654842,0.6738282578489052,125821,125821,Washington,Washington,44,9,Rhode Island,RI
45001,45CS001,264,253,274,301,37,27,48,34,-0.27743088415129585,0.1386960728949327,0.5853378049658466,0.8837996592481564,324,311,336,418,94,82,107,41,1.971268057069905,2.6135977112714133,3.221591573023548,0.43048192410366354,24509,24509,Abbeville+Edgefield+Greenwood+McCormick,Abbeville,45,1,South Carolina,SC
45037,45CS001,206,194,217,275,69,58,81,27,1.122158320549213,1.5521119497688787,1.9840032576816444,0.3838515986578356,255,241,269,369,114,100,128,56,1.9290890317005853,2.5475776024566765,3.140787978943312,0.4877770024384329,27254,27254,Abbeville+Edgefield+Greenwood+McCormick,Edgefield,45,37,South Carolina,SC
45047,45CS001,702,671,732,838,136,106,167,84,0.27970363585798497,0.7410169574820857,1.154259283531092,0.6127258101188502,865,828,902,1014,149,112,186,131,-0.320211001194183,0.3117012071887031,0.9523631038778444,0.8726749047296223,71009,71009,Abbeville+Edgefield+Greenwood+McCormick,Greenwood,45,47,South Carolina,SC
45065,45CS001,136,132,140,136,-0,-4,4,13,-1.854626372579301,-1.4157710089806872,-1.0149211001931653,21.967729225792464,167,162,171,180,13,9,18,19,-1.3031087909572137,-0.7377403850499665,-0.14110246531706352,1.3218486116905228,9449,9449,Abbeville+Edgefield+Greenwood+McCormick,McCormick,45,65,South Carolina,SC
45003,45CS002,1582,1508,1656,1928,346,272,420,157,0.6674646413627667,1.1008857594830028,1.5621721986984194,0.45231090151999753,1945,1855,2034,2498,553,464,643,390,0.525087472518456,1.1472949702513202,1.7743940693347588,0.7035578773295309,171965,171965,Aiken,Aiken,45,3,South Carolina,SC
45007,45CS003,1947,1859,2034,2446,499,412,587,295,0.5831732126987219,0.9926839753393244,1.4199888787851793,0.5894590762534915,2380,2274,2485,3024,644,539,750,504,0.18415075698675398,0.8365968475017498,1.418561725486199,0.7812119349332457,203228,203228,Anderson,Anderson,45,7,South Carolina,SC
45013,45CS004,1428,1344,1512,1638,210,126,294,100,0.14015010293932073,0.5746619669572879,1.0506322707767808,0.47453872083159687,1761,1660,1862,2106,345,244,446,184,0.363403438430352,0.9964503056335505,1.5862804579888445,0.5316841017357887,193896,193896,Beaufort,Beaufort,45,13,South Carolina,SC
45015,45CS005,1419,1318,1520,1617,198,97,299,126,-0.10129587409169062,0.3035899329075338,0.7346622287134237,0.6324584468737715,1760,1638,1882,2139,379,257,501,282,-0.15233281336959062,0.5092319879750437,1.1147844982794084,0.7416680278886469,231883,231883,Berkeley,Berkeley,45,15,South Carolina,SC
45017,45CS006,153,147,160,193,40,33,46,15,1.2867183808735871,1.6815174100259813,2.1246302044329024,0.3692908605273846,188,180,195,235,47,40,55,39,0.08890952677821727,0.6861283303759983,1.306909968272006,0.8054191667753208,14530,14530,Calhoun+Richland,Calhoun,45,17,South Carolina,SC
45079,45CS006,2685,2504,2865,3272,587,407,768,304,0.2668801906642535,0.6852096640537291,1.111761848573972,0.5167289941837095,3323,3107,3540,3978,655,438,871,429,-0.015663902660304298,0.6372463832843045,1.2520371878214382,0.6540091122050725,417870,417870,Calhoun+Richland,Richland,45,79,South Carolina,SC
45019,45CS007,2914,2735,3094,3276,362,182,541,274,-0.2261041732170205,0.21267769520854035,0.6596362216052163,0.7552370431546279,3594,3378,3810,3831,237,21,453,378,-1.0555726871206872,-0.4092726210966613,0.2156381522348912,1.58789025836315,414851,414851,Charleston,Charleston,45,19,South Carolina,SC
45021,45CS008,571,546,596,680,109,84,134,85,-0.024492874939653995,0.40962071789061594,0.838642402173212,0.7735277332243362,699,670,729,929,230,200,259,187,0.27113987495143416,0.8865112758990168,1.4696975919739346,0.811156244665762,57325,57325,Cherokee,Cherokee,45,21,South Carolina,SC
45023,45CS009,364,351,378,474,110,96,123,46,1.5346177103846659,1.9851562472861695,2.416731175154697,0.41623326735729516,447,430,463,544,97,81,114,85,-0.1600727714732832,0.46244812376875777,1.0717421407132206,0.8660248963825897,32205,32205,Chester+Fairfield,Chester,45,23,South Carolina,SC
45039,45CS009,249,239,258,329,80,71,90,41,1.3427861708651105,1.7784326115673947,2.2188617529594175,0.5036075036667013,304,293,316,391,87,75,98,50,1.3450637854357121,1.9932547918864951,2.55230564220355,0.5710786293515708,22212,22212,Chester+Fairfield,Fairfield,45,39,South Carolina,SC
45025,45CS010,452,433,472,597,145,125,164,67,1.2890384962037296,1.7094061486392924,2.13091577986654,0.4597993313240061,554,531,578,687,133,109,156,113,-0.08238630184701945,0.5460765379783482,1.1278371824299889,0.8448675060158348,45621,45621,Chesterfield+Marlboro,Chesterfield,45,25,South Carolina,SC
45069,45CS010,291,280,302,356,65,54,76,38,0.5944447767939829,1.0445787593720266,1.4845309807203473,0.5731452866452663,355,341,368,450,95,82,109,73,0.44416931909452817,1.0317560448579315,1.6471712376764895,0.7575983642686855,25917,25917,Chesterfield+Marlboro,Marlboro,45,69,South Carolina,SC
45027,45CS011,343,328,357,501,158,144,173,77,1.979985082236617,2.3995010150034606,2.849328493502185,0.48351600796683575,421,403,438,563,142,125,160,70,1.9401381999843341,2.5908455246255113,3.216218850365181,0.48792072487934435,33641,33641,Clarendon+Williamsburg,Clarendon,45,27,South Carolina,SC
45089,45CS011,346,333,359,469,123,110,136,79,1.0300861514301658,1.4579427083956675,1.897223714291076,0.6387987211502576,424,408,439,537,113,98,129,72,1.021257528507308,1.6815289579843933,2.2289505090390973,0.6298753584172456,30076,30076,Clarendon+Williamsburg,Williamsburg,45,89,South Carolina,SC
45031,45CS012,726,697,755,879,153,124,182,101,0.3778653856771971,0.76999572716783,1.2275531785857972,0.6554783283449023,888,854,922,1097,209,175,243,154,0.37789960527404254,0.9931192146444243,1.5681010635813257,0.7334496879000565,66595,66595,Darlington,Darlington,45,31,South Carolina,SC
45033,45CS013,324,311,337,461,137,124,150,48,2.5070099436699915,2.9312179934221954,3.362016322416555,0.34778787074578543,397,381,413,500,103,87,119,65,0.9356672760329925,1.4806695655110822,2.1265489079074738,0.6247521653631722,30358,30358,Dillon+Marion,Dillon,45,33,South Carolina,SC
45067,45CS013,352,339,365,468,116,103,129,80,0.7946809858315271,1.1882230701223815,1.5905125353760234,0.6825813931925204,430,414,445,517,87,72,103,80,-0.2980141741128202,0.2860109534265469,0.885249941480356,0.9068061622769408,30395,30395,Dillon+Marion,Marion,45,67,South Carolina,SC
45035,45CS014,1057,986,1129,1252,195,123,266,103,0.11507174954490271,0.5561550422030943,0.9687113198204255,0.5265485866684047,1308,1222,1394,1587,279,193,365,229,-0.23256678383918802,0.3661822432832173,1.022439613118108,0.8175835072105316,164442,164442,Dorchester,Dorchester,45,35,South Carolina,SC
45041,45CS015,1325,1265,1384,1751,426,367,486,240,0.939535938376552,1.3669326904204253,1.7887590399142845,0.5615621477207554,1628,1557,1700,2058,430,358,501,275,0.7433987684688177,1.3305380400810674,1.9205257533581865,0.6387453692366754,137903,137903,Florence,Florence,45,41,South Carolina,SC
45043,45CS016,685,658,713,885,200,172,227,91,1.2750947854893053,1.7369381804430288,2.1515820120614286,0.4537648270358179,838,806,871,1052,214,181,246,126,1.0482793397254198,1.6708193571720427,2.3067685242367264,0.5866853904575734,63162,63162,Georgetown,Georgetown,45,43,South Carolina,SC
45045,45CS017,3901,3672,4130,4546,645,416,874,449,-0.06365408861609465,0.3689847333906541,0.7969163371571214,0.6948521740997827,4796,4521,5071,5772,976,701,1251,881,-0.3789157555735756,0.21196301171876183,0.9049581290126406,0.9019092784490018,527972,527972,Greenville,Greenville,45,45,South Carolina,SC
45005,45CS018,96,95,97,119,23,22,24,14,0.9370098885350456,1.0412187243708355,1.1499813898754003,0.58668570659928,119,117,120,154,35,34,37,17,2.4577149720901987,2.607758045503094,2.7566254102751295,0.46575672329317874,8504,8504,Hampton and Nearby Counties,Allendale,45,5,South Carolina,SC
45009,45CS018,167,161,173,205,38,32,44,31,0.11721759970882892,0.5121721650531932,0.9333462130446369,0.7924256414627129,205,198,212,237,32,25,39,24,0.12890305286760936,0.6995575600427926,1.3446309094985882,0.7218227048369623,14024,14024,Hampton and Nearby Counties,Bamberg,45,9,South Carolina,SC
45011,45CS018,222,213,230,296,74,66,83,34,1.498397042510109,1.9504956521281895,2.3753920035966236,0.4504186274519142,273,262,284,317,44,33,55,51,-1.0176898123657463,-0.396592901054581,0.2033236854352593,1.1278919158279181,20874,20874,Hampton and Nearby Counties,Barnwell,45,11,South Carolina,SC
45029,45CS018,463,447,479,558,95,79,111,59,0.5232682183508921,0.9686832395409398,1.4033835314312826,0.6126578790126009,568,548,587,729,161,142,181,122,0.6137030919485575,1.2708318191731496,1.885810475588769,0.7518692541322627,37612,37612,Hampton and Nearby Counties,Colleton,45,29,South Carolina,SC
45049,45CS018,195,187,203,250,55,47,63,31,0.8944051178064159,1.28940741091083,1.6953304249965049,0.5532282741344308,239,229,248,294,55,46,65,36,0.6253704985828361,1.2447904987937894,1.7811631299692368,0.6397680053283094,18790,18790,Hampton and Nearby Counties,Hampton,45,49,South Carolina,SC
45053,45CS018,243,230,257,269,26,12,39,24,-0.38266347146087326,0.06329086474952703,0.48243145359189704,0.8913731699681244,303,287,320,386,83,66,99,68,-0.02368890305726367,0.5585253066065936,1.1647512137130516,0.8142841327567949,30833,30833,Hampton and Nearby Counties,Jasper,45,53,South Carolina,SC
45051,45CS019,3373,3216,3530,4023,650,493,807,353,0.39805573324392923,0.8393109910266625,1.2623696825214594,0.5421603174506933,4143,3955,4332,5244,1101,912,1289,639,0.9079540142029565,1.551265702817443,2.230637398215705,0.580056304488611,359014,359014,Horry,Horry,45,51,South Carolina,SC
45055,45CS020,612,583,641,716,104,75,133,73,0.013393539269533647,0.45491473596932536,0.8761491931368757,0.6981626597506431,754,720,789,984,230,195,264,124,1.26309263176292,1.8792382800214058,2.475072831498963,0.5376254433194589,67050,67050,Kershaw+Lee,Kershaw,45,55,South Carolina,SC
45061,45CS020,205,198,212,267,62,55,69,51,0.20005423249382998,0.6458151149977083,1.0484664836186761,0.8132909575902493,251,242,259,297,46,38,55,53,-1.1328383772406854,-0.472284990884698,0.1348198050712449,1.1228410101826685,16791,16791,Kershaw+Lee,Lee,45,61,South Carolina,SC
45057,45CS021,844,800,887,968,124,81,168,94,-0.1392938447081301,0.2994114985930711,0.7324372088630299,0.7508182285749877,1037,985,1089,1273,236,184,288,174,0.12640690043960331,0.7412588499472453,1.355637875457564,0.7331256867809782,99382,99382,Lancaster,Lancaster,45,57,South Carolina,SC
45059,45CS022,748,719,777,851,103,74,132,79,-0.0762049910510127,0.35199240579353913,0.7703140153700507,0.7585134517977655,917,882,952,1127,210,175,245,180,-0.07623348900505945,0.5421701280249807,1.1576770179921694,0.8520403957059944,67629,67629,Laurens,Laurens,45,59,South Carolina,SC
45063,45CS023,2254,2124,2385,2618,364,233,494,235,0.016579447910131266,0.4188714093234506,0.8634706965917203,0.6445361388315951,2779,2622,2936,3290,511,354,668,405,-0.22909713208023247,0.39806948286419047,1.0632304597084141,0.791545546794407,301306,301306,Lexington,Lexington,45,63,South Carolina,SC
45071,45CS024,370,353,387,488,118,101,135,67,0.8758366905187904,1.329360354999854,1.74650504803357,0.5632064220481174,449,429,469,561,112,92,132,71,0.684550440334405,1.284919463575054,1.8794030051523174,0.629921252914663,38423,38423,Newberry+Saluda,Newberry,45,71,South Carolina,SC
45081,45CS024,180,171,189,267,87,78,96,30,2.3759854887290497,2.7969558751355414,3.2179408450504274,0.34100414666085627,219,208,229,285,66,56,77,44,0.6936115386266549,1.3110260756699772,1.955677137052853,0.6539824450279543,20354,20354,Newberry+Saluda,Saluda,45,81,South Carolina,SC
45073,45CS025,812,778,847,869,57,22,91,75,-0.6388690697225019,-0.22872328128351727,0.2128979613695698,1.3021150010886045,995,954,1037,1192,197,155,238,205,-0.6969489285956895,-0.10301756326708138,0.5047747513533626,1.0365727196213044,79685,79685,Oconee,Oconee,45,73,South Carolina,SC
45075,45CS026,896,859,932,1155,259,223,296,132,1.0374179256669338,1.4812738007067767,1.8913380520179686,0.507110182251236,1097,1053,1141,1416,319,275,363,190,1.2063540467981086,1.7886830450712987,2.4207785624155513,0.5944671649544655,85861,85861,Orangeburg,Orangeburg,45,75,South Carolina,SC
45077,45CS027,1080,1025,1136,1319,239,183,294,145,0.2705181748611174,0.7273983648198981,1.145939398728097,0.6053982381362317,1328,1262,1394,1697,369,303,435,296,0.056163243433425304,0.7054486323751167,1.3247958672059044,0.8003291631675842,127394,127394,Pickens,Pickens,45,77,South Carolina,SC
45083,45CS028,2801,2661,2942,3356,555,414,695,382,0.0696027106060143,0.5401809895147605,0.9820799132297378,0.6876548933062299,3428,3259,3596,4304,876,708,1045,803,-0.32542937671986966,0.2825220724392843,0.9303332528756542,0.9154907411251094,322734,322734,Spartanburg+Union,Spartanburg,45,83,South Carolina,SC
45087,45CS028,327,315,339,409,82,70,94,43,0.9986701433703097,1.4559231197237306,1.8805675178636734,0.5176314894059676,397,383,411,516,119,105,133,71,1.4756866157696544,2.1065305273601465,2.747655087296279,0.5919871354989664,27125,27125,Spartanburg+Union,Union,45,87,South Carolina,SC
45085,45CS029,971,925,1017,1223,252,206,298,127,0.734279492565585,1.175845823727353,1.6066386907628527,0.5018800985954326,1189,1134,1244,1510,321,266,376,206,0.6809666620095364,1.2781251268303817,1.9326375777933515,0.6406170443499011,106520,106520,Sumter,Sumter,45,85,South Carolina,SC
45091,45CS030,1959,1835,2084,2240,281,156,405,224,-0.24214907974160005,0.1846834513689473,0.6499138449546085,0.795464139806542,2416,2267,2565,2795,379,230,528,370,-0.5883501918861014,0.04603336284315715,0.6810082426451348,0.9738977660085152,284668,284668,York,York,45,91,South Carolina,SC
46005,46CS001,169,161,177,195,26,18,34,36,-0.9326263664988499,-0.523074392065313,-0.12053555251678821,1.328085582291317,207,197,216,184,-23,-32,-13,13,-2.9824537790256502,-2.3594941833392484,-1.739897866615296,-0.5969415877627564,18441,18441,Clark and Nearby Counties,Beadle,46,5,South Dakota,SD
46025,46CS001,35,34,35,34,-1,-1,-0,0,-0.29613972558799495,-0.185157963059138,-0.06687895976267012,0,42,42,43,31,-11,-12,-11,6,-5.674457602726494,-5.517514190496958,-5.365251888093295,-0.5816675581545051,3766,3766,Clark and Nearby Counties,Clark,46,25,South Dakota,SD
46029,46CS001,210,197,222,300,90,78,103,68,0.37933377071490115,0.8011158523463622,1.216090126373443,0.7435292125566602,258,243,272,280,22,8,37,17,-0.38392595631272597,0.22093198228035155,0.8064566742152083,0.7264785666838981,28131,28131,Clark and Nearby Counties,Codington,46,29,South Dakota,SD
46039,46CS001,40,40,41,40,-0,-1,0,4,-1.1037659757622151,-1.002997083181018,-0.907547601562684,6.324611460110793,49,49,50,41,-8,-9,-8,4,-3.5317530767566345,-3.376578432872983,-3.224395194164875,-0.5537015988270777,4339,4339,Clark and Nearby Counties,Deuel,46,39,South Dakota,SD
46057,46CS001,55,54,56,90,35,34,36,28,1.040912283882459,1.1478970792609018,1.256627845757834,0.7744924777077923,67,66,68,53,-14,-15,-13,5,-3.7970830185609796,-3.6485397086068905,-3.4808610323814477,-0.38789164284533195,6228,6228,Clark and Nearby Counties,Hamlin,46,57,South Dakota,SD
46077,46CS001,54,53,54,57,3,3,4,12,-1.8972305865154153,-1.798901737099722,-1.682734609918499,2.9074249558578606,66,65,66,72,6,6,7,8,-0.5717621171671586,-0.4093691676538575,-0.26585073785765223,1.091085538629016,4940,4940,Clark and Nearby Counties,Kingsbury,46,77,South Dakota,SD
46115,46CS001,61,60,62,95,34,33,35,20,2.081116996027479,2.1841503880284905,2.290680352811748,0.5730513904190174,74,74,75,68,-6,-7,-6,10,-3.2712461485467923,-3.110979456610229,-2.962261640968092,-1.8187113703779962,6367,6367,Clark and Nearby Counties,Spink,46,115,South Dakota,SD
46027,46CS002,90,88,91,98,8,7,10,12,-0.3648702601757503,-0.2579877225580272,-0.1378367639547098,1.2816513339470181,110,108,112,115,5,3,7,5,-0.16266326104788245,-0.002643915527967568,0.1618300251840914,0.8440628841024028,14158,14158,Clay+Turner+Union+Yankton,Clay,46,27,South Dakota,SD
46125,46CS002,89,88,90,127,38,37,39,37,-0.03197140882722843,0.0727272516954801,0.1878584499660108,0.9580374616328671,109,108,110,109,-0,-1,1,4,-0.779594757305842,-0.6232498586622607,-0.4724310138699941,5.985262131134349,8338,8338,Clay+Turner+Union+Yankton,Turner,46,125,South Dakota,SD
46127,46CS002,114,113,116,142,28,26,29,26,-0.016825348614966363,0.0985921800644075,0.19873272999900402,0.911464602379097,140,138,143,130,-10,-13,-8,8,-1.5303585943113958,-1.370793246967921,-1.2224410730914466,-0.8484453799196856,16082,16082,Clay+Turner+Union+Yankton,Union,46,127,South Dakota,SD
46135,46CS002,211,201,221,228,17,7,27,27,-0.8573740609090779,-0.4441459275746225,0.021883120594221053,1.487199591903518,257,246,269,268,11,-1,22,13,-0.7289237144738029,-0.10662649226378922,0.48468508171691727,1.1250025148853275,22797,22797,Clay+Turner+Union+Yankton,Yankton,46,135,South Dakota,SD
46003,46CS003,25,24,25,41,16,16,17,11,1.8089050094148862,1.9174082929141916,2.024470348098059,0.637778139179256,30,30,31,46,16,15,16,6,4.007356552603035,4.1748517223407235,4.311843093721539,0.3631216957865313,2741,2741,Douglas and Nearby Counties,Aurora,46,3,South Dakota,SD
46009,46CS003,68,67,69,95,27,26,28,21,0.78239192715149,0.8829572765446422,0.998192177728401,0.7471679789151581,84,83,84,105,21,21,22,2,3.2431288360100434,3.3996001121494035,3.557804912961988,0.08892352559164579,6885,6885,Douglas and Nearby Counties,Bon Homme,46,9,South Dakota,SD
46015,46CS003,46,46,47,48,2,1,2,4,-0.5533374008542398,-0.4526151416886436,-0.3492882903657232,1.5197304703186876,57,56,58,49,-8,-9,-7,5,-3.153951334263053,-3.0044778359532094,-2.8356977967045047,-0.7038287023914438,5235,5235,Douglas and Nearby Counties,Brule,46,15,South Dakota,SD
46023,46CS003,97,96,98,130,33,32,34,16,1.7745790077612087,1.879437840159971,1.97662345455196,0.4645851162390886,119,117,120,117,-2,-3,-0,13,-2.0678144183161886,-1.9019585007762063,-1.7452917861818062,-18.594591737384487,9276,9276,Douglas and Nearby Counties,Charles Mix,46,23,South Dakota,SD
46035,46CS003,192,183,200,221,29,21,38,52,-1.5941482137753458,-1.1412858553178775,-0.6982006975171233,1.7163177039352595,235,225,245,235,0,-10,10,14,-1.3961072030058497,-0.8233404353974352,-0.18699061673861717,12.140781237950199,19843,19843,Douglas and Nearby Counties,Davison,46,35,South Dakota,SD
46043,46CS003,39,38,40,44,5,4,6,10,-2.0552253638317026,-1.6625572149526604,-1.2049966808201422,1.6224281546389712,47,46,49,47,-0,-2,1,7,-3.6335348356822763,-3.0073272594276608,-2.413854948092206,10.133066949652909,2909,2909,Douglas and Nearby Counties,Douglas,46,43,South Dakota,SD
46067,46CS003,95,94,95,103,8,8,9,16,-1.1496863731158797,-1.0380419831519634,-0.9306123163370921,1.6981742659053678,116,115,117,109,-7,-8,-6,5,-2.1309510187277882,-1.9816047508419588,-1.8216674207778802,-0.8306552391875472,7285,7285,Douglas and Nearby Counties,Hutchinson,46,67,South Dakota,SD
46083,46CS004,257,230,284,323,66,39,93,66,-0.4341190805355444,-7.328778854218578e-4,0.4814036119866879,0.9797752981327427,323,290,355,309,-14,-46,19,14,-1.1788467704071508,-0.5264461965748355,0.09456272775052461,-1.091171963005135,61978,61978,Lincoln+Minnehaha,Lincoln,46,83,South Dakota,SD
46099,46CS004,1295,1210,1379,1619,324,240,409,267,-0.14776290739379916,0.2681641902620394,0.7414870614350801,0.8205447757366368,1599,1498,1701,1684,85,-17,186,124,-0.8291303062081263,-0.2430432726086877,0.3921596693052517,1.4456347825172113,195197,195197,Lincoln+Minnehaha,Minnehaha,46,99,South Dakota,SD
46011,46CS005,172,156,187,221,49,34,65,29,0.11869396122058826,0.5755342787602972,1.0050630057140288,0.5743491761002903,214,196,232,202,-12,-30,6,5,-1.198406198922945,-0.554902309145027,0.0590468840672936,-0.4546086095779404,35521,35521,Miner and Nearby Counties,Brookings,46,11,South Dakota,SD
46061,46CS005,21,21,22,19,-2,-3,-2,4,-1.9146518358328606,-1.8069262787462117,-1.7076121150152492,-3.1145962505425326,26,26,27,34,8,7,8,2,1.815107054309569,1.9715776977895605,2.130907035879802,0.2295799888831861,3474,3474,Miner and Nearby Counties,Hanson,46,61,South Dakota,SD
46073,46CS005,24,23,25,32,8,7,9,15,-3.791497629322498,-3.372695634985124,-2.9651307478696785,1.6259679098989763,29,28,30,12,-17,-18,-16,2,-11.999899018917274,-11.361290462405405,-10.745510624436763,-0.12541600025260144,2002,2002,Miner and Nearby Counties,Jerauld,46,73,South Dakota,SD
46079,46CS005,100,98,101,91,-9,-10,-7,14,-1.8845323205559503,-1.7840018478164457,-1.6742579103692372,-1.8594677398026322,123,121,124,118,-5,-6,-3,4,-0.9608636378546662,-0.8097477795728156,-0.6597662296767636,-1.1377050505666384,12652,12652,Miner and Nearby Counties,Lake,46,79,South Dakota,SD
46087,46CS005,62,61,63,80,18,17,19,23,-1.013821263732568,-0.9174735136997783,-0.8131433360209884,1.2156505775140605,76,75,77,74,-2,-3,-1,2,-1.0556060563324896,-0.9057772560726298,-0.7443850011270043,-1.7428640931174713,5543,5543,Miner and Nearby Counties,McCook,46,87,South Dakota,SD
46097,46CS005,26,25,27,26,-0,-1,1,2,-1.492624076060024,-1.0616863175072193,-0.6032302262715741,3.126930740707525,32,31,33,40,8,7,9,3,1.994739585925399,2.645841933163215,3.2401955275003136,0.33751111743193063,2213,2213,Miner and Nearby Counties,Miner,46,97,South Dakota,SD
46101,46CS005,50,50,51,67,17,16,17,15,0.17198374809176525,0.27824375300162163,0.3772793023019039,0.8425544679448311,62,61,63,71,9,8,10,11,-0.4856502241622516,-0.32725615668999875,-0.1664879488068982,1.0793716861824663,6542,6542,Miner and Nearby Counties,Moody,46,101,South Dakota,SD
46111,46CS005,22,22,22,18,-4,-4,-4,3,-3.15194767299203,-3.0468193425422747,-2.9483463022015544,-0.9629996342436853,27,27,27,30,3,3,3,6,-1.7833646099516822,-1.6354400659126795,-1.4778439794621596,1.5658192153634742,2335,2335,Miner and Nearby Counties,Sanborn,46,111,South Dakota,SD
46017,46CS006,26,25,27,31,5,4,6,12,-3.9529816745164594,-3.5037504497781704,-3.0664520750636535,1.9787840526347331,32,31,33,53,21,20,22,3,10.651431802989487,11.186110653448548,11.809031423016132,0.13399424507419774,1971,1971,North Central South Dakota,Buffalo,46,17,South Dakota,SD
46021,46CS006,13,12,13,16,3,3,4,8,-3.456175659441447,-3.346476910704747,-3.2433636770928804,1.826028894122702,15,15,15,25,10,10,10,8,1.3408213072985855,1.4997518626215758,1.6678903884983176,0.7457273295956849,1380,1380,North Central South Dakota,Campbell,46,21,South Dakota,SD
46045,46CS006,33,33,34,42,9,8,9,10,-0.4777593286529545,-0.37348753597427686,-0.26074809871737625,1.0442381967050647,40,40,41,59,19,18,19,4,4.394819537964281,4.547553327356607,4.707045324367374,0.20451147115360666,3840,3840,North Central South Dakota,Edmunds,46,45,South Dakota,SD
46049,46CS006,26,26,26,38,12,12,12,4,3.3398705579955688,3.4510747136188327,3.561120954553469,0.30864118476098623,32,31,32,30,-2,-2,-1,6,-4.07576510277667,-3.924385232545162,-3.7657746142850352,-11.004612659143042,2307,2307,North Central South Dakota,Faulk,46,49,South Dakota,SD
46059,46CS006,41,40,43,42,1,-1,2,3,-1.2005359926591754,-0.7922934850196189,-0.3176489874017188,1.9533890030705578,51,49,52,58,7,6,9,4,0.7372294909490708,1.3364021751973059,1.9872101612861914,0.4725645179373382,3152,3152,North Central South Dakota,Hand,46,59,South Dakota,SD
46065,46CS006,153,145,160,175,22,15,30,28,-0.7673116136648529,-0.315769537073338,0.14261981680735633,1.2103461659697592,188,179,197,209,21,12,30,20,-0.5508833479497168,0.06936300109857772,0.6262824674614342,0.9066189811413198,17424,17424,North Central South Dakota,Hughes,46,65,South Dakota,SD
46069,46CS006,19,19,19,20,1,1,1,5,-2.9693923174314194,-2.8620276188117297,-2.7540294335707465,2.1632992705725385,23,22,23,36,13,13,14,8,4.81065867611433,4.973831623611973,5.125557932930797,0.5578836431248239,1289,1289,North Central South Dakota,Hyde,46,69,South Dakota,SD
46085,46CS006,30,30,31,51,21,20,21,3,4.562599977675265,4.675596791371044,4.788455525481894,0.1381253258428286,37,36,37,50,13,13,14,1,3.763994093703521,3.925260806095717,4.075527352288879,0.06954567415462552,3791,3791,North Central South Dakota,Lyman,46,85,South Dakota,SD
46089,46CS006,31,30,32,30,-1,-2,-0,2,-1.808557769642027,-1.4077675190031287,-0.9680484118896582,-6.151822463811001,38,37,39,37,-1,-2,0,1,-1.7148027759520412,-1.1019738807987582,-0.45493561368534796,-5.304510463023969,2378,2378,North Central South Dakota,McPherson,46,89,South Dakota,SD
46107,46CS006,29,28,30,34,5,4,6,5,-0.2622264893624912,0.17311517975477497,0.604558642818744,0.785224130895618,35,34,36,32,-3,-4,-2,1,-2.8623620504281537,-2.1843909836736484,-1.5835858486494823,-0.5111658052631729,2155,2155,North Central South Dakota,Potter,46,107,South Dakota,SD
46117,46CS006,17,17,18,18,1,0,1,6,-1.7784597910248905,-1.6696961233372862,-1.5589204994966979,3.3513847714236684,21,20,21,33,12,12,13,2,3.7773547574531885,3.928873215606798,4.091373105691082,0.15105052828161208,3126,3126,North Central South Dakota,Stanley,46,117,South Dakota,SD
46119,46CS006,11,11,11,10,-1,-1,-1,3,-2.7467671491868373,-2.6350002093635183,-2.531640039413092,8.594011323437734,13,13,13,15,2,2,2,8,-5.264273382306665,-5.102644881294366,-4.933101012201042,2.5627495261888775,1383,1383,North Central South Dakota,Sully,46,119,South Dakota,SD
46129,46CS006,62,61,63,69,7,6,8,14,-1.4084807496716172,-1.302819178175003,-1.2030795806234318,1.7560797704561457,75,74,76,86,11,10,12,5,1.1503741000400185,1.3063558731564962,1.4612524683960768,0.4218466853791726,5386,5386,North Central South Dakota,Walworth,46,129,South Dakota,SD
46013,46CS007,303,287,320,390,87,70,103,58,0.3546993758784801,0.7280120789214041,1.179524300848801,0.661012752261365,372,352,392,372,0,-20,20,38,-1.8263899584217893,-1.1495690436103534,-0.4874627376516617,26.46273524325164,38823,38823,Northeast South Dakota,Brown,46,13,South Dakota,SD
46037,46CS007,63,62,64,93,30,29,31,25,0.8162608185791943,0.9217821371396685,1.0299819044586414,0.8068148522170634,77,76,78,71,-6,-7,-5,6,-2.841038241093445,-2.690089815992169,-2.5335433807728913,-1.1861147335162876,5385,5385,Northeast South Dakota,Day,46,37,South Dakota,SD
46051,46CS007,73,73,74,94,21,20,21,33,-1.8703066961817183,-1.7624228390904597,-1.6596403486983329,1.5324454184797915,90,89,91,96,6,5,7,2,0.5422523797068957,0.6929832669717555,0.8489949264355894,0.2816825675439849,7060,7060,Northeast South Dakota,Grant,46,51,South Dakota,SD
46091,46CS007,37,37,38,41,4,3,4,7,-0.779537630681376,-0.6717705146688966,-0.5748076553870497,1.4881103664239346,46,45,46,53,7,7,8,5,0.38588169054896404,0.5526502322765481,0.717309601709934,0.6053340766981962,4901,4901,Northeast South Dakota,Marshall,46,91,South Dakota,SD
46109,46CS007,96,95,97,108,12,11,13,29,-1.7424589298517381,-1.651273448393957,-1.54890446665991,2.251550758117503,118,116,119,120,2,1,4,10,-1.049880700778957,-0.8959260966348465,-0.7410514591869964,3.0383174571411056,10371,10371,Northeast South Dakota,Roberts,46,109,South Dakota,SD
46019,46CS008,96,95,97,101,5,4,6,19,-1.4553832765102719,-1.3434750331338108,-1.2389419976338305,3.202198516280905,118,116,119,141,23,22,25,22,0.00397501823265478,0.14584637675529846,0.3087254913996706,0.9050969636009786,10468,10468,Northwest South Dakota,Butte,46,19,South Dakota,SD
46031,46CS008,41,41,42,56,15,14,15,14,0.022977960889903927,0.13306396989042588,0.23396343158064095,0.9011351196161416,51,50,51,56,5,5,6,4,0.20940716710059476,0.3691940854366585,0.5132199865534969,0.641155038877399,4057,4057,Northwest South Dakota,Corson,46,31,South Dakota,SD
46041,46CS008,50,50,51,82,32,31,32,16,2.5831465447004627,2.682228397326983,2.7915839085423264,0.48985714241363587,62,61,62,92,30,30,31,11,3.816422217986759,3.967284943517658,4.119249831822033,0.3514140535297106,5837,5837,Northwest South Dakota,Dewey,46,41,South Dakota,SD
46063,46CS008,11,11,11,11,0,0,0,6,-4.478910675126366,-4.375643274035287,-4.262108515457545,4.692553006720055,13,13,13,10,-3,-3,-3,5,-7.626417269746316,-7.468150421255883,-7.311428402607638,-2.3295617107529942,1309,1309,Northwest South Dakota,Harding,46,63,South Dakota,SD
46081,46CS008,212,201,224,248,36,24,47,36,-0.4270603882127447,-0.014654422666214554,0.399666922831127,0.979736761212959,262,248,275,303,41,28,55,36,-0.4400286588150687,0.2466606731050678,0.8214387158418048,0.8477577590317779,26038,26038,Northwest South Dakota,Lawrence,46,81,South Dakota,SD
46093,46CS008,188,175,200,193,5,-7,18,18,-0.8356613890280368,-0.4349126388636219,0.012620093315467776,2.800978005055638,232,218,247,245,13,-2,27,28,-1.3252548220839586,-0.6444624054626161,-0.010191579713011514,2.0482536654241725,28519,28519,Northwest South Dakota,Meade,46,93,South Dakota,SD
46105,46CS008,32,32,32,45,13,13,13,11,0.5527019510675445,0.6596333420210501,0.7613367032655507,0.7928557658252477,39,39,40,33,-6,-7,-6,2,-3.666356029972673,-3.5122459132105552,-3.3608274025888463,-0.37704359494635603,2833,2833,Northwest South Dakota,Perkins,46,105,South Dakota,SD
46137,46CS008,15,15,16,23,8,7,8,3,1.623009785236758,1.7279732538286126,1.8366125718660467,0.34338505722594515,19,18,19,41,22,22,23,4,7.806304482648589,7.977679195175347,8.141126563822244,0.17231411018944687,2741,2741,Northwest South Dakota,Ziebach,46,137,South Dakota,SD
46103,46CS009,855,805,905,1003,148,98,198,129,-0.2588072636373192,0.15535443008724312,0.6003357951899644,0.8654870448355879,1056,996,1116,1251,195,135,255,130,0.04835271253399821,0.6976604229877602,1.2670364465418082,0.6637495898223293,115040,115040,Pennington,Pennington,46,103,South Dakota,SD
46007,46CS010,32,31,32,32,0,0,1,2,-0.5656499272046149,-0.45668338908243045,-0.34910576217868006,1.3843251869232354,39,38,39,50,11,11,12,3,2.8542126897842333,3.0144275749674314,3.169451443563311,0.2403349918338391,3379,3379,Southwest Central South Dakota,Bennett,46,7,South Dakota,SD
46033,46CS010,87,86,88,91,4,3,5,11,-0.9045491320610387,-0.7981393912696255,-0.6936776427470396,2.2655125294091194,106,105,108,95,-11,-13,-10,5,-2.3387618923950098,-2.1879157900763517,-2.029204262294755,-0.4827662956302741,8966,8966,Southwest Central South Dakota,Custer,46,33,South Dakota,SD
46047,46CS010,97,96,97,109,12,12,13,3,1.2856540575080817,1.3963155986599871,1.499070676031283,0.22476042966596174,118,117,119,149,31,30,32,18,2.206142399548458,2.363944972127779,2.515155279634401,0.559531338696539,6696,6696,Southwest Central South Dakota,Fall River,46,47,South Dakota,SD
46053,46CS010,50,49,50,76,26,26,27,26,-0.08190520185172659,0.031046934665814443,0.14287339709486846,0.9582482313611486,61,60,61,75,14,14,15,3,3.0389177187040057,3.187801166367098,3.338965666159386,0.19767534303321074,4198,4198,Southwest Central South Dakota,Gregory,46,53,South Dakota,SD
46055,46CS010,22,21,22,24,2,2,3,5,-1.4836989916585195,-1.3861321145617276,-1.293871838159391,1.4643998187543128,26,26,27,28,2,1,2,7,-3.581917385040856,-3.430556319595478,-3.2760399439758103,2.6218713781380463,1864,1864,Southwest Central South Dakota,Haakon,46,55,South Dakota,SD
46071,46CS010,28,28,29,42,14,13,14,13,0.04149035117740037,0.1557249847528641,0.26438658422091976,0.895428762371956,35,34,35,70,35,35,36,3,11.463784023575208,11.616540094715743,11.77859725046924,0.08282063335058248,3329,3329,Southwest Central South Dakota,Jackson,46,71,South Dakota,SD
46075,46CS010,10,10,11,4,-6,-7,-6,4,-11.443521693266707,-11.33512458243116,-11.229169809137025,-0.733719550447406,13,13,13,13,0,0,0,2,-2.428669372776463,-2.2774578549281936,-2.11777060944608,1.599675444939549,922,922,Southwest Central South Dakota,Jones,46,75,South Dakota,SD
46095,46CS010,25,25,25,27,2,2,2,3,-0.5009167544664848,-0.39634242903746136,-0.2933508990482797,0.9427355563822383,30,30,31,30,-0,-1,0,4,-2.6229454239435515,-2.4670760090857895,-2.313862283130437,5.479798734915154,2077,2077,Southwest Central South Dakota,Mellette,46,95,South Dakota,SD
46102,46CS010,137,131,143,191,54,48,60,33,1.0129800997098706,1.4646305683975382,1.8714808749305862,0.6041484500158275,168,160,175,191,23,16,31,6,0.8033350582928465,1.4736588025610462,2.091914780886979,0.2472769818458665,14129,14129,Southwest Central South Dakota,Southwest Central South Dakota,46,102,South Dakota,SD
46121,46CS010,79,78,80,118,39,38,40,23,1.4829178577976159,1.588187011641466,1.6857643092576466,0.5699582122576886,96,95,97,139,43,42,44,15,3.100113050941582,3.2556109844330363,3.4188776768270617,0.34148482067531805,10307,10307,Southwest Central South Dakota,Todd,46,121,South Dakota,SD
46123,46CS010,63,63,64,81,18,17,18,13,0.8059175462304213,0.9076440916111466,1.0142693165073653,0.6873593852361962,77,76,78,68,-9,-10,-8,2,-2.5856550583771853,-2.4292332921804576,-2.265430249877197,-0.2515100518438336,5408,5408,Southwest Central South Dakota,Tripp,46,123,South Dakota,SD
47001,47CS001,866,833,900,928,62,28,95,69,-0.5134822124555091,-0.10874445466206706,0.29764948998448626,1.1022272295882374,1062,1022,1102,1272,210,170,250,140,0.48339186513882204,1.0728658107748166,1.7422890397153514,0.663860193962523,77227,77227,Anderson,Anderson,47,1,Tennessee,TN
47003,47CS002,448,427,470,514,66,44,87,68,-0.45505789974812744,-0.0521826324283361,0.39366619867070185,1.019153052701653,551,525,577,668,117,91,143,112,-0.5025884206407715,0.13933591507469809,0.7254748891376696,0.9488982987594619,49890,49890,Bedford+Lincoln+Moore,Bedford,47,3,Tennessee,TN
47103,47CS002,377,362,392,461,84,69,99,42,0.7967234265910363,1.2115173885403572,1.6470093776687038,0.49415817592123124,461,443,479,550,89,71,107,94,-0.8025382192387831,-0.17255791849271754,0.47447264606511624,1.0465863366886556,34479,34479,Bedford+Lincoln+Moore,Lincoln,47,103,Tennessee,TN
47127,47CS002,59,58,59,68,9,9,10,4,0.7069465935199275,0.8115092875673785,0.926778153710517,0.3913456220743772,72,71,73,95,23,22,24,17,0.9171704196483617,1.074909855149114,1.2385462177352993,0.714648839491513,6439,6439,Bedford+Lincoln+Moore,Moore,47,127,Tennessee,TN
47005,47CS003,219,212,225,264,45,39,52,34,0.29893905620840455,0.7225952825047718,1.1559493513185761,0.7312245707455225,265,257,274,331,66,57,74,56,0.10321452966034192,0.7094526221424466,1.3421827581230235,0.840369805809862,16171,16171,Benton+Carroll+Henry,Benton,47,5,Tennessee,TN
47017,47CS003,359,347,371,459,100,88,112,53,1.2594524225322692,1.6711495225836333,2.0796206434082456,0.5270239365171604,437,423,451,484,47,33,61,73,-1.763998656130759,-1.1137574049355405,-0.5318205468859297,1.5213218667632944,27739,27739,Benton+Carroll+Henry,Carroll,47,17,Tennessee,TN
47079,47CS003,400,386,414,473,73,59,87,46,0.3836848331424266,0.8303218454635297,1.2569375333293644,0.6227718967711868,486,470,503,567,81,64,97,71,-0.28651441532324934,0.37410213243122187,0.9716729518024992,0.8691107819862255,32204,32204,Benton+Carroll+Henry,Henry,47,79,Tennessee,TN
47007,47CS004,132,130,133,150,18,17,20,6,0.7000513607717018,0.8020782209474455,0.9039411670923867,0.31292549416197746,162,160,164,184,22,20,24,37,-1.3603763513392566,-1.2052895424849852,-1.0625642440191927,1.626745905347994,15142,15142,Bledsoe+Rhea+Van Buren+White,Bledsoe,47,7,Tennessee,TN
47143,47CS004,365,351,379,431,66,52,80,46,0.16503516678129096,0.5852385990776565,1.0598442271998647,0.685669555783379,444,426,461,552,108,91,126,66,0.918044356823845,1.545806335289751,2.170245323964967,0.6028853984245509,33305,33305,Bledsoe+Rhea+Van Buren+White,Rhea,47,143,Tennessee,TN
47175,47CS004,75,74,76,77,2,1,3,7,-0.9674801043264276,-0.8608906086734296,-0.7568513156209457,2.4023741952520274,92,91,93,146,54,53,55,36,3.480236786878849,3.6413447560179275,3.796863922336282,0.6554349609065045,5904,5904,Bledsoe+Rhea+Van Buren+White,Van Buren,47,175,Tennessee,TN
47185,47CS004,322,311,334,346,24,12,35,32,-0.7747795174244894,-0.31179432564335385,0.14102533627089017,1.3041239320582483,392,377,406,482,90,76,105,73,0.12659093724258924,0.761444417977088,1.3749654383012404,0.8003744119043288,27515,27515,Bledsoe+Rhea+Van Buren+White,White,47,185,Tennessee,TN
47009,47CS005,1275,1217,1333,1417,142,84,200,105,-0.14901535875005983,0.2773697314263168,0.7112839083222131,0.7340190639515499,1565,1495,1635,1917,352,282,422,192,0.8156246794720059,1.4205137931273937,2.008617329560922,0.544063972798274,133961,133961,Blount+Loudon,Blount,47,9,Tennessee,TN
47105,47CS005,592,569,616,600,8,-16,31,47,-1.1477428444350806,-0.7328545283113691,-0.28064962582130487,5.2815450711258976,725,697,754,835,110,81,138,94,-0.3396893589558045,0.33981800626952224,1.0132990062811411,0.8489336488193517,54402,54402,Blount+Loudon,Loudon,47,105,Tennessee,TN
47011,47CS006,972,925,1019,1194,222,175,269,72,0.9549418887403058,1.383270300480626,1.7904765557120492,0.3223139656752552,1195,1139,1252,1597,402,345,458,219,1.3589725296985267,1.997566757850913,2.599351021141431,0.5439702781188821,108582,108582,Bradley+Polk,Bradley,47,11,Tennessee,TN
47139,47CS006,208,201,215,246,38,31,45,13,1.0994595237977969,1.4940471787701144,1.9427649150403739,0.33144183177378955,254,245,263,346,92,83,101,41,3.044136066702094,3.667018289776675,4.220618728690998,0.4401597457107833,16794,16794,Bradley+Polk,Polk,47,139,Tennessee,TN
47013,47CS007,511,494,528,548,37,20,54,41,-0.5270971648873889,-0.10008958365259515,0.3499692309283767,1.069568659374608,621,600,641,777,156,136,177,80,1.7064222636740511,2.309877014285689,2.922127783654172,0.5083669126135035,39803,39803,Campbell+Claiborne+Hancock+Scott,Campbell,47,13,Tennessee,TN
47025,47CS007,368,354,381,409,41,28,55,24,0.1149817892685107,0.5656757140770813,0.9787538385855913,0.5652236788635527,447,431,464,598,151,134,167,111,0.8708500696636688,1.487827157251299,2.111528162001244,0.7322060830574108,31962,31962,Campbell+Claiborne+Hancock+Scott,Claiborne,47,25,Tennessee,TN
47067,47CS007,84,84,85,94,10,9,10,5,0.5786184433343222,0.6857273070188082,0.7958315857053054,0.4755204260671304,103,102,104,125,22,21,23,18,0.5180026040469565,0.6877226160646567,0.84737838893666,0.7909387508577131,6558,6558,Campbell+Claiborne+Hancock+Scott,Hancock,47,67,Tennessee,TN
47151,47CS007,235,225,244,242,7,-2,17,28,-1.3570587262911376,-0.932792591827439,-0.5018571945502799,3.2980056841456253,286,274,297,377,91,80,103,56,1.2767908925242057,1.9088019665820242,2.5152841364051377,0.6067165605302405,22097,22097,Campbell+Claiborne+Hancock+Scott,Scott,47,151,Tennessee,TN
47015,47CS008,162,155,168,181,19,13,26,16,-0.18274220254434848,0.24737386497497577,0.6345570757567804,0.7811028549496369,197,189,205,215,18,10,26,27,-1.3855078578460016,-0.7272436400588916,-0.07896186342640954,1.4091485656189928,14693,14693,Cannon+DeKalb+Warren,Cannon,47,15,Tennessee,TN
47041,47CS008,221,212,230,274,53,44,62,30,0.691490106272997,1.1269365747483104,1.5607468680728063,0.5527748729048818,269,258,280,335,66,55,77,45,0.5875622184527093,1.2192581956974187,1.8697721911960095,0.6732942639500155,20587,20587,Cannon+DeKalb+Warren,DeKalb,47,41,Tennessee,TN
47177,47CS008,438,420,456,503,65,47,83,51,-0.10104976597660417,0.3503370596867041,0.7415526485170711,0.7767278510457707,534,513,556,612,78,56,99,90,-0.98665963518737,-0.34292894948911984,0.22064217068808784,1.1393848875371302,41409,41409,Cannon+DeKalb+Warren,Warren,47,177,Tennessee,TN
47019,47CS009,656,631,680,786,130,106,155,87,0.3558977828290578,0.7686553163406455,1.2173527804343063,0.6622922494019254,808,779,837,955,147,118,176,128,-0.21280490487329945,0.4193673005040646,1.0795973230436802,0.86344630074471,56405,56405,Carter+Johnson+Unicoi,Carter,47,19,Tennessee,TN
47091,47CS009,223,215,230,258,35,28,43,33,-0.34196594002991065,0.12150617716628148,0.572464979512801,0.9071620757945864,274,265,283,299,25,16,34,44,-1.9251567899192437,-1.276632356718138,-0.5976255009344342,1.6843201646256578,17805,17805,Carter+Johnson+Unicoi,Johnson,47,91,Tennessee,TN
47171,47CS009,250,243,258,291,41,33,48,26,0.42617390811987044,0.8373747708578185,1.2450353613480976,0.6219901187025939,307,297,316,375,68,59,78,34,1.6797667181122717,2.308733778039968,2.8982124048050606,0.48997500874038996,17848,17848,Carter+Johnson+Unicoi,Unicoi,47,171,Tennessee,TN
47021,47CS010,374,356,391,434,60,43,78,29,0.33143915617059344,0.7646777904533958,1.1760500476342772,0.47273765767320836,457,436,479,565,108,86,129,64,0.6189722487881774,1.2643402119051503,1.8825716567978061,0.5891723246069104,40942,40942,Cheatham+Dickson,Cheatham,47,21,Tennessee,TN
47043,47CS010,514,491,538,565,51,27,74,68,-0.747485713019969,-0.30480719101725595,0.09997642823821527,1.3110027122730137,629,601,657,772,143,115,171,140,-0.5790914754021983,0.07177944636860094,0.7654462448363789,0.9723177909278822,54073,54073,Cheatham+Dickson,Dickson,47,43,Tennessee,TN
47023,47CS011,168,160,175,195,27,20,35,27,-0.4055210642272884,0.02615366474940916,0.44495294526549467,0.9485821708540587,206,197,215,262,56,47,65,41,0.4344317861142797,1.0563008855161191,1.6589372555030104,0.7153578446278134,17358,17358,Chester+Madison,Chester,47,23,Tennessee,TN
47113,47CS011,906,864,948,1128,222,180,264,155,0.2657071379759598,0.6864926162326346,1.135174376623379,0.6952487843660049,1113,1062,1164,1297,184,133,235,171,-0.40966009977164036,0.17909202615550723,0.7367649724584218,0.9246258831930824,98177,98177,Chester+Madison,Madison,47,113,Tennessee,TN
47029,47CS012,462,447,478,571,109,93,124,65,0.7996870500687563,1.2261433922838836,1.6443786509681098,0.5916724349428879,564,545,582,737,173,155,192,97,1.9120716722835747,2.538052095969523,3.1742483988056787,0.5559905031717902,36104,36104,Cocke+Jefferson,Cocke,47,29,Tennessee,TN
47089,47CS012,568,544,592,642,74,50,98,61,-0.1965968975221639,0.21321406746471674,0.6758169280910842,0.8129713002379444,696,667,724,891,195,167,224,132,0.7915585989929224,1.3694820141513206,2.0522491091459005,0.6721617635335003,54873,54873,Cocke+Jefferson,Jefferson,47,89,Tennessee,TN
47031,47CS013,598,573,623,669,71,46,96,70,-0.4466447076894147,0.0019077793279255464,0.3983261510050699,0.9752710521658083,730,700,759,876,146,117,176,129,-0.23359278630462005,0.3729052522524492,0.9999855942057219,0.8745938618593327,57098,57098,Coffee+Franklin,Coffee,47,31,Tennessee,TN
47051,47CS013,433,415,451,546,113,95,131,51,1.0191955714648404,1.4595874061030691,1.8682444444598272,0.4474110588744335,528,506,550,651,123,101,145,81,0.5665534975605641,1.1918134481725486,1.8946933022324093,0.6517107527468062,42351,42351,Coffee+Franklin,Franklin,47,51,Tennessee,TN
47033,47CS014,170,164,176,208,38,32,44,27,0.3280996796260168,0.7664650682256343,1.2170336085511488,0.6972448830853397,208,201,216,212,4,-4,11,23,-2.250273995532056,-1.639890730108013,-0.9686867586177895,4.85985697009348,14185,14185,Crockett+Gibson+Haywood,Crockett,47,33,Tennessee,TN
47053,47CS014,584,563,605,724,140,119,161,87,0.6575156616580384,1.0861695743681634,1.4996725955188972,0.6155170103829835,714,689,740,919,205,179,230,102,1.8609200500599572,2.5343703013449215,3.118680841424267,0.4954444878487215,49133,49133,Crockett+Gibson+Haywood,Gibson,47,53,Tennessee,TN
47075,47CS014,182,175,190,230,48,40,55,40,0.020434259130013017,0.45462839706252545,0.858310307446583,0.8231896278873845,223,215,232,286,63,54,71,41,0.9527358414152868,1.5275855135356693,2.154106630898575,0.6442268207888914,17143,17143,Crockett+Gibson+Haywood,Haywood,47,75,Tennessee,TN
47035,47CS015,740,714,766,865,125,99,151,64,0.5898492465894293,0.998693645724718,1.4200809754176345,0.5079047700259756,902,870,933,1246,344,313,376,182,2.5669900338876093,3.2043884974000787,3.833320519306314,0.5269276802724141,61153,61153,Cumberland+Fentress,Cumberland,47,35,Tennessee,TN
47049,47CS015,224,216,232,273,49,41,57,32,0.4530975195982743,0.9147807237245259,1.2923833457929275,0.6427821382774835,273,263,283,378,105,95,115,62,2.139742564920717,2.730256902956887,3.406910062338485,0.5859512031268457,18659,18659,Cumberland+Fentress,Fentress,47,49,Tennessee,TN
47037,47CS016,4665,4367,4964,5572,907,608,1205,539,0.10798212907091591,0.5371508420881216,0.9710742587886276,0.5936927724006382,5753,5394,6111,5937,184,-174,543,687,-1.4592352208220063,-0.871305976098433,-0.2681733799751367,3.7050370679934694,693489,693489,Davidson,Davidson,47,37,Tennessee,TN
47039,47CS017,154,149,159,199,45,40,50,22,1.590668499888288,2.0001345566520707,2.4624887392533705,0.47584373020700343,187,181,193,211,24,18,30,22,-0.3746190475385734,0.23667833917608316,0.8032430313915803,0.868765003535384,11605,11605,Decatur+Henderson+Lewis+Perry,Decatur,47,39,Tennessee,TN
47077,47CS017,295,283,307,366,71,59,83,55,0.11145998245801281,0.5661743025971984,0.9956952969148058,0.764766394821085,359,345,374,436,77,62,91,74,-0.5094947628289697,0.12151975745417266,0.7472430634251074,0.9532442673716537,28061,28061,Decatur+Henderson+Lewis+Perry,Henderson,47,77,Tennessee,TN
47101,47CS017,149,144,155,171,22,16,27,15,0.1645243724376002,0.536304819029762,0.9658831233522795,0.6593464670775092,182,175,188,224,42,36,49,27,0.8748599503706025,1.4956811845526252,2.143309444493882,0.6210788290939591,12307,12307,Decatur+Henderson+Lewis+Perry,Lewis,47,101,Tennessee,TN
47135,47CS017,106,105,107,112,6,5,7,17,-1.441632657481665,-1.3399401922823255,-1.2365681186207225,2.3635016950286554,130,128,131,145,15,14,17,21,-0.9710082564919359,-0.8252737935367196,-0.6624307182893934,1.2749289670036026,8090,8090,Decatur+Henderson+Lewis+Perry,Perry,47,135,Tennessee,TN
47045,47CS018,408,392,424,533,125,109,141,63,1.2679379692411707,1.6748342165583963,2.1105859787568315,0.49980192295172954,499,480,518,627,128,109,147,85,0.7500902163178547,1.3818186690886478,2.026713198939726,0.6609767462769855,36943,36943,Dyer+Lake+Lauderdale,Dyer,47,45,Tennessee,TN
47095,47CS018,80,79,81,93,13,12,14,12,0.023265464624705724,0.1243581293441608,0.23285534219233783,0.8644269899874162,98,97,99,137,39,38,40,16,3.72998050947644,3.901091140691792,4.058179154938263,0.4026467480628879,7001,7001,Dyer+Lake+Lauderdale,Lake,47,95,Tennessee,TN
47097,47CS018,258,247,269,296,38,27,49,32,-0.19238698586192343,0.25440912847244374,0.6545598107672088,0.8163285544619764,316,303,330,357,41,27,54,51,-1.0681577465267265,-0.4829957189020911,0.1189807196943703,1.2252437294166258,25543,25543,Dyer+Lake+Lauderdale,Lauderdale,47,97,Tennessee,TN
47047,47CS019,373,355,391,461,88,70,106,41,0.7182432228589252,1.1354283840489952,1.5961858879966835,0.45964729006427446,457,435,478,565,108,87,130,83,0.11671364744019347,0.7500831251880177,1.3339980448820152,0.7587046288482127,41284,41284,Fayette+Hardeman,Fayette,47,47,Tennessee,TN
47069,47CS019,254,243,265,333,79,68,90,50,0.7266959514283866,1.1536794491853706,1.5884638698283133,0.6258898568945405,310,297,323,383,73,60,86,42,0.878268432379998,1.4997544194506915,2.104029658505114,0.5668968344461861,24960,24960,Fayette+Hardeman,Hardeman,47,69,Tennessee,TN
47055,47CS020,335,322,347,413,78,66,91,43,0.8054172229870856,1.2012782960273776,1.6068951321158382,0.5410097233159129,410,394,425,526,116,101,132,79,0.911663291758841,1.4985098128507568,2.139139923769506,0.6733847425257494,29501,29501,Giles+Marshall,Giles,47,55,Tennessee,TN
47117,47CS020,329,314,344,369,40,25,55,31,-0.16293074701159224,0.2542204969768475,0.6682405133126631,0.7556819757704307,405,387,423,466,61,43,79,67,-0.7794840082645345,-0.2128377481908282,0.4007552518988648,1.0804731530209495,34719,34719,Giles+Marshall,Marshall,47,117,Tennessee,TN
47057,47CS021,258,248,269,332,74,63,84,27,1.5501464134624978,1.9621023572256677,2.4058521475655663,0.36210977870825134,316,304,329,394,78,65,90,59,0.33238513193209096,0.9341369640627238,1.580465278400743,0.7503881559970564,23472,23472,Grainger+Hamblen,Grainger,47,57,Tennessee,TN
47063,47CS021,670,642,698,859,189,161,217,79,1.25810446399117,1.6924956662215487,2.10997509191227,0.41596330252625635,821,787,855,1110,289,255,323,169,1.608593215307621,2.229541368102881,2.808272203389808,0.5830004852891919,64972,64972,Grainger+Hamblen,Hamblen,47,63,Tennessee,TN
47059,47CS022,830,800,860,931,101,71,131,88,-0.2329337317997741,0.20248092129897163,0.6444219269303211,0.8613281275651586,1016,980,1052,1285,269,233,305,167,1.1574442418008617,1.7727051638532416,2.3490161671587617,0.617935008431241,69312,69312,Greene,Greene,47,59,Tennessee,TN
47061,47CS023,180,174,186,197,17,11,23,17,-0.41409865705502863,-0.007667761711675249,0.42533623322918396,0.9358367376461537,218,211,225,246,28,21,35,42,-1.8813235764815606,-1.218582600105101,-0.6094983618864082,1.441267458273887,13441,13441,Grundy+Marion+Sequatchie,Grundy,47,61,Tennessee,TN
47115,47CS023,314,302,327,359,45,32,57,36,-0.13742147859839232,0.279582937734087,0.7290193688088968,0.7893116279309347,382,367,396,475,93,79,108,72,0.25525223265742975,0.8955832044256771,1.4974733612526305,0.7620020015047411,28897,28897,Grundy+Marion+Sequatchie,Marion,47,115,Tennessee,TN
47153,47CS023,148,142,155,165,17,10,23,12,-0.1320446926690396,0.3049886565113447,0.7673424370089289,0.6771720686429067,180,172,188,229,49,41,57,48,-0.5662166987585779,0.04426907593118062,0.7043308330351257,0.9646256000452208,15115,15115,Grundy+Marion+Sequatchie,Sequatchie,47,153,Tennessee,TN
47065,47CS024,3223,3063,3383,3584,361,201,521,257,-0.14490281849327077,0.2758084391815627,0.7151354467706339,0.709960781651796,3961,3769,4153,4508,547,355,739,527,-0.5824051869068269,0.0702049995250324,0.7160198740678495,0.9610452951915641,369395,369395,Hamilton,Hamilton,47,65,Tennessee,TN
47071,47CS025,334,323,345,404,70,59,81,36,0.9291425303773466,1.3436926238865514,1.7780439450412842,0.5042800159299019,407,394,421,527,120,106,133,71,1.6766844636821214,2.2928362338652293,2.898107443552613,0.5883098519319278,25609,25609,Hardin+McNairy,Hardin,47,71,Tennessee,TN
47109,47CS025,327,316,338,404,77,66,88,35,1.1889683961033601,1.6354594966214087,2.0456046451124,0.45018343164759667,400,387,413,462,62,49,75,50,-0.006009260531764407,0.5666315979717915,1.2116529157198606,0.7913927830861183,25676,25676,Hardin+McNairy,McNairy,47,109,Tennessee,TN
47073,47CS026,639,614,663,767,128,104,153,55,0.868176114477322,1.274935505073199,1.7255911026139128,0.42581983529476747,782,752,811,1038,256,227,286,155,1.5147556301936935,2.14027854779983,2.769492253949227,0.6020831762086911,56822,56822,Hawkins,Hawkins,47,73,Tennessee,TN
47081,47CS027,255,244,266,326,71,60,82,34,1.013712457802197,1.4628558454484837,1.88049167055061,0.473816123443978,313,300,326,378,65,52,78,60,-0.4038227344359938,0.25863770225250654,0.920288627069493,0.9055995733884643,25252,25252,Hickman+Houston+Humphreys+Stewart,Hickman,47,81,Tennessee,TN
47083,47CS027,101,100,102,128,27,26,28,17,1.0668377941045553,1.172203910972467,1.2877771174647188,0.6146460444289504,124,123,125,141,17,16,18,23,-1.0602088822617528,-0.9108719542291116,-0.7637139215812128,1.2987265860519563,8242,8242,Hickman+Houston+Humphreys+Stewart,Houston,47,83,Tennessee,TN
47085,47CS027,218,210,226,241,23,15,31,19,-0.23748408630482257,0.18246063668378834,0.6193243324421537,0.8083850979032776,267,257,276,350,83,74,93,43,1.9982356264344294,2.592211666656149,3.1887573343596425,0.5103269337633917,18594,18594,Hickman+Houston+Humphreys+Stewart,Humphreys,47,85,Tennessee,TN
47161,47CS027,153,147,159,158,5,-1,11,20,-1.5492278739909595,-1.084245133576269,-0.6635625719970333,3.301796227231114,187,180,194,208,21,14,28,25,-1.0148404724832443,-0.37620722272458895,0.2742397339793192,1.141818263865279,13766,13766,Hickman+Houston+Humphreys+Stewart,Stewart,47,161,Tennessee,TN
47087,47CS028,149,144,154,170,21,16,26,23,-0.5786968070732242,-0.1629863661634682,0.28285305022129525,1.038738103340216,181,175,187,182,1,-5,7,21,-2.661641035806212,-2.0089428903523396,-1.4053387177133987,11.149989793143883,11849,11849,Jackson+Putnam+Smith,Jackson,47,87,Tennessee,TN
47141,47CS028,740,705,775,924,184,149,219,118,0.3680298365036502,0.8136828021072807,1.2811605525543,0.6383231587948305,906,864,948,1043,137,95,179,91,0.0806599263488955,0.7012450225166992,1.2870484216291487,0.6585666779173472,80362,80362,Jackson+Putnam+Smith,Putnam,47,141,Tennessee,TN
47159,47CS028,186,178,195,217,31,22,39,21,0.04870609999440887,0.4779826077431804,0.9042726039273439,0.6663291660555235,228,218,239,286,58,47,68,39,0.4685006136235139,1.120607154393362,1.7695775553811484,0.6625566006977924,20186,20186,Jackson+Putnam+Smith,Smith,47,159,Tennessee,TN
47093,47CS029,3952,3748,4157,4556,604,399,808,287,0.2703707387346343,0.688421038668315,1.1024144001744511,0.4744840678842203,4844,4598,5089,5782,938,693,1184,606,0.200322410969863,0.8198231575696178,1.4550486982513222,0.6451634214659107,472417,472417,Knox+Union,Knox,47,93,Tennessee,TN
47173,47CS029,197,188,205,247,50,42,59,17,1.2409709421359334,1.6571867037140686,2.0888380688304498,0.3309016228011802,240,230,251,348,108,97,118,48,2.9603881677774093,3.594165727801898,4.19797465464496,0.44156305710229626,20041,20041,Knox+Union,Union,47,173,Tennessee,TN
47099,47CS030,486,466,505,595,109,90,129,62,0.6454277222973597,1.0597704431032346,1.4886294290262527,0.5615941298047248,593,570,616,694,101,78,124,102,-0.6450704654125231,-0.014362701040085997,0.5531130788418857,0.9969988906187057,44275,44275,Lawrence+Wayne,Lawrence,47,99,Tennessee,TN
47181,47CS030,179,172,186,196,17,10,24,19,-0.5563113824460935,-0.10094782342545605,0.34865661464512443,1.0350962456541548,218,209,226,264,46,38,55,32,0.4915907021102602,1.0211334132019694,1.6156222205483877,0.6785102952417581,16594,16594,Lawrence+Wayne,Wayne,47,181,Tennessee,TN
47107,47CS031,608,584,631,708,100,77,124,61,0.29318719206522376,0.7166467776708382,1.1426369593811339,0.6023408061691202,747,719,775,947,200,172,228,123,1.0666984205024381,1.722121915483248,2.334350339424012,0.6107748535579309,53976,53976,McMinn+Meigs+Monroe,McMinn,47,107,Tennessee,TN
47121,47CS031,159,153,164,156,-3,-8,3,17,-1.9979218204787632,-1.6064063017367172,-1.15691669561542,-9.280069174013862,195,188,201,210,15,9,22,29,-1.966809098366892,-1.319589196416973,-0.7263790301584175,1.7820909440896207,12430,12430,McMinn+Meigs+Monroe,Meigs,47,121,Tennessee,TN
47123,47CS031,523,503,544,606,83,62,103,53,0.20175271999649397,0.6420575130558056,1.0389316454741775,0.6329681177670452,643,619,668,824,181,156,205,127,0.7890379193557641,1.3705995218740332,2.0124624327980216,0.6986261349564158,46870,46870,McMinn+Meigs+Monroe,Monroe,47,123,Tennessee,TN
47119,47CS032,874,831,917,909,35,-8,78,105,-1.138954415526853,-0.7196713149349107,-0.297325044011171,2.9365010697336,1074,1022,1125,1197,123,72,175,143,-0.8822667851627538,-0.2698627425137959,0.4034295491442492,1.15030867958629,97960,97960,Maury,Maury,47,119,Tennessee,TN
47125,47CS033,1234,1142,1326,1493,259,167,351,112,0.25753629553508106,0.6959079257862433,1.1300006461909027,0.43012005388646724,1533,1422,1644,1947,414,303,525,304,-0.028065726650999764,0.6318760937991581,1.2162407915630198,0.732570961429823,211659,211659,Montgomery,Montgomery,47,125,Tennessee,TN
47129,47CS034,218,208,227,227,9,0,19,11,-0.5002612642411073,-0.05793660724276221,0.3847565353339844,1.0502571310066493,267,256,278,335,68,57,79,42,0.8179585517331942,1.4256552345188294,2.041022056796932,0.6115652342536498,21404,21404,Morgan+Roane,Morgan,47,129,Tennessee,TN
47145,47CS034,662,639,685,750,88,65,111,54,0.17733172145188528,0.6253064460993766,1.0635571290725654,0.6077613388693704,811,783,839,922,111,83,139,114,-0.6977845914764715,-0.07162094254794117,0.523928663767785,1.0153586123751255,53628,53628,Morgan+Roane,Roane,47,145,Tennessee,TN
47027,47CS035,97,96,97,137,40,40,41,19,2.710726175981697,2.8199230967764053,2.9220692941045057,0.4581415730395778,118,117,119,139,21,20,22,16,0.6566719933163659,0.8148301133196635,0.9748794381111267,0.7210415004527196,7610,7610,North Central Tennessee,Clay,47,27,Tennessee,TN
47111,47CS035,237,226,248,301,64,53,75,41,0.47022654349824716,0.9418486713246683,1.3916547988001169,0.6307075126499175,289,276,302,341,52,39,65,59,-0.9611567707187563,-0.33225640444625915,0.2567926614043165,1.1134600965570947,24709,24709,North Central Tennessee,Macon,47,111,Tennessee,TN
47133,47CS035,268,258,277,343,75,66,85,42,1.072303452986703,1.4946972107626477,1.9523863939240567,0.549694302999484,325,314,337,404,79,67,90,55,0.6405603347640921,1.2809832446305194,1.9132431846588267,0.691720428150454,22394,22394,North Central Tennessee,Overton,47,133,Tennessee,TN
47137,47CS035,64,63,64,79,15,15,16,18,-0.6749859755980764,-0.5727122151718618,-0.460344337218158,1.1175342812732791,78,77,79,80,2,1,3,1,0.08307374521063994,0.2383057908197191,0.4022725199988134,0.33126092418456365,5065,5065,North Central Tennessee,Pickett,47,137,Tennessee,TN
47169,47CS035,95,94,96,107,12,11,13,13,-0.20407289562137884,-0.0996854367487071,0.0037692699457853164,1.0098011048482132,116,115,118,152,36,34,37,20,1.4913035827198715,1.6571644414655717,1.8080615151465766,0.5449827171326671,11351,11351,North Central Tennessee,Trousdale,47,169,Tennessee,TN
47131,47CS036,331,318,344,455,124,111,137,72,1.3155307293606069,1.7470998333137382,2.160639966737786,0.573928843873505,406,390,421,497,91,76,107,74,0.03082079562120522,0.6880219116595716,1.338673401546031,0.8008420420084789,30200,30200,Obion+Weakley,Obion,47,131,Tennessee,TN
47183,47CS036,342,327,356,380,38,24,53,35,-0.3300668832995765,0.07832790562461897,0.4929797353243327,0.8918276542799387,420,403,437,496,76,59,93,59,0.041397769643700046,0.6110560684388414,1.1497310129037046,0.7683168873271953,33296,33296,Obion+Weakley,Weakley,47,183,Tennessee,TN
47147,47CS037,602,571,633,769,167,136,198,73,0.8931836631144023,1.3096618373727547,1.7348220185708687,0.43442211562207983,739,702,776,959,220,183,257,116,1.0673097397882074,1.7366009250897925,2.373240168622692,0.5246973952632142,71936,71936,Robertson,Robertson,47,147,Tennessee,TN
47149,47CS038,1888,1742,2034,2287,399,253,545,235,0.06991756106547965,0.4929600501244924,0.9417609522942629,0.5874035760643067,2347,2172,2522,2886,539,364,714,432,-0.25227348652970344,0.38754871489897735,1.0129548329991034,0.8000150352936198,335098,335098,Rutherford,Rutherford,47,149,Tennessee,TN
47155,47CS039,947,904,989,1105,158,116,201,86,0.314918192793047,0.7309459030658526,1.1702928525777083,0.5401378894905408,1162,1111,1213,1479,317,266,368,219,0.5629382102535148,1.1758931524107907,1.779570652105066,0.688612941379522,98753,98753,Sevier,Sevier,47,155,Tennessee,TN
47157,47CS040,7122,6719,7525,9054,1932,1529,2335,955,0.6161989532999351,1.0431503087392846,1.462827305847697,0.4940193084201252,8766,8282,9249,12526,3760,3277,4244,1620,2.193739792885893,2.750385744335267,3.3657604191219153,0.4307281310754226,936631,936631,Shelby,Shelby,47,157,Tennessee,TN
47163,47CS041,1812,1744,1881,2145,333,264,401,184,0.5071504079553664,0.9422050810086702,1.3326392805651717,0.5513842909593367,2213,2131,2295,2690,477,395,559,319,0.5892506856237584,1.2037882563618034,1.7734225057752573,0.6674752292281048,158588,158588,Sullivan,Sullivan,47,163,Tennessee,TN
47165,47CS042,1472,1388,1556,1729,257,173,341,188,-0.06062692387352579,0.3699686315877655,0.8220769684718486,0.7282325774320481,1814,1713,1915,2298,484,383,585,337,0.30711855853442477,0.9076501170045964,1.5371004953646492,0.6949874232962395,193190,193190,Sumner,Sumner,47,165,Tennessee,TN
47167,47CS043,526,499,552,598,72,46,99,64,-0.29303939492179587,0.13632151458644803,0.585943232417536,0.8735330972840407,644,612,676,804,160,128,192,126,-0.004717972028579481,0.6643851352631966,1.3515145799769934,0.7829698138563066,61800,61800,Tipton,Tipton,47,167,Tennessee,TN
47179,47CS044,1272,1216,1328,1539,267,211,323,151,0.4759964343200546,0.8851335501182175,1.315329312746424,0.5631568104734429,1558,1491,1626,1901,343,275,410,199,0.7304284422031138,1.3342040447954415,1.9252501530339883,0.5792893996035017,129960,129960,Washington,Washington,47,179,Tennessee,TN
47187,47CS045,1232,1127,1338,1390,158,52,263,138,-0.34062629191527083,0.08823113946948623,0.48883025685241727,0.8701145548898016,1540,1413,1667,1671,131,4,258,173,-0.8454033615203003,-0.2099415560865796,0.451043957324354,1.3096052142484174,241386,241386,Williamson,Williamson,47,187,Tennessee,TN
47189,47CS046,1039,975,1103,1283,244,180,308,144,0.24015759523712027,0.6969958694354416,1.116874941701445,0.5878419702832491,1284,1207,1360,1558,274,198,351,244,-0.3644655414942323,0.25417974651556136,0.936168112857033,0.8857806931661734,146017,146017,Wilson,Wilson,47,189,Tennessee,TN
48001,48CS001,565,540,590,612,47,22,72,76,-0.9387464616864595,-0.5064920882860935,-0.058078328273178374,1.5730691990637455,690,661,720,883,193,163,222,138,0.49339833794356847,1.1268252532562675,1.7788747664520577,0.7127253108943892,57811,57811,Anderson+Houston,Anderson,48,1,Texas,TX
48225,48CS001,244,234,254,308,64,54,74,27,1.1896128206146985,1.6236523281305493,2.0411244738396372,0.41511639609211254,298,286,310,392,94,82,106,70,0.6118339540613075,1.2808962020020063,1.916023994101724,0.7348768235616231,22860,22860,Anderson+Houston,Houston,48,225,Texas,TX
48005,48CS002,773,736,810,990,217,180,254,163,0.15635174438225571,0.6115200294028204,1.0368086295412415,0.7472299159513115,949,904,994,1256,307,262,352,262,0.008495390345394668,0.6092428905140175,1.2307039362329177,0.8498014742829914,86776,86776,Angelina,Angelina,48,5,Texas,TX
48007,48CS003,283,272,293,380,97,87,108,23,2.712401623726126,3.171018084626956,3.5783131814026894,0.2335767163206588,345,333,357,428,83,71,95,46,1.2760811979538085,1.8776730942156388,2.4782984866328492,0.5471450834965951,23552,23552,Aransas+Calhoun+Refugio,Aransas,48,7,Texas,TX
48057,48CS003,170,161,179,216,46,37,55,11,1.231864892007402,1.6544681828900072,2.0433870166028267,0.23523520495444644,209,198,220,268,59,48,70,29,1.1190753256665793,1.7187943184798762,2.3274307710976934,0.4817491431579485,21139,21139,Aransas+Calhoun+Refugio,Calhoun,48,57,Texas,TX
48391,48CS003,73,72,74,100,27,26,28,17,1.3674152834714752,1.4627446424105741,1.5667953311652452,0.6059624972191595,89,88,90,112,23,22,24,13,1.5561883830122067,1.7124409724017284,1.864266744640017,0.5468570541966457,6846,6846,Aransas+Calhoun+Refugio,Refugio,48,391,Texas,TX
48009,48CS004,77,76,78,76,-1,-2,-0,4,-0.6787816442731529,-0.5688304045113011,-0.4600387498284445,69.91937076541113,94,93,96,112,18,16,19,22,-0.7643489314148257,-0.6084458178256067,-0.44697779892007544,1.1845017266291022,8708,8708,Archer+Wichita,Archer,48,9,Texas,TX
48485,48CS004,1191,1134,1249,1403,212,154,269,240,-0.6468122944895233,-0.22351677923951402,0.20518968394509765,1.1292205027185307,1463,1394,1532,1775,312,243,381,306,-0.5660839842083347,0.05495998660255994,0.6893754205616417,0.9785495611800991,132693,132693,Archer+Wichita,Wichita,48,485,Texas,TX
48013,48CS005,365,343,387,485,120,98,142,89,0.1779740221725246,0.6014469389737155,1.0322110812340592,0.7370626927737378,450,424,477,627,177,150,203,136,0.3393851359259411,0.9583108253111017,1.5415682471510614,0.7658440093934602,51383,51383,Atascosa+Live Oak+McMullen,Atascosa,48,13,Texas,TX
48297,48CS005,108,106,109,131,23,22,25,17,0.40912037587743566,0.5144758694921651,0.6183253766455565,0.6986076639092131,132,130,133,155,23,22,25,30,-0.8199212655454091,-0.6702483767238495,-0.5136111358047835,1.2417967029240824,12273,12273,Atascosa+Live Oak+McMullen,Live Oak,48,297,Texas,TX
48311,48CS005,9,9,9,17,8,8,8,6,2.740174194588617,2.8470895299703765,2.957970394745539,0.6612242122572509,11,11,11,14,3,3,3,3,-0.012343282173242359,0.14681046013994167,0.31363656435220993,0.7333704389410879,728,728,Atascosa+Live Oak+McMullen,McMullen,48,311,Texas,TX
48015,48CS006,240,227,253,271,31,18,44,19,-0.01348512869455909,0.4015084457609381,0.8548549335837538,0.5949604058051217,294,278,309,365,71,56,87,42,0.5480864784123066,1.1680571375479503,1.7726154620201837,0.5801271993236277,30051,30051,Austin+Waller+Washington,Austin,48,15,Texas,TX
48473,48CS006,303,279,328,395,92,67,116,27,0.7097751672795594,1.146960940019827,1.6096834576911936,0.2914945570946959,376,346,406,501,125,95,155,78,0.4166052383714237,1.0013536767830025,1.6756895371189358,0.6192141631664279,56203,56203,Austin+Waller+Washington,Waller,48,473,Texas,TX
48477,48CS006,320,304,335,416,96,81,112,65,0.4457760787281471,0.8826225944076806,1.2958286957863365,0.6684591737088347,391,372,409,521,130,112,149,76,1.188276745014912,1.8143624497003938,2.457957317006478,0.5782641778188728,35686,35686,Austin+Waller+Washington,Washington,48,477,Texas,TX
48019,48CS007,227,217,237,264,37,27,47,15,0.47252454017843293,0.9443390152542,1.388175329987456,0.3931809898758421,277,265,290,329,52,39,64,49,-0.5154730066401007,0.1297554677407273,0.7796357322948634,0.9325306213045321,23464,23464,Bandera+Kendall+Kerr,Bandera,48,19,Texas,TX
48259,48CS007,352,332,373,379,27,6,47,38,-0.6551539833163013,-0.23694607266413417,0.18685702225076012,1.3798188100553348,433,408,458,457,24,-1,49,58,-1.4681726455803743,-0.847358212098958,-0.20674728358286273,2.3272976288131493,47878,47878,Bandera+Kendall+Kerr,Kendall,48,259,Texas,TX
48265,48CS007,635,613,658,699,64,41,86,51,-0.19696410113947385,0.24014526798892386,0.6577392535595653,0.788593432979572,773,746,800,863,90,63,117,92,-0.6832734198507984,-0.029413756989755173,0.5718844886341745,1.0117733309936978,52608,52608,Bandera+Kendall+Kerr,Kerr,48,265,Texas,TX
48021,48CS008,638,598,677,697,59,20,99,53,-0.3609695299000303,0.0733114755381183,0.4452424827897019,0.8771466122470019,787,740,835,943,156,108,203,144,-0.44458719314951933,0.15559256927910814,0.7365148692137091,0.9199508741232848,89930,89930,Bastrop+Caldwell,Bastrop,48,21,Texas,TX
48055,48CS008,319,300,337,414,95,77,114,50,0.6085408798156243,1.0545319468132783,1.4579937298882684,0.5182612953557375,392,370,415,489,97,74,119,102,-0.7288472537834274,-0.16159935951728152,0.5172420641561533,1.043798896375462,43746,43746,Bastrop+Caldwell,Caldwell,48,55,Texas,TX
48025,48CS009,234,220,248,276,42,28,56,49,-0.6288400868304451,-0.21350687401732454,0.23211481195537423,1.1377319699143664,289,273,306,398,109,92,125,90,0.07305372728511746,0.6917756529816099,1.2602999165374302,0.8211428961900277,32574,32574,Bee+Goliad+Karnes,Bee,48,25,Texas,TX
48175,48CS009,72,71,73,64,-8,-9,-7,4,-1.681627906088417,-1.5734908527171678,-1.466147970852576,-0.5713902175546791,88,87,89,98,10,9,11,19,-1.6237224438947941,-1.4697981683962817,-1.3137945331716345,1.773751711718217,7615,7615,Bee+Goliad+Karnes,Goliad,48,175,Texas,TX
48255,48CS009,140,133,147,156,16,9,23,24,-0.957510259445907,-0.5114105420657004,-0.08910609561276175,1.4114684265936703,172,164,180,175,3,-5,11,30,-2.678947122954907,-2.119084986302287,-1.496101723288464,8.28071298368398,15442,15442,Bee+Goliad+Karnes,Karnes,48,255,Texas,TX
48027,48CS010,2074,1915,2233,2385,311,152,470,202,-0.16254671963143066,0.2936081572059322,0.7321605907433433,0.6466131548878274,2573,2382,2764,3349,776,585,967,551,0.1113191670413074,0.724916780284157,1.3617410989237133,0.7095005712176974,366290,366290,Bell,Bell,48,27,Texas,TX
48029,48CS011,11902,11031,12773,14275,2373,1502,3244,1952,-0.21445666571437672,0.21963734516545966,0.6839843385909278,0.8221625434629661,14731,13684,15778,18940,4209,3162,5256,3396,-0.09835527238207081,0.48593190564104843,1.172037306918298,0.8065978507102266,2012602,2012602,Bexar+Wilson,Bexar,48,29,Texas,TX
48493,48CS011,367,345,389,382,15,-7,37,37,-0.8661178816107616,-0.4370854327996904,0.031656876331917744,2.3245705625827315,452,426,479,641,189,162,215,115,1.1370282929325994,1.7191863893759087,2.3448239946452127,0.6065875784323795,51397,51397,Bexar+Wilson,Wilson,48,493,Texas,TX
48035,48CS012,212,204,220,274,62,54,70,20,1.8256075906324676,2.2660442059562262,2.675828582161416,0.31692439569547215,257,247,266,305,48,39,58,36,0.17591167229973917,0.7884621863576781,1.380969202886637,0.7320332604037741,18598,18598,Bosque+Hamilton+Hill,Bosque,48,35,Texas,TX
48193,48CS012,119,118,120,105,-14,-15,-13,16,-3.5909492648088386,-3.4882504321904007,-3.38258436954308,-1.2641188932361402,145,144,146,157,12,11,13,6,0.7132582482399823,0.8581203174946082,1.0256954538516148,0.45971035949929717,8503,8503,Bosque+Hamilton+Hill,Hamilton,48,193,Texas,TX
48217,48CS012,390,374,406,451,61,45,77,40,0.13955268866872186,0.570938793345472,1.006000598273304,0.6414026384914743,473,454,492,673,200,181,219,139,1.3811303658994711,1.9790762165691738,2.612731800140406,0.6919605209729524,36732,36732,Bosque+Hamilton+Hill,Hill,48,217,Texas,TX
48037,48CS013,897,857,938,1063,166,125,206,126,0.013198237644895973,0.437235568887518,0.8520177461144685,0.7559292135178689,1099,1051,1148,1379,280,231,328,228,0.030738649081963217,0.6604669819692619,1.3045282100038678,0.8125820843515683,93495,93495,Bowie,Bowie,48,37,Texas,TX
48039,48CS014,2108,1944,2271,2443,335,172,499,239,-0.18945840723665042,0.256780392161592,0.6912070462639737,0.7104829586817548,2614,2417,2811,3457,843,646,1040,605,0.07393451653989035,0.7446552139849423,1.3547772061555585,0.7168151200489714,377124,377124,Brazoria,Brazoria,48,39,Texas,TX
48041,48CS015,922,822,1021,1141,219,120,319,146,-0.11161915935733606,0.2956640689116893,0.7361557265271618,0.6622405401947608,1150,1030,1270,1414,264,144,384,216,-0.3684396055435135,0.25409052385263015,0.8602537693496666,0.8145017616309034,230725,230725,Brazos+Burleson+Grimes+Robertson,Brazos,48,41,Texas,TX
48051,48CS015,201,193,209,211,10,2,18,20,-0.9470269834605906,-0.5479158357903787,-0.12178876230645183,1.8113689503201178,245,235,254,297,52,43,62,41,0.10285499522612741,0.7245163867030727,1.3019656508864605,0.7684266360303845,18462,18462,Brazos+Burleson+Grimes+Robertson,Burleson,48,51,Texas,TX
48185,48CS015,253,240,265,314,61,49,74,47,0.02663381657763411,0.4764515579568393,0.9435082490307743,0.7551182144337338,309,294,325,395,86,70,101,64,0.2646361311336006,0.9054013497728606,1.5104747004435648,0.7384530101508172,29221,29221,Brazos+Burleson+Grimes+Robertson,Grimes,48,185,Texas,TX
48395,48CS015,165,157,172,202,37,30,45,23,0.40707099442050354,0.8267984117835386,1.2494833076749372,0.6024771173703978,201,192,210,267,66,57,75,48,0.6489222435038454,1.2614757845196913,1.8876987072950477,0.7162605322810536,17125,17125,Brazos+Burleson+Grimes+Robertson,Robertson,48,395,Texas,TX
48049,48CS016,428,411,444,584,156,140,173,73,1.8004258801906408,2.203858126728697,2.6399180869330006,0.463912573057382,524,504,543,647,123,104,143,107,-0.04100972015164844,0.4993476221370925,1.1222882785528503,0.8600751524063275,37713,37713,Brown+Coleman+Mills,Brown,48,49,Texas,TX
48083,48CS016,133,130,137,124,-9,-13,-6,16,-3.5349596460364046,-3.0844451543684546,-2.666120960091875,-1.9767044074304285,162,158,166,214,52,48,56,42,0.8735266448944332,1.4888654236128138,2.0848869903068454,0.7916856369955414,8115,8115,Brown+Coleman+Mills,Coleman,48,83,Texas,TX
48333,48CS016,62,61,62,74,12,12,13,14,-0.44760888897244994,-0.3344248608347645,-0.23417241002070707,1.0479423097307003,76,75,77,92,16,15,17,14,0.35845165030971016,0.5018946301002526,0.6533145903902674,0.822576096753513,4859,4859,Brown+Coleman+Mills,Mills,48,333,Texas,TX
48053,48CS017,473,452,495,498,25,3,46,30,-0.5839581399024206,-0.10791976739188919,0.3347964827667854,1.1718844469378555,583,557,608,691,108,83,134,114,-0.7558497249005801,-0.15637539471902145,0.42042747684789733,1.0443062429357164,48852,48852,Burnet+Lampasas+Llano,Burnet,48,53,Texas,TX
48281,48CS017,196,187,206,252,56,46,65,13,1.555080768211619,1.9541206890568854,2.446006950349912,0.22998834705699844,242,231,253,331,89,78,100,54,1.3242185493819558,1.9230141191171282,2.531699724501661,0.5999310336733145,21579,21579,Burnet+Lampasas+Llano,Lampasas,48,281,Texas,TX
48299,48CS017,290,281,300,302,12,2,21,17,-0.6469743203577853,-0.24627590276905428,0.20146282178326863,1.315007358625207,354,343,366,412,58,46,69,67,-1.1137676812180026,-0.49722172660941766,0.06537217348666172,1.139790817413465,21872,21872,Burnet+Lampasas+Llano,Llano,48,299,Texas,TX
48059,48CS018,149,143,155,196,47,41,53,26,1.0896403866602138,1.4841640206311462,1.9233228622908953,0.5423682438668294,181,174,188,231,50,43,57,36,0.6058273307489906,1.1995520128948227,1.836764152774201,0.7042611551267762,14011,14011,Callahan and Nearby Counties,Callahan,48,59,Texas,TX
48133,48CS018,216,208,224,230,14,6,22,18,-0.6702188308720496,-0.19974249643254877,0.2321780254083442,1.1883818867862115,262,252,271,383,121,112,131,70,2.7754625104205526,3.384094724368161,3.9918336037484026,0.5716520120650959,18317,18317,Callahan and Nearby Counties,Eastland,48,133,Texas,TX
48253,48CS018,154,146,163,221,67,58,75,39,0.9689448762614097,1.3985972662801474,1.8172171607722585,0.5760731908253723,188,177,198,261,73,63,84,62,0.037036756649456624,0.6760914375491923,1.3186099550969048,0.834882542192195,19870,19870,Callahan and Nearby Counties,Jones,48,253,Texas,TX
48417,48CS018,25,25,26,38,13,12,13,8,1.2714322970197265,1.3751000742375161,1.477602637114585,0.591411045957597,31,31,32,42,11,10,11,6,1.5968319432431866,1.7632328934868586,1.9176158206965928,0.5075522733672674,3284,3284,Callahan and Nearby Counties,Shackelford,48,417,Texas,TX
48429,48CS018,93,92,94,123,30,29,31,17,1.255397319926555,1.362744883008146,1.4710825963684502,0.5523159805027654,114,113,115,144,30,29,31,24,0.6172495997706261,0.7731319313194068,0.932280359164452,0.7727463677787493,9352,9352,Callahan and Nearby Counties,Stephens,48,429,Texas,TX
48061,48CS019,2355,2173,2538,3734,1379,1196,1561,1075,0.3144168131713309,0.7207109782168294,1.1480531379044465,0.7791013376523712,2920,2701,3139,3805,885,666,1104,740,-0.2325588380272508,0.4098514127224973,0.9911105150149345,0.8355357288788609,423287,423287,Cameron,Cameron,48,61,Texas,TX
48067,48CS020,346,333,359,455,109,96,122,60,1.195580274312373,1.633656265691824,2.0414408490582763,0.5452367780875687,421,406,437,586,165,149,180,111,1.5114532714674787,2.182956176828747,2.7695404535408885,0.6689739193382345,29951,29951,Cass+Marion+Morris,Cass,48,67,Texas,TX
48315,48CS020,147,143,151,163,16,12,20,21,-0.9219706066959108,-0.50455069033877,-0.053584454667960066,1.2326868699299163,179,173,184,212,33,28,39,40,-1.4472523240900026,-0.7983766940481969,-0.1531302968605513,1.1610681839608565,9895,9895,Cass+Marion+Morris,Marion,48,315,Texas,TX
48343,48CS020,160,154,165,168,8,3,14,15,-0.9780811815952887,-0.5621957391055501,-0.11430388642083304,1.6228314013636893,194,188,201,228,34,27,40,43,-1.5137785121730851,-0.8968545327354034,-0.2859781373074696,1.2389241861119706,12364,12364,Cass+Marion+Morris,Morris,48,343,Texas,TX
48071,48CS021,268,248,287,334,66,47,86,28,0.4180811847189166,0.8693533401866939,1.263511862302602,0.415999672316536,330,307,354,418,88,64,111,86,-0.5739427831760282,0.04509492767499312,0.6488265762093757,0.9708778643970999,44503,44503,Chambers+Liberty,Chambers,48,71,Texas,TX
48291,48CS021,752,713,792,768,16,-24,55,92,-1.2851279756708354,-0.8561538663625605,-0.38725988793777677,5.554764609235769,922,874,969,1153,231,184,279,240,-0.7558166887725415,-0.12871088669612238,0.5362036486761798,1.0331839450880953,89742,89742,Chambers+Liberty,Liberty,48,291,Texas,TX
48073,48CS022,482,460,505,601,119,96,141,97,-0.018557775322915138,0.39967611906542383,0.8385062364597263,0.8110334563363647,590,563,618,794,204,176,231,148,0.6352161030340708,1.249213237224891,1.8275261380404086,0.7232906274215032,52692,52692,Cherokee,Cherokee,48,73,Texas,TX
48077,48CS023,110,109,111,128,18,17,19,13,0.3483060145123763,0.4472012726481477,0.5595573090579594,0.6941584214458945,135,134,137,151,16,14,17,16,-0.21492555117269924,-0.05743392829890093,0.08582527213302764,0.9689948280342809,10500,10500,Clay+Cooke+Montague,Clay,48,77,Texas,TX
48097,48CS023,370,352,387,424,54,37,72,39,-0.053365977752601,0.385133463130946,0.7922832577418708,0.7033373375537234,455,434,476,520,65,44,86,85,-1.2423640290951887,-0.579911684282172,0.033577543000215045,1.285784249160388,41207,41207,Clay+Cooke+Montague,Cooke,48,97,Texas,TX
48337,48CS023,245,236,253,325,80,72,89,41,1.523411145212585,1.9762311584402603,2.380474211921184,0.5037506656527315,299,289,309,368,69,59,79,55,0.22733212417716997,0.8307718478851496,1.4298112653461519,0.7862464437774326,19896,19896,Clay+Cooke+Montague,Montague,48,337,Texas,TX
48085,48CS024,4199,3739,4659,4832,633,173,1093,443,-0.2844941382269914,0.1870342432938555,0.6382975931291182,0.6987946601014109,5292,4739,5846,6210,918,364,1471,819,-0.5394839194394648,0.10864718857485854,0.7315991480003092,0.8914973747319731,1050487,1050487,Collin,Collin,48,85,Texas,TX
48091,48CS025,1212,1141,1283,1357,145,74,216,137,-0.39308181434026723,0.05098156148866489,0.49442458215155755,0.9377333953488955,1497,1412,1582,1785,288,203,373,289,-0.6471394731880328,-0.012391556714482796,0.6160958964230038,0.9994055886889972,159925,159925,Comal,Comal,48,91,Texas,TX
48093,48CS026,159,153,165,194,35,29,41,36,-0.4889475751958161,-0.07427761781161137,0.34051566497581165,1.0021806634129637,193,186,200,220,27,20,34,32,-1.063899606128142,-0.44623125997720475,0.23127222440117828,1.14744192485496,13679,13679,Comanche+Erath+Somervell,Comanche,48,93,Texas,TX
48143,48CS026,290,272,309,315,25,6,43,37,-0.6901792394704228,-0.2776497514716487,0.12886073902053408,1.4497499117735964,356,333,378,462,106,84,129,79,0.15096454818001434,0.7540579208602654,1.3448609209491325,0.7354018374790997,42823,42823,Comanche+Erath+Somervell,Erath,48,143,Texas,TX
48425,48CS026,82,81,83,99,17,16,18,3,1.4697670197437684,1.5813724425344429,1.690588170677547,0.1627452739929363,100,99,101,123,23,22,24,17,0.6448807954396791,0.7959974119316537,0.9578143279992342,0.7063840551112548,9130,9130,Comanche+Erath+Somervell,Somervell,48,425,Texas,TX
48099,48CS027,432,399,465,534,102,69,135,40,0.40982427024741,0.8134365962397987,1.250285047469941,0.3878436337412063,535,496,575,704,169,129,208,130,0.030472090528825026,0.612293334782465,1.2250733244217766,0.7665080027216498,76624,76624,Coryell,Coryell,48,99,Texas,TX
48105,48CS028,34,32,35,56,22,21,24,10,3.0356224237094813,3.465317067652598,3.9138288293654133,0.43378685747162965,42,40,44,55,13,11,15,6,1.8855392276713006,2.530549053866805,3.094006383433255,0.41998025367197844,3487,3487,Crockett+Kinney+Terrell+Val Verde,Crockett,48,105,Texas,TX
48271,48CS028,36,34,37,45,9,8,11,4,1.0529641789944297,1.4814119808628508,1.9130751040345129,0.3810064899003595,44,42,45,53,9,8,11,2,1.814029742647291,2.420086162208342,3.0493506960652565,0.1918988610618461,3669,3669,Crockett+Kinney+Terrell+Val Verde,Kinney,48,271,Texas,TX
48443,48CS028,9,9,9,12,3,3,3,3,-0.4298778072391397,-0.32104389361712243,-0.22206421667995663,0.7969139745011985,11,11,11,20,9,9,9,4,7.508038171236678,7.660338215185555,7.823620763800782,0.4137923407798682,731,731,Crockett+Kinney+Terrell+Val Verde,Terrell,48,443,Texas,TX
48465,48CS028,337,316,358,498,161,140,182,162,-0.44806932437288505,-0.022225002752959813,0.4063647203363844,1.0015761854887726,418,392,443,499,81,56,107,99,-1.0435911197559946,-0.4241291258590109,0.17328433996756673,1.2030543811853127,49036,49036,Crockett+Kinney+Terrell+Val Verde,Val Verde,48,465,Texas,TX
48107,48CS029,59,59,60,83,24,23,24,23,0.0031530890054286037,0.10629290375887418,0.21477473615176002,0.9354819874603,73,72,74,99,26,25,27,20,1.1371640285791267,1.2997867130380116,1.451315313769884,0.7376049059358746,5645,5645,Crosby+Floyd+Hale+Swisher,Crosby,48,107,Texas,TX
48153,48CS029,53,52,53,93,40,40,41,27,2.1914543394390185,2.2993030980627256,2.4077488802169458,0.6557297409354247,65,64,66,93,28,27,29,15,2.5897358253878218,2.7555830673659183,2.914226289713795,0.5150878662014485,5720,5720,Crosby+Floyd+Hale+Swisher,Floyd,48,153,Texas,TX
48189,48CS029,267,253,281,392,125,111,139,129,-0.5981041159413126,-0.13768635778570365,0.29509031051580387,1.0265527972217259,330,313,347,394,64,47,81,76,-1.0700258559791591,-0.46474318069195236,0.15217909007850183,1.1747198060516773,32955,32955,Crosby+Floyd+Hale+Swisher,Hale,48,189,Texas,TX
48437,48CS029,73,72,74,99,26,25,27,12,1.8159010439434458,1.9286014791703288,2.0375284596234486,0.4408026643952919,89,88,90,96,7,6,8,13,-1.186465317932448,-1.0293356413890145,-0.8718923061362054,1.6946410105700471,7374,7374,Crosby+Floyd+Hale+Swisher,Swisher,48,437,Texas,TX
48113,48CS030,14040,12906,15174,17173,3133,1999,4267,2301,-0.10240018071834363,0.3203456634604797,0.721602483827052,0.7341526402842367,17421,16060,18783,20545,3124,1762,4485,3389,-0.7766617156702371,-0.1154350074281253,0.5190025909981987,1.0845062111395374,2635722,2635722,Dallas,Dallas,48,113,Texas,TX
48121,48CS031,3558,3163,3952,4109,551,157,946,405,-0.27377527448874195,0.17903362016768845,0.6006595126052017,0.7333766416793368,4483,4008,4958,5335,852,377,1327,693,-0.4332553707186062,0.22032806013574968,0.880006830737287,0.8124974421662411,901498,901498,Denton,Denton,48,121,Texas,TX
48127,48CS032,76,75,77,91,15,14,16,13,0.05737013374067984,0.165663347270456,0.26344817706129386,0.8307678223214185,94,92,95,154,60,59,62,35,2.8954245359456108,3.049352233539441,3.206129776322242,0.5693127991186341,10029,10029,Dimmit+La Salle+Maverick,Dimmit,48,127,Texas,TX
48283,48CS032,49,48,50,68,19,18,20,19,-0.08502397756554907,0.02649038546522992,0.12877539215853645,0.9420452372223815,60,59,61,84,24,23,25,25,-0.2975799586725515,-0.1436799186897575,0.026951200633639108,0.9954268465809385,7527,7527,Dimmit+La Salle+Maverick,La Salle,48,283,Texas,TX
48323,48CS032,346,340,352,611,265,259,271,216,0.7311208862823234,0.8417163215147764,0.9510432059017624,0.8121247488970438,425,417,432,612,187,180,195,201,-0.4324077919330033,-0.28639911407492097,-0.12356939982075837,1.0673935798603578,58366,58366,Dimmit+La Salle+Maverick,Maverick,48,323,Texas,TX
48047,48CS033,67,67,68,101,34,33,34,28,0.6949361176012866,0.8039695973589155,0.9039555000613844,0.8074917383092466,83,82,84,97,14,13,15,20,-1.12686573241206,-0.9583845040498726,-0.7945051490538991,1.2986747465717092,7039,7039,Duval and Nearby Counties,Brooks,48,47,Texas,TX
48131,48CS033,108,107,110,123,15,13,16,25,-1.040170820195436,-0.93193230549511,-0.8311439681468269,1.5980644222227494,133,131,134,172,39,38,41,31,0.7284109513416155,0.8759071757041075,1.030468883477701,0.7734104917463138,11105,11105,Duval and Nearby Counties,Duval,48,131,Texas,TX
48247,48CS033,42,42,43,54,12,11,12,12,-0.1374370130776092,-0.031938679851378854,0.07223414789733172,0.9360804708784908,52,51,53,69,17,16,18,4,2.8904739603199956,3.0555791349986245,3.2122677796009134,0.22011325359253953,5171,5171,Duval and Nearby Counties,Jim Hogg,48,247,Texas,TX
48249,48CS033,342,324,359,429,87,70,105,68,0.02746848944470193,0.48347038630933487,0.9146344187685378,0.7695749269906927,419,398,440,594,175,154,196,109,1.361372430812333,1.956750355376931,2.6108903193813835,0.6179988075636565,40523,40523,Duval and Nearby Counties,Jim Wells,48,249,Texas,TX
48505,48CS033,84,82,85,115,31,30,33,22,0.5392737962289019,0.6504369492129698,0.7589020016901132,0.6824959872501648,103,101,105,139,36,34,38,23,0.9230487038181965,1.0701677669264154,1.231693953548703,0.6270493898308006,14201,14201,Duval and Nearby Counties,Zapata,48,505,Texas,TX
48011,48CS034,24,24,24,34,10,10,10,7,1.3959250827131517,1.4991544603157947,1.6171514138116159,0.6486045660007396,29,29,30,31,2,1,2,4,-1.7200911345074439,-1.5545829673395362,-1.3981441008125688,1.543203298257077,1860,1860,Eastern Central Panhandle,Armstrong,48,11,Texas,TX
48023,48CS034,52,52,52,57,5,5,5,6,-0.41707134132378715,-0.3079098118669331,-0.1999965005870105,1.015067584718573,63,63,64,81,18,17,18,17,0.09672305343138675,0.23584917605640893,0.3993754935646225,0.9085286079400648,3522,3522,Eastern Central Panhandle,Baylor,48,23,Texas,TX
48045,48CS034,16,16,16,22,6,6,6,3,1.9411308071775752,2.040497586052157,2.1544933193702023,0.42228240691947316,19,19,20,16,-3,-4,-3,5,-6.718314527866241,-6.562006417606794,-6.395734629053792,-2.1694426604168244,1519,1519,Eastern Central Panhandle,Briscoe,48,45,Texas,TX
48075,48CS034,65,64,66,72,7,6,8,13,-0.9580870972232767,-0.84704482405293,-0.7461686752356235,1.6494593128084802,79,78,80,84,5,4,6,13,-1.4971980155409432,-1.3440848351460812,-1.1905227002768664,2.190427723066151,7189,7189,Eastern Central Panhandle,Childress,48,75,Texas,TX
48101,48CS034,21,21,22,27,6,5,6,6,-0.533411245826141,-0.13711196646527524,0.27627916358409543,0.8798702697508116,26,25,27,21,-5,-6,-4,8,-11.806184866117535,-11.201051377073318,-10.601228902274501,-2.0706045029197027,1376,1376,Eastern Central Panhandle,Cottle,48,101,Texas,TX
48125,48CS034,23,23,23,38,15,15,15,7,3.693697117673835,3.8013313566696967,3.911474061078504,0.43122805567538225,28,27,28,30,2,2,3,4,-1.0647913898800767,-0.9181790572780604,-0.752248407525061,1.194076363217121,2166,2166,Eastern Central Panhandle,Dickens,48,125,Texas,TX
48129,48CS034,41,40,41,47,6,6,7,5,0.2668684240734683,0.3609068438297031,0.46650233263542906,0.6947676011969796,50,49,50,64,14,14,15,12,0.7244606317879784,0.8880860171097581,1.0412954686277842,0.7775064598544876,3282,3282,Eastern Central Panhandle,Donley,48,129,Texas,TX
48155,48CS034,18,17,18,27,9,9,10,4,4.267235423328017,4.676173987370357,5.086862226779351,0.3861467848639647,22,21,22,25,3,3,4,3,-0.1345992195226177,0.46245921872236223,1.137262816840342,0.6722225247717323,1147,1147,Eastern Central Panhandle,Foard,48,155,Texas,TX
48191,48CS034,36,36,36,47,11,11,11,7,1.221874625557001,1.32688958636089,1.4300102257013725,0.5869271418871047,44,43,44,52,8,8,9,5,1.128609135967039,1.2873205325524122,1.4539568122418383,0.5446074479896563,2970,2970,Eastern Central Panhandle,Hall,48,191,Texas,TX
48197,48CS034,40,40,41,68,28,27,28,10,4.333483523405957,4.431762508806696,4.543812638429275,0.34996728397884347,49,49,50,45,-4,-5,-4,4,-2.606835855060241,-2.447591396839218,-2.30001652312012,-1.2929571780835463,3962,3962,Eastern Central Panhandle,Hardeman,48,197,Texas,TX
48207,48CS034,61,61,62,71,10,9,10,15,-1.0315092062013713,-0.9243942329129008,-0.8217248033023061,1.3996520667019021,74,74,75,111,37,36,37,20,3.3237371413670065,3.4838820727895934,3.6506010437357346,0.5323223035803389,5702,5702,Eastern Central Panhandle,Haskell,48,207,Texas,TX
48269,48CS034,4,4,4,4,-0,-0,-0,4,-16.39306037448563,-15.954185724559824,-15.510253778509165,6.35712110223203,5,5,6,8,3,2,3,8,-24.1033063133222,-23.5056792955274,-22.89760554411605,2.2038970618545295,274,274,Eastern Central Panhandle,King,48,269,Texas,TX
48275,48CS034,44,43,44,66,22,22,23,12,2.7176245504618963,2.825273596086015,2.932199980437639,0.513661969196215,53,53,53,71,18,18,18,10,2.4555132355366873,2.617051032258694,2.7695899452152477,0.5265015470080283,3671,3671,Eastern Central Panhandle,Knox,48,275,Texas,TX
48345,48CS034,18,18,19,18,-0,-1,0,5,-4.936791209800555,-4.5240596492391045,-4.110688396199783,8.464589325017664,22,22,23,31,9,8,9,2,5.881873477505664,6.55259176433288,7.131719660828176,0.21021579548799524,1194,1194,Eastern Central Panhandle,Motley,48,345,Texas,TX
48433,48CS034,21,20,21,25,4,4,5,6,-1.8198384494616406,-1.4118091712851228,-0.9970948667816155,1.1772582795110451,26,25,26,24,-2,-2,-1,6,-7.4229866847362445,-6.77768334896477,-6.154662361510107,-10.36316834788099,1341,1341,Eastern Central Panhandle,Stonewall,48,433,Texas,TX
48447,48CS034,18,18,19,15,-3,-4,-3,6,-6.494416868065321,-6.386927870077287,-6.279162008121302,-2.4541619619469666,22,22,23,23,1,0,1,8,-6.1659864018636394,-6.003432969510493,-5.852444033892266,5.018894408697731,1479,1479,Eastern Central Panhandle,Throckmorton,48,447,Texas,TX
48487,48CS034,148,143,154,182,34,28,39,38,-0.7593325006647922,-0.32970094083947943,0.09013744987186195,1.0891554593505215,182,176,188,198,16,10,22,37,-2.6086302079339854,-1.9991764650963777,-1.3668560043591294,2.1755705550440254,12635,12635,Eastern Central Panhandle,Wilbarger,48,487,Texas,TX
48135,48CS035,1087,1015,1159,1393,306,234,378,268,-0.20926556214029832,0.23135790370948742,0.6339973005037821,0.8722640836582335,1342,1255,1429,1614,272,185,359,317,-0.9178884418310729,-0.3590512074487857,0.25091197478953964,1.1615307605357923,166828,166828,Ector,Ector,48,135,Texas,TX
48139,48CS036,1190,1108,1272,1420,230,148,312,184,-0.1928034588795323,0.2433559791594119,0.6671585142598067,0.7967989082840807,1472,1373,1571,1820,348,249,447,283,-0.24680041827848154,0.4083570693018194,1.0566050318177769,0.8108888712527573,187680,187680,Ellis,Ellis,48,139,Texas,TX
48141,48CS037,4709,4348,5071,7370,2661,2299,3022,2091,0.2550323501861258,0.6832359348362396,1.1267240917429542,0.7856071329613091,5849,5414,6283,7290,1441,1007,1876,1193,-0.3411183497779588,0.3744004155804283,0.9754385410293551,0.8271931237200022,839078,839078,El Paso,El Paso,48,141,Texas,TX
48145,48CS038,160,152,167,168,8,1,16,22,-1.1982443657827562,-0.7858718829073263,-0.31088627966394944,2.3401324604231966,195,186,204,245,50,41,59,38,0.23002986902933487,0.8469070013063074,1.4525027099510541,0.7402396525957741,17279,17279,Falls+Lee+Milam,Falls,48,145,Texas,TX
48287,48CS038,162,154,169,196,34,27,42,29,-0.15960994917469137,0.3150976679300227,0.7545565411335335,0.8202449125162723,197,188,206,209,12,3,21,27,-1.6812615443084369,-1.0647494704992784,-0.45705002529212935,2.1170485375522268,17338,17338,Falls+Lee+Milam,Lee,48,287,Texas,TX
48331,48CS038,248,237,259,256,8,-3,19,19,-0.8637235477973237,-0.45366807097395095,-0.024532513966427062,2.140463971070078,302,289,315,414,112,99,125,74,1.1985863912405648,1.821885704506759,2.4683034201875187,0.6562893539534808,24716,24716,Falls+Lee+Milam,Milam,48,331,Texas,TX
48147,48CS039,396,380,411,427,31,16,47,65,-1.3924119090717244,-0.9540852262641046,-0.49462802593521027,2.018590120068275,484,466,503,597,113,94,131,103,-0.28446970332898863,0.31931780162711937,0.948650118275028,0.90728458874309,35704,35704,Fannin+Lamar+Red River,Fannin,48,147,Texas,TX
48277,48CS039,533,512,555,675,142,120,163,97,0.43426876233894046,0.9149927935665232,1.3076644808315037,0.6806857344915364,653,627,679,823,170,144,196,126,0.44844494218593206,1.060902874861743,1.6538770756327676,0.7368083232279781,49833,49833,Fannin+Lamar+Red River,Lamar,48,277,Texas,TX
48387,48CS039,162,156,167,213,51,46,57,28,1.4893227711460737,1.9306061248768538,2.3805401461858318,0.5341125091372253,197,191,203,230,33,27,39,29,-0.24053766690033634,0.4046773328970711,1.058975627251595,0.8479059961194068,12053,12053,Fannin+Lamar+Red River,Red River,48,387,Texas,TX
48157,48CS040,3140,2780,3500,3864,724,364,1084,429,-0.053996242650819176,0.35926320604199213,0.7987717332878421,0.5918332872664513,3963,3529,4397,4852,889,455,1323,640,-0.2511962302427361,0.37683649706394007,0.9465057611495741,0.7192466540977343,823974,823974,Fort Bend,Fort Bend,48,157,Texas,TX
48161,48CS041,190,182,199,245,55,46,63,31,0.779807617572379,1.1706797920050505,1.6699543287161984,0.5578261248815278,234,223,244,255,21,11,32,46,-2.0609536894804372,-1.4847553977964458,-0.8808209401127894,2.0536144779016223,19803,19803,Freestone+Leon+Limestone+Navarro,Freestone,48,161,Texas,TX
48289,48CS041,188,181,196,217,29,21,36,22,-0.07098041421245989,0.36826635986936007,0.8183349766858508,0.7435024436787062,231,222,240,274,43,34,52,38,-0.24585843793762047,0.37288401855153863,0.9908016857401014,0.8548051317718909,17451,17451,Freestone+Leon+Limestone+Navarro,Leon,48,289,Texas,TX
48293,48CS041,237,227,248,297,60,49,70,28,0.8916697336399546,1.3483701116075182,1.8167002511427515,0.4626403054773918,291,279,303,399,108,96,120,78,0.9542100908393351,1.5380631971018501,2.1378766116810546,0.7140121319969442,23369,23369,Freestone+Leon+Limestone+Navarro,Limestone,48,293,Texas,TX
48349,48CS041,493,471,514,527,34,13,56,74,-1.2231418462971402,-0.7955156744198044,-0.356222536492269,2.0935537233871124,605,578,631,685,80,54,107,136,-1.9529150272774618,-1.3158447491524343,-0.7217785289189179,1.670193737281554,50276,50276,Freestone+Leon+Limestone+Navarro,Navarro,48,349,Texas,TX
48163,48CS042,142,133,150,157,15,7,24,21,-0.702100189623155,-0.2645002388589568,0.13475322526197722,1.2794333688709962,175,165,186,223,48,37,58,57,-1.1311336116192185,-0.5391665627700134,0.07684248417721593,1.1654741497192334,20274,20274,Frio+Medina+Uvalde+Zavala,Frio,48,163,Texas,TX
48325,48CS042,394,371,416,447,53,31,76,57,-0.5204054032782062,-0.08543764622118023,0.30191052315940486,1.0542518088618442,486,459,513,587,101,74,128,120,-1.0679032620559157,-0.4319504550484332,0.19933183816975622,1.179961623721753,51920,51920,Frio+Medina+Uvalde+Zavala,Medina,48,325,Texas,TX
48463,48CS042,218,206,229,281,63,52,75,40,0.4349361834192446,0.8563460334008245,1.283448699979464,0.6213606425040604,268,254,282,350,82,68,96,72,-0.14957630025156118,0.46747135611583235,1.0639618238139583,0.8648264724397263,26772,26772,Frio+Medina+Uvalde+Zavala,Uvalde,48,463,Texas,TX
48507,48CS042,93,92,95,140,47,45,48,27,1.5642585438457686,1.6707807854817922,1.769920046185827,0.5661471005808799,115,113,116,149,34,33,36,26,0.690628813246697,0.8328602960566827,1.0005049039183704,0.7381075545019034,11821,11821,Frio+Medina+Uvalde+Zavala,Zavala,48,507,Texas,TX
48003,48CS043,119,117,121,128,9,7,11,32,-1.2999783082048757,-1.1962353425654588,-1.0899550459871985,3.074965565944116,146,144,149,158,12,9,14,35,-1.61768735388682,-1.4678636158702072,-1.2998416311184917,2.7067875795006597,18845,18845,Gaines and Nearby Counties,Andrews,48,3,Texas,TX
48115,48CS043,129,123,134,169,40,35,46,52,-1.3246854471197556,-0.9051390963062355,-0.48866987819437124,1.258787040412353,158,151,164,166,8,2,15,31,-2.700594772862091,-2.0945089560133385,-1.4577872539102084,3.300743926304066,12980,12980,Gaines and Nearby Counties,Dawson,48,115,Texas,TX
48165,48CS043,112,110,114,147,35,33,37,33,-0.006917887416121477,0.08589616410878648,0.19056912798864667,0.9177992983092326,138,136,141,176,38,35,40,40,-0.2815313265441916,-0.1289213622845552,0.01683121420721664,1.0358073957010934,21730,21730,Gaines and Nearby Counties,Gaines,48,165,Texas,TX
48305,48CS043,53,52,53,82,29,29,30,16,2.1545245716161157,2.246585103428408,2.3488440446058827,0.5253464622122926,64,64,65,85,21,20,21,14,1.1484858343098925,1.3035351181157189,1.4498610477666407,0.6508260957715842,5985,5985,Gaines and Nearby Counties,Lynn,48,305,Texas,TX
48317,48CS043,44,43,45,56,12,11,13,17,-0.9766282846183363,-0.8695931200640059,-0.7657020654867106,1.3082378582011827,54,53,55,52,-2,-3,-1,2,-1.0009839301296093,-0.8497925667932551,-0.6918652593580605,-1.8469017778743921,5773,5773,Gaines and Nearby Counties,Martin,48,317,Texas,TX
48445,48CS043,127,122,132,155,28,23,33,44,-1.7311729423757276,-1.306306261189387,-0.8749793951505211,1.520123977674795,155,149,162,148,-7,-14,-1,26,-3.849030442071276,-3.2735160160072923,-2.66921618946297,-4.139948775162591,12283,12283,Gaines and Nearby Counties,Terry,48,445,Texas,TX
48501,48CS043,55,54,56,81,26,25,27,22,0.3542879935995706,0.45739576979236646,0.5600739406802072,0.8166976300643193,68,67,69,78,10,9,11,13,-0.5481023487593288,-0.3923307541497288,-0.24111597736840498,1.1621422361736304,8693,8693,Gaines and Nearby Counties,Yoakum,48,501,Texas,TX
48167,48CS044,2460,2312,2608,2863,403,255,551,220,0.11473331546297189,0.5318276145614856,0.948673672000264,0.5446205178618765,3029,2851,3207,3687,658,480,836,474,0.025530566012550028,0.6561655898785747,1.2888747765140394,0.7191371074050913,343019,343019,Galveston,Galveston,48,167,Texas,TX
48181,48CS045,1305,1246,1365,1533,228,168,287,192,-0.14868044079729897,0.2612967801955044,0.7080393159287797,0.8401638771867556,1598,1527,1670,1971,373,301,444,339,-0.3240767112417616,0.2862578456989794,0.9055939281662619,0.9069293627319314,137049,137049,Grayson,Grayson,48,181,Texas,TX
48183,48CS046,1128,1075,1181,1404,276,223,329,175,0.4162561712895345,0.8111614855089356,1.2335877592302424,0.6317820730084798,1385,1320,1449,1827,442,378,507,325,0.510825065473539,1.131011699193502,1.7773392093449045,0.7330588996538281,124153,124153,Gregg,Gregg,48,183,Texas,TX
48187,48CS047,1023,950,1096,1169,146,73,219,119,-0.26121177391393824,0.1511284331970253,0.5859980740195038,0.8087457594121602,1268,1180,1356,1617,349,261,437,249,0.08283889352662151,0.7239996251749861,1.3215003842599633,0.7108857666649943,168486,168486,Guadalupe,Guadalupe,48,187,Texas,TX
48199,48CS048,519,494,544,574,55,30,80,54,-0.44422036054369224,0.01865018507337235,0.4383563252126244,0.9674947748510025,638,608,668,806,168,138,198,162,-0.5078445206704559,0.10844913047979939,0.7947259057031517,0.9600834701605487,58008,58008,Hardin,Hardin,48,199,Texas,TX
48201,48CS049,23018,20980,25055,28388,5370,3333,7408,3653,-0.05061557385568492,0.36003107007503715,0.7776380828897057,0.6800827990861511,28660,26213,31108,36171,7511,5063,9958,6096,-0.24703387307462787,0.3493993079929286,0.9711216269874101,0.8115409367958462,4721330,4721330,Harris,Harris,48,201,Texas,TX
48203,48CS050,567,538,595,669,102,74,131,84,-0.1814486417209323,0.26250474379049993,0.7086503841200631,0.8119387796098138,693,658,727,945,252,218,287,159,1.0456857576684915,1.7052231886153355,2.2894067076503264,0.6274997965675324,66443,66443,Harrison+Upshur,Harrison,48,203,Texas,TX
48459,48CS050,412,394,430,474,62,44,80,49,-0.0826122882424889,0.312664026386182,0.7299219776087127,0.7809790119120381,503,482,525,659,156,134,177,137,-0.10082369506519977,0.5470614355749858,1.1882093114114938,0.8744569359771087,41897,41897,Harrison+Upshur,Upshur,48,459,Texas,TX
48209,48CS051,1076,973,1180,1140,64,-40,167,102,-0.6256187064304108,-0.1614502922179465,0.24533073056074117,1.5805090174748913,1347,1223,1472,1649,302,177,426,238,-0.32043379570704056,0.33768809736003624,1.0065995362002218,0.7859617291417936,234969,234969,Hays,Hays,48,209,Texas,TX
48213,48CS052,966,930,1002,1130,164,128,200,99,0.33943514685825027,0.7986407153419016,1.2260826744313835,0.5990121920746287,1179,1136,1222,1566,387,344,430,288,0.8155025376339968,1.4186393576957594,2.0463361990461397,0.742179641471098,83226,83226,Henderson,Henderson,48,213,Texas,TX
48215,48CS053,3911,3535,4288,6443,2532,2155,2908,2013,0.16280304483812352,0.609452706169727,1.0508340297465248,0.7948515027326205,4895,4443,5347,6403,1508,1056,1960,1202,-0.16561173384934194,0.4147471966582466,1.0530771918226696,0.7967042081240849,870546,870546,Hidalgo,Hidalgo,48,215,Texas,TX
48221,48CS054,662,635,690,767,105,77,132,74,0.04982062281672203,0.4936715509054957,0.9161660074568777,0.7013690309106481,809,776,842,991,182,149,215,128,0.4216314851197345,1.0239599747766719,1.6273232764127474,0.7001418679335449,62497,62497,Hood,Hood,48,221,Texas,TX
48063,48CS055,142,136,148,173,31,25,37,23,0.1961725044124462,0.6156302258035865,1.0584094611504395,0.717808615991947,174,167,181,232,58,51,65,41,0.9667266039867254,1.5767373360516002,2.2497935727761402,0.6938893838333751,13070,13070,Hopkins and Nearby Counties,Camp,48,63,Texas,TX
48119,48CS055,60,60,61,79,19,18,19,1,3.255615658887604,3.3547956839139053,3.4718133034889513,0.050184935307064464,74,73,74,91,17,17,18,17,-0.056462259916924044,0.1075257438630414,0.26112406904316865,0.9202217262374067,5336,5336,Hopkins and Nearby Counties,Delta,48,119,Texas,TX
48159,48CS055,104,103,105,137,33,32,34,14,1.6829600342655981,1.7974077943000937,1.897640752132406,0.4079806384837223,127,126,128,128,1,-0,2,23,-2.623780742112896,-2.457837817768504,-2.292373329791213,11.719759093596219,10779,10779,Hopkins and Nearby Counties,Franklin,48,159,Texas,TX
48223,48CS055,359,343,375,448,89,73,105,87,-0.3892994071769551,0.038509499023370204,0.4752819937854463,0.9682009057445439,441,422,460,523,82,63,101,67,-0.1681715533167722,0.48341056887012035,1.065827267493026,0.8099111726534116,37108,37108,Hopkins and Nearby Counties,Hopkins,48,223,Texas,TX
48449,48CS055,261,247,276,288,27,12,41,57,-1.3733823273413694,-0.9326244169987475,-0.5363047162782206,2.066283537096814,323,306,340,357,34,17,51,60,-1.6324148372300664,-0.9349145418219602,-0.3668963323062723,1.7083958274282267,32820,32820,Hopkins and Nearby Counties,Titus,48,449,Texas,TX
48499,48CS055,562,543,582,644,82,62,101,77,-0.2896663520830251,0.10129458550772451,0.563979383440653,0.9324698106776319,688,665,712,912,224,200,247,155,1.147163682689302,1.7923819838304875,2.4284805865532895,0.6902357181312385,45900,45900,Hopkins and Nearby Counties,Wood,48,499,Texas,TX
48231,48CS056,856,813,899,981,125,82,168,97,-0.14132096095496147,0.29998759639823985,0.708851381279532,0.7684980342672362,1047,996,1099,1303,256,204,307,244,-0.5131560216785066,0.13236627442101373,0.8112482514083297,0.9511305684592224,99079,99079,Hunt,Hunt,48,231,Texas,TX
48237,48CS057,84,83,85,97,13,12,14,12,-0.022784801071194356,0.08075801152616553,0.17702040023937765,0.8745772233488083,103,102,104,108,5,4,6,10,-0.8657641224246054,-0.7050372738588556,-0.546317302349449,1.7479775721386943,8991,8991,Jack+Palo Pinto+Young,Jack,48,237,Texas,TX
48363,48CS057,290,278,303,389,99,86,111,49,1.2962862900960488,1.7067207064308214,2.1265524948526924,0.4905497670142741,354,338,369,457,103,88,119,83,0.24761308084462372,0.8282841435214578,1.432610361558769,0.794554286381734,29200,29200,Jack+Palo Pinto+Young,Palo Pinto,48,363,Texas,TX
48503,48CS057,212,205,220,272,60,52,67,30,1.2465837780939912,1.661703174358283,2.093874852770799,0.4936984366966296,258,249,267,323,65,56,74,39,1.117234143038156,1.7484271976062533,2.365241888654215,0.5892472286585863,17923,17923,Jack+Palo Pinto+Young,Young,48,503,Texas,TX
48239,48CS058,146,139,152,158,12,6,19,23,-1.1624042560718066,-0.7130272598831436,-0.28420078132933246,1.7138146355666268,178,170,186,170,-8,-16,-0,28,-3.514766061290323,-2.9359154131953247,-2.2782765564979073,-4.007729844237147,14799,14799,Jackson+Matagorda+Wharton,Jackson,48,239,Texas,TX
48321,48CS058,344,328,360,408,64,48,80,67,-0.5174168078859605,-0.08543511262604789,0.3075086588261918,1.0302513536270184,421,402,440,467,46,27,65,95,-2.2281017376261025,-1.5871891328044183,-0.9988441620333541,2.00978282031568,36684,36684,Jackson+Matagorda+Wharton,Matagorda,48,321,Texas,TX
48481,48CS058,368,350,386,465,97,79,115,77,0.010314461863497779,0.47709420225617094,0.9441213820437068,0.7852105840722762,451,429,472,568,117,96,139,116,-0.5789274195909379,0.06354801163286922,0.6838347154989609,0.9789679958213982,41677,41677,Jackson+Matagorda+Wharton,Wharton,48,481,Texas,TX
48241,48CS059,370,355,386,447,77,61,92,53,0.26437661223483055,0.6601328931122272,1.1092450712345434,0.6820465232529789,452,434,470,604,152,134,170,122,0.3800550966121691,1.0098492642393277,1.605700706001767,0.7970032098658683,35512,35512,Jasper+Newton,Jasper,48,241,Texas,TX
48351,48CS059,139,133,145,174,35,29,41,19,0.754384413566586,1.1768555540131294,1.6028365775964903,0.5288351820365441,170,163,177,231,61,54,68,45,0.856274141061268,1.451873933289529,2.0603911360322034,0.7209245324175595,13565,13565,Jasper+Newton,Newton,48,351,Texas,TX
48245,48CS060,2089,1982,2197,2570,481,373,588,271,0.41329048303485655,0.8367144102054477,1.2476702883238884,0.5627493445036746,2560,2430,2689,3168,608,479,738,474,-0.01542306846991401,0.630972715164465,1.3066811127497342,0.777835018625557,250820,250820,Jefferson,Jefferson,48,245,Texas,TX
48251,48CS061,1311,1234,1388,1556,245,168,322,175,-0.03374236524243153,0.39522410196131363,0.8008476851090894,0.7120809061818529,1617,1524,1710,2034,417,324,510,388,-0.4466331784257391,0.20979686198693553,0.8021620502469589,0.9279272086043621,177488,177488,Johnson,Johnson,48,251,Texas,TX
48257,48CS062,967,906,1028,1078,111,50,172,132,-0.6051838421338432,-0.1547290426886449,0.30626464927784314,1.1782065299885431,1198,1124,1272,1466,268,194,342,261,-0.604348109676858,0.06489995639436444,0.7198180868639218,0.9695008409657757,139267,139267,Kaufman,Kaufman,48,257,Texas,TX
48261,48CS063,4,4,4,5,1,1,1,5,-10.012156011892847,-9.600734245811445,-9.160180434219816,2.142347442974725,5,4,5,5,0,0,1,5,-14.75172392847752,-14.146401477290864,-13.517535119829015,3.3437815384468865,382,382,Kenedy+Kleberg+Willacy,Kenedy,48,261,Texas,TX
48273,48CS063,239,226,253,295,56,42,69,62,-0.646482638364118,-0.229835069875456,0.24442711571426382,1.0964525009768558,296,280,312,333,37,21,53,69,-1.8853536018763724,-1.2593104190921767,-0.6160397598052884,1.8215370483981863,30434,30434,Kenedy+Kleberg+Willacy,Kleberg,48,273,Texas,TX
48489,48CS063,156,147,165,222,66,57,75,64,-0.31495907296962644,0.1255624737532887,0.49064714809515614,0.951666939946848,193,182,204,228,35,24,46,46,-1.2117036158004237,-0.6140270899813325,0.024529752654581474,1.278587416380501,21230,21230,Kenedy+Kleberg+Willacy,Willacy,48,489,Texas,TX
48089,48CS064,221,212,231,260,39,29,48,16,0.6110286540172154,1.0454593788278521,1.4986879991375037,0.40308597321199524,270,259,281,343,73,62,84,41,1.1639789806552598,1.8009706243867576,2.3802866207515403,0.5526075498774744,21527,21527,Lavaca and Nearby Counties,Colorado,48,89,Texas,TX
48123,48CS064,223,214,232,259,36,27,45,50,-1.1155034833632291,-0.6975306942072437,-0.24941747968898834,1.3520945278073762,272,261,282,289,17,7,28,38,-1.845301731520269,-1.2117004402051925,-0.6231461703195854,2.0562298673459005,20134,20134,Lavaca and Nearby Counties,DeWitt,48,123,Texas,TX
48149,48CS064,270,259,281,323,53,42,64,39,0.13017038701165823,0.5567030452091379,0.990590455127949,0.7201133124938104,329,316,342,391,62,49,75,52,-0.11355065782860482,0.4912053503785682,1.1272840565285571,0.8241190515204063,25408,25408,Lavaca and Nearby Counties,Fayette,48,149,Texas,TX
48177,48CS064,180,171,189,222,42,33,51,24,0.4066124647257787,0.8527761610560554,1.2685026682604024,0.5601745993165222,220,209,231,272,52,41,63,63,-1.295974975032727,-0.6661401211722913,-0.03281866039222201,1.1930569453403346,20919,20919,Lavaca and Nearby Counties,Gonzales,48,177,Texas,TX
48285,48CS064,220,211,228,274,54,46,63,48,-0.128001016184762,0.32717032419452485,0.7625700769845589,0.8657473869528013,267,257,278,296,29,18,39,38,-1.1608485109548976,-0.5727054627080871,0.08039391154423028,1.282037501512267,20181,20181,Lavaca and Nearby Counties,Lavaca,48,285,Texas,TX
48303,48CS065,2239,2103,2374,3014,775,640,911,616,0.057563754751510016,0.5105477448128759,0.9228105919607795,0.7934354853048013,2762,2599,2924,3346,584,422,747,519,-0.4130966363960954,0.24862426115010988,0.8881893092116384,0.8870362040455494,312622,312622,Lubbock,Lubbock,48,303,Texas,TX
48309,48CS066,1911,1800,2023,2338,427,315,538,304,0.04442200099743623,0.47720003402694544,0.9108419687857267,0.7106101089014397,2355,2220,2489,2941,586,452,721,462,-0.0359987978120899,0.6001126356275902,1.2280260171022002,0.7864916208568149,258184,258184,McLennan,McLennan,48,309,Texas,TX
48313,48CS067,122,120,123,140,18,17,20,21,-0.28795593337203385,-0.18888325167689118,-0.089169001587919,1.089707124895671,150,148,152,177,27,25,29,30,-0.3841314267787185,-0.21764211156924862,-0.05947526570949516,1.05862078752954,14401,14401,Madison+Trinity+Walker,Madison,48,313,Texas,TX
48455,48CS067,209,203,216,216,7,0,13,12,-0.8050987654877987,-0.37615186730205613,0.059143302119787175,1.5947882630570567,255,247,263,326,71,63,79,48,1.2279707679247271,1.8646573814410174,2.4395622171505704,0.668125908847301,14762,14762,Madison+Trinity+Walker,Trinity,48,455,Texas,TX
48471,48CS067,463,432,495,579,116,84,147,93,-0.10742920871736868,0.3157345735882881,0.7467328865729702,0.7981074378535433,573,536,611,711,138,100,175,105,-0.08482161379778544,0.567965624376026,1.1667256873060743,0.7575445209017171,71893,71893,Madison+Trinity+Walker,Walker,48,471,Texas,TX
48031,48CS068,115,114,117,111,-4,-6,-3,7,-1.0418764257663569,-0.9287891591901047,-0.8240281428250894,-2.158124836736353,142,140,144,157,15,13,17,22,-0.8481182624855284,-0.6882726262507851,-0.541637886335532,1.369666488721401,12095,12095,Menard and Nearby Counties,Blanco,48,31,Texas,TX
48081,48CS068,45,44,47,55,10,8,11,10,-0.5119987511369839,-0.11146756119062828,0.33520711709278345,0.9367852309028407,55,54,57,69,14,12,15,7,1.8025750499237965,2.4391723272463754,3.0229448856616616,0.47350531648895894,3319,3319,Menard and Nearby Counties,Coke,48,81,Texas,TX
48095,48CS068,25,25,25,28,3,3,3,4,-0.4183036206089282,-0.309432572057671,-0.20237047067557493,0.9670406285186209,31,30,31,34,3,3,4,7,-1.737345351409128,-1.575500826662558,-1.4195967291655418,1.6084513181691997,2782,2782,Menard and Nearby Counties,Concho,48,95,Texas,TX
48137,48CS068,23,22,23,28,5,5,6,8,-1.4693036869289338,-1.361998095153903,-1.2556138400424701,1.2528422383994589,28,28,28,31,3,3,3,0,1.846312146342914,2.0089092099553403,2.1536706695753476,0,1918,1918,Menard and Nearby Counties,Edwards,48,137,Texas,TX
48171,48CS068,308,296,319,329,21,10,33,25,-0.5959151407590161,-0.14315664124380026,0.2865216880956157,1.124258175405156,376,362,390,417,41,27,55,58,-1.368776308571561,-0.7490917432735249,-0.1338609265618986,1.3802997399553436,26941,26941,Menard and Nearby Counties,Gillespie,48,171,Texas,TX
48173,48CS068,15,14,15,6,-9,-9,-8,6,-10.32805296672057,-10.217541047014917,-10.122512511697902,-0.7845289674837186,18,18,18,12,-6,-6,-6,2,-6.868020865022848,-6.715570571579122,-6.560802040818425,-0.39795310160009645,1434,1434,Menard and Nearby Counties,Glasscock,48,173,Texas,TX
48235,48CS068,12,12,12,14,2,2,2,2,-0.024661261802051773,0.08522526277457171,0.18230538509176517,0.6387211431700865,15,14,15,24,9,9,10,5,3.1527291316152257,3.3212618576560318,3.4780600766026333,0.48376723503175645,1565,1565,Menard and Nearby Counties,Irion,48,235,Texas,TX
48267,48CS068,50,50,51,51,1,0,1,4,-0.8699350696909599,-0.7579596110057825,-0.6524711770227283,2.395348229585283,62,61,62,63,1,1,2,1,-0.1180410014278674,0.04062096240522046,0.19603181128017896,0.4664168067740071,4376,4376,Menard and Nearby Counties,Kimble,48,267,Texas,TX
48307,48CS068,91,90,91,109,18,18,19,12,0.7006459931722173,0.8097128451258472,0.9203352725350448,0.6179925307222315,111,110,112,166,55,54,56,28,3.872957221226018,4.037740268452327,4.195507860778446,0.503004024133192,7933,7933,Menard and Nearby Counties,McCulloch,48,307,Texas,TX
48319,48CS068,44,44,45,39,-5,-6,-5,6,-2.6930764015431228,-2.586492818728689,-2.4778356387262894,-1.4443457201708831,54,54,55,67,13,12,13,6,1.6937163777668216,1.8555598301311607,2.02684487534291,0.43906141800908965,4311,4311,Menard and Nearby Counties,Mason,48,319,Texas,TX
48327,48CS068,29,28,30,33,4,3,5,6,-1.3395414822218983,-0.9173910066478936,-0.4940027124591213,1.187483069794503,35,34,36,38,3,2,4,6,-2.524956813118695,-1.8749765351563088,-1.2346276101105336,1.6187569081655702,2109,2109,Menard and Nearby Counties,Menard,48,327,Texas,TX
48383,48CS068,25,25,26,28,3,2,3,7,-1.1814517384746885,-1.0713563704661275,-0.9597569840953833,1.7945814527081982,31,31,32,32,1,0,1,5,-1.428242666303041,-1.2767629155013889,-1.1245971259453815,2.6161953677563456,3838,3838,Menard and Nearby Counties,Reagan,48,383,Texas,TX
48385,48CS068,43,42,43,64,21,21,22,12,2.5584089220685016,2.6669168805431194,2.767941981679267,0.5414643808066423,53,52,53,63,10,10,11,11,-0.37361391775131064,-0.20658294978679262,-0.05721849409505429,0.9654557429513557,3440,3440,Menard and Nearby Counties,Real,48,385,Texas,TX
48399,48CS068,133,128,137,137,4,-0,9,20,-1.9790925226765579,-1.5277259547649393,-1.1050921185339782,3.785524002350362,162,157,167,190,28,23,33,36,-1.5377979646095645,-0.9340667897821889,-0.28362618792960226,1.2410870193609402,10322,10322,Menard and Nearby Counties,Runnels,48,399,Texas,TX
48411,48CS068,60,60,61,83,23,22,23,15,1.1623050750603796,1.2738175963503096,1.3817283984865238,0.633721622247544,74,73,75,90,16,15,17,14,0.19074115504588918,0.3426373063182821,0.5051253583285397,0.8362942042237693,6022,6022,Menard and Nearby Counties,San Saba,48,411,Texas,TX
48413,48CS068,23,23,24,25,2,1,2,8,-2.3832391604364824,-2.2785331429422078,-2.162970358820511,2.9970518309894656,29,28,29,33,4,4,5,2,0.8129204792792086,0.9586413736403125,1.114792700809399,0.38342298704003197,2784,2784,Menard and Nearby Counties,Schleicher,48,413,Texas,TX
48431,48CS068,12,12,12,13,1,1,1,7,-4.826377754507569,-4.726512879826054,-4.615222116815304,3.7974813276055412,15,15,15,16,1,1,1,3,-1.9774521590067202,-1.8227851271977493,-1.6573106081306574,1.4826212564496932,1303,1303,Menard and Nearby Counties,Sterling,48,431,Texas,TX
48435,48CS068,27,27,28,38,11,10,11,3,1.942913137282892,2.0474499556667234,2.1642216515831056,0.25606230503102856,34,33,34,47,13,13,14,4,2.8054852192362154,2.9501862089183977,3.1083421186222004,0.28040720953081133,3762,3762,Menard and Nearby Counties,Sutton,48,435,Texas,TX
48329,48CS069,1007,931,1084,1106,99,22,175,200,-0.9964413558332741,-0.568671515583153,-0.12121628490426455,2.003016354550365,1247,1155,1339,1403,156,64,248,233,-1.1358886865246138,-0.5052298742670728,0.12119524788078435,1.48284709114199,177035,177035,Midland,Midland,48,329,Texas,TX
48339,48CS070,3567,3298,3836,4026,459,190,728,290,-0.16322813064729277,0.2861513700275083,0.7104970150028389,0.6304458963816753,4424,4100,4747,5406,982,659,1306,850,-0.39765483516271816,0.2636810812968784,0.9112515086824677,0.8645448025834351,615403,615403,Montgomery,Montgomery,48,339,Texas,TX
48347,48CS071,493,465,521,635,142,114,170,103,0.15054405021653286,0.5950452838802937,1.0102229373762566,0.7212073038773776,607,574,640,789,182,149,215,128,0.4288433510944888,0.984038294687137,1.6383520581963293,0.6994205961963575,64807,64807,Nacogdoches,Nacogdoches,48,347,Texas,TX
48087,48CS072,32,31,34,43,11,9,12,4,1.8475809253364577,2.2622129295798996,2.6787543790491335,0.34537781559865305,40,38,41,42,2,1,4,8,-2.957035615910596,-2.3357332277130527,-1.712830524620848,2.378767936347667,2903,2903,Northeast Panhandle,Collingsworth,48,87,Texas,TX
48179,48CS072,223,213,232,245,22,13,32,41,-1.2855343438276088,-0.8419726096748225,-0.42996707308789606,1.7563597435896465,273,262,284,349,76,65,87,63,0.1022976996486725,0.717043778952216,1.341619480460935,0.8171033789915516,21769,21769,Northeast Panhandle,Gray,48,179,Texas,TX
48195,48CS072,42,41,42,50,8,8,9,19,-2.113885683230192,-2.0118643678591206,-1.9075979441482567,2.0505983547031668,51,51,52,61,10,9,10,10,-0.20529385267772673,-0.054851918984000575,0.09433189695934113,0.931460005950774,5338,5338,Northeast Panhandle,Hansford,48,195,Texas,TX
48211,48CS072,29,29,30,20,-9,-10,-9,4,-3.5559279483654014,-3.4488702761333885,-3.3450327905852557,-0.49219405105438957,36,35,36,24,-12,-12,-11,6,-5.769840599241377,-5.603206632739583,-5.44422184522715,-0.5562972475827108,3808,3808,Northeast Panhandle,Hemphill,48,211,Texas,TX
48295,48CS072,23,23,23,34,11,11,11,2,2.754341381587202,2.8567008712589455,2.9627087142231594,0.1658106104708888,28,28,29,40,12,11,12,2,3.541255350761388,3.7043218406167,3.874353231470311,0.15622659607013636,3171,3171,Northeast Panhandle,Lipscomb,48,295,Texas,TX
48357,48CS072,62,61,63,93,31,30,32,20,1.0432955131383503,1.1572735498232922,1.2583317638739522,0.6206413613432361,76,75,77,90,14,13,15,24,-1.4042834732471203,-1.240594810995954,-1.0894322733223167,1.6056280162977905,9725,9725,Northeast Panhandle,Ochiltree,48,357,Texas,TX
48393,48CS072,9,9,10,12,3,2,3,1,1.8193675738397959,2.213205810465975,2.6260531473321613,0.26123832321710927,11,11,12,1,-10,-11,-10,1,-16.860399575024687,-16.24871873279646,-15.615580376639953,-0.108685750073679,827,827,Northeast Panhandle,Roberts,48,393,Texas,TX
48483,48CS072,52,52,53,62,10,9,10,11,-0.3066654533238071,-0.20660454815406099,-0.1032917589927952,1.003005101946134,64,63,64,92,28,28,29,5,5.428774818680923,5.583632829853713,5.745244610811509,0.17098734584327593,4993,4993,Northeast Panhandle,Wheeler,48,483,Texas,TX
48065,48CS073,50,49,50,80,30,30,31,12,3.0141255948603822,3.1203133832408083,3.224304950137794,0.383650729929969,61,60,62,84,23,22,24,13,1.9522549297322587,2.0938627113015458,2.2513215654297176,0.5359358968836928,5862,5862,Northwest Panhandle,Carson,48,65,Texas,TX
48111,48CS073,38,37,38,68,30,30,31,14,2.125439575173416,2.243538271155441,2.347118603255838,0.44764826173664685,46,45,47,79,33,32,34,2,4.925621168168347,5.086226671045664,5.241255814771297,0.059199261004231146,7262,7262,Northwest Panhandle,Dallam,48,111,Texas,TX
48205,48CS073,37,37,38,48,11,10,11,11,-0.12012842788494216,-0.015836363430368743,0.08911204354926923,0.9231394571511381,45,45,46,45,-0,-1,0,4,-1.1070555225722436,-0.9481017043875049,-0.7985464717763674,6.200649860319895,5480,5480,Northwest Panhandle,Hartley,48,205,Texas,TX
48233,48CS073,210,201,219,274,64,55,73,56,-0.07477853197921948,0.3777782443008707,0.7856543339097303,0.865202605011699,257,246,268,347,90,79,101,64,0.9091190554714919,1.4910866080281788,2.1325127773955725,0.7032865646257466,20806,20806,Northwest Panhandle,Hutchinson,48,233,Texas,TX
48341,48CS073,141,132,150,175,34,25,43,63,-1.839152533166429,-1.3875956507839324,-0.9770574722859048,1.807731627787065,174,163,185,190,16,5,27,35,-1.753903273979944,-1.0969656979957993,-0.5103774027382236,2.0682829447743707,20816,20816,Northwest Panhandle,Moore,48,341,Texas,TX
48359,48CS073,14,14,14,17,3,3,3,2,0.2978402793486101,0.41111810378548863,0.5154357577325154,0.51744035659155585,17,17,18,19,2,1,2,1,0.24856700144880783,0.4015279213368605,0.5596054548170051,0.3688446219953415,2123,2123,Northwest Panhandle,Oldham,48,359,Texas,TX
48421,48CS073,22,22,22,27,5,5,5,12,-2.4749220156282177,-2.374587239179987,-2.264874563146431,2.056398838336944,27,27,27,33,6,6,6,7,-0.5939580831391602,-0.4314001638487585,-0.27937436960875944,1.0139508633501244,3021,3021,Northwest Panhandle,Sherman,48,421,Texas,TX
48355,48CS074,2527,2370,2683,3260,733,577,890,510,0.1499376689793758,0.6108288423525906,1.061512458308921,0.6944709118309861,3112,2924,3300,4047,935,747,1123,621,0.3533209603043763,1.0505863831797166,1.663251106060411,0.6634559678429849,362681,362681,Nueces,Nueces,48,355,Texas,TX
48361,48CS075,824,789,860,977,153,117,188,75,0.5033345517098826,0.9406722812112799,1.3724468799051237,0.48756405328655283,1007,964,1050,1234,227,184,270,234,-0.6872199828879615,-0.09124925045528127,0.506097968493959,1.026371785024051,82999,82999,Orange,Orange,48,361,Texas,TX
48365,48CS076,233,223,243,333,100,90,110,45,1.9573478288657091,2.3835052653002258,2.793324003752975,0.44475000010924703,284,272,296,368,84,72,96,74,-0.11927135013791901,0.49997839288757645,1.1174059695716496,0.8731872189626284,23138,23138,Panola+Sabine+San Augustine+Shelby,Panola,48,365,Texas,TX
48403,48CS076,150,145,154,156,6,2,11,16,-1.3533484420766038,-0.9249086342340437,-0.5022244355155089,2.205839796039546,182,176,187,258,76,71,82,52,2.1634885073498253,2.749964917137897,3.3758661186163352,0.6743432253612549,10497,10497,Panola+Sabine+San Augustine+Shelby,Sabine,48,403,Texas,TX
48405,48CS076,107,107,108,149,42,41,42,28,1.5399474972448954,1.6479309409842362,1.7434487405215515,0.6581144837000895,131,130,132,190,59,58,60,13,6.469688741030896,6.642864337881171,6.8016198528789555,0.2182041826247661,8232,8232,Panola+Sabine+San Augustine+Shelby,San Augustine,48,405,Texas,TX
48419,48CS076,245,235,256,295,50,39,60,44,-0.1723409456991718,0.2144714168268471,0.6703972466823928,0.8706649526768993,299,286,312,386,87,74,100,75,-0.026237464589996273,0.573390981096521,1.187685055413119,0.8553027488756635,25138,25138,Panola+Sabine+San Augustine+Shelby,Shelby,48,419,Texas,TX
48367,48CS077,1085,1022,1149,1222,137,73,200,109,-0.22313588908322807,0.19456461716983747,0.6630008544545714,0.7910143504344852,1339,1262,1415,1614,275,199,352,287,-0.7344534098037141,-0.09348226937984688,0.5448383475239282,1.0395710330509969,145253,145253,Parker,Parker,48,367,Texas,TX
48373,48CS078,603,580,625,719,116,94,139,66,0.5375299319774118,0.9662724760635094,1.3808829726534242,0.5624945600379789,735,707,762,961,226,199,254,163,0.8825742287127587,1.4344202897844962,2.056776084718233,0.7174658099746076,51979,51979,Polk+San Jacinto+Tyler,Polk,48,373,Texas,TX
48407,48CS078,283,270,295,323,40,28,53,24,0.14848888169239213,0.5698169562428207,0.9722130429725551,0.5805733931871727,345,330,360,482,137,122,152,79,1.8475019411437181,2.3890725248488587,2.990637966328968,0.5721483757356035,29048,29048,Polk+San Jacinto+Tyler,San Jacinto,48,407,Texas,TX
48457,48CS078,234,225,244,272,38,28,47,17,0.520349521760394,0.9459362750138889,1.3475787449973275,0.44154227940290847,285,274,297,410,125,113,136,60,2.9579435886842296,3.5832569479916243,4.1902020076849835,0.4776302071244596,21551,21551,Polk+San Jacinto+Tyler,Tyler,48,457,Texas,TX
48375,48CS079,1034,984,1083,1402,368,319,418,299,0.180791867268667,0.5936346860715634,1.0248706596664927,0.8092072834041185,1270,1210,1330,1579,309,249,369,269,-0.20207254312851147,0.4297966362649273,1.0018445131298823,0.8686486162454871,116479,116479,Potter,Potter,48,375,Texas,TX
48379,48CS080,150,145,156,170,20,14,25,20,-0.4209380958198232,-0.012329940439073553,0.4041146190389008,0.9627562611369632,183,176,189,205,22,16,29,32,-1.5054076410602275,-0.8998425891171032,-0.2968006636384984,1.368442052243268,12464,12464,Rains+Van Zandt,Rains,48,379,Texas,TX
48467,48CS080,569,544,594,698,129,104,154,71,0.5792435985511466,1.009079248300783,1.4263408292228086,0.5452836822273665,693,664,723,983,290,260,319,174,1.832045217893206,2.451613415249517,3.055971923373458,0.5984516819712562,57073,57073,Rains+Van Zandt,Van Zandt,48,467,Texas,TX
48381,48CS081,945,885,1005,1200,255,195,315,206,-0.0878646905681406,0.34225839765878646,0.8002435221196502,0.8045087488386071,1165,1093,1238,1476,311,238,383,218,0.2170729730387187,0.8047858905045956,1.4535530999608879,0.6997894162822231,138657,138657,Randall,Randall,48,381,Texas,TX
48397,48CS082,582,535,629,632,50,3,97,54,-0.43413169769625626,-0.030388659939745707,0.3855858604481402,1.0522901576075359,726,669,783,877,151,94,208,168,-0.8008967450616056,-0.19241837347919455,0.4953689444206162,1.1069045155346937,106956,106956,Rockwall,Rockwall,48,397,Texas,TX
48401,48CS083,466,442,489,577,111,88,135,76,0.22362059431024164,0.6486207327200317,1.0530949980259356,0.6776407537275814,571,543,599,767,196,168,224,151,0.3653857798142065,1.015989880781463,1.618921974240541,0.7658949800731274,54360,54360,Rusk,Rusk,48,401,Texas,TX
48409,48CS084,544,515,572,661,117,89,146,98,-0.14689025240064976,0.28530770248987497,0.7245560121315013,0.8272989765454064,667,633,702,881,214,179,248,195,-0.24864388425020317,0.322069071661385,0.9715338607753223,0.9089888987831775,66828,66828,San Patricio,San Patricio,48,409,Texas,TX
48033,48CS085,9,9,9,7,-2,-2,-2,7,-12.997162192000781,-12.891376403098668,-12.777744484996017,-9.619188081120264,11,11,11,3,-8,-8,-8,3,-19.050090816832476,-18.892368880412764,-18.726923347867316,-0.4506600017977255,677,677,Scurry and Nearby Counties,Borden,48,33,Texas,TX
48151,48CS085,39,37,41,59,20,18,22,12,1.7306926175955193,2.12507113029314,2.5374834157532313,0.5698001633355749,48,46,50,66,18,16,20,13,1.0418398696050957,1.6892089372185877,2.294536799648947,0.6722241869291614,3799,3799,Scurry and Nearby Counties,Fisher,48,151,Texas,TX
48169,48CS085,40,40,41,53,13,12,13,15,-0.5036185183923052,-0.3949095045224449,-0.2813160877829992,1.108453608546195,50,49,50,64,14,14,15,11,0.49314623268244995,0.6530745323137794,0.8182262657908111,0.7143285272757599,6231,6231,Scurry and Nearby Counties,Garza,48,169,Texas,TX
48227,48CS085,326,310,342,414,88,72,104,85,-0.33896059964209924,0.08585913207623287,0.4960229376412223,0.9556402494110317,400,381,419,458,58,39,77,70,-1.0187643199962448,-0.3990047555045987,0.2154524510803641,1.1938323154510841,36652,36652,Scurry and Nearby Counties,Howard,48,227,Texas,TX
48263,48CS085,12,12,12,16,4,4,4,7,-3.631531182018322,-3.5249673294626986,-3.411130274277001,1.3251243774472317,14,14,14,20,6,6,6,3,4.066521813853373,4.2107368999230745,4.364485662932239,0.4476991082012445,770,770,Scurry and Nearby Counties,Kent,48,263,Texas,TX
48335,48CS085,77,76,78,76,-1,-2,-0,16,-2.2332704930858767,-2.1184584324441014,-2.004030544139094,-51.95118411131094,95,93,96,109,14,13,16,27,-2.005684814229994,-1.842147465322217,-1.677231703522871,1.745216483761256,8178,8178,Scurry and Nearby Counties,Mitchell,48,335,Texas,TX
48353,48CS085,163,157,170,202,39,32,45,32,0.018477524691150805,0.44046464883911707,0.8877013672121913,0.8066840736995232,200,192,207,214,14,7,22,51,-3.6023705280401295,-2.960837613931652,-2.2991127153674,3.347738880505751,14834,14834,Scurry and Nearby Counties,Nolan,48,353,Texas,TX
48415,48CS085,148,141,155,201,53,46,60,38,0.49910975550827613,0.9065978655570749,1.34684031463087,0.7007219957187896,182,173,190,223,41,33,50,55,-1.5701159418662112,-0.9890879427511632,-0.36262652384181954,1.295955905227959,16658,16658,Scurry and Nearby Counties,Scurry,48,415,Texas,TX
48423,48CS086,1871,1770,1973,2318,447,345,548,286,0.23522518021369057,0.6912820533183871,1.1479027579399723,0.6389251022593259,2300,2178,2422,2977,677,555,799,531,0.13722296625795172,0.7197609179389989,1.407068714037688,0.7833966494655771,234120,234120,Smith,Smith,48,423,Texas,TX
48427,48CS087,372,365,379,641,269,262,276,210,0.8136231503934604,0.9239089584561233,1.0232688900921603,0.7768969580336195,458,450,467,632,174,165,182,126,0.732266072582317,0.8895767408652845,1.053564114766946,0.7211911621737556,64282,64282,Starr,Starr,48,427,Texas,TX
48439,48CS088,11562,10649,12475,13952,2390,1477,3303,1732,-0.1576719067999596,0.29944910102448424,0.7552521658563435,0.7244176702426506,14356,13260,15453,17727,3371,2274,4467,2929,-0.3469660229601524,0.24165274863905112,0.9035603474035345,0.8687491940273808,2110476,2110476,Tarrant,Tarrant,48,439,Texas,TX
48441,48CS089,1204,1144,1263,1390,186,127,246,218,-0.6585410671897067,-0.23772785597984314,0.20375988703543838,1.1633788644956833,1479,1407,1551,1838,359,287,431,391,-0.8841426932067462,-0.27348513661698887,0.3367223245474961,1.0859510088414628,138582,138582,Taylor,Taylor,48,441,Texas,TX
48451,48CS090,928,876,979,1222,294,243,346,190,0.46611539874983576,0.8690677613269965,1.2721315261353148,0.6437175573317306,1144,1082,1206,1456,312,250,374,211,0.41035672474997603,1.019053561525635,1.6316810377483366,0.6733065463870428,119671,119671,Tom Green,Tom Green,48,451,Texas,TX
48453,48CS091,5152,4594,5711,5943,791,232,1349,586,-0.2773831655162748,0.15060330401487618,0.5937872659745175,0.7399592381909954,6473,5801,7145,7382,909,237,1581,874,-0.5997292480533121,0.03453020188559546,0.6582951935095973,0.9604569825093857,1284790,1284790,Travis,Travis,48,453,Texas,TX
48469,48CS092,710,670,750,906,196,156,236,129,0.2814320128733824,0.72694756493937,1.1582641909804396,0.6547159417719263,872,825,920,1117,245,197,292,231,-0.4236432602521827,0.17984523065217836,0.7409005297900203,0.9408271252908358,91986,91986,Victoria,Victoria,48,469,Texas,TX
48479,48CS093,1216,1096,1335,1897,681,562,801,526,0.11804239257749162,0.559509968941543,0.9954652668155317,0.7709366801871639,1519,1375,1662,1973,454,311,598,423,-0.46895655378789103,0.1437618942600672,0.7148434661384008,0.9292892239680504,276926,276926,Webb,Webb,48,479,Texas,TX
48017,48CS094,49,48,50,59,10,9,11,14,-0.6701647722659791,-0.5609695849348448,-0.4543390600141257,1.2482028364707454,60,59,61,81,21,20,22,19,0.20042276265527748,0.348146880251791,0.49430992484963554,0.8649895756147699,6792,6792,Western Central Panhandle,Bailey,48,17,Texas,TX
48069,48CS094,52,51,53,75,23,22,24,24,-0.20779512251512594,-0.10765147248196628,0.0025025813662301914,0.991519246553762,64,63,65,96,32,31,33,19,1.9684589048244314,2.1359825924161617,2.2941746098805984,0.5716681207917398,7447,7447,Western Central Panhandle,Castro,48,69,Texas,TX
48079,48CS094,23,23,24,34,11,10,11,10,0.07697486077966832,0.17753608294450893,0.29750314649557263,0.8688535012080343,29,28,29,45,16,16,17,10,2.4266858924415655,2.5803754862717363,2.742474413319519,0.5836121134810438,2855,2855,Western Central Panhandle,Cochran,48,79,Texas,TX
48117,48CS094,136,128,144,173,37,29,45,60,-1.691051630951342,-1.2624225173031436,-0.8561025869163259,1.5919429731841865,168,159,178,216,48,38,57,41,-0.1736373683040516,0.4205536821613548,1.0806513637280664,0.8432094288274858,18442,18442,Western Central Panhandle,Deaf Smith,48,117,Texas,TX
48219,48CS094,187,177,197,285,98,88,108,91,-0.11498749362609759,0.30794170178563324,0.6973737690044243,0.9198397450358207,231,219,243,294,63,51,75,58,-0.30229503084338893,0.27155625306005193,0.8785377675438232,0.9015656273782121,22999,22999,Western Central Panhandle,Hockley,48,219,Texas,TX
48279,48CS094,138,132,143,194,56,51,62,67,-1.2146289077272845,-0.8248037095163622,-0.365523631271129,1.16588077057233,168,162,175,173,5,-2,11,28,-2.784021084847322,-2.1947494031232537,-1.5525738184812536,4.926516684789451,12823,12823,Western Central Panhandle,Lamb,48,279,Texas,TX
48369,48CS094,65,64,66,105,40,39,41,36,0.3138153859334196,0.4099625509313565,0.5105988957310603,0.879377744735281,80,79,81,103,23,22,24,10,1.4559905528917496,1.6234453912593019,1.7740159735752696,0.4186942541566372,9541,9541,Western Central Panhandle,Parmer,48,369,Texas,TX
48043,48CS095,74,73,75,81,7,6,8,12,-0.6513674694966027,-0.5431322360573858,-0.4360703997425239,1.4978608349549407,92,90,93,108,16,15,18,14,0.15057131968020207,0.30795372645363744,0.46746603150144583,0.8045220499238039,9183,9183,"West Texas, excluding El Paso",Brewster,48,43,Texas,TX
48103,48CS095,33,32,33,39,6,6,7,4,0.35579388164431525,0.4559237934661065,0.5621664523235174,0.5583476271046147,41,40,41,48,7,7,8,10,-0.852795867038046,-0.6982316658444104,-0.545234074784333,1.2152282517639634,4762,4762,"West Texas, excluding El Paso",Crane,48,103,Texas,TX
48109,48CS095,17,17,17,27,10,10,10,2,3.5115981880987692,3.6160831797005453,3.7132297374944008,0.18587956625547694,21,21,22,30,9,8,9,5,1.8780221810648234,2.045391800880084,2.201052035900333,0.5178655153994056,2147,2147,"West Texas, excluding El Paso",Culberson,48,109,Texas,TX
48229,48CS095,25,24,25,35,10,10,11,6,0.7586584102245969,0.8753592084037031,0.9761513310375953,0.5322733024083507,31,30,32,39,8,7,9,5,0.6019857358050688,0.7536462985057504,0.9182963518931355,0.5513129860475224,4888,4888,"West Texas, excluding El Paso",Hudspeth,48,229,Texas,TX
48243,48CS095,17,17,18,19,2,1,2,5,-1.6301346265906882,-1.5314809348108807,-1.4219121503945518,1.9575100325693506,22,21,22,28,6,6,7,3,1.6574638766988903,1.8007097530050946,1.957671415529763,0.4061254618586543,2252,2252,"West Texas, excluding El Paso",Jeff Davis,48,243,Texas,TX
48301,48CS095,2,2,2,7,5,5,5,7,-11.11756111303286,-10.694892742108397,-10.223570587210494,1.1357956716917188,2,2,2,5,3,3,3,5,-16.38864275817103,-15.727255425356466,-15.066431936387593,1.3353830201215586,172,172,"West Texas, excluding El Paso",Loving,48,301,Texas,TX
48371,48CS095,109,107,110,164,55,54,57,28,1.622690409599958,1.7308071744460702,1.8345830319530734,0.49784830668482755,135,133,137,176,41,39,43,33,0.4519027161255655,0.6027306097095606,0.7617672002499729,0.7863689473586338,15741,15741,"West Texas, excluding El Paso",Pecos,48,371,Texas,TX
48377,48CS095,39,38,40,55,16,15,17,20,-0.7299161298199254,-0.6212339596553852,-0.519305471789506,1.1824927634527775,49,48,50,69,20,19,21,14,0.9992094436393859,1.1500338122174318,1.3040295478053447,0.6569547485539481,6569,6569,"West Texas, excluding El Paso",Presidio,48,377,Texas,TX
48389,48CS095,104,102,106,128,24,22,26,28,-0.3642274825352283,-0.25998877919479124,-0.15847832524671251,1.1257056091379412,129,127,132,157,28,25,30,32,-0.48420310303627845,-0.33608434319682445,-0.18383418248414143,1.12038749767361,15950,15950,"West Texas, excluding El Paso",Reeves,48,389,Texas,TX
48461,48CS095,27,27,28,34,7,6,7,5,0.3742424886407844,0.4747239654424091,0.5784106209281759,0.6465334165382991,34,33,34,32,-2,-2,-1,5,-2.4017199551558273,-2.241396479947423,-2.079314589552203,-6.25047526316707,3635,3635,"West Texas, excluding El Paso",Upton,48,461,Texas,TX
48475,48CS095,104,103,105,115,11,10,12,13,-0.26737651405463275,-0.15714934567439479,-0.0560961030216864,1.078301815563055,129,127,130,122,-7,-8,-5,24,-3.188588405455601,-3.0449288217969452,-2.8913519068221394,-4.338719175047293,12032,12032,"West Texas, excluding El Paso",Ward,48,475,Texas,TX
48495,48CS095,63,62,64,75,12,11,13,15,-0.44484280932236464,-0.33515382387700593,-0.22766639079214715,1.1263350917036554,78,77,79,88,10,9,11,17,-1.1687756840885941,-1.003781108496866,-0.8437229327368415,1.4949738548111529,7935,7935,"West Texas, excluding El Paso",Winkler,48,495,Texas,TX
48491,48CS096,2774,2510,3039,3106,332,67,596,256,-0.3130934421751339,0.132609783703362,0.5979841218012134,0.769897281289945,3477,3157,3796,4064,587,268,907,564,-0.5421029132512074,0.050229760817697755,0.6463982240851257,0.9584971583064584,602670,602670,Williamson,Williamson,48,491,Texas,TX
48497,48CS097,565,535,596,665,100,69,130,78,-0.13824414513925606,0.32191601304972545,0.7590736812130251,0.7733762871437336,695,658,732,832,137,100,174,153,-0.909389658336035,-0.25357163447167697,0.34952935387410006,1.1081140785167345,70380,70380,Wise,Wise,48,497,Texas,TX
49001,49CS001,52,52,53,43,-9,-10,-9,5,-2.2251062278975255,-2.120731053188171,-2.0078990961775602,-0.6047755935304487,64,63,65,91,27,26,28,13,2.33177847250294,2.4986990884415574,2.6581338831255654,0.4637873765031794,6740,6740,Beaver+Iron+Millard,Beaver,49,1,Utah,UT
49021,49CS001,301,277,325,337,36,12,60,16,-0.08716430633605592,0.3434650003609288,0.766465353436779,0.4327149178654394,372,342,401,446,74,45,104,65,-0.4667822183804706,0.20332999618313202,0.8241040125836342,0.8637976879945003,55913,55913,Beaver+Iron+Millard,Iron,49,21,Utah,UT
49027,49CS001,91,89,92,111,20,19,22,7,0.9150220490613686,1.0141125839460154,1.1085917317328413,0.3275644430695507,111,109,113,154,43,41,45,31,0.937359852812965,1.0864776229273647,1.248616245400412,0.7047092829016045,13195,13195,Beaver+Iron+Millard,Millard,49,27,Utah,UT
49003,49CS002,351,326,375,417,66,42,91,29,0.1887247969653689,0.6522109885810352,1.0845638608904875,0.43136914107251667,434,404,463,511,77,48,107,77,-0.6345443482265091,0.007378735834709802,0.6386359453481597,0.9863560173054572,56394,56394,Box Elder+Cache+Rich,Box Elder,49,3,Utah,UT
49005,49CS002,511,455,567,529,18,-38,74,31,-0.5513302184232376,-0.10482315941815547,0.32529506774609,1.6167252272143253,642,575,709,732,90,23,157,60,-0.34309210766642845,0.2873723836420724,0.912423643064612,0.658116303561307,129015,129015,Box Elder+Cache+Rich,Cache,49,5,Utah,UT
49033,49CS002,15,14,15,11,-4,-4,-3,5,-3.650502285995851,-3.550953133052679,-3.4493501806831475,-1.8254265011039508,18,18,18,20,2,2,2,2,-0.20850193292659325,-0.0385997022042237,0.10932840782241517,0.6858145788101228,2461,2461,Box Elder+Cache+Rich,Rich,49,33,Utah,UT
49007,49CS003,193,184,202,220,27,18,36,6,0.5872850980117243,1.0170973254958062,1.4533396069816238,0.2148500313178903,237,226,247,292,55,45,66,30,0.81246458741701,1.4622481545691008,2.020993137227908,0.5321055414565332,20594,20594,Carbon+Daggett+Duchesne+Uintah,Carbon,49,7,Utah,UT
49009,49CS003,10,10,10,3,-7,-7,-7,3,-10.322961349049637,-10.206083503405992,-10.1059429649204,-0.4912165717228547,12,12,13,5,-7,-8,-7,5,-15.1648337163713,-15.01821527522969,-14.8582906431177,-0.7826617153701702,990,990,Carbon+Daggett+Duchesne+Uintah,Daggett,49,9,Utah,UT
49013,49CS003,137,129,146,137,-0,-9,8,1,-0.5262485593449695,-0.06408424004643025,0.36590074761189373,1.1161714330058166,169,159,179,195,26,16,36,16,-0.032342206273358085,0.620971708849455,1.2364374779998717,0.5926708329344876,19884,19884,Carbon+Daggett+Duchesne+Uintah,Duchesne,49,13,Utah,UT
49047,49CS003,214,199,230,254,40,24,55,15,0.2524738623145951,0.6882471452736296,1.1150910729898935,0.36965209399462157,265,247,284,339,74,55,92,43,0.3872598134206405,1.0250368827740766,1.6719103030117557,0.5770498829018422,35874,35874,Carbon+Daggett+Duchesne+Uintah,Uintah,49,47,Utah,UT
49011,49CS004,1617,1462,1771,1840,223,69,378,92,-0.07453637779702968,0.37953228170909836,0.814269473227624,0.409957586481768,2020,1834,2205,2333,313,128,499,212,-0.2792561848093747,0.3463360088230912,0.9840991783157673,0.6740957508265032,356941,356941,Davis,Davis,49,11,Utah,UT
49023,49CS005,68,67,69,72,4,3,5,7,-0.3497700758779284,-0.23877004624912343,-0.13339192289327262,1.3717437811777489,84,82,85,84,0,-1,2,3,-0.4411607274946065,-0.2719437958199084,-0.11477244176974502,2.4404324141389666,12052,12052,Juab+Sanpete+Tooele,Juab,49,23,Utah,UT
49039,49CS005,175,162,189,208,33,19,46,14,0.18622023259802142,0.6110168086209072,1.0306917447790545,0.41483782938425284,217,201,233,280,63,47,79,32,0.5251222814027173,1.1720103244683826,1.8277355376407112,0.5005786781693328,31156,31156,Juab+Sanpete+Tooele,Sanpete,49,39,Utah,UT
49045,49CS005,353,321,385,352,-1,-33,31,20,-0.708974489060122,-0.28707648043521433,0.13673226796032356,-61.200337902106966,441,402,479,526,85,47,124,64,-0.2745341716727415,0.37045873023036247,0.9709720387735417,0.7416020622598907,73111,73111,Juab+Sanpete+Tooele,Tooele,49,45,Utah,UT
49029,49CS006,58,57,59,72,14,13,15,8,0.37459634463508534,0.4889178625575944,0.5882598886663893,0.5336175647979939,71,70,73,65,-6,-8,-5,2,-0.9838631649955251,-0.8305715274691716,-0.6555718272248949,-0.36457418443185546,12260,12260,Morgan+Summit+Wasatch,Morgan,49,29,Utah,UT
49043,49CS006,142,124,161,147,5,-14,23,5,-0.40310129357930496,-0.008316267656961819,0.40234135629332535,0.8988072862945092,179,157,201,207,28,6,50,13,-0.22964287414029577,0.42447729537664997,1.0574701769789474,0.4497539060683662,42255,42255,Morgan+Summit+Wasatch,Summit,49,43,Utah,UT
49051,49CS006,136,133,140,166,30,26,33,16,0.28731609103185346,0.391958241271416,0.5014226604877031,0.5229411215726057,169,164,173,173,4,-0,9,12,-0.4113336663261253,-0.2559170463178126,-0.0979633485118052,2.1974057636378608,34664,34664,Morgan+Summit+Wasatch,Wasatch,49,51,Utah,UT
49035,49CS007,5880,5378,6381,6695,815,314,1317,576,-0.18499305456224685,0.2154793583928611,0.6446168479184418,0.7055050756549847,7310,6708,7912,7930,620,18,1222,623,-0.596184660515694,-0.011921628703700539,0.6391889726634119,1.0031609110842468,1161473,1161473,Salt Lake,Salt Lake,49,35,Utah,UT
49049,49CS008,2356,2077,2636,2649,293,13,572,223,-0.3273085782992989,0.10150178629626413,0.5602756311326619,0.7596060207454624,2971,2634,3307,3245,274,-62,611,389,-0.853234950952191,-0.23507059362928562,0.4554430596044994,1.4120605021268522,642085,642085,Utah (county),Utah (county),49,49,Utah,UT
49053,49CS009,1293,1213,1372,1478,185,106,265,111,-0.00798833126562699,0.3961988529506,0.8379690989643859,0.5959732313314564,1598,1503,1694,1888,290,194,385,249,-0.3571351205815975,0.25221539045704383,0.8932659517186909,0.8565383648162013,180844,180844,Washington,Washington,49,53,Utah,UT
49015,49CS010,86,85,87,96,10,9,11,7,0.1974733127953196,0.3036777781833018,0.40782759840931354,0.6314428720023317,106,104,107,127,21,20,23,20,-0.004278625690482748,0.15040148674239026,0.3275714815683325,0.8985546085690048,10097,10097,Wayne and Nearby Counties,Emery,49,15,Utah,UT
49017,49CS010,42,42,43,51,9,8,9,4,0.8363240183776653,0.9433213433530001,1.047083829478773,0.4116197038879237,52,51,53,61,9,8,10,3,1.2803385384311474,1.4183907481637974,1.5750948939125804,0.3014102960338147,5021,5021,Wayne and Nearby Counties,Garfield,49,17,Utah,UT
49019,49CS010,77,76,78,61,-16,-17,-15,4,-2.11847246066832,-2.0150734665352013,-1.9072802444072399,-0.2720837288555342,94,93,96,85,-9,-11,-8,7,-2.1801145010277967,-2.021387724903513,-1.883157794512276,-0.8237740322502227,9783,9783,Wayne and Nearby Counties,Grand,49,19,Utah,UT
49025,49CS010,69,68,69,57,-12,-12,-11,4,-2.082231758903287,-1.9743317852737767,-1.871815098436306,-0.3771205804921503,84,83,85,108,24,23,25,13,1.438978943266559,1.6083759398653716,1.7609320885732607,0.5288604516150259,7890,7890,Wayne and Nearby Counties,Kane,49,25,Utah,UT
49031,49CS010,16,15,16,15,-1,-1,0,1,-1.499019595812897,-1.080872661431852,-0.646155051853177,2.28138936130752,19,18,20,23,4,3,5,2,0.9447173034876983,1.5400913172283321,2.148567290678889,0.40851533930293843,1472,1472,Wayne and Nearby Counties,Piute,49,31,Utah,UT
49037,49CS010,103,101,104,147,44,43,46,43,-0.006840457183208998,0.08995613329088596,0.1987856594111475,0.946802232896366,127,125,129,153,26,24,28,27,-0.2181440653203062,-0.04834468151672416,0.10101118939712089,0.98726727642654,15249,15249,Wayne and Nearby Counties,San Juan,49,37,Utah,UT
49041,49CS010,183,174,192,198,15,6,24,2,0.1460024933382963,0.6040957336904424,1.0411606251241077,0.12486713053141217,226,215,237,230,4,-7,15,14,-1.1612440539283722,-0.5620159939400251,0.05857008251177476,2.8278473462035745,21696,21696,Wayne and Nearby Counties,Sevier,49,41,Utah,UT
49055,49CS010,22,22,22,33,11,11,11,2,3.1658765060625225,3.266229447295008,3.3738845295504967,0.16800410808550678,27,27,28,33,6,5,6,1,1.9512100311338785,2.111352494900862,2.2623951442064123,0.1472928536876412,2726,2726,Wayne and Nearby Counties,Wayne,49,55,Utah,UT
49057,49CS011,1588,1475,1700,1773,185,73,298,110,-0.1625288214313503,0.2886163536791292,0.7052380585121496,0.5900302099783484,1959,1823,2095,2138,179,43,315,213,-0.7527641465339373,-0.1551385628149311,0.4383083554111558,1.1833923177156669,260921,260921,Weber,Weber,49,57,Utah,UT
50001,50CS001,269,253,285,287,18,2,34,3,-0.01579549216664785,0.40491445842318463,0.8262751373278177,0.15832406159940404,331,312,350,370,39,20,58,7,0.4702677803580309,1.0525232730044434,1.65370151387404,0.17350185128816453,36934,36934,Addison+Chittenden,Addison,50,1,Vermont,VT
50007,50CS001,989,918,1060,1048,59,-12,130,62,-0.4490971205783518,-0.02419987300495397,0.41922827374932087,1.0326017305358992,1222,1137,1307,1318,96,11,181,42,-0.21403212076031264,0.40612318165270167,1.0134521655313347,0.43395979696128506,164080,164080,Addison+Chittenden,Chittenden,50,7,Vermont,VT
50003,50CS002,388,373,403,399,11,-4,26,2,-0.15184297523707024,0.23518275241044215,0.66553076660966215,0.16813695828503805,473,455,492,547,74,55,92,25,0.9754672665186,1.6619441498758576,2.2640295748344292,0.33479813138974884,35451,35451,Bennington+Windham,Bennington,50,3,Vermont,VT
50025,50CS002,383,365,401,390,7,-11,25,6,-0.4208020917762322,0.018176080777223404,0.44191255920405814,0.7649999210530607,469,447,491,536,67,45,89,24,0.6185496368643733,1.2249259534734391,1.8351183855737823,0.35235690768045014,42139,42139,Bennington+Windham,Windham,50,25,Vermont,VT
50005,50CS003,267,255,280,268,1,-12,13,2,-0.46685611319061937,-0.03241669509543636,0.37633528689948453,1.2626030871261917,328,313,344,387,59,43,74,14,1.1708688439813424,1.8001523935490231,2.395596191984996,0.23487356748992144,29795,29795,Caledonia+Essex+Orange,Caledonia,50,5,Vermont,VT
50009,50CS003,63,62,64,68,5,4,6,5,-0.1177708218714929,-0.008031568480730084,0.09966320815640278,0.8394935824537484,77,77,78,87,10,9,10,6,0.5578283375328962,0.7055802714979321,0.8628297025071177,0.5660730505960468,6136,6136,Caledonia+Essex+Orange,Essex,50,9,Vermont,VT
50017,50CS003,238,226,250,240,2,-10,14,7,-0.6132797592111302,-0.1828511418320645,0.24071718263967173,2.3988735299577355,293,278,308,295,2,-13,17,3,-0.6872283022866694,-0.02635989988957138,0.5822344269215008,1.0475902561420911,28821,28821,Caledonia+Essex+Orange,Orange,50,17,Vermont,VT
50011,50CS004,378,357,399,404,26,5,47,25,-0.4007614461033436,0.019619192667011783,0.4540617584430287,0.9248035100396887,465,439,491,481,16,-10,42,24,-0.798078682997821,-0.21090591214677018,0.43114760373808275,1.4098079011409115,49509,49509,Franklin+Grand Isle,Franklin,50,11,Vermont,VT
50013,50CS004,53,52,53,57,4,4,5,4,-0.04190712848192471,0.06283557169119401,0.16779854707343406,0.7339103378081118,64,63,65,95,31,30,32,5,4.124745989245146,4.275440361024766,4.417385148270744,0.15815355490478997,7192,7192,Franklin+Grand Isle,Grand Isle,50,13,Vermont,VT
50015,50CS005,177,166,188,214,37,26,48,5,0.8341962789275621,1.2427772585331802,1.6778384154908919,0.1324565273186712,217,204,230,245,28,15,41,6,0.41303888373583203,1.0479303798186217,1.6039993383183262,0.20773518181221104,25387,25387,Lamoille+Orleans,Lamoille,50,15,Vermont,VT
50019,50CS005,271,259,282,277,6,-5,18,4,-0.3287409895819143,0.08269743025374565,0.489150661956621,0.5612872405903818,330,316,344,428,98,84,112,24,2.657301068729414,3.3006041190067306,3.9211039578744424,0.24182999144419462,26919,26919,Lamoille+Orleans,Orleans,50,19,Vermont,VT
50021,50CS006,588,563,613,650,62,37,87,2,0.6403401647392362,1.023217435577226,1.4387854707288203,0.031735275664980724,720,690,750,803,83,53,113,34,0.40845133454243027,1.0092078395760755,1.6138587829916398,0.4039332273522762,57975,57975,Rutland,Rutland,50,21,Vermont,VT
50023,50CS007,462,437,487,536,74,49,99,2,0.7777954777152634,1.2305180227776,1.649357284855347,0.026577979687090372,567,537,597,610,43,13,73,20,-0.14558991242231234,0.4833461424773804,1.039677612686011,0.4562409011651841,58404,58404,Washington,Washington,50,23,Vermont,VT
50027,50CS008,500,476,523,554,54,31,78,6,0.4036212918228469,0.8780131191863357,1.3129030241938189,0.10818474707488974,611,582,639,675,64,36,93,27,0.2152718676051217,0.8230727923038914,1.428797047928459,0.41387949100764193,55014,55014,Windsor,Windsor,50,27,Vermont,VT
51001,51CS001,364,351,378,423,59,45,72,32,0.3657734245721398,0.8100352441654365,1.2665547344683503,0.5377971777954237,445,429,462,555,110,93,126,50,1.571995761250453,2.2302006653221684,2.8041484051455177,0.45137246662808445,32289,32289,Accomack+Northampton+Virginia Beach (city),Accomack,51,1,Virginia,VA
51131,51CS001,156,151,161,194,38,33,43,23,0.8721117915844803,1.296736559569419,1.7569537040137886,0.5855833430679243,190,184,196,213,23,17,29,20,-0.2896867913111,0.35354285337727015,0.9133478162199776,0.8185480394373724,11747,11747,Accomack+Northampton+Virginia Beach (city),Northampton,51,131,Virginia,VA
51810,51CS001,2722,2528,2916,3056,334,140,528,163,-0.042944882060145136,0.373412502093973,0.8014405872481857,0.486520238105758,3378,3145,3611,4056,678,445,911,403,0.10663381882615555,0.7271510911863635,1.3607414947822756,0.5932054580158979,450960,450960,Accomack+Northampton+Virginia Beach (city),Virginia Beach (city),51,810,Virginia,VA
51003,51CS002,734,686,782,852,118,70,166,46,0.2385945650156647,0.6623686831948362,1.0969330599744598,0.3863820112369645,903,846,960,1022,119,62,176,73,-0.13212071009056897,0.4936301727894946,1.1129100572009571,0.6078653212969158,110180,110180,Albemarle+Charlottesville (city),Albemarle,51,3,Virginia,VA
51540,51CS002,245,225,265,259,14,-6,34,26,-0.6801049582823877,-0.26163571079844267,0.14934199938257586,1.7200197202616647,303,279,327,329,26,2,50,23,-0.5603487198219482,0.08161128771850028,0.72546267419504,0.8471806083673302,47144,47144,Albemarle+Charlottesville (city),Charlottesville (city),51,540,Virginia,VA
51510,51CS003,630,561,698,705,75,7,144,87,-0.48442210735372454,-0.07837478773471625,0.3444966888287139,1.1377908536215755,790,708,872,798,8,-74,90,58,-1.0140665929428356,-0.38670490214165504,0.24389081697383966,6.567194455693593,158915,158915,Alexandria (city),Alexandria (city),51,510,Virginia,VA
51005,51CS004,177,171,183,211,34,28,40,25,0.15982318087942168,0.6188970995502429,1.047066088727286,0.7126409247639212,216,209,224,318,102,94,109,49,3.7048658698919192,4.28066487727489,4.838341262525968,0.47623541382893725,14816,14816,Alleghany and Nearby Counties and Independent Cities,Alleghany,51,5,Virginia,VA
51017,51CS004,55,55,55,65,10,10,10,1,2.052008505127025,2.1598908564661183,2.2652531767360577,0.09124078615954821,68,67,68,77,9,9,10,12,-0.9124452755436314,-0.7522454613126771,-0.6009909487590965,1.1520995685956303,4148,4148,Alleghany and Nearby Counties and Independent Cities,Bath,51,17,Virginia,VA
51023,51CS004,307,293,322,321,14,-1,28,20,-0.6257219210708667,-0.19642138754373617,0.21954096511071075,1.379084367304029,378,361,396,484,106,88,123,56,1.1737352902714664,1.7582178032192446,2.4116428911408185,0.5252437505887624,33555,33555,Alleghany and Nearby Counties and Independent Cities,Botetourt,51,23,Virginia,VA
51091,51CS004,25,25,25,25,0,-0,0,3,-1.4313014415904914,-1.3168094694297408,-1.2143996726485013,2.6870901186037237,31,30,31,33,2,2,3,7,-2.68863852298976,-2.5246089393632363,-2.3700580764764703,2.060375112489603,2186,2186,Alleghany and Nearby Counties and Independent Cities,Highland,51,91,Virginia,VA
51580,51CS004,96,95,96,88,-8,-8,-7,4,-2.1650829631926336,-2.069815836938658,-1.9593158275098872,-0.6030940592472399,117,116,118,117,-0,-1,1,25,-5.522213137690397,-5.36719013027378,-5.2066739138241465,30.693308828783376,5629,5629,Alleghany and Nearby Counties and Independent Cities,Covington (city),51,580,Virginia,VA
51007,51CS005,142,136,147,156,14,9,20,3,0.45898528309098763,0.8827248223413862,1.2827188578203308,0.19439619188195534,174,167,181,224,50,43,57,29,1.3344221948108788,1.9502576793470148,2.611769665690197,0.5667448638311,13040,13040,Amelia+Brunswick+Lunenburg+Nottoway,Amelia,51,7,Virginia,VA
51025,51CS005,182,175,189,193,11,4,18,13,-0.5850578149000214,-0.15459600148270525,0.2969453983881846,1.1179501988029397,224,215,232,274,50,42,59,27,1.0488448409808357,1.7430576767398738,2.349464843233125,0.5254128731119767,16118,16118,Amelia+Brunswick+Lunenburg+Nottoway,Brunswick,51,25,Virginia,VA
51111,51CS005,138,132,143,136,-2,-7,4,2,-0.7345865913152662,-0.2934943394756342,0.12083856243667208,-3.3179943170219595,169,163,175,177,8,2,14,18,-1.5980696643073888,-0.9636767674021404,-0.3007799739405504,1.9803015750838258,12258,12258,Amelia+Brunswick+Lunenburg+Nottoway,Lunenburg,51,111,Virginia,VA
51135,51CS005,175,169,182,184,9,2,15,21,-1.2403227171035522,-0.8027516664092981,-0.3508890648052618,2.1271144606967054,215,207,223,261,46,38,54,29,0.734899793049651,1.3553546328430819,1.9824127943422436,0.6138402475629018,15187,15187,Amelia+Brunswick+Lunenburg+Nottoway,Nottoway,51,135,Virginia,VA
51009,51CS006,297,283,311,324,27,13,41,18,-0.13876073062480326,0.28597925238673433,0.729512065863307,0.6415719743079857,364,348,381,478,114,97,130,49,1.847713921257316,2.469316662294218,3.133345071909597,0.4278531029704957,31673,31673,Amherst+Lynchburg (city)+Nelson,Amherst,51,9,Virginia,VA
51125,51CS006,166,159,172,186,20,14,27,4,0.7047678832091638,1.0986573080542665,1.518585718338997,0.18848791569401074,203,195,210,206,3,-4,11,24,-2.3468957166983855,-1.6802864660540204,-1.0159077548852036,5.460108737593968,14820,14820,Amherst+Lynchburg (city)+Nelson,Nelson,51,125,Virginia,VA
51680,51CS006,694,659,730,779,85,49,120,56,-0.10853200472812896,0.3390897299776496,0.7904843494329082,0.654835539507314,854,812,896,976,122,80,164,116,-0.5522383570760989,0.10864770301202155,0.7053395435654649,0.944691655677071,81673,81673,Amherst+Lynchburg (city)+Nelson,Lynchburg (city),51,680,Virginia,VA
51011,51CS007,164,157,171,156,-8,-15,-1,3,-1.1607767681088845,-0.703942697787157,-0.29122047503566084,-0.4145167453740061,201,193,209,201,0,-8,8,24,-2.4181885318928282,-1.8033337413579185,-1.2132166424017312,23.493246615171564,15961,15961,Appomattox+Campbell,Appomattox,51,11,Virginia,VA
51031,51CS007,489,465,513,603,114,90,138,46,0.7872186821193634,1.220454449382449,1.6431134475709193,0.40065551200703625,600,571,628,766,166,138,195,105,0.726491180778736,1.3277031786851243,1.9070248126565135,0.6282837751696957,55343,55343,Appomattox+Campbell,Campbell,51,31,Virginia,VA
51013,51CS008,785,682,889,986,201,97,304,152,-0.22363980947779258,0.19022617631850064,0.6415089694941595,0.7541841280868168,990,866,1114,1016,26,-98,150,75,-0.8853882363893584,-0.23952617969138654,0.3423511345987604,2.805176640967342,239112,239112,Arlington,Arlington,51,13,Virginia,VA
51015,51CS009,595,562,628,715,120,87,153,50,0.48293892989536175,0.9152214934740874,1.3658513405054373,0.4130355992827346,724,684,763,965,241,202,281,97,1.6349908631872343,2.2858334877372446,2.8889060901638497,0.400397605562835,76297,76297,Augusta+Rockbridge and Independent Cities,Augusta,51,15,Virginia,VA
51163,51CS009,221,211,231,271,50,40,60,21,0.8500539024639933,1.2834068248902282,1.6834376996256375,0.4121355864216042,268,256,280,346,78,66,90,63,0.1888000622767953,0.7953516615152463,1.401072712711254,0.7980022318719472,22767,22767,Augusta+Rockbridge and Independent Cities,Rockbridge,51,163,Virginia,VA
51530,51CS009,67,66,68,89,22,21,23,10,1.7385724576730255,1.841481139607616,1.946101364211767,0.43697718684792547,82,81,83,112,30,29,31,17,2.264192036437073,2.406288141625501,2.5571456517993782,0.5493983523551763,6448,6448,Augusta+Rockbridge and Independent Cities,Buena Vista (city),51,530,Virginia,VA
51678,51CS009,73,73,74,67,-6,-7,-6,1,-1.1042395620991026,-1.0039470983137015,-0.8948672175942846,-0.18926451034030162,90,89,91,72,-18,-19,-17,14,-5.379583785470651,-5.222485520441236,-5.064755773974788,-0.8427287199394328,7260,7260,Augusta+Rockbridge and Independent Cities,Lexington (city),51,678,Virginia,VA
51790,51CS009,323,312,334,345,22,11,33,36,-0.9805656449543997,-0.5568622354908749,-0.13724104075034954,1.5694044537578054,391,378,404,423,32,19,45,43,-1.149154577704495,-0.4979718916531627,0.11801534863418382,1.308871196829782,25030,25030,Augusta+Rockbridge and Independent Cities,Staunton (city),51,790,Virginia,VA
51820,51CS009,240,230,250,225,-15,-25,-5,15,-1.7582332070424038,-1.3358826730989495,-0.8958836441057793,-1.059270316154351,291,280,303,317,26,14,37,28,-0.7724983974702853,-0.11673472167365016,0.5059155711124453,1.050918480467577,22551,22551,Augusta+Rockbridge and Independent Cities,Waynesboro (city),51,820,Virginia,VA
51019,51CS010,705,671,740,817,112,77,146,42,0.43190057259304243,0.8685795910551584,1.3158792375490966,0.3732461986511364,866,825,907,1066,200,159,241,126,0.4536064581138725,1.0922263088055528,1.7158469240396574,0.627055766008109,79589,79589,Bedford (county)+Bedford (city),Bedford (county),51,19,Virginia,VA
51021,51CS011,70,69,70,80,10,10,11,6,0.5880713895682086,0.6975662769548139,0.7941672622023657,0.5283982552772998,85,85,86,98,13,12,13,7,0.9327700834817706,1.0866798319211366,1.2453376226180601,0.5124424606661961,6270,6270,Bland+Smyth+Wythe,Bland,51,21,Virginia,VA
51173,51CS011,380,367,393,441,61,48,74,46,0.04586200714672769,0.5042130454224742,0.9370322872509312,0.7426536429079056,464,449,480,601,137,121,152,77,1.7900815153379397,2.375476623789611,3.0738385834621464,0.5587694102116841,30144,30144,Bland+Smyth+Wythe,Smyth,51,173,Virginia,VA
51197,51CS011,348,336,360,398,50,38,62,39,-0.03116998718807068,0.3900085979538999,0.8342325369048907,0.7644939540863849,425,411,440,505,80,65,94,75,-0.4118538775099378,0.20060750153102516,0.8366598584361287,0.9308249311906269,28619,28619,Bland+Smyth+Wythe,Wythe,51,197,Virginia,VA
51191,51CS012,539,515,562,687,148,125,172,65,1.1399959049050676,1.5684351207855336,1.9766533649633786,0.43478314315302846,651,624,679,886,235,207,262,111,2.0984184598125517,2.7510110708174254,3.372307850578319,0.4711248446462261,53787,53787,Bristol (city)+Washington,Washington,51,191,Virginia,VA
51520,51CS012,233,226,241,249,16,8,23,20,-0.6977185783333748,-0.25310822570576336,0.19389007610666611,1.200105451683477,282,273,291,306,24,15,33,38,-1.5979689184746857,-0.9958242171323519,-0.3462624709412533,1.5280452506475481,17158,17158,Bristol (city)+Washington,Bristol (city),51,520,Virginia,VA
51027,51CS013,259,251,268,333,74,65,82,29,1.6889468611726928,2.1269712252513413,2.5289820962851013,0.38900098395797,317,306,327,394,77,67,88,64,0.1901865430901946,0.7443165970914906,1.3243193790721137,0.8182472201426814,20857,20857,Buchanan+Dickenson+Russell+Tazewell,Buchanan,51,27,Virginia,VA
51051,51CS013,179,173,185,195,16,10,22,16,-0.4687873851466421,-0.013428024207037623,0.3960180378363329,0.9584962250195909,219,212,226,230,11,4,18,24,-1.720696670894847,-1.095124466036043,-0.4763341990262482,1.9951655534456925,14205,14205,Buchanan+Dickenson+Russell+Tazewell,Dickenson,51,51,Virginia,VA
51167,51CS013,305,294,317,341,36,24,47,23,0.021699370721776384,0.452249041840335,0.8886254570044803,0.6300466159574665,374,360,388,463,89,75,103,59,0.7644810081977943,1.3472916470029275,1.965681803854819,0.6571260952918196,26701,26701,Buchanan+Dickenson+Russell+Tazewell,Russell,51,167,Virginia,VA
51185,51CS013,513,496,531,609,96,78,113,31,1.1682503524257735,1.5907858953653768,2.0090387618621444,0.3207247374345748,628,607,648,785,157,137,178,94,1.2780493840056286,1.8855078750412666,2.45030192346954,0.5930742954157063,40649,40649,Buchanan+Dickenson+Russell+Tazewell,Tazewell,51,185,Virginia,VA
51035,51CS014,312,299,325,394,82,69,95,49,0.658735075576738,1.1177279348591425,1.5446090882451458,0.5877245830007589,382,367,398,524,142,126,157,70,2.1921004300845803,2.873358896112317,3.4617480753179377,0.4903697644726374,30044,30044,Carroll+Galax (city)+Grayson,Carroll,51,35,Virginia,VA
51077,51CS014,173,166,180,214,41,34,48,29,0.356361454758241,0.7708985990901285,1.2209402033798693,0.6909109793711168,212,204,220,281,69,61,77,41,1.5969998599656312,2.1705600732243813,2.807579268578961,0.5839257023968155,15540,15540,Carroll+Galax (city)+Grayson,Grayson,51,77,Virginia,VA
51640,51CS014,133,133,134,123,-10,-11,-10,19,-4.764043236578348,-4.6513709560605525,-4.555683617174695,-2.0309035696947895,163,162,164,165,2,1,3,24,-4.3050337143725645,-4.146931835745345,-3.995556149324139,7.5672508091167785,6312,6312,Carroll+Galax (city)+Grayson,Galax (city),51,640,Virginia,VA
51036,51CS015,73,72,73,89,16,16,17,2,1.9887004955907137,2.090210339129464,2.1948303842286103,0.1146800255699986,89,88,90,115,26,25,27,14,1.8795367401861367,2.0313068317556313,2.200829444211,0.5240469898880682,6907,6907,Charles City+Goochland+Henrico+New Kent,Charles City,51,36,Virginia,VA
51075,51CS015,187,177,198,207,20,9,30,12,-0.1109894431990077,0.30646132052611136,0.7466315344286366,0.5797037372286905,231,218,244,277,46,33,59,33,0.007322610450260162,0.6485346795980573,1.2499008145458392,0.7028920409265416,24150,24150,Charles City+Goochland+Henrico+New Kent,Goochland,51,75,Virginia,VA
51087,51CS015,2450,2307,2594,2929,479,335,622,275,0.1898260811555994,0.6039389101261533,1.0267592429075398,0.5733543503707565,3022,2850,3195,3583,561,388,733,364,0.09277582782304732,0.7019954995900491,1.2952700075546708,0.6478376126595508,333035,333035,Charles City+Goochland+Henrico+New Kent,Henrico,51,87,Virginia,VA
51127,51CS015,173,163,183,178,5,-5,15,12,-0.7069639215047399,-0.29528320027923255,0.1278803209170963,1.9136131086745176,213,201,226,245,32,19,44,20,-0.01520765055720577,0.5804811245521331,1.1951713019610468,0.615330426409211,23261,23261,Charles City+Goochland+Henrico+New Kent,New Kent,51,127,Virginia,VA
51550,51CS016,1599,1493,1705,1810,211,105,317,138,-0.1340394172623504,0.30671070608502027,0.7522949419008071,0.6504644940403026,1976,1848,2104,2388,412,284,540,237,0.23358989935060595,0.8788729418271285,1.4704507245940575,0.573966557872636,246073,246073,Chesapeake (city),Chesapeake (city),51,550,Virginia,VA
51041,51CS017,2243,2089,2397,2583,340,186,494,185,0.040953923790443325,0.43734045449264536,0.8610909553116869,0.5420047961166122,2766,2581,2951,3333,567,382,752,362,0.06592830380925369,0.7106823248705776,1.3424955777112269,0.6368399534417404,355405,355405,Chesterfield+Colonial Heights (city)+Powhatan,Chesterfield,51,41,Virginia,VA
51145,51CS017,193,180,206,245,52,39,65,10,0.9431539789661753,1.3984119578958367,1.8400492744339587,0.18892000485491792,238,222,254,315,77,61,93,30,1.2661434871145707,1.8960125466875766,2.4611371539401836,0.38435628988680554,29906,29906,Chesterfield+Colonial Heights (city)+Powhatan,Powhatan,51,145,Virginia,VA
51570,51CS017,217,210,225,229,12,4,19,13,-0.4997622881548289,-0.06445217905350761,0.34625067659354297,1.0239385628971378,264,255,273,320,56,47,65,38,0.6385252984468109,1.2417925553758236,1.8023209603505765,0.670586424906257,17137,17137,Chesterfield+Colonial Heights (city)+Powhatan,Colonial Heights (city),51,570,Virginia,VA
51043,51CS018,144,138,150,153,9,3,15,10,-0.4949039062063323,-0.05695037006370962,0.3890504713194833,0.9863069413093367,176,169,184,185,9,1,16,19,-1.4703636759955336,-0.8605500344258543,-0.20132750587273365,1.9368458183038317,14595,14595,Clarke+Warren,Clarke,51,43,Virginia,VA
51187,51CS018,338,320,355,351,13,-4,31,29,-0.8452941664922142,-0.38650969889628484,0.05169984750430278,2.024323778082377,415,394,436,532,117,96,138,77,0.5456327733595091,1.1867794247319943,1.782304009251164,0.6532748928957626,40335,40335,Clarke+Warren,Warren,51,187,Virginia,VA
51045,51CS019,47,47,48,55,8,7,8,7,0.07691807403071482,0.18749144104949053,0.29322591765642225,0.7816759028496248,58,57,58,72,14,14,15,7,1.546358740991645,1.7034288177203372,1.8584400409100816,0.4590975997991969,5106,5106,Craig+Franklin (county)+Roanoke (county)+Salem (city),Craig,51,45,Virginia,VA
51067,51CS019,517,493,541,618,101,77,125,41,0.6537394066348655,1.0623210766507103,1.5065797930550884,0.40085397248548654,632,603,661,795,163,134,192,88,1.003482283141314,1.6176103785560236,2.233587567959231,0.5371789037380754,56178,56178,Craig+Franklin (county)+Roanoke (county)+Salem (city),Franklin (county),51,67,Virginia,VA
51161,51CS019,869,828,909,1003,134,94,175,92,0.030438102457034336,0.4293983486512487,0.8340341671374036,0.6796045317160647,1063,1014,1112,1350,287,238,336,113,1.6553555536972555,2.22568930396825,2.8624079652090537,0.3921628514721368,94459,94459,Craig+Franklin (county)+Roanoke (county)+Salem (city),Roanoke (county),51,161,Virginia,VA
51775,51CS019,301,290,312,348,47,36,58,25,0.44224702251987863,0.8475505563177407,1.30898425869501,0.521965750977193,367,354,380,395,28,15,41,51,-1.672274226857233,-1.0900631190556835,-0.4958404089062376,1.756136701857488,25264,25264,Craig+Franklin (county)+Roanoke (county)+Salem (city),Salem (city),51,775,Virginia,VA
51047,51CS020,394,371,417,406,12,-11,35,33,-0.8555069998047463,-0.3862629487731549,0.022291931967488323,2.5056137221261237,485,458,513,557,72,44,99,56,-0.2647627086989757,0.3521564521270548,0.9821915672055074,0.7701283265412977,53075,53075,Culpeper+Madison+Rappahannock,Culpeper,51,47,Virginia,VA
51113,51CS020,128,127,129,121,-7,-8,-6,7,-1.1597842479227107,-1.0595430341070913,-0.9574954923010356,-1.1559665934146426,157,156,159,177,20,18,21,27,-0.8066278122199739,-0.65914942308655,-0.49416931154752314,1.3053342861611055,13254,13254,Culpeper+Madison+Rappahannock,Madison,51,113,Virginia,VA
51157,51CS020,58,58,59,63,5,4,5,7,-0.4406752173094703,-0.342094479447787,-0.2332575885269403,1.2644877255859013,72,71,73,96,24,23,25,1,3.6021313814422538,3.770177122883725,3.9410176317800567,0.03995652233606977,7325,7325,Culpeper+Madison+Rappahannock,Rappahannock,51,157,Virginia,VA
51143,51CS021,612,586,638,694,82,56,108,55,0.030482667013652414,0.4462792661131625,0.8774034850419099,0.6616207393401485,753,722,784,890,137,106,168,105,0.022106600637193188,0.6378215661307299,1.2725838301386432,0.7600356727481644,60212,60212,Danville (city)+Pittsylvania,Pittsylvania,51,143,Virginia,VA
51590,51CS021,579,562,596,669,90,73,107,69,0.13478350570300843,0.5518944844839111,0.955759663512037,0.7579071512978499,707,687,728,883,176,155,196,109,1.3811308000678253,2.013898256057634,2.647675656197616,0.6169683224198045,39966,39966,Danville (city)+Pittsylvania,Danville (city),51,590,Virginia,VA
51053,51CS022,235,223,248,277,42,29,54,18,0.4169563419127786,0.8259291674974865,1.253940682834653,0.42123742453668267,292,277,306,371,79,65,94,42,0.9258962170980076,1.5716874303553472,2.1847707453808476,0.522134564126008,28756,28756,Dinwiddie+Petersburg (city),Dinwiddie,51,53,Virginia,VA
51730,51CS022,450,437,463,522,72,59,85,38,0.6658805588926442,1.1284779448467401,1.5581456903312338,0.519647312598842,550,534,565,667,117,102,133,73,1.1151747800572975,1.7507253833038605,2.332543648017178,0.6162210938808732,30532,30532,Dinwiddie+Petersburg (city),Petersburg (city),51,730,Virginia,VA
51059,51CS023,4563,4067,5058,5343,780,285,1276,688,-0.34868053101128343,0.08488200524745125,0.5152664821187088,0.8803717044429444,5773,5179,6368,6027,254,-341,848,423,-0.7611113587197719,-0.18627587560860848,0.41735663427760844,1.661703653180767,1151729,1151729,Fairfax (county)+Fairfax (city)+Falls Church (city),Fairfax (county),51,59,Virginia,VA
51600,51CS023,211,201,221,217,6,-4,16,15,-0.8552253286239805,-0.3805388666015005,0.013331648469945948,2.2062737908248233,260,248,272,233,-27,-39,-15,19,-3.014233117613378,-2.345262798395239,-1.7639473284342477,-0.7406073424973365,23350,23350,Fairfax (county)+Fairfax (city)+Falls Church (city),Fairfax (city),51,600,Virginia,VA
51610,51CS023,83,82,85,84,1,-1,2,10,-0.7334740217398249,-0.6209992332932734,-0.5102385049226955,5.212696467358745,103,101,105,99,-4,-6,-2,3,-0.7126769700493237,-0.5662857363232889,-0.3925127903549045,-1.045973878233279,14584,14584,Fairfax (county)+Fairfax (city)+Falls Church (city),Falls Church (city),51,610,Virginia,VA
51061,51CS024,484,453,515,524,40,9,71,23,-0.21337497954986043,0.22748977183182664,0.6298412174318525,0.5599665380875598,596,559,633,707,111,74,148,58,0.2751874562840742,0.8857456201975221,1.524440397183095,0.5190658641341515,71324,71324,Fauquier,Fauquier,51,61,Virginia,VA
51063,51CS025,149,142,156,198,49,42,56,12,1.9301932993903816,2.355836365192976,2.788427784215018,0.24012116901093408,182,174,191,212,30,21,38,15,0.49807742618613116,1.122001226171109,1.7469060464397093,0.4916144293445253,15788,15788,Floyd+Giles+Montgomery,Floyd,51,63,Virginia,VA
51071,51CS025,198,190,205,244,46,39,54,13,1.5898635421462364,2.006780921405648,2.4155806545600758,0.27427271619267707,241,232,250,299,58,49,67,31,1.3655780537953386,1.9470788692738428,2.57163780384081,0.5251468288831915,16680,16680,Floyd+Giles+Montgomery,Giles,51,71,Virginia,VA
51121,51CS025,549,507,591,604,55,13,97,54,-0.42306516862287724,0.026848916156611655,0.44889471175212503,0.9662766061655669,682,631,732,799,117,67,168,74,-0.06669309549636956,0.5533523514416684,1.1538248383416234,0.6249279247385972,98672,98672,Floyd+Giles+Montgomery,Montgomery,51,121,Virginia,VA
51069,51CS026,655,616,694,762,107,68,146,53,0.16857866300273444,0.607628260468932,1.0258771285447401,0.4913648454172603,810,763,857,1026,216,169,263,132,0.4759234005594132,1.1018424127494195,1.7156523157274606,0.6092935588711382,90165,90165,Frederick+Winchester (city),Frederick,51,69,Virginia,VA
51840,51CS026,219,207,231,269,50,38,62,25,0.4730191232881663,0.8943552097147733,1.37695191253641,0.4913436333848402,270,255,284,323,53,39,68,41,-0.06695853703224292,0.5526571588345393,1.1535400786693029,0.7544277051257926,27896,27896,Frederick+Winchester (city),Winchester (city),51,840,Virginia,VA
51177,51CS027,835,775,894,982,147,88,207,71,0.16056541480883138,0.5416498794111719,0.9742218433028754,0.47964179566862414,1035,963,1106,1226,191,120,263,115,0.05234907942437543,0.6605001003759821,1.2944961913281472,0.5977303357378201,137281,137281,Fredericksburg (city)+Spotsylvania,Spotsylvania,51,177,Virginia,VA
51630,51CS027,182,170,195,202,20,7,32,1,0.20433661746878673,0.6410903555115218,1.021444825512776,0.048453175240851555,226,210,241,257,31,16,47,11,0.2205295023202689,0.8527458505566801,1.4534200046415082,0.340259334656411,29353,29353,Fredericksburg (city)+Spotsylvania,Fredericksburg (city),51,630,Virginia,VA
51079,51CS028,146,137,154,154,8,-0,17,5,-0.29690178437137527,0.1699682111512653,0.5904236495253291,0.529109857509811,180,170,190,236,56,46,66,37,0.5699653090909863,1.1356765400998334,1.7735705140734774,0.6491994453877649,19997,19997,Greene+Louisa+Orange,Greene,51,79,Virginia,VA
51109,51CS028,315,299,332,341,26,9,42,14,-0.15898952137424988,0.31819528191139385,0.777445664878887,0.5228447992581916,389,369,408,492,103,84,123,41,1.3953839948042088,1.9655937919244204,2.6066872612892378,0.3928236004084981,37750,37750,Greene+Louisa+Orange,Louisa,51,109,Virginia,VA
51137,51CS028,362,346,378,379,17,1,33,12,-0.32051533126396886,0.14951152985985425,0.5629480784709836,0.6569514837532634,445,425,464,472,27,8,47,52,-1.3558680085407455,-0.7541554996799034,-0.13400154756287824,1.8253562963421515,37255,37255,Greene+Louisa+Orange,Orange,51,137,Virginia,VA
51083,51CS029,400,386,415,494,94,79,108,64,0.46604167754874815,0.8730431746834557,1.309890021129084,0.6763901998073489,490,473,508,605,115,97,132,70,0.9969052099885197,1.578004439446049,2.2013871183943845,0.605639698804256,33868,33868,Halifax+Mecklenburg,Halifax,51,83,Virginia,VA
51117,51CS029,397,384,411,443,46,32,59,51,-0.6058764176363706,-0.16739950813015403,0.2461617204987195,1.0944798248850072,486,471,502,553,67,51,82,49,0.05284680912851679,0.6943077750908315,1.3418203343638055,0.7244028414547783,30705,30705,Halifax+Mecklenburg,Mecklenburg,51,117,Virginia,VA
51650,51CS030,1093,1035,1151,1250,157,99,215,73,0.1875973813956864,0.6179373142548426,1.0834524069983862,0.4616497962914094,1341,1271,1411,1623,282,212,352,179,0.30739383455657726,0.9100748721529082,1.5430677546673905,0.633001560408953,135221,135221,Hampton (city)+Poquoson (city),Hampton (city),51,650,Virginia,VA
51735,51CS030,105,104,106,110,5,4,6,4,-0.015011159960196693,0.08228722890430869,0.18754252033526983,0.6629281915423721,129,127,130,137,8,7,10,12,-0.5434451004921522,-0.3744602881347054,-0.23608768055455726,1.3108213982025962,12240,12240,Hampton (city)+Poquoson (city),Poquoson (city),51,735,Virginia,VA
51085,51CS031,828,781,874,955,127,81,174,75,0.08947184211439557,0.48604893310447805,0.900850517663141,0.5852597566575655,1020,964,1076,1251,231,175,287,103,0.7855170688530018,1.4407147328193346,2.014941725058567,0.44323836267504496,107838,107838,Hanover,Hanover,51,85,Virginia,VA
51165,51CS032,631,595,666,788,157,122,193,76,0.543646564161851,1.0007036790608752,1.4253728749849583,0.47989844918656865,774,731,816,1018,244,202,287,145,0.8377734479519863,1.4747935127496632,2.0827898845660773,0.5917151039304926,82226,82226,Harrisonburg (city)+Rockingham,Rockingham,51,165,Virginia,VA
51660,51CS032,268,245,291,292,24,1,47,37,-0.7001425115828676,-0.24372730352656752,0.18451534092585542,1.4713054126964533,332,305,360,368,36,8,63,40,-0.7301632984286488,-0.0987452966658879,0.5243573553862895,1.090869981006117,53306,53306,Harrisonburg (city)+Rockingham,Harrisonburg (city),51,660,Virginia,VA
51089,51CS033,572,550,594,732,160,138,182,76,1.2675311574269839,1.6615461792101751,2.0947815435611887,0.4716145647632312,698,672,724,976,278,252,304,148,2.4399711143336575,3.076894171430988,3.701951151952696,0.530796872358488,50551,50551,Henry+Martinsville (city)+Patrick,Henry,51,89,Virginia,VA
51141,51CS033,221,213,228,273,52,45,60,32,0.7608637813922634,1.1646225076546168,1.594334852298262,0.5996968213129606,269,260,278,359,90,81,99,47,2.339771681889252,2.953056347881956,3.5723935032547156,0.5162775437874207,17551,17551,Henry+Martinsville (city)+Patrick,Patrick,51,141,Virginia,VA
51690,51CS033,257,251,262,261,4,-1,10,31,-2.570131716243259,-2.174804018292734,-1.7464822621644334,5.895402654494269,311,305,317,293,-18,-24,-12,57,-7.7769105176878695,-7.230039005208607,-6.671077211520171,-3.361131912175769,12406,12406,Henry+Martinsville (city)+Patrick,Martinsville (city),51,690,Virginia,VA
51149,51CS034,211,194,227,243,32,16,49,12,0.1145086965378525,0.5303633072872455,0.9495530068406891,0.36024066026710083,262,242,282,364,102,82,122,48,1.072415706912371,1.6847239932435132,2.298319971562692,0.4653858105808733,38594,38594,Hopewell (city)+Prince George,Prince George,51,149,Virginia,VA
51670,51CS034,263,253,272,273,10,1,20,19,-0.7972032651772365,-0.38558441858633047,0.0021351021614410483,1.6897542972654318,320,309,332,426,106,94,117,62,1.71759185833396,2.337564564290049,2.9471427466187117,0.5810815395520554,22461,22461,Hopewell (city)+Prince George,Hopewell (city),51,670,Virginia,VA
51095,51CS035,674,641,708,762,88,54,121,35,0.2571669177574696,0.6989975889251405,1.0912326076322798,0.39487761614820743,825,784,865,956,131,91,172,56,0.5641595592639768,1.16978325934297,1.7924098683802407,0.4227949087798275,77160,77160,James City +Williamsburg (city),James City,51,95,Virginia,VA
51830,51CS035,68,66,70,84,16,14,18,4,0.6822801938707901,0.7901617563947377,0.9014890728416979,0.23658855622965083,85,83,87,84,-1,-3,1,3,-0.45847336650625314,-0.3142854856928856,-0.15380248027105878,61.14677875969283,15119,15119,James City +Williamsburg (city),Williamsburg (city),51,830,Virginia,VA
51033,51CS036,249,236,262,278,29,16,42,23,-0.2479347598367293,0.18318095760156874,0.6245984185510651,0.7634095894301891,306,290,322,376,70,54,86,38,0.6047743434385328,1.2168048542456347,1.8259735558883905,0.5385142507361675,30793,30793,King and Queen and Nearby Counties,Caroline,51,33,Virginia,VA
51057,51CS036,114,113,116,132,18,16,19,5,1.0539872408024797,1.1535037347687607,1.2696222296074005,0.2682348490396175,141,139,142,183,42,41,44,18,2.5160336206050253,2.6772065459563836,2.8277626476542514,0.4148015044300449,10939,10939,King and Queen and Nearby Counties,Essex,51,57,Virginia,VA
51073,51CS036,351,335,367,417,66,50,82,13,0.9856446759833031,1.4222463708824717,1.8467306297930575,0.19303556750478124,430,411,449,497,67,48,86,56,-0.26656726915901435,0.34559804705450087,0.9442641244558561,0.8245766568033781,37482,37482,King and Queen and Nearby Counties,Gloucester,51,73,Virginia,VA
51097,51CS036,78,77,79,93,15,14,16,5,1.3552789022914007,1.4681157124247686,1.571003261056269,0.307851655191404,96,95,96,102,6,6,7,5,0.09645954849982988,0.2460060717337451,0.4058257940897232,0.6703833175805326,6982,6982,King and Queen and Nearby Counties,King and Queen,51,97,Virginia,VA
51101,51CS036,146,139,154,152,6,-2,13,7,-0.4770956354946218,-0.07011725755763563,0.39797841652077864,1.0150065191880915,180,171,189,220,40,31,49,17,0.9608086348361502,1.5811964846382862,2.2297837732599,0.4156489904353711,17383,17383,King and Queen and Nearby Counties,King William,51,101,Virginia,VA
51115,51CS036,125,121,129,119,-6,-10,-2,10,-2.269650727287763,-1.8322559696475993,-1.4135993084968297,-1.962713320096826,152,148,157,178,26,21,30,15,0.825670238335142,1.4840739581545537,2.0768014304379214,0.5612979676043554,8775,8775,King and Queen and Nearby Counties,Mathews,51,115,Virginia,VA
51119,51CS036,140,136,145,162,22,17,26,4,1.2331865255101175,1.6827075338814506,2.082453412450748,0.17670162709176895,171,166,177,212,41,35,46,24,1.3216164427219679,1.9225805885738232,2.5371202869986544,0.5725370326180267,10564,10564,King and Queen and Nearby Counties,Middlesex,51,119,Virginia,VA
51105,51CS037,255,245,265,315,60,50,70,33,0.724206372714921,1.1483580188366531,1.5506259944937528,0.5434486649004882,312,300,324,412,100,88,112,53,1.7769198350170037,2.370893226714377,3.0040428786048476,0.5272647476141507,23414,23414,Lee+Norton (city)+Scott+Wise,Lee,51,105,Virginia,VA
51169,51CS037,278,268,287,302,24,15,34,37,-1.0509843981353275,-0.6006536988061962,-0.1862648568928523,1.4661547805539663,339,328,351,390,51,39,62,56,-0.9169409736319059,-0.27123065740233654,0.3145202920675631,1.0857283536057145,21599,21599,Lee+Norton (city)+Scott+Wise,Scott,51,169,Virginia,VA
51195,51CS037,426,410,442,490,64,48,80,43,0.11416583084051396,0.5545415964471215,0.9766733514551242,0.6632024897481865,522,502,541,659,137,118,157,73,1.4442882623127384,2.07122976372018,2.6835264966137915,0.5271698728633115,37335,37335,Lee+Norton (city)+Scott+Wise,Wise,51,195,Virginia,VA
51720,51CS037,46,46,46,58,12,12,12,3,2.168750915693823,2.2692464621631343,2.3776112821932154,0.23023455979981872,56,56,57,95,39,38,39,13,7.553063797162895,7.705307439537407,7.856810439363404,0.328558766972471,3984,3984,Lee+Norton (city)+Scott+Wise,Norton (city),51,720,Virginia,VA
51107,51CS038,1322,1140,1504,1543,221,39,403,162,-0.29325637423819256,0.149587064211761,0.5627203408501618,0.7298060090651083,1681,1463,1900,1751,70,-149,288,130,-0.8344307060990789,-0.15937597549153065,0.44444118717092485,1.8372684897890663,418169,418169,Loudoun,Loudoun,51,107,Virginia,VA
51683,51CS039,214,196,231,251,37,20,55,45,-0.6366477545461516,-0.18735296208227642,0.2359785878162244,1.180489172900096,267,246,288,288,21,0,42,27,-0.7452396392541202,-0.18997482394739998,0.4540749100950052,1.2173013971519278,40891,40891,Manassas (city)+Manassas Park (city),Manassas (city),51,683,Virginia,VA
51685,51CS039,39,37,41,33,-6,-8,-4,8,-0.8760938428417137,-0.7765092004335422,-0.6692504810269715,-1.6021745539348677,49,47,52,49,-0,-3,2,5,-0.5066970659596635,-0.342887387361875,-0.19194940526519244,6.427184855308195,18043,18043,Manassas (city)+Manassas Park (city),Manassas Park (city),51,685,Virginia,VA
51700,51CS040,1333,1256,1410,1599,266,189,343,94,0.5016299904352409,0.9514709036226355,1.3673875427782372,0.35165139819867924,1639,1547,1732,1972,333,240,425,201,0.2626708956797556,0.8623080848025648,1.45947184561733,0.6023308229398625,179455,179455,Newport News (city),Newport News (city),51,700,Virginia,VA
51710,51CS041,1697,1593,1802,1896,199,94,303,123,-0.09094314358041637,0.3146449052735675,0.7425709990290744,0.6163986456822195,2092,1967,2218,2445,353,227,478,216,0.07496380323629726,0.6835154038585174,1.2745726560300616,0.6104412364346276,243257,243257,Norfolk (city),Norfolk (city),51,710,Virginia,VA
51139,51CS042,254,244,264,319,65,55,75,36,0.7804533448407955,1.207030658317796,1.6369663886786407,0.545619327839215,311,299,323,358,47,35,59,53,-0.9987712267415695,-0.3111999759006094,0.37128985460895947,1.104250534460681,23935,23935,Page+Shenandoah,Page,51,139,Virginia,VA
51171,51CS042,428,409,447,544,116,97,135,62,0.7743866177478635,1.240326541671896,1.7028221732933084,0.5285849741738061,525,502,548,639,114,91,137,103,-0.3410049291699709,0.32708191038624684,0.9303363574591103,0.8951752086046344,43702,43702,Page+Shenandoah,Shenandoah,51,171,Virginia,VA
51740,51CS043,890,849,931,1065,175,134,216,85,0.5676439821459278,0.94995791787833,1.389051858852461,0.48200621341823263,1085,1036,1134,1342,257,208,306,151,0.7556048107012878,1.358176439112576,1.969380947828665,0.5860279777793723,94795,94795,Portsmouth (city),Portsmouth (city),51,740,Virginia,VA
51029,51CS044,149,141,156,174,25,18,33,23,-0.30103048489190004,0.15303987717028714,0.5868767093743348,0.8745818694874039,184,175,192,222,38,30,47,21,0.6122046159160831,1.2268697551983692,1.8072346108422523,0.5333853830151897,17148,17148,Prince Edward and Nearby Counties,Buckingham,51,29,Virginia,VA
51037,51CS044,148,143,153,161,13,8,18,13,-0.4480414804099702,-0.008087533744960265,0.4317113206946857,0.9304141919847922,181,175,187,236,55,49,61,32,1.6766759108294602,2.3182774696992903,2.907774150039717,0.5729276699136676,11837,11837,Prince Edward and Nearby Counties,Charlotte,51,37,Virginia,VA
51049,51CS044,85,84,86,102,17,16,18,8,0.7713133184320735,0.8783067280854572,0.9866617935936155,0.45015152300793126,105,104,106,130,25,24,26,13,1.2967017503935947,1.452868459386473,1.6092564340384143,0.49890448703134166,9953,9953,Prince Edward and Nearby Counties,Cumberland,51,49,Virginia,VA
51065,51CS044,209,198,221,223,14,2,25,14,-0.4496206639259824,-0.0019067904637662394,0.39327858760814155,0.9582015407680028,260,245,274,290,30,16,45,19,-0.15845881099351336,0.5203922475867071,1.1222918635046548,0.6056033523902706,27331,27331,Prince Edward and Nearby Counties,Fluvanna,51,65,Virginia,VA
51147,51CS044,209,199,219,222,13,3,23,17,-0.5838569872677946,-0.15520312913224546,0.2678619471777435,1.1851295977424032,257,246,269,273,16,4,27,25,-1.1252793763634452,-0.4721064646603248,0.11180779094950606,1.5117883242028043,22902,22902,Prince Edward and Nearby Counties,Prince Edward,51,147,Virginia,VA
51153,51CS045,1744,1540,1949,2300,556,351,760,324,0.06814427796019705,0.4993856213440968,0.9183201712831098,0.5817938035150829,2203,1957,2448,2641,438,193,684,274,-0.20708840613899784,0.41573995514513185,1.0424216491304799,0.6236219837749174,473340,473340,Prince William,Prince William,51,153,Virginia,VA
51155,51CS046,387,372,401,452,65,51,80,47,0.09915780191376808,0.5452300067242742,1.007428274897945,0.7074258266066396,473,456,491,578,105,87,122,60,0.9652910435182098,1.5646592253256633,2.173995897630274,0.568316740375008,33978,33978,Pulaski+Radford (city),Pulaski,51,155,Virginia,VA
51750,51CS046,112,110,114,103,-9,-11,-7,3,-0.7609108851627104,-0.6609807088892024,-0.5476114931508284,-0.37526967261882016,138,136,141,139,1,-2,3,16,-1.1645500107883673,-1.0086206274999758,-0.8586165756916756,9.704622605220992,18169,18169,Pulaski+Radford (city),Radford (city),51,750,Virginia,VA
51760,51CS047,1609,1509,1709,1732,123,23,223,138,-0.48932648404237217,-0.05769083737156439,0.3756798373619866,1.1138829417748946,1988,1868,2108,2295,307,187,427,224,-0.20417156028375574,0.4343088447804104,1.0960256564436062,0.7267514745869516,231527,231527,Richmond (city),Richmond (city),51,760,Virginia,VA
51770,51CS048,1036,994,1079,1284,248,205,290,107,0.9866824894118718,1.4228585480044518,1.8022115795466445,0.43021462402720917,1270,1218,1321,1468,198,147,250,117,0.3420902564042871,0.983240065194536,1.5979661560133755,0.5867902810346786,99150,99150,Roanoke (city),Roanoke (city),51,770,Virginia,VA
51081,51CS049,127,125,128,138,11,10,13,21,-0.9428417398688871,-0.8387305370900814,-0.7366495324503477,1.6806216906182325,155,154,157,161,6,4,7,16,-1.2711711775960477,-1.1178383315307592,-0.9456328009796905,2.4485521359479363,11285,11285,Southampton and Nearby Counties and Independent Cities,Greensville,51,81,Virginia,VA
51093,51CS049,306,290,323,352,46,29,62,27,0.052417935583364876,0.4880018162364365,0.87777327559504,0.5803367706073558,376,357,396,476,100,80,119,55,0.8059130343026495,1.4476982100159186,2.0139080283088493,0.545976673784426,37535,37535,Southampton and Nearby Counties and Independent Cities,Isle of Wight,51,93,Virginia,VA
51175,51CS049,156,149,164,194,38,30,45,33,-0.15606390456085006,0.2637952412783936,0.6966068413116088,0.8568752515432541,191,182,201,258,67,57,76,29,1.9361643723677917,2.539378027602946,3.1234587453065137,0.42951747168291676,17730,17730,Southampton and Nearby Counties and Independent Cities,Southampton,51,175,Virginia,VA
51181,51CS049,68,67,68,74,6,6,7,6,-0.03659415320631513,0.07242032715078348,0.18060345872099584,0.8044380321080044,83,82,84,101,18,17,19,3,2.6422254828573615,2.802818609236417,2.9657056918282154,0.1583647820634646,6398,6398,Southampton and Nearby Counties and Independent Cities,Surry,51,181,Virginia,VA
51183,51CS049,116,115,118,125,9,7,10,17,-0.8737890461064189,-0.7654147420941466,-0.663716039157371,1.7857427142619855,143,142,145,176,33,31,34,20,1.2292456406162098,1.3897218417969108,1.544368714016721,0.5923360997590393,11022,11022,Southampton and Nearby Counties and Independent Cities,Sussex,51,183,Virginia,VA
51595,51CS049,48,48,49,110,62,61,62,21,7.535861616207326,7.637113077410741,7.732419346839001,0.33432922645475444,59,59,60,95,36,35,36,7,6.277320272041389,6.430732111048183,6.599661139169403,0.19108620888146668,5346,5346,Southampton and Nearby Counties and Independent Cities,Emporia (city),51,595,Virginia,VA
51620,51CS049,131,127,134,132,1,-2,5,20,-2.785557775666463,-2.3564962758444867,-1.9421136910975203,8.248495552197623,158,154,162,179,21,17,25,18,-0.20798888282887293,0.3991616146325972,1.0062060027450206,0.8310215953313672,7853,7853,Southampton and Nearby Counties and Independent Cities,Franklin (city),51,620,Virginia,VA
51179,51CS050,714,646,781,751,37,-30,105,36,-0.40907085222068057,-0.0028291146438976177,0.4651046032413381,0.935893188623964,894,814,975,1028,134,53,214,87,-0.2798437669767965,0.3532618981487084,0.9855168548005223,0.6467403820931539,155014,155014,Stafford,Stafford,51,179,Virginia,VA
51800,51CS051,678,638,719,838,160,119,200,83,0.3794723514064394,0.8196449737456619,1.2710418003809898,0.5166667503234424,837,788,885,1062,225,177,274,140,0.5039053397771853,1.088097229806705,1.7587127439288834,0.6192630441636051,92959,92959,Suffolk (city),Suffolk (city),51,800,Virginia,VA
51099,51CS052,172,161,184,196,24,12,35,16,-0.18007543180403016,0.27559462897217607,0.7564959602685143,0.6491904924746622,216,202,230,201,-15,-29,-1,17,-2.0924735118707543,-1.426133213870488,-0.7581629456853435,-1.2110759113254421,27148,27148,Westmoreland and Nearby Counties,King George,51,99,Virginia,VA
51103,51CS052,185,180,189,196,11,7,16,5,0.15982044946205917,0.5870139931081825,1.0332090194302852,0.40731842679039604,225,220,231,241,16,10,21,17,-0.7324545072544795,-0.13097055007414257,0.4881274942056804,1.0082361492291263,10619,10619,Westmoreland and Nearby Counties,Lancaster,51,103,Virginia,VA
51133,51CS052,157,152,162,177,20,15,25,12,0.2429062399680139,0.6750404989419747,1.0933560101737838,0.5665142385811515,192,186,198,245,53,47,59,28,1.8498873692323192,2.4681771992869717,3.0577994711819425,0.5197395872529431,12069,12069,Westmoreland and Nearby Counties,Northumberland,51,133,Virginia,VA
51159,51CS052,107,106,108,106,-1,-2,-0,5,-0.8221164764632094,-0.7082062688243425,-0.6075647270195881,-11.73602141917154,132,131,133,132,0,-1,1,10,-1.4620940026807585,-1.3099872519765072,-1.149602300224025,9.154290929196629,9068,9068,Westmoreland and Nearby Counties,Richmond (county),51,159,Virginia,VA
51193,51CS052,210,202,217,230,20,13,28,16,-0.1852359890415784,0.24943589234661973,0.6656153519739146,0.7489811601112102,258,248,267,256,-2,-11,8,28,-2.5639139857185564,-1.9696728182835581,-1.357224452986982,-43.770504478205574,18079,18079,Westmoreland and Nearby Counties,Westmoreland,51,193,Virginia,VA
51199,51CS053,395,366,425,453,58,28,87,21,0.1031329690510553,0.520893125460882,0.9875186138030901,0.3582170177257232,493,457,529,628,135,99,171,63,0.614274493891098,1.2698531802669357,1.8403368168189536,0.46267687072481,68837,68837,York,York,51,199,Virginia,VA
53001,53CS001,107,105,109,110,3,1,5,18,-0.8597546475289587,-0.7455543763134775,-0.6417502084597754,4.424495359106309,131,129,134,155,24,21,26,18,0.18245381541398598,0.3357745729885992,0.49149742687147846,0.7327089702996121,19987,19987,Adams+Grant,Adams,53,1,Washington,WA
53025,53CS001,614,571,656,710,96,54,139,82,-0.2599563738473715,0.13622924163109038,0.5626665977073465,0.8420830173613542,758,706,809,911,153,102,205,120,-0.183261100304971,0.40514837255349845,1.0296446260618963,0.7775013590447932,98550,98550,Adams+Grant,Grant,53,25,Washington,WA
53003,53CS002,222,212,232,266,44,34,54,22,0.5440964097304238,0.9621041291444612,1.4261929755429992,0.48718209813547125,271,259,283,289,18,6,30,29,-1.2188386183623832,-0.5762459112824191,0.037701233491077145,1.5429843518085318,22742,22742,Asotin+Columbia+Garfield+Whitman,Asotin,53,3,Washington,WA
53013,53CS002,48,48,49,52,4,3,4,3,0.04948199982151358,0.15857550777186963,0.2673100495069177,0.6464556440979687,59,59,60,74,15,14,15,1,3.9996854453964574,4.151745066451641,4.306492413065536,0.06272526584300202,4033,4033,Asotin+Columbia+Garfield+Whitman,Columbia,53,13,Washington,WA
53023,53CS002,24,23,25,24,0,-1,1,5,-2.5158528993179297,-2.0788000081831868,-1.648113134242179,3.9523927231315077,29,28,30,32,3,2,4,5,-1.6765584405697957,-1.0427321063379884,-0.3702568929588664,1.248529108532648,2276,2276,Asotin+Columbia+Garfield+Whitman,Garfield,53,23,Washington,WA
53075,53CS002,237,216,258,270,33,12,54,25,-0.25154159038088486,0.1692055065092793,0.6085874489029535,0.7337305126686378,295,269,320,396,101,76,127,44,0.7519711984699486,1.370985234393947,1.9572181067363688,0.4294393133664327,49871,49871,Asotin+Columbia+Garfield+Whitman,Whitman,53,75,Washington,WA
53005,53CS003,1292,1203,1381,1520,228,139,317,149,-0.029240101928310853,0.3900505022410909,0.820764948946974,0.6500679716674039,1593,1487,1700,1904,311,204,417,227,-0.10698752888545941,0.5074804660217819,1.151092302129661,0.7282212117597547,205112,205112,Benton,Benton,53,5,Washington,WA
53007,53CS004,604,571,638,653,49,15,82,40,-0.3230353279840744,0.10028773385836344,0.5648306869984787,0.8074730276774883,744,704,784,832,88,48,128,73,-0.3759021334450714,0.21108693632915468,0.8493183141187455,0.8169163676627872,77270,77270,Chelan+Kittitas,Chelan,53,7,Washington,WA
53037,53CS004,292,271,313,302,10,-11,31,29,-0.7882203848254347,-0.4019827458373263,0.054243477658096395,2.6464496314064707,363,337,388,384,21,-4,47,30,-0.866238668432755,-0.2109582926866099,0.415645829339876,1.3402107274427362,48418,48418,Chelan+Kittitas,Kittitas,53,37,Washington,WA
53009,53CS005,902,868,935,917,15,-18,49,6,-0.30997629631959506,0.12212919321933453,0.5485707018469119,0.3647142330270055,1105,1065,1145,1255,150,110,190,75,0.5743076958981506,1.1301026122045494,1.7952251484968211,0.49650185242852457,77711,77711,Clallam+Jefferson,Clallam,53,9,Washington,WA
53031,53CS005,343,329,357,350,7,-7,21,3,-0.30396037606553467,0.12022454784421506,0.5159645345350277,0.38715757769964626,422,405,439,448,26,9,43,18,-0.2954222695762022,0.30241168080966635,0.9394843175027124,0.6581064539731667,32494,32494,Clallam+Jefferson,Jefferson,53,31,Washington,WA
53011,53CS006,3173,2960,3387,3577,404,190,617,137,0.12566307616891517,0.5276069775853116,0.9810159449314011,0.3385926455844548,3928,3671,4184,4642,714,458,971,409,0.1521077880956341,0.729820980416907,1.3928580635178582,0.5717673726277424,492435,492435,Clark,Clark,53,11,Washington,WA
53015,53CS007,1058,1010,1106,1084,26,-22,74,25,-0.4075268794087386,0.006854958724683754,0.439641396347415,0.9307728824092826,1299,1242,1357,1587,288,230,345,229,0.051311132189816776,0.6231781847386305,1.2937256254555065,0.7926381872084516,110798,110798,Cowlitz+Klickitat+Skamania+Wahkiakum,Cowlitz,53,15,Washington,WA
53039,53CS007,182,172,192,177,-5,-15,5,5,-0.8698799879981177,-0.42831943024632463,-0.009432983579010807,-1.3022437982766821,224,212,236,296,72,60,84,26,1.8545895629884024,2.4431514174818525,3.0423190468996753,0.3571731917231583,22543,22543,Cowlitz+Klickitat+Skamania+Wahkiakum,Klickitat,53,39,Washington,WA
53059,53CS007,83,81,84,86,3,2,5,7,-0.3924444601716063,-0.2847400299144142,-0.17586114014633092,1.5564590710168478,102,100,103,105,3,2,5,2,-0.03853454626355588,0.11888023475930506,0.2694466523965377,0.4755301884283931,12101,12101,Cowlitz+Klickitat+Skamania+Wahkiakum,Skamania,53,59,Washington,WA
53069,53CS007,43,43,44,41,-2,-3,-2,2,-1.082389004687009,-0.9834195281641592,-0.8777148597512137,-1.4684296183055263,53,53,54,68,15,14,15,2,3.26477171339441,3.4283679718601463,3.579226820397683,0.12717505825017852,4452,4452,Cowlitz+Klickitat+Skamania+Wahkiakum,Wahkiakum,53,69,Washington,WA
53017,53CS008,270,251,288,283,13,-5,32,13,-0.4309437098387636,0.00346006204078574,0.4655446943937437,0.903532324507529,333,310,355,387,54,32,77,42,-0.31051788487720616,0.30983487462234,0.9424658142630282,0.763253278176598,43380,43380,Douglas+Okanogan,Douglas,53,17,Washington,WA
53047,53CS008,388,370,406,413,25,7,43,33,-0.6299559749020723,-0.18459751623393825,0.27196860999361994,1.2670957719469154,475,453,497,562,87,65,109,76,-0.36239117890611533,0.33675407521101924,0.9858330407266667,0.8615816859953187,42493,42493,Douglas+Okanogan,Okanogan,53,47,Washington,WA
53019,53CS009,71,71,72,85,14,13,14,6,0.8862292308441989,0.995511250510814,1.0976463481890264,0.4090681776176977,87,86,88,133,46,45,47,12,5.064931789086941,5.216931815376882,5.388805664890172,0.25798114121591087,7711,7711,Ferry+Lincoln+Pend Oreille+Stevens,Ferry,53,19,Washington,WA
53043,53CS009,101,100,102,102,1,0,2,9,-0.8009303759988841,-0.6989247876935494,-0.592178841007506,3.883093434252346,123,122,125,144,21,19,22,20,-0.0997555740902096,0.05636728405728701,0.21561363829051555,0.9298736400662615,11001,11001,Ferry+Lincoln+Pend Oreille+Stevens,Lincoln,53,43,Washington,WA
53051,53CS009,146,140,152,144,-2,-8,4,5,-0.9520477278523378,-0.5237330284519464,-0.09025904138775191,-4.094290585323665,179,171,186,236,57,50,65,23,2.3337032261594257,2.9845934831919707,3.5735123932493797,0.3933952478126854,13900,13900,Ferry+Lincoln+Pend Oreille+Stevens,Pend Oreille,53,51,Washington,WA
53065,53CS009,405,385,425,432,27,7,47,21,-0.31120524738856425,0.12517771521462778,0.5658488573600595,0.7551478893318645,495,471,519,631,136,112,160,101,0.2533026617191237,0.9137401928521272,1.5641129830736356,0.7389890934532893,46042,46042,Ferry+Lincoln+Pend Oreille+Stevens,Stevens,53,65,Washington,WA
53021,53CS010,365,324,407,454,89,47,130,69,-0.2023360240410851,0.20221745240363614,0.6824405341703705,0.7688300138794505,461,411,512,554,93,42,143,95,-0.6389869213310697,-0.039774020353203064,0.5954598640367086,1.015111155122902,96125,96125,Franklin,Franklin,53,21,Washington,WA
53027,53CS011,756,723,788,800,44,12,77,28,-0.229464756355288,0.21816341899411582,0.6547953669818494,0.6168459165482175,926,887,965,1133,207,168,246,116,0.8291788006490857,1.4721764077316473,2.0883584071632937,0.5573763232181557,75423,75423,Grays Harbor+Pacific,Grays Harbor,53,27,Washington,WA
53049,53CS011,292,282,302,268,-24,-34,-14,4,-1.6180975036831813,-1.2266796197490744,-0.7842805267027728,-0.17586110790654944,356,344,368,412,56,44,68,30,0.7380339022340457,1.3453861655113801,1.986928956017949,0.5283214255817781,22712,22712,Grays Harbor+Pacific,Pacific,53,49,Washington,WA
53029,53CS012,682,645,719,704,22,-15,59,30,-0.5365746174940594,-0.08506366156750235,0.3237998289992273,1.2803535534494679,838,794,883,907,69,24,113,41,-0.24547565216963532,0.3795966204102103,0.9307030389189034,0.5888263861742645,85623,85623,Island,Island,53,29,Washington,WA
53033,53CS013,11621,10643,12598,12136,515,-462,1493,976,-0.6147886481763606,-0.1951906471744998,0.20997595194504676,1.8901801860254441,14444,13269,15619,15033,589,-586,1764,734,-0.6802799367418221,-0.0771477495283067,0.5767116379564523,1.2445297117866507,2259929,2259929,King,King,53,33,Washington,WA
53035,53CS014,1955,1838,2073,2012,57,-61,174,41,-0.3884092872040567,0.06368267738311902,0.4714865647760694,0.7094322316321836,2408,2267,2549,2647,239,98,380,192,-0.3447811070837911,0.1910999938418349,0.8178263854892048,0.8007788196036452,272502,272502,Kitsap,Kitsap,53,35,Washington,WA
53041,53CS015,811,775,846,863,52,17,88,31,-0.1988777114841809,0.2702485141144865,0.6652306025251936,0.5802682054215,992,950,1035,1129,137,94,179,145,-0.7288660168284685,-0.1202446866237151,0.4944801526902277,1.0537205227797226,81228,81228,Lewis,Lewis,53,41,Washington,WA
53045,53CS016,620,591,649,623,3,-26,32,13,-0.5873847698222503,-0.15071054220005922,0.29623874310153514,3.3871124900503675,759,724,795,875,116,80,151,75,0.12708958956701347,0.7193446782873897,1.3467481717068075,0.6427548148394103,67474,67474,Mason,Mason,53,45,Washington,WA
53053,53CS017,5967,5574,6360,6198,231,-162,624,304,-0.5183398329626203,-0.09585840080692483,0.38671220184939237,1.3123188273531545,7364,6892,7836,8216,852,380,1324,627,-0.3630762230416145,0.26598414838438134,0.9545557190019566,0.7351994181273813,909124,909124,Pierce,Pierce,53,53,Washington,WA
53055,53CS018,128,126,130,124,-4,-6,-2,7,-0.754854768808457,-0.6463393236953994,-0.5439832525092497,-2.1632803818952193,157,155,159,159,2,-0,4,7,-0.5107670380629401,-0.3530580471997804,-0.20939156735569228,2.4823800775919707,17410,17410,San Juan+Skagit,San Juan,53,55,Washington,WA
53057,53CS018,1069,1013,1125,1128,59,3,115,43,-0.3518073700129076,0.11981032711924142,0.5834028886569768,0.7168424561019117,1307,1239,1374,1535,228,161,296,96,0.5913570937921242,1.2263590625222456,1.8363483794721995,0.41847716693409664,129851,129851,San Juan+Skagit,Skagit,53,57,Washington,WA
53061,53CS019,4827,4470,5184,5226,399,42,756,368,-0.3767479412643885,0.05112991709747551,0.47074526891393675,0.9198177256725648,5975,5546,6404,6381,406,-23,835,348,-0.4973161130167346,0.06562297207441001,0.7088082662648011,0.8556484522967799,825738,825738,Snohomish,Snohomish,53,61,Washington,WA
53063,53CS020,4085,3858,4312,4498,413,186,640,289,-0.19886739106047985,0.23524402332256572,0.6751531357451475,0.6975293614806791,5016,4743,5289,5861,845,572,1118,641,-0.1828252084558327,0.45370173254073093,1.085493554441261,0.7577410360660336,524728,524728,Spokane,Spokane,53,63,Washington,WA
53067,53CS021,2050,1924,2177,2101,51,-76,177,57,-0.4541070084741065,-0.011021090235985943,0.42115772094101417,1.1011645902305134,2530,2378,2682,2906,376,224,528,201,0.12239071626488773,0.7199255720537239,1.3145301219226966,0.5327459088417896,291500,291500,Thurston,Thurston,53,67,Washington,WA
53071,53CS022,499,472,525,541,42,16,69,37,-0.34236858618093613,0.08847109046970314,0.536076953155868,0.8569318384529139,610,579,642,711,101,69,132,63,0.15715156997426086,0.7258086493175964,1.340969571395279,0.6198399768467429,61158,61158,Walla Walla,Walla Walla,53,71,Washington,WA
53073,53CS023,1509,1410,1609,1570,61,-39,160,56,-0.4384183163422035,0.02701941690931369,0.4081414356146103,0.9091438631563368,1863,1744,1982,2081,218,99,337,129,-0.09418206606112439,0.47845646399177016,1.0801928011577033,0.5888256602792357,229650,229650,Whatcom,Whatcom,53,73,Washington,WA
53077,53CS024,1737,1628,1845,2127,390,282,499,303,-0.05754012520728902,0.3355159627013096,0.740856382049707,0.7744295765788994,2141,2011,2271,2535,394,264,524,308,-0.1638638703578559,0.4057326183083887,1.0323190800570885,0.7795150046414696,251688,251688,Yakima,Yakima,53,77,Washington,WA
54001,54CS001,164,157,171,211,47,40,54,12,1.6817598498641237,2.107249254898619,2.578444865764526,0.2509336484972875,201,192,209,251,50,42,59,35,0.4959342806019909,1.1090790219373838,1.7144751378996081,0.6847861839828143,16457,16457,Barbour+Pocahontas+Randolph+Tucker,Barbour,54,1,West Virginia,WV
54075,54CS001,87,86,88,99,12,11,13,3,0.9514262918722963,1.0568133158646198,1.1612096245481953,0.23627856492739,107,106,109,134,27,25,28,14,1.6687948048707226,1.8235543545111326,1.987026316008023,0.5084745631723415,8239,8239,Barbour+Pocahontas+Randolph+Tucker,Pocahontas,54,75,West Virginia,WV
54083,54CS001,305,293,317,323,18,6,30,4,0.05555145206510379,0.47563206846414974,0.9067265843174357,0.21309561984325803,373,358,387,448,75,61,90,55,0.28292484865003326,0.8508352628863096,1.5402296370143798,0.7207653557045168,28552,28552,Barbour+Pocahontas+Randolph+Tucker,Randolph,54,83,West Virginia,WV
54093,54CS001,77,77,78,101,24,23,24,4,2.759955586957865,2.8656638505139376,2.967935333225604,0.16216544042465722,95,94,96,112,17,16,18,24,-1.4048811102484586,-1.2462872112330272,-1.0941751479515802,1.3427973610751596,6860,6860,Barbour+Pocahontas+Randolph+Tucker,Tucker,54,93,West Virginia,WV
54003,54CS002,950,898,1003,1158,208,155,260,65,0.77056541518565,1.1712802441333774,1.610792532365148,0.3114037745837062,1171,1107,1234,1449,278,215,342,186,0.29192433839227055,0.8970180404763985,1.6093642613434946,0.6656346940155152,120666,120666,Berkeley+Morgan,Berkeley,54,3,West Virginia,WV
54065,54CS002,194,187,202,203,9,1,16,4,-0.18392278466975975,0.26121084396236877,0.7175007773048233,0.41216405097306447,237,228,247,272,35,25,44,48,-1.5010099061742657,-0.9015101657796838,-0.29361961882731624,1.3439587149550476,17874,17874,Berkeley+Morgan,Morgan,54,65,West Virginia,WV
54005,54CS003,266,257,275,298,32,23,41,14,0.3864338821098784,0.824489991823441,1.2566742500280292,0.42669982450105953,326,316,337,379,53,42,63,35,0.333008872728376,1.0062005727674839,1.5824310296655595,0.6541250806232278,21228,21228,Boone+Lincoln+Logan,Boone,54,5,West Virginia,WV
54043,54CS003,239,231,248,271,32,23,40,11,0.5820661251637314,1.0274381582709085,1.43037307179537,0.3375964196960246,294,284,304,365,71,61,81,46,0.8789145510899703,1.5006368092755733,2.142216973298344,0.6379231823687443,20282,20282,Boone+Lincoln+Logan,Lincoln,54,43,West Virginia,WV
54045,54CS003,458,444,472,518,60,46,74,56,-0.2662550204208961,0.12700252876963428,0.5647033469168083,0.9164179178562342,560,544,577,669,109,92,125,77,0.5620182301435709,1.2012986321544534,1.8355729231824602,0.7015155007381917,31864,31864,Boone+Lincoln+Logan,Logan,54,45,West Virginia,WV
54007,54CS004,151,145,157,153,2,-4,8,4,-0.5715569032745931,-0.134073575899674,0.3062027697912737,1.2655819115205202,184,176,191,199,15,8,23,22,-1.1567122437432589,-0.5810600994264786,0.09062614960223492,1.33769541411308,13814,13814,Braxton+Gilmer+Lewis+Upshur,Braxton,54,7,West Virginia,WV
54021,54CS004,73,72,73,80,7,7,8,1,0.7029872170491024,0.8062522830765205,0.9134511725960334,0.11956189192741941,89,88,90,85,-4,-5,-3,13,-2.7855198775648886,-2.63580039934486,-2.4780840047429233,-4.012837977332426,7856,7856,Braxton+Gilmer+Lewis+Upshur,Gilmer,54,21,West Virginia,WV
54041,54CS004,196,189,203,214,18,11,25,5,0.381543388905637,0.8022140559433459,1.2068907446976593,0.2652671565662678,238,230,247,331,93,84,101,59,1.8896134800961764,2.545879521111279,3.144280026498982,0.6308560706241089,15847,15847,Braxton+Gilmer+Lewis+Upshur,Lewis,54,41,West Virginia,WV
54097,54CS004,227,217,238,255,28,17,38,8,0.38967166107505347,0.7987457544742288,1.235921468200569,0.278720410862097,278,265,290,334,56,44,69,61,-0.8248470433929919,-0.21513967256603164,0.35203294495462417,1.061968511014944,24280,24280,Braxton+Gilmer+Lewis+Upshur,Upshur,54,97,West Virginia,WV
54009,54CS005,267,258,277,350,83,73,92,37,1.6886984265030969,2.1008119593634085,2.5377604880838205,0.44158684274846505,325,314,337,418,93,81,104,57,1.3653364293522776,1.9447536486139994,2.5576548950019578,0.6091235977844224,21820,21820,Brooke+Hancock,Brooke,54,9,West Virginia,WV
54029,54CS005,358,345,370,452,94,82,107,63,0.6398582561574742,1.104056925383662,1.5253990510154136,0.6608509252613413,436,421,450,501,65,51,80,84,-1.3829816864016722,-0.7499484371616085,-0.15919750676932462,1.2644430100334174,28724,28724,Brooke+Hancock,Hancock,54,29,West Virginia,WV
54011,54CS006,1074,1035,1114,1171,97,57,136,95,-0.3950447095783174,0.008593284101683805,0.46671181408853507,0.9727384396650403,1315,1267,1362,1490,175,128,223,154,-0.32259228588444844,0.266558214920836,0.914182325674356,0.8729271671618788,91769,91769,Cabell,Cabell,54,11,West Virginia,WV
54015,54CS007,100,99,101,112,12,11,13,6,0.631186956167503,0.7311184919721432,0.8290794942190687,0.455424496146092,123,122,124,146,23,22,24,20,0.31441913695173906,0.47117506631353245,0.6243731975917609,0.8217580997547159,8437,8437,Clay+Fayette+Nicholas+Webster,Clay,54,15,West Virginia,WV
54019,54CS007,538,520,556,574,36,18,54,39,-0.49434531251404845,-0.06725119105263468,0.3770601029408008,1.052530319233422,659,637,681,752,93,71,115,82,-0.32237660471990665,0.3188521763262993,0.9348578973385946,0.873680261646768,42318,42318,Clay+Fayette+Nicholas+Webster,Fayette,54,19,West Virginia,WV
54067,54CS007,283,272,293,291,8,-2,19,4,-0.27179386787695486,0.19160206480754893,0.6302680220571427,0.4227808435021232,347,334,360,419,72,59,85,70,-0.46857545123885513,0.11430278885278664,0.7428231343416255,0.9586441749427329,24474,24474,Clay+Fayette+Nicholas+Webster,Nicholas,54,67,West Virginia,WV
54101,54CS007,103,102,104,103,0,-1,1,8,-1.065393123340128,-0.9554580895619773,-0.8515857529217709,6.4546242438922254,126,125,127,144,18,17,19,26,-1.3655908218463673,-1.210758402467526,-1.0503902220376742,1.3819885205200275,8129,8129,Clay+Fayette+Nicholas+Webster,Webster,54,101,West Virginia,WV
54025,54CS008,424,410,439,472,48,33,62,41,-0.23605623413361326,0.19120201352441185,0.6119853126753223,0.8419987327791603,519,502,537,609,90,72,107,78,-0.25357412572676225,0.38494515651068445,0.9997968916272617,0.8614210271578565,34503,34503,Greenbrier+Monroe+Summers,Greenbrier,54,25,West Virginia,WV
54063,54CS008,157,151,163,183,26,20,32,16,0.2974238584073094,0.7433617405162936,1.1539252495510657,0.5963719688882568,193,186,199,220,27,21,34,18,0.26168837887817276,0.8407291653758481,1.4643913259462833,0.6347537591205494,13268,13268,Greenbrier+Monroe+Summers,Monroe,54,63,West Virginia,WV
54089,54CS008,169,164,174,187,18,13,23,10,0.19544411562811326,0.6426777328891125,1.0547690103582734,0.5296225774011042,207,200,213,247,40,34,47,23,1.0749360175982599,1.6785756616481058,2.2843671500122884,0.5567402723025519,12498,12498,Greenbrier+Monroe+Summers,Summers,54,89,West Virginia,WV
54023,54CS009,120,119,121,143,23,22,24,22,0.007571369430805596,0.10866835894144435,0.21399711671010563,0.9062845846693153,147,146,149,168,21,19,22,27,-0.7969883005740055,-0.646834656946388,-0.4908839800774293,1.2377565066408955,11496,11496,Hardy and Nearby Counties,Grant,54,23,West Virginia,WV
54027,54CS009,238,228,248,268,30,20,40,23,-0.16663198927603892,0.27365893891252147,0.7422147614993263,0.7487077608418891,293,281,305,341,48,36,60,46,-0.4953538838183158,0.11190858840418677,0.7154408347292159,0.9307310467092162,23203,23203,Hardy and Nearby Counties,Hampshire,54,27,West Virginia,WV
54031,54CS009,145,139,151,171,26,20,32,9,0.8190789035921959,1.2384172494056682,1.6554957386903801,0.33038304503820326,177,170,184,200,23,16,30,36,-1.7664241636510734,-1.1843056526256994,-0.5652138403998022,1.5267419728158163,13745,13745,Hardy and Nearby Counties,Hardy,54,31,West Virginia,WV
54057,54CS009,286,274,297,353,67,56,79,70,-0.5097809743993863,-0.09371064283862734,0.3232846042907755,1.0228285774486783,350,336,364,405,55,41,69,69,-1.2043136042737845,-0.6325436720595843,-0.03506768588364487,1.2355715113011687,26828,26828,Hardy and Nearby Counties,Mineral,54,57,West Virginia,WV
54071,54CS009,81,81,82,100,19,18,19,0,2.56787958178932,2.676417873818849,2.7754809814618984,0,100,99,101,110,10,9,11,10,-0.14371306373336312,0.003227812465652944,0.1605099604851616,0.9061162624923607,6948,6948,Hardy and Nearby Counties,Pendleton,54,71,West Virginia,WV
54033,54CS010,726,697,755,724,-2,-31,27,27,-0.9061377352729529,-0.4288979430764223,-0.03371200706116253,-27.858455594760713,885,851,920,1044,159,124,193,149,-0.401492503063417,0.1678353576927002,0.7981267003287433,0.934139330019753,67144,67144,Harrison+Taylor,Harrison,54,33,West Virginia,WV
54091,54CS010,172,165,180,209,37,29,44,10,1.166473075655374,1.5929795771389106,2.0209786332180864,0.2659490990729793,211,202,219,250,39,31,48,35,-0.32374977077194605,0.3000303402047801,0.9317490134065545,0.8658845760401349,16704,16704,Harrison+Taylor,Taylor,54,91,West Virginia,WV
54013,54CS011,78,77,78,86,8,8,9,3,0.6593923515013246,0.7618372295358856,0.8759567073520438,0.32085129439158167,95,94,96,115,20,19,21,5,2.3312382678472026,2.4927883344007373,2.6418902809780564,0.242840474752667,7022,7022,Jackson and Nearby Counties,Calhoun,54,13,West Virginia,WV
54035,54CS011,312,300,325,347,35,22,47,28,-0.19723737455432716,0.23082877215500824,0.6693219792570433,0.7844901965115216,384,369,399,439,55,40,70,62,-0.9293054209595053,-0.2935890412419036,0.2790736506552654,1.1097031337638863,28574,28574,Jackson and Nearby Counties,Jackson,54,35,West Virginia,WV
54053,54CS011,308,296,319,332,24,13,36,22,-0.31116735903536236,0.08723192673654288,0.5327217243660367,0.8682938691172347,378,364,391,466,88,75,102,54,0.9046734332783917,1.5539407986677305,2.1457399778956954,0.6053261323647215,26473,26473,Jackson and Nearby Counties,Mason,54,53,West Virginia,WV
54087,54CS011,175,169,181,170,-5,-11,1,5,-1.1607246323916631,-0.7186887315051164,-0.3004061333738022,-1.3323739401072425,214,207,221,223,9,2,16,22,-1.7862229607015014,-1.1329511480672643,-0.5224451089680892,2.2056885675197613,13581,13581,Jackson and Nearby Counties,Roane,54,87,West Virginia,WV
54105,54CS011,53,52,53,53,0,-0,1,7,-1.2533293353656927,-1.145017669867292,-1.0388339066936845,4.885666331209758,65,64,65,83,18,18,19,13,0.9464936372676236,1.099475554404587,1.2595889486792045,0.6745324803082361,5750,5750,Jackson and Nearby Counties,Wirt,54,105,West Virginia,WV
54037,54CS012,428,403,453,505,77,52,102,36,0.30316114551821244,0.7309896500164714,1.1425606304206657,0.46076560288593427,527,498,557,579,52,22,81,66,-0.9183030972793169,-0.2890360876292442,0.32981618735510515,1.2510407766969311,57405,57405,Jefferson,Jefferson,54,37,West Virginia,WV
54039,54CS013,2099,2023,2174,2484,385,310,461,189,0.6619521603215365,1.097289674629443,1.5182492193741859,0.4891122143900153,2561,2470,2652,2966,405,314,496,303,0.0968173989563826,0.6651353342742485,1.2753573074686522,0.746827822576628,177501,177501,Kanawha,Kanawha,54,39,West Virginia,WV
54047,54CS014,259,252,267,309,50,42,57,5,2.2005405493036267,2.5635149144985734,3.020894928168654,0.09863324753915637,315,306,324,388,73,64,82,60,0.32195651360305316,0.9151006795538698,1.496678365147398,0.8117318246835661,17315,17315,McDowell+Mercer,McDowell,54,47,West Virginia,WV
54055,54CS014,742,717,767,884,142,117,167,50,1.137090896250076,1.555242221494433,2.0248609148282544,0.34986111644462536,907,877,937,1100,193,163,223,149,0.28726673419713034,0.9038676726624453,1.5467041260128984,0.7676793001272699,58588,58588,McDowell+Mercer,Mercer,54,55,West Virginia,WV
54049,54CS015,600,576,624,608,8,-16,32,18,-0.6030786036511231,-0.18655198572880108,0.2374444687345371,2.090409029785601,733,704,762,841,108,79,137,118,-0.8187035165816013,-0.20125986998558665,0.42928893840030125,1.0848602998779298,56029,56029,Marion,Marion,54,49,West Virginia,WV
54051,54CS016,328,316,341,398,70,57,82,58,-0.02141140894316182,0.38439845789215,0.7879592153321848,0.8223780713107187,401,386,417,487,86,70,101,76,-0.24471026773977328,0.38550124104468836,1.0109067316598799,0.8771143066946973,30368,30368,Marshall+Ohio,Marshall,54,51,West Virginia,WV
54069,54CS016,488,471,506,600,112,94,129,47,1.1241706209318592,1.561910137324431,2.005902444890775,0.4169430128643024,596,575,617,692,96,75,117,73,0.0634262768017436,0.6914620054510504,1.2808122170506067,0.75192085451718,41441,41441,Marshall+Ohio,Ohio,54,69,West Virginia,WV
54059,54CS017,290,280,299,337,47,38,57,25,0.532502722572547,0.9680944587642054,1.387863241120813,0.5158180738525865,354,342,366,472,118,106,130,89,0.9236295859626891,1.5076233769446703,2.057326748394703,0.7489739383184211,23207,23207,Mingo+Wayne,Mingo,54,59,West Virginia,WV
54099,54CS017,441,424,458,527,86,69,103,29,1.0470962957698469,1.4648734399742251,1.9249076029085477,0.3324025389193443,541,521,561,678,137,117,157,88,0.8698657382185182,1.515572513371862,2.1253252087484213,0.636510142241009,39344,39344,Mingo+Wayne,Wayne,54,99,West Virginia,WV
54061,54CS018,610,564,656,671,61,15,107,33,-0.16229202421902658,0.27265085272468104,0.6785609468578213,0.5352571646045212,753,698,808,796,43,-12,98,99,-1.236344841062674,-0.6198695654537141,-0.022118752689638813,2.2352262117899206,106505,106505,Monongalia+Preston,Monongalia,54,61,West Virginia,WV
54077,54CS018,313,299,327,343,30,16,44,36,-0.6010289964538758,-0.17882006885948326,0.23705878032506283,1.1620903708956787,382,365,399,460,78,61,95,78,-0.6602037508095248,0.019765857300995702,0.6049532124983484,0.9844970079428504,33438,33438,Monongalia+Preston,Preston,54,77,West Virginia,WV
54079,54CS019,521,496,545,595,74,50,99,54,-0.06699102473240977,0.36693487482088527,0.8041046492985255,0.7171350586572346,639,610,668,706,67,38,96,62,-0.49330581734283563,0.09637293639943688,0.6985277192899297,0.9147238202801004,56474,56474,Putnam,Putnam,54,79,West Virginia,WV
54081,54CS020,886,855,917,1019,133,102,164,28,1.037932512723671,1.434713502942067,1.8595725267758172,0.209092169208968,1080,1043,1118,1290,210,172,247,140,0.5316460284988809,1.135458989850131,1.7015887361553212,0.6644228632022553,73351,73351,Raleigh+Wyoming,Raleigh,54,81,West Virginia,WV
54109,54CS020,257,249,266,319,62,53,70,23,1.4729619111508299,1.919715230169813,2.3166502496097325,0.36670741463247286,313,303,324,388,75,64,85,58,0.4050498241941625,1.009798701997749,1.6006443521444627,0.7656919032257657,20313,20313,Raleigh+Wyoming,Wyoming,54,109,West Virginia,WV
54017,54CS021,68,67,69,78,10,9,11,2,0.825629518813822,0.9233057875363568,1.0298942888016067,0.18550776046716974,84,83,85,93,9,8,10,12,-0.5803434057361792,-0.41905478409886326,-0.27379367456254133,1.1930629051966442,8416,8416,Tyler and Nearby Counties,Doddridge,54,17,West Virginia,WV
54073,54CS021,81,80,82,88,7,6,8,7,-0.14041332218161762,-0.03397315823803686,0.07709424670094503,0.9021052085263146,100,99,101,121,21,20,22,19,0.21855353745954273,0.3793764957145056,0.5349676295666345,0.8507421654339692,7425,7425,Tyler and Nearby Counties,Pleasants,54,73,West Virginia,WV
54085,54CS021,100,99,101,113,13,12,14,5,0.7316571239440438,0.8363816696301178,0.937579233050858,0.35769570105186055,123,122,124,135,12,11,13,16,-0.6371887938903452,-0.46864286155528206,-0.32146747180352664,1.2081349875705063,9567,9567,Tyler and Nearby Counties,Ritchie,54,85,West Virginia,WV
54095,54CS021,95,94,96,86,-9,-10,-8,9,-2.203481177305347,-2.0973767979403237,-1.992387303312036,-1.1257539217518906,117,115,118,137,20,19,22,21,-0.22541928180083934,-0.0755540351285353,0.07978893376926903,0.9780758176802072,8585,8585,Tyler and Nearby Counties,Tyler,54,95,West Virginia,WV
54103,54CS021,184,178,190,195,11,5,17,14,-0.6079532320069321,-0.19096539476325325,0.23255544531891928,1.1604551133604897,225,217,232,300,75,68,83,49,1.4407107642147239,2.1079768132042083,2.702867104921943,0.6420469657027162,15036,15036,Tyler and Nearby Counties,Wetzel,54,103,West Virginia,WV
54107,54CS022,918,882,954,1004,86,50,122,74,-0.30668458934661297,0.14456178832525807,0.5586967199030901,0.851767285795074,1122,1079,1165,1292,170,127,213,167,-0.6070301939124111,0.052203723413900636,0.6684990762286621,0.97696171081164,83364,83364,Wood,Wood,54,107,West Virginia,WV
55001,55CS001,227,219,236,241,14,5,22,16,-0.542170460430321,-0.12416619423166866,0.3124920144569725,1.0960167165537957,277,266,287,322,45,35,56,30,0.2516093093533519,0.891933162701843,1.530150065467055,0.6498482808380517,20364,20364,Adams+Juneau+Monroe+Vernon,Adams,55,1,Wisconsin,WI
55057,55CS001,256,244,267,257,1,-10,13,18,-1.0293109264257363,-0.6109489167863119,-0.1851921612025011,7.492614323956526,312,298,326,382,70,56,84,37,0.8682114428048731,1.4537066842275135,2.092791674987938,0.5195079407988474,26780,26780,Adams+Juneau+Monroe+Vernon,Juneau,55,57,Wisconsin,WI
55081,55CS001,364,344,384,419,55,35,75,27,0.17436859155857468,0.6058555135767126,1.0380073698857166,0.47896197649275857,445,421,469,547,102,78,126,41,0.9727814704884178,1.5723735995183492,2.2094319677508554,0.3967925393204179,46636,46636,Adams+Juneau+Monroe+Vernon,Monroe,55,81,Wisconsin,WI
55123,55CS001,254,241,267,318,64,51,77,22,0.9007202442325168,1.3633058530489581,1.803838392031809,0.33816527540666547,310,294,326,355,45,29,61,33,-0.2016050451783826,0.45191767707667,1.0780764695575669,0.7217481180738201,30870,30870,Adams+Juneau+Monroe+Vernon,Vernon,55,123,Wisconsin,WI
55003,55CS002,161,154,168,163,2,-5,9,11,-1.0030774091158272,-0.5698468136457181,-0.14739767116320343,3.5822253331136076,197,189,205,206,9,1,17,18,-1.3212329760911248,-0.6659732915222114,-0.018652018883834543,1.7263940653595642,15468,15468,Ashland+Bayfield+Douglas+Price,Ashland,55,3,Wisconsin,WI
55007,55CS002,155,148,162,163,8,1,15,17,-1.0326844986652035,-0.5986247071353213,-0.11901716295842214,1.8803589387402069,190,182,197,189,-1,-8,7,13,-1.7366684846825404,-1.0827924924417591,-0.4580844028174817,28.22745825262724,15201,15201,Ashland+Bayfield+Douglas+Price,Bayfield,55,7,Wisconsin,WI
55031,55CS002,359,340,378,466,107,88,126,53,0.8456487961971524,1.2198662952075077,1.6814142687592275,0.4903619740716155,441,418,464,497,56,33,79,36,-0.09325985528000595,0.5679995023433095,1.1700871954086989,0.6309758838702562,43588,43588,Ashland+Bayfield+Douglas+Price,Douglas,55,31,Wisconsin,WI
55099,55CS002,161,155,167,177,16,10,22,3,0.578893440197209,0.9985723763823993,1.412671536694255,0.17467036187674984,196,189,203,213,17,10,24,18,-0.6542311950322973,-0.08978481875306998,0.52523412496663,0.9955015593120422,13304,13304,Ashland+Bayfield+Douglas+Price,Price,55,99,Wisconsin,WI
55005,55CS003,446,426,465,503,57,38,77,55,-0.4104327101894869,0.053102157343227076,0.47673604641547807,0.9430791169529685,547,524,570,618,71,48,94,51,-0.08043696703378121,0.539657970726864,1.1441783370753231,0.7090207180445132,45169,45169,Barron+Sawyer+Washburn,Barron,55,5,Wisconsin,WI
55113,55CS003,185,178,192,217,32,25,39,16,0.5405892569485025,0.9821638602372715,1.398650350968508,0.483572996904232,227,218,235,278,51,43,60,34,0.6101546882746824,1.2572368633226971,1.8381653336329782,0.6496699462263854,16607,16607,Barron+Sawyer+Washburn,Sawyer,55,113,Wisconsin,WI
55129,55CS003,175,168,182,203,28,21,35,13,0.5019077823080244,0.9625579125967068,1.3912164851267002,0.44645563032477087,214,206,222,278,64,56,72,25,2.3552706697934362,2.9765758596597682,3.6261311298833605,0.38530749898622574,15742,15742,Barron+Sawyer+Washburn,Washburn,55,129,Wisconsin,WI
55009,55CS004,1777,1663,1891,2060,283,169,397,216,-0.16179519028372258,0.25775248600447725,0.6643918275971503,0.7601475211361497,2193,2056,2329,2374,181,45,318,196,-0.6683613115011392,-0.03925010700860437,0.5967212204682882,1.0751273110584354,264195,264195,Brown,Brown,55,9,Wisconsin,WI
55011,55CS005,111,110,112,109,-2,-3,-1,11,-1.0960919305855594,-0.9932459352225245,-0.8929232876212232,-11.82854184073025,136,134,138,143,7,5,9,5,0.013892339006954893,0.17433738458572265,0.3321030417480322,0.6338274884592637,13021,13021,Buffalo+Jackson+Pepin+Trempealeau,Buffalo,55,11,Wisconsin,WI
55053,55CS005,180,171,189,224,44,35,53,18,0.8139190887491515,1.2616805045918889,1.6745797496422878,0.3984869029758993,220,209,231,236,16,5,27,15,-0.529200495121544,0.06540019787521319,0.6882987509545407,0.8862540948659856,20657,20657,Buffalo+Jackson+Pepin+Trempealeau,Jackson,55,53,Wisconsin,WI
55091,55CS005,59,58,60,61,2,1,3,3,-0.26116678630937545,-0.15190122255084773,-0.04644837608203933,1.0377835999155471,73,72,74,81,8,7,9,10,-0.4079612780624368,-0.2571380762389477,-0.10049154050618207,1.0590060485537818,7268,7268,Buffalo+Jackson+Pepin+Trempealeau,Pepin,55,91,Wisconsin,WI
55121,55CS005,252,239,265,269,17,4,30,33,-0.9694448861534876,-0.5205153278809718,-0.08637443053920395,1.8128118236948105,308,293,324,303,-5,-21,10,16,-1.501016387502134,-0.8624526532808858,-0.2656502738280185,-3.5893118612116903,29624,29624,Buffalo+Jackson+Pepin+Trempealeau,Trempealeau,55,121,Wisconsin,WI
55013,55CS006,168,161,174,170,2,-4,9,27,-2.0087048057202344,-1.589908428268724,-1.1163549209982104,8.020724230207325,205,197,214,229,24,15,32,23,-0.5623645433246323,0.03621849682487828,0.6626186220778957,0.9383140327749717,15460,15460,Burnett+Polk,Burnett,55,13,Wisconsin,WI
55095,55CS006,397,378,416,423,26,7,45,29,-0.49370815146214286,-0.06545089344669897,0.3713743595758161,1.0730220599335591,488,465,511,580,92,69,115,83,-0.36275474675719965,0.2528863383363267,0.8962607896089699,0.8935809202418791,43742,43742,Burnett+Polk,Polk,55,95,Wisconsin,WI
55015,55CS007,310,289,332,353,43,21,64,34,-0.23345175665487097,0.162901637902681,0.6015256409771533,0.7814210224621366,384,358,410,404,20,-6,46,57,-1.4933246140467407,-0.8685970813605696,-0.24795273973293497,2.6906209119902798,50152,50152,Calumet+Winnebago,Calumet,55,15,Wisconsin,WI
55139,55CS007,1307,1233,1380,1525,218,145,292,172,-0.14542141455160237,0.2855508281315857,0.676746056853165,0.7841257247356035,1606,1517,1695,1729,123,34,212,137,-0.7130402079930964,-0.10595172856618254,0.534569475561885,1.1049408750102836,171730,171730,Calumet+Winnebago,Winnebago,55,139,Wisconsin,WI
55017,55CS008,524,496,552,584,60,32,88,56,-0.3679503243865557,0.07752649991400641,0.5073333281947865,0.914865811974559,643,609,676,674,31,-2,65,64,-1.203729625200906,-0.6028980778674392,7.575336904744873e-5,1.98202250708882,64711,64711,Chippewa+Rusk,Chippewa,55,17,Wisconsin,WI
55107,55CS008,158,152,164,163,5,-1,11,17,-1.2794216357513968,-0.875837000286516,-0.45620315807039374,3.049560754282941,193,186,200,234,41,34,48,28,0.48820669300819075,1.0969141180404804,1.676603747913622,0.6681081883733571,14062,14062,Chippewa+Rusk,Rusk,55,107,Wisconsin,WI
55019,55CS009,290,275,305,332,42,27,57,52,-0.7607979308906286,-0.2838854647959111,0.1459437440424018,1.2208160985517063,355,337,373,389,34,16,52,45,-0.974886049706078,-0.3902621440249651,0.21432378302309288,1.293642809374817,34758,34758,Clark+Taylor,Clark,55,19,Wisconsin,WI
55119,55CS009,165,156,173,175,10,2,19,24,-1.1184484137667499,-0.6534247458771509,-0.20895440188234168,2.109435266888154,201,191,212,226,25,14,35,29,-0.8620831151650997,-0.253282547311035,0.36343361342603403,1.137189229124124,20331,20331,Clark+Taylor,Taylor,55,119,Wisconsin,WI
55021,55CS010,478,453,502,528,50,26,75,40,-0.29906219226578634,0.19603093961748955,0.5707253191943401,0.7770040745778749,586,557,616,631,45,15,74,50,-0.7057722146091234,-0.11232964335749679,0.48729065093983637,1.0983130517793824,57592,57592,Columbia,Columbia,55,21,Wisconsin,WI
55023,55CS011,154,148,161,165,11,4,17,11,-0.4326205565319046,-0.027620344580172464,0.40981394396980914,0.9541285759727601,190,181,198,197,7,-1,16,11,-0.8807448194699399,-0.28642810726307755,0.36614697505542343,1.3121760371015436,16079,16079,Crawford+Grant+Richland,Crawford,55,23,Wisconsin,WI
55043,55CS011,429,407,451,503,74,52,96,51,0.02028946597086349,0.4348076821437342,0.9197503107628056,0.6781450978751555,528,502,554,578,50,24,76,35,-0.24040835289118578,0.3631612806495252,0.9551680943792762,0.6860967779272318,51306,51306,Crawford+Grant+Richland,Grant,55,43,Wisconsin,WI
55103,55CS011,167,160,174,191,24,17,31,11,0.33950273595386293,0.7466212569000983,1.2571767603535147,0.4402844180037349,205,196,214,226,21,12,30,24,-0.8190183170783106,-0.1944689934244211,0.38247439712117853,1.0934462827720497,17290,17290,Crawford+Grant+Richland,Richland,55,103,Wisconsin,WI
55025,55CS012,2930,2692,3167,3366,436,199,674,216,-0.008463143064670227,0.40461730598059137,0.8344948049348442,0.4938726145109178,3641,3356,3927,3767,126,-160,411,147,-0.6879330206638176,-0.05182231487635376,0.5481825288214106,1.1586221146383784,549678,549678,Dane,Dane,55,25,Wisconsin,WI
55027,55CS013,802,765,840,1019,217,179,254,126,0.6164381742766424,1.04789588639245,1.4409363234785377,0.5786672626413031,984,939,1029,1111,127,82,172,112,-0.42076328292606324,0.19267691069827542,0.7975584315411678,0.8739311235182532,87505,87505,Dodge,Dodge,55,27,Wisconsin,WI
55029,55CS014,290,278,302,325,35,23,47,25,-0.09153585085781472,0.3619346059462533,0.7601830793791844,0.7020124200009816,354,340,368,381,27,13,41,22,-0.4162056852160426,0.21035215766227425,0.8372846400339816,0.7833172263386673,27809,27809,Door+Kewaunee+Manitowoc,Door,55,29,Wisconsin,WI
55061,55CS014,162,153,171,191,29,20,38,26,-0.27640841676107414,0.13900474529730725,0.5618304535939777,0.8721320331596414,198,188,209,206,8,-3,18,15,-1.0594582075447743,-0.44971996433680816,0.2237209817300137,1.7540890219915584,20424,20424,Door+Kewaunee+Manitowoc,Kewaunee,55,61,Wisconsin,WI
55071,55CS014,742,708,776,844,102,68,136,56,0.15023911094878972,0.5770367854613628,1.0093958276625483,0.5437409069583364,905,865,946,948,43,2,83,71,-1.0074032146709166,-0.4465488072429867,0.15861761229195984,1.6269242360627747,78773,78773,Door+Kewaunee+Manitowoc,Manitowoc,55,71,Wisconsin,WI
55033,55CS015,302,283,322,306,4,-16,23,23,-0.8538987583419697,-0.42330450761928057,0.023266469069225713,4.784383733211807,372,348,395,414,42,19,66,33,-0.42521933393256484,0.24708575365480814,0.8414086747911818,0.7645564530839737,45412,45412,Dunn+Eau Claire,Dunn,55,33,Wisconsin,WI
55035,55CS015,753,708,799,846,93,47,138,81,-0.26440925352680994,0.11323580394636404,0.5479389549083472,0.8649481589898137,926,871,980,998,72,18,127,68,-0.5562758288566138,0.04643677924885288,0.6092178518693316,0.9292501102272999,104797,104797,Dunn+Eau Claire,Eau Claire,55,35,Wisconsin,WI
55037,55CS016,56,55,56,63,7,7,8,13,-1.4882564155575544,-1.3846759639119521,-1.281363029111792,1.6137668390915407,69,68,69,67,-2,-2,-1,8,-2.8377059703094742,-2.6713667811310096,-2.51890278147069,-13.585357405053017,4299,4299,Florence+Forest+Marinette+Oconto,Florence,55,37,Wisconsin,WI
55041,55CS016,105,104,106,99,-6,-7,-5,21,-3.11710864363717,-3.0087284080865833,-2.9042139117058205,-4.108891215215241,129,128,130,152,23,22,24,15,0.9064456092429758,1.0757778769225592,1.2323711574910339,0.6246067121121566,9003,9003,Florence+Forest+Marinette+Oconto,Forest,55,41,Wisconsin,WI
55075,55CS016,458,441,476,538,80,62,97,63,0.002420621639722844,0.4077319911873983,0.8133125828925021,0.7825213422954065,561,541,582,615,54,33,74,44,-0.3186004969552925,0.2960489983289388,0.9049203376180179,0.804541417174135,40258,40258,Florence+Forest+Marinette+Oconto,Marinette,55,75,Wisconsin,WI
55083,55CS016,326,310,343,396,70,53,86,49,0.10738733596676646,0.5332930164673856,0.983175670984521,0.6943576621978151,403,383,422,414,11,-8,31,34,-1.3348261944437163,-0.7184050735604661,-0.04355898304324179,2.7414792161172734,38193,38193,Florence+Forest+Marinette+Oconto,Oconto,55,83,Wisconsin,WI
55039,55CS017,828,783,872,999,171,127,216,108,0.19813761575917235,0.6175681898244331,1.0539966995433068,0.6268947077615329,1019,966,1073,1182,163,109,216,106,0.03661279985418785,0.6524806241112856,1.2483253899064526,0.6480419353587691,103005,103005,Fond du Lac,Fond du Lac,55,39,Wisconsin,WI
55045,55CS018,294,278,309,340,46,31,62,14,0.4504705392863391,0.8836126844329992,1.2990520285782603,0.2951576065485087,359,340,377,397,38,20,57,29,-0.29798932946712364,0.3159994899960363,0.952061199771863,0.7353758653206703,36749,36749,Green+Iowa+Lafayette,Green,55,45,Wisconsin,WI
55049,55CS018,177,167,188,197,20,9,30,3,0.29849574460212586,0.7051910051412884,1.1149637410751576,0.14533985278252126,217,205,229,212,-5,-17,7,12,-1.4747311863169774,-0.8588749134452123,-0.2702099506413209,-2.9885204103874266,23645,23645,Green+Iowa+Lafayette,Iowa,55,49,Wisconsin,WI
55065,55CS018,122,120,123,142,20,19,22,3,0.9372205273089734,1.04457227027906,1.1458660903300584,0.14005465095789196,149,147,152,165,16,13,18,14,-0.031979724347634575,0.12104831499783317,0.2618331517138742,0.8397893582387452,16658,16658,Green+Iowa+Lafayette,Lafayette,55,65,Wisconsin,WI
55047,55CS019,202,194,210,221,19,11,27,19,-0.43708266505471216,-0.030057372282057973,0.39442490200374114,0.9624626000751645,247,237,257,286,39,29,49,31,-0.11525240072305569,0.5148706259638506,1.107662025531566,0.7724758869444973,18909,18909,Green Lake+Marquette+Waushara,Green Lake,55,47,Wisconsin,WI
55077,55CS019,173,166,179,210,37,31,44,24,0.42239349391473857,0.8683071951809799,1.2666057966493764,0.6255423163620176,211,203,219,250,39,31,47,25,0.4840899961114889,1.0950717531271625,1.7589133257618128,0.6194823065992862,15557,15557,Green Lake+Marquette+Waushara,Marquette,55,77,Wisconsin,WI
55137,55CS019,244,233,254,289,45,35,56,25,0.3848317810725289,0.8073975568626799,1.2597303924619951,0.5429691842769481,298,285,311,331,33,20,46,41,-1.0242862690922467,-0.40014039498390175,0.23523710318208066,1.2072175944669443,24362,24362,Green Lake+Marquette+Waushara,Waushara,55,137,Wisconsin,WI
55051,55CS020,75,74,75,93,18,18,19,19,-0.21043788719668338,-0.09992148517908836,0.011592400306758562,0.9784829148708932,91,91,92,109,18,17,18,5,2.5103043917817516,2.6622032631067722,2.8273105402815,0.26823444841735944,5692,5692,Iron+Oneida+Vilas,Iron,55,51,Wisconsin,WI
55085,55CS020,403,388,419,499,96,80,111,46,0.9756483975478776,1.3867673529720477,1.8198452675686025,0.4756845039126765,493,475,512,531,38,19,56,45,-0.8690287674351163,-0.2755730386373078,0.4204014612547637,1.166173988776969,35667,35667,Iron+Oneida+Vilas,Oneida,55,85,Wisconsin,WI
55125,55CS020,271,262,281,282,11,1,20,29,-1.2625664675475794,-0.8326017555418167,-0.4071218364345349,2.5192696516489197,332,320,343,365,33,22,45,42,-1.1279346374094195,-0.4865167898283745,0.17843901874067966,1.2297593019835447,22238,22238,Iron+Oneida+Vilas,Vilas,55,125,Wisconsin,WI
55055,55CS021,609,572,646,713,104,67,141,83,-0.1769416899763193,0.24294251172109524,0.6914258396506291,0.7909739560933535,752,708,796,891,139,95,183,85,0.14753259750307063,0.7510023311235172,1.3753707329904383,0.6070562437152718,84916,84916,Jefferson,Jefferson,55,55,Wisconsin,WI
55059,55CS022,1254,1181,1327,1488,234,161,307,229,-0.40552760729048054,0.016146304191904094,0.43807795078375134,0.9757349656271141,1546,1459,1634,1707,161,73,248,180,-0.7495606505981481,-0.12262255980030162,0.5101943694615242,1.113006323347947,169723,169723,Kenosha,Kenosha,55,59,Wisconsin,WI
55063,55CS023,878,828,929,1004,126,75,176,69,0.042775208047197616,0.4865168969191113,0.9337441407420167,0.5454291100976685,1084,1023,1145,1140,56,-5,117,68,-0.7188613440824613,-0.12162744858212679,0.5161259541771068,1.1869779002105731,118297,118297,La Crosse,La Crosse,55,63,Wisconsin,WI
55067,55CS024,197,189,206,256,59,50,67,35,0.8066462525138074,1.2362880861180001,1.667199740832188,0.5875125315973833,242,232,251,306,64,55,74,18,2.323384411786108,2.904559966825133,3.4742754164539207,0.2749364787296244,19171,19171,Langlade+Lincoln+Menominee+Shawano,Langlade,55,67,Wisconsin,WI
55069,55CS024,286,274,298,372,86,74,98,68,0.21113710437684513,0.6404523295928172,1.0600236370396998,0.7821649680272559,350,336,364,437,87,73,101,50,1.0370638420692306,1.6144597415447632,2.196598180458492,0.5684162708697736,27584,27584,Langlade+Lincoln+Menominee+Shawano,Lincoln,55,69,Wisconsin,WI
55078,55CS024,44,42,46,59,15,13,17,14,-0.16945716519852672,0.2442674626210432,0.6485203837431711,0.8686282419785429,54,51,56,65,11,9,14,5,1.0744232805284817,1.6657274781236566,2.246523895044597,0.40891943999174246,4550,4550,Langlade+Lincoln+Menominee+Shawano,Menominee,55,78,Wisconsin,WI
55115,55CS024,406,389,424,477,71,53,88,63,-0.2326047379324654,0.18479019349719178,0.6383987323158756,0.8802659030302366,498,477,519,505,7,-14,28,39,-1.5799623134479628,-0.9388968542555906,-0.3331848723953281,4.7334961765577654,40791,40791,Langlade+Lincoln+Menominee+Shawano,Shawano,55,115,Wisconsin,WI
55073,55CS025,1049,991,1107,1209,160,102,218,156,-0.40138086670598555,0.022775354514205714,0.4620965360081828,0.9693558446799228,1290,1220,1360,1444,154,84,224,190,-0.9446189226847651,-0.32135377278785004,0.3049081040525779,1.2278174834576778,135654,135654,Marathon,Marathon,55,73,Wisconsin,WI
55079,55CS026,7117,6710,7523,8848,1731,1325,2138,898,0.44370904983654874,0.8873230117395885,1.2901521035753885,0.5183644359570589,8764,8276,9252,9486,722,234,1210,274,-0.0157759379797588,0.5607165418534122,1.1694981627925163,0.3788145576374221,946180,946180,Milwaukee,Milwaukee,55,79,Wisconsin,WI
55087,55CS027,1282,1201,1363,1498,216,135,297,164,-0.1508792880114908,0.2844939432176677,0.6844612852163243,0.7565394044061223,1582,1484,1679,1673,91,-6,189,140,-0.9310858909064001,-0.3174084236946105,0.3075301974797681,1.5186186982079382,188277,188277,Outagamie,Outagamie,55,87,Wisconsin,WI
55089,55CS028,692,653,730,781,89,51,128,85,-0.3832677279487246,0.05323698944871013,0.4578590228111951,0.9408410051606807,851,804,897,906,55,9,102,71,-0.8145549836091974,-0.2232775472559681,0.39274987521412114,1.2617239241754519,89783,89783,Ozaukee,Ozaukee,55,89,Wisconsin,WI
55093,55CS029,249,231,268,287,38,19,56,25,-0.11541942918263275,0.2957266975337491,0.7227460838397172,0.6449012021490133,307,285,329,370,63,41,85,30,0.2985073819751353,0.9118752527723324,1.54504661623433,0.46984968220100154,42740,42740,Pierce+St. Croix,Pierce,55,93,Wisconsin,WI
55109,55CS029,534,495,574,628,94,54,133,41,0.16589740164611674,0.5981720621323247,0.9928579520990244,0.4321496825440516,659,612,707,812,153,105,200,90,0.21242790287823926,0.8285023367381428,1.4647542187759164,0.5847461075641844,91169,91169,Pierce+St. Croix,St. Croix,55,109,Wisconsin,WI
55097,55CS030,459,428,489,520,61,31,92,45,-0.22009697990678137,0.21893744458030293,0.6482701461504925,0.7245953146888782,567,530,604,717,150,113,187,76,0.6033138409640441,1.2222540419425287,1.8257860767565766,0.5027034099856739,70980,70980,Portage,Portage,55,97,Wisconsin,WI
55101,55CS031,1599,1515,1684,1934,335,250,419,267,-0.10071422622375961,0.34584653319982805,0.800997750120344,0.7953945313299737,1966,1865,2067,2230,264,163,365,217,-0.34211074591069596,0.2900691476469285,0.8670609509473953,0.8197430468721238,196036,196036,Racine,Racine,55,101,Wisconsin,WI
55105,55CS032,1321,1251,1392,1564,243,172,313,139,0.22412932045298128,0.6267379335160593,1.05768097068668,0.5706805913571663,1624,1540,1708,1770,146,62,230,127,-0.4806755316921978,0.1411182600003025,0.758708762380394,0.8639332288422785,163105,163105,Rock,Rock,55,105,Wisconsin,WI
55111,55CS033,555,528,583,631,76,48,103,44,0.07505782154349755,0.5169608948026437,0.9399049923508374,0.57414078464325,679,646,713,753,74,40,107,67,-0.49942487138858477,0.10783934483888619,0.772185715833512,0.8965907078282533,64432,64432,Sauk,Sauk,55,111,Wisconsin,WI
55117,55CS034,966,917,1016,1137,171,121,220,127,-0.04136220975098292,0.37396789228226257,0.8240951547808688,0.7392661931542027,1186,1126,1245,1251,65,6,125,102,-0.9786666319450339,-0.38121007353202424,0.2843325262739887,1.5353819475393082,115235,115235,Sheboygan,Sheboygan,55,117,Wisconsin,WI
55127,55CS035,817,773,862,998,181,136,225,116,0.1781895563695712,0.6210132288153671,1.0297154532140524,0.6385313746252027,1007,953,1060,1095,88,35,142,95,-0.6965980660389594,-0.08432284170930597,0.5393582112905684,1.0632635869054576,103921,103921,Walworth,Walworth,55,127,Wisconsin,WI
55131,55CS036,1015,956,1074,1188,173,114,232,117,-0.03379464084238758,0.4108569070565742,0.8703856345507914,0.6724965926023904,1252,1182,1322,1387,135,65,205,129,-0.539503132432436,0.06541911662409519,0.6638915267740242,0.9485214007621605,136362,136362,Washington,Washington,55,131,Wisconsin,WI
55133,55CS037,3016,2841,3190,3670,654,480,829,421,0.12355164753557996,0.582786170835946,1.0214675587065485,0.6424096618244743,3718,3508,3928,4148,430,220,640,329,-0.3904362558800546,0.3114244301130745,0.9351606268460124,0.7629272580564626,405223,405223,Waukesha,Waukesha,55,133,Wisconsin,WI
55135,55CS038,610,588,632,716,106,84,128,118,-0.6623441823415978,-0.23152594133288773,0.17763286119343652,1.1053390385636026,743,717,769,759,16,-10,42,71,-1.946415498316263,-1.316269055467399,-0.6985025356353947,4.173710780584424,50780,50780,Waupaca,Waupaca,55,135,Wisconsin,WI
55141,55CS039,708,677,739,824,116,85,147,52,0.4622482605808766,0.8807620991329295,1.3187855759957225,0.44366058493712596,867,830,905,1051,184,146,221,122,0.385664148973343,1.0063354021241704,1.6391429359542973,0.6605998960737495,72697,72697,Wood,Wood,55,141,Wisconsin,WI
56003,56CS001,119,118,121,127,8,6,9,14,-0.6439886511972276,-0.5382994024196748,-0.429023025438541,1.6036188418386252,147,145,148,190,43,42,45,32,0.9984262585438433,1.148606229164989,1.3051976765538809,0.7245341485332077,11675,11675,Big Horn+Hot Springs+Park+Washakie,Big Horn,56,3,Wyoming,WY
56017,56CS001,61,61,62,80,19,18,19,2,3.722276895959653,3.8322637583253947,3.9425776825487198,0.10025691282956012,75,74,76,87,12,11,13,10,0.4022415876238523,0.5631054852748182,0.7113951426360205,0.7648432873271416,4419,4419,Big Horn+Hot Springs+Park+Washakie,Hot Springs,56,17,Wyoming,WY
56029,56CS001,254,242,267,303,49,36,61,14,0.740345170603174,1.1894090186369535,1.6233167537942181,0.2812820601808132,315,300,330,441,126,111,141,103,0.3048511086297561,0.9599042305870837,1.5541689317064178,0.8107451873207507,29250,29250,Big Horn+Hot Springs+Park+Washakie,Park,56,29,Wyoming,WY
56043,56CS001,73,72,74,87,14,13,15,21,-1.040959748086056,-0.9279047684660583,-0.825407670020856,1.4239144309173313,90,89,91,113,23,22,24,18,0.5682223534745363,0.7320196848293612,0.8827406140766454,0.7587118554523049,7797,7797,Big Horn+Hot Springs+Park+Washakie,Washakie,56,43,Wyoming,WY
56013,56CS002,363,346,380,486,123,106,140,64,1.0803972315178587,1.5055636997556197,1.9248331400076806,0.514432608016953,445,425,466,579,134,113,154,91,0.6541966580357901,1.291989250235275,1.8511613145614034,0.6753872780887875,39404,39404,Fremont+Lincoln+Sublette+Teton,Fremont,56,13,Wyoming,WY
56023,56CS002,125,123,127,155,30,28,32,10,0.8983419919599865,1.00646742619091,1.1160097877857083,0.3201760234897648,154,152,157,173,19,16,21,15,0.07450369313796742,0.23073404332186545,0.39631139781465474,0.756680486374916,20067,20067,Fremont+Lincoln+Sublette+Teton,Lincoln,56,23,Wyoming,WY
56035,56CS002,52,51,53,67,15,14,16,4,0.9714780685887789,1.07756549525153,1.18707331342795,0.25561474774107035,65,64,66,78,13,12,14,16,-0.5099370602045836,-0.34926697251356537,-0.19669075113412593,1.1319698933152156,9862,9862,Fremont+Lincoln+Sublette+Teton,Sublette,56,35,Wyoming,WY
56039,56CS002,87,85,90,79,-8,-11,-6,8,-0.802083649613143,-0.6979069012327435,-0.5898542645868304,-1.0954424522521227,109,106,112,89,-20,-23,-17,5,-1.4300375414063,-1.2818471755681125,-1.1286313860519228,-0.2629679931469956,23432,23432,Fremont+Lincoln+Sublette+Teton,Teton,56,39,Wyoming,WY
56021,56CS003,743,700,786,821,78,35,121,63,-0.290449366751311,0.15112969651967972,0.5684181892657951,0.796798310435225,917,865,969,1258,341,289,393,173,1.370936805112823,2.0158306698233295,2.6144276023399664,0.5054844330408194,100169,100169,Laramie,Laramie,56,21,Wyoming,WY
56025,56CS004,626,592,661,761,135,100,169,95,0.08823662056081485,0.49472555153349107,0.9066910587242016,0.6998708496827074,772,730,814,934,162,120,204,131,-0.17428461670015047,0.47745030139799216,1.1125928204501423,0.8036157587283149,80184,80184,Natrona,Natrona,56,25,Wyoming,WY
56005,56CS005,217,197,237,276,59,39,79,39,0.01769931012885213,0.4299697436615169,0.8562792838555662,0.6488784552009353,271,247,295,367,96,72,120,86,-0.33013057649231936,0.25910828410131553,0.8673016446732407,0.8879286764764672,46527,46527,Northeast Wyoming,Campbell,56,5,Wyoming,WY
56011,56CS005,55,54,56,99,44,43,45,10,4.370414724610852,4.480959035403068,4.5846615177237124,0.22239770739480508,68,67,69,82,14,13,15,13,0.0515597747181212,0.21020867505040927,0.36635121257939113,0.8482447551947052,7581,7581,Northeast Wyoming,Crook,56,11,Wyoming,WY
56019,56CS005,83,82,84,84,1,-0,2,6,-0.7208721842846695,-0.6202883981867136,-0.5014489876671746,3.482000923052407,102,101,103,110,8,7,9,0,0.9497129039800409,1.1026788408538462,1.273299939634012,0,8565,8565,Northeast Wyoming,Johnson,56,19,Wyoming,WY
56033,56CS005,284,270,297,300,16,3,30,18,-0.4609878917148039,-0.06472905996222898,0.4152723138817501,1.037884678640536,348,332,364,384,36,20,52,43,-0.8434429583325556,-0.27097470615937713,0.3537270132972602,1.1541746932690715,30708,30708,Northeast Wyoming,Sheridan,56,33,Wyoming,WY
56045,56CS005,55,54,56,68,13,12,14,7,0.7711237624032249,0.8884342592579727,0.9935708857047307,0.4985583940977421,68,67,68,106,38,38,39,11,4.677011080989979,4.832120139594327,4.985957099363015,0.2785405868877809,6823,6823,Northeast Wyoming,Weston,56,45,Wyoming,WY
56001,56CS006,179,162,196,213,34,17,51,10,0.17972470429793386,0.6211666861806736,1.0482478643677857,0.2864784062271513,226,206,246,267,41,21,61,34,-0.3753013826886811,0.23660165291403523,0.8278966148265199,0.8056167283602845,38874,38874,"Southeast Wyoming, excluding Laramie",Albany,56,1,Wyoming,WY
56007,56CS006,110,108,111,137,27,26,29,17,0.5853726391458369,0.6948701455655724,0.8030997087182028,0.6018901470130631,135,133,136,162,27,26,29,31,-0.4356140215565503,-0.28669720673394716,-0.1255261259520031,1.088149280017995,14782,14782,"Southeast Wyoming, excluding Laramie",Carbon,56,7,Wyoming,WY
56009,56CS006,103,102,105,127,24,22,25,4,1.314634815063685,1.4225775890725223,1.5324038019674056,0.162019834408118,127,125,128,164,37,36,39,36,-0.03352551344080371,0.11851231108564254,0.2714512073041371,0.9377136444007806,13840,13840,"Southeast Wyoming, excluding Laramie",Converse,56,9,Wyoming,WY
56015,56CS006,141,136,147,160,19,13,24,19,-0.4140614498521155,-0.022740164890674944,0.4039792675242419,0.9692070590474354,173,167,180,188,15,8,21,31,-2.138433067470746,-1.4716460264013445,-0.875508277743788,1.982534934120154,13229,13229,"Southeast Wyoming, excluding Laramie",Goshen,56,15,Wyoming,WY
56027,56CS006,22,21,23,33,11,10,12,6,1.6555085755672434,2.0694209204963463,2.471258115451484,0.5104914399435287,27,26,28,36,9,8,10,8,-0.20391199562671258,0.38787862880687246,1.0459588246595881,0.8216150050114016,2313,2313,"Southeast Wyoming, excluding Laramie",Niobrara,56,27,Wyoming,WY
56031,56CS006,83,82,84,96,13,12,14,6,0.6862137900585819,0.7854445084463249,0.8959772077884418,0.43797157433847184,102,101,103,171,69,68,70,25,6.0539033071889286,6.208619085253252,6.358859704647756,0.3566536905809965,8518,8518,"Southeast Wyoming, excluding Laramie",Platte,56,31,Wyoming,WY
56037,56CS007,256,238,275,357,101,82,119,22,1.4168319273607364,1.843791614252042,2.27450593243173,0.21623462152083098,318,296,340,414,96,74,118,82,-0.22196526953279716,0.3883812093186163,1.0624536583825226,0.8460110762432217,42815,42815,Sweetwater+Uinta,Sweetwater,56,37,Wyoming,WY
56041,56CS007,138,129,146,154,16,8,25,2,0.2824052592170166,0.7027237467241828,1.1286677021971732,0.11534817686834638,170,160,181,186,16,5,26,23,-1.0866643512816196,-0.4193748840367843,0.179122478343789,1.3758680714426008,20204,20204,Sweetwater+Uinta,Uinta,56,41,Wyoming,WY
