FIPSCode,csCode,expDeathsMed2020,expDeathsLow2020,expDeathsUp2020,deaths2020,excDeathsMed2020,excDeathsLow2020,excDeathsUp2020,COVIDDeaths2020,nonCovidExcCDRLow2020,nonCovidExcCDRMed2020,nonCovidExcCDRUp2020,COVIDExcRatio2020,expDeathsMed2021,expDeathsLow2021,expDeathsUp2021,deaths2021,excDeathsMed2021,excDeathsLow2021,excDeathsUp2021,COVIDDeaths2021,nonCovidExcCDRLow2021,nonCovidExcCDRMed2021,nonCovidExcCDRUp2021,COVIDExcRatio2021,pop2020,pop2021,csName,countyName,stateFIPS,countyFIPS,state,stateStr
01001,01CS001,475,450,500,565,90,65,115,55,0.17420863088370844,0.6057793503721643,1.038606260771918,0.6034875400538314,587,557,618,706,119,88,149,107,-0.3716146693885807,0.21215583213915892,0.8776889162118084,0.8937353241797977,58446,59063,Autauga,Autauga,1,1,Alabama,AL
01003,01CS002,2020,1920,2121,2277,257,156,357,165,-0.040745866911238285,0.3926469417416759,0.8460494754116212,0.6407278832792175,2535,2412,2658,3094,559,436,682,435,0.04353814758305918,0.610819660277952,1.2732744876482096,0.7765242877586959,232385,238397,Baldwin,Baldwin,1,3,Alabama,AL
01005,01CS003,257,246,268,324,67,56,78,38,0.7490119828328058,1.1632210304562194,1.5836126276179607,0.5579609821189985,314,301,327,372,58,45,71,52,-0.30845370708147385,0.29793266780023336,0.9201491626262899,0.8803431084662878,25081,24996,Barbour+Bullock+Henry,Barbour,1,5,Alabama,AL
01011,01CS003,103,102,104,132,29,28,30,20,0.7679144882919965,0.8659135420528321,0.967657915775327,0.668463532664155,127,126,128,141,14,13,15,13,-0.03665849294869987,0.12360778820275023,0.26546476530922064,0.8664505402263935,10286,10318,Barbour+Bullock+Henry,Bullock,1,11,Alabama,AL
01067,01CS003,193,185,200,228,35,28,43,24,0.23070482220320274,0.6582143663432835,1.0774752335342774,0.6582704233269768,239,230,248,269,30,21,39,37,-1.1045334070220185,-0.48919630321875607,0.10312096345886866,1.1868445292267202,17191,17416,Barbour+Bullock+Henry,Henry,1,67,Alabama,AL
01007,01CS004,220,210,229,252,32,23,42,40,-0.7917437404289195,-0.3266184548962736,0.06345328654189915,1.2051279310194052,273,261,284,336,63,52,75,46,0.36013422998662087,0.9295595756707262,1.5269308363768859,0.7142520355043239,22263,22440,Bibb+Chilton+Coosa+Perry,Bibb,1,7,Alabama,AL
01021,01CS004,445,425,464,529,84,65,104,76,-0.2403761651803558,0.18903697923851212,0.6588016140822303,0.8919339037007686,550,527,574,653,103,79,126,107,-0.7388716594967027,-0.11431784167318193,0.5097829072744624,1.0309270480496493,44946,45238,Bibb+Chilton+Coosa+Perry,Chilton,1,21,Alabama,AL
01037,01CS004,130,126,135,144,14,9,18,19,-0.9055008392788795,-0.4946480604768504,-0.08064885877828026,1.2812340870913568,160,154,165,184,24,19,30,21,-0.19547056678573302,0.3963984618137669,1.0163241328974137,0.829905000494866,10433,10440,Bibb+Chilton+Coosa+Perry,Coosa,1,37,Alabama,AL
01105,01CS004,97,96,98,141,44,43,45,23,2.3444265506187003,2.4411266594607883,2.537015906126874,0.5134517177478094,117,116,118,160,43,42,44,21,2.9951479449841036,3.1352186008216263,3.2941041762249252,0.47853433042376026,8513,8369,Bibb+Chilton+Coosa+Perry,Perry,1,105,Alabama,AL
01009,01CS005,597,572,622,731,134,109,159,92,0.29965098869449636,0.7081052882767496,1.1661027527339782,0.6818529476026042,733,703,764,838,105,74,135,98,-0.5324372599155821,0.1411065648454062,0.7620083677298632,0.9258338864834293,58896,59047,Blount,Blount,1,9,Alabama,AL
01013,01CS006,215,206,223,256,41,33,50,52,-0.964136176557117,-0.5509332754365314,-0.1281144159190562,1.2238881300841618,260,250,270,307,47,37,57,47,-0.5776721355257614,0.024047727517512656,0.6144808427612128,0.9755295226164747,19095,18907,Butler+Crenshaw+Pike,Butler,1,13,Alabama,AL
01041,01CS006,155,150,161,209,54,48,59,29,1.4484971004867129,1.871880068595838,2.3041005333212223,0.5291443722091864,188,181,195,240,52,45,59,30,1.4066437816872064,2.021780116803242,2.5948872176124538,0.5640347899597067,13245,13094,Butler+Crenshaw+Pike,Crenshaw,1,41,Alabama,AL
01109,01CS006,268,254,282,359,91,77,105,45,0.9714608017438723,1.3952521871624985,1.830470853351627,0.4900861715303467,330,313,347,455,125,108,142,74,1.2741900864312379,1.8702587790873864,2.4908481384351457,0.5858730947206373,32990,32990,Butler+Crenshaw+Pike,Pike,1,109,Alabama,AL
01015,01CS007,1265,1215,1315,1535,270,220,320,175,0.3778698591940078,0.8250036157743224,1.2686066504169495,0.6448956143832533,1544,1484,1604,1863,319,259,379,302,-0.42477004101810956,0.16022994219447825,0.8181557225297086,0.944248494884529,115915,116015,Calhoun,Calhoun,1,15,Alabama,AL
01017,01CS008,374,359,389,516,142,127,157,73,1.5274929092565472,2.0067963760269554,2.412171483213561,0.5105643418440676,455,437,473,576,121,103,139,77,0.9416690106388255,1.5274412872474088,2.151943549218221,0.6312577412979659,34455,34561,Chambers+Cleburne+Randolph,Chambers,1,17,Alabama,AL
01029,01CS008,169,162,175,189,20,14,27,25,-0.7011547284624113,-0.29762499225058703,0.10370948045744932,1.168357141743405,206,198,213,261,55,48,63,41,0.5127229417909501,1.1451819106492591,1.7886110717204184,0.7276408925284974,15030,15093,Chambers+Cleburne+Randolph,Cleburne,1,29,Alabama,AL
01111,01CS008,250,241,260,306,56,46,65,54,-0.3587971962598042,0.0700519851717354,0.5004189314727885,0.9551802396264388,304,292,315,355,51,40,63,55,-0.8424096856228049,-0.1930248826463941,0.3991589153943415,1.0485854694038774,22091,21986,Chambers+Cleburne+Randolph,Randolph,1,111,Alabama,AL
01019,01CS009,291,281,302,398,107,96,117,34,2.4454103957641817,2.880401628273974,3.2996455611927846,0.31595116512763194,354,342,367,468,114,101,126,64,1.7088699659816766,2.387736583735731,3.0428985300661346,0.5588034778142216,25151,24990,Cherokee+Etowah,Cherokee,1,19,Alabama,AL
01055,01CS009,1201,1156,1245,1446,245,201,290,222,-0.22213439854147982,0.23372118706061384,0.6575997921248317,0.9014915308664233,1464,1411,1518,1818,354,300,407,287,0.184423190275304,0.7878140626229835,1.3881673465882625,0.8090523888052412,103233,103196,Cherokee+Etowah,Etowah,1,55,Alabama,AL
01023,01CS010,154,149,160,160,6,0,11,31,-2.450838733655284,-2.0173296741635314,-1.602917063482654,4.7462581639676165,188,182,195,210,22,15,28,23,-0.7295393114020413,-0.10554921348186161,0.4782083404831804,1.0046411778573652,12604,12546,Choctaw+Clarke+Washington,Choctaw,1,23,Alabama,AL
01025,01CS010,251,242,261,371,120,110,129,43,2.8983464700380437,3.3110259106457094,3.77455786441583,0.35668894665483525,305,294,317,388,83,71,94,53,0.9851087112418456,1.595385870579025,2.1851776136324466,0.6334546253637552,23066,22794,Choctaw+Clarke+Washington,Clarke,1,25,Alabama,AL
01129,01CS010,165,158,172,188,23,16,30,24,-0.4911896332731714,-0.061547139119121214,0.36160887373436923,1.0019148866080985,200,192,208,243,43,35,51,32,0.2503669365174169,0.8513940107654823,1.4362759440934456,0.7264302008203245,15424,15169,Choctaw+Clarke+Washington,Washington,1,129,Alabama,AL
01027,01CS011,163,157,169,218,55,49,61,40,0.617965037737557,1.0478413067255423,1.4991573084232497,0.7161601663717377,200,193,207,235,35,28,42,24,0.2546055187736095,0.9468528612103357,1.564755274448542,0.6668472280376192,14057,14190,Clay+Talladega,Clay,1,27,Alabama,AL
01121,01CS011,872,837,907,1038,166,131,201,130,0.04014013716935397,0.4343484085133458,0.8584518107695369,0.7786645775159704,1062,1020,1104,1362,300,258,342,203,0.872126108286968,1.4215619071148564,2.0596278462499966,0.67366007306838,81743,81603,Clay+Talladega,Talladega,1,121,Alabama,AL
01031,01CS012,477,454,500,616,139,116,162,70,0.8719681907702679,1.2934366718272663,1.7345629699543508,0.4988992570851223,592,564,620,715,123,95,151,128,-0.7664104007345645,-0.11971539385951858,0.533852520913622,1.032119996807495,53493,54085,Coffee+Geneva,Coffee,1,31,Alabama,AL
01061,01CS012,315,304,327,402,87,75,98,54,0.747427182611029,1.232089935614239,1.6194801608651048,0.6151598763395266,386,372,400,527,141,127,155,81,2.0447022947368287,2.701752931492773,3.2992396357047884,0.570779527075007,26624,26697,Coffee+Geneva,Geneva,1,61,Alabama,AL
01033,01CS013,649,624,674,675,26,1,51,83,-1.4247265234711695,-0.9900486542245746,-0.5820531018110295,3.0746120378190223,797,768,827,882,85,55,114,117,-1.3196641471017554,-0.6796549849458782,-0.09831953396319294,1.3641578496811586,56970,57439,Colbert,Colbert,1,33,Alabama,AL
01035,01CS014,148,143,153,183,35,30,40,27,0.22139200152690844,0.6690308015588123,1.0785036031592237,0.7572421235809194,179,173,185,220,41,35,47,35,-0.015096396925121432,0.6308384526260883,1.227591589868532,0.8367884651925561,11602,11361,Conecuh+Marengo+Monroe+Wilcox,Conecuh,1,35,Alabama,AL
01091,01CS014,237,229,246,281,44,35,52,35,0.05734688418617301,0.4544593167776788,0.8487091978823688,0.7835037713685229,290,280,299,350,60,51,70,60,-0.60391184598393155,0.03891542430238524,0.6551780334443662,0.9768305192688969,19186,19035,Conecuh+Marengo+Monroe+Wilcox,Marengo,1,91,Alabama,AL
01099,01CS014,219,210,227,283,64,56,73,30,1.3321018802083575,1.71947949553125,2.1568390752367548,0.4596851331673997,268,258,278,373,105,95,115,52,2.587588298488183,3.238591210286601,3.841517009408741,0.49119631788148793,19856,19659,Conecuh+Marengo+Monroe+Wilcox,Monroe,1,99,Alabama,AL
01131,01CS014,139,135,144,150,11,6,15,22,-1.5066968184172271,-1.09997331532923,-0.6428364431416143,1.9016379164886252,171,165,176,182,11,6,17,25,-2.1798631822644636,-1.568631324571808,-0.9385499181152022,2.0192301251657936,10493,10456,Conecuh+Marengo+Monroe+Wilcox,Wilcox,1,131,Alabama,AL
01039,01CS015,463,447,479,591,128,112,144,90,0.579627321798941,1.0277402958505037,1.4477283971157575,0.6977152788840525,566,546,585,723,157,138,177,126,0.38549257249108804,1.0099757045883149,1.6297574980956593,0.7957488630893562,37418,37516,Convington+Escambia,Covington,1,39,Alabama,AL
01053,01CS015,407,391,423,515,108,92,124,58,0.9351221014788309,1.3528675335376708,1.8224880732225712,0.533174097568574,498,479,517,655,157,138,176,108,0.9689663150575687,1.6214364865038742,2.2537889396872255,0.6829939049247205,36655,36694,Convington+Escambia,Escambia,1,53,Alabama,AL
01043,01CS016,945,907,982,1043,98,61,136,121,-0.7104660244944107,-0.24570982714041226,0.15198142456647434,1.2169106761988944,1174,1128,1220,1307,133,87,179,187,-1.3735057631659842,-0.7321276728833309,-0.13504712676396785,1.3982145474097434,87554,89284,Cullman,Cullman,1,43,Alabama,AL
01045,01CS017,454,433,475,555,101,80,122,86,-0.15109993749065873,0.2963166038447493,0.7319081965321306,0.8420342724697651,557,532,583,735,178,152,203,96,1.3834540593129276,1.9695474386426992,2.598311259226309,0.5374186790452782,49239,49323,Dale,Dale,1,45,Alabama,AL
01047,01CS018,436,419,452,560,124,108,141,100,0.2168846792641286,0.6394254274651727,1.070794258132334,0.797708216803946,527,508,547,678,151,131,170,101,0.9278937679013163,1.5800983674907008,2.211938689281718,0.6655393299553857,37984,37702,Dallas+Lowndes,Dallas,1,47,Alabama,AL
01085,01CS018,134,129,138,156,22,18,27,39,-2.0827530610344565,-1.6545275846421084,-1.1965452382014758,1.6782380309326392,160,155,165,184,24,19,29,33,-1.6846047807276112,-1.0974454492400672,-0.48203266815732926,1.3136989111698305,10179,10013,Dallas+Lowndes,Lowndes,1,85,Alabama,AL
01049,01CS019,701,670,731,868,167,137,198,123,0.20983784517113338,0.6151486676753488,1.0906487254418764,0.730453293462556,859,822,896,1119,260,223,297,172,0.8412731672142006,1.4515198144959487,2.079211156090464,0.6595523100461835,71631,71786,DeKalb,DeKalb,1,49,Alabama,AL
01051,01CS020,728,691,766,850,122,84,159,93,-0.06297772850118241,0.32847909293313066,0.7364057686206371,0.7584836431126196,909,863,955,1085,176,130,222,157,-0.3461613475278906,0.26388105209468965,0.8879316615747643,0.884948943854436,87286,89131,Elmore,Elmore,1,51,Alabama,AL
01057,01CS021,193,186,200,236,43,36,50,41,-0.31632289075672443,0.09315537463793391,0.5123010771489767,0.9396839430005702,233,225,242,314,81,72,89,51,1.5755695672702985,2.210130948611554,2.769518213602119,0.6253045681606437,16286,16171,Fayette+Lamar+Marion,Fayette,1,57,Alabama,AL
01075,01CS021,168,162,174,220,52,46,58,45,0.07301513191478542,0.47730128258145893,0.9404778709663197,0.8504209288325577,202,195,209,242,40,33,47,34,-0.08356616117352225,0.548005768332397,1.1386527368160324,0.8240556674376812,13898,13726,Fayette+Lamar+Marion,Lamar,1,75,Alabama,AL
01093,01CS021,346,333,359,444,98,85,111,61,0.8335408472763337,1.2761177544630513,1.6893445566730516,0.6165716066635195,420,405,435,508,88,73,103,72,0.08382394102301316,0.6951651275493784,1.2970564550010322,0.8057292546345359,29361,29252,Fayette+Lamar+Marion,Marion,1,93,Alabama,AL
01059,01CS022,320,306,334,385,65,51,79,49,0.057006175177453884,0.49990024251626763,0.8850983538861285,0.7444932755865179,391,375,408,490,99,82,115,57,0.9616017623955382,1.5617298793862557,2.1795220759161498,0.5726057544397595,31988,32020,Franklin+Lawrence,Franklin,1,59,Alabama,AL
01079,01CS022,349,335,363,461,112,98,126,59,1.1800873855541225,1.5908820501933403,2.042784169791844,0.5225735705973462,427,410,444,582,155,138,172,96,1.518148986698738,2.139467122035285,2.7373258272298377,0.61464576762199985,33035,33086,Franklin+Lawrence,Lawrence,1,79,Alabama,AL
01063,01CS023,86,85,87,133,47,46,48,21,3.2692202190810797,3.37210243469389,3.476838456147643,0.4361156203531146,104,103,105,136,32,31,33,23,1.2847766497784237,1.4302616946579039,1.5724240247847738,0.6944220877285888,7755,7640,Greene+Hale+Pickens+Sumter,Greene,1,63,Alabama,AL
01065,01CS023,169,163,176,216,47,40,53,37,0.17783629522622485,0.6606234799818334,1.0890363766355973,0.7747386667240116,208,200,215,262,54,47,62,40,0.5459315493627286,1.1681450607939097,1.786784222523494,0.7211719846187257,14770,14760,Greene+Hale+Pickens+Sumter,Hale,1,65,Alabama,AL
01107,01CS023,208,200,216,277,69,61,77,37,1.2257442000321261,1.6549131782875532,2.102919308565845,0.5294253042759259,252,243,262,339,87,77,96,48,1.798443465590027,2.448675311683512,3.044744112598028,0.5471084020877485,19163,18839,Greene+Hale+Pickens+Sumter,Pickens,1,107,Alabama,AL
01119,01CS023,143,138,148,171,28,23,33,27,-0.34092148166245784,0.08559705607744432,0.49273451427512965,0.9301287850505886,174,168,180,163,-11,-17,-5,14,-3.1033945051518645,-2.4561788335079835,-1.7927186829964497,-1.395714700364708,12291,12183,Greene+Hale+Pickens+Sumter,Sumter,1,119,Alabama,AL
01069,01CS024,983,937,1029,1210,227,181,273,171,0.09384991715777835,0.5299854093946477,0.9269239729542477,0.7492556668589027,1208,1152,1263,1602,394,339,450,244,1.0464800521725688,1.6985967249248293,2.267495705809296,0.6172087216173497,107079,107419,Houston,Houston,1,69,Alabama,AL
01071,01CS025,613,591,636,747,134,111,156,69,0.8206827213430812,1.2387623762497781,1.6801485877186422,0.5118512011537595,751,724,779,985,234,206,261,159,1.0690851690213772,1.7098238763204843,2.3548124175520146,0.6774812327271432,52422,52736,Jackson,Jackson,1,71,Alabama,AL
01073,01CS026,6243,5954,6532,7235,992,703,1281,748,-0.11300086329117479,0.35266168934563247,0.7783632702500801,0.753329629329712,7614,7269,7959,8972,1358,1013,1703,1033,-9.95037098299753e-4,0.5672979186932904,1.2089665670134842,0.7600750444797366,670607,668625,Jefferson,Jefferson,1,73,Alabama,AL
01077,01CS027,962,922,1002,1121,159,119,199,130,-0.09472463484573962,0.3051850330775918,0.7169450632572666,0.8114724348778899,1180,1131,1228,1303,123,75,172,174,-1.2978807952723452,-0.6532553220050563,-0.03262098479197026,1.4016069265716662,93570,93980,Lauderdale,Lauderdale,1,77,Alabama,AL
01081,01CS028,1013,938,1088,1123,110,35,185,130,-0.5352994849314986,-0.10089394481546707,0.3410513584528454,1.169397909717234,1277,1186,1369,1442,165,73,256,189,-0.8223827621966434,-0.15642083242161475,0.4637094660203828,1.1416184939994507,173476,176836,Lee,Lee,1,81,Alabama,AL
01083,01CS029,768,723,813,925,157,112,202,91,0.18523875888448543,0.6286622238062085,1.1049913053555063,0.5751175806087722,971,916,1026,1147,176,121,231,122,0.015256096325311198,0.6011053863823628,1.2623757665733615,0.6900010110023879,103899,107051,Limestone,Limestone,1,83,Alabama,AL
01087,01CS030,221,213,229,289,68,60,76,38,1.14504027262532,1.5746512234232324,1.9830215831994542,0.5507539436859453,268,258,278,244,-24,-34,-14,30,-4.027460646119361,-3.4152353124671073,-2.8040627214811993,-1.3115978783824096,19210,18980,Macon+Tallapoosa,Macon,1,87,Alabama,AL
01123,01CS030,481,464,499,534,53,35,70,79,-1.0657120991070035,-0.6396242409450102,-0.21713624567074463,1.4765626816576776,591,570,613,726,135,113,156,99,0.4121977487159662,1.0393349746758376,1.7018682918923709,0.7304181823471463,41077,41053,Macon+Tallapoosa,Tallapoosa,1,123,Alabama,AL
01089,01CS031,2949,2781,3116,3158,209,42,377,217,-0.45503201984258196,-0.018738385363453975,0.40649471343632027,1.0314090491905572,3677,3474,3881,4086,409,205,612,466,-0.777604019167552,-0.18194514509179813,0.42397784669928307,1.1378504058226209,387770,394407,Madison,Madison,1,89,Alabama,AL
01095,01CS032,988,946,1030,1227,239,197,281,147,0.5341126264016854,0.9417967053229496,1.3628008612907063,0.6131424494293509,1213,1163,1264,1420,207,156,257,152,0.08232452207966123,0.6859988364169517,1.239243493150682,0.7322010386863441,97548,98138,Marshall,Marshall,1,95,Alabama,AL
01097,01CS033,3742,3564,3921,4423,681,502,859,473,0.0802868835313779,0.4876586354253215,0.9271253338700988,0.6940509342648129,4582,4369,4796,5813,1231,1017,1444,844,0.5173697921615483,1.1243576322341147,1.7091978088000719,0.6852624758736929,414020,413245,Mobile,Mobile,1,97,Alabama,AL
01101,01CS034,1812,1713,1910,2377,565,467,664,337,0.5496282839700314,0.9859940541159404,1.4239141827542785,0.5949178096428036,2217,2099,2334,2776,559,442,677,384,0.28234498663415175,0.9299447106530101,1.5280399209665922,0.685121611671716,227996,227582,Montgomery,Montgomery,1,101,Alabama,AL
01103,01CS035,1203,1150,1256,1492,289,236,342,169,0.5630526950877524,0.9720975162420402,1.4278761018010757,0.5823722851116303,1481,1417,1545,1690,209,145,273,214,-0.6763452112249073,-0.016689976456013497,0.5281608909852478,1.0198910708198539,122830,123620,Morgan,Morgan,1,103,Alabama,AL
01113,01CS036,546,521,572,637,91,65,116,70,-0.05502179753219884,0.3343179507095814,0.7998180640130786,0.7620361860128801,664,634,695,850,186,155,216,124,0.6351059611921261,1.2554365590767627,1.9079967112100018,0.6638701726436081,59009,58796,Russell,Russell,1,113,Alabama,AL
01115,01CS037,835,795,874,1035,200,161,240,136,0.3028474991521769,0.6955276495770658,1.1073204677995376,0.6758960553114453,1035,987,1083,1311,276,228,324,219,0.150317984321262,0.7547015448873817,1.3312862823609959,0.7912696322740401,91247,92542,St. Clair,St. Clair,1,115,Alabama,AL
01117,01CS038,1347,1251,1444,1592,245,148,341,148,0.013716233091725252,0.4189774083602045,0.8650688727437481,0.6028445041715498,1692,1575,1809,1931,239,122,356,225,-0.5576478750968734,0.06991066889717662,0.6658273349924345,0.9383674950249428,223234,226436,Shelby,Shelby,1,117,Alabama,AL
01125,01CS039,1620,1523,1717,1887,267,170,364,252,-0.33463367078084877,0.0658563967246728,0.5109484479926397,0.9412586819788755,2003,1886,2120,2339,336,219,453,362,-0.7319513379884267,-0.13081904455979348,0.5123049740674381,1.0749779558372166,224683,227028,Tuscaloosa,Tuscaloosa,1,125,Alabama,AL
01127,01CS040,877,849,905,1111,234,206,262,165,0.6279270498588266,1.0665719214855014,1.495360659985518,0.702635825453851,1065,1032,1099,1291,226,192,259,201,-0.15939282759927947,0.4734884034287173,1.0806506758454126,0.885952655191153,64864,64859,Walker+Winston,Walker,1,127,Alabama,AL
01133,01CS040,264,254,274,327,63,53,73,37,0.6901969347915123,1.0997240670380242,1.5143237607405606,0.5772802721938758,323,311,335,424,101,89,113,71,0.949332882716782,1.517161124145682,2.1369129925212067,0.696552001162435,23538,23629,Walker+Winston,Winston,1,133,Alabama,AL
02020,02CS001,1470,1345,1595,1748,278,153,403,117,0.0998672434179543,0.5639805985917995,0.9647585769955602,0.4193085090096149,1823,1674,1972,2351,528,379,677,278,0.47199398635227235,1.0396437643470422,1.674079277063568,0.5251711408579192,290106,288488,Anchorage,Anchorage,2,20,Alaska,AK
02090,02CS002,396,355,437,473,77,36,118,19,0.22504285054067352,0.6132000901520388,1.032864656018031,0.24260554723250496,495,446,545,680,185,135,234,90,0.5703514054319662,1.1539504685811213,1.8660385130152206,0.4848619866144496,95581,95548,Fairbanks North Star,Fairbanks North Star,2,90,Alaska,AK
02122,02CS003,392,366,417,393,1,-24,27,18,-0.7128783915673306,-0.30548303332388493,0.16517644598525838,7.699986038295857,488,457,519,586,98,67,129,66,-0.013898437897917143,0.6458080640069779,1.23542215580029,0.6665795710225099,58987,59640,Kenai Peninsula,Kenai Peninsula,2,122,Alaska,AK
02170,02CS004,535,488,581,639,104,58,151,33,0.2304562424480616,0.656053501326661,1.079707395323032,0.31346718972679205,679,622,736,989,310,253,367,165,1.0110919839826904,1.5775747523994326,2.2032198234321534,0.5307211953347901,107959,110216,Matanuska-Susitna,Matanuska-Susitna,2,170,Alaska,AK
02140,02CS005,48,47,49,52,4,3,5,4,-0.08123337577220903,0.023892365501738143,0.1186531708326544,0.7729551860918993,58,57,59,69,11,10,12,7,0.5343459683070101,0.6788970564696766,0.8182586032590431,0.5702955130873446,7744,7593,Northern Alaska,Northern Alaska,2,140,Alaska,AK
02180,02CS005,63,62,64,66,3,2,4,8,-0.646247230389847,-0.5448174269756345,-0.4464948707154922,2.252369947575741,77,76,78,91,14,13,15,2,1.2864920828994748,1.4444813850286948,1.590847769261839,0.1342730042877047,10016,9889,Northern Alaska,Nome,2,180,Alaska,AK
02185,02CS005,55,54,56,45,-10,-11,-9,8,-1.746613004032188,-1.6461288672246563,-1.5429209195350475,-0.9166207646677272,69,67,70,59,-10,-11,-8,6,-1.8853645443886622,-1.7358552025205056,-1.5868154858958115,-0.6755894792228626,10763,10975,Northern Alaska,North Slope,2,185,Alaska,AK
02240,02CS005,91,90,92,108,17,16,18,6,0.6934549647894657,0.7874107825981008,0.896579980269872,0.3350745858089746,112,110,114,145,33,31,35,10,1.8472312722439874,1.9908276163147784,2.140746080931358,0.29445507227470946,13827,13824,Northern Alaska,Southeast Fairbanks,2,240,Alaska,AK
02261,02CS005,53,52,54,3,-50,-51,-49,3,-5.635854310661575,-5.53564012287223,-5.442063537726377,-0.06080242115228873,65,64,67,4,-61,-63,-60,4,-8.335428683936478,-8.193446632762903,-8.04365174838042,-0.06617087098366915,9634,9588,Northern Alaska,Valdez-Cordova,2,261,Alaska,AK
02100,02CS006,10,10,10,19,9,9,9,7,0.8323470389727254,0.9354046705368572,1.033102134585964,0.699670122464755,12,12,12,21,9,9,9,5,2.2646013362517605,2.398883893493237,2.5504852163548075,0.49255611428746926,2153,2073,Southeast Alaska,Haines,2,100,Alaska,AK
02110,02CS006,166,152,180,171,5,-9,19,4,-0.3958488420079294,0.02895622105296088,0.43591661791023617,0.6923868259802357,205,188,221,218,13,-3,30,13,-0.5789136642894724,0.01794729140630397,0.617205524459637,0.9010225063715359,32149,32005,Southeast Alaska,Juneau,2,110,Alaska,AK
02195,02CS006,192,181,203,231,39,28,50,8,0.7869390447491263,1.2198655585293612,1.6440725580987892,0.20061097165468686,233,220,246,348,115,102,128,16,4.129731658121025,4.767473568003658,5.392533080572893,0.13779379472513953,25242,24932,Southeast Alaska,Petersburg,2,195,Alaska,AK
02220,02CS006,51,50,52,56,5,4,6,3,0.13109828513293073,0.2260963982872001,0.32774340872779634,0.505638338797453,62,61,64,76,14,12,15,1,1.6288979951647158,1.7800505750854665,1.9250123980663476,0.06895716566000429,8436,8410,Southeast Alaska,Sitka,2,220,Alaska,AK
02232,02CS006,32,30,34,20,-12,-14,-10,2,-3.8205145626269483,-3.413953641931492,-2.938867105462685,-0.17680744069769264,39,37,41,44,5,3,7,6,-0.9251057701778236,-0.2929279212918255,0.29834477598213793,1.0157283103671055,4217,4185,Southeast Alaska,Southeast Alaska,2,232,Alaska,AK
02010,02CS007,35,34,36,18,-17,-18,-16,7,-2.876282333103053,-2.777454585957542,-2.674832422213928,-0.43513447099838143,43,42,44,27,-16,-17,-15,7,-3.3485625276029607,-3.1989167965050727,-3.0563485281348006,-0.4786776353963119,8670,8481,Southwest Alaska,Southwest Alaska,2,10,Alaska,AK
02050,02CS007,108,106,110,115,7,5,9,15,-0.5258406060560789,-0.42595540469028853,-0.32605547969232984,1.8469825733751408,133,130,135,144,11,9,14,22,-0.8436247294554639,-0.6977368693382607,-0.5554778580631834,1.804308858865574,18616,18570,Southwest Alaska,Bethel,2,50,Alaska,AK
02060,02CS007,7,7,7,5,-2,-2,-2,5,-8.970826636957009,-8.870570750188467,-8.77273704549308,-3.60304182723741,9,9,9,15,6,6,6,4,2.559993269510399,2.6999057108252114,2.8514721292662224,0.5809360484865159,833,837,Southwest Alaska,Bristol Bay,2,60,Alaska,AK
02070,02CS007,44,43,45,53,9,8,10,3,0.8506022303430981,0.9467069300998597,1.0478082743887784,0.2999051623581022,53,52,54,62,9,8,10,11,-0.5746427811529771,-0.42645461715060734,-0.26851417921672815,1.1237970909450468,6314,6203,Southwest Alaska,Dillingham,2,70,Alaska,AK
02150,02CS007,54,53,55,66,12,11,13,1,0.7361526647541411,0.8437249809954692,0.9410316422248268,0.07699599286029113,66,64,68,104,38,36,40,6,2.8411166206204737,2.9977914979238918,3.144022652622197,0.1537987215436858,13026,12821,Southwest Alaska,Kodiak Island,2,150,Alaska,AK
02158,02CS007,53,52,54,52,-1,-2,-0,4,-0.7280558794055935,-0.6314036130400389,-0.5192943892541989,-15.303465220216207,66,65,67,82,16,15,17,10,0.7543642136327009,0.906285235126747,1.0683281843401715,0.5757485395631751,8361,8360,Southwest Alaska,Southwest Alaska,2,158,Alaska,AK
04001,04CS001,564,557,571,1042,478,471,485,300,2.559648517711844,2.663368109206887,2.7666696240609854,0.6266199524673407,682,674,690,1190,508,500,516,270,4.201201515479014,4.352123349914334,4.505502181133013,0.5303614817693749,66747,65663,Apache,Apache,4,1,Arizona,AZ
04003,04CS002,1150,1096,1204,1387,237,183,291,171,0.08681959431245961,0.5048709399650957,0.9514037319125644,0.7191911586410206,1417,1352,1482,1832,415,350,480,311,0.3766865104446282,0.9942399782853996,1.5945489383496272,0.7476317545034326,125736,125955,Cochise+Graham+Greenee,Cochise,4,3,Arizona,AZ
04009,04CS002,256,240,273,322,66,49,82,50,-0.006788339448378804,0.40555202022828396,0.8241251622638323,0.7507304326785392,320,300,340,489,169,149,189,88,1.8851871261158064,2.4702918134580805,3.101090528984751,0.5185248583507244,38700,38986,Cochise+Graham+Greenee,Graham,4,9,Arizona,AZ
04011,04CS002,56,55,57,62,6,5,7,5,0.031520837620671045,0.13395795051404266,0.24515808300014175,0.6865896417880715,68,67,69,96,28,27,29,25,0.20992924698549886,0.3540248536569465,0.5109997155892158,0.8686297496866247,9502,9421,Cochise+Graham+Greenee,Greenlee,4,11,Arizona,AZ
04005,04CS003,747,685,810,1027,280,217,342,207,0.07346222598158152,0.4970487124863763,0.9465454587801396,0.7370452530643131,929,854,1004,1194,265,190,340,184,0.045449162875048514,0.6743661395030476,1.3043689123634643,0.6910325548373516,144942,145061,Coconino,Coconino,4,5,Arizona,AZ
04007,04CS004,659,636,682,834,175,152,198,118,0.6217481449423298,1.077991605213236,1.45263248073045,0.6708836622529601,804,776,831,1054,250,223,278,157,1.474131481198508,2.086459874802998,2.711742519289876,0.6249573057802864,53448,53548,Gila,Gila,4,7,Arizona,AZ
04025,04CS005,2665,2563,2768,3143,478,375,580,252,0.5191398145402962,0.9388108610750557,1.396520841780112,0.5264739013564554,3304,3179,3428,4117,813,689,938,595,0.4686507221002203,1.089473023049728,1.7356887810249981,0.7306439099602499,237461,241497,La Paz+Yavapai,Yavapai,4,25,Arizona,AZ
04013,04CS006,27383,25469,29296,34979,7596,5683,9510,4403,0.2951355207059471,0.7120109930728131,1.1448185787434664,0.5795545121292061,34149,31832,36466,44145,9996,7679,12313,6755,0.2419081589695442,0.8946026480143665,1.4723240908826554,0.6756873999193596,4452272,4488094,Maricopa,Maricopa,4,13,Arizona,AZ
04015,04CS007,2859,2767,2951,3445,586,494,678,326,0.8212740984222465,1.2071451192907712,1.6238742107407655,0.5554567264994196,3529,3417,3641,4616,1087,975,1199,767,1.1477215310002142,1.7695217260098584,2.4028973127103503,0.7048244592338638,214415,217164,Mohave,Mohave,4,15,Arizona,AZ
04017,04CS008,901,890,912,1519,618,607,629,365,2.2478165601272386,2.3526620287470785,2.4444536694448016,0.5898024621610566,1113,1100,1127,1843,730,716,743,366,3.8886546515721507,4.0465258473426156,4.201039935961218,0.5009190139402019,107560,107951,Navajo,Navajo,4,17,Arizona,AZ
04019,04CS009,8313,7863,8763,10505,2192,1742,2642,1182,0.5639899753825917,0.9610992002202403,1.4391122118112345,0.5389205674100641,10256,9713,10799,12818,2562,2019,3105,1745,0.3334035253963759,0.9395469195277302,1.5699129668576637,0.6808591189631402,1046803,1051092,Pima+Santa Cruz,Pima,4,19,Arizona,AZ
04023,04CS009,264,243,284,413,149,129,170,103,0.5457023831318256,0.9752492247816814,1.3722839126117528,0.68524502463939585,329,304,354,427,98,73,123,79,-0.08597225258244376,0.4612171902339214,1.1067724397709309,0.7976992603511586,47542,47849,Pima+Santa Cruz,Santa Cruz,4,23,Arizona,AZ
04021,04CS010,2671,2485,2858,3650,979,792,1165,389,0.9343039716773911,1.3443613115006305,1.7509801858367486,0.3971239600260413,3386,3155,3616,4936,1550,1320,1781,880,1.2201545682040427,1.7906222012236521,2.4377176087472483,0.5671973046424831,436339,446644,Pinal,Pinal,4,21,Arizona,AZ
04027,04CS011,1530,1434,1626,2445,915,819,1011,576,1.104105741958422,1.5188465051119915,1.9602754071818183,0.6287506332963693,1895,1779,2010,2633,738,623,854,468,0.8422381597857771,1.4291668631967613,2.05136210384251,0.6329258240755644,223368,223051,Yuma,Yuma,4,27,Arizona,AZ
05001,05CS001,205,197,212,259,54,47,62,22,1.4439619071323304,1.8809319284265833,2.319961525512537,0.3979291990832768,247,239,256,336,89,80,97,30,3.616260383205087,4.196485781622468,4.837591919174499,0.3341896294384417,17125,16778,Arkansas (county)+Monroe+Phillips+Prairie,Arkansas (county),5,1,Arkansas,AR
05095,05CS001,98,97,99,116,18,17,19,11,0.9144300929182918,1.0103453988678663,1.1144572748502337,0.5844137052394481,119,119,120,136,17,16,17,20,-0.7773602392221148,-0.6134439592985516,-0.4658283293510037,1.138342893769696,6750,6695,Arkansas (county)+Monroe+Phillips+Prairie,Monroe,5,95,Arkansas,AR
05107,05CS001,197,190,204,266,69,62,76,38,1.4394569014004384,1.8550645032666777,2.287687429579789,0.5437589920485332,235,227,243,311,76,68,84,52,1.148367959369002,1.7911604075771184,2.3558485956094652,0.6762468903122782,16582,15985,Arkansas (county)+Monroe+Phillips+Prairie,Phillips,5,107,Arkansas,AR
05117,05CS001,93,93,94,127,34,33,34,14,2.28505928169674,2.3826615260112316,2.4815957196751257,0.4046385498425678,114,113,115,145,31,30,32,20,1.480622945869854,1.6283084433994988,1.7796131305914376,0.6241657146398661,8214,8151,Arkansas (county)+Monroe+Phillips+Prairie,Prairie,5,117,Arkansas,AR
05005,05CS002,581,563,599,708,127,109,145,75,0.8237283424013331,1.2415649507103046,1.6624013310508228,0.5869668868635485,711,689,732,928,217,196,239,125,2.0386940427502847,2.6214458035046078,3.2562790250324163,0.5725571687178318,41753,42073,Baxter+Marion,Baxter,5,5,Arkansas,AR
05089,05CS002,224,217,231,268,44,37,51,23,0.8113318289581399,1.2409322585637703,1.665675853496046,0.5097937342130018,273,265,282,305,32,23,40,43,-1.4158290389103267,-0.8130662176496939,-0.18191418060407147,1.3197410719897433,16842,16961,Baxter+Marion,Marion,5,89,Arkansas,AR
05007,05CS003,1706,1583,1830,1959,253,129,376,282,-0.5342258260146145,-0.0823223962454551,0.3090388087263384,1.1112363665739555,2150,1999,2301,2519,369,218,520,372,-0.6728325412240188,-0.026123470904103503,0.5873072313733251,1.0051542797072648,286167,292622,Benton,Benton,5,7,Arkansas,AR
05009,05CS004,385,369,401,478,93,77,109,63,0.38032849550750447,0.7942818614193085,1.2236112081459174,0.6691858868771638,473,454,493,582,109,89,128,68,0.6456114001253218,1.267020383119043,1.8800274271867707,0.6203354895572113,37440,37760,Boone+Carroll+Madison,Boone,5,9,Arkansas,AR
05015,05CS004,280,268,292,314,34,22,46,38,-0.555477067479398,-0.12112134360385272,0.2579772798784024,1.0776348415006867,343,329,358,394,51,36,65,40,-0.11927356803793276,0.4628829421812505,1.0784870271300129,0.7726420105902637,28248,28401,Boone+Carroll+Madison,Carroll,5,15,Arkansas,AR
05087,05CS004,169,162,176,154,-15,-22,-8,10,-1.9449326798100093,-1.5114890814927435,-1.0797813927867468,-0.7094105666899645,210,201,219,259,49,40,58,32,0.6217263060986888,1.226409443668147,1.835393386745341,0.6393295565575903,16589,16900,Boone+Carroll+Madison,Madison,5,87,Arkansas,AR
05011,05CS005,132,128,137,167,35,30,39,27,0.26316503886358594,0.7078630397542949,1.139722845155275,0.7603897924894973,160,155,166,165,5,-1,10,18,-2.0922955315962084,-1.5309569514782484,-0.9557812593565445,3.134894008415737,10532,10421,Bradley+Calhoun+Cleveland+Union,Bradley,5,11,Arkansas,AR
05013,05CS005,59,59,60,69,10,9,10,4,1.0859432308109576,1.1798164259004216,1.2861748631008803,0.3755808266041666,72,72,73,89,17,16,17,5,2.858324602613721,3.00811901410444,3.1731132647706604,0.2795312519535756,4787,4739,Bradley+Calhoun+Cleveland+Union,Calhoun,5,13,Arkansas,AR
05025,05CS005,87,86,87,110,23,23,24,20,0.3405635982159512,0.44140594431690794,0.5456604098452809,0.8212415579925513,105,104,106,135,30,29,31,11,2.83670642909286,2.9844544762359453,3.1345673885740175,0.3584666285727832,7598,7518,Bradley+Calhoun+Cleveland+Union,Cleveland,5,25,Arkansas,AR
05139,05CS005,439,422,456,539,100,83,117,70,0.35676679861750243,0.764599384042268,1.1886362730659537,0.6935762695009516,531,511,551,617,86,66,106,70,-0.1559186972721034,0.4732052333520486,1.142318117868957,0.8058601687059327,38828,38425,Bradley+Calhoun+Cleveland+Union,Union,5,139,Arkansas,AR
05019,05CS006,202,193,211,243,41,32,50,18,0.6385572030744788,1.0816617491509455,1.474986450169715,0.4296840531322767,247,236,258,291,44,33,55,35,-0.10059957359046794,0.5073448499875515,1.1502413469138635,0.7738524037600483,21504,21327,Clark+Dallas+Ouachita,Clark,5,19,Arkansas,AR
05039,05CS006,83,82,83,105,22,22,23,14,1.1618200752780912,1.264089472250738,1.3630593378224374,0.6030227088891988,99,98,99,119,20,20,21,5,2.7651519496957286,2.914116687454756,3.0683971798224,0.23403472737211195,6505,6328,Clark+Dallas+Ouachita,Dallas,5,39,Arkansas,AR
05103,05CS006,280,271,290,341,61,51,70,38,0.5926571690538533,0.9989842086443212,1.403956698040501,0.6157018121145087,338,327,350,392,54,42,65,46,-0.24547599435847411,0.4122643478418315,1.0460084393433815,0.8377204768982681,22676,22348,Clark+Dallas+Ouachita,Ouachita,5,103,Arkansas,AR
05021,05CS007,198,192,204,216,18,12,24,27,-1.0389672011462914,-0.6259320447497667,-0.1763946706001684,1.4414605193626586,239,232,246,280,41,34,48,41,-0.6060159155098899,-0.010641199031800826,0.6783436824151146,0.9755426447324376,14490,14373,Clay+Greene,Clay,5,21,Arkansas,AR
05055,05CS007,432,412,452,495,63,43,83,56,-0.28898876191189954,0.14706919719644626,0.5545108197918222,0.8770952162909746,532,509,556,612,80,56,103,73,-0.4072437474100955,0.15704542525478324,0.827119337059969,0.9067501000673381,45797,46244,Clay+Greene,Greene,5,55,Arkansas,AR
05027,05CS008,235,226,245,319,84,74,93,30,1.899163463077887,2.349787390368548,2.7620394840654585,0.3549418043935525,285,274,297,304,19,7,30,24,-0.9254863101943093,-0.30088576765532266,0.3355397666684961,1.2137676457450761,22844,22682,Columbia+Lafayette+Miller,Columbia,5,27,Arkansas,AR
05073,05CS008,77,76,77,105,28,28,29,5,3.6124509222728154,3.7092751686272636,3.810452506862162,0.1695047369273826,92,91,92,105,13,13,14,13,-0.06953644558239168,0.07213707245710528,0.2426188630918448,0.9042278759004573,6333,6182,Columbia+Lafayette+Miller,Lafayette,5,73,Arkansas,AR
05091,05CS008,415,396,433,503,88,70,107,61,0.18964577955201423,0.6350529219409226,1.076369319312103,0.6825661888731155,505,483,527,654,149,127,171,102,0.727767426272108,1.327385997538797,1.9382298201086334,0.6803187920379641,42695,42637,Columbia+Lafayette+Miller,Miller,5,91,Arkansas,AR
05029,05CS009,234,225,243,229,-5,-14,4,11,-1.1520288025020902,-0.7946071214214028,-0.35060496365627386,-2.594127309632951,287,276,298,301,14,3,25,27,-1.4103751543739154,-0.7449718736522704,-0.1533115766350166,1.8178063005775507,20770,20852,Conway+Pope,Conway,5,29,Arkansas,AR
05115,05CS009,515,488,543,642,127,99,154,56,0.6855464444832303,1.1036237476578115,1.5369177327635477,0.43823314124643353,636,603,668,752,116,84,149,93,-0.16157191692751519,0.41850060025264785,1.0649045934898802,0.7916657272949026,63509,63724,Conway+Pope,Pope,5,115,Arkansas,AR
05031,05CS010,834,786,882,1005,171,123,219,99,0.22572383273224883,0.6629502666095348,1.0613128886626362,0.57507200641783,1030,973,1088,1189,159,101,216,104,-0.00981009200335445,0.597193167866002,1.2092337155389195,0.6516260243749927,111526,112124,Craighead,Craighead,5,31,Arkansas,AR
05033,05CS011,521,495,547,663,142,116,168,56,0.9884957676845577,1.4245590347775314,1.822765968468296,0.3925314969891423,637,606,668,874,237,206,268,123,1.6441012646235205,2.2725981856588304,2.8550297566969634,0.5166992421152086,60616,60338,Crawford,Crawford,5,33,Arkansas,AR
05035,05CS012,435,414,456,555,120,99,141,68,0.6631016743519557,1.0866700823564355,1.4991900124268067,0.5621094521141192,531,506,555,685,154,130,179,87,1.0505973429738495,1.7116198550945292,2.3090603655967294,0.5600354978572187,47990,47604,Crittenden,Crittenden,5,35,Arkansas,AR
05037,05CS013,200,193,208,223,23,15,30,29,-0.8022424276159469,-0.37653735529199084,0.026729825562250075,1.2304658440948433,245,236,254,266,21,12,30,29,-1.2084005380494809,-0.5529763612287105,0.028089616171452232,1.3196472146823512,16691,16693,Cross+Lee+St. Francis,Cross,5,37,Arkansas,AR
05077,05CS013,93,93,94,144,51,50,51,17,3.799733028908178,3.9075720929856033,4.014225667967098,0.3295263106344774,115,114,116,155,40,39,41,27,1.6740516494559106,1.8201131241977566,1.9616946896198542,0.6579467639002669,8591,8606,Cross+Lee+St. Francis,Lee,5,77,Arkansas,AR
05123,05CS013,211,201,221,271,60,50,70,32,0.7386450638470646,1.2010036260951644,1.6398198829723687,0.522884545326457,255,244,267,336,81,69,92,46,1.2834609047160228,1.8218076154910743,2.4682387219268156,0.5632402962045017,23296,22784,Cross+Lee+St. Francis,St. Francis,5,123,Arkansas,AR
05045,05CS014,852,799,906,954,102,48,155,70,-0.1984469741837936,0.2547771945311609,0.687146976540912,0.6828230168211072,1060,996,1125,1189,129,64,193,117,-0.46299854414312736,0.10049886674188788,0.7531620810176679,0.9010112414010251,124131,124896,Faulkner,Faulkner,5,45,Arkansas,AR
05047,05CS015,190,182,197,242,52,45,60,22,1.3635126724076558,1.7574026437934358,2.189838775912174,0.4115450109512299,231,222,240,275,44,35,53,31,0.2950351218218201,0.9064855728354468,1.5397952193917923,0.6894976415000567,17217,17166,Franklin+Johnson+Logan,Franklin,5,47,Arkansas,AR
05071,05CS015,229,218,240,272,43,32,54,20,0.4806064225809329,0.8729899536704762,1.3230302341582767,0.45399045682480044,281,267,294,354,73,60,87,46,0.6581618982892529,1.255452606857372,1.887404249904041,0.6198860703695818,25840,25823,Franklin+Johnson+Logan,Johnson,5,71,Arkansas,AR
05083,05CS015,240,231,249,285,45,36,54,12,1.1642844705138793,1.5790340103629237,2.013820859624631,0.2595341198641344,293,282,304,375,82,71,93,37,1.9147565297495797,2.5468585765900538,3.1717697650733965,0.4463189531496056,21167,21198,Franklin+Johnson+Logan,Logan,5,83,Arkansas,AR
05051,05CS016,1217,1174,1260,1365,148,105,191,137,-0.33182755271611547,0.10626458949601077,0.5522505913734465,0.9211381913660526,1487,1435,1539,1705,218,166,270,229,-0.7319958970251308,-0.13947758516293185,0.43950827504660855,1.044960987618593,100079,100306,Garland,Garland,5,51,Arkansas,AR
05053,05CS017,177,169,184,201,24,17,32,14,0.14676223016441858,0.5759531569485135,1.0003181383700406,0.5521411580306015,217,208,226,306,89,80,98,39,2.705445899158636,3.315854634255772,3.9116471762538603,0.4332240924048976,18032,18073,Grant+Hot Spring,Grant,5,53,Arkansas,AR
05059,05CS017,361,346,375,441,80,66,95,51,0.47946613840179053,0.8818207127484019,1.3192865000357379,0.6261799514786295,441,424,458,526,85,68,102,53,0.5400699705336336,1.175227393562448,1.7902738264082962,0.6153118125163307,33155,33131,Grant+Hot Spring,Hot Spring,5,59,Arkansas,AR
05057,05CS018,192,183,200,226,34,26,43,20,0.2852381695760407,0.7050360261537674,1.146502109287892,0.5687774540904761,231,221,242,280,49,38,59,29,0.5967088919903489,1.1914585395599453,1.7834530561348942,0.5851559935709966,20192,19738,Hempstead+Howard+Nevada+Pike,Hempstead,5,57,Arkansas,AR
05061,05CS018,154,149,160,171,17,11,22,18,-0.49374964641537755,-0.10172833015768237,0.34391420489407926,1.0030332862366556,187,181,194,164,-23,-30,-17,14,-4.15488302114697,-3.486156590368364,-2.85727759044727,-0.634115860650499,12817,12706,Hempstead+Howard+Nevada+Pike,Howard,5,61,Arkansas,AR
05099,05CS018,99,98,100,118,19,18,20,22,-0.437745633889628,-0.34256373967009235,-0.24355795315743442,1.0900509714247277,120,119,121,115,-5,-6,-4,18,-3.56176189981957,-3.414145116369673,-3.2621555075596125,-4.16936251847372,8262,8201,Hempstead+Howard+Nevada+Pike,Nevada,5,99,Arkansas,AR
05109,05CS018,111,110,112,129,18,17,19,18,-0.14581669334971212,-0.04477921767066597,0.05593874486451432,0.9707437007962798,135,134,136,177,42,41,43,27,1.6576845325789347,1.8106633362057316,1.9573420878355194,0.6248233498095438,10233,10080,Hempstead+Howard+Nevada+Pike,Pike,5,109,Arkansas,AR
05063,05CS019,351,335,368,452,101,84,117,72,0.3445897946269405,0.7454878176820399,1.1700403098438055,0.7079802009331939,427,407,446,545,118,99,138,76,0.7315004750178588,1.3306272631665175,1.9152642337284267,0.6362065089388292,37864,37748,Independence+Jackson+Woodruff,Independence,5,63,Arkansas,AR
05067,05CS019,188,181,195,239,51,44,58,22,1.291221938586519,1.7320171383062313,2.169678897878888,0.42269181537341854,229,220,238,254,25,16,34,22,-0.3835704940453062,0.21313848857125337,0.8184868557783622,0.8461608075614757,16751,16800,Independence+Jackson+Woodruff,Jackson,5,67,Arkansas,AR
05147,05CS019,83,82,83,95,12,12,13,6,0.8855315579981312,0.9923612805417042,1.096884517032088,0.45541954495927406,100,99,101,105,5,4,6,16,-2.2740301401391583,-2.121070644975728,-1.9752881876192152,2.5944147515068314,6225,6128,Independence+Jackson+Woodruff,Woodruff,5,147,Arkansas,AR
05069,05CS020,684,655,713,901,217,188,246,132,0.8396613737774111,1.2681318879671293,1.6621811698471172,0.6055598913033118,826,792,860,998,172,138,206,102,0.7184701676335489,1.2671392150863408,1.8321870158125853,0.5899028854822269,66760,66000,Jefferson,Jefferson,5,69,Arkansas,AR
05081,05CS021,148,142,153,192,44,39,50,28,0.9558528555386911,1.3652532510411275,1.8129268934115024,0.6154039094502677,179,173,185,200,21,15,27,35,-2.092067020169251,-1.449330142012846,-0.8366783052803084,1.6145381092013116,12026,11948,Little River+Polk+Sevier,Little River,5,81,Arkansas,AR
05113,05CS021,227,219,236,258,31,22,39,51,-1.463969344190527,-1.0562114682837456,-0.6096258035551353,1.6108789657831037,279,269,289,374,95,85,105,72,0.7978012880189072,1.4530744427456266,2.09877890393916,0.7473884331792653,19311,19328,Little River+Polk+Sevier,Polk,5,113,Arkansas,AR
05133,05CS021,135,129,142,175,40,33,46,29,0.2311522636404676,0.6695891461693869,1.0962713711502843,0.7149896343521035,166,157,174,229,63,55,72,35,1.5595005042780874,2.1512832145778553,2.7602449868583707,0.5436537198431123,15953,15782,Little River+Polk+Sevier,Sevier,5,133,Arkansas,AR
05085,05CS022,598,566,630,674,76,44,108,75,-0.4186683107512674,0.018264621495122254,0.4434439839243965,0.9698454808642503,738,699,776,836,98,60,137,85,-0.3790127548579672,0.20760208500547908,0.8325692841321044,0.8562921395950983,74055,74623,Lonoke,Lonoke,5,85,Arkansas,AR
05093,05CS023,426,409,444,571,145,127,162,82,1.1279119683095524,1.5523958450647561,2.009213309769184,0.5628315048156686,514,493,535,594,80,59,101,61,-0.04198806523068076,0.5713804406375713,1.1791894450890084,0.7534294388454235,40446,39784,Mississippi+Poinsett,Mississippi,5,93,Arkansas,AR
05111,05CS023,283,273,293,352,69,59,79,49,0.4275613587202051,0.8589854928284767,1.287974984000435,0.7006827857878325,342,331,354,423,81,69,92,40,1.5433327321609835,2.1457159182746146,2.7479373307108625,0.4898742139984851,22958,22694,Mississippi+Poinsett,Poinsett,5,111,Arkansas,AR
05097,05CS024,125,121,129,135,10,6,14,21,-1.6588786166101588,-1.2784466913098758,-0.7950586556043749,1.8885230530798527,153,148,157,173,20,16,25,34,-2.550664893536793,-1.9375875750725133,-1.3004705788339666,1.5950391168736746,8561,8589,Montgomery+Perry+Scott+Yell,Montgomery,5,97,Arkansas,AR
05105,05CS024,105,104,107,111,6,4,7,3,0.14734719291870632,0.24964296830275134,0.3442831805740841,0.46145196985863446,128,127,130,152,24,22,25,20,0.2875175382797539,0.4483865403523112,0.6007055777137814,0.8091085556394122,10055,9969,Montgomery+Perry+Scott+Yell,Perry,5,105,Arkansas,AR
05127,05CS024,109,108,110,141,32,31,33,14,1.7651053671997272,1.863737586195166,1.9673446339083471,0.4190553273652491,132,131,134,181,49,47,50,19,3.458497235922419,3.610469093681409,3.772713261235781,0.38339806189022235,9871,9820,Montgomery+Perry+Scott+Yell,Scott,5,127,Arkansas,AR
05149,05CS024,213,204,221,252,39,31,48,37,-0.28507665816828964,0.11625453170933155,0.5638641798662792,0.9146691199253302,257,247,268,297,40,29,50,40,-0.6634454375759816,-0.02373710613837666,0.6179149790137906,0.9856178029515504,20379,20164,Montgomery+Perry+Scott+Yell,Yell,5,149,Arkansas,AR
05119,05CS025,3240,3069,3412,3803,563,391,734,342,0.11538897585374565,0.5529557851475273,0.9868624126681761,0.6066314483742823,3979,3773,4184,4722,743,538,949,479,0.2103831520558868,0.8002734315299609,1.424887185170221,0.6436332821721855,397957,398004,Pulaski,Pulaski,5,119,Arkansas,AR
05125,05CS026,1024,970,1077,1101,77,24,131,98,-0.5822497898231858,-0.1674636130471601,0.29400418822793717,1.250589578915856,1269,1205,1334,1580,311,246,375,165,0.7478608020845484,1.4130382503898657,2.001339498896098,0.528934536270651,123678,125007,Saline,Saline,5,125,Arkansas,AR
05131,05CS027,1111,1056,1165,1345,234,180,289,111,0.5201457859833795,0.9548990417344817,1.3954981875203814,0.4713623529243107,1367,1301,1433,1711,344,278,410,217,0.5484606003720796,1.1809445184188616,1.830558001106436,0.6294523188540524,127800,128304,Sebastian,Sebastian,5,131,Arkansas,AR
05049,05CS028,164,159,169,183,19,14,24,35,-1.7469245475631283,-1.2948505424785601,-0.8746740545394628,1.7333842128301844,200,194,206,256,56,50,62,43,0.6192096622935489,1.2938250915834193,1.9163090678040813,0.7545311206697705,12115,12129,Sharp and Nearby Counties,Fulton,5,49,Arkansas,AR
05065,05CS028,175,169,181,191,16,10,22,10,0.05200441640144864,0.46353947295591,0.8746363002597511,0.5805405723952068,217,209,224,262,45,38,53,35,0.28560654654194456,0.8957374180118447,1.5227802472496452,0.7541415465996123,13617,13862,Sharp and Nearby Counties,Izard,5,65,Arkansas,AR
05075,05CS028,201,194,208,230,29,22,36,32,-0.6122051522303259,-0.17942519037346807,0.26375187788678417,1.0608250360664768,245,237,254,250,5,-4,13,18,-1.650848190766734,-0.9589260600377731,-0.3890763284481808,3.2537646479846813,16242,16278,Sharp and Nearby Counties,Lawrence,5,75,Arkansas,AR
05121,05CS028,222,214,230,258,36,28,44,44,-0.8625786873920214,-0.4144143827322066,-0.01043710832264275,1.1824741642281478,274,264,284,283,9,-1,19,24,-1.5265494987088024,-0.9378200788413642,-0.37022668583415125,2.3826482814676595,18549,18824,Sharp and Nearby Counties,Randolph,5,121,Arkansas,AR
05135,05CS028,246,239,253,240,-6,-13,1,26,-2.2847170404148978,-1.8528520282770438,-1.4342169671470602,-5.177475838465273,303,294,313,347,44,34,53,42,-0.534574787172728,0.10886551832056911,0.7049693665918564,0.9431596320177345,17317,17572,Sharp and Nearby Counties,Sharp,5,135,Arkansas,AR
05003,05CS029,211,203,219,248,37,29,45,21,0.4044616038565163,0.8308840218166264,1.2688654187290678,0.5563639261032566,255,246,265,321,66,56,75,37,1.2321864696077236,1.8410745590677524,2.4480500642458867,0.5549066436137544,19044,18716,Southeast Arkansas,Ashley,5,3,Arkansas,AR
05017,05CS029,134,129,138,149,15,11,20,25,-1.345299641034229,-0.9456578297024855,-0.4813057872558902,1.517643760179456,162,156,167,171,9,4,15,13,-1.0343900303976394,-0.4495649239821849,0.16100829492796945,1.2598451261986678,10137,10037,Southeast Arkansas,Chicot,5,17,Arkansas,AR
05041,05CS029,143,138,147,151,8,4,13,13,-0.8296563001748969,-0.4034861991775896,-0.005543117241728499,1.3850874757960434,172,166,177,191,19,14,25,24,-1.0898157022653672,-0.5115851341737728,0.09846367395204257,1.1803379298806,11315,11125,Southeast Arkansas,Desha,5,41,Arkansas,AR
05043,05CS029,171,164,179,238,67,59,74,23,2.082715787862813,2.52001154175179,2.934562949017632,0.3405524611143999,208,199,217,223,15,6,24,24,-1.2120355911071259,-0.6651574288593279,-0.047746988188459946,1.525023389241581,17402,17139,Southeast Arkansas,Drew,5,43,Arkansas,AR
05079,05CS029,129,123,135,151,22,16,28,27,-0.8151253246442043,-0.3931089278789398,0.019748865045987087,1.1764291870838026,160,153,167,176,16,9,23,28,-1.7341751597233754,-1.0920977781617889,-0.496436524259297,1.6362826479163974,12915,13014,Southeast Arkansas,Lincoln,5,79,Arkansas,AR
05023,05CS030,320,309,331,368,48,37,59,38,-0.008276585639732442,0.40634095745137433,0.844926608803928,0.7742011001178688,394,381,407,457,63,50,76,61,-0.524041884418968,0.08192901928326081,0.7109382054642412,0.9570922912108077,24753,24964,Van Buren and Nearby Counties,Cleburne,5,23,Arkansas,AR
05101,05CS030,78,77,78,124,46,46,47,17,3.928313967695745,4.029127395437744,4.134657688157957,0.3593264580121261,94,94,95,139,45,44,45,15,4.779488580615884,4.9204090673265926,5.080495009925354,0.3290932613048928,7274,7203,Van Buren and Nearby Counties,Newton,5,101,Arkansas,AR
05129,05CS030,100,99,101,91,-9,-10,-8,15,-3.1320231974972215,-3.0311780739090484,-2.939436758057871,-1.9283448844812485,123,122,124,158,35,34,36,15,2.93567354845289,3.0731584143207726,3.232468831720106,0.41457073052712257,7838,7872,Van Buren and Nearby Counties,Searcy,5,129,Arkansas,AR
05137,05CS030,151,146,156,197,46,41,51,19,1.7590822086054434,2.179244022203841,2.615537630823927,0.40415473840369626,186,179,192,243,57,51,64,25,2.522802489067734,3.1322379402122,3.7128502725231547,0.4277739359489245,12413,12464,Van Buren and Nearby Counties,Stone,5,137,Arkansas,AR
05141,05CS030,201,194,208,201,0,-7,7,13,-1.2490182400143621,-0.825222545316382,-0.4013643807846539,11.939954276623661,244,236,252,323,79,71,87,35,2.7960849685965687,3.3902448424935683,3.9696254443613754,0.43567925484053566,15869,15704,Van Buren and Nearby Counties,Van Buren,5,141,Arkansas,AR
05143,05CS031,1481,1375,1587,1646,165,59,271,217,-0.6448384674962215,-0.21726646113361273,0.19997540619999324,1.3039910651216808,1854,1725,1983,2044,190,61,319,237,-0.8086326172342209,-0.238794410129229,0.37850834958329543,1.2403376437661093,245955,249562,Washington,Washington,5,143,Arkansas,AR
05145,05CS032,711,678,744,841,130,97,163,55,0.5422808504903176,0.9507182037150155,1.3803908999862469,0.4209841154808119,873,833,912,1094,221,182,261,111,1.1195205155809793,1.7230173659666774,2.366230388297595,0.4990953666703277,77115,77149,White,White,5,145,Arkansas,AR
06001,06CS001,8592,7872,9312,9396,804,84,1524,635,-0.3560971664028832,0.1017587637026516,0.5159213795069124,0.7888445197072179,10539,9685,11392,11264,725,-128,1579,805,-0.6895203359823013,-0.051458436982293354,0.5440711709909767,1.1084350571432975,1674918,1653119,Alameda,Alameda,6,1,California,CA
06003,06CS002,18,18,19,19,1,0,1,4,-3.033904508036771,-2.943196962997418,-2.8318275794629226,2.660582742857238,24,23,24,27,3,3,4,4,-0.6523172630380397,-0.49601526794873596,-0.34159000678386714,0.8916409151508271,1189,1230,Alpine and Nearby Counties,Alpine,6,3,California,CA
06005,06CS002,396,378,413,426,30,13,48,19,-0.15876085366138715,0.28340638294761666,0.7237913160366005,0.6042728975696215,491,470,513,549,58,36,79,43,-0.1838576942514108,0.4308106634627207,1.0554857785382872,0.7334496513144619,40492,41154,Alpine and Nearby Counties,Amador,6,5,California,CA
06009,06CS002,431,411,450,466,35,16,55,17,-0.026827004573523525,0.3922277472900585,0.8329306069659487,0.4704076554003277,535,511,558,619,84,61,108,59,0.028320120307469342,0.6417989724067754,1.2692005500873231,0.6905523874907993,45536,46091,Alpine and Nearby Counties,Calaveras,6,9,California,CA
06027,06CS002,191,183,199,204,13,5,21,28,-1.1909877610097233,-0.7731235150564301,-0.3459863985299549,1.9519260805875824,234,224,244,245,11,1,21,22,-1.3464472616148082,-0.6961090586877617,-0.04066306772967047,1.8186254775765627,18867,18978,Alpine and Nearby Counties,Inyo,6,27,California,CA
06051,06CS002,54,53,55,39,-15,-16,-14,2,-1.3717037424072422,-1.2701185582149517,-1.1640458712774469,-0.14293831304513802,68,66,69,64,-4,-5,-2,4,-0.8494267048753908,-0.6966052958049803,-0.5345809794158579,-1.4826495776703958,13392,13241,Alpine and Nearby Counties,Mono,6,51,California,CA
06007,06CS003,1877,1786,1968,1992,115,24,206,132,-0.5181548955564417,-0.0775502885720924,0.3541558516914797,1.1374458194411317,2273,2165,2381,2569,296,188,404,293,-0.63660975653593,0.008713434401024013,0.641126844014889,0.9866719717789245,211159,208568,Butte,Butte,6,7,California,CA
06011,06CS004,148,139,157,155,7,-2,16,15,-0.7875162841407674,-0.3758064324651286,0.04084595989459511,1.8888626456923872,183,171,194,183,0,-11,12,23,-1.8487671340206542,-1.2315796771863272,-0.6393150057564961,18.70754907295726,21804,21908,Colusa+Lake,Colusa,6,11,California,CA
06033,06CS004,777,747,806,719,-58,-87,-28,39,-1.866362428689295,-1.4317435564819712,-1.0073158470781556,-0.6901895426183989,956,921,991,956,0,-35,35,89,-2.1851395372783675,-1.5545908767052041,-0.9629807559243857,87.58871869190837,67694,68680,Colusa+Lake,Lake,6,33,California,CA
06013,06CS005,6794,6293,7294,7277,483,-17,984,422,-0.3628462755224108,0.05885389416429736,0.5033678338400721,0.8714293227775489,8388,7788,8988,9111,723,123,1323,650,-0.5172749028989849,0.07079199982329723,0.6801554437504325,0.89815219911675,1163281,1162018,Contra Costa,Contra Costa,6,13,California,CA
06015,06CS006,260,248,272,283,23,11,35,6,0.18838132920883882,0.5853352239189957,1.019023645977807,0.25211687308541886,322,307,336,380,58,44,73,45,-0.08853127699063347,0.5352810836227763,1.1944815323521185,0.7624334467757279,27778,28043,Del Norte+Humboldt+Trinity,Del Norte,6,15,California,CA
06023,06CS006,1148,1089,1207,1200,52,-7,111,23,-0.22550414762633425,0.2208167443384317,0.6115682712324083,0.43390698566887964,1411,1340,1481,1602,191,121,262,93,0.24007863022915585,0.8830402219495908,1.5123293324589684,0.48328514687177093,136272,136316,Del Norte+Humboldt+Trinity,Humboldt,6,23,California,CA
06105,06CS006,177,171,184,147,-30,-37,-24,4,-2.6251356691342793,-2.2165662870316027,-1.7749565354271974,-0.1363302029123569,221,212,229,198,-23,-31,-14,19,-3.739413605836786,-3.1140047639650006,-2.523522628076115,-0.8751716758632864,15538,16064,Del Norte+Humboldt+Trinity,Trinity,6,105,California,CA
06017,06CS007,1353,1270,1435,1514,161,79,244,72,0.029974643443537993,0.4711403292362842,0.8966605422134107,0.44319489633850484,1676,1576,1775,1902,226,127,326,159,-0.2121994159449622,0.41020507364422903,1.0323108983355216,0.6994115664595788,191617,192914,El Dorado,El Dorado,6,17,California,CA
06019,06CS008,6034,5601,6468,7507,1473,1039,1906,937,0.09460334057468892,0.5337261831954554,0.9731169792341235,0.6358953385905118,7503,6980,8026,9345,1842,1319,2365,1402,-0.09568788996334208,0.5177132937612873,1.1392928628001115,0.7608434570782251,1007825,1012908,Fresno,Fresno,6,19,California,CA
06021,06CS009,233,220,245,223,-10,-22,3,22,-1.542311647804853,-1.0900952599632678,-0.6894983518043433,-2.4765874263580923,287,272,302,330,43,28,58,59,-1.2429860135874309,-0.6452988251249258,-0.017852496464966096,1.3310390927083093,28818,28818,Glenn+Tehama,Glenn,6,21,California,CA
06103,06CS009,612,584,640,679,67,39,95,44,-0.0836279468008861,0.35974680104443935,0.7589344297989524,0.648742101625862,751,717,785,940,189,155,223,129,0.4920939301907856,1.0838035636712806,1.6856496241768355,0.6790419770242712,65540,65515,Glenn+Tehama,Tehama,6,103,California,CA
06025,06CS010,969,951,987,1660,691,673,709,529,0.8077103763614711,0.9013569027550722,1.0040472574592973,0.7642393289368794,1196,1173,1218,1585,389,367,412,344,0.1560532185838788,0.3043045987957735,0.4528185273977702,0.8811409409052161,179665,179798,Imperial,Imperial,6,25,California,CA
06029,06CS011,5345,4954,5736,6535,1190,799,1581,678,0.14575224833636635,0.5682481311418228,0.9910746101418092,0.5692899772825795,6672,6199,7145,8582,1910,1437,2383,1345,0.09222036675939664,0.7610186535525011,1.3312537935988835,0.7038561627298426,909178,916554,Kern,Kern,6,29,California,CA
06031,06CS012,749,683,814,920,171,106,237,113,-0.04790076931970423,0.36753731224899233,0.7886447560987359,0.6557680702689436,938,859,1017,1301,363,284,442,225,0.4891431006977055,1.0905870240681321,1.7067699683060271,0.6181271924070978,152727,153324,Kings,Kings,6,31,California,CA
06035,06CS013,223,209,237,247,24,10,38,16,-0.18164937331187261,0.26166286607125144,0.6676757548134505,0.6341199927462425,278,261,296,364,86,68,103,65,0.12580393004869664,0.7175912087458293,1.4019763148461581,0.7510922721797665,32470,33095,Lassen+Plumas+Sierra,Lassen,6,35,California,CA
06063,06CS013,203,194,211,232,29,21,38,7,0.7059583378361296,1.1380343427435953,1.5679859839450763,0.2304455337875594,249,239,260,278,29,18,39,30,-0.6894522444810047,-0.08553870156692395,0.5551160835811586,1.0162180200201485,19680,19894,Lassen+Plumas+Sierra,Plumas,6,63,California,CA
06091,06CS013,32,31,32,36,4,4,5,1,0.939860271972278,1.0435644263918682,1.1374083099447012,0.1873972223649038,40,39,40,37,-3,-3,-2,3,-2.270497846428346,-2.1309027997971905,-1.9792787664465663,-1.6570807662010616,3194,3275,Lassen+Plumas+Sierra,Sierra,6,91,California,CA
06037,06CS014,53793,49505,58081,69724,15931,11643,20219,11176,0.04331016611358829,0.4792550449036572,0.9050463472165967,0.7014837755590095,66022,60935,71108,82176,16154,11068,21241,13943,-0.3711307081765402,0.2758790775050007,0.8572672471954395,0.8630508098428714,9975810,9852822,Los Angeles,Los Angeles,6,37,California,CA
06039,06CS015,949,882,1017,1137,188,120,255,170,-0.32350493314992385,0.11254429507845008,0.4942553258834407,0.9012352195677493,1188,1106,1270,1494,306,224,388,269,-0.34862593629075134,0.28160873918801543,0.9216838527036693,0.8753441181274545,156925,159003,Madera,Madera,6,39,California,CA
06041,06CS016,1665,1552,1777,1754,89,-23,202,114,-0.5242965110081514,-0.09680619181460338,0.3293579547597269,1.2644057464614553,2048,1914,2183,2165,117,-18,251,76,-0.46696431136599226,0.1680946418297651,0.7830716935157679,0.6460557304058087,261220,260435,Marin,Marin,6,41,California,CA
06043,06CS017,173,166,180,175,2,-5,9,5,-0.596120139860442,-0.16808269145704824,0.25262813666130574,1.7037755666682626,212,203,220,243,31,23,40,22,0.021592924990964723,0.6523454845424012,1.3147844049560515,0.6783780924456176,17125,17144,Mariposa+Tuolumne,Mariposa,6,43,California,CA
06109,06CS017,583,559,607,647,64,40,88,33,0.15208807184195836,0.5522230830169222,1.0055765074657086,0.5100991650919414,716,687,745,847,131,102,160,115,-0.2723975883320007,0.33771494006849745,1.009736402309426,0.8708486418446073,55368,55767,Mariposa+Tuolumne,Tuolumne,6,109,California,CA
06045,06CS018,753,714,793,870,117,77,156,35,0.46955544708024943,0.9000237001223002,1.3450573529778413,0.29758426290599466,928,881,975,1056,128,81,175,65,0.23331128951961938,0.8350145179146367,1.4463486487145074,0.5039629449147802,90704,91312,Mendocino,Mendocino,6,45,California,CA
06047,06CS019,1566,1445,1687,1948,382,261,503,260,0.028858714478380253,0.44007402166514337,0.8844322603067247,0.6789652968557184,1964,1817,2112,2341,377,229,524,384,-0.6393962442574871,-0.022819319951367243,0.5420022494647225,1.0171171676316133,281547,285770,Merced,Merced,6,47,California,CA
06049,06CS020,94,93,95,101,7,6,8,2,0.5121241405636657,0.6175731411144688,0.712391044079616,0.24075128192197814,114,113,116,141,27,25,28,12,1.8603288262126394,2.006588645736632,2.164207233563182,0.43625478490937813,8689,8661,Modoc+Siskiyou,Modoc,6,49,California,CA
06093,06CS020,492,473,511,542,50,31,69,14,0.39286487174982276,0.828364256599715,1.249813065833227,0.27340334860235055,600,577,623,742,142,119,165,75,1.2232922816007492,1.8299864291542505,2.4583302453433933,0.5238670076145315,43935,44095,Modoc+Siskiyou,Siskiyou,6,93,California,CA
06053,06CS021,2246,2058,2434,2539,293,105,481,256,-0.34796067424712174,0.07890248806552362,0.5185844395104825,0.8707508104153188,2788,2562,3014,3156,368,142,594,367,-0.5754292800985176,0.025954563563501305,0.6110236074033304,0.9938555173980569,437631,437496,Monterey,Monterey,6,53,California,CA
06055,06CS022,1032,973,1091,1043,11,-48,70,38,-0.6172360722704258,-0.1890040491601018,0.21410687993468433,3.127573076716649,1259,1189,1329,1344,85,15,155,73,-0.5136821448928675,0.10915412346786849,0.7381168222651155,0.8483035357130165,137472,136411,Napa,Napa,6,55,California,CA
06057,06CS023,910,866,954,988,78,34,122,63,-0.2818955251021976,0.13957444937791924,0.5636541217650767,0.8001839856557141,1129,1075,1182,1207,78,25,132,67,-0.4759302755360571,0.11489788590844904,0.7029130292280422,0.8429256253778695,101961,103299,Nevada,Nevada,6,57,California,CA
06059,06CS024,17174,15806,18542,19959,2785,1417,4153,2459,-0.3328885198799416,0.09986058889422235,0.5227377204977851,0.8826554610231877,21266,19630,22903,25158,3892,2255,5528,3517,-0.4729904225784811,0.13653169745072,0.7615570283229001,0.9035011807234007,3180472,3170185,Orange,Orange,6,59,California,CA
06061,06CS025,2880,2706,3055,2988,108,-67,282,157,-0.5391810797412386,-0.12653999092839832,0.30465290325223915,1.4460858903183373,3588,3376,3800,3892,304,92,516,306,-0.5872319304982254,-0.010243677078016602,0.6840709131114135,1.0035430756830555,405429,411343,Placer,Placer,6,61,California,CA
06065,06CS026,14474,13429,15520,18545,4071,3025,5116,2657,0.16293724362076348,0.5700938924593645,1.0284015949663017,0.6525436028795237,18083,16817,19350,23058,4975,3708,6241,3945,-0.10877222468509429,0.5215279607973073,1.1259630252012602,0.7928592532014301,2432718,2453199,Riverside,Riverside,6,65,California,CA
06067,06CS027,10289,9608,10970,11312,1023,342,1704,948,-0.3594715114046558,0.037324497259848474,0.4921759460714955,0.925494466938014,12737,11917,13557,13863,1126,306,1946,1326,-0.7993608158359344,-0.14238461799949167,0.4825407512965344,1.1768554989481603,1581477,1588530,Sacramento,Sacramento,6,67,California,CA
06069,06CS028,321,293,349,352,31,3,59,32,-0.46130537589974124,-0.031945654567559954,0.4156286249537153,1.0087040810558159,411,376,445,475,64,30,99,60,-0.5187542369287094,0.058200609271958956,0.7293401557034461,0.9179322874024511,64485,66361,San Benito,San Benito,6,69,California,CA
06071,06CS029,12427,11488,13366,16663,4236,3297,5175,2747,0.2624002063588238,0.6882968047869765,1.1180251749472512,0.6483113434323671,15478,14346,16610,19890,4412,3280,5544,3626,-0.13325995023411208,0.43054026756879005,1.0326303539427661,0.8216248967750235,2183190,2192964,San Bernardino,San Bernardino,6,71,California,CA
06073,06CS030,18345,16927,19764,20772,2427,1008,3845,1748,-0.19666641220133363,0.218574430072874,0.6572156449203145,0.7200794978483493,22684,20986,24381,26416,3732,2035,5430,2869,-0.23813660716081195,0.31641766097532775,0.9094509163047015,0.7685143704689232,3300930,3287700,San Diego,San Diego,6,73,California,CA
06075,06CS031,4876,4505,5248,5343,467,95,838,222,-0.17165513871721974,0.27292185278697206,0.7315355193776273,0.4748040448295668,5759,5334,6184,6568,809,384,1234,342,0.06525771463229352,0.6666420371644354,1.2858242407643912,0.42214860933446013,865589,823195,San Francisco,San Francisco,6,75,California,CA
06077,06CS032,4956,4620,5291,5976,1020,685,1356,793,-0.1496840015132641,0.2886173987137103,0.7043724755232845,0.776407216058266,6177,5770,6584,7226,1049,642,1456,1092,-0.6671693331916263,-0.05415373063451599,0.5470930710239693,1.0399491625767443,778680,788113,San Joaquin,San Joaquin,6,77,California,CA
06079,06CS033,2064,1943,2186,2068,4,-118,125,116,-0.8661623683628739,-0.4072158856045161,0.046685337761246004,24.704420403969834,2546,2400,2692,2670,124,-22,270,248,-1.112462250990837,-0.517589796724403,0.05903708897825153,1.988516781968411,282400,283024,San Luis Obispo,San Luis Obispo,6,79,California,CA
06081,06CS034,4001,3674,4327,4151,150,-176,477,248,-0.5600478370207,-0.13764420594777096,0.3128260636612222,1.6385861459601194,4847,4464,5230,5115,268,-115,651,357,-0.7748129980578249,-0.14073540456642514,0.44978758401296803,1.3268469639280978,760238,741470,San Mateo,San Mateo,6,81,California,CA
06083,06CS035,2738,2546,2931,2900,162,-31,354,177,-0.454866921990386,-0.04950962803504529,0.3958096083064236,1.0870822557017645,3380,3149,3611,3659,279,48,510,378,-0.8745768986319968,-0.25644647779068946,0.3198369758720934,1.3502545071382592,447543,446711,Santa Barbara,Santa Barbara,6,83,California,CA
06085,06CS036,8680,7852,9507,9579,899,72,1727,852,-0.4322295386103573,0.029588362835978915,0.4445748606650434,0.9463219078999126,10655,9678,11632,11347,692,-285,1669,1085,-0.9099199591966015,-0.2519595709565488,0.3786887417645565,1.5658309361399507,1924707,1892084,Santa Clara,Santa Clara,6,85,California,CA
06087,06CS037,1478,1362,1594,1583,105,-11,221,122,-0.5058180941738105,-0.06544907044433691,0.3461730968044631,1.1494185248322761,1819,1681,1957,2003,184,46,322,147,-0.5354253836252609,0.147078781863335,0.8096602200406406,0.794772287325166,270453,268165,Santa Cruz,Santa Cruz,6,87,California,CA
06089,06CS038,1926,1848,2004,2068,142,64,220,102,-0.21807704459310517,0.2248615321441529,0.6096822917383339,0.7143509692783934,2356,2262,2450,2775,419,325,513,346,-0.13714169977131233,0.47472190766508304,1.1061955614508252,0.8242229105816785,181591,182103,Shasta,Shasta,6,89,California,CA
06095,06CS039,2950,2756,3145,3118,168,-27,362,171,-0.42935970133538215,-4.103979611238178e-4,0.41502856620287704,1.0127566896372848,3642,3409,3875,4077,435,202,668,358,-0.41891002557490786,0.20781752518877816,0.785824264321187,0.8208233658950901,452260,451943,Solano,Solano,6,95,California,CA
06097,06CS040,3429,3219,3639,3693,264,54,474,196,-0.3011047699041723,0.15349431081231832,0.5943245494787854,0.7388033785665068,4205,3954,4456,4555,350,99,601,232,-0.3831058806205904,0.2883075127707246,0.903089597938035,0.661645806337674,488668,486245,Sonoma,Sonoma,6,97,California,CA
06099,06CS041,3728,3491,3966,4541,813,575,1050,634,-0.1069780775529734,0.32020030469084243,0.7538814472294765,0.7793061331175907,4597,4312,4883,5580,983,697,1268,860,-0.3870519190017764,0.2668657262230486,0.8829346728760397,0.8744137715185365,552310,552957,Stanislaus,Stanislaus,6,99,California,CA
06101,06CS042,736,693,778,799,63,21,106,62,-0.40885790883004564,0.025139153350249625,0.43686815922180045,0.9657787655410642,904,853,955,1012,108,57,159,146,-1.0840760344320948,-0.4629617530046455,0.12988589314023424,1.3419895648630495,99062,99124,Sutter,Sutter,6,101,California,CA
06107,06CS043,2700,2496,2904,3323,623,419,827,451,-0.06640346774097346,0.35842544526263004,0.7697462634719682,0.722766008510811,3364,3118,3610,4330,966,720,1212,783,-0.2016305376989322,0.4803710655035066,1.0663411871789175,0.8096587750902775,472917,476570,Tulare,Tulare,6,107,California,CA
06111,06CS044,4888,4525,5250,5547,659,297,1022,376,-0.07535249371780217,0.32964959489037965,0.7509224709001563,0.569369215027429,6039,5606,6473,7127,1088,654,1521,818,-0.22540612845462632,0.3757802561657221,0.9947754766610578,0.7513938366125946,842781,840241,Ventura,Ventura,6,111,California,CA
06113,06CS045,1125,1032,1218,1253,128,35,221,110,-0.3481624498997555,0.0813959792380442,0.5095960058301999,0.8545869471307324,1398,1286,1510,1540,142,30,254,131,-0.5620614730906471,0.060949369215346966,0.6583030576662026,0.9145043893995619,216880,216879,Yolo,Yolo,6,113,California,CA
06115,06CS046,587,552,622,561,-26,-61,9,29,-1.1009822117216344,-0.656355442449596,-0.2673220338206946,-1.162390129807599,733,690,776,805,72,29,115,85,-0.8313321891790051,-0.20716997831449183,0.37572066327503645,1.1714345215519086,81594,83204,Yuba,Yuba,6,115,California,CA
08005,08CS002,3365,3084,3647,4174,809,527,1090,492,0.03040171774506152,0.473668366571413,0.9269943493278582,0.6076196895536361,4177,3839,4516,4869,692,353,1030,392,-0.09565910243773637,0.5638030343184324,1.2049427503142944,0.5660328029592566,655227,654931,Arapahoe,Arapahoe,8,5,Colorado,CO
08015,08CS005,156,148,165,182,26,17,34,15,0.08736090764203071,0.5412071606875463,0.9852547357245647,0.5630290005314309,194,183,204,167,-27,-37,-16,12,-2.9443240545195857,-2.321395673215393,-1.727695817664671,-0.4667587997641602,19732,20001,Central Colorado,Chaffee,8,15,Colorado,CO
08051,08CS005,66,64,67,70,4,3,6,5,-0.13069852735157922,-0.028447426095110116,0.06957895300853088,0.9109185259941631,81,79,83,89,8,6,10,7,-0.08486024587771268,0.07957368184352108,0.23918358489848396,0.7648590105697685,17058,17232,Central Colorado,Gunnison,8,51,Colorado,CO
08065,08CS005,32,31,33,31,-1,-2,-0,6,-1.0340191549613922,-0.93667794235556745,-0.8439815601602918,-115.08822913219949,39,38,40,58,19,18,20,4,2.3367275503855027,2.4911124110326033,2.644175503334944,0.19634159091297684,7505,7407,Central Colorado,Lake,8,65,Colorado,CO
08097,08CS005,50,48,52,60,10,8,12,6,0.13102732158634361,0.2334868122339763,0.3267323264845659,0.5425190922451122,61,59,63,72,11,9,13,8,0.06501966977210429,0.21544570127270263,0.3654935533570789,0.6573440410151941,17424,17347,Central Colorado,Pitkin,8,97,Colorado,CO
08109,08CS005,40,39,41,53,13,12,14,3,1.451702914196278,1.5591748319443273,1.6573949236633578,0.21344978583280538,49,48,50,68,19,18,20,2,3.0694582602865252,3.2095904139658518,3.356227736071056,0.09864666103998558,6457,6458,Central Colorado,Saguache,8,109,Colorado,CO
08027,08CS006,38,37,38,46,8,8,9,6,0.3529062556898775,0.44620460499113085,0.5412567960875792,0.6562297799556723,48,48,49,61,13,12,13,17,-1.1721143784166266,-1.0226995108124926,-0.8671119857441484,1.237339335472235,4806,4996,Custer+Fremont,Custer,8,27,Colorado,CO
08043,08CS006,490,469,511,533,43,22,64,26,-0.09799039368902632,0.36015251038732604,0.7782673893202343,0.5897158684557707,606,581,632,755,149,123,174,137,-0.3407373847725949,0.29138963968279313,0.8797652567547218,0.915994472133221,48910,49562,Custer+Fremont,Fremont,8,43,Colorado,CO
08029,08CS007,342,329,356,371,29,15,42,23,-0.22984872608785245,0.17799009324784318,0.6106862912427531,0.7688109550057239,422,406,439,504,82,65,98,93,-1.0678240590310846,-0.44141620245326896,0.18760975945769523,1.125000545102591,31246,31598,Delta+Montrose,Delta,8,29,Colorado,CO
08085,08CS007,384,365,402,417,33,15,52,27,-0.2821776051643815,0.14454150133469806,0.562179522995888,0.7889167523400334,474,451,496,613,139,117,162,114,0.03942964058351498,0.7192222606349358,1.2694702551827464,0.8124158130918521,42836,43114,Delta+Montrose,Montrose,8,85,Colorado,CO
08031,08CS008,3944,3635,4253,4938,994,685,1303,647,0.05198237614351607,0.4869821147304641,0.8894275475285034,0.650248827865789,4844,4476,5212,5229,385,17,753,408,-0.690410021673417,-0.03523011953133598,0.5851278780140987,1.0563902516643044,718136,712362,Denver,Denver,8,31,Colorado,CO
08035,08CS009,1298,1143,1453,1611,313,158,468,166,-0.01732423768788767,0.40325120836188927,0.8450397106350334,0.5288475175357508,1670,1480,1859,1994,324,135,514,165,-0.10406177305691819,0.514855130727549,1.175606794361798,0.5069715444539913,359823,367694,Douglas,Douglas,8,35,Colorado,CO
08037,08CS010,135,130,141,130,-5,-11,0,13,-0.43257173163709933,-0.3326576192919881,-0.23274317804424446,-2.9325928533350254,170,163,177,189,19,12,26,16,-0.08305166412484334,0.05728577138737584,0.21065247004829746,0.8078476180700565,55601,55718,Eagle,Eagle,8,37,Colorado,CO
08039,08CS011,140,128,151,150,10,-1,22,13,-0.5551401023817651,-0.1160161423138129,0.31817029437616207,1.1587174614398819,178,164,192,210,32,18,46,25,-0.3177340344278733,0.31523323324365266,0.9265114513766411,0.7583019554248583,26375,26994,East Central Colorado,Elbert,8,39,Colorado,CO
08063,08CS011,57,56,58,81,24,23,25,5,2.612430413082595,2.7057929679261465,2.809454325354443,0.19885566149141531,69,68,70,103,34,33,35,15,3.1861825209217467,3.335836494797091,3.484861462760535,0.4240417641132471,7066,6967,East Central Colorado,Kit Carson,8,63,Colorado,CO
08073,08CS011,49,48,50,50,1,0,2,4,-0.6341940377366605,-0.5386296465573291,-0.4347383322432901,2.0662201497545554,60,59,61,67,7,6,8,6,0.037415394040037,0.18344405780252687,0.32953624387099445,0.7646425699484473,5675,5685,East Central Colorado,Lincoln,8,73,Colorado,CO
08121,08CS011,45,44,45,65,20,20,21,14,1.1862411865620572,1.2859688085644565,1.3914021355422421,0.6592258024781198,55,54,56,67,12,11,13,14,-0.6655671903469306,-0.5084579822227822,-0.3551108527536638,1.0816826216628397,4828,4854,East Central Colorado,Washington,8,121,Colorado,CO
08125,08CS011,84,83,85,101,17,16,18,12,0.4375976630864236,0.5361377206085547,0.6329868663331161,0.6550397385774489,102,101,103,103,1,-0,2,7,-0.8815290429693576,-0.7357006406581624,-0.5876593644288759,3.6223405036674263,9981,9947,East Central Colorado,Yuma,8,125,Colorado,CO
08041,08CS012,4265,3950,4579,5200,935,621,1250,530,0.09929058580574707,0.5517112368789724,0.971091026470046,0.5661185926581662,5324,4944,5705,6483,1159,778,1539,828,-0.07426455108602721,0.537315310177914,1.1038440317296205,0.713908305875705,731028,736989,El Paso,El Paso,8,41,Colorado,CO
08045,08CS013,314,288,341,338,24,-3,50,36,-0.6014009151535584,-0.20263490848142326,0.20422699834780617,1.4672560340271912,394,362,426,423,29,-3,61,40,-0.8471555509539269,-0.1799078659362527,0.3989048330810759,1.326218380908378,61562,62105,Garfield,Garfield,8,45,Colorado,CO
08059,08CS014,10102,9311,10892,11827,1725,935,2516,1405,-0.26244093509232924,0.1654185518739397,0.6198969203719383,0.8138646491731543,12564,11611,13517,14154,1590,637,2543,1420,-0.5016091013615481,0.10118130315226542,0.7131543908865182,0.8925062932102045,1837707,1845626,Jefferson,Jefferson,8,59,Colorado,CO
08067,08CS015,295,271,319,362,67,43,91,24,0.3659518832126788,0.7712228855992835,1.17735645559141,0.3542001240473578,369,340,398,440,71,42,100,36,0.09344597139696428,0.7481976740728173,1.3216157042976289,0.5027877035734952,55822,56161,La Plata+Montezuma,La Plata,8,67,Colorado,CO
08083,08CS015,230,219,242,251,21,9,32,16,-0.2528700660814281,0.16785475065927688,0.5885934746129453,0.741535334190811,284,271,298,370,86,72,99,47,1.153153216206865,1.7593176334333531,2.345624677106477,0.5428965800676557,25966,26129,La Plata+Montezuma,Montezuma,8,83,Colorado,CO
08069,08CS016,2055,1901,2210,2213,158,3,312,114,-0.3053018859540941,0.14429748442097007,0.5603603794124332,0.7189694880615641,2557,2370,2744,2778,221,34,408,241,-0.6445796374491408,-0.07343062914734656,0.553239666694843,1.085146910080791,359626,362118,Larimer,Larimer,8,69,Colorado,CO
08075,08CS017,180,171,189,264,84,75,93,55,0.926280400428902,1.3368375345337238,1.726353629056934,0.6483338759940867,220,209,231,272,52,41,63,46,-0.2891637367607442,0.3191623878956762,0.9880179470734161,0.8678730951434638,21627,21488,Logan+Morgan+Phillips+Sedgwick,Logan,8,75,Colorado,CO
08087,08CS017,236,224,249,296,60,47,72,71,-0.8188716544478194,-0.3794298763265834,0.027107821665949647,1.1665976277849164,289,274,304,330,41,26,56,44,-0.7381943351338013,-0.15003450765829277,0.46299632108591227,1.0560773343947207,29041,29016,Logan+Morgan+Phillips+Sedgwick,Morgan,8,87,Colorado,CO
08095,08CS017,45,45,46,67,22,21,22,2,4.2608541473780805,4.362238012516539,4.461813114335783,0.08826533440382324,55,55,56,71,16,15,16,1,3.7331034112118466,3.881533763356627,4.0276812708308105,0.060313181904447795,4506,4515,Logan+Morgan+Phillips+Sedgwick,Phillips,8,95,Colorado,CO
08115,08CS017,31,30,31,41,10,10,11,5,2.2065622663144557,2.3087827573397193,2.4028838848802394,0.4361016718667486,37,37,37,34,-3,-3,-3,3,-3.128988072663661,-2.994404258956463,-2.8443062252259232,-1.6187320792300148,2367,2344,Logan+Morgan+Phillips+Sedgwick,Sedgwick,8,115,Colorado,CO
08077,08CS018,1336,1269,1403,1536,200,133,267,108,0.1732608929406877,0.6027921598343785,0.9935474311053419,0.5366637097478603,1652,1571,1733,1995,343,262,424,319,-0.39037714155885805,0.1695411961991532,0.8183458739699356,0.9273377283050831,155882,157131,Mesa,Mesa,8,77,Colorado,CO
08049,08CS019,67,66,69,64,-3,-5,-2,4,-0.5641933872990565,-0.46144020561670024,-0.35345552542391573,-1.787338815122379,84,82,86,100,16,14,18,13,0.11586952159009438,0.26286938911115915,0.4153811231455021,0.7447177088686319,15748,15841,Northwest Colorado,Grand,8,49,Colorado,CO
08057,08CS019,11,11,11,11,-0,-0,0,8,-5.933881934431077,-5.8339198048741805,-5.743396313703704,8.36087835149794,13,13,14,14,1,0,1,7,-5.800116720332649,-5.635741083832702,-5.489414881950022,4.422514213740079,1378,1365,Northwest Colorado,Jackson,8,57,Colorado,CO
08081,08CS019,87,86,88,139,52,51,53,21,2.247460452351856,2.3499446618191877,2.4486749186779737,0.39556977040998076,106,105,108,157,51,49,52,32,1.5385878250924818,1.6985271946579252,1.8379470644636373,0.619602734421738,13250,13197,Northwest Colorado,Moffat,8,81,Colorado,CO
08103,08CS019,46,45,46,56,10,10,11,3,1.029432449716314,1.1345843004212173,1.2339688229143404,0.2637022704590461,56,55,57,70,14,13,15,10,0.5964470146916399,0.7498917713519799,0.9001838391676993,0.6647061336430266,6489,6482,Northwest Colorado,Rio Blanco,8,103,Colorado,CO
08107,08CS019,105,103,108,115,10,7,12,21,-0.5472434019324229,-0.4417966994457233,-0.3466987558183844,1.935822263270531,130,127,134,133,3,-1,6,3,-0.15880611957741464,-0.022604458487957734,0.14780269651059175,0.8183642226144552,24973,25054,Northwest Colorado,Routt,8,107,Colorado,CO
08019,08CS020,53,52,54,57,4,3,5,4,-0.14378975493869228,-0.03940130382624315,0.06498743032048714,0.8620646379259074,66,65,67,68,2,1,3,1,-0.001263448761273133,0.15427324669308756,0.31383629384406464,0.30829157248832184,9437,9440,Park and Nearby Counties,Clear Creek,8,19,Colorado,CO
08047,08CS020,27,26,27,27,0,-0,1,6,-1.064863093261569,-0.962411313169604,-0.8561936736253535,4.419033887025633,33,32,34,40,7,6,8,1,1.0898961950055157,1.2581963449566484,1.4068741496447494,0.1225964036231465,5878,5864,Park and Nearby Counties,Gilpin,8,47,Colorado,CO
08093,08CS020,86,84,87,113,27,26,29,8,0.9939054357408288,1.0917393709128798,1.1923153193921583,0.28267997713746523,106,104,108,118,12,10,14,10,-0.0052167456487980405,0.145116683259041,0.285742670378322,0.7611330143108145,17665,17676,Park and Nearby Counties,Park,8,93,Colorado,CO
08117,08CS020,71,68,74,72,1,-2,4,6,-0.2578009909096744,-0.15853065512439363,-0.05955269601009817,2.8152057695841974,89,85,93,88,-1,-5,3,7,-0.4612454489524855,-0.30455048561453985,-0.16176815104151712,78.18484800136655,30950,30945,Park and Nearby Counties,Summit,8,117,Colorado,CO
08119,08CS020,150,139,161,183,33,22,44,3,0.7637447417232294,1.1954355726830324,1.6461962493532978,0.08865562159199297,186,173,199,288,102,89,115,42,2.2667934304318798,2.889185446365756,3.549057917907175,0.4083379919988172,24846,24897,Park and Nearby Counties,Teller,8,119,Colorado,CO
08101,08CS021,1560,1488,1633,1998,438,365,510,262,0.599130038879457,1.0499169306548866,1.4827514095358758,0.5971804065849279,1924,1837,2012,2470,546,458,633,365,0.622867066773076,1.2762049037679397,1.8854018363077492,0.6677564019138519,168579,169454,Pueblo,Pueblo,8,101,Colorado,CO
08009,08CS022,44,43,44,60,16,16,17,2,3.9872929466983367,4.096706911754742,4.196280754050324,0.1151142235930357,53,53,54,78,25,24,25,3,7.30428291735962,7.460908949944714,7.607534449418212,0.11617943552862016,3508,3510,Southeast Colorado,Baca,8,9,Colorado,CO
08011,08CS022,54,53,55,67,13,12,14,5,1.3116377272132587,1.4072199110251824,1.5120789954785667,0.35839051824062534,67,66,68,85,18,17,19,22,-0.9981986992888073,-0.8512745095257418,-0.6956466293258518,1.162369134156919,5640,5741,Southeast Colorado,Bent,8,11,Colorado,CO
08017,08CS022,15,15,16,23,8,7,8,2,3.1431803361480317,3.241494550265531,3.3432818512977547,0.23085667611925725,18,18,19,24,6,5,6,7,-1.0841026582545263,-0.9393867336788672,-0.7843494969024221,1.0494572420470565,1746,1711,Southeast Colorado,Cheyenne,8,17,Colorado,CO
08021,08CS022,68,67,69,79,11,10,12,4,0.7903999536009755,0.8871401075021678,0.99009632701991,0.34086597140611835,83,82,84,139,56,55,57,48,1.0558498558751956,1.2118501356232574,1.3521165228831322,0.8468950274924275,7582,7590,Southeast Colorado,Conejos,8,21,Colorado,CO
08023,08CS022,33,32,33,35,2,2,3,8,-1.690102902823067,-1.590506194294615,-1.4865508005152672,2.408806022311859,40,40,41,58,18,17,18,10,2.4261090770581455,2.579268254250178,2.7212642402791087,0.5331179261713108,3572,3608,Southeast Colorado,Costilla,8,23,Colorado,CO
08025,08CS022,41,40,42,63,22,21,23,0,3.6082252467238987,3.7073046238362943,3.8026464393217627,0,51,50,51,69,18,18,19,13,0.8988432013779255,1.0600275728461555,1.2029897515840546,0.6746467061198239,5919,5995,Southeast Colorado,Crowley,8,25,Colorado,CO
08055,08CS022,91,91,92,113,22,21,22,10,1.6116334892795816,1.7089103751765506,1.8082406077646578,0.440688748218172,112,112,113,138,26,25,26,7,3.074980281120313,3.228313834383221,3.3680713939039073,0.26361753830408036,6830,6904,Southeast Colorado,Huerfano,8,55,Colorado,CO
08061,08CS022,18,18,18,17,-1,-1,-1,3,-2.8896310355801567,-2.787861723109393,-2.6872183886143817,-84.37692695096487,22,22,22,20,-2,-2,-2,3,-4.324076946638251,-4.174214729412121,-4.01247566598304,-2.8497041121836353,1447,1452,Southeast Colorado,Kiowa,8,61,Colorado,CO
08071,08CS022,159,152,165,164,5,-1,12,5,-0.4127145774081298,0.022905772433312637,0.4450572450193927,0.7882146575649901,193,186,201,239,46,38,53,27,0.9035644502412178,1.527160237053425,2.1875529716270914,0.5780510777121618,14549,14623,Southeast Colorado,Las Animas,8,71,Colorado,CO
08089,08CS022,206,198,214,264,58,50,66,36,0.7662099577039126,1.1942448482380281,1.603172857774467,0.60924357520857,250,240,259,313,63,54,73,62,-0.5154163242374755,0.10270717670437697,0.7051061330307915,0.9616225111307285,18598,18605,Southeast Colorado,Otero,8,89,Colorado,CO
08099,08CS022,110,108,111,148,38,37,40,18,1.6032702919622368,1.7013793330529012,1.8063237631579523,0.45647418431881964,133,132,135,181,48,46,49,22,2.3986963375798624,2.5561865945276336,2.704650913437,0.45337079702190386,12005,11995,Southeast Colorado,Prowers,8,99,Colorado,CO
08003,08CS023,135,128,142,140,5,-2,12,21,-1.4273845139291383,-0.9922498000318146,-0.5811134194935262,3.5951681100337294,167,159,176,187,20,11,28,26,-1.1076255696330615,-0.4765637350132684,0.1267218962907366,1.2628288045893445,16358,16520,Southwest Colorado,Alamosa,8,3,Colorado,CO
08007,08CS023,92,91,94,90,-2,-4,-1,4,-0.5707452708140173,-0.4701022354809534,-0.36720393175500976,-3.082249432249265,116,114,118,135,19,17,21,11,0.5362830561479665,0.681008931501447,0.8347234786847182,0.5557751202439576,13536,13737,Southwest Colorado,Archuleta,8,7,Colorado,CO
08033,08CS023,23,22,24,21,-2,-3,-1,8,-4.730623924593631,-4.293827449041433,-3.856436579879327,-9.280539759611141,29,28,30,47,18,17,19,7,5.053728834662366,5.613585206185177,6.242090928693292,0.3642091123031534,2301,2388,Southwest Colorado,Dolores,8,33,Colorado,CO
08053,08CS023,9,9,9,2,-7,-7,-7,2,-11.876459340506702,-11.780888915506129,-11.68252541122114,-0.315982235046551,11,11,11,2,-9,-9,-9,2,-17.551259294499612,-17.38941391388187,-17.239417211478543,-0.23957406016205196,792,783,Southwest Colorado,Hinsdale,8,53,Colorado,CO
08079,08CS023,11,10,11,7,-4,-4,-3,7,-12.37492551474136,-12.274497522408062,-12.175275556734881,-2.7764154672394765,14,14,14,7,-7,-7,-7,7,-18.266946541509547,-18.118385012065122,-17.969802768170094,-1.200821926531599,857,916,Southwest Colorado,Mineral,8,79,Colorado,CO
08091,08CS023,26,25,26,24,-2,-2,-1,5,-1.4776173389117873,-1.377360594512853,-1.270944711174841,-6.727207873666879,33,32,33,32,-1,-1,-0,8,-2.250715610490985,-2.1058427591190165,-1.9568764717113123,42.25287983851195,4906,5011,Southwest Colorado,Ouray,8,91,Colorado,CO
08105,08CS023,114,113,115,142,28,27,29,6,1.822742824390972,1.9244768464825484,2.016284096794621,0.2061118156155336,140,138,141,174,34,33,36,28,0.5031337504983411,0.6585155699048376,0.8125759621527775,0.7932845275734172,11486,11427,Southwest Colorado,Rio Grande,8,105,Colorado,CO
08111,08CS023,7,7,7,3,-4,-4,-4,3,-10.275352034465099,-9.852050317434813,-9.442035999729624,-0.9882970984110406,9,8,9,5,-4,-4,-3,5,-15.025075653015087,-14.455160621578301,-13.856660006240155,-1.7908716142025605,714,730,Southwest Colorado,San Juan,8,111,Colorado,CO
08113,08CS023,24,23,25,24,0,-1,1,2,-0.3172289276339081,-0.2191857106873043,-0.11441575883892686,1.6267016119448388,30,29,31,31,1,-0,2,1,-0.1864847873903915,-0.028408754528978904,0.11484383943136474,0.5688135930640837,8074,8071,Southwest Colorado,San Miguel,8,113,Colorado,CO
09001,09CS001,5892,5481,6303,7546,1654,1243,2065,1629,-0.44173998184379265,0.03843993552696862,0.4914241061347003,0.9843472876912238,7307,6812,7802,7400,93,-402,588,517,-1.1220575421802654,-0.5107925923767463,0.07964580544073716,5.509734820291109,954620,959203,Fairfield,Fairfield,9,1,Connecticut,CT
09003,09CS002,6958,6573,7344,8610,1652,1266,2037,1731,-0.5383682884377429,-0.09686933159110264,0.32516373251414254,1.0474277897229831,8559,8096,9022,8822,263,-200,726,731,-1.2246687105872034,-0.6368115311607209,-8.519252263152642e-4,2.765869691322714,896860,897011,Hartford,Hartford,9,3,Connecticut,CT
09005,09CS003,1595,1516,1674,1890,295,216,374,249,-0.17611737262322252,0.2536346479837503,0.6418037789037313,0.8416210557160738,1966,1871,2062,2040,74,-22,169,143,-1.1023255528660594,-0.46727894655632046,0.1732718651295207,1.9147348884429327,184234,184982,Litchfield,Litchfield,9,5,Connecticut,CT
09007,09CS004,1350,1280,1421,1526,176,105,246,214,-0.6540116761783673,-0.20492268906552866,0.1988902990174304,1.2109970336406068,1668,1583,1753,1694,26,-59,111,134,-1.39571173285541,-0.8000084963115743,-0.1580420067225287,4.940490407144721,163808,164637,Middlesex,Middlesex,9,7,Connecticut,CT
09009,09CS005,6757,6386,7128,8319,1562,1191,1933,1488,-0.3350596198394104,0.07992357871792076,0.5263939086837045,0.9518526913325108,8314,7868,8760,8563,249,-197,695,717,-1.257173328074458,-0.6407336979489987,-0.06124563390205892,2.8713489383668658,862107,863671,New Haven,New Haven,9,9,Connecticut,CT
09011,09CS006,2135,2020,2250,2348,213,98,328,274,-0.6329563629304242,-0.2294151483696349,0.2438930595171249,1.2800489481081392,2634,2495,2773,2949,315,176,454,243,-0.30387285435363026,0.32675289081218345,0.9341012272082981,0.768722428122332,267947,268724,New London,New London,9,11,Connecticut,CT
09013,09CS007,925,861,990,1042,117,52,181,113,-0.40184241773109736,0.04096741810543741,0.46551212617772264,0.9614796741225365,1150,1073,1228,1276,126,48,203,87,-0.2886212189136545,0.3144277173696849,0.908904568829398,0.6872190640047643,149894,150199,Tolland,Tolland,9,13,Connecticut,CT
09015,09CS008,927,877,977,1084,157,107,207,84,0.18575748923012114,0.6260427802345476,1.034578491700676,0.5325444950776808,1142,1082,1203,1239,97,36,157,147,-1.1429039504354626,-0.5213046434740481,0.08807970211012749,1.5074760420974078,116352,116392,Windham,Windham,9,15,Connecticut,CT
10001,10CS001,1441,1363,1520,1740,299,220,377,191,0.1514241576666322,0.5860312963867728,1.0260567664912834,0.6368405113391317,1785,1690,1880,2232,447,352,542,250,0.6422096141954551,1.2679009549497153,1.9201148597108701,0.5582323325710212,182342,183873,Kent,Kent,10,1,Delaware,DE
10003,10CS002,4182,3937,4427,4893,711,466,956,499,-0.06755402629321187,0.37440288882626127,0.7858227984782505,0.7011191558677489,5169,4874,5465,5700,531,235,826,523,-0.5933080641408989,0.006423900712731694,0.6563741202682496,0.9839904977258711,569249,571564,New Castle,New Castle,10,3,Delaware,DE
10005,10CS003,2364,2261,2467,2784,420,317,523,318,0.03492899061966718,0.4224438578539847,0.8268840222909358,0.7557299839160205,2970,2843,3097,3308,338,211,465,338,-0.5826075740525892,-0.017828619282964864,0.5779297733291224,0.996324768397643,239273,246271,Sussex,Sussex,10,5,Delaware,DE
11001,11CS001,4163,3867,4459,5284,1121,825,1417,831,-0.014935396448571742,0.4266974225611736,0.8447413963423456,0.7407013176465145,5018,4671,5366,5813,795,447,1142,463,-0.030325463391485615,0.5744364185943853,1.2190103161912151,0.5818537913678489,690654,672973,District of Columbia,District of Columbia,11,1,District of Columbia,DC
12001,12CS001,1746,1626,1865,1931,185,66,305,133,-0.23634151378233273,0.19497698395199786,0.5948753871761948,0.7140725428550252,2165,2021,2309,2440,275,131,419,290,-0.7154374703438632,-0.07247776809093445,0.5694693015958049,1.0517698660279124,277401,279157,Alachua,Alachua,12,1,Florida,FL
12003,12CS002,223,210,235,257,34,22,47,36,-0.44980609267048205,-0.05567836525829184,0.3752842028676467,1.016842991337317,275,261,290,368,93,78,107,80,-0.10249723519340208,0.5261778530301414,1.118021537816038,0.8545640912649479,28494,28656,Baker+Bradford+Union,Baker,12,3,Florida,FL
12007,12CS002,281,268,293,294,13,1,26,20,-0.6557809479462878,-0.23683489313172387,0.20374554600560846,1.392622548863125,345,330,359,408,63,49,78,87,-1.6019614882721878,-0.9707741525420299,-0.3934402935728946,1.350369651906621,28380,28514,Baker+Bradford+Union,Bradford,12,7,Florida,FL
12125,12CS002,217,210,224,259,42,35,49,58,-1.3904149859740864,-0.9770379416741497,-0.5347454402964412,1.3363374192743347,267,259,276,249,-18,-27,-10,27,-3.93233023520634,-3.3458510828668975,-2.6687102141334735,-1.5691582606359429,16015,16305,Baker+Bradford+Union,Union,12,125,Florida,FL
12005,12CS003,1584,1508,1659,1811,227,152,303,179,-0.14140031946449896,0.2794503196870225,0.716192328859175,0.7836049413209272,1980,1887,2072,2546,566,474,659,420,0.36205543306741267,0.9494221858002041,1.6017906036499097,0.7402008484461736,174869,178482,Bay,Bay,12,5,Florida,FL
12009,12CS004,6515,6253,6777,7028,513,251,775,478,-0.3721118545328564,0.04740749948472328,0.5025398289367201,0.9298638083536965,8050,7732,8368,9270,1220,902,1538,1073,-0.3491144078303349,0.29459109352367185,0.8795819040113102,0.8786923006385841,607887,615371,Brevard,Brevard,12,9,Florida,FL
12011,12CS005,12919,12084,13753,15293,2374,1540,3209,1736,-0.10793211909777663,0.3501910938122,0.8157733659763285,0.7308438745925308,15845,14847,16843,18739,2894,1896,3892,2673,-0.48766926206945843,0.1498525725642614,0.7590834727469373,0.9232420579881456,1942454,1932519,Broward,Broward,12,11,Florida,FL
12015,12CS006,2341,2260,2422,2695,354,273,435,245,0.1279117660443031,0.5768455427783208,0.9955472376128175,0.690106334264676,2923,2823,3023,3342,419,319,519,388,-0.39355131624982814,0.19860778631100084,0.8014734398560309,0.9233397141233577,188926,193839,Charlotte,Charlotte,12,15,Florida,FL
12017,12CS007,2327,2261,2394,2726,399,332,465,204,0.8228841466395137,1.258615416148395,1.693028327720464,0.5102291772177548,2884,2802,2965,3561,677,596,759,478,0.9079117634990291,1.5455049190168868,2.1241198408308355,0.7047602978230877,154167,157546,Citrus,Citrus,12,17,Florida,FL
12019,12CS008,1600,1506,1694,1861,261,167,355,148,0.08293469545271882,0.518663075170604,0.9246536597536043,0.565141227561432,1993,1879,2108,2768,775,660,889,476,0.9837864290557787,1.6279679483975231,2.242844283387299,0.613616521107881,219200,221841,Clay,Clay,12,19,Florida,FL
12021,12CS009,2963,2800,3126,3412,449,286,612,318,-0.05458640626289004,0.3536783789408367,0.781487486212424,0.7062944282141179,3700,3501,3898,4461,761,563,960,498,0.1619196037482129,0.822986720829625,1.4368284483151903,0.6532490792696753,379295,384682,Collier,Collier,12,21,Florida,FL
12023,12CS010,688,657,718,813,125,95,156,96,-0.01293362596993583,0.4229720190188984,0.8601528724148475,0.7591757555689945,845,808,881,1137,292,256,329,178,1.3184681570786128,1.9492985960634488,2.592593279236753,0.6070358993154907,70214,70313,Columbia,Columbia,12,23,Florida,FL
12027,12CS011,288,273,303,374,86,71,101,55,0.4646065311125631,0.8929077647736934,1.3207245583448728,0.6340123998199876,354,336,371,469,115,98,133,78,0.7132572630198675,1.305535614106508,1.9142587536345097,0.6703410136941158,34660,34360,DeSoto+Hardee,DeSoto,12,27,Florida,FL
12049,12CS011,182,171,193,217,35,24,46,21,0.1011210743460818,0.5415830883482767,0.9806473223158223,0.5885399521406626,225,212,238,352,127,114,140,74,1.9066418339364812,2.4999189317208814,3.088255253288687,0.576857921531153,25542,25409,DeSoto+Hardee,Hardee,12,49,Florida,FL
12029,12CS012,193,186,201,212,19,11,26,14,-0.16113092836663598,0.2592000745358427,0.7026495223971512,0.7152070664768622,239,230,247,313,74,66,83,50,1.1315692329867768,1.7452456817559239,2.319835356088421,0.6626598898249351,16848,17059,Dixie+Gilchrist+Levy,Dixie,12,29,Florida,FL
12041,12CS012,173,166,181,191,18,10,25,13,-0.1268432849591216,0.24647389751140794,0.684436487158108,0.6959664157725757,215,205,224,301,86,77,96,42,2.333667705244475,2.8898762909667455,3.4756314259536447,0.48153964931135274,18067,18297,Dixie+Gilchrist+Levy,Gilchrist,12,41,Florida,FL
12075,12CS012,496,478,515,552,56,37,74,30,0.1728348154934394,0.5979466747535435,1.0116554866944611,0.5274412447256425,617,595,640,757,140,117,162,111,0.1594995157868148,0.7897788417192395,1.3813718459117632,0.7889495471885793,42958,43997,Dixie+Gilchrist+Levy,Levy,12,75,Florida,FL
12031,12CS013,7557,7130,7985,8614,1057,629,1484,709,-0.04423186259906413,0.34636543180325163,0.77461434410905,0.6702833359892095,9358,8842,9874,11527,2169,1653,2685,1831,-0.2156393484514468,0.39740270474492195,1.02290002742258,0.8439012586008827,991418,999416,Duval,Duval,12,31,Florida,FL
12033,12CS014,3012,2874,3151,3586,574,435,712,327,0.3597109657562307,0.7558209746647607,1.185711610137804,0.5691449956724821,3700,3533,3866,4581,881,715,1048,557,0.5830932857740331,1.2086606800015198,1.8309899494988318,0.6314224446675084,321976,322395,Escambia,Escambia,12,33,Florida,FL
12035,12CS015,1225,1174,1275,1360,135,85,186,53,0.24692813663952293,0.7149778459126983,1.1408382126133638,0.3884565342048794,1548,1486,1610,1844,296,234,358,221,0.13762202673971813,0.7535667907911916,1.3689268545753916,0.7444269119166996,116414,120208,Flagler,Flagler,12,35,Florida,FL
12039,12CS016,386,367,405,481,95,76,114,54,0.5211894872916983,0.9342257284264586,1.372341254079718,0.5634192899907191,473,450,495,663,190,168,213,96,1.965328867511816,2.60788038372483,3.226231770674848,0.5018810520604354,43990,43712,Gadsden+Leon,Gadsden,12,39,Florida,FL
12073,12CS016,1665,1539,1791,2057,392,266,518,158,0.3702802846387837,0.8053315064700889,1.2224076599461342,0.4022491736410517,2073,1922,2224,2572,499,348,650,309,0.10541276144442475,0.7751021207800263,1.4251446953374218,0.6183209272396959,292641,292753,Gadsden+Leon,Leon,12,73,Florida,FL
12043,12CS017,100,99,101,129,29,28,30,16,0.9626744514015569,1.0600786184734603,1.1547106072563116,0.5304991503677114,121,119,122,167,46,45,48,16,2.8275293653816655,2.9838794922981684,3.129968318192608,0.3378401235919453,12438,12226,Glades+Hendry+Okeechobee,Glades,12,43,Florida,FL
12051,12CS017,261,244,279,315,54,36,71,51,-0.3684817919465087,0.06610792281746206,0.4616158565875754,0.9346407871356017,325,304,346,479,154,133,175,79,1.6156496558708642,2.22828314845185,2.8393764463320172,0.5089540196141421,40115,40225,Glades+Hendry+Okeechobee,Hendry,12,51,Florida,FL
12093,12CS017,384,367,401,467,83,66,100,55,0.24741468912020864,0.7031638470409511,1.1196793892385668,0.6560069694286788,473,452,494,657,184,163,205,103,1.8485868781788521,2.419289718287943,3.0164855366219467,0.556659960659301,40071,40175,Glades+Hendry+Okeechobee,Okeechobee,12,93,Florida,FL
12047,12CS018,138,132,144,176,38,32,44,19,0.928532862036193,1.3247532310240424,1.7284218330025394,0.4921221456063207,169,162,177,226,57,49,64,33,1.4255981117387762,2.034077601981603,2.667694720945668,0.5720914219934171,14059,13992,Hamilton+Lafayette+Suwannee,Hamilton,12,47,Florida,FL
12067,12CS018,67,66,68,97,30,29,31,16,1.5564557289657843,1.659049997657614,1.758883983875641,0.520425089462365,84,83,85,118,34,33,35,22,1.621728263032934,1.7753045467255282,1.921030516923506,0.6222246570212698,8285,8363,Hamilton+Lafayette+Suwannee,Lafayette,12,67,Florida,FL
12121,12CS018,486,467,505,587,101,82,120,71,0.24993318286327199,0.6862102096534851,1.1199089482639277,0.6966524272718371,603,580,626,783,180,157,203,161,-0.11496297919340792,0.5010029958774764,1.1510210937121153,0.8912811410352676,43744,44343,Hamilton+Lafayette+Suwannee,Suwannee,12,121,Florida,FL
12053,12CS019,2450,2365,2534,2676,226,142,311,203,-0.34813438765058696,0.12593482688196184,0.5138323099914787,0.893383342266388,3043,2940,3146,3685,642,539,745,557,-0.13282510782544085,0.5142799386285897,1.0779633880078803,0.8659967124916839,195865,199890,Hernando,Hernando,12,53,Florida,FL
12055,12CS020,1332,1289,1376,1582,250,206,293,185,0.21460092089288899,0.6160792717959469,1.0550104750845968,0.7383924207480327,1644,1591,1697,2129,485,432,538,284,1.714453170667689,2.3307778720246377,2.9705021612518983,0.5845182229123251,102119,102994,Highlands,Highlands,12,55,Florida,FL
12057,12CS021,9337,8707,9968,10901,1564,933,2194,945,-0.01348498140586322,0.41685353885902404,0.8438304130481954,0.6040018793192099,11589,10827,12351,14306,2717,1955,3479,1769,0.15720548887502864,0.7681532756423964,1.3963531808443541,0.6507801388866316,1466826,1476034,Hillsborough,Hillsborough,12,57,Florida,FL
12059,12CS022,239,230,247,286,47,39,56,28,0.5534863345073849,0.9787261959817244,1.403967457283441,0.579445594069406,294,284,304,362,68,58,78,47,0.6938488110575656,1.2654136994635008,1.8900440390829245,0.6806878994218118,19645,19760,Holmes+Walton,Holmes,12,59,Florida,FL
12131,12CS022,637,604,670,665,28,-5,61,49,-0.6778870038391283,-0.28725153361442574,0.15298248298710082,1.6845650678418145,820,779,861,891,71,30,112,127,-1.4524323310801186,-0.8262613474245893,-0.213487364670463,1.7597865652729205,76042,79454,Holmes+Walton,Walton,12,131,Florida,FL
12061,12CS023,1823,1754,1892,2023,200,131,269,141,-0.04739931997437728,0.3501969398078584,0.7916519542566994,0.7027642818625894,2259,2175,2344,2717,458,373,542,358,0.11934178334305605,0.7288764326530617,1.3358491660446643,0.7803985648114037,160602,163178,Indian River,Indian River,12,61,Florida,FL
12063,12CS024,539,519,559,666,127,107,147,102,0.1322246548533624,0.5395738300503582,0.9824170342365285,0.7958438263593118,668,643,692,761,93,69,118,99,-0.7198290196843372,-0.1251201051775854,0.46984750704413203,1.0501206804816416,47124,47624,Jackson+Washington,Jackson,12,63,Florida,FL
12133,12CS024,294,283,305,299,5,-6,16,22,-1.1127136431018978,-0.688530020891612,-0.24007762985753603,3.5824841764471476,361,348,374,417,56,43,69,62,-0.9332555257233284,-0.2934233526606832,0.3310876371955758,1.0920702777125384,25408,25424,Jackson+Washington,Washington,12,133,Florida,FL
12065,12CS025,154,148,160,184,30,24,36,13,0.7519387303836015,1.171810540031771,1.5844775010706154,0.42184388724876365,188,181,196,225,37,29,44,32,-0.20835929603450523,0.3855712355413306,0.9885143693376691,0.8452073794075561,14519,14556,Jefferson+Madison+Taylor,Jefferson,12,65,Florida,FL
12079,12CS025,193,185,201,273,80,72,88,38,1.8618815060266065,2.3194826567154343,2.7468021776238905,0.47051395158050996,238,228,247,303,65,56,75,51,0.28253955985155804,0.9462101440544846,1.5426571813472916,0.7690270660675183,18099,18242,Jefferson+Madison+Taylor,Madison,12,79,Florida,FL
12123,12CS025,221,211,230,284,63,54,73,31,1.0523980054292121,1.4943120573602595,1.9413585952454464,0.480851074824753,270,258,281,330,60,49,72,49,0.028633026920083616,0.6510907138236125,1.2291014193083591,0.7985636689058854,21733,21807,Jefferson+Madison+Taylor,Taylor,12,123,Florida,FL
12069,12CS026,4023,3857,4189,4366,343,177,509,292,-0.3020195092546266,0.12380833453246086,0.5849465933535314,0.8481592561101182,5027,4823,5230,5749,722,519,926,778,-0.794546993127552,-0.1977743979614449,0.45206916046839074,1.075558225802758,384148,394356,Lake,Lake,12,69,Florida,FL
12071,12CS027,6371,6041,6702,7250,879,548,1209,599,-0.047873302899859756,0.3628464793957294,0.8095985161899778,0.6810236887843554,7978,7573,8383,9402,1424,1019,1829,1019,-0.003272646574179418,0.6199998491824255,1.2418779197411618,0.7152880896294154,768212,784579,Lee,Lee,12,71,Florida,FL
12013,12CS028,149,143,155,180,31,25,37,20,0.4292859839295444,0.8320049333876165,1.2642443356172877,0.618762535050674,182,175,189,239,57,50,64,42,0.6876750773451279,1.292918135458731,1.9051830659099087,0.7296722509363258,13694,13637,Liberty and Nearby Counties,Calhoun,12,13,Florida,FL
12037,12CS028,138,133,143,143,5,-0,10,5,-0.4495417380169871,2.1424589016603383e-4,0.4143338466100412,0.8537575592044959,171,165,178,205,34,27,40,38,-1.0090442677253648,-0.4022192786581574,0.1768861027053668,1.0949764250071614,12418,12555,Liberty and Nearby Counties,Franklin,12,37,Florida,FL
12045,12CS028,154,148,160,197,43,37,49,22,1.031109460864176,1.4534860184589065,1.9194256613889031,0.5044773047490241,192,185,200,242,50,42,57,32,0.8688153322353999,1.4898932298051124,2.0708296732790537,0.6316619824600169,14100,14336,Liberty and Nearby Counties,Gulf,12,45,Florida,FL
12077,12CS028,60,59,61,78,18,17,19,15,0.31798035807902536,0.41003598359360305,0.5163077446716317,0.7772259184881986,73,72,74,117,44,43,45,17,3.9866015990233774,4.120202860973605,4.263594354929057,0.37640662982624423,8020,7911,Liberty and Nearby Counties,Liberty,12,77,Florida,FL
12129,12CS028,263,248,277,321,58,44,73,30,0.40331633484681023,0.8352058008597506,1.2593900385998082,0.5046995197952947,332,314,349,414,82,65,100,60,0.19995392689160724,0.8044407936511865,1.3996307100075125,0.7192043539219075,33949,34576,Liberty and Nearby Counties,Wakulla,12,129,Florida,FL
12081,12CS029,3636,3462,3809,4106,470,297,644,379,-0.2086647110818846,0.22644649397322084,0.62699685907644,0.8038875549608866,4541,4329,4753,5298,757,545,969,694,-0.3555053808934185,0.192649732735569,0.8039937158541778,0.9156046742070764,402840,411061,Manatee,Manatee,12,81,Florida,FL
12083,12CS030,4620,4458,4782,5251,631,469,793,441,0.08431232373289145,0.5056286682097444,0.9310795576481233,0.6977126825619303,5742,5544,5941,7065,1323,1124,1521,1110,0.06181344943634919,0.6841250441601713,1.2808451808530397,0.8386769664241874,376602,384669,Marion,Marion,12,83,Florida,FL
12085,12CS031,1646,1578,1715,1995,349,280,417,167,0.6968450528476935,1.133769450433667,1.5929390894585553,0.477713227435164,2020,1938,2103,2464,444,361,526,225,1.0480042404096686,1.6466738539483852,2.2677910182980474,0.5060423004745345,159067,159736,Martin,Martin,12,85,Florida,FL
12086,12CS032,17029,15872,18186,22009,4980,3823,6137,3655,0.07921223284457513,0.5044508457178413,0.8895375179247245,0.7338411102517697,20833,19456,22210,26064,5231,3854,6608,4101,-0.13764231080996858,0.531856504840129,1.1278403193822797,0.7838160503122228,2692160,2667106,Miami-Dade,Miami-Dade,12,86,Florida,FL
12087,12CS033,657,622,693,662,5,-31,40,40,-0.8565982249707409,-0.41753026881075334,0.005454816554583165,7.004837034727021,806,764,849,853,47,4,89,56,-0.7724161190097316,-0.12103112889201556,0.4467841048578438,1.1702972266166924,81443,82263,Monroe,Monroe,12,87,Florida,FL
12089,12CS034,832,793,871,901,69,30,108,67,-0.43699354171952987,0.011587113170264078,0.43556418905634414,0.958507429131022,1047,999,1095,1208,161,113,209,169,-0.7239349291354418,-0.09900359494702765,0.5130878476163454,1.0439230595014712,90974,93723,Nassau,Nassau,12,89,Florida,FL
12091,12CS035,1619,1528,1710,1896,277,186,368,200,-0.06490774313243262,0.3839812651877998,0.7888153719115643,0.7192401743596559,1998,1888,2108,2359,361,251,471,305,-0.2677626368559956,0.28694157220294825,0.9809534173989557,0.8432061661974167,211902,213044,Okaloosa,Okaloosa,12,91,Florida,FL
12095,12CS036,7361,6748,7974,8379,1018,405,1631,745,-0.25852383043471355,0.18638887258585052,0.6313027819232602,0.7310631291132728,9130,8395,9865,10765,1635,900,2370,1451,-0.49395392561093243,0.1395061655165276,0.789364529123669,0.8869238250061976,1424119,1423789,Orange,Orange,12,95,Florida,FL
12097,12CS037,2216,2048,2384,2531,315,147,483,276,-0.34765061618329796,0.08982394873234431,0.5433789343487605,0.8728638705349232,2820,2613,3028,3532,712,504,919,605,-0.37399413524818176,0.31147267126849526,0.9170199628725364,0.8490455966841824,389716,401470,Osceola,Osceola,12,97,Florida,FL
12099,12CS038,12653,12011,13296,14606,1953,1310,2595,1572,-0.16506540556504257,0.2512496353351996,0.6792328298279545,0.8046224582398646,15533,14760,16306,17795,2262,1489,3035,1994,-0.39790167977572255,0.21434757454525732,0.7870622154433472,0.8812534675605427,1493819,1497182,Palm Beach,Palm Beach,12,99,Florida,FL
12101,12CS039,5677,5433,5921,6147,470,226,714,352,-0.22003508747454473,0.20327939107822915,0.6253470996161736,0.7473572663114414,7113,6812,7413,8129,1016,716,1317,1049,-0.6963690178271728,-0.058196264293379874,0.523314421624011,1.031006518765337,565945,581395,Pasco,Pasco,12,101,Florida,FL
12103,12CS040,10071,9658,10484,11173,1102,689,1515,747,-0.06954511132768268,0.3783233421484185,0.823349345334059,0.6773398896906239,12269,11775,12763,13920,1651,1157,2145,1235,-0.07851867337172054,0.5054916727028453,1.116375691647725,0.7474628262775241,960952,956927,Pinellas,Pinellas,12,103,Florida,FL
12105,12CS041,6284,5969,6599,7210,926,611,1241,718,-0.1259907458344169,0.29125743570307405,0.7544377408006768,0.7745460488199034,7888,7501,8276,9799,1911,1523,2298,1555,-9.673275830520993e-4,0.5453971465657956,1.1526292458452878,0.8134797370691769,731141,749978,Polk,Polk,12,105,Florida,FL
12107,12CS042,854,823,886,994,140,108,171,71,0.4655706202585408,0.9308980055966988,1.3543762668916883,0.5044810518608037,1050,1012,1089,1488,438,399,476,265,2.162185899980181,2.8000978819267,3.3972793429473644,0.6040662163433159,73573,74047,Putnam,Putnam,12,107,Florida,FL
12109,12CS043,1920,1801,2040,1984,64,-56,183,101,-0.5540064786022584,-0.1456246463922737,0.30239341853493384,1.560104553563597,2465,2315,2615,2676,211,61,361,300,-0.9672335385823971,-0.3688312530469377,0.26501998244283514,1.4170850519805016,276808,290198,St. Johns,St. Johns,12,109,Florida,FL
12111,12CS044,2952,2809,3095,3405,453,310,596,362,-0.15551444519698762,0.2635264585351938,0.6973705674046047,0.798163169066189,3718,3541,3894,4438,720,544,897,522,0.08035015386330684,0.6696646893604393,1.3010098398238397,0.7235114183466834,332088,341785,St. Lucie,St. Lucie,12,111,Florida,FL
12113,12CS045,1426,1344,1507,1572,146,65,228,130,-0.3313020881161098,0.08124421603919084,0.5202987982267325,0.8827982460204716,1796,1696,1896,2093,297,197,397,332,-0.8607882572666984,-0.22547554052083132,0.34576073996607154,1.1141082007843992,188977,193289,Santa Rosa,Santa Rosa,12,113,Florida,FL
12115,12CS046,5035,4847,5223,5783,748,560,936,387,0.3994338753469488,0.8236100366034362,1.2663495661194508,0.5166998680445322,6258,6028,6488,7117,859,629,1089,682,-0.15163503493771108,0.4722037431938659,1.050573280350695,0.7934291857926667,436755,445396,Sarasota,Sarasota,12,115,Florida,FL
12117,12CS047,3033,2830,3235,3358,325,123,528,248,-0.2575986633050807,0.16399228941809962,0.5696796079735942,0.7600110180726649,3736,3493,3978,4398,662,420,905,530,-0.2970232277589163,0.3594689754069522,0.9417435150172354,0.7988717466563122,471064,470234,Seminole,Seminole,12,117,Florida,FL
12119,12CS048,1704,1647,1760,2017,313,257,370,117,1.0620713215962427,1.4758305250742954,1.8983234691892499,0.37241899424230596,2130,2060,2199,2742,612,543,682,320,1.9887335560408723,2.613226848417383,3.182428152517687,0.5217804136603547,131810,134947,Sumter,Sumter,12,119,Florida,FL
12127,12CS049,6297,6058,6536,6918,621,382,860,402,-0.034658815988560944,0.39869286253336633,0.8272499282793567,0.6462009704239194,7779,7488,8069,9311,1532,1242,1823,1137,0.23860165154635055,0.8489495401213543,1.507668580125153,0.7415614912044642,555770,563025,Volusia,Volusia,12,127,Florida,FL
13001,13CS001,177,169,185,232,55,47,63,48,-0.011988716871332272,0.3827756009968718,0.8669017751655113,0.8525217389816452,216,207,226,269,53,43,62,58,-0.9284356157879742,-0.35148517540916563,0.30117736784001636,1.0758289325975976,18429,18479,Appling+Jeff Davis+Long+Wayne,Appling,13,1,Georgia,GA
13161,13CS001,146,140,152,186,40,34,46,26,0.5233914523132677,0.9519073203898851,1.366641146223871,0.6325994635349422,178,171,186,214,36,28,43,35,-0.5441087794947482,0.0463543418010363,0.6917786997078573,0.9560294176771479,14834,14858,Appling+Jeff Davis+Long+Wayne,Jeff Davis,13,161,Georgia,GA
13183,13CS001,80,78,82,105,25,23,27,4,1.147499967976369,1.246274583493977,1.338274368971982,0.15394263745453482,99,97,102,149,50,47,52,29,1.3021771038777914,1.445899059406669,1.5952493288305352,0.5733095023976843,16867,17026,Appling+Jeff Davis+Long+Wayne,Long,13,183,Georgia,GA
13305,13CS001,299,286,312,336,37,24,50,40,-0.5545447060210291,-0.10876072849184086,0.3186379248813672,1.0592760915779387,367,351,383,511,144,128,160,103,0.976254638136788,1.6234964554580964,2.274310989735471,0.71001414480913,30158,30347,Appling+Jeff Davis+Long+Wayne,Wayne,13,305,Georgia,GA
13005,13CS002,127,122,132,146,19,14,24,25,-0.9835120133513204,-0.5551517584860368,-0.11719255481752386,1.2463491120833008,155,149,160,185,30,25,36,40,-1.6230499091866208,-1.0335887582928442,-0.4075172028749732,1.2722583389305637,11115,11085,Bacon+Ben Hill+Coffee+Irwin,Bacon,13,5,Georgia,GA
13017,13CS002,195,188,202,267,72,65,79,50,0.842434763502845,1.2881734717406792,1.6945925691523507,0.6857438934725993,239,230,248,286,47,38,56,39,-0.021243484215648676,0.5800763573540912,1.1829828725376843,0.8082556199487312,17089,17157,Bacon+Ben Hill+Coffee+Irwin,Ben Hill,13,17,Georgia,GA
13069,13CS002,362,343,380,479,117,99,136,94,0.13111507233399095,0.5378323778756325,0.9564361397212563,0.7937879907934687,446,424,469,549,103,80,125,113,-0.9391946949177556,-0.27996454327149667,0.33100345899316974,1.0913826727665636,43116,43337,Bacon+Ben Hill+Coffee+Irwin,Coffee,13,69,Georgia,GA
13155,13CS002,99,99,100,121,22,21,22,18,0.2676733903292971,0.36896865496745107,0.47183304316162145,0.7995061993083525,122,121,123,154,32,31,33,27,0.4482010043564476,0.603126408295285,0.7520932023164122,0.8222856328812512,9611,9622,Bacon+Ben Hill+Coffee+Irwin,Irwin,13,155,Georgia,GA
13011,13CS003,153,145,161,168,15,7,23,18,-0.5869722217660015,-0.16167085002224535,0.2897583424008543,1.1065400105327767,190,180,199,268,78,69,88,41,1.837559514908404,2.4276178107481083,3.0343484221286556,0.5180049316150429,18282,18490,Banks+Habersham,Banks,13,11,Georgia,GA
13137,13CS003,409,389,429,508,99,79,119,74,0.09939176537438928,0.5328086240892297,0.9239345151081424,0.7425310593054503,507,483,531,603,96,72,120,94,-0.5880542203218069,0.044780961107810206,0.6722342671106577,0.9674037299142251,46093,46676,Banks+Habersham,Habersham,13,137,Georgia,GA
13013,13CS004,567,530,603,619,52,16,89,55,-0.45985741178947226,-0.02736807000223712,0.4115342289742467,1.0322992646453586,716,672,761,887,171,126,215,114,0.16993658483980126,0.7776558434611243,1.3947036770240286,0.6631359902189653,84188,86265,Barrow,Barrow,13,13,Georgia,GA
13015,13CS005,816,769,863,1038,222,175,269,119,0.5240286144855245,0.9418080297064247,1.3882512470865258,0.5340154012160924,1018,961,1075,1334,316,259,373,182,0.8371561702090897,1.480935036319751,2.0643441138239558,0.5747174274129788,109244,110620,Bartow,Bartow,13,15,Georgia,GA
13021,13CS006,1498,1430,1565,1827,329,262,397,199,0.4089214899907149,0.828350577335812,1.2902545358200044,0.6024654361669743,1835,1754,1916,2309,474,393,555,332,0.4977974779315348,1.1029791540120986,1.7034432905289338,0.6996117291798263,156498,156812,Bibb,Bibb,13,21,Georgia,GA
13023,13CS007,134,129,139,175,41,36,46,30,0.45400654165690524,0.8794365176862178,1.3055782716390525,0.7132213667177376,163,157,170,197,34,27,40,43,-1.4966054289488762,-0.9003783586584231,-0.2769239235968538,1.2454777194414666,12631,12603,Bleckley+Dodge+Pulaski+Twiggs,Bleckley,13,23,Georgia,GA
13091,13CS007,187,178,196,289,102,93,111,67,1.3275069397392054,1.760766338008648,2.170508858391185,0.650293626676415,227,217,238,319,92,81,102,64,1.0603051570481279,1.6795365323414253,2.290295516670744,0.690483274072315,19960,19772,Bleckley+Dodge+Pulaski+Twiggs,Dodge,13,91,Georgia,GA
13235,13CS007,90,89,91,111,21,20,22,22,-0.20179363230924716,-0.09469780759024224,-0.005977313883323951,0.9996645410723713,108,107,110,172,64,62,65,34,3.4452505789465224,3.576682880223651,3.7286319947477886,0.5265362067628704,10058,9909,Bleckley+Dodge+Pulaski+Twiggs,Pulaski,13,235,Georgia,GA
13289,13CS007,93,92,94,131,38,37,39,19,2.3059124568170004,2.4144046203052976,2.5165290540553578,0.48348295677345826,111,110,112,161,50,49,51,26,3.434067819922329,3.5812584808473025,3.730676626466223,0.5146560992241906,7998,7875,Bleckley+Dodge+Pulaski+Twiggs,Twiggs,13,289,Georgia,GA
13025,13CS008,170,162,178,207,37,29,45,29,0.009839141823766395,0.4241082655296398,0.865791571779881,0.7676714207431367,209,200,219,294,85,75,94,67,0.5628131560022289,1.1585444857288345,1.789703108640354,0.7828220531293593,18204,18092,Brantley+Pierce+Ware,Brantley,13,25,Georgia,GA
13229,13CS008,192,184,201,252,60,51,68,37,0.7192543534185976,1.1586742018384724,1.569810748682439,0.6111462527188882,240,229,250,346,106,96,117,78,1.068680773490177,1.7200850718133462,2.353454855438252,0.7265582959502549,19708,19939,Brantley+Pierce+Ware,Pierce,13,229,Georgia,GA
13299,13CS008,411,395,426,505,94,79,110,72,0.19983835601784794,0.6175042859074438,1.071204427410741,0.7541430786199711,503,484,521,650,147,129,166,144,-0.5014054898855101,0.10456049451732055,0.7641891862583651,0.970485886379622,36140,36060,Brantley+Pierce+Ware,Ware,13,299,Georgia,GA
13027,13CS009,183,176,190,200,17,10,24,28,-1.1664351665944077,-0.7143625600988606,-0.3172588653423462,1.5900400662298595,226,218,235,230,4,-5,12,35,-2.9984685302200753,-2.3008417384426245,-1.6289025207544876,7.5074746705556015,16132,16264,Brooks+Thomas,Brooks,13,27,Georgia,GA
13275,13CS009,473,453,492,539,66,47,86,76,-0.6729101875678678,-0.21664562415699368,0.198468764163356,1.1309129454566966,584,560,607,691,107,84,131,85,-0.004112972995220818,0.5865859103571754,1.1843467369019032,0.7851690411466762,45579,45831,Brooks+Thomas,Thomas,13,275,Georgia,GA
13029,13CS010,283,264,302,295,12,-7,31,19,-0.6035261512955739,-0.1652573147354913,0.2610145779524393,1.4820060227065937,363,339,387,368,5,-19,29,54,-1.8568807107519725,-1.2786855528828929,-0.6518395902858557,8.768345576325355,44427,46655,Bryan+Liberty,Bryan,13,29,Georgia,GA
13179,13CS010,333,305,361,384,51,23,79,35,-0.19373802580276633,0.2494405174381453,0.6454800892274641,0.6768472006945286,416,382,450,599,183,149,217,102,0.8735434582760246,1.4892419371940093,2.090895224189294,0.5545124168112655,64920,65639,Bryan+Liberty,Liberty,13,179,Georgia,GA
13031,13CS011,486,451,521,559,73,38,108,53,-0.16684539173545512,0.23293380638032904,0.6818906211691476,0.7182580947493763,606,564,649,748,142,99,184,146,-0.7105482423016777,-0.06066123030623816,0.5676678446401303,1.0239198555869131,81247,82287,Bulloch,Bulloch,13,31,Georgia,GA
13033,13CS012,224,213,234,248,24,14,35,25,-0.4866152552467829,-0.00906570912669264,0.4136387156928866,0.9818885672995095,275,262,287,286,11,-1,24,52,-2.598674602798694,-2.0151374619330498,-1.3597153967390825,4.206616998765809,24279,24355,Burke+Emanuel+Jenkins+Screven,Burke,13,33,Georgia,GA
13107,13CS012,255,245,265,304,49,39,59,47,-0.33568567722270143,0.0950197064243766,0.5118253528888478,0.9429704834195726,313,301,324,407,94,83,106,82,0.022792692960394878,0.6560501562814881,1.3244980501559447,0.859556695596132,22710,22718,Burke+Emanuel+Jenkins+Screven,Emanuel,13,107,Georgia,GA
13165,13CS012,86,85,87,110,24,23,25,26,-0.3316278482611958,-0.23017610808774336,-0.1335599352658127,1.0401501586010098,105,104,106,133,28,27,29,20,0.917747741036154,1.0841702706826086,1.2271925768805045,0.6951198786847054,8670,8642,Burke+Emanuel+Jenkins+Screven,Jenkins,13,165,Georgia,GA
13251,13CS012,154,148,160,181,27,21,33,17,0.319934623621829,0.7242520491669411,1.131065446821592,0.5993043317982714,189,182,196,251,62,55,69,43,0.9842970178059155,1.6226182118855736,2.2522702530285184,0.6813175775968153,14048,14098,Burke+Emanuel+Jenkins+Screven,Screven,13,251,Georgia,GA
13035,13CS013,242,231,253,290,48,37,59,41,-0.14059255870514298,0.2693991595165069,0.7119132323028299,0.8354549490216885,298,285,311,360,62,49,75,55,-0.35288314035523116,0.3045399509657565,0.9825412732600375,0.8742098348530198,25476,25746,Butts+Lamar+Monroe,Butts,13,35,Georgia,GA
13171,13CS013,180,172,188,236,56,48,64,28,1.0550838317232927,1.4702355026954423,1.9088696589080882,0.4952547028069969,224,215,234,306,82,72,91,55,1.0828643953660142,1.6748174644513425,2.3364567319639566,0.6657870954036448,18671,19003,Butts+Lamar+Monroe,Lamar,13,171,Georgia,GA
13207,13CS013,247,235,259,303,56,44,68,43,0.06392765899012354,0.47033052514319446,0.8663047743694496,0.7514925276621861,307,293,322,372,65,50,79,65,-0.6369888690823403,-0.01152064190878503,0.59918281733174406,0.9895682860814006,28062,28615,Butts+Lamar+Monroe,Monroe,13,207,Georgia,GA
13007,13CS014,28,28,28,38,10,10,10,5,1.7034018742128718,1.810217937017656,1.9050455727258306,0.44678373279072386,34,34,34,45,11,11,11,3,3.215330555860203,3.3658824676862222,3.510010208555011,0.2515979302263637,2871,2823,Calhoun and Nearby Counties,Baker,13,7,Georgia,GA
13037,13CS014,52,51,52,70,18,18,19,2,2.782785897997575,2.877519567155695,2.9838602657732523,0.10384079073668549,63,62,64,67,4,3,5,2,0.2608768377053733,0.4151718341173997,0.5779817951590465,0.4078790083391735,5646,5516,Calhoun and Nearby Counties,Calhoun,13,37,Georgia,GA
13061,13CS014,36,35,37,37,1,-0,2,5,-1.848350703664846,-1.4219998969912293,-0.9796154894528594,2.5710759849885996,45,43,46,57,12,11,14,2,3.7156639902246678,4.355969784890407,4.959674490757457,0.14927661547029605,2850,2875,Calhoun and Nearby Counties,Clay,13,61,Georgia,GA
13099,13CS014,141,137,146,172,31,26,35,35,-0.8315648346828289,-0.4272609256594857,0.038134805061502595,1.1070298698031429,172,166,177,194,22,17,28,23,-0.7170138066538886,-0.08327904975045496,0.5629071652652045,0.9848031414953976,10700,10647,Calhoun and Nearby Counties,Early,13,99,Georgia,GA
13177,13CS014,224,210,238,267,43,29,57,32,-0.07395243202944604,0.32877751434530117,0.7720416420442942,0.7286283481743552,283,266,300,310,27,10,44,43,-1.177478723643161,-0.5659830835240061,0.03363390636953362,1.533483914527941,32746,33377,Calhoun and Nearby Counties,Lee,13,177,Georgia,GA
13201,13CS014,81,81,82,95,14,13,14,3,1.7088709229163914,1.8099145177837865,1.9051303465199814,0.20365213263182677,101,100,101,128,27,27,28,20,1.371408558612841,1.518366335420753,1.673022538073309,0.7018096297891435,5933,5929,Calhoun and Nearby Counties,Miller,13,201,Georgia,GA
13239,13CS014,28,27,29,33,5,4,6,5,-0.5846205750985425,-0.13456162055811607,0.300256453836737,0.8744292449897201,35,34,36,51,16,15,17,5,5.427081369265944,6.0104100424330635,6.609291368369901,0.28991840559677157,2237,2240,Calhoun and Nearby Counties,Quitman,13,239,Georgia,GA
13243,13CS014,74,74,75,104,30,29,30,25,0.6556920111912641,0.7559255261814798,0.8555003360628146,0.8109791079577415,90,89,91,115,25,24,26,6,3.418728133848129,3.5744783129164017,3.7229025149987525,0.23279881112309306,6430,6300,Calhoun and Nearby Counties,Randolph,13,243,Georgia,GA
13273,13CS014,104,103,105,136,32,31,33,31,0.049786256127983444,0.15257107533263606,0.24824980267891078,0.9287081383541148,128,127,129,135,7,6,8,15,-1.1915313908568168,-1.04989715663111,-0.8957837111472993,1.8417822157225916,9049,8992,Calhoun and Nearby Counties,Terrell,13,273,Georgia,GA
13039,13CS015,331,307,354,357,26,3,50,22,-0.3703536362189127,0.07363870097908262,0.5247851110353028,0.8103511368762619,416,387,445,529,113,84,142,82,0.08532444718480009,0.6687994104473671,1.2816387280952506,0.7196726550645268,54971,55554,Camden+Charlton,Camden,13,39,Georgia,GA
13049,13CS015,96,94,97,141,45,44,47,17,2.119549135323052,2.2329065904456913,2.3250004547820455,0.3676313273317827,119,117,120,178,59,58,61,45,1.1985563759872888,1.3455231984505824,1.4919276514153126,0.7465001560076282,12664,12732,Camden+Charlton,Charlton,13,49,Georgia,GA
13043,13CS016,133,129,138,174,41,36,45,35,0.10174773782803799,0.5087515523766606,0.9323238560461834,0.8392820646334622,162,156,168,232,70,64,76,42,2.4346611159329545,3.0477659064740754,3.6345799780991825,0.5899738342294351,10981,11032,Candler+Evans+Tattnall+Toombs,Candler,13,43,Georgia,GA
13109,13CS016,98,97,99,126,28,27,29,11,1.4477477103471525,1.5516375625369108,1.6530107893622399,0.38398422309692654,119,118,121,179,60,58,61,33,2.838619792910338,2.9937639556509663,3.1410512968411726,0.5441603791789792,10734,10684,Candler+Evans+Tattnall+Toombs,Evans,13,109,Georgia,GA
13267,13CS016,189,179,199,242,53,43,63,34,0.40118456292032584,0.8340194780161964,1.247458610373195,0.6248153059999159,228,216,240,346,118,106,130,74,1.6581024388818992,2.272835488217847,2.889469923727767,0.6233717148354171,23232,23023,Candler+Evans+Tattnall+Toombs,Tattnall,13,267,Georgia,GA
13279,13CS016,262,250,274,364,102,90,114,47,1.6311729273277944,2.0458827401307684,2.448789674536758,0.4562123870467912,316,303,330,455,139,125,152,96,1.2735304843454631,1.9102856453530825,2.5052503933094834,0.68814915415033,27007,26932,Candler+Evans+Tattnall+Toombs,Toombs,13,279,Georgia,GA
13045,13CS017,957,905,1008,1159,202,151,254,126,0.22690251521980556,0.6335690590548565,1.0581670550229954,0.6201261262395311,1192,1129,1255,1487,295,232,358,207,0.28879548929388604,0.8832997036124379,1.486576352273002,0.6992562043406719,119819,121603,Carroll+Heard,Carroll,13,45,Georgia,GA
13149,13CS017,111,110,112,135,24,23,25,4,1.6289781974403346,1.7315391420370747,1.8295241682428782,0.16034400523734424,136,135,138,178,42,40,43,28,1.2732935395099205,1.4229118653585495,1.5795987717046294,0.6558394432893292,11528,11550,Carroll+Heard,Heard,13,149,Georgia,GA
13047,13CS018,569,540,598,645,76,47,105,60,-0.2141242597875486,0.23179002012491876,0.6619304128426778,0.7785140268536039,700,664,735,898,198,163,234,151,0.21067979281152802,0.8285041079000106,1.4361896868205086,0.757065526765501,67963,68336,Catoosa,Catoosa,13,47,Georgia,GA
13051,13CS019,2133,2006,2260,2425,292,165,419,193,-0.10022143729259764,0.33690661489865065,0.7622738064038571,0.6586987027106557,2639,2486,2792,3192,553,400,706,396,0.01922982155592349,0.6446976503660385,1.2381936250662797,0.7149676013368675,294364,296121,Chatham,Chatham,13,51,Georgia,GA
13055,13CS020,276,266,287,336,60,49,70,36,0.5039120805890926,0.935014785686736,1.399904997454092,0.5938179228264128,337,324,350,380,43,30,56,48,-0.8746400279195635,-0.23548338057469292,0.4014309867756509,1.0846815959328115,24911,24930,Chattooga+Dade+Walker,Chattooga,13,55,Georgia,GA
13083,13CS020,163,156,170,207,44,37,51,2,2.198531210694676,2.5943081767870027,3.046285519953146,0.04425403527312229,200,191,208,245,45,37,54,31,0.4597095524539306,1.072194238805308,1.687090869590709,0.6679293863067314,16217,16311,Chattooga+Dade+Walker,Dade,13,83,Georgia,GA
13295,13CS020,705,675,734,830,125,96,155,63,0.5059727027746798,0.9051739583182998,1.3231534704492918,0.4981571201371373,864,829,899,996,132,97,167,156,-0.9991670747625907,-0.4192485178753876,0.17963187985119525,1.1719766214315217,68094,68393,Chattooga+Dade+Walker,Walker,13,295,Georgia,GA
13057,13CS021,1449,1333,1564,1630,181,66,297,116,-0.16177487745248847,0.24996507967508505,0.6766408712862322,0.6366347430440918,1832,1691,1974,2235,403,261,544,260,-6.104372367187543e-4,0.6084797001215744,1.2917142257936491,0.6443340449126767,267478,273657,Cherokee+Pickens,Cherokee,13,57,Georgia,GA
13227,13CS021,303,289,317,334,31,17,45,23,-0.16468928789128717,0.24455440089356273,0.631008516309611,0.7170656142017783,377,359,394,468,91,74,109,86,-0.44383869940819,0.17201913954897857,0.8050073320915563,0.9331916456395516,33305,33923,Cherokee+Pickens,Pickens,13,227,Georgia,GA
13059,13CS022,680,625,735,698,18,-37,73,50,-0.6672674698612139,-0.2435380289251521,0.15660364182014458,2.6619849859094527,851,785,918,961,110,43,176,86,-0.400054959875151,0.21062525955034633,0.808349123460585,0.7755546108881013,128476,128679,Clarke+Madison+Oconee,Clarke,13,59,Georgia,GA
13195,13CS022,261,248,274,282,21,8,34,26,-0.5996946881235127,-0.1736622322592252,0.29497544133190756,1.1756905209356745,326,310,342,399,73,57,89,50,0.27289492462914394,0.8976796035140218,1.5291455279375568,0.6761644635296603,30278,30794,Clarke+Madison+Oconee,Madison,13,195,Georgia,GA
13219,13CS022,249,231,268,292,43,24,61,27,-0.03629245712598308,0.38608244765508143,0.8000870187031316,0.6203372461469491,317,295,339,350,33,11,55,29,-0.48933596647086164,0.12007782838309901,0.7230257867696386,0.8474685957115237,41874,42877,Clarke+Madison+Oconee,Oconee,13,219,Georgia,GA
13063,13CS023,1537,1409,1665,1920,383,255,511,204,0.17469095365839632,0.60984982684593525,1.0312174404038132,0.5314729109072013,1912,1758,2065,2613,701,548,855,432,0.46981747199683466,1.098525264906296,1.7206595096323456,0.6152361543267573,296653,297146,Clayton,Clayton,13,63,Georgia,GA
13067,13CS024,3842,3513,4172,4574,732,402,1061,451,-0.03965630533334808,0.362170512766647,0.8179904988793122,0.6155120847568007,4786,4391,5182,5622,836,440,1231,629,-0.2639289542833131,0.3366119094445885,0.9269986906537766,0.7519417464487237,765520,766716,Cobb,Cobb,13,67,Georgia,GA
13071,13CS025,423,404,443,525,102,82,121,55,0.5552770452638757,1.0125702352970591,1.4366042207367957,0.5357229419237868,520,497,544,640,120,96,143,108,-0.30193411317177504,0.3037636958590298,0.9275968779209173,0.8945712622763371,45817,45820,Colquitt+Mitchell,Colquitt,13,71,Georgia,GA
13205,13CS025,220,211,230,288,68,58,77,50,0.3986138822937036,0.8181322335230978,1.2323802301807378,0.7267933117700086,269,257,280,287,18,7,30,35,-1.5475705222962437,-0.9163241693289813,-0.28684003220897475,1.7982957893874454,21685,21544,Colquitt+Mitchell,Mitchell,13,205,Georgia,GA
13073,13CS026,846,778,913,1012,166,99,234,101,-0.019045036512725384,0.4147171847399153,0.8377720842491274,0.6044005358814271,1065,983,1147,1352,287,205,369,175,0.21776015075211821,0.8352187296829465,1.5175090670435187,0.6080249132632739,157123,159221,Columbia,Columbia,13,73,Georgia,GA
13077,13CS027,924,860,987,1100,176,113,240,95,0.128743017720971,0.565566966080277,0.9501510017205934,0.535237878001013,1158,1081,1235,1574,416,339,493,247,0.7516615269586249,1.3508282408940495,1.9387946076061875,0.5927326644850568,147267,149474,Coweta,Coweta,13,77,Georgia,GA
13079,13CS028,130,125,135,140,10,5,15,5,-0.047277844381608126,0.42691534700213735,0.8567769013836465,0.45003076900206873,160,153,166,213,53,47,60,30,1.6753482465110956,2.3192404023885214,2.9130640371599243,0.5510654921554485,12141,12145,Crawford+Peach+Pike+Upson,Crawford,13,79,Georgia,GA
13225,13CS028,276,263,288,319,43,31,56,36,-0.1617073652218494,0.2603255346814191,0.6830858178681184,0.8097293850341079,342,328,357,407,65,50,79,68,-0.7849418807526043,-0.13926048267675553,0.4768042102899935,1.035575943347089,28026,28361,Crawford+Peach+Pike+Upson,Peach,13,225,Georgia,GA
13231,13CS028,174,166,182,190,16,8,24,32,-1.319854430274892,-0.8216599186157866,-0.4146779463009075,1.8532489970855688,218,208,228,262,44,34,54,55,-1.2666731409676508,-0.6988241602278756,-0.0367138821091814,1.2300921804927398,18994,19398,Crawford+Peach+Pike+Upson,Pike,13,231,Georgia,GA
13293,13CS028,340,328,352,421,81,69,93,55,0.5381546963874195,0.9311093095055779,1.3847478408432319,0.6724872021284921,418,404,432,548,130,116,144,97,0.8877497777817637,1.4318778403987296,2.0158793285792775,0.7399136205805319,27522,27719,Crawford+Peach+Pike+Upson,Upson,13,293,Georgia,GA
13081,13CS029,198,190,207,318,120,111,128,45,3.2440402401135318,3.655597630581651,4.0893273471186955,0.37344208932701994,240,230,251,346,106,95,116,66,1.769845329120486,2.3931068736928394,3.0312497401332474,0.6183191116729532,20366,19903,Crisp+Dooly+Turner+Wilcox,Crisp,13,81,Georgia,GA
13093,13CS029,91,89,92,170,79,78,81,20,5.096467515687396,5.1960411946114995,5.294163326245252,0.24864248972988137,107,105,108,173,66,65,68,25,4.416946158885906,4.55783221685214,4.712899282647648,0.37059804143839703,11445,10922,Crisp+Dooly+Turner+Wilcox,Dooly,13,93,Georgia,GA
13287,13CS029,114,113,115,117,3,2,4,25,-2.6021163082203045,-2.503479821052085,-2.4011346014479344,6.369892727493252,142,141,143,134,-8,-9,-7,15,-3.2621179781488214,-3.112484949086079,-2.9640852989022424,-2.070825062929319,8819,8967,Crisp+Dooly+Turner+Wilcox,Turner,13,287,Georgia,GA
13315,13CS029,84,83,85,117,33,32,34,25,0.7827557617174502,0.8807818151061559,0.9831791010053159,0.7427310088148251,104,103,105,171,67,66,68,17,6.713239912586891,6.864392456326256,7.019864378168274,0.24999384315186565,8714,8738,Crisp+Dooly+Turner+Wilcox,Wilcox,13,315,Georgia,GA
13085,13CS030,224,213,236,230,6,-6,17,18,-0.9223543680064392,-0.477330213939205,-0.03593816458999844,2.7529797903860875,287,272,301,315,28,14,43,56,-1.7766968458275345,-1.1719605444323278,-0.5483222795452607,1.9061211464791052,27059,28286,Dawson+Lumpkin+White,Dawson,13,85,Georgia,GA
13187,13CS030,256,242,271,287,31,16,45,20,-0.08911990937287068,0.3119652453631975,0.739825132970854,0.6346579759137397,320,302,337,422,102,85,120,67,0.6099076435183574,1.24618160412628,1.8626660691226458,0.6477132685541832,33681,34179,Dawson+Lumpkin+White,Lumpkin,13,187,Georgia,GA
13311,13CS030,242,230,254,336,94,82,106,33,1.7053957545639609,2.1441226261132758,2.5475804189721023,0.3484985149579222,297,283,312,447,150,135,164,67,2.863968811947362,3.508946992281825,4.14036845605675,0.4445562147026495,28493,28391,Dawson+Lumpkin+White,White,13,311,Georgia,GA
13087,13CS031,298,285,310,367,69,57,82,39,0.59006513087989,1.0523358007555146,1.4934431076114625,0.554964594924291,365,350,380,395,30,15,45,51,-1.4734526701678314,-0.8754180811497437,-0.24509147940642073,1.6655829937259565,28892,29082,Decatur+Grady+Seminole,Decatur,13,87,Georgia,GA
13131,13CS031,234,223,246,273,39,27,50,38,-0.41659493088163,0.02464308555196209,0.46754218139857995,0.9617796464582367,287,274,301,347,60,46,73,49,-0.12368848495266727,0.5084478114443183,1.0964783953134818,0.8098494408201521,25951,25962,Decatur+Grady+Seminole,Grady,13,131,Georgia,GA
13253,13CS031,119,118,120,125,6,5,7,14,-0.9684525900630104,-0.8646765876903848,-0.7666366454750353,1.945362125420064,149,148,150,163,14,13,15,28,-1.9613532482612241,-1.7993141381655613,-1.6513297959927924,1.8451758020989755,8991,9188,Decatur+Grady+Seminole,Seminole,13,253,Georgia,GA
13089,13CS032,3969,3641,4297,4797,828,500,1156,479,0.018303677259277916,0.4718343218126668,0.8967209704079291,0.5780777939160027,4910,4518,5301,5842,932,541,1324,564,-0.053507896656570395,0.6046732312277977,1.2738821608080366,0.6042414837168952,762626,758609,DeKalb,DeKalb,13,89,Georgia,GA
13095,13CS033,781,745,818,1089,308,271,344,173,1.1034915580372031,1.5724527188666442,2.0087262138773316,0.5607602362917133,953,909,996,1203,250,207,294,149,0.8525713076352067,1.4542591350282117,2.039630831825726,0.5924651487487252,85674,84920,Dougherty,Dougherty,13,95,Georgia,GA
13097,13CS034,847,785,909,1034,187,125,249,108,0.09730844460416431,0.543025504491771,0.9732016524263922,0.5744819900709773,1053,978,1128,1295,242,167,317,164,0.010707473830072168,0.6585303786683764,1.2425559416457996,0.6754451923072516,144953,145622,Douglas,Douglas,13,97,Georgia,GA
13103,13CS035,422,394,450,470,48,20,76,31,-0.14009836307109474,0.27516659354841067,0.7093817066780025,0.6337782702330624,531,497,565,655,124,90,158,143,-1.025352334319726,-0.3354749435174755,0.2630680421051609,1.14409795029538,65198,66509,Effingham,Effingham,13,103,Georgia,GA
13105,13CS036,224,216,233,296,72,63,80,27,1.8885964095157377,2.2984399091591894,2.7128374284368,0.3706303995349805,273,263,284,331,58,47,68,39,0.46612327149392635,1.1325911118157717,1.7993731422628942,0.6666421602488694,19560,19586,Elbert+Franklin+Hart+Stephens,Elbert,13,105,Georgia,GA
13119,13CS036,264,254,274,323,59,49,69,33,0.7030438596788086,1.0997099103638661,1.5437886958005613,0.5502966014607964,326,314,338,368,42,30,54,43,-0.6717494818421107,-0.06414796560654391,0.5927570618727431,0.9973720946489066,23450,23733,Elbert+Franklin+Hart+Stephens,Franklin,13,119,Georgia,GA
13147,13CS036,257,246,268,324,67,56,78,36,0.756639062444185,1.1799737914539057,1.6258528763313114,0.5306490704023057,319,305,332,407,88,75,102,52,1.0260133734403487,1.6377526794950499,2.2583691246303608,0.5836174034707857,25979,26330,Elbert+Franklin+Hart+Stephens,Hart,13,147,Georgia,GA
13257,13CS036,326,314,337,330,4,-7,16,42,-1.8276303530556468,-1.4299834478015745,-0.9705889934926035,8.37372801875355,399,385,413,488,89,75,103,69,0.2978961230153003,0.9049398025314013,1.463652807769569,0.7667624630827596,26693,26856,Elbert+Franklin+Hart+Stephens,Stephens,13,257,Georgia,GA
13111,13CS037,284,273,295,352,68,57,79,26,1.206584467977267,1.6511172472135331,2.1032393205631195,0.3780622688749642,347,334,361,468,121,107,134,79,1.363401561837722,1.9375754312125584,2.5865494932589748,0.6487336887731238,25538,25756,Fannin+Rabun+Towns+Union,Fannin,13,111,Georgia,GA
13241,13CS037,181,174,188,234,53,46,60,24,1.3389603777139774,1.713628347345323,2.1223728851417927,0.4432265162597654,221,212,230,285,64,55,73,46,0.6546851823544791,1.2618832677416214,1.8943062003517177,0.7049861341731319,16950,17086,Fannin+Rabun+Towns+Union,Rabun,13,241,Georgia,GA
13281,13CS037,169,164,175,181,12,6,17,26,-1.569507174467124,-1.1334549724462228,-0.684036436183405,2.0426967659179933,209,203,216,248,39,32,45,41,-0.8169969339986183,-0.21370873515224767,0.4368236572029688,1.0304365059373364,12497,12826,Fannin+Rabun+Towns+Union,Towns,13,281,Georgia,GA
13291,13CS037,279,268,290,361,82,71,93,31,1.6261632767577474,2.053253225301633,2.481111384047902,0.3730813491779059,345,332,358,435,90,77,103,64,0.5916709580199766,1.2446128995934653,1.8644601737771729,0.7035209947733976,24821,25411,Fannin+Rabun+Towns+Union,Union,13,291,Georgia,GA
13113,13CS038,793,742,844,868,75,24,126,70,-0.41336305114827404,0.04440971163013142,0.46122710249307153,0.9226104729772913,987,925,1050,1186,199,136,261,145,-0.08244675371950823,0.5463004996739703,1.1639447528370679,0.7262112485799438,118860,120409,Fayette,Fayette,13,113,Georgia,GA
13115,13CS039,965,923,1007,1143,178,136,220,107,0.3175177179859382,0.7257388785315455,1.1500287294329261,0.5979319120182585,1185,1134,1236,1448,263,212,314,207,0.03143452947038558,0.6933770284955418,1.3142857989817402,0.7827510690813568,98572,98745,Floyd,Floyd,13,115,Georgia,GA
13117,13CS040,1091,982,1200,1196,105,-4,214,71,-0.27773428231718283,0.1437467275643826,0.5363188706090168,0.670433726712572,1392,1258,1525,1692,300,167,434,201,-0.1450499086220245,0.4402986210365079,1.0485700593819187,0.667045456610163,252369,259124,Forsyth,Forsyth,13,117,Georgia,GA
13121,13CS041,5852,5393,6312,7006,1154,694,1613,687,0.022389517277313045,0.4391250310433277,0.8874526515766148,0.5949006730892701,7237,6687,7787,8332,1095,545,1645,877,-0.37358989955942257,0.22762148078337036,0.8749054465226584,0.800045207893404,1068055,1065872,Fulton,Fulton,13,121,Georgia,GA
13123,13CS042,308,294,321,363,55,42,69,33,0.27714069619541526,0.717466098160553,1.1128811185784457,0.5841424149050766,382,365,398,503,121,105,138,93,0.4893831533316617,1.053128190515107,1.7017002358338926,0.7617285232130261,31512,31939,Gilmer+Murray,Gilmer,13,123,Georgia,GA
13213,13CS042,326,309,343,406,80,63,97,41,0.49498068410987334,0.9646776276046021,1.4105954587104055,0.5080331211196578,402,381,422,544,142,122,163,92,0.880228851963642,1.535745555526213,2.146340655606985,0.6416150438756147,39948,39949,Gilmer+Murray,Murray,13,213,Georgia,GA
13127,13CS043,751,715,787,945,194,158,230,107,0.6041859694068759,1.0271182539544756,1.4646907329357268,0.5486630576891092,922,878,966,1141,219,175,263,189,-0.15139112521708045,0.3915341025319567,1.049599696850284,0.8595848197300404,84623,84700,Glynn+McIntosh,Glynn,13,127,Georgia,GA
13191,13CS043,105,100,110,148,43,38,48,12,2.2878551316098115,2.7113137008669073,3.1413318937983385,0.27294569395788915,127,121,132,226,99,94,105,25,7.411590730679324,8.042606400791552,8.649352479638775,0.24899424345166887,11480,11102,Glynn+McIntosh,McIntosh,13,191,Georgia,GA
13129,13CS044,483,459,508,593,110,85,134,61,0.3931635685134009,0.8171089434085301,1.263049190744524,0.5519596404371768,599,569,629,773,174,144,204,122,0.4060440405172944,1.077460857589893,1.6521095219856832,0.6980003808316836,57803,58158,Gordon,Gordon,13,129,Georgia,GA
13135,13CS045,3863,3451,4274,4746,883,472,1295,531,-0.05051411437375018,0.36141341803545746,0.7965586882726992,0.6006518495310286,4873,4376,5371,5974,1101,603,1598,761,-0.20361581605076273,0.4226059039581236,1.0644129713394632,0.6908374556506425,955528,963562,Gwinnett,Gwinnett,13,135,Georgia,GA
13139,13CS046,1338,1251,1426,1728,390,302,477,183,0.5751057223415046,1.0088053522808373,1.4847415497913754,0.46844208174723706,1672,1565,1779,2026,354,247,461,332,-0.4828788981825232,0.12385088088242541,0.7205124054809041,0.9352891435320149,204088,206818,Hall,Hall,13,139,Georgia,GA
13141,13CS047,94,93,94,159,65,65,66,40,2.833547781912914,2.9252397487662716,3.029232470006749,0.6026167927959294,114,113,115,167,53,52,54,30,3.0393526770347625,3.180518239997203,3.328736774785786,0.5563655049302818,8676,8643,Hancock+Jasper+Morgan+Putnam,Hancock,13,141,Georgia,GA
13159,13CS047,141,134,147,144,3,-3,10,16,-1.2868939463038558,-0.8518929503707751,-0.43457490182489306,3.5604525127154405,177,169,185,225,48,40,56,53,-0.98899544334141,-0.4129941015605018,0.2257509296169418,1.082448947763994,14642,15185,Hancock+Jasper+Morgan+Putnam,Jasper,13,159,Georgia,GA
13211,13CS047,176,167,185,209,33,24,42,12,0.6316240545463347,1.0544862741119698,1.461437791724922,0.35133252676596805,219,208,230,293,74,63,85,38,1.5183641144285291,2.0925937641996075,2.7230652758001708,0.5066312192173159,20086,20568,Hancock+Jasper+Morgan+Putnam,Morgan,13,211,Georgia,GA
13237,13CS047,210,200,219,258,48,39,58,30,0.3754317073643709,0.823121027900844,1.235014340819944,0.6091043452534638,259,248,271,366,107,95,118,51,2.369270074206077,2.9509168288943344,3.5463366460092867,0.474005794092205,22178,22520,Hancock+Jasper+Morgan+Putnam,Putnam,13,237,Georgia,GA
13143,13CS048,311,298,324,392,81,68,94,50,0.6034466572155384,1.0595328203610614,1.4373644461348367,0.6074718287886945,383,367,398,444,61,46,77,68,-0.8166708367845111,-0.2813821198345884,0.3374661067044966,1.0908995476383434,30031,30486,Haralson+Polk,Haralson,13,143,Georgia,GA
13233,13CS048,422,403,440,504,82,64,101,46,0.39278623633871834,0.8548393181705226,1.2897731219344502,0.5513846041832883,517,495,540,660,143,120,165,88,0.8986224911423177,1.4980882045311397,2.1066258297704046,0.6128883459397052,42939,43413,Haralson+Polk,Polk,13,233,Georgia,GA
13145,13CS049,253,238,268,284,31,16,46,29,-0.3584573643287146,0.052377330660890335,0.46556899463974566,0.9002031371495418,317,299,335,345,28,10,46,58,-1.6076735314500112,-0.998623905067557,-0.4104364508281613,1.9987814710141418,35038,35524,Harris+Meriwether+Talbot,Harris,13,145,Georgia,GA
13199,13CS049,233,224,242,284,51,42,60,19,1.1310565136049622,1.5294235251141077,1.9594668979811802,0.3661091983465737,286,276,297,400,114,103,124,68,2.0267982007309544,2.6163784456212515,3.195175467893537,0.5933802692943416,20709,20768,Harris+Meriwether+Talbot,Meriwether,13,199,Georgia,GA
13263,13CS049,67,66,68,80,13,12,14,2,1.808788039167226,1.911816688341407,2.0098188967513004,0.1419927143243072,81,81,82,97,16,15,16,20,-1.0641720752694843,-0.8966413834405271,-0.7492774984890309,1.1976225106864644,5799,5740,Harris+Meriwether+Talbot,Talbot,13,263,Georgia,GA
13151,13CS050,1426,1322,1530,1751,325,221,429,151,0.30756708506549396,0.7125160869791223,1.1299241195864482,0.4637750941655314,1788,1661,1914,2208,420,294,547,326,-0.13632998489300194,0.44918680000623784,1.0642467465165915,0.7735426243823031,241132,244737,Henry,Henry,13,151,Georgia,GA
13153,13CS051,1097,1027,1168,1304,207,136,277,106,0.16768834916614325,0.6046336675353914,1.0418578153512983,0.5103634099085352,1375,1290,1461,1701,326,240,411,247,0.0037896431832833014,0.5608625740215007,1.1955624054682106,0.7563688635885654,163518,166452,Houston,Houston,13,153,Georgia,GA
13157,13CS052,580,547,613,680,100,67,133,77,-0.107260942473372,0.3035761075134031,0.7122701304587503,0.7632245511596965,736,695,777,858,122,81,163,139,-0.8749236676850611,-0.256267929202386,0.340397805600957,1.1313665382978821,76545,79765,Jackson,Jackson,13,157,Georgia,GA
13003,13CS053,72,71,73,80,8,7,9,11,-0.45870454166566516,-0.3604964924654123,-0.26361581407186224,1.2216861522340345,89,88,90,139,50,49,51,28,2.9760314551879374,3.128012052197142,3.2855291976916523,0.5506165256068402,8306,8378,Lanier and Nearby Counties,Atkinson,13,3,Georgia,GA
13019,13CS053,184,176,192,227,43,35,51,30,0.30951994565035934,0.7243901780533383,1.1468289683914201,0.6800200540895844,223,214,233,286,63,53,72,37,1.0698521921528055,1.6581253813515093,2.3023200533528856,0.5819408482434248,18335,18149,Lanier and Nearby Counties,Berrien,13,19,Georgia,GA
13065,13CS053,71,70,72,92,21,20,22,13,1.1112735464233228,1.2131951987253,1.319664771465083,0.5867632537118785,87,86,88,116,29,28,30,19,1.6299239780382253,1.7837708821343197,1.9266986428256476,0.6334517231483054,6711,6725,Lanier and Nearby Counties,Clinch,13,65,Georgia,GA
13075,13CS053,167,159,174,213,46,39,54,32,0.39393623747605794,0.8074393111673556,1.2361439330818127,0.6782891116734627,204,195,213,229,25,16,34,29,-0.8512552626493557,-0.2698572410270647,0.34941761370192675,1.1166022818907484,17233,17226,Lanier and Nearby Counties,Cook,13,75,Georgia,GA
13101,13CS053,21,21,21,36,15,15,15,4,2.871282006765349,2.9663951851836092,3.065590665737372,0.24893497159566386,26,25,26,42,16,16,17,4,3.8745325699376685,4.033685092828575,4.184940374527425,0.2294888389819761,3735,3699,Lanier and Nearby Counties,Echols,13,101,Georgia,GA
13173,13CS053,78,77,79,84,6,5,7,10,-0.4725879081544452,-0.3744980620808377,-0.27554619753796356,1.3767602894531332,95,93,96,114,19,18,21,3,1.8463360875170418,1.9928235588394423,2.1368803099595057,0.14661984769824385,10012,9908,Lanier and Nearby Counties,Lanier,13,173,Georgia,GA
13185,13CS054,802,751,853,989,187,136,238,107,0.277673908488989,0.6722431502837113,1.089191679722814,0.5689681941328846,998,937,1060,1237,239,177,300,156,0.19944639503243772,0.8129155007319118,1.470640980844697,0.6503663231143115,118312,119136,Lowndes,Lowndes,13,185,Georgia,GA
13053,13CS055,35,34,36,35,-0,-1,1,4,-0.5303206574126459,-0.4338480313910752,-0.3242956975131656,4.803326568195671,42,41,43,39,-3,-4,-2,9,-1.7135573881411856,-1.5584143045442644,-1.414009112231025,-4.881441989652706,9657,9111,Marion and Nearby Counties,Chattahoochee,13,53,Georgia,GA
13193,13CS055,135,130,140,147,12,7,17,11,-0.33884876193081204,0.09420148523528815,0.5205731296017659,0.8339720306662272,164,158,170,174,10,4,16,23,-1.895408924199657,-1.2423656584546288,-0.6817609685150098,2.0382374568565824,12152,12006,Marion and Nearby Counties,Macon,13,193,Georgia,GA
13197,13CS055,67,66,68,87,20,19,21,3,2.145751892142523,2.2579159480575832,2.352277692060049,0.14135169879573445,80,79,81,126,46,45,47,30,2.356136461060537,2.5114491804383854,2.670616271069801,0.6439797525993657,7642,7452,Marion and Nearby Counties,Marion,13,197,Georgia,GA
13249,13CS055,31,30,31,40,9,9,10,6,0.603171646099393,0.7007390084639714,0.8054551477905046,0.5855372946657531,37,36,38,58,21,20,22,2,4.953453583086765,5.098057663307439,5.25286166042217,0.09062726704974372,4636,4487,Marion and Nearby Counties,Schley,13,249,Georgia,GA
13259,13CS055,49,49,50,59,10,9,10,12,-0.48638106890291377,-0.38480779253822184,-0.28476257761672286,1.1037919048421743,59,58,60,78,19,18,20,12,1.465021563991445,1.6030486461302689,1.7627971240519948,0.595660884698336,5497,5334,Marion and Nearby Counties,Stewart,13,259,Georgia,GA
13261,13CS055,311,298,323,342,31,19,44,69,-1.7348993550110943,-1.2843471846647552,-0.8452174709457662,2.1424357764037527,378,363,393,431,53,38,68,58,-0.862034098556988,-0.20760124453677153,0.4571479063822049,1.0808055196153739,29503,29322,Marion and Nearby Counties,Sumter,13,261,Georgia,GA
13269,13CS055,82,82,83,98,16,15,16,17,-0.2647437393160039,-0.16821912383275134,-0.06484003147450204,1.0198671535619581,101,100,102,138,37,36,38,15,3.252819275214385,3.413041360813165,3.555471447161746,0.3929637872253885,7847,7801,Marion and Nearby Counties,Taylor,13,269,Georgia,GA
13307,13CS055,21,21,21,27,6,6,6,8,-0.9226242073360588,-0.8178154167941877,-0.7198226853576842,1.1343950899352333,26,25,26,25,-1,-1,-0,3,-1.991489201096813,-1.8503048687444097,-1.707961195605263,8.658182363287255,2384,2365,Marion and Nearby Counties,Webster,13,307,Georgia,GA
13215,13CS056,1781,1692,1869,1981,200,112,289,190,-0.3763173179263726,0.041373026946165466,0.46697115769537345,0.9438253522742683,2186,2080,2292,2562,376,270,482,369,-0.5564118667344874,0.04459740363981329,0.6386826049644353,0.9788341539698635,205233,205813,Muscogee,Muscogee,13,215,Georgia,GA
13217,13CS057,786,738,835,999,213,164,261,104,0.5562195621589817,0.9832075478822082,1.4073894944512246,0.4871097821724447,988,928,1047,1249,261,202,321,199,0.008833104347022771,0.6431528632395592,1.2476363035919689,0.7590551347043295,112919,114979,Newton,Newton,13,217,Georgia,GA
13223,13CS058,849,776,922,1046,197,124,270,106,0.09608195358627934,0.5338206049330799,0.9412959246857541,0.5361765930833021,1076,987,1166,1288,212,122,301,188,-0.41945992315823843,0.15740825114450366,0.7851035425955504,0.8842076449575742,170037,173179,Paulding,Paulding,13,223,Georgia,GA
13245,13CS059,1775,1686,1863,2116,341,253,430,236,0.058292728123448406,0.5111841662778555,0.9696715498295408,0.6896927933407544,2175,2068,2281,2656,481,375,588,391,-0.07955477627394823,0.5361387492480402,1.137253699109041,0.8103734525017144,205722,205769,Richmond,Richmond,13,245,Georgia,GA
13247,13CS060,655,615,695,777,122,82,162,71,0.07395587473315972,0.5574271461320277,0.9502088791954736,0.5779303800160878,816,768,865,1008,192,143,240,151,-0.07780947582056257,0.5207607486851538,1.1170405403478054,0.7825522362355816,93229,94014,Rockdale,Rockdale,13,247,Georgia,GA
13255,13CS061,662,633,691,839,177,148,206,94,0.8096939699854537,1.2244203585838493,1.642104385252359,0.5284437481621618,814,779,849,1101,287,252,322,205,0.8386086475086187,1.463661816009136,2.0575073808006215,0.7126242349396625,67380,67837,Spalding,Spalding,13,255,Georgia,GA
13133,13CS062,196,188,204,212,16,8,24,23,-0.8205270060597436,-0.37717201860771404,0.055443147934476376,1.3708010808983093,246,236,256,275,29,19,39,33,-0.8936947490015996,-0.26183983765014246,0.3380166330474727,1.1120459376372858,18981,19461,Taliaferro and Nearby Counties,Greene,13,133,Georgia,GA
13181,13CS062,79,78,80,96,17,16,18,17,-0.08837962917324688,0.01692078681791103,0.12017053425868769,0.9385067045278916,97,96,98,122,25,24,26,17,1.105295247102568,1.2680038930118025,1.4200247061149558,0.649480075753177,7747,7742,Taliaferro and Nearby Counties,Lincoln,13,181,Georgia,GA
13189,13CS062,220,211,229,238,18,9,27,23,-0.6605432746026036,-0.24131279606201722,0.20594939011482022,1.2236709941211619,271,260,282,309,38,27,49,37,-0.5978994973788254,0.07411360122356309,0.6454946298200112,0.9523090447708078,21552,21626,Taliaferro and Nearby Counties,McDuffie,13,189,Georgia,GA
13221,13CS062,141,135,148,151,10,3,16,2,0.09171403384199156,0.5178514143089702,0.938874404460761,0.18826211479383703,176,168,184,194,18,10,26,20,-0.7931945121818387,-0.14494246408234382,0.46622523833809143,1.0469634016765783,14946,15100,Taliaferro and Nearby Counties,Ogelthorpe,13,221,Georgia,GA
13265,13CS062,21,21,21,23,2,2,2,5,-2.009270472797371,-1.9094875354553325,-1.8053877187847132,1.6508162198855516,26,26,26,37,11,11,11,2,6.982028959553752,7.1353534683081286,7.289481373582317,0.1629628864682647,1556,1558,Taliaferro and Nearby Counties,Taliaferro,13,265,Georgia,GA
13301,13CS062,66,66,67,89,23,22,23,6,3.101655916504039,3.2136295257329772,3.317099181789328,0.25259425500701116,82,81,82,86,4,4,5,13,-2.117009861295312,-1.9739626372011851,-1.8195058930699628,2.3990958885944624,5211,5235,Taliaferro and Nearby Counties,Warren,13,301,Georgia,GA
13317,13CS062,134,130,138,135,1,-3,5,11,-1.4735320556822467,-1.0638262565433387,-0.6058518780580266,5.576504428124683,163,158,168,179,16,11,21,21,-1.2321234009986441,-0.6135117250274302,0.027656465139506543,1.2168068294386893,9583,9519,Taliaferro and Nearby Counties,Wilkes,13,317,Georgia,GA
13277,13CS063,391,373,408,450,59,42,77,69,-0.6125428333098867,-0.24207284859042696,0.15974972507427765,1.1447002978896923,484,462,505,545,61,40,83,79,-1.106625992300053,-0.5179177880735193,0.07976001198431869,1.2681051276904667,41232,41232,Tift+Worth,Tift,13,277,Georgia,GA
13321,13CS063,214,205,222,240,26,18,35,40,-1.072951571934414,-0.6614282687123332,-0.23044344578168394,1.4558696215591977,263,252,274,314,51,40,62,41,-0.01621655862458966,0.5938937288860983,1.1945348411550791,0.7875648784949753,20624,20578,Tift+Worth,Worth,13,321,Georgia,GA
13285,13CS064,600,570,630,789,189,159,219,100,0.8345880395358332,1.2777881369890909,1.7025710545199317,0.5262983070510742,737,701,773,941,204,168,240,161,0.12430445235141087,0.731391701333489,1.3851863122038137,0.7870954191440585,69520,69672,Troup,Troup,13,285,Georgia,GA
13297,13CS065,783,741,825,904,121,79,163,91,-0.11895949124817175,0.30446929808318807,0.7613772581975751,0.7469204819899117,983,931,1034,1239,256,205,308,213,-0.08756786770042928,0.5387593295417225,1.1574324083932495,0.8280890484651577,97080,99457,Walton,Walton,13,297,Georgia,GA
13009,13CS066,390,371,409,498,108,89,127,45,1.0200278679120323,1.4386628393037302,1.8475525464088516,0.4126736572470616,480,457,502,620,140,118,163,88,0.8047006925677888,1.4378853918528514,2.096046027323931,0.6223377378995317,43954,43780,Washington and Nearby Counties,Baldwin,13,9,Georgia,GA
13125,13CS066,32,32,33,38,6,5,6,10,-1.6455514357877825,-1.5488043162557024,-1.4485625529668036,1.5353263413901153,40,40,40,51,11,11,11,4,2.6806612365300553,2.8336254976551456,2.990222812312022,0.33659868607646604,2898,2914,Washington and Nearby Counties,Glascock,13,125,Georgia,GA
13163,13CS066,192,186,199,257,65,58,71,33,1.5789008391038093,2.0220314610479186,2.4598915143853803,0.5025571106468398,234,226,242,278,44,36,52,47,-0.8701480652635988,-0.24737690893934636,0.35035328978123176,1.0509639505568846,15598,15544,Washington and Nearby Counties,Jefferson,13,163,Georgia,GA
13167,13CS066,87,86,88,124,37,36,38,24,1.2913919294059553,1.3931097448375835,1.497951615016783,0.6338399238047158,106,105,107,142,36,35,37,25,1.258183105812479,1.4208534238583852,1.5681053184297304,0.6793028549658103,9248,9161,Washington and Nearby Counties,Johnson,13,167,Georgia,GA
13169,13CS066,219,207,232,263,44,31,56,18,0.4595659133169009,0.9071217630739987,1.3377373187994968,0.40419708604006227,272,257,286,384,112,98,127,60,1.643405890715799,2.2153834159474464,2.8097091217588126,0.5292644059290366,28409,28394,Washington and Nearby Counties,Jones,13,169,Georgia,GA
13303,13CS066,198,189,207,271,73,64,82,53,0.5447433312213344,0.9946663334831952,1.4448903817745031,0.7166736488796519,242,232,252,312,70,60,80,58,0.1099613891923802,0.749197934271631,1.3699858541372258,0.8141052458756266,19974,19806,Washington and Nearby Counties,Washington,13,303,Georgia,GA
13319,13CS066,102,101,103,130,28,27,29,13,1.565751279226885,1.6649424882740202,1.7579857419506189,0.4523634994403487,125,124,126,190,65,64,66,26,5.123697775336295,5.269494750041029,5.4136628703848,0.39528985700846414,8856,8833,Washington and Nearby Counties,Wilkinson,13,319,Georgia,GA
13175,13CS067,502,481,523,642,140,119,161,103,0.2939853455506683,0.7548989977811484,1.191646799985868,0.7291852723968418,617,592,643,809,192,166,217,116,1.2031102896856873,1.838060064909624,2.480148312532159,0.6024539471327061,49221,49540,Wheeler and Nearby Counties,Laurens,13,175,Georgia,GA
13209,13CS067,76,75,77,101,25,24,26,14,1.1332878847321015,1.2345438409038556,1.3342143163499407,0.5454416839078808,94,93,95,151,57,56,58,30,3.6329716057508996,3.788692431367071,3.9498428233674647,0.5148426386210737,8668,8642,Wheeler and Nearby Counties,Montgomery,13,209,Georgia,GA
13271,13CS067,116,110,121,192,76,71,82,33,2.877418069262921,3.3193107189432585,3.7652424487624927,0.4283433374958601,139,132,145,184,45,39,52,32,0.6417443416636281,1.2646715465677374,1.8817886818756502,0.6939984367039608,12945,12421,Wheeler and Nearby Counties,Telfair,13,271,Georgia,GA
13283,13CS067,63,62,63,93,30,30,31,13,2.575678901757811,2.6703851755865458,2.7719043805703403,0.4164792996308944,76,75,76,132,56,56,57,33,4.2807439304668335,4.430325266362297,4.593776166285208,0.5755437372612555,6450,6318,Wheeler and Nearby Counties,Treutlen,13,283,Georgia,GA
13309,13CS067,53,53,54,68,15,14,15,12,0.2418818948588788,0.3323702509234913,0.43426707390666086,0.7712696222458514,66,65,67,78,12,11,13,12,-0.11599394777436126,0.045508287143266386,0.18038490994054776,0.9035641657957172,7498,7465,Wheeler and Nearby Counties,Wheeler,13,309,Georgia,GA
13313,13CS068,733,689,778,916,183,138,227,138,0.024732078584106632,0.43504986178878624,0.8390414686735586,0.7517647272943795,905,852,958,1136,231,178,284,199,-0.27779329066961245,0.39421029408293445,1.0054331074313538,0.8566099923221927,102964,102830,Whitfield,Whitfield,13,313,Georgia,GA
15001,15CS001,1505,1418,1591,1531,26,-60,113,47,-0.5230944689289523,-0.07646552161158073,0.35403177393308294,1.7332011624369092,1865,1760,1969,2054,189,85,294,107,-0.14934956901308694,0.49747521734081823,1.0980597942965564,0.5620548492842674,201178,202591,Hawaii (county),Hawaii (county),15,1,Hawaii,HI
15003,15CS002,6754,6321,7188,6909,155,-279,588,275,-0.5644861961301627,-0.12859497614799478,0.31213256406723927,1.7656277904211224,8295,7778,8813,8764,469,-49,986,470,-0.6218821452919201,0.005193526820576751,0.6612392955243959,1.000777402613837,1006147,1002689,Honolulu,Honolulu,15,3,Hawaii,HI
15005,15CS003,1,1,1,1,0,0,0,1,-8.730034912642749,-8.30920837158839,-7.894516480091784,0.7637333655248306,1,1,1,3,2,2,2,3,-12.908422697736938,-12.334662204623694,-11.703149353594974,0.9504629123300607,83,82,Kalawao+Maui,Kalawao,15,5,Hawaii,HI
15009,15CS003,990,919,1061,1026,36,-35,107,16,-0.29924508583630915,0.12006864468506566,0.5551485736778431,0.43186879068317646,1222,1137,1307,1389,167,82,252,84,-0.012803105533426356,0.5966249791261117,1.2010297361651403,0.5006975667474998,165051,164284,Kalawao+Maui,Maui,15,9,Hawaii,HI
15007,15CS004,505,474,537,487,-18,-50,13,3,-0.7036626313836579,-0.286066972807717,0.15015034456084028,-0.17180074233351686,626,588,664,590,-36,-74,2,18,-1.508405086617076,-0.8927935108527272,-0.25959004351769316,-0.5139262715734797,73080,73417,Kauai,Kauai,15,7,Hawaii,HI
16001,16CS001,2881,2667,3095,3261,380,166,594,315,-0.27924142779250266,0.1318179231024953,0.6017966793118232,0.8268245725817144,3647,3383,3910,4152,505,242,769,451,-0.5174153115454132,0.11630239408029905,0.7344535071185908,0.8906529839423595,497088,509897,Ada,Ada,16,1,Idaho,ID
16005,16CS002,638,601,676,704,66,28,103,59,-0.3544678841275768,0.08203938849338725,0.4698574549625717,0.8830834631514777,794,749,840,939,145,99,190,126,-0.3908555769230636,0.24539107866099075,0.8803125922058459,0.8640123750436588,87384,88105,Bannock+Bear Lake+Caribou+Franklin,Bannock,16,5,Idaho,ID
16007,16CS002,53,52,54,69,16,15,17,6,1.4691679592451166,1.5732535826457186,1.6716277439536562,0.3530819325082967,67,66,68,79,12,11,13,11,0.03683525809570298,0.19406638768796558,0.3458776016949039,0.8407032020174884,6353,6519,Bannock+Bear Lake+Caribou+Franklin,Bear Lake,16,7,Idaho,ID
16029,16CS002,58,57,59,74,16,15,17,7,1.1641274317733339,1.259729874686157,1.361603207295854,0.4146535959406701,72,71,73,78,6,5,7,15,-1.6786315651787966,-1.5255156365156395,-1.3766918892175923,2.1554779801231545,7045,7097,Bannock+Bear Lake+Caribou+Franklin,Caribou,16,29,Idaho,ID
16041,16CS002,97,95,98,91,-6,-7,-4,5,-0.8586025007947988,-0.7514136653439575,-0.6505477556930503,-1.0407974276047638,122,120,124,134,12,10,14,16,-0.5059527188909743,-0.35775649557191325,-0.20472782703846346,1.264483654574076,14256,14608,Bannock+Bear Lake+Caribou+Franklin,Franklin,16,41,Idaho,ID
16009,16CS003,112,111,113,102,-10,-11,-9,4,-1.526314650256943,-1.4240988857278356,-1.3280582529346936,-0.46206516806455106,141,139,142,158,17,16,19,23,-0.8511770310114158,-0.6966872580390975,-0.5503717481127912,1.2595507840364895,9573,9879,Benewah+Latah+Nez Perce,Benewah,16,9,Idaho,ID
16057,16CS003,182,165,199,213,31,14,48,2,0.30902227061795157,0.7387826420383519,1.1596603033454365,0.06173952626452721,227,206,247,303,76,56,97,29,0.7924829866557653,1.4192204829370272,2.04540181703036,0.37492244872690794,39795,40211,Benewah+Latah+Nez Perce,Latah,16,57,Idaho,ID
16069,16CS003,443,425,461,463,20,2,38,37,-0.8222716949884024,-0.40770407894214583,-0.00784076597835832,1.7799645027832733,543,522,565,609,66,44,87,58,-0.4300622237591575,0.21495384296084072,0.8605604481463831,0.8721546356090505,41909,42401,Benewah+Latah+Nez Perce,Nez Perce,16,69,Idaho,ID
16011,16CS004,350,329,371,406,56,35,77,43,-0.16784271393189584,0.27805683567747325,0.6879299930204645,0.7555334292864815,438,413,463,504,66,41,91,75,-0.8529075196768434,-0.2084601311424571,0.3842116738388861,1.1190638473623513,47963,48758,Bingham+Oneida+Power,Bingham,16,11,Idaho,ID
16071,16CS004,38,38,38,39,1,1,1,4,-0.7643033560007548,-0.6642901680113864,-0.5704869813289916,2.031549600211653,47,47,48,63,16,15,16,6,2.3873072497125705,2.546260046609538,2.6894376021360973,0.358285783176297,4552,4603,Bingham+Oneida+Power,Oneida,16,71,Idaho,ID
16077,16CS004,55,55,56,63,8,7,8,3,0.4922088057251557,0.5892449410514701,0.6870660282664277,0.3480103429306187,69,68,70,88,19,18,20,12,0.9138862942752435,1.0619888974274188,1.215477180691761,0.5985110051737846,7851,7940,Bingham+Oneida+Power,Power,16,77,Idaho,ID
16015,16CS005,51,50,52,57,6,5,7,3,0.26688311487042354,0.3673054982549315,0.46182018893072335,0.43860155884079116,66,65,67,93,27,26,28,3,3.4812076645864276,3.6454796497303867,3.8032920257613054,0.10559579423481305,7731,8029,Boise+Gem+Payette+Washington,Boise,16,15,Idaho,ID
16045,16CS005,200,192,209,227,27,18,35,17,0.04867521447857965,0.4889361773885341,0.8716926469219741,0.6158161536779316,251,241,261,304,53,43,63,37,0.3706799447931197,0.9727348483701412,1.5980644618147726,0.6832188507290421,19156,19714,Boise+Gem+Payette+Washington,Gem,16,45,Idaho,ID
16075,16CS005,219,208,230,220,1,-10,12,25,-1.3420490827566658,-0.9573656140643134,-0.5183607724202721,13.523893542295983,276,262,289,338,62,49,76,47,0.04798816692982589,0.7023125415356161,1.261811849422739,0.74402278865608,25444,26239,Boise+Gem+Payette+Washington,Payette,16,75,Idaho,ID
16087,16CS005,107,106,108,138,31,30,32,13,1.5781024753946014,1.6833376140328042,1.7860603429107509,0.4101985347537739,136,134,137,163,27,26,29,28,-0.24896356131340683,-0.09091227877260369,0.05493668293209097,0.9955457220307815,10520,10846,Boise+Gem+Payette+Washington,Washington,16,87,Idaho,ID
16017,16CS006,417,396,437,414,-3,-23,18,18,-0.8545299680599221,-0.44573378329977004,-0.013715446943925385,-10.678331822365497,528,502,553,618,90,65,116,120,-1.3398085053282223,-0.7307528336463175,-0.14142126291540855,1.3138317661734784,47373,49185,Bonner+Boundary+Shoshone,Bonner,16,17,Idaho,ID
16021,16CS006,99,98,100,113,14,13,15,1,0.9693225731472257,1.0612465846417833,1.1640432473830988,0.06698122922809213,125,123,126,179,54,53,56,41,1.1256959993889886,1.2761782607677934,1.4324464836390474,0.7410303442953311,12193,12496,Bonner+Boundary+Shoshone,Boundary,16,21,Idaho,ID
16079,16CS006,167,161,172,158,-9,-14,-3,24,-2.8990161457343704,-2.47344926587253,-2.072220407650881,-3.1795611075730963,208,201,215,246,38,31,45,42,-0.9489001210410706,-0.33339412387438433,0.28382013428176484,1.069305461992096,13186,13550,Bonner+Boundary+Shoshone,Shoshone,16,79,Idaho,ID
16019,16CS007,835,781,888,942,107,54,161,111,-0.4520599537746739,-0.016994538348272407,0.39906577348128974,1.0238983171079339,1054,988,1120,1104,50,-16,116,115,-1.2395019411858879,-0.5945806752776753,0.034138337054785806,2.25672033323178,124191,127448,Bonneville,Bonneville,16,19,Idaho,ID
16027,16CS008,1425,1324,1526,1649,224,123,325,209,-0.3573006167782936,0.05505957888346893,0.5395540428808739,0.9289107417853832,1818,1693,1943,2131,313,188,438,334,-0.6912298269317582,-0.11465371820935469,0.5067093602870901,1.064221831299278,233441,241598,Canyon,Canyon,16,27,Idaho,ID
16003,16CS009,38,38,39,41,3,2,3,3,-0.1929076738555764,-0.08752334942164659,0.011930286214128236,0.8332437708440102,49,48,50,55,6,5,7,4,0.37767421608981433,0.535375795350781,0.6823916846763384,0.5664618522196115,4422,4596,Central Idaho,Adams,16,3,Idaho,ID
16035,16CS009,92,91,92,104,12,12,13,4,0.8676354514478456,0.9651976982253854,1.0726839169642233,0.296735580875512,113,112,115,132,19,17,20,16,0.1964025389696007,0.3462443229825755,0.496401411588236,0.818042134590163,8767,8874,Central Idaho,Clearwater,16,35,Idaho,ID
16037,16CS009,45,43,47,40,-5,-7,-3,2,-2.0459609723225043,-1.5632558633706604,-1.156666479453198,-0.5404215956480465,56,53,58,69,13,11,16,4,1.8890272830573325,2.516275650614795,3.139362571044507,0.28084815182496287,4284,4404,Central Idaho,Custer,16,37,Idaho,ID
16049,16CS009,168,161,176,181,13,5,20,16,-0.6610664371970778,-0.21255362448189624,0.21824233747831376,1.180687016452871,209,200,218,257,48,39,57,30,0.6640246264542882,1.278031080785174,1.8704201623720234,0.610033742122557,16620,16970,Central Idaho,Idaho (county),16,49,Idaho,ID
16059,16CS009,90,89,91,109,19,18,20,11,0.8897067366276467,0.9876310110266795,1.0876842218862766,0.552811316824588,112,111,113,148,36,35,37,13,3.206749980205443,3.352417491818913,3.506156358614896,0.35379577529954964,7988,8131,Central Idaho,Lemhi,16,59,Idaho,ID
16061,16CS009,37,36,39,47,10,8,11,8,0.0018812729853299715,0.45708854495344364,0.8637251516393882,0.750402160547552,47,45,49,67,20,18,22,12,2.0917682927156207,2.7008779463876533,3.312134565207003,0.5630464802531746,3596,3688,Central Idaho,Lewis,16,61,Idaho,ID
16085,16CS009,77,76,79,83,6,4,7,4,0.02397479521854634,0.12758963969867587,0.2302333055511759,0.6139809147155917,98,97,100,101,3,1,4,1,0.02653975593935472,0.18039625892833158,0.32844552040329905,0.26060677561578555,11822,12182,Central Idaho,Valley,16,85,Idaho,ID
16039,16CS010,194,181,206,209,15,3,28,11,-0.2702378713110975,0.1449728683456944,0.5483336903641661,0.6769761901423985,241,226,256,239,-2,-17,13,43,-2.503458810905152,-1.8833039347170035,-1.2827930317647442,-35.7033452498834,28496,28804,Elmore+Gooding+Owyhee,Elmore,16,39,Idaho,ID
16047,16CS010,120,119,122,169,49,47,50,20,1.753545116604135,1.8474501234549088,1.949185832642569,0.40100423567554955,149,147,151,170,21,19,23,26,-0.5175307923413496,-0.3692880244926836,-0.2135169301321592,1.175363577277867,15605,15753,Elmore+Gooding+Owyhee,Gooding,16,47,Idaho,ID
16073,16CS010,89,88,90,118,29,28,30,17,0.8981802602590643,1.0018262859384717,1.109365168818516,0.5659113389265167,112,110,113,140,28,27,30,19,0.7317139644031605,0.8853035685893065,1.034162158047698,0.6530734410573265,11993,12284,Elmore+Gooding+Owyhee,Owyhee,16,73,Idaho,ID
16023,16CS011,25,25,25,31,6,6,6,1,1.8534825777473538,1.9448647751605352,2.045664314002672,0.14189317834400264,31,31,32,45,14,13,14,4,4.284887001035794,4.442971734362875,4.584872490964098,0.27077655242281123,2591,2643,Jefferson and Nearby Counties,Butte,16,23,Idaho,ID
16033,16CS011,5,5,5,6,1,1,1,6,-6.645784409415764,-6.547862648265202,-6.439886903768282,3.3856327722001067,6,6,6,10,4,4,4,4,-0.7504764776636829,-0.5806120699878766,-0.4343731801313227,0.8672194174477335,799,792,Jefferson and Nearby Counties,Clark,16,33,Idaho,ID
16043,16CS011,95,94,96,111,16,15,17,13,0.10873796650118236,0.2199362030147548,0.31405162344329474,0.7690229769001545,119,117,120,164,45,44,47,5,3.410735079002726,3.5742246153162793,3.7170707401668466,0.1079250411571508,13380,13565,Jefferson and Nearby Counties,Fremont,16,43,Idaho,ID
16051,16CS011,163,150,176,176,13,-0,26,16,-0.4945654313544685,-0.10515472062337614,0.33115678337974536,1.1520781207424298,207,190,223,251,44,28,61,37,-0.32013516959393695,0.24298367406299745,0.9246521212323104,0.8182049073716896,31009,32035,Jefferson and Nearby Counties,Jefferson,16,51,Idaho,ID
16065,16CS011,174,152,196,164,-10,-32,12,15,-0.9060389572754874,-0.48887780076319814,-0.06333555783377293,-1.6657339005194507,225,197,253,234,9,-19,37,20,-0.8674290669306369,-0.2511022498532965,0.3624790592715605,2.007042448146201,51133,53734,Jefferson and Nearby Counties,Madison,16,65,Idaho,ID
16081,16CS011,45,44,46,37,-8,-9,-7,7,-1.342005385579045,-1.2422692052408761,-1.1408344641936472,-1.0440780418878237,57,56,59,70,13,11,14,7,0.401788652040316,0.5650958396140898,0.7182460710692207,0.5088266899409298,11840,12189,Jefferson and Nearby Counties,Teton,16,81,Idaho,ID
16055,16CS012,1381,1307,1455,1387,6,-68,80,115,-1.067974656405029,-0.6361794192867103,-0.2279391727971942,16.36239787181791,1757,1665,1849,2018,261,169,353,310,-0.9264422974943746,-0.32060125887306423,0.31149789232700925,1.1838060706777471,172371,178747,Kootenai,Kootenai,16,55,Idaho,ID
16013,16CS013,112,110,115,121,9,6,11,15,-0.35137592550610575,-0.2533017670296779,-0.15554568095698623,1.5181462533838272,142,139,145,156,14,11,17,11,-0.010665424545088863,0.13980085135331038,0.2716908854249899,0.7474001922467146,24181,24702,Lincoln and Nearby Counties,Blaine,16,13,Idaho,ID
16025,16CS013,10,10,11,12,2,1,2,0,0.9712480659622873,1.3956358388723775,1.8339881051379319,0,13,13,14,7,-6,-7,-6,7,-14.692390491295743,-14.102072902770534,-13.440855028497129,-1.3257575370855996,1094,1132,Lincoln and Nearby Counties,Camas,16,25,Idaho,ID
16031,16CS013,185,175,196,192,7,-4,17,18,-0.8778651183426884,-0.45367185569811813,-0.05114366921142545,2.36301998628141,232,219,245,234,2,-11,15,25,-1.7525132304254818,-1.112281393268701,-0.5091630482028697,9.784284657997029,24653,25096,Lincoln and Nearby Counties,Cassia,16,31,Idaho,ID
16053,16CS013,154,143,164,158,4,-6,15,17,-0.9470549814769462,-0.5203300278979869,-0.0534471542563213,3.0948714689962085,193,180,205,243,50,38,63,39,-0.08164281790766882,0.5458159451657745,1.1716961138749256,0.7613213671914658,24306,24598,Lincoln and Nearby Counties,Jerome,16,53,Idaho,ID
16063,16CS013,33,33,34,39,6,5,6,4,0.20500042585230688,0.3110948317831014,0.4118040185008846,0.6073344228291244,42,41,43,38,-4,-5,-3,2,-1.5003455266294579,-1.347870780258463,-1.205082486342436,-0.6821065190299438,5177,5260,Lincoln and Nearby Counties,Lincoln,16,63,Idaho,ID
16067,16CS013,175,166,185,178,3,-7,12,23,-1.3733148919043217,-0.9303464653486594,-0.5189349616637933,6.258860120655911,219,207,230,228,9,-2,21,29,-1.6517904743721048,-1.0587154660053815,-0.5306276385997309,2.8009140297078097,21592,21914,Lincoln and Nearby Counties,Minidoka,16,67,Idaho,ID
16083,16CS014,693,655,732,838,145,106,183,98,0.07401180014509669,0.5089497751162549,0.9632954349205496,0.6730705111511187,868,820,915,986,118,71,166,130,-0.7794957260417262,-0.15289355048687145,0.429236108361708,1.0909375733754376,90024,91957,Twin Falls,Twin Falls,16,83,Idaho,ID
17001,17CS001,681,653,710,745,64,35,92,71,-0.5374622623897627,-0.1225754634286815,0.33118314159089784,1.0989180403441485,828,794,861,936,108,75,142,103,-0.5347921723075312,0.08326887624242063,0.7083711432093536,0.9419197593185712,65451,65038,Adams,Adams,17,1,Illinois,IL
17005,17CS002,151,143,158,165,14,7,22,11,-0.1867480493710549,0.21830240096616707,0.6407378062160187,0.7133429414826626,183,174,192,219,36,27,45,28,-0.06999816777167567,0.5782476328919186,1.1943270981020206,0.7581371548035172,16626,16606,Bond+Effingham+Fayette,Bond,17,5,Illinois,IL
17049,17CS002,308,294,323,379,71,56,85,44,0.3479666691390034,0.7657674153583184,1.1872398154147101,0.6143144670236765,375,357,392,430,55,38,73,53,-0.5201926265524365,0.07638259626390194,0.6630586281581624,0.9415131319849716,34521,34457,Bond+Effingham+Fayette,Effingham,17,49,Illinois,IL
17051,17CS002,192,182,201,226,34,25,44,34,-0.39561374209751177,0.0070885912331039285,0.427834909998408,0.963380327102095,233,222,244,244,11,-0,22,30,-1.6742121767674585,-1.0874229398076374,-0.42148994758003794,2.513679195118272,21433,21395,Bond+Effingham+Fayette,Fayette,17,51,Illinois,IL
17007,17CS003,359,336,382,401,42,19,65,57,-0.7030929825254483,-0.2925082212919962,0.17374340575267036,1.327571231990051,442,415,470,501,59,31,86,37,-0.137050643624625,0.4947825088512315,1.0828847031469682,0.6202227303151212,53302,53183,Boone,Boone,17,7,Illinois,IL
17009,17CS004,47,46,48,60,13,12,14,2,1.623315344624687,1.7314958491268,1.8291836460080324,0.14402430213824774,59,58,60,67,8,7,9,8,-0.11677385440323992,0.02851109535152907,0.18506514423260026,0.8717290835819724,6297,6391,Brown and Nearby Counties,Brown,17,9,Illinois,IL
17013,17CS004,41,41,42,59,18,17,18,5,2.773394930938029,2.8748539842143055,2.9702539599418527,0.26588357860740575,50,49,50,68,18,18,19,2,4.331283047275194,4.47862140620768,4.634219422531828,0.10342935470152069,4455,4375,Brown and Nearby Counties,Calhoun,17,13,Illinois,IL
17017,17CS004,125,124,127,140,15,13,16,27,-1.0601551859450882,-0.9568402676904065,-0.8581106942185324,1.7154583892579114,153,152,155,149,-4,-6,-3,16,-2.0604790661911845,-1.9166825146140285,-1.7706860018370534,-4.626640535307261,12818,12800,Brown and Nearby Counties,Cass,17,17,Illinois,IL
17149,17CS004,171,164,177,217,46,40,53,39,0.07674975286430458,0.5072878059840866,0.9313488739917837,0.8237757739832935,208,200,215,236,28,21,36,32,-0.8845346498233292,-0.32241652891417166,0.32816242150617764,1.0922732728283309,14769,14620,Brown and Nearby Counties,Pike,17,149,Illinois,IL
17169,17CS004,78,78,79,80,2,1,2,4,-0.42480197412162324,-0.32104157509635184,-0.22175911783687569,1.437672675601564,96,95,96,108,12,12,13,3,1.4987490972069928,1.6490413775535484,1.7882681627519286,0.22395084504402413,6865,6848,Brown and Nearby Counties,Schuyler,17,169,Illinois,IL
17171,17CS004,50,50,51,59,9,8,9,4,0.84808777358013,0.9437615633425026,1.0438447744529826,0.4140083543668475,61,60,61,69,8,8,9,6,0.392785782610714,0.5430137662412085,0.7072007121123586,0.651729723403241,4924,4849,Brown and Nearby Counties,Scott,17,171,Illinois,IL
17011,17CS005,345,330,359,417,72,58,87,57,0.013882071897022676,0.4602418153624481,0.8775733219978549,0.7775301431835263,420,403,437,447,27,10,44,51,-1.4487778897374706,-0.8736582228113741,-0.29381593775891635,1.844775983056555,33021,32917,Bureau+Marshall+Putnam+Stark,Bureau,17,11,Illinois,IL
17123,17CS005,148,143,153,148,0,-5,5,6,-0.9206792429629097,-0.5032627946653591,-0.12846619091852693,5.2480751628697275,180,174,186,184,4,-2,10,17,-1.9311625388232259,-1.3588494721314481,-0.7683389045820995,3.6659541327853225,11655,11667,Bureau+Marshall+Putnam+Stark,Marshall,17,123,Illinois,IL
17155,17CS005,49,48,50,42,-7,-8,-6,6,-2.4202254985997946,-2.315879455967856,-2.215721314239371,-0.9889290964096425,59,59,60,71,12,11,12,8,0.6224174483034635,0.7757277049487771,0.921204594805628,0.6356112558107144,5644,5576,Bureau+Marshall+Putnam+Stark,Putnam,17,155,Illinois,IL
17175,17CS005,63,63,64,77,14,13,14,12,0.21331260634104718,0.313103717380328,0.41679616140962783,0.817999370368265,77,76,77,97,20,20,21,4,3.5627867828155524,3.7093716141783326,3.864912820859044,0.18673140698628807,5369,5308,Bureau+Marshall+Putnam+Stark,Stark,17,175,Illinois,IL
17015,17CS006,171,164,178,216,45,38,52,26,0.794309529797313,1.2268620372702612,1.6572660831983717,0.5647654946204044,210,202,218,214,4,-4,12,13,-1.306040361538735,-0.7030024941531874,-0.08875250860605181,2.6501200212369067,15474,15693,Carroll+Jo Daviess+Stephenson,Carroll,17,15,Illinois,IL
17085,17CS006,207,198,216,247,40,31,49,23,0.34991550561945206,0.7633327137702071,1.2197282047673976,0.5604454013889985,253,241,264,259,6,-5,18,18,-1.2672382771076662,-0.6314226321538895,-0.029522521942235064,2.475289460186042,21907,21953,Carroll+Jo Daviess+Stephenson,Jo Daviess,17,85,Illinois,IL
17177,17CS006,462,443,481,573,111,92,130,64,0.6394144923280103,1.0686385512730128,1.478605340944088,0.5721772501817065,560,537,582,653,93,71,116,93,-0.6364529391926005,-0.01020593108635749,0.6616669947582218,0.9843438606764738,44399,44085,Carroll+Jo Daviess+Stephenson,Stephenson,17,177,Illinois,IL
17019,17CS007,1126,1037,1214,1277,151,63,240,66,-0.03873682049043487,0.42194976741808266,0.8335690184221404,0.43348138998859065,1399,1293,1505,1643,244,138,350,128,0.021255087298962843,0.6696141950337906,1.395311066306249,0.5222781383748174,206123,205874,Champaign,Champaign,17,19,Illinois,IL
17021,17CS008,371,357,386,418,47,32,61,61,-0.8678907818462287,-0.41859547227128685,0.021950054574814977,1.281750844978704,453,436,471,501,48,30,65,40,-0.3828745714640026,0.2797422975201878,0.8988338930278679,0.8205156086760885,33660,33697,Christian+Shelby,Christian,17,21,Illinois,IL
17173,17CS008,201,192,210,234,33,24,42,30,-0.2784369564502419,0.14696454810454881,0.5745124554425342,0.8784976277294863,244,234,255,321,77,66,87,48,1.0787323835922435,1.6401647559582522,2.226763634542181,0.6188386086692101,20994,20805,Christian+Shelby,Shelby,17,173,Illinois,IL
17023,17CS009,163,157,170,191,28,21,34,18,0.20815568825894584,0.6532940408843276,1.0700442945751245,0.6233055855523342,197,189,205,234,37,29,45,30,-0.01167909910566876,0.5855553350708974,1.211669786937162,0.7825619081316271,15404,15316,Clark+Crawford+Cumberland+Jasper,Clark,17,23,Illinois,IL
17033,17CS009,186,178,194,195,9,1,17,29,-1.4860702112720137,-1.0614397934539341,-0.6184387170664225,2.841854083964217,225,216,235,240,15,5,24,27,-1.4538100741390538,-0.8293048412140314,-0.20152729824013305,1.738601138953854,18648,18656,Clark+Crawford+Cumberland+Jasper,Crawford,17,33,Illinois,IL
17035,17CS009,94,93,95,103,9,8,10,20,-1.1851918009707203,-1.081387431261335,-0.9782956883033996,2.064214718214047,114,113,115,157,43,42,44,19,2.6097693046735397,2.7637352668256874,2.907992900541083,0.43326453131628223,10464,10357,Clark+Crawford+Cumberland+Jasper,Cumberland,17,35,Illinois,IL
17079,17CS009,82,81,83,87,5,4,6,13,-0.969863375038046,-0.8700223853619012,-0.766140904867447,2.190976058113598,99,98,101,124,25,23,26,13,1.3690766489114927,1.5206672867845632,1.6801867033860163,0.5066308874073803,9295,9201,Clark+Crawford+Cumberland+Jasper,Jasper,17,79,Illinois,IL
17025,17CS010,157,151,163,176,19,13,25,29,-1.1521565750987712,-0.7581628681186837,-0.3080130633934489,1.447612357603917,190,184,197,182,-8,-15,-2,19,-3.123067268667457,-2.5169021831273928,-1.9242689344680552,-2.538321804166961,13241,13161,Clay+Hamilton+Wayne+White,Clay,17,25,Illinois,IL
17065,17CS010,86,85,87,107,21,20,22,11,1.1419508101384153,1.2357441980097252,1.3282303868672094,0.50258629017232,105,104,106,103,-2,-3,-1,18,-3.1395670767721464,-2.99841851814408,-2.8389425679426665,-24.090650628845616,7993,7921,Clay+Hamilton+Wayne+White,Hamilton,17,65,Illinois,IL
17191,17CS010,172,165,179,215,43,36,50,32,0.23859294347175558,0.6691025087217618,1.093234045956191,0.7330409684741815,209,201,218,242,33,24,41,29,-0.32276894460243716,0.28012835031107713,0.8833592992468009,0.8596613396584508,16115,15986,Clay+Hamilton+Wayne+White,Wayne,17,191,Illinois,IL
17193,17CS010,192,186,198,215,23,17,29,31,-1.0300859729073728,-0.6147697779610704,-0.19082687653989944,1.3142804978665794,234,227,242,253,19,11,26,22,-0.9197982079715271,-0.2944567417775896,0.3634332523897305,1.121526285324643,13771,13788,Clay+Hamilton+Wayne+White,White,17,193,Illinois,IL
17027,17CS011,292,276,308,347,55,39,71,41,-0.04910870353135456,0.37748078640850613,0.7859217146194329,0.7333891723121005,355,336,374,364,9,-10,28,35,-1.4937816037580187,-0.8751479209629757,-0.24182873904822497,3.5543085981597655,36965,36808,Clinton+Marion,Clinton,17,27,Illinois,IL
17121,17CS011,439,423,456,567,128,111,144,51,1.6269642287453718,2.0389010892496735,2.465717695887269,0.3964405281194525,531,512,551,593,62,42,81,67,-0.7943876259475471,-0.17136751140222273,0.46644995130060085,1.0670186003654551,37545,37423,Clinton+Marion,Marion,17,121,Illinois,IL
17029,17CS012,401,381,421,524,123,103,143,50,1.1341571909655268,1.5542086710373255,1.9877436149176086,0.40281480782749934,488,464,512,597,109,85,133,64,0.5860611152061825,1.1536557822199323,1.741538593143268,0.5802039830720026,47329,46761,Coles,Coles,17,29,Illinois,IL
17031,17CS013,34998,32744,37252,44691,9693,7439,11947,7636,-0.03171971205639121,0.4016256749893696,0.8482803796605018,0.7876936082587671,42715,40037,45392,47065,4350,1673,7028,4196,-0.6029937919548551,0.05949474935307153,0.6591904652726117,0.9643075499625289,5236285,5186212,Cook,Cook,17,31,Illinois,IL
17037,17CS014,602,559,646,753,151,107,194,56,0.5178522547765512,0.9360671124749147,1.3818652546672558,0.3696035194116799,744,692,796,892,148,96,200,69,0.33333017016993244,0.931925779615778,1.5566250339976677,0.46321552524667614,100966,100388,DeKalb,DeKalb,17,37,Illinois,IL
17039,17CS015,171,164,177,205,34,28,41,21,0.4606973451188873,0.867975105545447,1.316680483816246,0.5934620457419933,208,200,216,230,22,14,30,21,-0.5133735507653127,0.09866367736800459,0.6891115728190398,0.9071496533206378,15457,15356,De Witt+Logan+Mason+Menard,De Witt,17,39,Illinois,IL
17107,17CS015,291,278,303,351,60,48,73,47,0.0634388794780332,0.48491301678365406,0.8802638291405972,0.7643896821751821,357,342,371,332,-25,-39,-10,30,-2.9294300853755666,-2.3356457443500576,-1.748495204988195,-1.2698980625529097,28001,27976,De Witt+Logan+Mason+Menard,Logan,17,107,Illinois,IL
17125,17CS015,156,150,161,193,37,32,43,33,-0.08701481392320828,0.35621754668928707,0.7762947773937322,0.8587031871713374,188,182,195,222,34,27,40,20,0.6606839127171354,1.2604700543648242,1.8733888122101297,0.5770032377185758,13064,12902,De Witt+Logan+Mason+Menard,Mason,17,125,Illinois,IL
17129,17CS015,106,105,108,111,5,3,6,12,-0.7123776929146695,-0.6024405648149549,-0.5092511331436376,2.1547622742080197,130,129,132,162,32,30,33,14,1.605358299861717,1.7463823112698618,1.898108908766935,0.42749671721817395,12245,12179,De Witt+Logan+Mason+Menard,Menard,17,129,Illinois,IL
17041,17CS016,169,161,178,200,31,22,39,29,-0.32411039635162564,0.09242043531849929,0.5281305915827913,0.9127922851319721,208,198,218,247,39,29,49,17,0.7292916279608318,1.3473419825479496,1.9973293228527054,0.4218427718706226,19697,19725,Douglas+Edgar+Moultrie+Piatt,Douglas,17,41,Illinois,IL
17045,17CS016,193,186,201,242,49,41,56,36,0.3512136491560271,0.7535538877404808,1.184837471211918,0.7266429096182876,233,225,242,278,45,36,53,42,-0.40778397081798623,0.20139647174255348,0.8670616829527471,0.9150297613448413,16791,16554,Douglas+Edgar+Moultrie+Piatt,Edgar,17,45,Illinois,IL
17139,17CS016,165,159,172,183,18,11,24,20,-0.5944570879101072,-0.20930749934935733,0.2244004510922713,1.0801345575144863,202,195,210,216,14,6,21,19,-1.0835292836421986,-0.4257588839638119,0.12357004718001019,1.2807891221563772,14485,14506,Douglas+Edgar+Moultrie+Piatt,Moultrie,17,139,Illinois,IL
17147,17CS016,152,144,159,162,10,3,18,2,0.07636179048289958,0.5052963854821964,0.9392168947298446,0.1739933129927624,187,178,195,210,23,15,32,10,0.3407999633819273,0.9551754485153362,1.565834530913531,0.41091051647014687,16626,16739,Douglas+Edgar+Moultrie+Piatt,Piatt,17,147,Illinois,IL
17043,17CS017,5387,4987,5787,6490,1103,703,1503,821,-0.12820612900024547,0.30666918871144166,0.7356215118039304,0.7435192392616844,6647,6169,7125,6991,344,-134,822,393,-0.6944773982894632,-0.06472345778932234,0.5363420573788751,1.138501413476688,929276,925799,DuPage,DuPage,17,43,Illinois,IL
17047,17CS018,61,60,61,81,20,20,21,10,1.5698229442098621,1.6710516067010859,1.7722208236509143,0.4671281892903012,73,72,73,90,17,17,18,18,-0.2625721487752917,-0.11577151465133517,0.02119128463362328,0.9782715060468364,6221,6094,Edwards+Lawrence+Richland+Wabash,Edwards,17,47,Illinois,IL
17101,17CS018,163,156,170,180,17,10,24,30,-1.2738997767893359,-0.8615944493078215,-0.41601395523234547,1.663201744335399,196,188,204,197,1,-7,9,20,-2.1418755494581214,-1.5083370809943728,-0.8870777218046759,11.135086415414749,15288,15164,Edwards+Lawrence+Richland+Wabash,Lawrence,17,101,Illinois,IL
17159,17CS018,174,167,181,222,48,41,55,29,0.7753904437501,1.1882617071889072,1.6694536863153207,0.59291605857543,211,203,219,265,54,46,62,41,0.37038296322838515,0.9785517987277147,1.6049400871695134,0.7470305733203444,15761,15797,Edwards+Lawrence+Richland+Wabash,Richland,17,159,Illinois,IL
17185,17CS018,123,118,128,139,16,11,21,15,-0.3622353773835308,0.07064678399646378,0.5324928011726576,0.8937497733086767,148,142,154,161,13,7,19,15,-0.8520463719017148,-0.2186549855390774,0.38403709018884635,1.080116813261199,11312,11219,Edwards+Lawrence+Richland+Wabash,Wabash,17,185,Illinois,IL
17053,17CS019,173,167,178,203,30,25,36,24,0.07897343620462412,0.4696021373948361,0.9009239339450114,0.7648462317872716,211,204,218,237,26,19,33,20,-0.10507055236331983,0.5796962661119611,1.1359205412387368,0.7324593734798257,13449,13514,Ford+Iroquois+Livingston,Ford,17,53,Illinois,IL
17075,17CS019,319,307,331,381,62,50,74,44,0.23800092761506533,0.6654214649327133,1.1364657770119548,0.6974898590281087,387,373,401,418,31,17,45,43,-1.1778905827129442,-0.5375675604311098,0.07954711048673344,1.3455873199726935,26984,26850,Ford+Iroquois+Livingston,Iroquois,17,75,Illinois,IL
17105,17CS019,375,359,390,420,45,30,61,54,-0.6881200109784996,-0.24502934508512736,0.17374772725725776,1.1685942406303336,457,439,476,482,25,6,43,64,-1.9827611099163434,-1.3424578236024434,-0.7242264372349894,2.48479537249604,35714,35677,Ford+Iroquois+Livingston,Livingston,17,105,Illinois,IL
17055,17CS020,428,412,444,518,90,74,106,60,0.3876496035285462,0.793914227302159,1.2268271308247467,0.6584644445832056,519,500,539,643,124,104,143,88,0.5318326816329739,1.1554301110574927,1.761546712136615,0.7058445339156268,37746,37470,Franklin+Gallatin+Saline,Franklin,17,55,Illinois,IL
17059,17CS020,63,63,64,68,5,4,5,1,0.6832242156949512,0.7920776481613154,0.8920033049844216,0.1694245047118611,77,76,78,91,14,13,15,1,3.003317139621862,3.153803353373241,3.3125468187911253,0.06708928426336107,4926,4909,Franklin+Gallatin+Saline,Gallatin,17,59,Illinois,IL
17165,17CS020,309,299,320,330,21,10,31,41,-1.2925602177480846,-0.8575620142215162,-0.4488432327005414,1.9050870497821386,373,361,385,423,50,38,62,53,-0.8029007048696208,-0.17373567614207847,0.4221393791119957,1.0478838110188373,23588,23366,Franklin+Gallatin+Saline,Saline,17,165,Illinois,IL
17057,17CS021,390,376,404,450,60,46,74,31,0.45100501122671266,0.862806562445089,1.3223616132596054,0.5087918355849944,474,457,491,515,41,24,58,55,-1.1037697155717294,-0.5039754363586002,0.1746603301700741,1.3091508298047496,33531,33232,Fulton+McDonough,Fulton,17,57,Illinois,IL
17109,17CS021,248,236,260,318,70,58,82,31,0.9744933267588434,1.4307875051897518,1.8599332773237212,0.4360299505639879,301,287,314,323,22,9,36,32,-1.0720441557612386,-0.42839090482349906,0.14464357950040052,1.3622033900231443,27448,26865,Fulton+McDonough,McDonough,17,109,Illinois,IL
17061,17CS022,136,131,141,163,27,22,32,26,-0.36549210946142047,0.07450143516231594,0.5241091705549529,0.9310929161458912,165,159,171,181,16,10,22,19,-0.943960014343557,-0.3051701502564246,0.29492255212743235,1.1220266472100386,12054,11854,Greene+Jersey+Morgan,Greene,17,61,Illinois,IL
17083,17CS022,233,224,242,271,38,29,47,36,-0.32928525975599787,0.0960388334859579,0.49495377781446576,0.9250486648449109,285,274,296,317,32,21,43,29,-0.4557731588859467,0.19164075988048962,0.7748022022232298,0.8782581698774943,21465,21349,Greene+Jersey+Morgan,Jersey,17,83,Illinois,IL
17137,17CS022,339,325,353,414,75,61,89,54,0.22947151367847102,0.6417227991370904,1.0573088982095054,0.7103905531218602,414,397,431,437,23,6,40,31,-0.9182752083597006,-0.3150736212774301,0.3100631021362269,1.3016777841486429,32906,32634,Greene+Jersey+Morgan,Morgan,17,137,Illinois,IL
17063,17CS023,369,347,392,466,97,74,119,44,0.5815576520139568,1.0097931430862006,1.4128362059073218,0.4495861253880081,460,433,487,527,67,40,94,55,-0.4061281266131237,0.26291641422694284,0.9056523534557657,0.8076043165152104,52347,52920,Grundy,Grundy,17,63,Illinois,IL
17067,17CS024,176,169,184,235,59,51,66,32,1.0670878150071743,1.5128896019155844,1.9763317009068173,0.5372601626389731,216,207,225,238,22,13,31,24,-0.76447310010124,-0.1231999577295689,0.49551560550780277,1.0383031106019123,17558,17422,Hancock+Henderson+Mercer+Warren,Hancock,17,67,Illinois,IL
17071,17CS024,70,69,70,95,25,25,26,15,1.5055874657673467,1.6110791945074063,1.7063289854499426,0.57076778454033394,85,84,86,109,24,23,25,10,2.548284700743162,2.7017434047695135,2.8595744457337076,0.396332191466019,6390,6316,Hancock+Henderson+Mercer+Warren,Henderson,17,71,Illinois,IL
17131,17CS024,173,166,180,192,19,12,26,16,-0.2604110107991669,0.18768913533030865,0.6250912276036615,0.8071224292994232,213,204,221,206,-7,-15,2,16,-2.353746974523901,-1.71005785240194,-1.1160646331576878,-2.8956779090268605,15607,15589,Hancock+Henderson+Mercer+Warren,Mercer,17,131,Illinois,IL
17187,17CS024,163,156,170,218,55,48,62,31,0.9813395192565125,1.4253809612318333,1.871536318257312,0.5557292046156697,199,191,208,215,16,7,24,28,-1.4949072076647247,-0.8849099016266021,-0.21395271786744868,1.6573256136508003,16757,16567,Hancock+Henderson+Mercer+Warren,Warren,17,187,Illinois,IL
17073,17CS025,454,433,475,583,129,108,150,64,0.9357459760162776,1.3270418097082288,1.7646196002564023,0.4924541907724881,553,528,578,601,48,23,73,41,-0.4616993986937254,0.1511796599966374,0.78762358673603,0.840346324166981,49084,48941,Henry,Henry,17,73,Illinois,IL
17077,17CS026,382,359,405,535,153,130,176,68,1.1231919893248818,1.5834825641742816,1.9888858132167744,0.44058001155975235,466,439,493,611,145,118,172,64,1.240685776795213,1.8382237527893874,2.456474204796686,0.4393551139730831,53437,52613,Jackson,Jackson,17,77,Illinois,IL
17081,17CS027,373,357,388,486,113,98,129,65,0.8747437618491641,1.307347339859105,1.7222105401123546,0.5679133738511868,454,435,473,549,95,76,114,67,0.2990644350180749,0.9172906604307092,1.5404132798327306,0.6990890880825387,37102,36899,Jefferson+Washington,Jefferson,17,81,Illinois,IL
17189,17CS027,138,132,144,149,11,5,17,17,-0.8521060601409475,-0.4133449393121199,0.03702054967696464,1.3718893992520818,168,161,175,167,-1,-8,6,21,-2.5396825702706045,-1.9049403937501483,-1.3319571423927559,93.33568499506391,13737,13663,Jefferson+Washington,Washington,17,189,Illinois,IL
17089,17CS028,2735,2512,2957,3584,849,627,1072,513,0.21300134507901824,0.6606587040213804,1.0831233552403507,0.6033518020097696,3387,3121,3653,3905,518,252,784,326,-0.20705314662784888,0.435259909032092,1.0340505206783963,0.6281099623576736,518449,515671,Kane,Kane,17,89,Illinois,IL
17091,17CS029,955,909,1001,1149,194,148,240,124,0.22918194652640952,0.6438047898271325,1.1006028146897615,0.635375678271756,1163,1108,1218,1378,215,160,270,132,0.31955039089908327,0.929815945383979,1.5413656512379639,0.6122618871599252,107510,106694,Kankakee,Kankakee,17,91,Illinois,IL
17093,17CS030,532,476,589,630,98,41,154,74,-0.2962224902853797,0.17923487970421143,0.5885997230978216,0.750913612915564,679,609,748,781,102,33,172,61,-0.20922480906197494,0.3644946707212753,0.9788639918637867,0.5895422161457585,132065,134491,Kendall,Kendall,17,93,Illinois,IL
17095,17CS031,570,549,591,694,124,103,145,106,-0.08653409423277166,0.3646858721018852,0.7943364526078174,0.8482758066889597,691,666,717,729,38,12,63,73,-1.4594011398597004,-0.8466153532421659,-0.23111957661800145,1.8786709316982544,49677,49336,Knox,Knox,17,95,Illinois,IL
17097,17CS032,4052,3746,4358,4865,813,507,1119,699,-0.2615768428389322,0.155766104431114,0.5821823547453259,0.8585686906733653,5026,4659,5394,5213,187,-181,554,373,-0.9248529226634578,-0.3315790983253106,0.2945676961328143,1.9871297363659515,710666,711527,Lake,Lake,17,97,Illinois,IL
17099,17CS033,1121,1074,1168,1295,174,127,221,180,-0.4788917325844091,-0.04979604227234568,0.39222269567921536,1.02938087617977,1368,1311,1424,1434,66,10,123,129,-1.2919506923353943,-0.6950732388637124,-0.08106979006799246,1.9161948937713207,109195,109022,La Salle,La Salle,17,99,Illinois,IL
17103,17CS034,323,308,337,387,64,50,79,64,-0.4286525171440283,0.012285920370848448,0.4490914559954282,0.977134125274759,397,379,414,420,23,6,41,39,-1.17607061966793,-0.5494733798923335,0.05347324107484471,1.593276393238586,34030,34045,Lee+Whiteside,Lee,17,103,Illinois,IL
17195,17CS034,573,549,597,706,133,109,157,148,-0.6849784240203269,-0.299232486833367,0.1578199358874136,1.105357231941252,701,673,730,757,56,27,84,79,-1.111473879231912,-0.514433156972558,0.08136978325460911,1.395140039938531,55445,55335,Lee+Whiteside,Whiteside,17,195,Illinois,IL
17111,17CS035,1837,1704,1970,2165,328,195,461,234,-0.10889739037739989,0.2909829645269715,0.7242091881409924,0.7114432791634472,2284,2123,2444,2536,252,92,413,183,-0.32643441714346594,0.2773066590301951,0.9117079826885497,0.7223758264711522,309571,310925,McHenry,McHenry,17,111,Illinois,IL
17113,17CS036,1025,952,1099,1220,195,121,268,110,0.04688053832118312,0.4879405304751036,0.9455663634812358,0.5614282994404427,1270,1181,1358,1411,141,53,230,145,-0.6637127939171213,-0.03817800273684071,0.5680884640963709,1.0189760787229296,170931,170886,McLean,McLean,17,113,Illinois,IL
17115,17CS037,1044,1000,1089,1242,198,153,242,142,0.13504535373614937,0.523738873613725,0.952488987571204,0.7147323064860455,1268,1215,1321,1433,165,112,218,136,-0.2792061763372788,0.36467764471069586,0.9426436471642776,0.8188980919290355,103574,102609,Macon,Macon,17,115,Illinois,IL
17117,17CS038,470,451,489,568,98,79,117,66,0.2736616066772298,0.6903319854242279,1.1497834273345162,0.6675356641173016,570,547,593,646,76,53,99,70,-0.5120769822702487,0.17972419651881316,0.7753065069734681,0.9130731815620567,44807,44465,Macoupin+Montgomery,Macoupin,17,117,Illinois,IL
17135,17CS038,300,288,312,360,60,48,72,29,0.6322503101304446,1.1052250798539496,1.5055391558706703,0.4769055908766202,366,351,380,459,93,79,108,69,0.39917899665689505,1.0650328924247217,1.6468110959219133,0.7317001500774135,28185,28095,Macoupin+Montgomery,Montgomery,17,135,Illinois,IL
17119,17CS039,2468,2354,2582,2909,441,327,555,294,0.14283800033988145,0.5615108121092881,0.9706340423255391,0.6656726992912834,3022,2885,3159,3374,352,215,489,319,-0.5104793379895951,0.12441361342078187,0.7962832518990408,0.9036435408277032,265118,264637,Madison,Madison,17,119,Illinois,IL
17133,17CS040,264,249,279,302,38,23,53,45,-0.6473144258752985,-0.20557755802404362,0.22776544849635436,1.1510093604696339,326,308,344,358,32,14,50,35,-0.7079503514370303,-0.11201948290888517,0.46670639366112493,1.0650764224220381,34878,34927,Monroe+St. Clair,Monroe,17,133,Illinois,IL
17163,17CS040,2176,2065,2286,2685,509,399,620,324,0.29596277060682386,0.7200470523200277,1.1513537170822488,0.6347415804933172,2660,2528,2792,3066,406,274,538,295,-0.14932149001292888,0.5157841509631782,1.1395232794788064,0.7246274712852027,257033,255087,Monroe+St. Clair,St. Clair,17,163,Illinois,IL
17141,17CS041,449,427,471,518,69,47,91,52,-0.07915419202878017,0.3492663776037418,0.771806810294049,0.7409791985794877,550,524,577,592,42,15,68,49,-0.8297794158526235,-0.1581388955328368,0.4079376445591685,1.1482039409692164,51506,51482,Ogle,Ogle,17,141,Illinois,IL
17143,17CS042,1539,1461,1617,1770,231,153,309,146,0.05288356750760105,0.470466170787461,0.886694477436618,0.628710652025025,1872,1779,1964,2148,276,184,369,211,-0.1445452478203661,0.46825682718284,1.0054036799828872,0.7607028965451113,180766,179693,Peoria+Woodford,Peoria,17,143,Illinois,IL
17203,17CS042,326,310,343,383,57,40,73,46,-0.12895192782036055,0.2888752973287765,0.6790655746094458,0.7982057966061313,398,378,418,421,23,3,43,58,-1.7156248225397228,-1.099745132437264,-0.5153549211306119,2.440271197535985,38371,38250,Peoria+Woodford,Woodford,17,203,Illinois,IL
17145,17CS043,197,188,206,232,35,26,44,29,-0.1760465594877179,0.2751220198425168,0.7307255122027079,0.8147284414549835,242,231,253,301,59,48,70,40,0.5123663045769228,1.086488040653567,1.72442791691559,0.6639736982927713,20899,20970,Perry+Randolph,Perry,17,145,Illinois,IL
17157,17CS043,295,282,308,362,67,54,80,51,0.10565084037649622,0.5137124409517821,0.9521687641900951,0.7526282571255563,359,344,375,444,85,69,100,50,0.7750867326422466,1.3755747692966886,2.072070588037219,0.5826927945239523,30308,30129,Perry+Randolph,Randolph,17,157,Illinois,IL
17161,17CS044,1363,1301,1425,1652,289,227,351,192,0.24153804808244272,0.6935122211440732,1.1225447510605964,0.6624882749274007,1661,1587,1735,1776,115,41,189,160,-0.9783623373388645,-0.35741421105889565,0.22408617292034194,1.3825848753545489,143762,143107,Rock Island,Rock Island,17,161,Illinois,IL
17167,17CS045,1682,1598,1766,1899,217,133,301,190,-0.29146182027742107,0.13490655634009543,0.5861477381259234,0.8703204227488873,2055,1954,2155,2118,63,-37,164,141,-1.1080627632478066,-0.5017935115543029,0.12047888281654519,2.194924163419706,195714,194920,Sangamon,Sangamon,17,167,Illinois,IL
17003,17CS046,69,69,70,99,30,29,30,11,3.481149495904748,3.5736239523108404,3.6735863420569284,0.3577676278099609,82,81,82,103,21,21,22,12,2.0310318762508603,2.180148256395756,2.3360887451571304,0.5414201411479098,5244,5050,Southern Illinois,Alexander,17,3,Illinois,IL
17069,17CS046,51,51,52,62,11,10,11,10,0.08856409399417434,0.1747328551908757,0.27676198019801684,0.8588469728028202,63,62,63,83,20,20,21,11,2.9203778744008555,3.069871137337322,3.223991252174411,0.5154851993315097,3667,3648,Southern Illinois,Hardin,17,69,Illinois,IL
17087,17CS046,139,133,144,140,1,-4,7,16,-1.5507208325990505,-1.1160471936182166,-0.679056034220496,6.8640644172057135,173,166,180,175,2,-5,9,32,-3.3767276968210935,-2.6815652731095665,-2.0747269317379806,11.297021390065972,13188,13440,Southern Illinois,Johnson,17,87,Illinois,IL
17127,17CS046,181,175,187,200,19,13,25,23,-0.7100219659325695,-0.29647660221956285,0.15287621486809996,1.1626607586750686,221,213,228,239,18,11,26,29,-1.4880170384121865,-0.8936929212509064,-0.3513550107996008,1.4960183345964704,14056,13984,Southern Illinois,Massac,17,127,Illinois,IL
17151,17CS046,40,40,41,42,2,1,2,6,-1.219486066061956,-1.1262224578197935,-1.0244322855305652,2.2114417800528843,49,49,50,71,22,21,22,12,3.0032068779083048,3.159594183839239,3.313013082014464,0.5233166891030421,3811,3774,Southern Illinois,Pope,17,151,Illinois,IL
17153,17CS046,66,66,67,68,2,1,2,7,-1.1335160107256472,-1.028897649491085,-0.9337889482755096,2.6191335546407384,80,79,81,107,27,26,28,16,2.4638722609336265,2.6098369213267687,2.7621203359420807,0.5702630612696244,5173,5079,Southern Illinois,Pulaski,17,153,Illinois,IL
17181,17CS046,200,193,207,231,31,24,38,22,0.0700268728256299,0.5311321970367223,0.9475137203037768,0.6901014831093509,244,235,252,278,34,26,43,32,-0.4431894763791657,0.14849558632075102,0.7860749941291771,0.9046611366074692,17081,16960,Southern Illinois,Union,17,181,Illinois,IL
17179,17CS047,1182,1126,1239,1421,239,182,295,112,0.5371264693652026,0.9687586137472332,1.3746139294394306,0.4672523075083578,1441,1374,1509,1718,277,209,344,165,0.41816109371618343,1.0182075319306823,1.6518920399231267,0.5940141907494083,131076,130501,Tazewell,Tazewell,17,179,Illinois,IL
17183,17CS048,798,766,829,928,130,99,162,84,0.18536072147333912,0.6242804235030152,1.0437198975097455,0.639563544077212,965,927,1003,1186,221,183,259,157,0.46776371819175583,1.0534134405036426,1.6480230902382664,0.7073673332048347,74071,73210,Vermilion,Vermilion,17,183,Illinois,IL
17197,17CS049,4024,3725,4323,4966,942,643,1241,644,-0.0128733741510796,0.4184154976642579,0.8725007707131781,0.6830864220468397,5005,4645,5364,5524,519,160,879,461,-0.46939790192603237,0.09243483425308954,0.7016089831157745,0.8857283056754328,695208,697055,Will,Will,17,197,Illinois,IL
17199,17CS050,638,609,667,744,106,77,135,76,0.01898434617055637,0.46074907786715835,0.8834487639268619,0.7082970650919019,778,743,813,889,111,76,146,97,-0.35133295692045974,0.26079342622334295,0.827851083900149,0.8664186625255031,67004,66910,Williamson,Williamson,17,199,Illinois,IL
17201,17CS051,2538,2416,2661,2933,395,272,517,323,-0.16801075122975667,0.2393032382649335,0.6653895477975516,0.8164407682239068,3101,2954,3247,3540,439,293,586,303,-0.046671244114779104,0.5651243316738741,1.2337670482884266,0.6881409760488578,284328,283373,Winnebago,Winnebago,17,201,Illinois,IL
18001,18CS001,271,256,287,336,65,49,80,43,0.19827337246223242,0.5902920656308286,1.0248192060116013,0.6541031428257071,334,316,353,382,48,29,66,55,-0.8353507576464063,-0.2729100929669671,0.38048394291072735,1.1323773382099134,35820,35941,Adams+Wells,Adams,18,1,Indiana,IN
18179,18CS001,261,249,273,315,54,42,66,46,-0.12264171896244096,0.29147839569959677,0.7284561934713679,0.8323975294414107,319,305,334,363,44,29,58,54,-1.0349289221087392,-0.4292115847100223,0.1737925204693224,1.2078746917258656,28174,28194,Adams+Wells,Wells,18,179,Indiana,IN
18003,18CS002,2958,2792,3124,3470,512,346,678,428,-0.22951073757766646,0.21515225510132346,0.6419688158332846,0.8344165880839571,3664,3464,3864,3911,247,47,447,387,-1.0410511867647165,-0.41667054420142535,0.1758074540389263,1.5602861042163325,385171,388212,Allen,Allen,18,3,Indiana,IN
18005,18CS003,631,596,667,726,95,59,130,101,-0.4911401737377962,-0.06703976097608438,0.3736408553143437,1.0548772552908803,773,731,816,892,119,76,161,87,-0.14838192889413188,0.4485951136183297,1.082047624971752,0.7270661339805039,82468,82429,Bartholomew+Brown,Bartholomew,18,5,Indiana,IN
18013,18CS003,147,140,154,172,25,18,32,18,0.02785906635871051,0.4475349731498067,0.8460765447551303,0.6908426225057661,180,172,188,204,24,16,32,23,-0.5753740006139929,0.05105269488686408,0.69056279628565,0.9302366627916412,15420,15540,Bartholomew+Brown,Brown,18,13,Indiana,IN
18007,18CS004,74,73,75,95,21,20,22,11,1.0697911792161157,1.1720797406196204,1.2707021210704421,0.49497431824887106,91,90,92,106,15,14,16,11,0.4554482359629148,0.5978910349431961,0.7531448999127066,0.6732215029700052,8720,8714,Benton+Jasper+Newton,Benton,18,7,Indiana,IN
18073,18CS004,277,262,291,350,73,59,88,34,0.7443725806218249,1.2041317578674082,1.6022119318333254,0.4571485494336027,341,324,358,425,84,67,101,75,-0.3194755549679354,0.31590030848621314,0.898684568264025,0.8819038798663518,33014,33064,Benton+Jasper+Newton,Jasper,18,73,Indiana,IN
18111,18CS004,147,141,153,163,16,10,22,23,-0.9062984955352544,-0.46587163243635504,-0.02799578882435981,1.3202294769708232,179,172,186,223,44,37,51,31,0.4961422705106902,1.090859398550284,1.7558989807221257,0.6924920433307611,13823,13806,Benton+Jasper+Newton,Newton,18,111,Indiana,IN
18009,18CS005,147,142,152,173,26,21,31,22,-0.07012735700520631,0.3458628360465774,0.7526994480995449,0.8081780415442706,180,174,186,204,24,18,30,35,-1.69315561034721,-1.0949669288405148,-0.45627128496093056,1.400156082516897,12052,12092,Blackford+Jay+Randolph,Blackford,18,9,Indiana,IN
18075,18CS005,199,190,208,226,27,18,36,34,-0.75994925042873,-0.3420930013923289,0.05265717763755122,1.2077630441271348,243,232,253,297,54,44,65,38,0.29415859426450097,0.9648032822377034,1.6528876424665797,0.688928578061735,20433,20278,Blackford+Jay+Randolph,Jay,18,75,Indiana,IN
18135,18CS005,261,251,272,327,66,55,76,56,-0.011532135676553989,0.400405716499889,0.8137481674481519,0.839754024426892,321,308,333,415,94,82,107,54,1.342118603453922,1.9829019453545254,2.6119394496687307,0.5665662372581646,24399,24385,Blackford+Jay+Randolph,Randolph,18,135,Indiana,IN
18011,18CS006,490,460,521,511,21,-10,51,76,-1.1922419817461105,-0.7863247471995335,-0.36277443301562523,3.474610897339544,616,579,654,640,24,-14,61,54,-1.1160560568804017,-0.5060859151949415,0.1560878779729638,2.1818705666833305,70891,72777,Boone,Boone,18,11,Indiana,IN
18015,18CS007,162,154,171,165,3,-6,11,18,-1.194897261002581,-0.7529052842362317,-0.313947623919679,4.802085394953943,199,188,209,235,36,26,47,34,-0.4848371552973234,0.14221535975272978,0.72972905935225,0.9086360235306086,20307,20424,Carroll+Clinton,Carroll,18,15,Indiana,IN
18023,18CS007,318,303,332,387,69,55,84,35,0.6071337030824927,1.032686753174421,1.475461619648352,0.4971279796797745,386,369,403,433,47,30,64,49,-0.68498985040352,-0.06760867944939448,0.5820639229826019,1.0179443836850066,33018,33078,Carroll+Clinton,Clinton,18,23,Indiana,IN
18017,18CS008,358,342,374,450,92,76,108,75,0.024759219706308584,0.4642801257762454,0.8503778309854629,0.8049925832058206,437,417,456,495,58,39,78,63,-0.791890062578007,-0.15735425778218248,0.47715314711782764,1.0633522443813985,37726,37593,Cass+White,Cass,18,17,Indiana,IN
18181,18CS008,257,246,267,279,22,12,33,31,-0.7506524113154243,-0.3510238141199532,0.04303515690029819,1.3192503094534367,314,302,327,515,201,188,213,52,6.639348676703719,7.214226442837655,7.863749037294008,0.2577382474296151,24574,24649,Cass+White,White,18,181,Indiana,IN
18019,18CS009,1117,1065,1169,1253,136,84,188,129,-0.35575989352412696,0.05549979146274395,0.48598912652140797,0.9435559865413804,1384,1320,1447,1536,152,89,216,181,-0.8761578640741314,-0.2811551432339157,0.32421239187751516,1.1798667086301924,120983,122526,Clark+Scott,Clark,18,19,Indiana,IN
18143,18CS009,280,270,291,333,53,42,63,38,0.20957577514921477,0.6078835078887728,1.0167277699314543,0.7085441612166069,343,330,355,437,94,82,107,55,1.2940733650930072,1.9373424563728534,2.585982897077596,0.5779018417160888,24268,24352,Clark+Scott,Scott,18,143,Indiana,IN
18021,18CS010,257,246,269,317,60,48,71,32,0.6392705182467623,1.038849402093236,1.4694971841533129,0.5282472811903033,312,299,326,350,38,24,51,36,-0.5892689299761934,0.08539989220016296,0.7514851873999748,0.9282538093184548,26411,26413,Clay+Sullivan+Vermillion+Vigo,Clay,18,21,Indiana,IN
18153,18CS010,196,187,205,225,29,20,38,28,-0.3242342858384954,0.046096752572717586,0.47803225963507606,0.9231430337193056,237,227,248,274,37,26,47,30,-0.27936225483374977,0.38580581600981506,1.0242966981369295,0.7952645530603009,20769,20765,Clay+Sullivan+Vermillion+Vigo,Sullivan,18,153,Indiana,IN
18165,18CS010,174,167,181,195,21,14,28,26,-0.7698293147149807,-0.32252691516389725,0.078627292127039,1.187287586049001,210,202,218,233,23,15,31,27,-0.944536880035674,-0.3526825817570045,0.23611545614559165,1.1390107274927863,15398,15348,Clay+Sullivan+Vermillion+Vigo,Vermillion,18,165,Indiana,IN
18167,18CS010,953,908,999,1144,191,145,236,138,0.06445265339413082,0.5103878016313574,0.93174863239913,0.7199346968513273,1157,1102,1211,1348,191,137,246,128,0.13414874501489502,0.717067869273287,1.3503987690009538,0.6649622830233186,106144,105996,Clay+Sullivan+Vermillion+Vigo,Vigo,18,167,Indiana,IN
18025,18CS011,105,104,106,124,19,18,20,11,0.6398035452099559,0.741152950487242,0.8477583180868888,0.5550935622038776,129,128,130,166,37,36,38,26,1.1150041652917821,1.263227212243817,1.411425767827017,0.6830470636612042,10545,10518,Crawford+Harrison+Perry,Crawford,18,25,Indiana,IN
18061,18CS011,352,335,369,403,51,34,68,41,-0.23361633121454023,0.2711310927351304,0.6679517714977948,0.7882551643614898,433,413,454,542,109,88,129,72,0.4690641200604349,1.110571409290526,1.7266061087772928,0.6550164356539736,39795,39745,Crawford+Harrison+Perry,Harrison,18,61,Indiana,IN
18123,18CS011,191,182,199,210,19,11,28,25,-0.690367811056107,-0.27613104676668343,0.14372429719365018,1.222059824181236,235,225,245,244,9,-1,19,32,-2.068580766819177,-1.4297618130213914,-0.783343021043664,3.2746802776168558,19172,19292,Crawford+Harrison+Perry,Perry,18,123,Indiana,IN
18027,18CS012,292,278,306,336,44,30,58,70,-1.215624722094364,-0.782809177196102,-0.33311580880744823,1.5528874582523995,359,342,376,343,-16,-33,1,38,-2.5220283043559912,-1.9500840637276708,-1.321705009316524,-2.5251864973483213,33399,33396,Daviess+Knox+Martin,Daviess,18,27,Indiana,IN
18083,18CS012,373,358,389,477,104,88,119,68,0.5313936974766744,0.998931480912926,1.3952450928509552,0.6504289194263533,455,436,473,503,48,30,67,43,-0.40468022139898585,0.16967778282374227,0.7876249313679182,0.870717595026627,36266,35998,Daviess+Knox+Martin,Knox,18,83,Indiana,IN
18101,18CS012,90,89,91,95,5,4,6,10,-0.6290720586280496,-0.5240667575480216,-0.42682545468325644,1.7075637827291004,110,109,111,128,18,17,19,5,1.4322872755502756,1.5796684427701593,1.7260790602794864,0.2648357121843042,9843,9781,Daviess+Knox+Martin,Martin,18,101,Indiana,IN
18029,18CS013,436,414,457,474,38,17,60,58,-0.8009202177034479,-0.38929357134544196,0.05249053249091548,1.4687422176328215,536,510,562,616,80,54,106,84,-0.7462283179126349,-0.0792094733620267,0.5563373617273142,1.0359731493489635,50567,50803,Dearborn+Ohio+Ripley+Switzerland,Dearborn,18,29,Indiana,IN
18115,18CS013,57,56,58,66,9,8,10,16,-1.2723967969883416,-1.167167024915919,-1.06872721895675,1.585982862173749,70,70,71,89,19,18,19,2,3.1999303257007545,3.362637493830419,3.5080581505015562,0.10141107723439273,5932,5971,Dearborn+Ohio+Ripley+Switzerland,Ohio,18,115,Indiana,IN
18137,18CS013,265,252,277,332,67,55,80,43,0.41475513729432995,0.843549052482587,1.273305850532506,0.6305792804429978,326,311,341,420,94,79,109,74,0.2307843533559793,0.8426541464867198,1.4648777100491808,0.7764883413323422,28915,29066,Dearborn+Ohio+Ripley+Switzerland,Ripley,18,137,Indiana,IN
18155,18CS013,85,84,86,90,5,4,6,6,-0.22074227770182595,-0.11392420999169502,-0.008605728769484936,1.0260692008872776,103,102,105,116,13,11,14,12,-0.08832125975858988,0.07180635858620973,0.2268557755016583,0.8826301613091376,9890,9780,Dearborn+Ohio+Ripley+Switzerland,Switzerland,18,155,Indiana,IN
18031,18CS014,247,235,258,332,85,74,97,61,0.4838110169101717,0.9146124297704513,1.3451608587169759,0.7059039805164401,302,288,315,331,29,16,43,38,-0.9821736439659594,-0.3842997665416484,0.1735076323163303,1.2521592984567576,26460,26343,Decatur+Shelby,Decatur,18,31,Indiana,IN
18145,18CS014,408,389,427,492,84,65,103,62,0.04809089955864113,0.48538540083744175,0.9346840731004508,0.7285873388089661,502,479,525,541,39,16,62,69,-1.4316669275830245,-0.7875340999099942,-0.17345210675354092,1.7167894383200055,44990,45037,Decatur+Shelby,Shelby,18,145,Indiana,IN
18033,18CS015,364,346,383,458,94,75,112,63,0.31086209443225804,0.7041842314519093,1.1211571990944595,0.664249212337095,446,424,469,489,43,20,65,55,-0.9233671482145037,-0.36213729565953323,0.29192056372437947,1.26199509623092,43322,43324,DeKalb+Steuben,DeKalb,18,33,Indiana,IN
18151,18CS015,277,262,292,306,29,14,44,32,-0.49784051878841634,-0.07485684245225048,0.32320499751670567,1.0624916329218819,341,323,359,395,54,36,72,60,-0.7841354293997785,-0.16841342462629194,0.4437035105128354,1.0852717890272179,34507,34604,DeKalb+Steuben,Steuben,18,151,Indiana,IN
18035,18CS016,1100,1052,1148,1343,243,195,291,120,0.6802875642219254,1.0919931328804813,1.5001556639522435,0.49227381942639176,1351,1293,1409,1554,203,145,261,183,-0.3873013750916436,0.20586042897514023,0.7975318955048187,0.8977847236115248,111996,111842,Delaware,Delaware,18,35,Indiana,IN
18037,18CS017,358,339,377,412,54,35,73,55,-0.4670592615676899,-0.02687096406524066,0.4413272795365536,0.9972955675944037,438,416,461,534,96,73,118,62,0.3388964899473265,0.9225942105666826,1.5602727978275843,0.6416888551948466,43449,43557,Dubois+Pike+Spencer,Dubois,18,37,Indiana,IN
18125,18CS017,139,134,144,154,15,10,20,25,-1.1928912618865688,-0.824083597742646,-0.3940421766949712,1.5577937316888628,168,162,174,189,21,15,27,16,-0.1560261102930635,0.49373823533897804,1.0654179690924632,0.729241447311901,12246,12157,Dubois+Pike+Spencer,Pike,18,125,Indiana,IN
18147,18CS017,170,161,178,195,25,17,34,12,0.2419487611544666,0.6634432726235049,1.0805747103277787,0.45455395875962123,207,197,217,280,73,63,83,43,1.1779056245611537,1.8210354443179382,2.465224453049266,0.5796471363118821,19884,19801,Dubois+Pike+Spencer,Spencer,18,147,Indiana,IN
18039,18CS018,1489,1400,1578,1781,292,203,381,331,-0.6516121872458163,-0.18823429926833155,0.23713896425059053,1.1290018814310463,1833,1726,1939,2089,256,150,363,219,-0.3997967184152767,0.2130369530409495,0.8594971058124871,0.8508506889129437,206767,206909,Elkhart,Elkhart,18,39,Indiana,IN
18041,18CS019,282,272,292,344,62,52,72,44,0.36353249475764476,0.7820030806926906,1.2303200967219852,0.6970534432324332,345,333,357,390,45,33,57,61,-1.4213476969223695,-0.812567345199751,-0.2153283941713248,1.3210304470375183,23293,23356,Fayette+Franklin+Union,Fayette,18,41,Indiana,IN
18047,18CS019,187,177,197,249,62,52,72,30,0.9971288526087035,1.4102564339499946,1.8415501861858004,0.47585119883720084,231,219,242,262,31,20,43,36,-0.8749565250761933,-0.24609675722931681,0.358228038651825,1.1136108495760835,22774,22831,Fayette+Franklin+Union,Franklin,18,47,Indiana,IN
18161,18CS019,64,63,65,94,30,29,31,1,3.975658024161599,4.072258092194965,4.1693884416646085,0.03238904807526467,78,78,79,89,11,10,11,19,-1.5754080339700445,-1.4263425523573703,-1.2713014941912177,1.6371880226556248,7092,7053,Fayette+Franklin+Union,Union,18,161,Indiana,IN
18043,18CS020,722,687,756,830,108,74,143,87,-0.15540000420164976,0.2756885960042117,0.688578057727297,0.7973121117820041,889,848,931,955,66,24,107,95,-1.0680444828332776,-0.4514047997949679,0.17631609798217743,1.4282698060820918,80171,80452,Floyd,Floyd,18,43,Indiana,IN
18045,18CS021,189,182,196,227,38,31,45,26,0.28541288311848617,0.7415059974861773,1.1629722178231,0.6639734359218376,231,222,239,258,27,19,36,34,-1.150388622194955,-0.4778279488955868,0.09284476822499359,1.2074436959010453,16459,16433,Fountain+Montgomery+Warren,Fountain,18,45,Indiana,IN
18107,18CS021,354,337,370,405,51,35,68,63,-0.7400724958323981,-0.2948007533537775,0.13573455357034375,1.2002072074532069,436,416,455,487,51,32,71,63,-0.977905838498657,-0.39018025757130737,0.2599393526662882,1.2023392004056455,37996,38044,Fountain+Montgomery+Warren,Montgomery,18,107,Indiana,IN
18171,18CS021,73,72,74,105,32,31,33,8,2.767548854669853,2.8658675497063606,2.970953390575065,0.2418108343325972,90,89,91,98,8,7,9,11,-0.6368021674126898,-0.47710461688426203,-0.3197409055014596,1.275406611877718,8397,8466,Fountain+Montgomery+Warren,Warren,18,171,Indiana,IN
18049,18CS022,212,204,221,237,25,16,33,31,-0.7268300510545926,-0.3106427068568507,0.13159973351553503,1.20779000821389,260,249,271,293,33,22,44,41,-1.075712272617296,-0.48307133797435287,0.12643279394068221,1.2064737045297134,20372,20393,Fulton+Miami+Wabash,Fulton,18,49,Indiana,IN
18103,18CS022,334,318,349,387,53,38,69,37,0.007974088383231938,0.4573099038090259,0.8630207874344296,0.6843944611638026,412,393,430,519,107,89,126,77,0.37620243476576526,1.0012019651821173,1.644008947774687,0.7106961154003126,35877,36058,Fulton+Miami+Wabash,Miami,18,103,Indiana,IN
18169,18CS022,379,366,392,434,55,42,68,54,-0.39673874791154784,0.038121829556536015,0.4737740541652773,0.9610209295018913,462,446,477,530,68,53,84,62,-0.40141516872544647,0.26118630853923175,0.8774351426804451,0.8926047795026834,30901,30826,Fulton+Miami+Wabash,Wabash,18,169,Indiana,IN
18051,18CS023,306,292,321,382,76,61,90,71,-0.3006033079020787,0.1421392227924947,0.5570551088762995,0.9279371957992428,374,357,391,400,26,9,43,48,-1.4079435635405608,-0.7784653994441858,-0.19145231089733747,1.7557417450404273,33111,32938,Gibson+Posey,Gibson,18,51,Indiana,IN
18129,18CS023,209,199,220,233,24,13,34,23,-0.4210160421112124,0.031015479558630397,0.46247282906081744,0.9332094035605947,256,243,269,255,-1,-14,12,20,-1.6873878053523477,-1.0151990479064588,-0.43279653073836255,-75.49207838508937,25192,25123,Gibson+Posey,Posey,18,129,Indiana,IN
18053,18CS024,725,696,753,892,167,139,196,120,0.31258769465830744,0.7019870968257613,1.1576065000928837,0.7130806780712655,886,851,920,1121,235,201,270,144,1.0251253171158305,1.6353536251559715,2.3140009089695632,0.6093037619309001,66338,66290,Grant,Grant,18,53,Indiana,IN
18055,18CS025,323,309,336,367,44,31,58,55,-0.7854557724314608,-0.35798438942243893,0.09071402868642962,1.2120868908453355,394,378,410,447,53,37,69,40,-0.06807383284731341,0.5124703422842227,1.1592315133826125,0.7399028046723521,30983,30787,Greene+Owen+Parke+Putnam,Greene,18,55,Indiana,IN
18119,18CS025,207,205,209,259,52,50,54,23,1.2726461211069582,1.3664513414802648,1.4616515444035074,0.4340213123383622,256,254,259,74,-182,-185,-180,21,-11.535024023877684,-11.384851452724481,-11.23139293303309,-0.1158333199445783,21253,21424,Greene+Owen+Parke+Putnam,Owen,18,119,Indiana,IN
18121,18CS025,142,135,149,150,8,1,15,13,-0.7109844660310687,-0.28685139659918196,0.11195858533777996,1.4468422739639393,176,168,185,194,18,9,26,31,-1.5709933241292042,-0.9438321737195815,-0.33919233813500654,1.6358122903215646,16288,16370,Greene+Owen+Parke+Putnam,Parke,18,121,Indiana,IN
18133,18CS025,310,295,326,363,53,37,68,38,-0.021452203219676766,0.4118201523190539,0.8186942654070015,0.7084895693212787,384,365,403,441,57,38,76,51,-0.4469668285217475,0.21590244707055067,0.8339134314521995,0.8767061604683,36830,36933,Greene+Owen+Parke+Putnam,Putnam,18,133,Indiana,IN
18057,18CS026,1638,1488,1788,1971,333,183,483,274,-0.2642596077396266,0.164102143384258,0.5766979310952438,0.8213561698657075,2086,1902,2270,2310,224,40,408,168,-0.44189769782086563,0.1981901460267071,0.8109726919854637,0.746801219936576,348087,355515,Hamilton,Hamilton,18,57,Indiana,IN
18059,18CS027,603,569,638,659,56,21,90,81,-0.731133857201363,-0.3032924532136076,0.15040498962533358,1.4255077100544133,752,710,794,917,165,123,207,104,0.30203938063145613,0.8819524678394141,1.5168936862348341,0.627791297706354,80035,81551,Hancock,Hancock,18,59,Indiana,IN
18063,18CS028,1104,1029,1180,1288,184,108,259,189,-0.4625624654964418,-0.03391379838463692,0.4020646033009594,1.0234135582716368,1391,1299,1483,1457,66,-26,158,157,-1.2310853915169289,-0.614924809307863,0.050440270861521905,2.347489077983803,175109,178797,Hendricks,Hendricks,18,63,Indiana,IN
18065,18CS029,514,493,535,622,108,87,129,63,0.49588410023661167,0.9345833520285917,1.350606025322017,0.5769774722508351,628,603,653,734,106,81,131,109,-0.6790811206909453,-0.10154281363786406,0.49940256472333244,1.019462060751958,48765,48928,Henry+Rush,Henry,18,65,Indiana,IN
18139,18CS029,170,162,177,183,13,6,21,17,-0.6490046011062881,-0.21721399594816873,0.20655947535537875,1.1763110237186944,206,198,215,220,14,5,22,21,-1.1307321696192956,-0.5425315739839541,0.07056512947300239,1.4406128766609798,16716,16682,Henry+Rush,Rush,18,139,Indiana,IN
18067,18CS030,922,886,958,1064,142,106,178,137,-0.37940394833504976,0.057876666645035685,0.4778670101296508,0.9562213351212643,1129,1085,1172,1332,203,160,247,184,-0.31337214452566514,0.2555163145419141,0.9587601750316368,0.8999907778560743,83486,83677,Howard+Tipton,Howard,18,67,Indiana,IN
18159,18CS030,163,157,170,186,23,16,29,36,-1.2661706243566306,-0.8709989372356635,-0.4295128305781909,1.5097274689327158,200,192,208,230,30,22,38,36,-1.081981434296293,-0.464830617195207,0.20230184962725498,1.1580651143662832,15332,15371,Howard+Tipton,Tipton,18,159,Indiana,IN
18069,18CS031,357,341,372,426,69,54,85,44,0.24647557571516399,0.6955496423129502,1.0996290521840686,0.6260579302008898,438,419,457,521,83,64,102,71,-0.25744504060150936,0.38035621408072673,0.9947566006181761,0.8448330559404468,36603,36700,Huntington+Whitley,Huntington,18,69,Indiana,IN
18183,18CS031,277,262,291,305,28,14,43,27,-0.40754026684771855,0.048201345102035685,0.48241875723417654,0.9173286733189112,341,324,359,384,43,25,60,40,-0.5281131007378046,0.09311193661112323,0.7103797169845266,0.9161996251999532,34263,34413,Huntington+Whitley,Whitley,18,183,Indiana,IN
18071,18CS032,430,410,450,474,44,24,64,50,-0.5556810440612858,-0.13905077489575698,0.2827159027688785,1.1191394841859736,525,502,549,567,42,18,65,48,-0.788248364963347,-0.15052168275545688,0.44514189465096543,1.1248509322698244,46021,46112,Jackson+Washington,Jackson,18,71,Indiana,IN
18175,18CS032,272,260,284,293,21,9,33,19,-0.3336209039989492,0.07214131194975543,0.5008671907117237,0.8714230214241883,331,317,346,397,66,51,80,44,0.29708010210271024,0.9171130074175761,1.5032475856677707,0.661494294292118,28185,28119,Jackson+Washington,Washington,18,175,Indiana,IN
18077,18CS033,331,316,345,382,51,37,66,45,-0.2866376325512588,0.17476984558077371,0.6031154924230602,0.860226135910802,406,389,423,427,21,4,38,75,-2.610414745189864,-1.9561257710178466,-1.3447899669109609,3.444856096826527,32964,33131,Jennings+Jefferson,Jefferson,18,77,Indiana,IN
18079,18CS033,262,250,274,300,38,26,50,30,-0.13648271842137613,0.29499470539218947,0.6895585995401177,0.7716634761748826,320,306,334,345,25,11,39,32,-0.910680783057233,-0.3067981598119714,0.26846670056803357,1.2213774634839967,27562,27432,Jennings+Jefferson,Jennings,18,79,Indiana,IN
18081,18CS034,1213,1143,1282,1462,249,180,319,223,-0.2795045709928769,0.16796012309239244,0.580428036730181,0.8906289694033099,1508,1423,1592,1742,234,150,319,199,-0.3827038858730995,0.25355163564269667,0.870744104508097,0.8452340246051055,161839,163989,Johnson,Johnson,18,81,Indiana,IN
18085,18CS035,626,592,661,679,53,18,87,67,-0.6396554193617515,-0.16897831340910086,0.25536129727154494,1.245626259128063,772,730,813,922,150,109,192,97,0.2288514300916571,0.776945845522634,1.4102900859426286,0.6405208296509651,79967,80098,Kosciusko,Kosciusko,18,85,Indiana,IN
18087,18CS036,252,234,269,308,56,39,74,72,-0.8203117059872727,-0.3851244215580749,0.032258792691070445,1.2589520165640393,314,293,335,313,-1,-22,20,32,-1.6231240221474557,-0.9883246255566264,-0.35892596137490745,-347.8278991980435,40407,40523,LaGrange+Noble,LaGrange,18,87,Indiana,IN
18113,18CS036,395,375,415,437,42,22,62,47,-0.5782252338571138,-0.09912743426007119,0.339376179795084,1.0956289794169753,486,461,510,552,66,42,91,59,-0.4381256088041092,0.1636425848877566,0.8222359118555957,0.878749922018842,47440,47249,LaGrange+Noble,Noble,18,113,Indiana,IN
18089,18CS037,4383,4170,4597,5247,864,650,1077,627,0.04094874922824909,0.469897109816027,0.91905013815424,0.7252456209523018,5395,5138,5652,6026,631,374,888,617,-0.574094348710555,0.023837131895440677,0.6937459462029268,0.9763051268082009,496791,498564,Lake,Lake,18,89,Indiana,IN
18091,18CS038,1061,1013,1109,1271,210,162,258,130,0.23188591679403725,0.72928300053251,1.1430904310439463,0.6157798060606727,1301,1243,1359,1366,65,7,123,107,-1.0966580382977504,-0.4599203141529465,0.1644117966531243,1.6309252202891913,111922,112366,LaPorte,LaPorte,18,91,Indiana,IN
18093,18CS039,463,443,482,545,82,63,102,82,-0.4163128102586296,-0.008754690505189061,0.43304818878241386,0.9852542411658377,565,542,588,733,168,145,191,108,0.98654126439732015,1.608523742589386,2.2469649872065434,0.6396094051913318,45085,45063,Lawrence+Orange,Lawrence,18,93,Indiana,IN
18117,18CS039,203,195,212,264,61,52,69,35,0.8969127316983412,1.3054580376556943,1.7260576155624061,0.5670267644464319,248,238,259,309,61,50,71,39,0.6994875885342643,1.3074138726498021,1.9323529219048599,0.6326784243873441,19812,19831,Lawrence+Orange,Orange,18,117,Indiana,IN
18095,18CS040,1303,1247,1359,1558,255,199,311,227,-0.18158214830935113,0.21211681190582438,0.6376947545415128,0.8859162015835598,1602,1534,1669,1948,346,279,414,261,0.18720694280567546,0.794500834541376,1.4295867064425134,0.7513494627118186,130045,130677,Madison,Madison,18,95,Indiana,IN
18097,18CS041,7153,6733,7572,8757,1604,1185,2024,1268,-0.025061495220771036,0.3419406815020787,0.7764938820670858,0.7898897351959403,8768,8266,9270,10193,1425,923,1927,1003,-0.09697718627364241,0.5119166004844955,1.1396557941807106,0.7034131857304068,974292,971929,Marion,Marion,18,97,Indiana,IN
18099,18CS042,392,372,412,515,123,103,143,74,0.6304224998919864,1.0602461828406708,1.479208776214209,0.5981724863108535,483,459,507,540,57,33,81,71,-0.9527000336887312,-0.37768013200436784,0.22809244423288433,1.229308833823152,46055,46106,Marshall+Pulaski+Starke,Marshall,18,99,Indiana,IN
18131,18CS042,145,140,151,163,18,12,23,28,-1.2836688893980153,-0.8393269021362418,-0.3922233994742699,1.511931637219254,176,170,183,211,35,28,41,33,-0.4840173802734741,0.15883372032750215,0.7932624987855401,0.9266248066135856,12457,12361,Marshall+Pulaski+Starke,Pulaski,18,131,Indiana,IN
18149,18CS042,236,226,246,296,60,50,70,49,0.05876639603285239,0.45610683951243575,0.8897738717191159,0.8063738048835778,290,278,302,374,84,72,96,42,1.5274062663133352,2.1643324669134785,2.7891690886157603,0.4941609849408625,23307,23370,Marshall+Pulaski+Starke,Starke,18,149,Indiana,IN
18105,18CS043,801,741,861,1017,216,156,276,113,0.291164316889519,0.734770820723551,1.138054125227263,0.5209635576294934,988,916,1060,1159,171,99,243,116,-0.13335246271101334,0.46111665879237784,1.0813201207952594,0.6745262342407785,140817,139823,Monroe,Monroe,18,105,Indiana,IN
18109,18CS044,626,595,656,720,94,64,125,93,-0.45836328825760575,0.01711860059449805,0.448760146858815,0.9749259100345613,774,737,811,901,127,90,164,112,-0.4202356375974655,0.24496033491561972,0.8560094394737066,0.8747555059802741,71640,72147,Morgan,Morgan,18,109,Indiana,IN
18127,18CS045,1337,1262,1411,1602,265,191,340,180,0.05453009582347906,0.4965359144600424,0.9067155991090575,0.6764236732083606,1656,1566,1746,1904,248,158,338,192,-0.29768329238716873,0.39160854405840545,0.9873188133283427,0.769983820510253,172971,174099,Porter,Porter,18,127,Indiana,IN
18141,18CS046,2343,2226,2461,2802,459,341,576,372,-0.12665682202098666,0.32281379807299876,0.7440416754260375,0.8093807359279258,2874,2734,3015,3110,236,95,376,250,-0.6677800622530724,-0.06348794710907385,0.5554017968600254,1.056348538693044,272389,272261,St. Joseph,St. Joseph,18,141,Indiana,IN
18157,18CS047,1032,951,1112,1164,132,52,213,83,-0.1529967338113103,0.24719662193576036,0.6554856619873412,0.6223675538472354,1277,1181,1374,1491,214,117,310,167,-0.32085930869748575,0.29916230875281213,0.9184364655542323,0.7780194788519471,187592,186955,Tippecanoe,Tippecanoe,18,157,Indiana,IN
18163,18CS048,1697,1619,1774,2038,341,264,419,247,0.09836998894624256,0.5284040405157063,0.9558458559406283,0.7213525773857902,2076,1983,2169,2334,258,165,351,219,-0.33239768262527075,0.26230264536013587,0.8640655731460766,0.8453477846914401,180345,180012,Vanderburgh,Vanderburgh,18,163,Indiana,IN
18173,18CS049,529,502,557,661,132,104,159,85,0.2888822033005306,0.7365673807091,1.1424784061028475,0.6411042554899962,657,624,691,722,65,31,98,73,-0.7621390043996243,-0.15644209428273517,0.47010106940836127,1.112358541344571,63860,64434,Warrick,Warrick,18,173,Indiana,IN
18177,18CS050,764,736,793,935,171,142,199,131,0.183714911874893,0.6122415207006933,1.006175917572486,0.7630236032400006,934,900,969,1027,93,58,127,113,-1.0303058199687187,-0.3507074093971908,0.23353277855794022,1.2068813725732603,66380,66456,Wayne,Wayne,18,177,Indiana,IN
19005,19CS001,158,152,164,169,11,5,17,27,-1.59084953457034,-1.1558423893872458,-0.6993112016716954,2.2964401922473123,192,185,199,169,-23,-30,-16,20,-4.3301328935279315,-3.721047434578622,-3.0900097738432253,-0.905521993779557,13995,13947,Allamakee+Clayton+Winneshiek,Allamakee,19,5,Iowa,IA
19043,19CS001,165,158,172,197,32,25,39,43,-1.0818526916929543,-0.6401736327097455,-0.19294934850372245,1.3055063824053355,201,193,210,223,22,13,30,16,-0.22431840397033825,0.4061496227840506,1.0288456647331312,0.7078612207892518,17069,16998,Allamakee+Clayton+Winneshiek,Clayton,19,43,Iowa,IA
19191,19CS001,166,157,175,161,-5,-14,4,22,-1.7812843652030212,-1.3400722788214354,-0.9028808059302066,-5.595284253370821,203,192,213,202,-1,-11,10,16,-1.6051873599940611,-1.0102826197531967,-0.3587324635570928,40.951200806169325,20011,19912,Allamakee+Clayton+Winneshiek,Winneshiek,19,191,Iowa,IA
19001,19CS002,90,89,91,98,8,7,9,16,-1.208354648598104,-1.1038155139315975,-1.0016726394431457,1.817035769826627,112,111,113,130,18,17,19,19,-0.27708627317741846,-0.12618637207982644,0.034343205422669165,0.9896668027346419,7429,7532,Audubon and Nearby Counties,Adair,19,1,Iowa,IA
19009,19CS002,73,72,73,68,-5,-5,-4,4,-1.6851574929913888,-1.5809371859123507,-1.483029799640045,-1.019238940459467,89,88,90,82,-7,-8,-6,4,-2.504853154539334,-2.366347630880952,-2.217951731053827,-0.653380100786636,5641,5640,Audubon and Nearby Counties,Audubon,19,9,Iowa,IA
19029,19CS002,172,166,177,205,33,28,39,41,-1.0205446931380044,-0.5924284360180893,-0.16013540661582365,1.1935270602851613,209,202,215,203,-6,-12,1,25,-3.478560225327311,-2.7983580551773586,-2.2196370528643095,-5.29254581911821,13057,13058,Audubon and Nearby Counties,Cass,19,29,Iowa,IA
19077,19CS002,104,103,105,133,29,28,30,20,0.7160252364054861,0.8233688531556566,0.9229044627008636,0.6727793219679882,127,126,128,127,-0,-1,1,14,-1.7615149433080832,-1.5908647595388834,-1.4305675181143709,14.220400752523174,10626,10574,Audubon and Nearby Counties,Guthrie,19,77,Iowa,IA
19165,19CS002,128,127,129,162,34,33,35,28,0.3868528496923875,0.49577467011613285,0.6033786060234969,0.8046117285349865,158,156,159,150,-8,-9,-6,13,-2.284781110531826,-2.1428844874118127,-1.9886812257766515,-1.862957718759174,11674,11760,Audubon and Nearby Counties,Shelby,19,165,Iowa,IA
19011,19CS003,212,201,223,267,55,44,66,41,0.08431831265509745,0.5448681732525023,0.9454430776959174,0.7339448974948161,263,250,276,235,-28,-41,-15,14,-2.5663238499955945,-1.9577788581441082,-1.3389242613227332,-0.5212864356672628,25553,25668,Benton+Iowa (county)+Keokuk+Washington,Benton,19,11,Iowa,IA
19095,19CS003,171,164,179,195,24,16,31,22,-0.323969726592172,0.079439025324383,0.5220095099551355,0.8956947583701579,210,201,219,214,4,-5,13,14,-1.3362551304217711,-0.7211117242563844,-0.10718301287937258,2.7665600380442426,16590,16584,Benton+Iowa (county)+Keokuk+Washington,Iowa (county),19,95,Iowa,IA
19107,19CS003,100,99,101,128,28,27,29,26,0.11567511331126494,0.21751560337585266,0.3225518268080985,0.8907903397535132,122,120,123,156,34,33,36,18,1.841007660259001,1.989430988558187,2.152346704924408,0.5075315452058322,10015,9926,Benton+Iowa (county)+Keokuk+Washington,Keokuk,19,107,Iowa,IA
19183,19CS003,217,207,226,263,46,37,56,32,0.2340670114714168,0.637170004780963,1.0834476480304827,0.6770085185538964,267,255,278,265,-2,-13,10,34,-2.5146741830543395,-1.916078210269174,-1.3121874456970717,-49.55355828743099,22439,22494,Benton+Iowa (county)+Keokuk+Washington,Washington,19,183,Iowa,IA
19013,19CS004,1050,994,1106,1302,252,196,308,239,-0.3487899467118163,0.0977945283263827,0.5125974798479646,0.945118252892768,1289,1222,1357,1449,160,92,227,141,-0.4412503121599621,0.17503504311512505,0.7812160591334225,0.8782724204489127,130932,130457,Black Hawk,Black Hawk,19,13,Iowa,IA
19015,19CS005,252,241,264,284,32,20,43,15,0.20245734458589842,0.6424319512124679,1.079863159286505,0.4559006436827839,308,294,322,334,26,12,40,27,-0.6909077293080906,-0.04812250104734519,0.5556802586679901,1.007924336949255,26643,26718,Boone+Carroll+Greene,Boone,19,15,Iowa,IA
19027,19CS005,204,195,213,239,35,26,44,36,-0.4604812710940575,-0.06796240939783375,0.34236038628632526,1.007637168032139,250,239,260,281,31,21,42,10,0.6300399970967369,1.2440217047266322,1.835576484624693,0.3084120763464237,20616,20693,Boone+Carroll+Greene,Carroll,19,27,Iowa,IA
19073,19CS005,99,98,100,85,-14,-15,-13,4,-2.14181946355317,-2.0381887073956553,-1.9404128604072393,-0.31101588101764277,120,119,121,130,10,9,11,10,-0.18542118745750755,-0.03616430215586168,0.11079553028804061,0.9305005366043297,8763,8721,Boone+Carroll+Greene,Greene,19,73,Iowa,IA
19017,19CS006,203,192,213,272,69,59,80,44,0.5789112484551966,1.0068764766478655,1.452226944859435,0.6247681040839214,251,238,264,254,3,-10,16,23,-1.596299860816781,-0.9651696003126449,-0.3131579568824226,5.784609040471777,25014,25065,Bremer+Butler+Grundy,Bremer,19,17,Iowa,IA
19023,19CS006,164,158,170,153,-11,-17,-5,22,-2.7628978130509836,-2.3245773099627707,-1.9192631579032509,-2.136830168315954,201,194,209,199,-2,-10,5,21,-2.623966593299866,-1.9602059371119438,-1.3694295845950566,-14.418378963921066,14327,14329,Bremer+Butler+Grundy,Butler,19,23,Iowa,IA
19075,19CS006,124,123,126,142,18,16,19,26,-0.7845185347216355,-0.6795387555948069,-0.5881077223973834,1.3992099436295304,154,152,155,147,-7,-8,-5,3,-1.0866879084055785,-0.9332043647716388,-0.794810594507997,-0.5334343718422443,12303,12342,Bremer+Butler+Grundy,Grundy,19,75,Iowa,IA
19019,19CS007,173,164,182,191,18,9,27,22,-0.6071378818007059,-0.20519764677228283,0.21497093063089104,1.1704385251292853,212,202,223,223,11,-0,21,20,-1.1791721199185647,-0.5490711627533058,0.06495235346910694,1.727608148226216,20675,20647,Buchanan+Delaware+Fayette,Buchanan,19,19,Iowa,IA
19055,19CS007,151,143,158,187,36,29,44,32,-0.1959052066790999,0.233049308945197,0.6531568299447753,0.8616566767719777,186,177,195,188,2,-7,11,23,-2.0188286428795683,-1.4105595322420506,-0.7848354462305857,6.8370209465258815,17405,17502,Buchanan+Delaware+Fayette,Delaware,19,55,Iowa,IA
19065,19CS007,210,201,218,250,40,32,49,26,0.3031074723776066,0.7341362254811333,1.187518053868802,0.6301872440462905,254,244,264,273,19,9,29,30,-1.311192120155515,-0.7075290795252122,-0.1039657840727647,1.5323893216266515,19410,19279,Buchanan+Delaware+Fayette,Fayette,19,65,Iowa,IA
19031,19CS008,155,147,163,181,26,18,34,18,0.013646693054654678,0.43120632282994836,0.8936743845551189,0.6672097901095054,189,179,198,213,24,15,34,5,0.6254799639144807,1.2293920592939198,1.850602650139843,0.19912369201384003,18493,18422,Cedar+Clinton+Jackson+Jones,Cedar,19,31,Iowa,IA
19045,19CS008,471,451,491,531,60,40,80,71,-0.6722680311481313,-0.24015630419931505,0.18823355517764556,1.1589714625811354,574,550,598,609,35,11,59,47,-0.9380931998134534,-0.315358415803301,0.2728814678346066,1.3058962552595086,46443,46456,Cedar+Clinton+Jackson+Jones,Clinton,19,45,Iowa,IA
19097,19CS008,191,182,199,223,32,24,41,32,-0.4112842799748274,0.039228158762725056,0.44495378195720947,0.9573501548994158,232,222,242,269,37,27,47,27,-0.0248568788169213,0.6265679124498419,1.2512376005942658,0.7080497786640478,19421,19378,Cedar+Clinton+Jackson+Jones,Jackson,19,97,Iowa,IA
19105,19CS008,173,164,182,210,37,28,46,48,-0.9461953265624905,-0.5192913755594419,-0.06602548612153916,1.2534122711051567,212,202,223,241,29,18,39,14,0.16393920992387748,0.8194082945744408,1.4840097748415992,0.4724476676139829,20662,20782,Cedar+Clinton+Jackson+Jones,Jones,19,105,Iowa,IA
19033,19CS009,449,430,467,533,84,66,103,67,-0.046825305071917386,0.40034611073334253,0.8144540712794953,0.7842310747567881,548,526,570,601,53,31,75,63,-0.8719563889053314,-0.2717154857551609,0.3245726488981531,1.158238315056008,42867,42744,Cerro Gordo+Hancock+Winnebago,Cerro Gordo,19,33,Iowa,IA
19081,19CS009,101,100,102,120,19,18,20,20,-0.15992704088538515,-0.058076289654176896,0.03725674644399771,0.9822963352905145,123,122,124,154,31,30,32,16,1.5278857400581052,1.6875362689546936,1.834620328584971,0.49986912203525885,10734,10677,Cerro Gordo+Hancock+Winnebago,Hancock,19,81,Iowa,IA
19189,19CS009,111,110,112,137,26,25,27,24,0.1192644738423809,0.21968258019241246,0.3188081863458363,0.8785119386392031,136,135,138,126,-10,-12,-9,11,-2.5634352272775556,-2.414946125989084,-2.2571287448466397,-1.1638254789337383,10608,10655,Cerro Gordo+Hancock+Winnebago,Winnebago,19,189,Iowa,IA
19049,19CS010,481,438,524,557,76,33,119,63,-0.287068792692136,0.13064660925370608,0.5469992364032538,0.8206753196320797,617,564,670,585,-32,-85,21,46,-1.5377736435264326,-0.9118098746328938,-0.2714011162605118,-1.4767561954351685,99831,103313,Dallas,Dallas,19,49,Iowa,IA
19051,19CS011,81,80,82,91,10,9,11,20,-1.170170879921807,-1.0660980675332095,-0.9734142838204539,1.7712896201128354,100,99,101,82,-18,-19,-17,2,-2.7552160387990337,-2.606410453138122,-2.4505617798122397,-0.11886907931428108,9097,9134,Davis+Jefferson+Van Buren+Wapello,Davis,19,51,Iowa,IA
19101,19CS011,137,130,143,178,41,35,48,25,0.5879862575595349,1.038848935866956,1.4525803004053126,0.5890394506751355,166,158,174,183,17,9,25,15,-0.42041455381395443,0.16588258076726445,0.7749258598768988,0.8238997085760631,16025,15649,Davis+Jefferson+Van Buren+Wapello,Jefferson,19,101,Iowa,IA
19177,19CS011,81,81,82,80,-1,-2,-1,13,-2.114288862230156,-2.012619580099885,-1.9173999065623095,-29.137404596569272,101,100,102,91,-10,-11,-9,4,-2.4450854300091813,-2.287043777694414,-2.1288979015387115,-0.45513411119551445,7185,7237,Davis+Jefferson+Van Buren+Wapello,Van Buren,19,177,Iowa,IA
19179,19CS011,358,343,373,456,98,83,113,95,-0.3695831247500772,0.08998282121205507,0.47961685592375347,0.9601018431955379,439,420,457,468,29,11,48,60,-1.6367853305482325,-1.0454994430014612,-0.4156553468139332,1.9782244547530083,35304,35268,Davis+Jefferson+Van Buren+Wapello,Wapello,19,179,Iowa,IA
19057,19CS012,391,374,407,434,43,27,60,42,-0.41972269865905,0.018997269238526737,0.45210128198407157,0.9500825625383491,475,456,495,548,73,53,92,63,-0.32027117474215167,0.2758598826587035,0.9270287813010006,0.8568031474288434,38828,38541,Des Moines+Henry+Lee,Des Moines,19,57,Iowa,IA
19087,19CS012,190,181,199,246,56,47,65,35,0.5891522484114694,1.028295520073195,1.42136813945142,0.6165529543047537,234,223,244,250,16,6,27,23,-1.0171467640930871,-0.40397128095221296,0.2045076157353765,1.3346395368051556,20325,20391,Des Moines+Henry+Lee,Henry,19,87,Iowa,IA
19111,19CS012,365,350,379,439,74,60,89,33,0.7995053007677422,1.2412650150326654,1.6983997374625477,0.43776556797532024,443,426,460,509,66,49,83,75,-0.9115541236635073,-0.32271093826737746,0.30187049506372365,1.1189694522996767,33500,33258,Des Moines+Henry+Lee,Lee,19,111,Iowa,IA
19061,19CS013,794,751,837,867,73,30,116,151,-1.2450657956212916,-0.785917476863294,-0.34593731255444543,2.0418319019208586,974,923,1025,1050,76,25,127,100,-0.8694221689920233,-0.27869640603457946,0.3354172664056747,1.2965459843692013,98914,98793,Dubuque,Dubuque,19,61,Iowa,IA
19069,19CS014,103,102,104,135,32,31,33,18,1.2621214196350814,1.3572386662121465,1.4566478018884248,0.5528005024724273,127,125,128,168,41,40,43,16,2.9004995957208943,3.0607827513504193,3.2133856081670507,0.3776432804530628,9994,9957,Franklin+Hamilton+Hardin+Wright,Franklin,19,69,Iowa,IA
19079,19CS014,161,155,168,176,15,8,21,33,-1.671460539728265,-1.2077987392096556,-0.7851607555200705,2.1081925702312927,197,189,205,193,-4,-12,4,22,-2.7396076743164,-2.0992134832517,-1.4631217607993345,-6.934388196168863,14974,14906,Franklin+Hamilton+Hardin+Wright,Hamilton,19,79,Iowa,IA
19083,19CS014,188,181,195,215,27,20,34,28,-0.47197435918485686,-0.04912083399594219,0.4097739881038633,0.9917885768764874,229,221,238,280,51,42,59,15,1.9510310072919088,2.573283422763955,3.189046655937276,0.2904075030890927,16807,16724,Franklin+Hamilton+Hardin+Wright,Hardin,19,83,Iowa,IA
19197,19CS014,159,153,164,161,2,-3,8,23,-2.01592258781163,-1.6039957475487547,-1.166744176829168,6.712257258492758,193,187,200,189,-4,-11,2,25,-3.3720327945890762,-2.727467602899801,-2.076526067474208,-7.634506824929306,12848,12804,Franklin+Hamilton+Hardin+Wright,Wright,19,197,Iowa,IA
19071,19CS015,77,76,77,70,-7,-7,-6,5,-1.8575565761351545,-1.754575433979276,-1.6705472169781408,-0.8879536161695175,93,92,94,97,4,3,5,12,-1.6448775344482072,-1.497928968335555,-1.3504546184904804,2.500022972574766,6613,6566,Fremont+Harrison+Mills+Pottawattamie,Fremont,19,71,Iowa,IA
19085,19CS015,169,162,175,235,66,60,73,61,-0.08111842942309212,0.36148152752094814,0.8047692834453127,0.9059418330736484,208,200,215,193,-15,-22,-7,20,-3.4332932651709775,-2.832388910237097,-2.213773301424612,-1.4810812119284629,14484,14651,Fremont+Harrison+Mills+Pottawattamie,Harrison,19,85,Iowa,IA
19129,19CS015,112,110,113,136,24,23,26,16,0.4510611089509589,0.5530244907780955,0.6587169928610046,0.6387029142030606,137,135,139,156,19,17,21,15,0.17413768930195309,0.33097254551804944,0.47889183218194437,0.7515149477205216,14516,14456,Fremont+Harrison+Mills+Pottawattamie,Mills,19,129,Iowa,IA
19155,19CS015,807,767,847,994,187,147,227,111,0.4045847414172335,0.8114774289307778,1.2395498028353114,0.5905184232781068,987,939,1036,1137,150,101,198,117,-0.24448647328568843,0.41994452609175503,1.0492535113493016,0.7769940579821955,93511,93341,Fremont+Harrison+Mills+Pottawattamie,Pottawattamie,19,155,Iowa,IA
19099,19CS016,337,321,354,388,51,34,67,58,-0.6233781717129127,-0.20453230444035034,0.24314217029078544,1.1229039607007356,413,393,432,448,35,16,55,29,-0.45025110652876205,0.20014297740881803,0.8410321242440182,0.8026561502001899,37706,37770,Jasper+Poweshiek,Jasper,19,99,Iowa,IA
19157,19CS016,185,177,193,194,9,1,17,25,-1.3127569502908458,-0.8717983901198628,-0.4536838076630072,2.6231476468715687,226,216,236,245,19,9,29,25,-1.0015722769535944,-0.4167389425506676,0.2110325209815637,1.255289412031321,18610,18594,Jasper+Poweshiek,Poweshiek,19,157,Iowa,IA
19103,19CS017,651,585,717,727,76,10,142,53,-0.27877278903251257,0.15541366598250583,0.5488485301607537,0.6889975286935344,821,741,901,902,81,1,161,59,-0.45984442125823355,0.1577393076222415,0.8008717349800066,0.7192526777427588,153094,154491,Johnson,Johnson,19,103,Iowa,IA
19113,19CS018,1565,1466,1664,1921,356,257,455,266,-0.0699808204353341,0.39704973337103555,0.7851210107630415,0.7454430557741062,1922,1804,2040,2074,152,34,270,177,-0.7495396277376607,-0.12404721249828539,0.4935945825769886,1.157148854792764,229684,229132,Linn,Linn,19,113,Iowa,IA
19115,19CS019,93,92,94,111,18,17,19,30,-1.1877254061205682,-1.0793344661486304,-0.9765061742035155,1.5549872288276723,113,112,114,122,9,8,10,20,-1.3849396323209544,-1.2372711414997706,-1.0837801334650314,2.016733703014588,10837,10757,Louisa+Muscatine,Louisa,19,115,Iowa,IA
19139,19CS019,357,338,375,431,74,56,93,79,-0.5335948809822592,-0.11901388374181587,0.3202689313041047,1.0493404253369962,436,414,458,484,48,26,70,45,-0.4906155560469843,0.09289923296884893,0.6727751215797181,0.9108186849536529,42990,42750,Louisa+Muscatine,Muscatine,19,139,Iowa,IA
19007,19CS020,147,142,153,180,33,27,38,40,-0.9852029154493003,-0.5837858212598682,-0.17031524268327417,1.1839489593124157,178,172,184,187,9,3,15,16,-1.3083885826498054,-0.6708081244359995,-0.07765534134557962,1.5924853075721852,12315,12261,Lucas and Nearby Counties,Appanoose,19,7,Iowa,IA
19039,19CS020,97,96,98,100,3,2,4,4,-0.2419653118903566,-0.1273357683148504,-0.03474440177445844,1.0847016249518358,120,119,121,158,38,37,39,22,1.7795985908500316,1.930539717867791,2.0891557426084817,0.5676473057878879,9682,9776,Lucas and Nearby Counties,Clarke,19,39,Iowa,IA
19053,19CS020,70,70,71,76,6,5,6,2,0.3581846084152482,0.4665673392813609,0.5686171446247302,0.30467442847583376,86,85,87,99,13,12,14,15,-0.5240490170341026,-0.3521494321363346,-0.19921231878061632,1.0914690176844075,7650,7652,Lucas and Nearby Counties,Decatur,19,53,Iowa,IA
19117,19CS020,95,94,96,98,3,2,4,11,-1.0442809056281006,-0.9464539294524278,-0.8426428224726805,2.8529715156922477,117,116,119,125,8,6,9,12,-0.7683021063035722,-0.6093092236496052,-0.46222310206441053,1.401008268767955,8617,8696,Lucas and Nearby Counties,Lucas,19,117,Iowa,IA
19135,19CS020,84,84,85,101,17,16,17,16,-0.009384628776045708,0.09122953421054729,0.1926405728198666,0.9045756351892824,103,102,104,109,6,5,7,17,-1.9328826573199562,-1.7687508224825335,-1.6209182949740764,2.501547407030945,7599,7606,Lucas and Nearby Counties,Monroe,19,135,Iowa,IA
19185,19CS020,74,73,75,94,20,19,21,17,0.35765234545840685,0.47173248992459393,0.5690349662956724,0.8076483911825456,91,90,91,86,-5,-5,-4,7,-2.295247755877785,-2.1387136927796475,-1.9929091327287334,-1.9361577672319572,6495,6508,Lucas and Nearby Counties,Wayne,19,185,Iowa,IA
19119,19CS021,95,93,96,112,17,16,19,35,-1.5764312426414118,-1.4773566833769847,-1.3843306427730808,1.9024434505708405,117,115,118,94,-23,-24,-21,3,-2.717697861833301,-2.5616983123335118,-2.403258418844124,-0.13881604215146268,11911,11997,Lyon+O'Brien+Osceola+Sioux,Lyon,19,119,Iowa,IA
19141,19CS021,172,166,178,220,48,42,54,50,-0.5059006197614168,-0.11914155178930273,0.31649885687686496,1.0117932631893645,207,200,214,183,-24,-31,-17,11,-3.579162028323541,-3.002938343365679,-2.440526084866739,-0.473186124761814,14087,14035,Lyon+O'Brien+Osceola+Sioux,O'Brien,19,141,Iowa,IA
19143,19CS021,61,61,62,71,10,9,10,10,-0.16148446989998708,-0.05301385405273771,0.04351828547892366,0.9365714357538121,75,74,76,91,16,15,17,4,2.1738484948353434,2.317740982796307,2.4859542859505197,0.23642842252574975,6153,6163,Lyon+O'Brien+Osceola+Sioux,Osceola,19,143,Iowa,IA
19167,19CS021,213,198,229,279,66,50,81,63,-0.3430542047259348,0.08162014678175422,0.49559093892754963,0.9421045739222957,263,244,281,257,-6,-24,13,13,-1.2632535570074115,-0.621056679610001,-0.027196179440725957,-2.8849436182812913,35737,35890,Lyon+O'Brien+Osceola+Sioux,Sioux,19,167,Iowa,IA
19121,19CS022,143,136,150,122,-21,-28,-14,10,-2.320791102005476,-1.890617784106467,-1.4801287379173493,-0.4928096174390045,177,168,186,180,3,-6,12,15,-1.4452856538415226,-0.8301800239103085,-0.25963793813309044,3.6225329183162436,16590,16752,Madison+Warren,Madison,19,121,Iowa,IA
19181,19CS022,381,359,404,423,42,19,64,48,-0.5165851777269298,-0.11728332482282362,0.30630739300652104,1.1204061925018358,475,447,502,534,59,32,87,62,-0.7307761820897004,-0.05087950630333713,0.5705178492423165,1.0266773303677927,52491,53277,Madison+Warren,Warren,19,181,Iowa,IA
19123,19CS023,205,195,214,250,45,36,55,38,-0.07558712682760142,0.3437273212826453,0.7702469004965616,0.8184451668857279,250,239,261,274,24,13,35,34,-1.1409582583735003,-0.5445742371321758,0.10112199854217072,1.3557190526936014,22172,22008,Mahaska+Marion,Mahaska,19,123,Iowa,IA
19125,19CS023,297,283,311,329,32,18,46,51,-1.0144342300766358,-0.5664751053773157,-0.15497812296966873,1.549186115975723,366,348,383,370,4,-13,22,45,-2.085907686156419,-1.4715774173778582,-0.8370279055229775,8.532912167617798,33363,33380,Mahaska+Marion,Marion,19,125,Iowa,IA
19127,19CS024,409,392,426,467,58,41,75,60,-0.47664251462506446,-0.05995080699049281,0.3694111281756437,1.019235935390108,499,479,520,531,32,11,52,26,-0.40770602000426587,0.16276164275728572,0.7630818536500947,0.7977679103861287,39952,39883,Marshall+Tama,Marshall,19,127,Iowa,IA
19171,19CS024,178,171,185,222,44,37,51,56,-1.1202027323064863,-0.7123048763470544,-0.2781218843022343,1.2464241881870128,216,207,225,216,-0,-9,9,20,-1.9997385313374854,-1.4171101054242365,-0.837257532926411,22.271468661031747,17026,16897,Marshall+Tama,Tama,19,171,Iowa,IA
19037,19CS025,115,114,116,133,18,17,19,11,0.48425952346664924,0.574313113421777,0.6760898146991404,0.5820661768200489,141,139,142,146,5,4,7,13,-0.9282685685153411,-0.7737512002991891,-0.62592685319228,2.0530383671309886,11957,11899,Mitchell and Nearby Counties,Chickasaw,19,37,Iowa,IA
19067,19CS025,154,147,161,202,48,41,55,30,0.7126649849845228,1.1544358384431288,1.6068768292251334,0.6142748368254118,188,180,196,199,11,3,19,17,-1.1117643118013227,-0.45177130467255755,0.19021734882954827,1.4025033202179742,15553,15433,Mitchell and Nearby Counties,Floyd,19,67,Iowa,IA
19089,19CS025,102,101,103,99,-3,-4,-2,15,-2.001203611844093,-1.8943489815757386,-1.788814688617246,-8.027536706612127,126,124,127,133,7,6,9,7,-0.10951659771110765,0.059047446203197546,0.20642871003942448,0.8278768973606381,9436,9479,Mitchell and Nearby Counties,Howard,19,89,Iowa,IA
19131,19CS025,117,116,118,129,12,11,13,37,-2.4424205566420434,-2.3470163134077056,-2.2520108740256375,2.8056199187127278,143,142,144,150,7,6,8,2,0.40566227562940127,0.5605281153582616,0.7151332084518492,0.25126543434279436,10577,10559,Mitchell and Nearby Counties,Mitchell,19,131,Iowa,IA
19195,19CS025,72,71,73,59,-13,-14,-12,5,-2.525435891753155,-2.4306341223126617,-2.3283318949619143,-0.4160207560688371,88,87,89,99,11,10,12,6,0.6485888745127191,0.8006964570154087,0.9496205103046105,0.5047524515985677,7418,7391,Mitchell and Nearby Counties,Worth,19,195,Iowa,IA
19041,19CS026,165,158,172,187,22,15,29,16,-0.052973656830606994,0.3567633563248599,0.810476369983758,0.6987953431927046,203,194,211,198,-5,-13,4,20,-2.4335208478761774,-1.786962520673849,-1.1293097449905076,-5.6739470416456905,16309,16424,Palo Alto and Nearby Counties,Clay,19,41,Iowa,IA
19059,19CS026,179,172,187,197,18,10,25,28,-1.0046517143659712,-0.5970339405698947,-0.174310811456771,1.5034054214788735,220,211,229,216,-4,-13,5,27,-2.7141500902044724,-2.0885505678156204,-1.4641411893032366,-8.630707901828519,17691,17836,Palo Alto and Nearby Counties,Dickinson,19,59,Iowa,IA
19063,19CS026,104,103,105,132,28,27,29,32,-0.5627604198502317,-0.46508840624373476,-0.36532631638731466,1.1159788912393387,128,127,129,131,3,2,4,14,-1.5632392462552098,-1.409863008461133,-1.2751302798591142,3.5062145062193055,9315,9323,Palo Alto and Nearby Counties,Emmet,19,63,Iowa,IA
19109,19CS026,152,146,159,175,23,16,29,44,-1.8562718875080793,-1.4456379792154757,-1.0301206035100812,1.8682432155706612,184,176,191,219,35,28,43,30,-0.17046816551815328,0.4434112012973079,1.0693978216116484,0.8221143804700042,14757,14566,Palo Alto and Nearby Counties,Kossuth,19,109,Iowa,IA
19147,19CS026,109,108,110,119,10,9,11,11,-0.18679506333534676,-0.08692487739610306,0.012884220613222126,0.9810254513367629,133,132,134,139,6,5,7,22,-2.2787189021968906,-2.13877876373135,-1.9935314157241382,3.0842080799164515,8942,8914,Palo Alto and Nearby Counties,Palo Alto,19,147,Iowa,IA
19021,19CS027,166,157,175,175,9,-0,18,31,-1.5029656080598242,-1.0650704898933772,-0.6314481329151095,3.14739030827727,205,195,216,184,-21,-32,-11,14,-2.714186783478978,-2.0268952350944067,-1.402357321595578,-0.6885731756849681,20617,20772,Pocahontas and Nearby Counties,Buena Vista,19,21,Iowa,IA
19025,19CS027,116,115,117,111,-5,-6,-4,4,-1.0598627185444796,-0.9627175813158918,-0.8594265986278412,-0.8941865965291237,143,142,145,145,2,0,3,10,-1.1697088941186744,-1.0158138757318482,-0.8594986413457305,3.836660014213546,9850,9911,Pocahontas and Nearby Counties,Calhoun,19,25,Iowa,IA
19091,19CS027,98,97,99,106,8,7,9,20,-1.3369315371922208,-1.2359297783458585,-1.1382269776810288,2.190590373455017,120,119,122,129,9,7,10,10,-0.32922751033593983,-0.17784418673141336,-0.01325916379356671,1.041649261128747,9585,9628,Pocahontas and Nearby Counties,Humboldt,19,91,Iowa,IA
19151,19CS027,84,84,85,95,11,10,11,15,-0.7360436988081582,-0.6339279864348419,-0.5322520957858403,1.2983703224123746,104,103,105,111,7,6,8,10,-0.6999480175406381,-0.5534356886184372,-0.4118530242739572,1.2909509652270936,7010,7074,Pocahontas and Nearby Counties,Pocahontas,19,151,Iowa,IA
19161,19CS027,115,114,116,128,13,12,14,15,-0.3384987445574073,-0.2410976577675706,-0.13609485554512016,1.0996475933314847,141,140,142,151,10,9,11,12,-0.3972293949997749,-0.24378028685734915,-0.09832752090187026,1.0878571048810406,9770,9758,Pocahontas and Nearby Counties,Sac,19,161,Iowa,IA
19187,19CS027,374,358,390,469,95,79,111,68,0.31453035118994405,0.7298885607900963,1.1297457142896428,0.7081425930887868,461,441,480,510,49,30,69,47,-0.5182883016078554,0.08862302369726892,0.6842179075949694,0.9318653980353887,36832,37119,Pocahontas and Nearby Counties,Webster,19,187,Iowa,IA
19153,19CS028,3158,2946,3370,3754,596,384,808,437,-0.12793875361978133,0.32214349121324953,0.7610200134196068,0.7316845819848339,3925,3669,4181,4340,415,159,671,380,-0.5371633260708584,0.0765002615419136,0.685392316507975,0.9137261228983887,492940,496250,Polk,Polk,19,153,Iowa,IA
19163,19CS029,1322,1247,1397,1594,272,197,347,178,0.10061377355239468,0.5347691798130345,0.9695819173621548,0.6530430706788527,1625,1535,1715,1820,195,105,285,133,-0.16952470433086347,0.43362059327713676,1.042468128653662,0.6797067330849101,174296,174216,Scott,Scott,19,163,Iowa,IA
19169,19CS030,481,438,523,477,-4,-46,39,35,-0.8205943762373135,-0.3942380041321769,0.008321122897265458,-12.72023706142491,604,553,655,627,23,-28,74,26,-0.7019899416998745,-0.03170730352190905,0.6189856147352127,1.0784939385030594,98533,99347,Story,Story,19,169,Iowa,IA
19003,19CS031,37,37,38,40,3,2,3,5,-0.7417801647230465,-0.6419365699231175,-0.5391870912979831,1.3709750790076662,45,45,46,62,17,16,17,6,3.342790494238551,3.4906611758741812,3.645201904466245,0.34048037243128043,3677,3649,Taylor and Nearby Counties,Adams,19,3,Iowa,IA
19137,19CS031,141,136,145,169,28,24,33,30,-0.6054122860599875,-0.17228297344821844,0.23629226426451877,1.0244532896745373,172,167,178,159,-13,-19,-8,15,-3.865158349276846,-3.294482448010537,-2.6477923617294934,-1.2294827110390028,10273,10324,Taylor and Nearby Counties,Montgomery,19,137,Iowa,IA
19145,19CS031,177,170,183,189,12,6,19,15,-0.6190531782848167,-0.18016004190540522,0.2681311795454788,1.1379443627295125,217,209,225,219,2,-6,10,18,-1.8485873574922165,-1.2193444707270698,-0.6227208332125794,5.46063035974783,15174,15195,Taylor and Nearby Counties,Page,19,145,Iowa,IA
19159,19CS031,64,64,65,93,29,28,29,8,4.325065353026527,4.426525511056755,4.517981425004609,0.2696732288510004,78,77,79,87,9,8,10,16,-1.975184933495156,-1.8263892631882657,-1.6613144321147542,1.6110579397068894,4672,4639,Taylor and Nearby Counties,Ringgold,19,159,Iowa,IA
19173,19CS031,62,62,63,79,17,16,17,5,1.90761528206392,2.008387439185721,2.109090784118865,0.27978454323896823,75,75,76,105,30,29,30,11,3.640401046000241,3.7859179828208953,3.928676210026121,0.36061253094287066,5909,5867,Taylor and Nearby Counties,Taylor,19,173,Iowa,IA
19175,19CS031,129,124,135,151,22,16,27,23,-0.5588257127390072,-0.11452341843690124,0.319046880971778,1.0184252588168576,158,152,164,172,14,8,20,13,-0.5128415150985539,0.11701077973083662,0.7606962041015716,0.8566322412491808,12107,12030,Taylor and Nearby Counties,Union,19,175,Iowa,IA
19035,19CS032,151,146,156,152,1,-4,6,25,-2.499460704965354,-2.061241631686108,-1.6619838592263094,12.051383060856784,182,176,188,172,-10,-16,-4,17,-3.4530566248911203,-2.8597352847657733,-2.2313379249611285,-1.7998031947139297,11560,11522,West Central Iowa,Cherokee,19,35,Iowa,IA
19047,19CS032,149,142,156,169,20,13,27,23,-0.6283447916939663,-0.1843435926652186,0.2494801508523928,1.0944848750998208,180,171,188,158,-22,-30,-13,20,-3.6777645124971863,-3.0631763692950402,-2.4093682869260724,-0.9748404671789739,16492,16231,West Central Iowa,Crawford,19,47,Iowa,IA
19093,19CS032,88,87,88,117,29,29,30,31,-0.3224488790220875,-0.2211312835333587,-0.12545791836427603,1.0173630039425006,107,106,108,96,-11,-12,-10,6,-3.097337429193303,-2.9508999405350465,-2.8042890570460033,-0.5924818779631827,6975,6963,West Central Iowa,Ida,19,93,Iowa,IA
19133,19CS032,118,117,119,154,36,35,37,17,2.0408906499683637,2.137789316423678,2.243877101337115,0.464220829274888,143,142,144,157,14,13,15,22,-1.3066849389600603,-1.1477448833977146,-0.9919124958753185,1.488031068809452,8708,8598,West Central Iowa,Monona,19,133,Iowa,IA
19149,19CS032,210,199,221,262,52,41,63,64,-0.9292253315582489,-0.47186469428371336,-0.047771756190747326,1.2145641885599323,258,244,271,250,-8,-21,6,19,-1.9399957683498328,-1.2449745960877856,-0.5921187117020051,-2.883101505631603,25608,25655,West Central Iowa,Plymouth,19,149,Iowa,IA
19193,19CS032,851,806,896,1064,213,168,258,175,-0.10762386811775909,0.3566466446108976,0.8152997804195092,0.8175802353406435,1043,988,1097,1084,41,-13,96,91,-1.1502570315185547,-0.5723367900165228,0.05570624754906738,2.1449650063631087,105413,105639,West Central Iowa,Woodbury,19,193,Iowa,IA
20001,20CS001,143,137,148,129,-14,-19,-8,4,-1.8544556004416994,-1.4260689509845588,-0.9873723488462087,-0.31238527285703876,173,166,179,199,26,20,33,27,-0.7152927250981383,-0.059067777168759036,0.5656298087618443,0.9882124498355571,12510,12475,Allen+Anderson+Franklin+Osage,Allen,20,1,Kansas,KS
20003,20CS001,88,87,89,90,2,1,3,5,-0.4484737358062187,-0.3585510389597755,-0.2503081135506309,1.563651085328178,106,106,107,103,-3,-4,-3,21,-3.922795374208679,-3.7803098669817956,-3.6187562964067554,-8.40154833741198,7850,7788,Allen+Anderson+Franklin+Osage,Anderson,20,3,Kansas,KS
20059,20CS001,232,220,243,269,37,26,49,21,0.1936072964353397,0.6274322883668647,1.0748706181914058,0.5469939637731599,282,268,295,338,56,43,70,40,0.13407257319235655,0.7385690686625676,1.4020899634499646,0.7004932025106696,25964,25992,Allen+Anderson+Franklin+Osage,Franklin,20,59,Kansas,KS
20139,20CS001,164,157,170,230,66,60,73,23,2.319145285697287,2.761050919046813,3.1811897556724174,0.34133338389615075,199,191,207,232,33,25,41,23,0.1485364728938147,0.7504159351675259,1.384633495959881,0.6748451976613137,15755,15762,Allen+Anderson+Franklin+Osage,Osage,20,139,Kansas,KS
20011,20CS002,163,157,169,181,18,12,24,17,-0.36517727182815907,0.08747194009911265,0.5225897949328495,0.8918740960051428,197,190,204,213,16,9,23,34,-2.0727113454228756,-1.501373341404973,-0.885618322658664,1.989538752174609,14356,14324,Bourbon+Linn+Miami,Bourbon,20,11,Kansas,KS
20107,20CS002,93,92,94,122,29,28,30,5,2.348678312229259,2.4515606102564025,2.548926825995719,0.16922996142382715,115,114,117,166,51,49,52,24,3.125577656222851,3.2737229184647125,3.4298379990534578,0.4658527387172397,9618,9723,Bourbon+Linn+Miami,Linn,20,107,Kansas,KS
20121,20CS002,254,240,269,292,38,23,52,23,0.03075485512754327,0.4390970724304327,0.8384139897946441,0.5971245642872263,312,294,330,419,107,89,125,61,0.9644035783807988,1.5972336551957296,2.2199699293980935,0.5648005767199342,34235,34533,Bourbon+Linn+Miami,Miami,20,121,Kansas,KS
20005,20CS003,155,148,162,146,-9,-16,-2,3,-1.1941599907482248,-0.7528566904840207,-0.33648605340663584,-0.3633982468542072,189,181,198,218,29,20,37,26,-0.4249058601120738,0.18294039085592897,0.7814319312185681,0.879835424084864,16274,16249,Brown and Nearby Counties,Atchison,20,5,Kansas,KS
20013,20CS003,111,110,111,147,36,36,37,31,0.48243768801680154,0.5786617039907213,0.6844661983535127,0.8269391395965993,136,134,137,157,21,20,23,11,1.1536653040404747,1.3132139868621548,1.4607815010263645,0.49234003258053594,9481,9458,Brown and Nearby Counties,Brown,20,13,Kansas,KS
20043,20CS003,76,75,77,92,16,15,17,10,0.7353377535027021,0.8323533055030982,0.9347685852462648,0.5797858337487777,93,92,94,111,18,17,19,17,-0.020110054578706262,0.12999947476378027,0.2737586606213142,0.9038804526070239,7486,7471,Brown and Nearby Counties,Doniphan,20,43,Kansas,KS
20085,20CS003,130,125,136,125,-5,-11,0,12,-1.7407914394439767,-1.2938637633714116,-0.904616810027469,-2.7433720141208457,160,153,166,159,-1,-7,6,14,-1.941508802532824,-1.316388850523846,-0.7527277245344476,40.594941601508765,13224,13256,Brown and Nearby Counties,Jackson,20,85,Kansas,KS
20087,20CS003,158,151,166,180,22,14,29,23,-0.5382173454077073,-0.08491599590255698,0.36751532914851526,1.0221252213208498,194,185,204,204,10,0,19,27,-1.7653577839794172,-1.1187200293228596,-0.4899553313897808,2.5112519449908146,18438,18395,Brown and Nearby Counties,Jefferson,20,87,Kansas,KS
20117,20CS003,118,117,119,123,5,4,6,24,-1.9617047921012474,-1.8692670829876397,-1.76405288363534,3.7403516002978785,145,144,146,132,-13,-14,-12,14,-3.403235066451895,-3.2396234613224117,-3.0907539564716684,-1.16887764133717,9963,9984,Brown and Nearby Counties,Marshall,20,117,Kansas,KS
20131,20CS003,114,112,115,158,44,43,46,42,0.13802724101910788,0.24409314703524285,0.34174251447261983,0.9233087505706131,140,139,141,123,-17,-18,-16,7,-2.9569118919797486,-2.800519416586324,-2.6443103823344787,-0.441976687567175,10211,10216,Brown and Nearby Counties,Nemaha,20,131,Kansas,KS
20015,20CS004,562,533,591,638,76,47,105,38,0.13915525649793692,0.5453984013628985,1.027014064653472,0.49558795546583007,695,660,730,790,95,60,130,101,-0.7954733707057966,-0.10760033005097656,0.49951186449044005,1.0539540901024969,67383,67818,Butler+Harvey,Butler,20,15,Kansas,KS
20079,20CS004,344,330,359,380,36,21,50,40,-0.5829776637061153,-0.12519736880757054,0.2919215220992029,1.0877404770691588,420,402,437,512,92,75,110,61,0.5296351669919148,1.125563817208912,1.7515190065719601,0.6536021878219295,34002,33835,Butler+Harvey,Harvey,20,79,Kansas,KS
20009,20CS005,241,230,252,306,65,54,76,36,0.7259228668446867,1.1406994795358214,1.5691126503047859,0.5437147666458105,291,278,304,368,77,64,90,50,0.6475598681145708,1.2568185304647608,1.9116405158350211,0.6426260572112116,25474,25246,Central Kansas,Barton,20,9,Kansas,KS
20051,20CS005,207,194,219,259,52,40,65,57,-0.6224072041260063,-0.1459911037081535,0.27470503785205724,1.0689524489993651,252,238,267,235,-17,-32,-3,18,-2.0851978719180075,-1.473444363724697,-0.805509838336589,-1.098548944098246,28876,28811,Central Kansas,Ellis,20,51,Kansas,KS
20053,20CS005,72,71,73,92,20,19,21,17,0.35540645087267597,0.45795157906809986,0.5577730902336265,0.8137679562347273,89,88,89,83,-6,-6,-5,8,-2.7095699301047658,-2.557629397023697,-2.412401517102897,-1.769543218917252,6314,6339,Central Kansas,Ellsworth,20,53,Kansas,KS
20113,20CS005,324,311,337,356,32,19,45,48,-0.9602242761691085,-0.5253245843393292,-0.11825534312994983,1.4507984243208283,396,380,411,422,26,11,42,46,-1.4263734708739413,-0.7761473645805386,-0.17710208704707014,1.6772331718582671,29929,30148,Central Kansas,McPherson,20,113,Kansas,KS
20159,20CS005,100,99,101,107,7,6,8,10,-0.4289158615266148,-0.33263930529010693,-0.23056839241161262,1.26573793115493,122,121,124,144,22,20,23,15,0.6956741474017059,0.8491336089280218,1.0041739507277818,0.6621338839174431,9396,9388,Central Kansas,Rice,20,159,Kansas,KS
20167,20CS005,75,74,76,120,45,44,46,19,3.7946743835082692,3.894269772940746,3.986528107520323,0.41196002317680774,92,91,92,85,-7,-7,-6,13,-3.655505758686048,-3.4903597671197892,-3.3399607577231616,-2.3625009225248754,6704,6698,Central Kansas,Russell,20,167,Kansas,KS
20017,20CS006,28,28,28,21,-7,-7,-7,1,-3.2922734871601484,-3.1939400838862064,-3.0840133626225437,-0.16113546927515193,35,35,35,32,-3,-3,-3,5,-3.7764244366073325,-3.629690834581597,-3.475949970318348,-2.719744322801356,2571,2593,Chase+Coffey+Lyon+Marion,Chase,20,17,Kansas,KS
20031,20CS006,86,85,87,89,3,2,4,8,-0.7271121791098274,-0.6182777089740095,-0.5251333819924483,2.080276586715121,106,105,107,111,5,4,6,15,-1.5395127778047206,-1.3833552853644149,-1.2341402311027243,2.3630733138277193,8333,8343,Chase+Coffey+Lyon+Marion,Coffey,20,31,Kansas,KS
20111,20CS006,240,226,253,323,83,70,97,68,0.037000304478924516,0.46875323978502226,0.8731170032279437,0.8057321052316374,294,277,310,320,26,10,43,30,-0.7778602892642124,-0.13423647587406803,0.5098117885703787,1.0911521259315646,32253,32013,Chase+Coffey+Lyon+Marion,Lyon,20,111,Kansas,KS
20115,20CS006,148,143,153,133,-15,-20,-10,10,-2.5025029652137625,-2.1042193381180265,-1.643247744868901,-0.7285446799635694,179,173,186,222,43,36,49,29,0.8023737247142925,1.4005589894090678,1.9937304685434536,0.6660444068879747,11761,11718,Chase+Coffey+Lyon+Marion,Marion,20,115,Kansas,KS
20021,20CS007,228,220,236,271,43,35,51,26,0.4407558419674881,0.8823578366278617,1.296412786461093,0.5911796880678921,278,268,288,310,32,22,42,43,-1.295102614888325,-0.6623490960359554,-0.10616756019588074,1.2911196589268008,19358,19151,Cherokee+Crawford,Cherokee,20,21,Kansas,KS
20037,20CS007,379,362,396,484,105,88,122,53,0.9165798273208933,1.32951913015204,1.7767427364915023,0.5001385857567033,470,449,490,518,48,28,69,63,-1.1066021017025098,-0.43506979287175174,0.17760971110218107,1.2737231732314687,38920,39084,Cherokee+Crawford,Crawford,20,37,Kansas,KS
20027,20CS008,84,83,85,90,6,5,7,17,-1.4353929465786417,-1.3361562803490632,-1.2312434552235019,2.3624716428252217,102,101,103,113,11,10,12,10,0.0013653384940867598,0.15895568024876516,0.3057658048574771,0.8307961159608063,8093,8082,Cloud and Nearby Counties,Clay,20,27,Kansas,KS
20029,20CS008,117,116,118,128,11,10,12,21,-1.2328472176033474,-1.1361602231420211,-1.037790169367587,1.7744520586169164,142,141,144,157,15,13,16,17,-0.4790821451239685,-0.3275201616665355,-0.18819396312770753,1.0946392440048358,8951,8937,Cloud and Nearby Counties,Cloud,20,29,Kansas,KS
20089,20CS008,32,32,32,31,-1,-1,-1,1,-0.7558495430980233,-0.6475094127788277,-0.5490765166315197,8.456737704086962,39,39,39,59,20,20,20,11,3.5009945130270195,3.6438121267653107,3.8073194914583377,0.5258733682372274,2917,2935,Cloud and Nearby Counties,Jewell,20,89,Kansas,KS
20105,20CS008,30,29,30,39,9,9,10,5,1.3841823356424618,1.4841231308577694,1.5806871542447463,0.4823994207482468,36,35,36,40,4,4,5,4,-0.019033909322006173,0.13594716990243924,0.2856504243001152,0.7509635076509692,2945,2909,Cloud and Nearby Counties,Lincoln,20,105,Kansas,KS
20123,20CS008,68,67,68,76,8,8,9,4,0.6238288572375617,0.7304027735564873,0.8363815348283411,0.4331041679713745,82,81,83,97,15,14,16,12,0.48899183852026756,0.6374449768641411,0.7816812970469311,0.7478292085638206,5792,5750,Cloud and Nearby Counties,Mitchell,20,123,Kansas,KS
20141,20CS008,49,49,50,48,-1,-2,-1,4,-1.6571657562265836,-1.5614061074053798,-1.4551188714395966,-9.144434907442092,60,60,61,59,-1,-2,-1,7,-3.040820410075331,-2.8766540269298457,-2.720692526082099,-17.55053256550058,3486,3497,Cloud and Nearby Counties,Osborne,20,141,Kansas,KS
20143,20CS008,61,60,61,64,3,3,4,11,-1.4578548337887918,-1.361557834910076,-1.251735222947661,2.6211556730892807,75,74,76,75,-0,-1,1,10,-2.2317836657616343,-2.0846069543887213,-1.9358967103816571,11.526158121081524,5741,5823,Cloud and Nearby Counties,Ottawa,20,143,Kansas,KS
20157,20CS008,69,69,70,65,-4,-5,-4,10,-3.2050664785911325,-3.102189802132821,-2.998152626358484,-2.8995189949807534,85,84,85,86,1,1,2,7,-1.595429839471149,-1.4473590362056965,-1.3046473128531162,2.961053137448572,4661,4665,Cloud and Nearby Counties,Republic,20,157,Kansas,KS
20183,20CS008,47,47,47,43,-4,-4,-4,5,-2.6015243798157544,-2.5034718930440816,-2.4039964577836073,-1.7112668839386986,57,57,58,55,-2,-3,-2,2,-1.5966835386154654,-1.454573746456344,-1.3100190320265226,-1.5102468419927622,3563,3574,Cloud and Nearby Counties,Smith,20,183,Kansas,KS
20201,20CS008,60,60,61,66,6,5,6,10,-0.8394594451482842,-0.7361903584062165,-0.6346022986206478,1.440310929640493,73,72,74,83,10,9,11,10,-0.1766226990962495,-0.034840623164475996,0.10459379751492048,0.9229979174005868,5513,5513,Cloud and Nearby Counties,Washington,20,201,Kansas,KS
20041,20CS009,198,190,206,203,5,-3,13,23,-1.4154863995044635,-0.9791015609184965,-0.5451674679414844,3.7513372733300736,242,233,252,285,43,33,52,47,-0.8951384268622455,-0.26927314919626916,0.3505506138760227,1.0723989653106367,18368,18444,Dickinson+Geary+Morris,Dickinson,20,41,Kansas,KS
20061,20CS009,195,179,211,214,19,3,35,26,-0.6594928925952968,-0.18962748664743462,0.22368127886983963,1.2947852566751867,240,222,259,273,33,14,51,40,-0.85701084558385765,-0.23280507678317827,0.3668574213469826,1.1831416063616451,35969,36053,Dickinson+Geary+Morris,Geary,20,61,Kansas,KS
20127,20CS009,64,63,64,77,13,13,14,14,-0.2611982588278092,-0.156158927587463,-0.05408957484134743,0.9880196593256104,77,77,78,75,-2,-3,-2,2,-1.1356759912607266,-0.9857820890180737,-0.8289489189941143,-1.4268102201997497,5398,5357,Dickinson+Geary+Morris,Morris,20,127,Kansas,KS
20045,20CS010,622,571,673,729,107,56,158,53,0.010971490509452833,0.4459914561737331,0.8570547009335107,0.49069245993090355,773,711,834,848,75,14,137,40,-0.2645191387844374,0.3749622637437192,1.0013275985432175,0.5239811164440559,119375,119283,Douglas,Douglas,20,45,Kansas,KS
20019,20CS011,45,43,46,41,-4,-5,-2,5,-3.048054867131757,-2.5851213594709455,-2.145945706143774,-1.8519218452545885,55,53,57,65,10,8,12,10,-0.5424827767502794,0.058853601231158195,0.6839004633684466,0.8947021504626981,3360,3394,Elk and Nearby Counties,Chautauqua,20,19,Kansas,KS
20035,20CS011,370,355,384,429,59,45,74,63,-0.5144140520508962,-0.10536135264550972,0.30361482038110116,1.041873411134453,452,434,469,504,52,35,70,64,-1.023814735669816,-0.41494211879333687,0.138501437512067,1.1978897500698562,34540,34496,Elk and Nearby Counties,Cowley,20,35,Kansas,KS
20049,20CS011,33,32,34,36,3,2,4,2,0.08409218411143887,0.4820759691218976,0.9149239245902778,0.475239333951866,40,38,41,50,10,9,12,5,2.116620742427152,2.6902275378125684,3.2461564006364885,0.43537811786850655,2476,2446,Elk and Nearby Counties,Elk,20,49,Kansas,KS
20073,20CS011,82,81,82,87,5,5,6,5,-0.04030455738911733,0.06235772657162421,0.15865520180598824,0.7853954977293777,99,98,100,124,25,24,26,13,2.273981803583458,2.426824632530194,2.5754494754556254,0.49971066860139746,5973,5944,Elk and Nearby Counties,Greenwood,20,73,Kansas,KS
20205,20CS011,92,92,93,112,20,19,20,6,1.4748824376980307,1.5724084799866902,1.6789813655617707,0.29268165127430695,112,111,113,155,43,42,44,26,2.2064397933576183,2.353021352100108,2.508818515315135,0.594951799769354,8568,8533,Elk and Nearby Counties,Wilson,20,205,Kansas,KS
20207,20CS011,41,40,42,51,10,9,11,2,2.115467342310561,2.531852738698446,2.9737086624837765,0.1839756684756969,50,49,52,55,5,3,6,1,0.8665702291822811,1.514118911898729,2.1131735531411104,0.16989501696455697,3102,3102,Elk and Nearby Counties,Woodson,20,207,Kansas,KS
20091,20CS012,3547,3285,3810,3992,445,182,707,479,-0.4817198226529084,-0.0531592226447081,0.3787956260941919,1.0746116000071213,4416,4100,4733,4819,403,86,719,420,-0.7064249543849095,-0.037957898677550415,0.5641262399616167,1.0400612083379608,609709,612828,Johnson,Johnson,20,91,Kansas,KS
20099,20CS013,227,219,236,241,14,5,22,28,-1.1901518745543076,-0.7041040068353164,-0.28953877828269764,1.9056844914101823,276,266,287,303,27,16,37,39,-1.3686511620648358,-0.7311475436777937,-0.1373411045546096,1.4107815119097444,20037,19942,Labette+Montgomery+Neosho,Labette,20,99,Kansas,KS
20125,20CS013,365,351,378,412,47,34,61,41,-0.21829508974505835,0.20295899714966834,0.5984954505336173,0.8487176472748699,443,427,459,542,99,83,115,79,0.13085617176082026,0.766171851712107,1.4114259501142021,0.7907628961898966,31402,31186,Labette+Montgomery+Neosho,Montgomery,20,125,Kansas,KS
20133,20CS013,174,167,181,192,18,11,25,17,-0.34106950636000816,0.08113034663055119,0.5257814842461858,0.8796427255114597,211,203,219,241,30,22,38,39,-1.3227357755108307,-0.7267869083176313,-0.07591353156611752,1.270766362236503,15895,15802,Labette+Montgomery+Neosho,Neosho,20,133,Kansas,KS
20103,20CS014,549,514,584,669,120,85,155,63,0.23194702462943534,0.6936421737421488,1.1045223020342367,0.5206170665498634,679,636,721,793,114,72,157,88,-0.21316451763592145,0.37283235328439984,1.0578748505847555,0.7630350025476055,81909,82138,Leavenworth,Leavenworth,20,103,Kansas,KS
20023,20CS015,31,31,31,48,17,17,17,12,1.8496881542905663,1.9578952598390889,2.060237942511525,0.6618170508756417,38,38,38,41,3,3,3,6,-1.4718950400113853,-1.3280694081619628,-1.1807874648195282,1.4666886457324277,2622,2631,Northwest Kansas,Cheyenne,20,23,Kansas,KS
20039,20CS015,39,38,39,35,-4,-4,-3,5,-3.2548625302329612,-3.15049528106575,-3.0443536669658453,-1.8615080542576004,47,47,48,58,11,10,11,10,0.21548504405533475,0.3685960560257536,0.5366635794484887,0.8443426832610221,2759,2751,Northwest Kansas,Decatur,20,39,Kansas,KS
20063,20CS015,29,29,29,47,18,18,18,20,-0.8160073728274075,-0.7091638709973713,-0.6066132171776144,1.048016215939145,36,36,36,44,8,8,8,4,1.5625380880555269,1.7176672690178623,1.861206020913247,0.4477299934944133,2696,2746,Northwest Kansas,Gove,20,63,Kansas,KS
20065,20CS015,30,30,30,28,-2,-2,-2,5,-2.9320419508676276,-2.831116152485224,-2.7290321500708195,-6.0882420744868435,36,36,37,40,4,3,4,2,0.6727814159794686,0.8241244400571721,0.9846344574699503,0.42999395567667775,2410,2401,Northwest Kansas,Graham,20,65,Kansas,KS
20109,20CS015,28,28,28,39,11,11,11,4,2.4604439693128937,2.5572344276229226,2.6550565582990417,0.33276031714118093,34,34,34,50,16,16,16,3,5.570158588112437,5.717765903118845,5.86834376421375,0.1766539273360309,2746,2725,Northwest Kansas,Logan,20,109,Kansas,KS
20137,20CS015,57,57,58,76,19,18,19,22,-0.6834471828447298,-0.5810457057113857,-0.4727524365369122,1.1068725439628835,69,68,70,56,-13,-14,-12,2,-3.553794889804187,-3.395252391271791,-3.249133754595201,-0.16423895490034335,5416,5356,Northwest Kansas,Norton,20,137,Kansas,KS
20147,20CS015,58,58,59,65,7,6,7,15,-1.7821869830674981,-1.6749000886918113,-1.5803980849079797,1.9562045606518215,69,69,70,77,8,7,8,16,-2.2062555741776273,-2.0560963596112263,-1.9112076763993753,1.8371287779700443,4982,4835,Northwest Kansas,Phillips,20,147,Kansas,KS
20153,20CS015,35,35,36,32,-3,-4,-3,4,-3.038878761373652,-2.9338755482716725,-2.8373442291729103,-1.6231805698954256,43,43,44,37,-6,-7,-6,3,-4.596582477794724,-4.435908735587628,-4.2900007648342395,-0.5516591952373042,2545,2550,Northwest Kansas,Rawlins,20,153,Kansas,KS
20163,20CS015,55,55,56,59,4,3,4,10,-1.3879666728499027,-1.292805043012408,-1.1908618824730195,2.1436701879394593,67,66,68,73,6,5,7,3,0.600830741326159,0.7461587106850048,0.888596189109422,0.4283643420788436,4894,4840,Northwest Kansas,Rooks,20,163,Kansas,KS
20179,20CS015,25,24,25,44,19,19,20,10,3.745198025673879,3.845996623034684,3.9466323998668025,0.48896212425569746,30,30,31,40,10,9,10,2,3.6097757294571093,3.7505962160658703,3.89359870974097,0.18643639536080941,2457,2473,Northwest Kansas,Sheridan,20,179,Kansas,KS
20181,20CS015,59,58,59,51,-8,-8,-7,11,-3.300260112482294,-3.1854106471042005,-3.0945206567539456,-1.6196111975920797,72,71,73,62,-10,-11,-9,4,-3.0103736305164785,-2.8657019709743814,-2.716516756495629,-0.4415046255937606,5891,5893,Northwest Kansas,Sherman,20,181,Kansas,KS
20193,20CS015,70,70,71,69,-1,-2,-1,10,-1.5533944840162546,-1.4513787228327286,-1.3569954113678446,-22.670696787228117,86,85,87,72,-14,-15,-13,14,-4.4748047476899915,-4.321517390108161,-4.1723361301133,-1.0453032949281122,7881,7883,Northwest Kansas,Thomas,20,193,Kansas,KS
20195,20CS015,37,37,37,45,8,8,8,2,2.0870759909442786,2.188706144937146,2.300002364210162,0.2191186878073566,45,45,45,45,0,-0,0,4,-1.859228808427976,-1.7065881307571227,-1.5667133923545333,3.9343985406089432,2802,2795,Northwest Kansas,Trego,20,195,Kansas,KS
20199,20CS015,14,14,14,15,1,1,1,5,-2.773471252264727,-2.6736482832326787,-2.5745592921782943,2.561402929960662,17,17,17,19,2,2,2,3,-1.0803293056261452,-0.9214489418671907,-0.7757248418317548,1.0573399998895205,1514,1509,Northwest Kansas,Wallace,20,199,Kansas,KS
20025,20CS016,27,27,27,33,6,6,6,7,-0.6010236126760344,-0.49728522822355514,-0.39043322418060766,0.996940913572932,33,33,34,31,-2,-3,-2,3,-3.397968454360107,-3.230402522313369,-3.0848391970128275,-2.2583491447961292,1978,1976,Pawnee and Nearby Counties,Clark,20,25,Kansas,KS
20033,20CS016,25,25,25,29,4,4,4,2,1.0718443832953066,1.176662876779666,1.284305143520932,0.4014538681397107,31,30,31,32,1,1,2,4,-2.088614837924901,-1.9271550870481773,-1.7664878098530583,1.7243655764815276,1683,1672,Pawnee and Nearby Counties,Comanche,20,33,Kansas,KS
20047,20CS016,38,37,38,69,31,31,32,11,6.96580074705591,7.069872617700887,7.171799714726884,0.34035694863129956,46,46,46,60,14,14,14,2,4.890164730330507,5.023890181935772,5.179393858345963,0.13415925476654303,2874,2842,Pawnee and Nearby Counties,Edwards,20,47,Kansas,KS
20057,20CS016,220,205,235,253,33,18,48,41,-0.6667371767839104,-0.2246653722204395,0.18824430148670235,1.2024747572380472,274,257,292,276,2,-16,19,56,-2.528067031833023,-1.8956464249625733,-1.3407345398577921,20.68363509961591,34076,34166,Pawnee and Nearby Counties,Ford,20,57,Kansas,KS
20083,20CS016,22,22,22,20,-2,-2,-2,2,-2.331153088450161,-2.2316182873305217,-2.128608827352674,-2.360098960051165,27,27,27,41,14,14,14,5,6.261340695941652,6.420191436967449,6.565228374596918,0.33004908101908126,1724,1711,Pawnee and Nearby Counties,Hodgman,20,83,Kansas,KS
20097,20CS016,25,25,25,29,4,4,4,3,0.38144617088221466,0.4834322503413737,0.5906924813839517,0.5792203170462675,30,30,31,37,7,6,7,4,1.2159887490211705,1.364825299615955,1.5146989842497693,0.5170162778489299,2448,2401,Pawnee and Nearby Counties,Kiowa,20,97,Kansas,KS
20135,20CS016,38,38,39,55,17,16,17,14,0.934766069529827,1.0289228097371246,1.1231694847279432,0.7877878383762345,47,47,47,53,6,6,6,3,1.2391429823332405,1.3931678540179597,1.5412162807199332,0.42220007416898064,2693,2673,Pawnee and Nearby Counties,Ness,20,135,Kansas,KS
20145,20CS016,72,72,73,82,10,9,10,3,0.9633135874562924,1.06670469990373,1.17324319004447,0.2811201255886676,89,88,90,85,-4,-5,-3,13,-3.4653827050328037,-3.3121531668101647,-3.172076876412742,-4.060616570131255,6262,6228,Pawnee and Nearby Counties,Pawnee,20,145,Kansas,KS
20165,20CS016,50,50,50,58,8,8,8,13,-1.8193858622711792,-1.7194873463032005,-1.6288498137542613,1.4574910086649462,62,61,62,60,-2,-2,-1,1,-1.2525527160576155,-1.1055835412300297,-0.9434783893697734,-1.398193062158755,2952,2952,Pawnee and Nearby Counties,Rush,20,165,Kansas,KS
20149,20CS017,167,156,178,180,13,2,24,16,-0.5595892276605134,-0.09871593513697664,0.3050032533808178,1.1108798182518507,208,195,221,225,17,4,30,34,-1.4073355653302264,-0.8030938553406043,-0.19579003744547283,1.8730885156750554,25299,25732,Pottawatomie+Riley+Wabaunsee,Pottawatomie,20,149,Kansas,KS
20161,20CS017,308,277,339,348,40,9,71,22,-0.18662513502078765,0.2513857053543625,0.6997200513482156,0.5354215363923258,384,347,421,431,47,10,84,32,-0.3911195682867992,0.27172333841456087,0.9257116345740304,0.6679790972684768,72130,72177,Pottawatomie+Riley+Wabaunsee,Riley,20,161,Kansas,KS
20197,20CS017,54,54,55,57,3,2,3,6,-0.6039063628181364,-0.49982649814995367,-0.3968424337542774,1.687112227972922,67,66,68,92,25,24,26,10,2.3831013835299717,2.532283249990125,2.6840520480415098,0.3895611581170009,6894,6954,Pottawatomie+Riley+Wabaunsee,Wabaunsee,20,197,Kansas,KS
20155,20CS018,612,585,638,746,134,108,161,94,0.22071901836080676,0.6454872915892375,1.0826181731262763,0.694154371377801,744,712,776,825,81,49,113,75,-0.4980047142094145,0.10420225230098337,0.733573148129117,0.9161742848493254,61790,61471,Reno,Reno,20,155,Kansas,KS
20169,20CS019,479,455,502,545,66,43,90,77,-0.6199364096581362,-0.19875959263784662,0.19629768243369594,1.1413905783698086,586,558,614,736,150,122,178,130,-0.19912254206769922,0.43789146941320833,1.0548719629156662,0.8600930983121651,54183,53938,Saline,Saline,20,169,Kansas,KS
20055,20CS020,204,187,220,275,71,55,88,59,-0.10724110368638748,0.3231960721596812,0.762845268239481,0.8140156657732879,253,234,273,324,71,51,90,45,0.14443192147375652,0.8085198109049095,1.3650842776015637,0.6289370790497533,37993,38135,Scott and Nearby Counties,Finney,20,55,Kansas,KS
20071,20CS020,21,21,21,24,3,3,3,3,0.19021593360049913,0.284697716284949,0.3896034830631902,0.6875526410615862,26,26,26,27,1,1,1,3,-1.789194164076501,-1.6404696564453902,-1.473086632155963,1.348424422645825,1270,1300,Scott and Nearby Counties,Greeley,20,71,Kansas,KS
20075,20CS020,20,20,21,20,-0,-1,-0,3,-1.4340458253587862,-1.3366291870869724,-1.2324092971899165,4.515389214852404,25,24,25,27,2,2,3,7,-2.4697614859769783,-2.315732712749355,-2.167200843332238,2.1809802310004094,2496,2485,Scott and Nearby Counties,Hamilton,20,75,Kansas,KS
20093,20CS020,29,28,29,29,0,-0,1,7,-1.7962354175759048,-1.6982907913740344,-1.5949231396364987,5.329569182170088,35,34,35,48,13,13,14,2,3.281700717345052,3.4329057013195814,3.588999680980726,0.14108762774955472,3939,3903,Scott and Nearby Counties,Kearny,20,93,Kansas,KS
20101,20CS020,24,24,25,26,2,1,2,6,-2.9761651159896645,-2.879620080768151,-2.7843372354459355,2.3983992058481234,30,30,30,33,3,3,3,5,-1.659731909731911,-1.5090462354677363,-1.3623433862786094,1.2407199054126705,1562,1565,Scott and Nearby Counties,Lane,20,101,Kansas,KS
20171,20CS020,45,44,45,55,10,10,11,16,-1.2686009635350282,-1.1599215582463804,-1.063303486288416,1.443929176567468,55,55,56,72,17,16,17,12,0.9280989282908441,1.0834014897614446,1.2352694259976018,0.6805821599972133,5095,5132,Scott and Nearby Counties,Scott,20,171,Kansas,KS
20203,20CS020,19,19,20,31,12,11,12,5,3.003830439093803,3.112640884616188,3.2123817787940614,0.3953488306842045,23,23,23,30,7,7,7,7,-0.265046677319165,-0.11563530715967447,0.03229864601449933,0.8978099293253345,2134,2091,Scott and Nearby Counties,Wichita,20,203,Kansas,KS
20173,20CS021,3917,3692,4142,4833,916,691,1141,497,0.3858085874197548,0.7985947683551429,1.2505263911552076,0.5420333705072733,4821,4550,5091,5621,800,530,1071,611,-0.2182158029243157,0.4290603037395984,1.0636805744496034,0.7624550171101132,523084,523889,Sedgwick,Sedgwick,20,173,Kansas,KS
20177,20CS022,1646,1570,1723,1914,268,191,344,239,-0.25754096796994086,0.1610641899574424,0.597210893876784,0.8898232814465065,2018,1926,2110,2153,135,43,227,238,-1.32394326394048,-0.6956833825902861,-0.10701195894562895,1.7505640226959596,178299,178314,Shawnee,Shawnee,20,177,Kansas,KS
20007,20CS023,49,49,49,66,17,17,17,3,3.2255689434058645,3.3216120713026283,3.4258050081328117,0.16625667970929023,59,58,59,66,7,7,8,5,0.4425788003229635,0.5955974606671546,0.7476121822519071,0.6220684956742245,4227,4123,South Central Kansas,Barber,20,7,Kansas,KS
20077,20CS023,77,77,78,94,17,16,17,14,0.39176420677829565,0.48786598638640816,0.5832445929618716,0.7924493653275364,94,93,94,78,-16,-16,-15,7,-5.218193120035137,-5.066946345376761,-4.916232357372374,-0.48050032194154396,5445,5350,South Central Kansas,Harper,20,77,Kansas,KS
20095,20CS023,158,155,161,212,54,51,57,31,2.7447261760342805,3.128625191540525,3.5907371383279627,0.5620927355206614,193,189,196,265,72,69,76,35,5.463695352223287,6.043945931080372,6.7018483007110525,0.4768057111450205,7384,7400,South Central Kansas,Kingman,20,95,Kansas,KS
20151,20CS023,101,101,102,124,23,22,23,25,-0.37193414496643973,-0.26885127504213857,-0.16567253045785335,1.06185422610589,126,125,127,129,3,2,4,6,-0.5093174458116053,-0.3586536526950674,-0.20454801321352703,1.408298673060805,9149,9177,South Central Kansas,Pratt,20,151,Kansas,KS
20185,20CS023,51,50,51,59,8,8,9,8,-0.003227459769622094,0.09537800225273355,0.18871765998492898,0.8525207515709058,62,62,63,81,19,18,19,16,0.716587057708115,0.8711722499519169,1.0229271336417272,0.8019809462019792,4063,4038,South Central Kansas,Stafford,20,185,Kansas,KS
20191,20CS023,230,221,240,270,40,30,49,42,-0.5198890494399695,-0.08758697677303554,0.3466531051531567,1.028401829828462,286,275,298,322,36,24,47,30,-0.34280518866146437,0.3193296045298268,0.947698452170952,0.8164475811311103,22407,22377,South Central Kansas,Sumner,20,191,Kansas,KS
20067,20CS024,51,50,52,60,9,8,10,16,-1.061611901391956,-0.9623436198736061,-0.8583792622058077,1.599868602883973,63,63,64,59,-4,-5,-4,16,-3.508294930949484,-3.3608855868487244,-3.209951828452025,-4.571923301197702,7299,7324,Southwest Kansas,Grant,20,67,Kansas,KS
20069,20CS024,45,45,46,55,10,9,10,10,-0.12092200385049263,-0.02303348529773192,0.0763404675276464,0.9192465149774522,55,55,56,66,11,10,11,11,-0.23539901347340272,-0.08878854805050844,0.07120899358784248,0.9494588621287835,5687,5642,Southwest Kansas,Gray,20,69,Kansas,KS
20081,20CS024,25,25,26,25,-0,-1,-0,5,-1.5290406591362609,-1.4375870808869955,-1.3395297051750528,8.654582383267122,31,30,31,35,4,4,5,3,0.26469875145706484,0.40963593106528395,0.5545974334708488,0.5697765065568837,3781,3681,Southwest Kansas,Haskell,20,81,Kansas,KS
20119,20CS024,42,42,43,56,14,13,14,5,2.020383888935698,2.1229632843204564,2.2258934023293286,0.3431518688745196,52,52,53,58,6,5,6,7,-0.4860419331105951,-0.3328812463264145,-0.17603590061269697,1.0167719714539751,4039,4025,Southwest Kansas,Meade,20,119,Kansas,KS
20129,20CS024,32,32,32,36,4,4,4,1,1.0589612862567797,1.1588937426861359,1.261609626095245,0.19607925768472237,40,39,40,44,4,4,5,5,-0.4007783635382062,-0.24792827608626503,-0.09144222740281228,0.9198805479370822,2672,2692,Southwest Kansas,Morton,20,129,Kansas,KS
20175,20CS024,117,115,119,141,24,22,26,38,-0.7299944243359399,-0.6306208340779361,-0.5202674401743931,1.5019759279340885,146,143,148,163,17,15,20,14,0.03222187340151818,0.18301617011230104,0.3421417578607057,0.7623256657051668,21763,21759,Southwest Kansas,Seward,20,175,Kansas,KS
20187,20CS024,18,18,18,16,-2,-2,-2,2,-2.026739969696349,-1.9273973805661606,-1.8198786462736694,-2.0816195553598904,22,22,22,19,-3,-3,-3,4,-4.312741953995524,-4.159981346912108,-4.017811652024152,-1.9007725670040188,2057,2048,Southwest Kansas,Stanton,20,187,Kansas,KS
20189,20CS024,40,39,41,46,6,5,7,5,0.09358731472706264,0.19420613500997178,0.2891157711661885,0.7117060728149358,50,49,50,53,3,3,4,10,-1.6661688936215238,-1.5202077912818102,-1.366852663531211,2.3209839322070893,5267,5285,Southwest Kansas,Stevens,20,189,Kansas,KS
20209,20CS025,1213,1141,1286,1474,261,188,333,213,-0.16688186330468802,0.2849158910291096,0.7008626035722676,0.8140009127941167,1486,1399,1572,1648,162,76,249,174,-0.7230560077486905,-0.08613742704115869,0.5500340776242287,1.0658847989372482,168265,167312,Wyandotte,Wyandotte,20,209,Kansas,KS
21001,21CS001,175,167,183,268,93,85,101,44,2.183712297477025,2.6017421697970113,3.0296728052730013,0.4675924524379518,214,205,224,270,56,46,65,40,0.3609615258834007,0.995805446558588,1.6027601239605718,0.7077984218683958,18964,18923,Adair and Nearby Counties,Adair,21,1,Kentucky,KY
21045,21CS001,169,162,175,210,41,35,48,25,0.5796723051293411,1.026798691728198,1.4661780648025118,0.5901239493885848,206,198,214,242,36,28,44,39,-0.8194768145661576,-0.22551349188857545,0.42455173105980215,1.0472611589850451,15930,15869,Adair and Nearby Counties,Casey,21,45,Kentucky,KY
21087,21CS001,129,128,130,141,12,11,13,16,-0.4439574382569834,-0.347822755599914,-0.25075415419882213,1.2192628377466188,160,159,162,164,4,2,5,28,-2.739320628214748,-2.588067772092326,-2.4252526704966697,5.895923137903621,11107,11265,Adair and Nearby Counties,Green,21,87,Kentucky,KY
21207,21CS001,218,210,226,272,54,46,62,33,0.7540340400392086,1.1698830473273851,1.5887536097256785,0.5990846070926588,268,259,277,310,42,33,51,35,-0.1615207053027642,0.48728998713244875,1.08935963383508,0.8124878236063482,17989,18130,Adair and Nearby Counties,Russell,21,207,Kentucky,KY
21217,21CS001,269,258,280,311,42,31,53,28,0.10363813754863661,0.5404316748043094,0.9656238972286079,0.6506529631793567,331,318,345,445,114,100,127,66,1.5658719588161576,2.184709866666594,2.77620783991505,0.5762481940535359,26001,26204,Adair and Nearby Counties,Taylor,21,217,Kentucky,KY
21005,21CS002,213,202,223,246,33,23,44,13,0.427717435054599,0.870542072141353,1.2807080672602167,0.3777155459663226,262,250,275,290,28,15,40,47,-1.5831557265550193,-0.9695850776091391,-0.36265304628009526,1.6301650326379786,23716,24011,Anderson+Franklin,Anderson,21,5,Kentucky,KY
21073,21CS002,487,465,509,528,41,19,63,40,-0.4031845277811304,0.006932707267858552,0.4417326440855056,0.9531996056782895,596,569,623,754,158,131,185,79,1.2000895593095553,1.8250999094485323,2.456548875515167,0.4974008032617534,51481,51666,Anderson+Franklin,Franklin,21,73,Kentucky,KY
21003,21CS003,204,195,213,231,27,18,36,30,-0.5659838725795502,-0.14294044778662335,0.24893795189267393,1.0631092245797367,250,239,261,288,38,27,49,47,-1.1682844875145864,-0.49575527656149343,0.11671933549749361,1.200210962464977,20722,20768,Barren and Nearby Counties,Allen,21,3,Kentucky,KY
21009,21CS003,447,428,466,507,60,41,79,45,-0.09055790212159048,0.3281850414420237,0.7962969678644993,0.7377833230485046,547,524,570,653,106,83,129,111,-0.7353980718171609,-0.1378119710255776,0.4883118502330981,1.0352724021590654,44417,44530,Barren and Nearby Counties,Barren,21,9,Kentucky,KY
21099,21CS003,195,187,203,227,32,24,40,31,-0.4183739701793811,0.04528233291361889,0.44209553233896476,0.9436925970877882,240,230,250,269,29,19,39,45,-1.6123446179427088,-0.9763202953707586,-0.36857229480262593,1.5069167326123374,19253,19432,Barren and Nearby Counties,Hart,21,99,Kentucky,KY
21169,21CS003,118,117,119,148,30,29,31,14,1.477816041818485,1.5788208896538176,1.6786947999121056,0.44890737935870206,145,144,147,160,15,13,16,34,-2.4073951726400944,-2.2483711715927432,-2.1107450135580526,2.178331659276184,10252,10338,Barren and Nearby Counties,Metcalfe,21,169,Kentucky,KY
21171,21CS003,150,145,155,152,2,-3,7,37,-3.5381741040292245,-3.12176579310023,-2.672453599081025,11.835959523357882,182,176,188,185,3,-3,9,37,-4.228219832161898,-3.6520284026073413,-3.0523601240894878,9.92814773369536,11200,11243,Barren and Nearby Counties,Monroe,21,171,Kentucky,KY
21011,21CS004,147,142,153,150,3,-3,8,10,-0.9882112932737769,-0.5945338425662625,-0.1732286566948264,2.736424019814014,180,174,187,220,40,33,46,19,1.3292459113411836,1.9759074215944428,2.564801633488399,0.4652573896356528,12690,12768,Bath+Clark+Montgomery+Rowan,Bath,21,11,Kentucky,KY
21049,21CS004,366,351,382,396,30,14,45,17,-0.10498642588326629,0.3347010329094453,0.7673621162576165,0.5565677319532149,446,427,465,518,72,53,91,31,0.7002086846264938,1.3270138685644481,1.9339013671821896,0.4270778938237048,36881,36890,Bath+Clark+Montgomery+Rowan,Clark,21,49,Kentucky,KY
21173,21CS004,269,257,281,306,37,25,49,20,0.18875883169912305,0.6110262163611142,1.0574465362535923,0.5219133330336655,329,314,343,428,99,85,114,67,0.7510674185661074,1.3928852602414168,1.9907985350227357,0.6683238819558877,28120,28200,Bath+Clark+Montgomery+Rowan,Montgomery,21,173,Kentucky,KY
21205,21CS004,198,188,209,230,32,21,42,11,0.42094414567431426,0.8326991951780108,1.2516217874794473,0.33710094804959284,244,231,257,327,83,70,96,45,1.2422525795750987,1.8595415255830332,2.426995977454073,0.5347619015711615,24714,24842,Bath+Clark+Montgomery+Rowan,Rowan,21,205,Kentucky,KY
21013,21CS005,318,307,328,362,44,34,55,40,-0.2893410968378922,0.1692151368951781,0.5858383955137867,0.8820552518306028,385,372,397,541,156,144,169,80,3.2446185920530883,3.8261975335696103,4.492028852265223,0.5086174006490696,24237,23870,Bell+Harlan,Bell,21,13,Kentucky,KY
21095,21CS005,365,353,376,471,106,95,118,31,2.4163688278478737,2.8422804152401464,3.2538014202224286,0.2892492666990843,441,427,454,587,146,133,160,87,2.0924912784720022,2.723574469673078,3.3331663501222515,0.5900502557215381,26528,26241,Bell+Harlan,Harlan,21,95,Kentucky,KY
21015,21CS006,828,769,886,911,83,25,142,91,-0.5149474315088458,-0.060732945098823175,0.3909450102970711,1.0801123450034773,1032,961,1103,1167,135,64,206,160,-0.8152405723408986,-0.210670001320018,0.37672771507496566,1.1753794036970824,136110,137265,Boone,Boone,21,15,Kentucky,KY
21017,21CS007,205,196,213,202,-3,-11,6,1,-0.5963136236254234,-0.18818271672102652,0.2648171275878386,-0.6013312097226197,251,240,261,333,82,72,93,37,2.027008180978025,2.6955323996458507,3.3306444030826436,0.44532391196284526,20205,20237,Bourbon+Fleming+Lewis+Nicholas,Bourbon,21,17,Kentucky,KY
21069,21CS007,164,157,170,179,15,9,22,17,-0.5387544103562153,-0.12795414208429431,0.3405460083025839,1.047714555588417,202,194,210,208,6,-2,14,29,-2.4259975054077088,-1.82657277954353,-1.2209022463756327,4.343547481383378,15029,15205,Bourbon+Fleming+Lewis+Nicholas,Fleming,21,69,Kentucky,KY
21135,21CS007,157,151,162,174,17,12,23,29,-1.3361551588703227,-0.8988749557567771,-0.4566620177017913,1.5795667392310762,190,184,197,228,38,31,44,39,-0.7122181678823962,-0.10913412710056122,0.4721226830763757,1.007450372132527,13089,12998,Bourbon+Fleming+Lewis+Nicholas,Lewis,21,135,Kentucky,KY
21181,21CS007,87,86,88,77,-10,-11,-9,4,-1.9910592485926577,-1.8978141016900563,-1.7987857973333545,-0.4327426742427143,109,108,110,116,7,6,8,21,-2.3883490384554813,-2.240776470034061,-2.0728410092906238,2.727093368884688,7512,7686,Bourbon+Fleming+Lewis+Nicholas,Nicholas,21,181,Kentucky,KY
21019,21CS008,569,549,590,641,72,51,92,50,0.007851710427963824,0.4480576306509701,0.8810978245017306,0.6892487329865618,698,673,723,788,90,65,115,78,-0.27636678556162386,0.3010498124997425,0.8689054339684052,0.8587878478243528,47951,47939,Boyd+Carter+Greenup,Boyd,21,19,Kentucky,KY
21043,21CS008,292,280,303,304,12,1,24,22,-0.7874476522906931,-0.36322065902778666,0.07270309375671635,1.6782483714987702,357,344,371,430,73,59,86,56,0.16755512618988663,0.7477198274574951,1.4098017439090862,0.7603877702027076,26586,26436,Boyd+Carter+Greenup,Carter,21,43,Kentucky,KY
21089,21CS008,425,410,441,498,73,57,88,37,0.5628212625378203,0.9958406891491759,1.4327420208427382,0.5019917979496094,521,503,539,575,54,36,72,66,-1.0401746662862916,-0.39551817805313483,0.16988984214003908,1.200812033596744,35731,35679,Boyd+Carter+Greenup,Greenup,21,89,Kentucky,KY
21021,21CS009,302,289,315,339,37,24,50,45,-0.7273172448636386,-0.27962392718723583,0.1554108985718181,1.1920724728432406,373,357,389,441,68,52,84,55,-0.09980704657573691,0.5107185340737872,1.1495081096429076,0.796423072018251,30604,30740,Boyle+Lincoln+Mercer,Boyle,21,21,Kentucky,KY
21137,21CS009,262,251,272,309,47,37,58,37,0.0016781812346319481,0.4328082442909676,0.8521314170202323,0.7658436412926025,321,308,333,433,112,100,125,64,1.7262878300857876,2.392179098448211,2.99690003715189,0.5662219834530289,24280,24242,Boyle+Lincoln+Mercer,Lincoln,21,137,Kentucky,KY
21167,21CS009,256,247,266,260,4,-6,13,25,-1.407805659962735,-0.9678268882281487,-0.5186269798334031,5.476274982643544,318,306,329,350,32,21,44,51,-1.5930780475366388,-0.9777899007186351,-0.33997487800268755,1.5275826917945865,22539,22816,Boyle+Lincoln+Mercer,Mercer,21,167,Kentucky,KY
21023,21CS010,83,82,83,90,7,7,8,8,-0.1713555966019585,-0.0739309020705101,0.035254588342063214,0.9531203690229286,102,101,103,139,37,36,38,22,2.015038164631587,2.1610288282522068,2.304838797285109,0.5760608021276108,8386,8432,Bracken and Nearby Counties,Bracken,21,23,Kentucky,KY
21097,21CS010,198,190,206,209,11,3,19,11,-0.43099498203868924,0.005429038856399634,0.4309314738915192,0.9194690557966643,245,236,255,296,51,41,60,43,-0.12700310887315913,0.470352263836018,1.1457601737130132,0.8329437434903214,18750,18914,Bracken and Nearby Counties,Harrison,21,97,Kentucky,KY
21161,21CS010,203,195,210,197,-6,-13,2,21,-1.9901804812961175,-1.5532709968668033,-1.143448824270491,-4.584227624634973,247,238,255,272,25,17,34,44,-1.9346410113844728,-1.3121254224873116,-0.7067893249022831,1.666958977664378,17064,16953,Bracken and Nearby Counties,Mason,21,161,Kentucky,KY
21191,21CS010,147,141,154,153,6,-1,12,8,-0.5892808375556371,-0.1741325666387519,0.27952625242995083,1.2022168756222211,181,173,188,209,28,21,36,23,-0.16494430225108506,0.4319984548144935,1.0664710920986729,0.791884194608714,14626,14612,Bracken and Nearby Counties,Pendleton,21,191,Kentucky,KY
21201,21CS010,27,27,27,39,12,12,12,1,4.940752194007934,5.039503508448298,5.127517917228299,0.076822038356067393,34,34,34,39,5,5,5,7,-1.1750250287085993,-1.0329835358828183,-0.8757874291766494,1.1528985463184884,2186,2246,Bracken and Nearby Counties,Robertson,21,201,Kentucky,KY
21027,21CS011,204,195,213,249,45,36,54,15,1.0275002148002754,1.4701075916216524,1.9013139155474397,0.32498751406991633,250,239,261,353,103,92,114,44,2.8174657896593285,3.462537161784298,4.049833822275143,0.42249497401605945,20460,20619,Breckinridge+Grayson+Hancock+Meade,Breckinridge,21,27,Kentucky,KY
21085,21CS011,280,269,291,314,34,23,45,40,-0.6501511141252265,-0.21030657945416614,0.18185795341498234,1.1409995640106458,341,328,355,447,106,92,119,65,1.2510793161762754,1.8150185096113305,2.4433094882974546,0.6092686673095224,26426,26507,Breckinridge+Grayson+Hancock+Meade,Grayson,21,85,Kentucky,KY
21091,21CS011,77,76,78,102,25,24,26,4,2.235020185107246,2.340916153646692,2.438849544696995,0.1530270059328189,95,94,96,114,19,18,20,8,1.3418489723335612,1.4919272455121042,1.6545884687050005,0.3939175707656139,9034,9068,Breckinridge+Grayson+Hancock+Meade,Hancock,21,91,Kentucky,KY
21163,21CS011,235,222,248,243,8,-5,21,13,-0.575950493390153,-0.17631617624537885,0.23007242558716676,1.4681677558566257,289,274,305,356,67,51,82,63,-0.4617800874398331,0.14034774496472027,0.7847095994648019,0.9300369390237702,29797,30109,Breckinridge+Grayson+Hancock+Meade,Meade,21,163,Kentucky,KY
21029,21CS012,569,534,605,699,130,94,165,63,0.40881109213623057,0.8155151664873417,1.269684621185497,0.48200660204712253,704,661,747,850,146,103,189,103,-0.0014265107794010563,0.635609320574262,1.211025230204486,0.7014511237865761,82287,82827,Bullitt+Spencer,Bullitt,21,29,Kentucky,KY
21215,21CS012,148,139,156,157,9,1,18,12,-0.6017786902405411,-0.14067562165494193,0.2954373746988997,1.1771647940365124,184,174,194,213,29,19,39,26,-0.4047928560373747,0.18093691097890788,0.7807425036981999,0.8644641385845253,19562,19865,Bullitt+Spencer,Spencer,21,215,Kentucky,KY
21031,21CS013,145,140,150,170,25,20,30,20,-0.050492180650441115,0.39245302911691426,0.8429288239441177,0.7697312909684133,176,170,183,189,13,6,19,30,-2.3178048054921763,-1.6941904940273191,-1.009658979604816,2.2041751598885218,12395,12298,Butler+McLean+Muhlenberg+Ohio,Butler,21,31,Kentucky,KY
21149,21CS013,101,100,102,128,27,26,28,16,1.145774829934245,1.239456368502864,1.3472958401987183,0.5646215290051632,123,122,124,145,22,21,23,21,-0.058224602473797606,0.08916347712228516,0.24158723691264622,0.925828546509132,9120,9102,Butler+McLean+Muhlenberg+Ohio,McLean,21,149,Kentucky,KY
21177,21CS013,333,319,346,364,31,18,45,42,-0.7783909231162411,-0.34869288402398974,0.08593628278185136,1.2985015147494827,406,390,422,481,75,59,91,61,-0.06872615319955316,0.5477232042227621,1.201511495403928,0.8011432540783447,30828,30720,Butler+McLean+Muhlenberg+Ohio,Muhlenberg,21,177,Kentucky,KY
21183,21CS013,247,236,257,260,13,3,24,29,-1.0640630074195587,-0.652421806115868,-0.23639299409574716,2.008593760054084,301,289,314,371,70,57,82,46,0.5930260197177881,1.1941594077351994,1.8073903969749052,0.6523233226414427,23768,23694,Butler+McLean+Muhlenberg+Ohio,Ohio,21,183,Kentucky,KY
21035,21CS014,329,313,345,404,75,59,91,40,0.48751625412341754,0.9220264412101956,1.3815366940551428,0.5248136157875855,406,386,425,509,103,84,123,40,1.4005316207112555,2.046278870345797,2.641423444372909,0.3835694460740642,37471,37500,Calloway+Marshall,Calloway,21,35,Kentucky,KY
21157,21CS014,380,366,393,385,5,-8,19,35,-1.4107994165577422,-0.9536346104157786,-0.5509480521808258,5.642283958385622,466,449,482,510,44,28,61,48,-0.7399933424238693,-0.12845798278190199,0.461612718186163,1.0565342069189305,31593,31736,Calloway+Marshall,Marshall,21,157,Kentucky,KY
21037,21CS015,745,705,785,817,72,32,112,58,-0.2992863778388406,0.14731702790028775,0.557887472331622,0.793379471824832,914,866,962,956,42,-6,90,84,-1.1788173249721137,-0.52440878497896,0.06986020261341389,1.9729702973691192,93192,93055,Campbell,Campbell,21,37,Kentucky,KY
21047,21CS016,534,503,566,668,134,102,165,72,0.45037238470391283,0.8557474730809358,1.2900109234196682,0.5352051046609302,660,622,697,834,174,137,212,102,0.6125128929131284,1.2043683753280552,1.7844521876786446,0.5818711149697929,72498,72406,Christian,Christian,21,47,Kentucky,KY
21051,21CS017,240,232,249,236,-4,-13,4,21,-1.6855375883023418,-1.2560201320891962,-0.8271964777853135,-6.2827377374197715,296,286,306,389,93,83,103,43,2.3975119983260402,2.971082631065326,3.553540714798578,0.45745082900350653,20229,20219,Clay+Jackson+Leslie+Owsley,Clay,21,51,Kentucky,KY
21109,21CS017,154,149,160,173,19,13,24,23,-0.7951852302294707,-0.3072021821617302,0.07897962881973346,1.164244772533262,190,183,197,224,34,27,41,42,-1.353425644303391,-0.7642235475291108,-0.15663916329783958,1.205116399963356,13008,12979,Clay+Jackson+Leslie+Owsley,Jackson,21,109,Kentucky,KY
21131,21CS017,159,155,164,132,-27,-32,-23,3,-3.3651956169394834,-2.9296871330128873,-2.526761816305246,-0.11386644972137916,194,189,199,206,12,7,17,29,-2.583316414868423,-1.9590159848096174,-1.3514386461384358,2.204524357172453,10353,10304,Clay+Jackson+Leslie+Owsley,Leslie,21,131,Kentucky,KY
21189,21CS017,58,57,58,91,33,33,34,12,5.118806128239712,5.216089164383373,5.319321976800035,0.35048623376073157,69,69,70,83,14,13,14,7,1.9260396605581906,2.086516241139562,2.2320388968693416,0.47087713969277806,4069,3962,Clay+Jackson+Leslie+Owsley,Owsley,21,189,Kentucky,KY
21053,21CS018,104,103,105,145,41,40,42,21,2.0487233280234043,2.1482687298041623,2.2436441798584745,0.4986031566487185,126,125,127,157,31,30,32,21,1.1667474306230725,1.3082911594839106,1.4589278718042948,0.6543424883568255,9365,9258,Clinton+Cumberland+McCreary+Wayne,Clinton,21,53,Kentucky,KY
21057,21CS018,78,78,79,97,19,18,19,4,2.387573194610685,2.485338218106998,2.5910457798521174,0.20145476028540063,94,93,95,111,17,16,18,11,1.0393598283370138,1.1935700466025911,1.3466013666550418,0.6167934286995356,5971,5876,Clinton+Cumberland+McCreary+Wayne,Cumberland,21,57,Kentucky,KY
21147,21CS018,189,181,196,198,9,2,17,11,-0.5429991736850964,-0.09760259738206409,0.359792805645853,1.056062291828892,230,221,239,286,56,47,65,57,-0.7566292958507266,-0.09889598014708985,0.5556090613929873,1.0033719665947936,16915,16886,Clinton+Cumberland+McCreary+Wayne,McCreary,21,147,Kentucky,KY
21231,21CS018,197,188,205,258,61,53,70,26,1.3553786874270308,1.797193638940983,2.2299034110572165,0.41733007180622933,240,230,250,334,94,84,104,46,2.3899627761228923,2.934664496947763,3.568075108902584,0.48398272471961656,19639,19538,Clinton+Cumberland+McCreary+Wayne,Wayne,21,231,Kentucky,KY
21059,21CS019,947,902,991,1034,87,43,132,92,-0.4864145031581088,-0.036274530467880726,0.38068585173792063,1.0411054318790587,1160,1107,1214,1308,148,94,201,191,-1.14540190659785,-0.4944390364589522,0.07155498018990686,1.285305037126386,103014,103096,Daviess,Daviess,21,59,Kentucky,KY
21061,21CS020,135,130,140,140,5,-0,10,19,-1.5948374021040177,-1.171075082679687,-0.7325196508926524,3.2946638495328213,166,160,173,187,21,14,27,29,-1.4375353676908202,-0.7906538115805051,-0.20002565774652148,1.3318055730579117,12151,12268,Edmonson+Warren,Edmonson,21,61,Kentucky,KY
21227,21CS020,922,864,980,1081,159,101,217,95,0.04673053501705173,0.48130182784481956,0.9383467257403654,0.5939332873322128,1149,1078,1219,1334,185,115,256,158,-0.3774130513568098,0.22881908105372922,0.8392756057762645,0.8473052556386325,134853,136880,Edmonson+Warren,Warren,21,227,Kentucky,KY
21063,21CS021,67,66,68,65,-2,-3,-1,3,-0.7647989743923814,-0.6640232782719993,-0.5632439416523268,-3.3710004252084236,83,82,84,114,31,30,32,15,2.4775687742961403,2.6278297452524284,2.7884479561698963,0.46650339254149276,7361,7374,Elliott+Johnson+Lawrence+Magoffin,Elliott,21,63,Kentucky,KY
21115,21CS021,273,264,283,302,29,19,38,17,0.07560495333126449,0.5161091289903712,0.9700229003435078,0.5758916021420347,335,324,347,435,100,88,111,68,1.0759828056501541,1.700071942668546,2.2705891693395954,0.6745838324382137,22561,22567,Elliott+Johnson+Lawrence+Magoffin,Johnson,21,115,Kentucky,KY
21127,21CS021,191,184,198,182,-9,-16,-2,14,-1.8564882493344617,-1.4298938447444969,-1.042846411090806,-1.7047015808856147,236,227,244,272,36,28,45,37,-0.6658446977196938,-0.06723167636601354,0.5930309592914551,0.9949158887306317,16158,16290,Elliott+Johnson+Lawrence+Magoffin,Lawrence,21,127,Kentucky,KY
21153,21CS021,142,137,147,152,10,5,15,10,-0.4047949457132224,0.011372956865121488,0.416944185465073,0.9029271384158463,172,166,178,214,42,36,48,24,1.2184753639250863,1.8485988189511766,2.448026608305116,0.5616395448755312,11670,11511,Elliott+Johnson+Lawrence+Magoffin,Magoffin,21,153,Kentucky,KY
21065,21CS022,172,166,178,195,23,17,29,11,0.3765323281625522,0.8335083462785717,1.2381591323207473,0.4622203911497563,210,203,217,271,61,54,68,27,2.2953410348082337,2.896165977385066,3.489196608913777,0.43513373345510503,14131,14098,Estill+Madison+Rockcastle,Estill,21,65,Kentucky,KY
21151,21CS022,710,669,750,833,123,83,164,63,0.20477277992975212,0.6478224500267586,1.0862074911796942,0.5062047258256056,888,839,937,1070,182,133,231,142,-0.09571504784965573,0.5118484935262969,1.12994766739004,0.7759061183045903,93128,94411,Estill+Madison+Rockcastle,Madison,21,151,Kentucky,KY
21203,21CS022,168,161,175,192,24,17,31,13,0.2786865914690708,0.683095802832157,1.1050350617625693,0.5179071906307905,206,197,214,316,110,102,119,39,4.716957232875703,5.313265605240992,5.948919677422316,0.3501213520293474,16159,16106,Estill+Madison+Rockcastle,Rockcastle,21,203,Kentucky,KY
21067,21CS023,2089,1950,2228,2478,389,250,528,142,0.33981725219474207,0.7766664837129248,1.1895055486112067,0.3640083148067771,2571,2405,2737,2828,257,91,423,229,-0.49587205268187146,0.0993504107147419,0.7299237118779003,0.8879857984977916,322561,321882,Fayette,Fayette,21,67,Kentucky,KY
21071,21CS024,457,442,472,541,84,69,99,46,0.645300484783601,1.0467446878464195,1.4843606192422485,0.5419377662768041,552,534,571,675,123,104,141,110,-0.22170408109883186,0.4316653885778801,1.0402702803932704,0.8903016596387012,35671,35344,Floyd+Martin,Floyd,21,71,Kentucky,KY
21159,21CS024,131,126,136,140,9,4,14,6,-0.13306920176079748,0.26885687989752943,0.7151266536735089,0.5950817625410528,159,153,165,184,25,19,31,29,-1.0433703269198475,-0.43770159928527536,0.24395245332358448,1.1153158004821628,11223,11153,Floyd+Martin,Martin,21,159,Kentucky,KY
21079,21CS025,155,148,162,203,48,41,55,22,1.105749069831798,1.519423608735795,1.9619877914321313,0.4491309688478537,193,184,202,241,48,39,57,33,0.4206083143618581,1.0478023901419469,1.6526134693374446,0.670059897134109,17089,17300,Garrard+Jessamine,Garrard,21,79,Kentucky,KY
21113,21CS025,414,391,437,454,40,17,63,49,-0.590384424496528,-0.17391232304122003,0.2656191225421593,1.1974234568059794,513,485,541,595,82,54,110,51,0.06514126890529197,0.6810047604784969,1.3167813122875496,0.6148939744664998,53192,53531,Garrard+Jessamine,Jessamine,21,113,Kentucky,KY
21093,21CS026,828,781,876,1003,175,127,222,84,0.40743582209808954,0.8184150651458297,1.224021335381396,0.4783341331780044,1030,972,1088,1394,364,306,422,223,0.9103196339408112,1.5238442832641677,2.121152650784909,0.6110045246841179,110848,111478,Hardin+Larue,Hardin,21,93,Kentucky,KY
21123,21CS026,161,154,167,162,1,-5,8,6,-0.7779614816971966,-0.31435641742483156,0.09779736038593966,2.6947952988351225,199,191,207,223,24,16,32,34,-1.4336020513197747,-0.8010854456529403,-0.18255738901231744,1.3618181802778688,14817,15005,Hardin+Larue,Larue,21,123,Kentucky,KY
21101,21CS027,429,410,448,543,114,95,133,60,0.7325685135817288,1.1952413423841302,1.6193495374660416,0.5224240010110603,521,498,544,631,110,87,133,71,0.4589192062992756,1.0674127226539953,1.669889302977956,0.6377989200248323,44704,44375,Henderson+Union,Henderson,21,101,Kentucky,KY
21225,21CS027,145,139,151,142,-3,-9,3,13,-1.58389123686841,-1.145714227626688,-0.7268660854641595,-7.187340272566491,175,168,182,245,70,63,77,40,2.0690514765992614,2.685470402089581,3.265633353440001,0.5606334482539965,13759,13559,Henderson+Union,Union,21,225,Kentucky,KY
21103,21CS028,161,155,168,164,3,-4,9,3,-0.4300146437826333,-0.005505814063087945,0.45108335460683646,0.8017329634619803,197,189,205,230,33,25,41,29,-0.27137457366057066,0.3090021199995487,0.9350859952867908,0.8447492651696645,15723,15658,Henry+Shelby,Henry,21,103,Kentucky,KY
21211,21CS028,332,311,352,416,84,64,105,39,0.5244113041801834,0.9327992553926447,1.3758412609448394,0.457347299428371,410,385,435,507,97,72,122,77,-0.12846789778347048,0.49475551344259583,1.1138900237665628,0.7893507737903512,48331,48420,Henry+Shelby,Shelby,21,211,Kentucky,KY
21107,21CS029,504,484,523,613,109,90,129,95,-0.1025675519721013,0.30681636522447825,0.7131196380237905,0.8617138973627955,608,585,632,755,147,123,170,103,0.526150422490793,1.1421407550730112,1.7559611807006652,0.6971277071726413,45240,45171,Hopkins+Webster,Hopkins,21,107,Kentucky,KY
21233,21CS029,147,141,153,174,27,21,33,23,-0.11722979578037047,0.31001531975206126,0.7176295597220909,0.8226610816100264,176,170,183,205,29,22,35,28,-0.5006578171565454,0.06884369168898401,0.7167515315913534,0.9406895903268556,12964,12839,Hopkins+Webster,Webster,21,233,Kentucky,KY
21111,21CS030,6914,6579,7250,8138,1224,888,1559,753,0.1631727707858019,0.6023550325729055,1.041945766204563,0.6147747753158466,8450,8048,8852,9544,1094,692,1496,907,-0.32694093458551104,0.2866895814805141,0.9143382097783401,0.8282227258491734,779589,778494,Jefferson,Jefferson,21,111,Kentucky,KY
21117,21CS031,1334,1262,1407,1390,56,-17,128,109,-0.7318440680131846,-0.3119184617674913,0.08558195612083234,1.9234915143225737,1641,1553,1728,1751,110,23,198,197,-1.2658041681814918,-0.6362858803555131,-0.018293476536055932,1.7681511289954837,168946,169450,Kenton,Kenton,21,117,Kentucky,KY
21119,21CS032,169,163,175,197,28,22,34,11,0.8222383609009427,1.228368137380813,1.6283722994513083,0.37689852875222646,206,199,213,268,62,55,69,34,1.7650352241366003,2.3734834507560785,2.982722451794173,0.5404849293438685,14251,14069,Knott+Letcher+Perry,Knott,21,119,Kentucky,KY
21133,21CS032,286,277,295,324,38,29,47,24,0.21083437185371628,0.6330922182565071,1.0753257806793544,0.6173103857033071,349,338,360,421,72,61,83,61,-0.011609689535960937,0.5886914946833138,1.2033452973776162,0.8403061298846712,21429,21279,Knott+Letcher+Perry,Letcher,21,133,Kentucky,KY
21193,21CS032,404,392,416,436,32,20,44,33,-0.46917281411035744,-0.05031117980752698,0.37490657711598313,1.006322772913908,494,480,509,594,100,85,114,87,-0.046078684876149405,0.5509843239211702,1.2025654599281959,0.8621186620790813,27955,27994,Knott+Letcher+Perry,Perry,21,193,Kentucky,KY
21121,21CS033,337,324,350,411,74,61,87,30,1.042339980681033,1.4307327379072208,1.8471710582900687,0.4013691292695999,407,392,423,520,113,97,128,84,0.5482266310642532,1.1385349710989652,1.7289423743979475,0.7388162800468218,30260,29942,Knox+Whitley,Knox,21,121,Kentucky,KY
21235,21CS033,430,414,446,474,44,28,60,25,0.09273274543133656,0.529565129660131,0.9678910594447374,0.5522596725749712,526,507,545,635,109,90,128,108,-0.5909044964408804,0.032823415783451104,0.6715566447743305,0.9813774627335912,36666,36902,Knox+Whitley,Whitley,21,235,Kentucky,KY
21125,21CS034,585,559,612,687,102,75,128,27,0.7639855882685532,1.1901323277995843,1.6281485677364524,0.2631898310346154,719,687,752,936,217,184,249,142,0.8250107797862435,1.4474179196414585,2.084630731305277,0.6523039246929755,62386,62576,Laurel,Laurel,21,125,Kentucky,KY
21141,21CS035,282,270,293,317,35,24,47,40,-0.5934750761513106,-0.17008767683118792,0.30007986295141653,1.097151711270665,347,333,362,386,39,24,53,41,-0.7279656907885205,-0.11383405585102196,0.5342279696760368,1.0350979314604116,27469,27731,Logan+Simpson+Todd,Logan,21,141,Kentucky,KY
21213,21CS035,195,187,204,222,27,18,35,24,-0.2933377344957897,0.13104805698721836,0.590361867423269,0.8661768203893357,241,231,251,264,23,13,33,55,-2.564480207041777,-1.9423661398200827,-1.3633833195036007,2.2991427243320177,19471,19704,Logan+Simpson+Todd,Simpson,21,213,Kentucky,KY
21219,21CS035,119,118,120,121,2,1,3,13,-0.9746553258855352,-0.8802418928583678,-0.7755657893038198,4.022737697906235,146,144,148,183,37,35,39,20,1.5050596641576761,1.6588557792059688,1.814711579619771,0.5266394156127754,12286,12284,Logan+Simpson+Todd,Todd,21,219,Kentucky,KY
21033,21CS036,146,141,152,145,-1,-7,4,14,-1.5963969734802987,-1.1728353113692036,-0.7621604036085317,-116.24778849314455,178,172,185,209,31,24,37,30,-0.5460268857482867,0.07236163796215644,0.646737589310257,0.9451702079413821,12646,12625,Lyon and Nearby Counties,Caldwell,21,33,Kentucky,KY
21055,21CS036,110,109,110,112,2,2,3,12,-1.1723747233839674,-1.0673041331181334,-0.9680420859386933,3.4989132330895054,134,133,135,157,23,22,24,23,-0.18802198486585758,-0.03706096094654939,0.10605002078360129,0.9697614948506805,8955,8953,Lyon and Nearby Counties,Crittenden,21,55,Kentucky,KY
21139,21CS036,106,105,107,154,48,47,49,19,3.1973834784282302,3.2937144700657255,3.3924750564694537,0.38533160624047524,130,129,131,174,44,43,45,27,2.1115899501499564,2.2524639699533364,2.4020553816102357,0.6026593258129276,8901,8942,Lyon and Nearby Counties,Livingston,21,139,Kentucky,KY
21143,21CS036,105,104,106,112,7,6,8,12,-0.7191219999931268,-0.6210959745879318,-0.5300643057956835,1.5682254428568214,132,130,133,139,7,6,9,13,-0.9167446119348462,-0.7614038947266502,-0.6188120031976572,1.5475307543996975,8619,8783,Lyon and Nearby Counties,Lyon,21,143,Kentucky,KY
21221,21CS036,152,146,158,196,44,38,50,6,2.2205153119004533,2.644210225874742,3.0956534007270053,0.13446489678018866,187,180,194,258,71,64,78,25,3.291652813653177,3.9234776668538585,4.505727459329731,0.3464911749743224,14168,14174,Lyon and Nearby Counties,Trigg,21,221,Kentucky,KY
21145,21CS037,703,674,732,795,92,63,121,76,-0.20808879675917152,0.24978771722811655,0.6754256001945358,0.8157693250837222,856,821,891,1006,150,115,185,109,0.11634937318655816,0.7414450129675565,1.3371508629742377,0.7234230210790559,67473,67510,McCracken,McCracken,21,145,Kentucky,KY
21155,21CS038,189,180,197,232,43,35,52,27,0.4147445147614641,0.8454345920353248,1.253860588618431,0.6080765864457142,233,223,243,256,23,13,33,30,-1.0540691835546836,-0.4135189297121266,0.2132233007655681,1.242490877080633,19545,19704,Marion+Nelson+Washington,Marion,21,155,Kentucky,KY
21179,21CS038,388,368,408,441,53,33,73,36,-0.07463590044853687,0.3622278277400726,0.7893577706456502,0.6650670051585186,480,456,505,615,135,110,159,87,0.6046894262551883,1.2145543140821122,1.8387141522853354,0.6409594032550286,46714,47048,Marion+Nelson+Washington,Nelson,21,179,Kentucky,KY
21229,21CS038,130,125,136,150,20,14,25,27,-1.0578671077372128,-0.6147697517803157,-0.21286735751347766,1.3108402451682148,160,154,166,151,-9,-15,-3,18,-3.318443490011523,-2.66401221418402,-2.068248520307841,-2.2764176574468675,12040,12065,Marion+Nelson+Washington,Washington,21,229,Kentucky,KY
21185,21CS039,376,347,405,424,48,19,77,50,-0.4336837708941429,-0.0480256251036423,0.3853802491686896,1.0251344305147074,473,437,508,484,11,-24,47,37,-1.0723611994931508,-0.4723821004218634,0.12650565618296095,2.9800100561703515,67630,68533,Oldham,Oldham,21,185,Kentucky,KY
21041,21CS040,120,119,121,122,2,1,3,13,-1.0784859790341241,-0.9804900702908802,-0.8799740582374683,3.8223443238171413,147,145,148,151,4,3,6,23,-2.2111332860436574,-2.0728197960780284,-1.9292020076338723,4.3598158616209615,10811,10859,Owen and Nearby Counties,Carroll,21,41,Kentucky,KY
21077,21CS040,86,85,87,100,14,13,15,11,0.2752117737113333,0.37169749654888096,0.46777729390750294,0.7219893528207953,105,104,107,119,14,12,15,23,-1.4398214818459318,-1.2947572379069785,-1.1439469204792074,1.5831532902740124,8704,8759,Owen and Nearby Counties,Gallatin,21,77,Kentucky,KY
21081,21CS040,208,197,219,227,19,8,30,13,-0.22065665093605547,0.22896015678085563,0.6594262433344918,0.6533960240622132,254,241,267,321,67,54,80,36,0.8449037452029429,1.4587322057891408,2.075274607959729,0.5326452439891738,25049,25210,Owen and Nearby Counties,Grant,21,81,Kentucky,KY
21187,21CS040,105,104,106,133,28,27,29,11,1.3901597097840166,1.481424972640851,1.582901072752912,0.38363406540182593,129,128,131,160,31,29,32,18,1.192410482039658,1.3351170993040122,1.4784749378998818,0.5700728530977718,11234,11294,Owen and Nearby Counties,Owen,21,187,Kentucky,KY
21223,21CS040,87,86,87,98,11,11,12,11,-0.04183400922527761,0.058430614813702764,0.16381689324308862,0.8802496291829505,106,105,107,147,41,40,42,25,2.0692983405066463,2.224704373665015,2.374759930124717,0.5982580858326709,8478,8520,Owen and Nearby Counties,Trimble,21,223,Kentucky,KY
21195,21CS041,682,657,707,781,99,74,124,47,0.4766330819706224,0.9129532242002394,1.3208494780000652,0.46934642250667974,824,794,854,1068,244,214,274,160,1.1253302312421225,1.756658254047259,2.3474722820430376,0.6528712068532072,58231,57539,Pike,Pike,21,195,Kentucky,KY
21199,21CS042,710,682,738,814,104,76,132,66,0.14013191056889748,0.5740794255894711,1.0142991529312686,0.6311263619825853,870,836,903,1040,170,137,204,165,-0.49763345780492413,0.1061935704384824,0.7427158402380841,0.9631549094474314,65092,65364,Pulaski,Pulaski,21,199,Kentucky,KY
21209,21CS043,377,352,402,389,12,-13,37,23,-0.5976930036007524,-0.18702584520784424,0.24820503166602234,1.7527387854644307,470,440,500,557,87,57,117,51,0.14353378429801888,0.741676571031874,1.3297352830495253,0.5805795117342777,57500,58139,Scott+Woodford,Scott,21,209,Kentucky,KY
21239,21CS043,220,209,232,237,17,5,28,6,-0.025887456714943375,0.38599163269619535,0.7928773628651511,0.3381786832465639,272,258,286,301,29,15,43,31,-0.7522637397876972,-0.10176797806988379,0.548358726875115,1.0324771062152183,26876,27048,Scott+Woodford,Woodford,21,239,Kentucky,KY
21007,21CS044,91,90,91,96,5,5,6,6,-0.17061498689133883,-0.067306861176066,0.033061563632008475,0.9290055493935305,111,110,112,134,23,22,24,24,-0.3310759724383868,-0.1766239937058258,-0.01729124737197889,1.005567580490541,7735,7699,Southwest Kentucky,Ballard,21,7,Kentucky,KY
21039,21CS044,63,62,63,69,6,6,7,4,0.415135653815857,0.503811304130027,0.6054376431819631,0.5379923318414461,77,76,78,107,30,29,31,10,4.857159710859024,5.001479649453567,5.146512355639773,0.3226678683770872,4796,4794,Southwest Kentucky,Carlisle,21,39,Kentucky,KY
21075,21CS044,86,86,87,111,25,24,25,19,0.7828834343543034,0.8843495208524625,0.993551879919624,0.7399438107742407,108,107,108,125,17,17,18,14,0.466892036129712,0.6262151963326792,0.7778521109988037,0.7619258313302324,6427,6510,Southwest Kentucky,Fulton,21,75,Kentucky,KY
21083,21CS044,394,379,410,471,77,61,92,66,-0.14833049310735047,0.281443534684025,0.7162015647348151,0.8514488124355851,485,466,504,577,92,73,111,52,0.7199053171726768,1.306698574630978,1.934509973109237,0.5572076407576851,36619,36600,Southwest Kentucky,Graves,21,83,Kentucky,KY
21105,21CS044,57,56,57,76,19,19,20,7,2.6315568961581897,2.7313096257226657,2.8341055480651502,0.3457304807305453,69,69,70,72,3,2,3,11,-2.336576375888235,-2.2025361960365193,-2.051326009402938,2.8425500043033662,4488,4438,Southwest Kentucky,Hickman,21,105,Kentucky,KY
21025,21CS045,176,171,182,183,7,1,12,7,-0.4400653029425035,-0.02755020863915132,0.40521893905425765,0.9245469061963665,216,209,223,276,60,53,67,47,0.46984738667862647,1.1330592738949612,1.7747072648356852,0.7736524901440147,13510,13571,Wolfe and Nearby Counties,Breathitt,21,25,Kentucky,KY
21129,21CS045,94,94,95,124,30,29,30,16,1.7332531837081384,1.8369958338341412,1.9336052981014331,0.5243588505887458,117,116,118,148,31,30,32,22,1.3018316352208268,1.451282159105053,1.5985865566103425,0.6885414802936466,7374,7438,Wolfe and Nearby Counties,Lee,21,129,Kentucky,KY
21165,21CS045,73,72,74,80,7,6,8,5,0.21588945106160787,0.31736389075926624,0.4286232316458921,0.6271289224824081,90,89,91,127,37,36,38,22,2.786429670885468,2.9394139000212705,3.095099551173224,0.5765420345158697,6177,6182,Wolfe and Nearby Counties,Menifee,21,165,Kentucky,KY
21175,21CS045,146,140,152,138,-8,-14,-2,7,-1.542916668995713,-1.1001855182839837,-0.6783770084761872,-1.022090886230371,181,174,188,182,1,-6,8,19,-2.1861083890460478,-1.5794750108778024,-0.97731069676088,9.656344807592095,13668,13805,Wolfe and Nearby Counties,Morgan,21,175,Kentucky,KY
21197,21CS045,169,163,174,163,-6,-11,-0,5,-1.277202115976477,-0.8275443113846791,-0.392178200660755,-1.071010996486956,208,202,215,217,9,2,15,19,-1.555327106453589,-0.9674270842475937,-0.339571017433682,1.9725660121940414,12976,13126,Wolfe and Nearby Counties,Powell,21,197,Kentucky,KY
21237,21CS045,86,85,87,102,16,15,17,4,1.7136926754285597,1.8170959958793567,1.9279193608367053,0.23457544711813919,104,103,104,164,60,60,61,11,8.961832036976645,9.09102371827824,9.23947763801627,0.17920837509399368,6635,6514,Wolfe and Nearby Counties,Wolfe,21,237,Kentucky,KY
22001,22CS001,529,504,554,770,241,216,266,134,1.4247826319347707,1.8372624435073153,2.2995354917158095,0.5532682367939532,646,617,676,880,234,204,263,83,2.555140662161771,3.1497289188958177,3.735435680325828,0.3538153656876131,58131,57312,Acadia +Jefferson Davis,Acadia,22,1,Louisiana,LA
22053,22CS001,342,329,356,365,23,9,36,56,-1.4703684589113577,-1.02984191321535,-0.6495717220565054,2.3735370569848024,423,407,440,514,91,74,107,66,0.3165816522248913,0.9130303140035694,1.5199832918300737,0.71946848120952,32079,32319,Acadia +Jefferson Davis,Jefferson Davis,22,53,Louisiana,LA
22003,22CS002,206,196,215,320,114,105,124,53,2.1901101800632956,2.6516138895845143,3.0651656439508987,0.45925512095524934,250,238,261,337,87,76,99,39,1.9344877086298675,2.562316471376613,3.186517599127702,0.44196388308315215,23118,22688,Allen+Evangeline,Allen,22,3,Louisiana,LA
22039,22CS002,315,301,329,416,101,87,115,57,0.9097671687475257,1.3556983191595766,1.7749589615460128,0.5592319278257892,384,368,401,486,102,85,118,78,0.286723626528347,0.8797742338981267,1.5092431382233062,0.7605635991563623,32456,32228,Allen+Evangeline,Evangeline,22,39,Louisiana,LA
22005,22CS003,655,601,710,841,186,131,240,116,0.12609688977460803,0.5464162037507114,0.921035581002271,0.621537349205298,821,755,887,992,171,105,237,115,-0.06541113053762419,0.5129922480762182,1.1531063261175585,0.6687409264329466,127101,128167,Ascension,Ascension,22,5,Louisiana,LA
22007,22CS004,180,171,189,226,46,37,55,24,0.590994457254888,1.0274691248178676,1.4451229248015778,0.5138820160920218,219,208,230,323,104,93,115,31,3.611434468975286,4.24290856593424,4.867595303984047,0.29474318567275104,21078,20730,Assumption+St.James+St.John the Baptist,Assumption,22,7,Louisiana,LA
22093,22CS004,167,158,176,210,43,34,52,38,-0.1484749293835267,0.2661790131057576,0.6939991958987847,0.8632360545290397,202,192,212,251,49,39,59,21,1.0537513376186467,1.6961505859638344,2.3298176814882035,0.41977510633770226,20221,19798,Assumption+St.James+St.John the Baptist,St. James,22,93,Louisiana,LA
22095,22CS004,349,331,367,440,91,73,109,91,-0.44852572060965473,0.0018047223901323094,0.4182737153501978,0.9901676451831652,427,406,449,472,45,23,66,43,-0.5828664281466895,0.028344909678454704,0.6908017845768436,0.9418607092188208,42425,42138,Assumption+St.James+St.John the Baptist,St. John the Baptist,22,95,Louisiana,LA
22009,22CS005,410,393,427,526,116,99,133,71,0.6734518227275157,1.15198450412803,1.56679431633426,0.6071427784729463,500,480,520,623,123,103,143,75,0.876180175193545,1.4678564382803063,2.0848416895335076,0.6040524048934203,39653,39291,Avoyelles+East Feliciana+Pointe Coupee+West Feliciana,Avoyelles,22,9,Louisiana,LA
22037,22CS005,219,210,227,278,59,51,68,67,-0.8162972991019463,-0.4082319375560303,-0.026485724102611463,1.1130591038909954,268,258,278,293,25,15,35,38,-1.4324829560575771,-0.7768983124573795,-0.1936112356271803,1.44154301138457,19388,19354,Avoyelles+East Feliciana+Pointe Coupee+West Feliciana,East Feliciana,22,37,Louisiana,LA
22077,22CS005,211,202,220,281,70,61,79,45,0.7968396531445371,1.2077774968489046,1.6144814131727652,0.6336688814779305,255,245,266,325,70,59,80,27,1.9059609250619212,2.5179858837085147,3.1776768146245473,0.381624584783846,20807,20405,Avoyelles+East Feliciana+Pointe Coupee+West Feliciana,Pointe Coupee,22,77,Louisiana,LA
22125,22CS005,120,118,121,149,29,28,31,26,0.1252158594036252,0.22249154849406572,0.3262426472452774,0.8540147101604586,149,147,151,166,17,15,19,14,0.09903618508374346,0.24834594816044292,0.3962210791529257,0.7691972809423857,15327,15459,Avoyelles+East Feliciana+Pointe Coupee+West Feliciana,West Feliciana,22,125,Louisiana,LA
22011,22CS006,323,307,339,423,100,84,116,54,0.8417507153053077,1.2397512811019356,1.6979010020175633,0.5340488339076624,396,377,415,467,71,52,90,75,-0.72266568234102,-0.12239544263979764,0.49838370772476864,1.0363652917388482,36731,36582,Beauregard +Vernon,Beauregard,22,11,Louisiana,LA
22115,22CS006,348,327,369,463,115,94,136,63,0.672276537021122,1.0576487027868,1.5084900178358014,0.5447225369087576,427,402,451,489,62,38,87,75,-0.9419870731625811,-0.3277233216559274,0.3061950203821533,1.1834706539959834,48497,48108,Beauregard +Vernon,Vernon,22,115,Louisiana,LA
22013,22CS007,163,157,168,223,60,55,66,44,0.8084111770876247,1.2441179663609423,1.6536574572307823,0.7193344890164407,197,190,204,262,65,58,72,30,2.6696519438586495,3.287898139854689,3.9121908893412054,0.4540574015168188,12935,12794,Bienville+Natchitoches+Red River,Bienville,22,13,Louisiana,LA
22069,22CS007,340,324,356,424,84,68,100,51,0.4517548013973751,0.8628507621224746,1.282104711599876,0.6026143389739057,415,396,434,529,114,95,133,72,0.7373516772336627,1.366618117573358,1.9694213533518017,0.6244831091883042,37436,37073,Bienville+Natchitoches+Red River,Natchitoches,22,69,Louisiana,LA
22081,22CS007,83,82,84,139,56,55,57,27,3.6604871733190953,3.7647666549780987,3.8730640387030566,0.47291941841614044,100,99,101,135,35,34,36,19,2.4413331532424647,2.5951147137141626,2.735320128219903,0.5222659545517956,7724,7572,Bienville+Natchitoches+Red River,Red River,22,81,Louisiana,LA
22015,22CS008,934,879,989,1132,198,143,253,169,-0.23660581390774452,0.2216670323811538,0.6638700805850604,0.8487710150626879,1155,1089,1222,1375,220,153,286,142,0.1159330295996438,0.7122376435809571,1.3268115032648218,0.6433739943163862,128490,129067,Bossier,Bossier,22,15,Louisiana,LA
22017,22CS009,2263,2161,2365,3042,779,677,881,463,0.9194138193344576,1.3265093107833366,1.762929318900695,0.5934529631590857,2735,2615,2856,3375,640,519,760,409,0.5948572412463995,1.16784954477825,1.773017987242983,0.638210618383948,237135,233670,Caddo,Caddo,22,17,Louisiana,LA
22019,22CS010,1840,1748,1932,2226,386,294,478,269,0.12268535700310569,0.5405450021101569,0.9742406716741796,0.6949414259460696,2181,2074,2288,2448,267,160,374,327,-1.0014397349582378,-0.34651908067668125,0.25704587909257165,1.2194633889296769,213451,206906,Calcasieu,Calcasieu,22,19,Louisiana,LA
22023,22CS011,37,36,38,61,24,23,25,3,3.5535562936002125,3.656933000544973,3.7605798882464057,0.11968078919826369,41,40,41,52,11,11,12,3,1.77619657660107,1.9247988920854064,2.066962027485368,0.24467106080808773,5761,5159,Cameron +Vermilion,Cameron,22,23,Louisiana,LA
22113,22CS011,479,454,504,639,160,135,185,65,1.2408588534422345,1.637805731799613,2.072407492820703,0.40376926520640216,587,557,616,775,188,159,218,84,1.6247473680626277,2.183359290027607,2.765779665535003,0.4439625657007925,57613,57216,Cameron +Vermilion,Vermilion,22,113,Louisiana,LA
22021,22CS012,104,103,105,125,21,20,22,23,-0.3150005069871373,-0.20937646723331854,-0.10749315204481874,1.0466205010678264,126,125,128,158,32,30,33,16,1.8184167459201581,1.9633503449656968,2.1142614790596035,0.4898211816590517,9660,9578,Catahoula and Nearby Parishes,Caldwell,22,21,Louisiana,LA
22025,22CS012,97,97,98,140,43,42,43,22,2.1952856962151657,2.2994445848892537,2.4081494112115265,0.5048624004027712,118,117,119,145,27,26,28,25,0.16437598997483205,0.3244328705983569,0.4750414409357285,0.8808809222588035,8941,8813,Catahoula and Nearby Parishes,Catahoula,22,25,Louisiana,LA
22029,22CS012,198,190,206,258,60,52,68,43,0.46612396998126765,0.8811146348343517,1.3298195986321661,0.7088643978558562,239,229,248,295,56,47,66,30,1.0950944139681384,1.7231816846021613,2.3464673865115824,0.5235582937341179,18673,18407,Catahoula and Nearby Parishes,Concordia,22,29,Louisiana,LA
22059,22CS012,143,137,149,175,32,26,38,25,0.021105951014360056,0.47915387663674386,0.8829944607517581,0.7559044392907786,174,167,182,197,23,15,30,19,-0.3151808719121136,0.2670787470370643,0.9175002514668769,0.8042651271401636,14829,14831,Catahoula and Nearby Parishes,La Salle,22,59,Louisiana,LA
22107,22CS012,45,45,46,71,26,25,26,6,4.65379098298934,4.744941972750601,4.842980985799767,0.22521273522354052,54,54,55,85,31,30,31,6,7.119866112886892,7.279042632595788,7.423847129657397,0.19000416733066564,4138,4054,Catahoula and Nearby Parishes,Tensas,22,107,Louisiana,LA
22027,22CS013,150,144,156,202,52,46,58,40,0.38373220953756254,0.8646404914240751,1.2395589007204162,0.7533881111813582,180,173,188,202,22,14,29,23,-0.7235359102547755,-0.12207792977803936,0.488295567036448,1.0163772936758813,14336,14048,Claiborne+Webster,Claiborne,22,27,Louisiana,LA
22119,22CS013,416,401,432,564,148,132,163,77,1.5035812696735495,1.9375518180716318,2.3411307515304896,0.5181828264606929,499,480,517,696,197,179,216,74,3.448397483663442,4.066138476645592,4.691405377759099,0.37325465786859885,37006,36283,Claiborne+Webster,Webster,22,119,Louisiana,LA
22031,22CS014,256,245,268,310,54,42,65,53,-0.41414814835460667,0.021796455830428132,0.4299545300273846,0.9696141604920137,314,300,328,373,59,45,73,57,-0.522934572068636,0.1069559670680438,0.7166701132835008,0.9484564079304412,26946,26910,De Soto+Sabine,De Soto,22,31,Louisiana,LA
22085,22CS014,222,212,231,339,117,108,127,48,2.666288250657712,3.0930747561963012,3.519876679301132,0.40611441967108075,270,258,281,372,102,91,114,51,2.1647650977448953,2.7767067872309394,3.4308286042638874,0.49376250102608527,22379,22133,De Soto+Sabine,Sabine,22,85,Louisiana,LA
22033,22CS015,3381,3185,3576,4176,795,600,991,523,0.14753303387299685,0.5992392311803896,1.0536717300873375,0.656728311654611,4155,3921,4389,5048,893,659,1127,538,0.3100269843814318,0.9279101982029879,1.5205105214918055,0.6019564217046549,453513,453678,East Baton Rouge,East Baton Rouge,22,33,Louisiana,LA
22043,22CS016,186,177,196,235,49,39,58,38,0.0351537798710225,0.48693506945308485,0.9028279743005662,0.7645282804337307,229,218,241,282,53,41,64,33,0.4203662737693744,1.0610894179916708,1.6429262329057115,0.61409454113689,22173,22220,Grant+Jackson+Winn,Grant,22,43,Louisiana,LA
22049,22CS016,156,150,163,200,44,37,50,17,1.3576602498526256,1.7826531276466957,2.2203248856841546,0.3790980566654024,189,181,197,223,34,26,42,16,0.7791562851198093,1.4582760675277573,2.1068084847451156,0.45695743467952926,15090,14892,Grant+Jackson+Winn,Jackson,22,49,Louisiana,LA
22127,22CS016,148,142,154,210,62,56,68,29,1.976229776598446,2.400709169694511,2.8138231869937727,0.4627858669756646,179,172,186,210,31,24,38,21,0.29242141840637575,0.9383559603643058,1.5457879711746718,0.6495766683675636,13732,13522,Grant+Jackson+Winn,Winn,22,127,Louisiana,LA
22045,22CS017,621,591,651,802,181,151,211,81,1.0013668858118825,1.4406830161479605,1.8469395379955025,0.44535228714561625,757,721,792,924,167,132,203,100,0.5752427501454942,1.1481679661218407,1.788114516455089,0.5942081903615934,69634,69084,Iberia,Iberia,22,45,Louisiana,LA
22047,22CS018,260,247,273,393,133,120,146,56,2.122332429174336,2.5114089827553876,2.923476879743077,0.419007422324179,313,298,329,430,117,101,132,54,1.9534465889718198,2.5238806604479636,3.1656679688870324,0.4581459781186028,30425,29864,Iberville+West Baton Rouge,Iberville,22,47,Louisiana,LA
22121,22CS018,185,174,197,249,64,52,75,40,0.40836229926015677,0.8640518130938338,1.3039072498570174,0.6197521463253215,231,217,245,283,52,38,66,26,0.5572350464237237,1.1426160168929027,1.7048963938298822,0.4890301116278654,27194,27711,Iberville+West Baton Rouge,West Baton Rouge,22,121,Louisiana,LA
22051,22CS019,3648,3459,3836,4495,847,659,1036,592,0.15889480962201197,0.5765195060435184,0.9994178729095797,0.697984491348228,4445,4220,4669,5070,625,401,850,415,-0.014835576231740425,0.56706236298760615,1.1632028198533266,0.6625930068612412,438365,434586,Jefferson,Jefferson,22,51,Louisiana,LA
22055,22CS020,1537,1433,1642,1930,393,288,497,134,0.6555316435562951,1.0651058284533792,1.4972860351911814,0.34031381976963015,1911,1785,2037,2411,500,374,626,184,0.949193729928844,1.5485956775414063,2.1541337284148327,0.367320368748328,242641,243884,Lafayette,Lafayette,22,55,Louisiana,LA
22057,22CS021,767,725,809,953,186,144,228,132,0.14585874710418328,0.5492604424311233,0.9756111883278981,0.7069603189510069,944,894,995,1211,267,216,317,150,0.8008023953430157,1.4412934702619482,2.0568299622058963,0.560175043441243,97514,97503,Lafourche,Lafourche,22,57,Louisiana,LA
22061,22CS022,344,323,364,437,93,73,114,68,0.0591115707973021,0.5232475647363559,0.9315134297407044,0.7218723409867243,426,401,451,490,64,39,89,33,0.14696767295437432,0.7878908439348965,1.4370583470558291,0.5068154132943469,48043,48168,Lincoln+Union,Lincoln,22,61,Louisiana,LA
22111,22CS022,225,216,234,351,126,117,135,52,3.065626117466289,3.4894636830659422,3.9343877087361365,0.4088954914902936,274,263,285,348,74,63,85,34,1.6403232550412719,2.2821228086013137,2.8751308711493944,0.454171799434058,21258,21096,Lincoln+Union,Union,22,111,Louisiana,LA
22063,22CS023,957,895,1018,1142,185,124,247,119,0.035822451843551636,0.4603797307417589,0.9016103805952534,0.6394651637996916,1199,1124,1274,1585,386,311,461,250,0.4727913021297196,1.1135037061061266,1.7385092267790103,0.6457901629043655,142879,145377,Livingston,Livingston,22,63,Louisiana,LA
22035,22CS024,76,75,77,82,6,5,7,19,-1.8601036520290637,-1.7607863549309055,-1.6562440800906921,2.6478807352638154,93,92,93,116,23,23,24,19,0.5726072398742209,0.7320554069212667,0.8773322399404523,0.7780404813172961,7285,7244,Northeast Louisiana,East Carroll,22,35,Louisiana,LA
22041,22CS024,228,220,236,286,58,50,66,55,-0.2778737041056801,0.1630358144288108,0.5860357273784709,0.932155027031636,278,268,288,313,35,25,45,46,-1.2797649023257125,-0.69084694761871,-0.08028505763869785,1.2856785399638595,19756,19676,Northeast Louisiana,Franklin,22,41,Louisiana,LA
22065,22CS024,101,100,102,118,17,16,18,18,-0.20765469617040866,-0.1075995694957634,-0.008838515939760741,1.0044893889641326,121,120,122,146,25,24,26,32,-1.006477339559742,-0.8671752996857381,-0.7109519008117128,1.2337902037703194,10069,9818,Northeast Louisiana,Madison,22,65,Louisiana,LA
22067,22CS024,314,304,325,405,91,80,101,44,1.3923342107997854,1.8377069952583143,2.2758100410863444,0.4807327813232335,381,368,394,501,120,107,133,62,2.1560312739635394,2.7849119074096076,3.3958267320692506,0.5112916383015982,25302,25084,Northeast Louisiana,Morehouse,22,67,Louisiana,LA
22083,22CS024,197,189,206,250,53,44,61,45,-0.04070396486536301,0.37935729137209895,0.8173974642374545,0.8357344197880014,240,230,251,302,62,51,72,42,0.6113115885247017,1.2076560644200958,1.817658172033955,0.6700557745381825,19999,19833,Northeast Louisiana,Richland,22,83,Louisiana,LA
22123,22CS024,121,116,125,156,35,31,40,35,-0.4132556093807576,0.02412810288410822,0.4677695804263621,0.9621091645787962,145,140,150,159,14,9,19,17,-0.9385640775149863,-0.33801648237919424,0.27646461824370167,1.12066280442609,9860,9609,Northeast Louisiana,West Carroll,22,123,Louisiana,LA
22071,22CS025,2785,2621,2950,3765,980,815,1144,548,0.7084287419854648,1.1238854224450001,1.589110371710655,0.558840907513511,3386,3191,3582,3997,611,415,806,261,0.526307593366672,1.1270549027656882,1.6989689933576917,0.4268026909789957,383775,377891,Orleans,Orleans,22,71,Louisiana,LA
22073,22CS026,1396,1328,1465,1726,330,261,398,274,-0.07455847563304191,0.34919998766394106,0.7818689493258818,0.828372330268992,1712,1630,1794,2049,337,255,419,282,-0.21065785860202407,0.400265268153169,1.0111475141125632,0.8340002878485158,158912,158948,Ouachita,Ouachita,22,73,Louisiana,LA
22075,22CS027,162,151,172,209,47,37,58,20,0.7353661385757454,1.1762450905797146,1.6139818014381635,0.41256961292217975,198,186,210,222,24,12,36,20,-0.4563309477073618,0.18099119603150415,0.7939371302495656,0.809305178205834,23420,23327,Plaquemines+St. Bernard,Plaquemines,22,75,Louisiana,LA
22087,22CS027,305,286,324,379,74,55,93,42,0.28230835792517306,0.7373967833560993,1.1555136335353529,0.5572617167194437,376,353,398,488,112,90,135,47,1.1773216709818324,1.7614222958386347,2.3747339756480508,0.4147341892438942,44371,44197,Plaquemines+St. Bernard,St. Bernard,22,87,Louisiana,LA
22079,22CS028,1261,1205,1317,1626,365,309,421,211,0.7410770570512704,1.1768390525655474,1.6483623255031574,0.5767527442881969,1537,1471,1604,1967,430,363,496,241,1.1836691478467318,1.759710104645053,2.3695366157402713,0.5597362264901447,129536,128793,Rapides,Rapides,22,79,Louisiana,LA
22089,22CS029,364,341,386,463,99,77,122,57,0.3459937021054878,0.8196431050925029,1.2372679359524816,0.5688128093427369,449,422,476,495,46,19,73,43,-0.509560054735487,0.08258276312373043,0.6472894488529048,0.9076581893780908,52548,52311,St. Charles,St. Charles,22,89,Louisiana,LA
22091,22CS030,130,125,135,136,6,1,11,3,-0.11248587310733277,0.28708179875921047,0.6866147097637955,0.4284369364998885,160,154,166,170,10,4,16,19,-1.6397431862397063,-1.0071154122878834,-0.345596138149554,1.745003431677464,10783,10909,St. Helena +Tangipahoa +Washington,St. Helena,22,91,Louisiana,LA
22105,22CS030,1102,1044,1159,1323,221,164,279,155,0.04559345920303381,0.49725050066401316,0.9054438659201366,0.6972080649635183,1369,1300,1439,1767,398,328,467,286,0.334003839457624,1.0275673483827652,1.6095982875214612,0.7176271009808844,133912,134974,St. Helena +Tangipahoa +Washington,Tangipahoa,22,105,Louisiana,LA
22117,22CS030,510,490,529,630,120,101,140,79,0.4728756993863521,0.9124385103600717,1.3546061582393836,0.6525745070200045,621,598,644,754,133,110,156,110,0.013288022289956805,0.6039075205205366,1.2274473747729775,0.8208618924181389,45460,45168,St. Helena +Tangipahoa +Washington,Washington,22,117,Louisiana,LA
22097,22CS031,857,822,892,1109,252,217,287,168,0.5925489588696626,1.02609059987376,1.4216314044966618,0.6637853318850205,1048,1006,1090,1249,201,159,243,122,0.558139435973818,1.1630894853802,1.7474245905883257,0.6040599591951128,82241,82100,St. Landry,St. Landry,22,97,Louisiana,LA
22099,22CS032,412,389,434,580,168,146,191,82,1.2501671511567478,1.6510643798758402,2.095538841640788,0.48384602774313124,504,478,531,629,125,98,151,62,0.8331341232412329,1.4594883431721468,2.0942308934585587,0.4935560058554834,51873,51549,St. Martin,St. Martin,22,99,Louisiana,LA
22101,22CS033,465,444,486,589,124,103,145,87,0.31930600089753974,0.7670591484051602,1.1584145431380666,0.6963186670130843,562,537,587,716,154,129,179,112,0.44897762590195406,1.0404877355651236,1.5992106044953824,0.7244440802658175,49068,48364,St. Mary,St. Mary,22,101,Louisiana,LA
22103,22CS034,2000,1886,2114,2355,355,241,469,259,-0.08036367230905749,0.3673456700738257,0.790304613712089,0.728135208661451,2499,2360,2637,2939,440,302,579,307,-0.016068666947693516,0.5987864794223261,1.1816688773708393,0.6956336202385393,264868,268738,St. Tammany,St. Tammany,22,103,Louisiana,LA
22109,22CS035,872,825,919,1054,182,135,229,117,0.18563172251457344,0.5952608899049122,1.0152214456082946,0.6405058506947948,1068,1012,1125,1388,320,263,376,171,1.0552354188136772,1.6289469502757004,2.2381601891328637,0.5335071333736704,109444,108797,Terrebonne,Terrebonne,22,109,Louisiana,LA
23001,23CS001,1042,994,1089,1032,-10,-57,38,23,-0.7156405394714579,-0.297816810577092,0.09019434406305467,-2.6531339561489973,1282,1225,1339,1480,198,141,255,150,-0.09817623814037035,0.5344967685256284,1.1152462485150272,0.7534550058858251,110648,111035,Androscoggin,Androscoggin,23,1,Maine,ME
23003,23CS002,733,704,762,796,63,34,92,21,0.21214781333692626,0.5994755642115088,1.0639558496111012,0.32824534551534773,892,857,926,1107,215,181,250,94,1.5580253209112827,2.1671350947410866,2.835177723096057,0.43502947567034145,66994,66879,Aroostook,Aroostook,23,3,Maine,ME
23005,23CS003,2397,2267,2527,2469,72,-58,202,106,-0.5547352725276133,-0.1231816197526872,0.2983573802634555,1.4490963993830939,2965,2807,3122,3101,136,-21,294,171,-0.7640045923934549,-0.1125945725098041,0.4610664786820161,1.2437672238798463,302453,304951,Cumberland,Cumberland,23,5,Maine,ME
23007,23CS004,295,283,308,285,-10,-23,2,4,-0.9084938145265292,-0.4730421580882774,-0.06553837811642885,-0.4294068228553786,364,349,379,410,46,31,61,40,-0.36734048190227653,0.2528024282193795,0.9250045930310543,0.8487197394444302,29538,29648,Franklin+Oxford,Franklin,23,7,Maine,ME
23017,23CS004,583,558,608,608,25,0,50,32,-0.5106578633875469,-0.10180447134058775,0.3122937312335494,1.2196851255208836,721,691,752,849,128,97,158,91,0.1328943381396177,0.7610959100481041,1.3381653838495053,0.7079666593442061,57937,58515,Franklin+Oxford,Oxford,23,17,Maine,ME
23009,23CS005,534,510,558,575,41,17,65,27,-0.17675374680245612,0.25913797633366875,0.7036275287473162,0.6447978659742982,660,631,689,753,93,64,122,44,0.45600551233022285,1.066030488921608,1.6499413397456983,0.4675055773666296,55483,56085,Hancock+Washington,Hancock,23,9,Maine,ME
23029,23CS005,362,349,376,429,67,53,80,2,1.6231134002802003,2.0746632766704365,2.474659869136979,0.029554163335135133,442,426,458,530,88,72,104,38,1.2740845358141848,1.9177857973329016,2.5029041533104253,0.42719158386762635,31101,31112,Hancock+Washington,Washington,23,29,Maine,ME
23011,23CS006,1153,1100,1206,1193,40,-13,93,34,-0.36794453744549604,0.049505094065336416,0.47769003291389944,0.8257543186501357,1418,1354,1483,1629,211,146,275,124,0.25717985395360776,0.8205104667120042,1.4054447112846549,0.5860868258446749,123610,124379,Kennebec,Kennebec,23,11,Maine,ME
23013,23CS007,436,419,454,390,-46,-64,-29,5,-1.6809170906662425,-1.2696483430089769,-0.8601098457809992,-0.10998244083266308,538,517,560,539,1,-21,22,19,-1.1199863812965642,-0.5292016231275506,0.08498444017590347,12.628417953745366,40539,41015,Knox+Waldo,Knox,23,13,Maine,ME
23027,23CS007,357,340,374,388,31,14,48,20,-0.15766483889301489,0.26259838135807706,0.69324347053123625,0.6312843485118032,440,419,461,529,89,68,110,32,1.087033031861359,1.7044487707137348,2.2898507805022725,0.3554997679816386,39681,39872,Knox+Waldo,Waldo,23,27,Maine,ME
23015,23CS008,355,340,371,384,29,13,44,3,0.3255681437294408,0.714480038014617,1.1469037344341624,0.10152380436901022,439,420,457,453,14,-4,33,18,-0.7126816511113424,-0.13147221924909025,0.45238947911181665,1.1839092175461032,35184,35735,Lincoln+Sagadahoc,Lincoln,23,15,Maine,ME
23023,23CS008,317,302,333,302,-15,-31,0,3,-0.9280362264445903,-0.5007705037969865,-0.05167946254631158,-0.20940459469078088,391,372,410,437,46,27,65,21,0.19433992798803582,0.8272713737876372,1.4384116131341835,0.44316271984254,36636,37015,Lincoln+Sagadahoc,Sagadahoc,23,23,Maine,ME
23019,23CS009,1433,1368,1499,1529,96,30,161,34,0.011134526989007807,0.3918154341254592,0.8297994142070144,0.350987269414229,1765,1687,1844,1999,234,155,312,211,-0.3927564245636425,0.17935949775904927,0.7626167749949239,0.8996343720359353,152059,152654,Penobscot+Piscataquis,Penobscot,23,19,Maine,ME
23021,23CS009,209,202,217,203,-6,-14,1,4,-1.0328762761464045,-0.6230350531765644,-0.18606330030116897,-0.7374245939413253,260,251,269,302,42,33,51,36,-0.17771319222381476,0.42477289414112357,1.036206324183933,0.8345494076526745,16826,17107,Penobscot+Piscataquis,Piscataquis,23,21,Maine,ME
23025,23CS010,523,501,545,559,36,14,58,19,-0.11406139055423586,0.3362269369688828,0.7494268578633156,0.5118495227377516,640,614,666,774,134,108,160,65,0.9838709941964873,1.6822338702556017,2.2672873826544087,0.48074186191328816,50471,50565,Somerset,Somerset,23,25,Maine,ME
23031,23CS011,1860,1769,1951,1901,41,-50,132,82,-0.6047713117511008,-0.18796226975549166,0.22933585311054827,1.949640029900811,2306,2195,2417,2365,59,-52,170,176,-1.2562654158429354,-0.6704159974949465,-0.07272789490038531,2.9314693378190224,211750,214226,York,York,23,31,Maine,ME
24001,24CS001,741,712,770,995,254,225,283,161,0.9330831242968021,1.371717834912452,1.7978709053105701,0.6316015800760817,900,865,935,1055,155,120,190,140,-0.36925242987172047,0.25976140681422505,0.9086524272051053,0.8992856744062883,68301,67761,Allegany+Garrett,Allegany,24,1,Maryland,MD
24023,24CS001,284,271,296,376,92,80,105,49,1.1042307224514314,1.4813939052905383,1.913640112240425,0.5260949210442427,347,332,361,396,49,35,64,56,-0.8740465779525968,-0.2862742557128132,0.3044009576080524,1.1108498604994084,28797,28711,Allegany+Garrett,Garrett,24,23,Maryland,MD
24003,24CS002,3871,3618,4124,4228,357,104,610,356,-0.42724277942483546,0.004990450824872096,0.4701792645409096,0.995634375519585,4800,4496,5105,4996,196,-109,500,412,-1.071800405968613,-0.4229641551464058,0.19457021382340256,2.095458206097949,587638,590107,Anne Arundel,Anne Arundel,24,3,Maryland,MD
24510,24CS003,5384,5133,5634,6749,1365,1115,1616,684,0.6972203875248529,1.177630046493978,1.5998433601464275,0.5005890920108931,6540,6242,6839,7522,982,683,1280,604,0.1792192728840454,0.7906731483323872,1.369278930361429,0.6147542578822057,584114,577465,Baltimore (city),Baltimore (city),24,510,Maryland,MD
24005,24CS004,7313,6948,7679,8384,1071,705,1436,889,-0.20067524655651986,0.22457996010046422,0.6628085819146933,0.8295139198395466,8968,8530,9407,9456,488,49,926,863,-1.092881020290813,-0.5469957150378568,0.068815297593906255,1.7659905702390224,849099,849864,Baltimore (county),Baltimore (county),24,5,Maryland,MD
24009,24CS005,614,574,654,711,97,57,137,52,0.0755354061265464,0.48428422124949483,0.9042591681490721,0.5296828352416949,765,717,814,858,93,44,141,61,-0.21669719746258959,0.3966094022020827,1.0113647392722978,0.6522153283890721,92940,93772,Calvert,Calvert,24,9,Maryland,MD
24011,24CS006,292,278,307,347,55,40,69,15,0.7655903896807361,1.2069684361743929,1.6179980036599466,0.2697616700979596,360,343,378,436,76,58,93,58,0.05049710031372443,0.6591862364521841,1.2591345279439525,0.7578811752720946,33332,33372,Caroline+Dorchester+Talbot,Caroline,24,11,Maryland,MD
24019,24CS006,354,340,368,379,25,11,39,27,-0.5023021027445095,-0.06989345786279523,0.4042111636217889,1.0379111950605948,434,417,451,493,59,42,76,57,-0.5669605785344839,0.056044359774213695,0.6900504271929314,0.9523398808508241,32412,32492,Caroline+Dorchester+Talbot,Dorchester,24,19,Maryland,MD
24041,24CS006,391,375,407,458,67,51,83,1,1.3389727601310715,1.7560187679363,2.2052134520696223,0.014698802172190502,481,462,501,555,74,54,93,52,0.07702792595877651,0.6864223380366626,1.338080637246256,0.6951869157658986,37434,37601,Caroline+Dorchester+Talbot,Talbot,24,41,Maryland,MD
24013,24CS007,1411,1337,1485,1557,146,72,220,178,-0.6167404761299613,-0.15512803940442452,0.23520099743503328,1.2123898090911085,1746,1656,1836,1885,139,49,229,132,-0.600085208406506,0.05746306810279245,0.6561108192272578,0.9433217486429358,172392,173730,Carroll,Carroll,24,13,Maryland,MD
24015,24CS008,868,823,913,1040,172,127,217,93,0.32492057103356875,0.765207383199738,1.2370884200743442,0.5374654370313644,1071,1018,1125,1248,177,123,230,144,-0.17311735688626576,0.3530761398404806,0.9577241043436058,0.8106266483499063,103663,103881,Cecil,Cecil,24,15,Maryland,MD
24017,24CS009,992,920,1063,1223,231,160,303,153,0.04758336156235239,0.46987042113354416,0.892709237001343,0.658597765356317,1244,1157,1331,1473,229,142,316,160,-0.12550895053823005,0.5155395743971225,1.1361069418325835,0.6967157105660462,166462,168404,Charles,Charles,24,17,Maryland,MD
24021,24CS010,1720,1603,1838,1873,153,35,270,189,-0.577154191516281,-0.14647065712540774,0.3004864153410161,1.2311222026751263,2172,2028,2316,2208,36,-108,180,205,-1.3177999576905457,-0.7225825623479922,-0.13368109239911108,5.505296984059388,271708,278800,Frederick,Frederick,24,21,Maryland,MD
24025,24CS011,1913,1801,2025,2163,250,138,362,158,-0.09825842215300451,0.35189265418158056,0.8069116355551277,0.6301189744519992,2372,2236,2508,2605,233,97,369,231,-0.6428590753554029,0.006445226131737785,0.6457099576594777,0.9877001333515011,260509,262706,Harford,Harford,24,25,Maryland,MD
24027,24CS012,1522,1379,1665,1734,212,69,355,178,-0.30876840406570594,0.10622245582310154,0.503741978563788,0.8370505712820431,1913,1741,2086,1993,80,-93,252,93,-0.6636227208865583,-0.043439181205179006,0.551855251134476,1.1539468596742477,331923,334265,Howard,Howard,24,27,Maryland,MD
24029,24CS013,221,213,229,285,64,56,72,34,1.1684337514135046,1.5658587763180203,1.9837045831730504,0.5222269957553977,272,262,282,315,43,33,53,23,0.6258785641860837,1.2706491348968039,1.8653069470430308,0.5186409287635851,19197,19251,Kent+Queen Anne's,Kent,24,29,Maryland,MD
24035,24CS013,380,359,402,392,12,-10,33,27,-0.7374574453314603,-0.3054901553418615,0.13076400980944236,2.1388165749404826,476,450,502,522,46,20,72,48,-0.6797830844256201,-0.047052846349414895,0.5634644813015135,1.0245961414040445,50156,50679,Kent+Queen Anne's,Queen Anne's,24,35,Maryland,MD
24031,24CS014,5402,4946,5857,6588,1186,731,1642,1118,-0.4034965292078,0.053447032106987064,0.47763292156168763,0.9417167478362778,6689,6143,7234,7006,317,-228,863,565,-0.914103009099445,-0.2990467537240356,0.3330461684387665,1.7740177419950225,1059100,1055763,Montgomery,Montgomery,24,31,Maryland,MD
24033,24CS015,5499,5087,5912,7260,1761,1348,2173,1249,0.0925056907027582,0.5483176984622777,0.9492086890125723,0.7089975996237945,6813,6319,7307,7618,805,311,1299,734,-0.6061034231820842,0.08895376591725085,0.6753252621455333,0.9103634798613979,956648,956807,Prince George's,Prince George's,24,33,Maryland,MD
24037,24CS016,719,670,768,855,136,87,185,88,0.012866768201312996,0.4191757282876328,0.8475934176869154,0.6436678095528235,894,835,953,1050,156,97,215,89,0.07449609057601644,0.7021352110678254,1.2978633630824616,0.5679797389892635,113979,114393,St. Mary's,St. Mary's,24,37,Maryland,MD
24039,24CS017,220,210,231,300,80,69,90,17,2.098044858886948,2.5373480008102436,2.991751592324597,0.2102126755373313,269,256,282,312,43,30,56,31,-0.0350105561147808,0.5928167196159327,1.20810779443526,0.7053473289489622,24721,24582,Somerset+Worcester,Somerset,24,39,Maryland,MD
24047,24CS017,550,528,573,614,64,41,86,53,-0.20579842828904063,0.21603938572334266,0.6570251882378824,0.8193812338635069,679,652,707,743,64,36,91,70,-0.7925294254802095,-0.13285933859045929,0.4858056152448833,1.0793815283633603,52490,53032,Somerset+Worcester,Worcester,24,47,Maryland,MD
24043,24CS018,1406,1340,1473,1660,254,187,320,143,0.2930447643893029,0.7076662911573,1.1498881800003578,0.5618236569547929,1735,1655,1815,2018,283,203,363,272,-0.524761963465993,0.08331933995265912,0.6855579380470224,0.9583728621257066,154109,154886,Washington,Washington,24,43,Maryland,MD
24045,24CS019,862,817,906,1033,171,127,216,83,0.43859159961548877,0.8643237245097003,1.268281961370914,0.4817435039748744,1064,1010,1118,1253,189,135,243,151,-0.21282908997525027,0.44868532627016305,1.062662940893235,0.7942164385804679,103603,103906,Wicomico,Wicomico,24,45,Maryland,MD
25001,25CS001,2675,2577,2773,2625,-50,-148,48,197,-1.5488058482473894,-1.087041880129066,-0.6438396386108175,-4.028686184029793,3313,3193,3432,3313,0,-119,120,199,-1.6987339787677165,-1.038431415875893,-0.4439579807750813,140.72121952557083,226988,231909,Barnstable+Dukes+Nantucket,Barnstable,25,1,Massachusetts,MA
25007,25CS001,163,154,171,143,-20,-28,-11,7,-1.7443843556713865,-1.3194126849700019,-0.8967357633430585,-0.37775532250981797,206,195,216,171,-35,-45,-24,6,-2.887043004367126,-2.3133701082672182,-1.699639843947709,-0.17885527823016936,20180,21022,Barnstable+Dukes+Nantucket,Dukes,25,7,Massachusetts,MA
25019,25CS001,77,76,78,64,-13,-14,-12,8,-1.6191167417507617,-1.5171215649528837,-1.4255274027035094,-0.6639547422211666,99,97,101,91,-8,-10,-6,3,-1.0572481791540012,-0.9153804868102742,-0.7514245406761271,-0.42931995430938097,13845,14455,Barnstable+Dukes+Nantucket,Nantucket,25,19,Massachusetts,MA
25003,25CS002,1339,1284,1394,1386,47,-8,102,121,-1.027361245454451,-0.5828104436720962,-0.12113104135887086,2.5106718765142104,1642,1575,1708,1759,117,51,184,128,-0.728724683535263,-0.10242288039627642,0.4685877378173115,1.0815666221737403,128231,128672,Berkshire,Berkshire,25,3,Massachusetts,MA
25005,25CS003,4766,4517,5014,5477,711,463,960,777,-0.5177292711897,-0.10598828200116832,0.3281346447821812,1.0906533463177694,5869,5570,6169,6242,373,73,672,669,-1.197658645211832,-0.6121959156151657,-0.014415125322139179,1.78923383736024,577223,580019,Bristol,Bristol,25,5,Massachusetts,MA
25009,25CS004,6102,5755,6449,7072,970,623,1317,1242,-0.7454551947652515,-0.3425361328160272,0.0751336169223402,1.2793221457363166,7509,7092,7925,7483,-26,-442,391,631,-1.5889393971369121,-0.973669622143331,-0.3486861776164924,-25.601951720641097,806152,807387,Essex,Essex,25,9,Massachusetts,MA
25011,25CS005,607,577,638,705,98,67,128,70,-0.018363405902345867,0.37948347347304906,0.8049942475623368,0.7093994935467861,745,708,782,717,-28,-65,9,26,-1.538174421458194,-0.9087290285333649,-0.31081418424897683,-0.9592396097254414,70887,71011,Franklin,Franklin,25,11,Massachusetts,MA
25013,25CS006,3896,3696,4096,4817,921,721,1121,751,-0.07372771398008193,0.3661094518921803,0.80709615658996825,0.8146609333393082,4769,4530,5008,5143,374,135,613,448,-0.7842880558315796,-0.1790309304754452,0.3999994189733513,1.194919297312492,464803,463037,Hampden,Hampden,25,13,Massachusetts,MA
25015,25CS007,1109,1039,1179,1246,137,67,207,149,-0.501798905953594,-0.0673674294187517,0.35531874722290957,1.0804452480357716,1368,1285,1452,1404,36,-48,119,93,-1.0771798023388717,-0.41694292460867,0.19104049809331047,2.5174422270921486,161944,161644,Hampshire,Hampshire,25,15,Massachusetts,MA
25017,25CS008,10013,9313,10712,11522,1509,810,2209,2117,-0.8227312858028444,-0.3729803804989991,0.06084238700907894,1.4015861361827329,12299,11465,13134,12198,-101,-936,733,823,-1.273429764232909,-0.6831444461372755,-0.06851383336400932,-8.190990554823887,1625245,1616883,Middlesex,Middlesex,25,17,Massachusetts,MA
25021,25CS009,5146,4835,5458,5757,611,299,922,926,-0.888123162910191,-0.4441204891975134,0.019260352773475604,1.513877587066012,6333,5959,6707,6181,-152,-526,222,374,-1.5211802144867073,-0.8693094047861751,-0.25591915057655923,-2.482036607515686,723116,724727,Norfolk,Norfolk,25,21,Massachusetts,MA
25023,25CS010,4129,3901,4357,4799,670,442,898,741,-0.576611767701647,-0.13014850426769348,0.3010171229196011,1.104733097487656,5097,4822,5372,5436,339,64,614,412,-0.7659463483597924,-0.1615283243396893,0.4465201540745376,1.21100478230433,529857,532708,Plymouth,Plymouth,25,23,Massachusetts,MA
25025,25CS011,4048,3706,4389,5128,1080,739,1422,1089,-0.41334105583022823,-0.012044361329239446,0.40539796902786623,1.0070215500147572,4904,4504,5304,5137,233,-167,633,393,-0.8565201169658236,-0.21552400386398224,0.3839073645820009,1.6787722674897965,794441,774772,Suffolk,Suffolk,25,25,Massachusetts,MA
25027,25CS012,6446,6077,6816,6985,539,169,908,1135,-1.0919181797358348,-0.7030721823983817,-0.28484218942813655,2.1030767926627387,7953,7508,8398,7791,-162,-607,283,665,-1.7841600352079083,-1.1358259575544227,-0.5460298606539002,-4.132593527372886,856834,861946,Worcester,Worcester,25,27,Massachusetts,MA
26001,26CS001,157,153,162,176,19,14,23,20,-0.5285166895402785,-0.11061379114770764,0.32159175624668257,1.0101800251268993,191,186,196,226,35,30,40,35,-0.6076410358502482,5.828958536016185e-4,0.641950373866255,0.9689149284306022,10209,10224,Alcona+Alpena+Presque Isle,Alcona,26,1,Michigan,MI
26007,26CS001,326,314,339,343,17,4,29,20,-0.5464434010578106,-0.10987639840510802,0.2845617384825266,1.131965841206694,397,382,412,477,80,65,95,72,-0.2845165744233897,0.3384853408276746,0.89698340217145,0.8891197798083614,28808,28891,Alcona+Alpena+Presque Isle,Alpena,26,7,Michigan,MI
26141,26CS001,171,165,176,170,-1,-6,5,11,-1.3056750546598435,-0.883736162049019,-0.4830172309207258,26.20805433521256,209,202,215,211,2,-4,9,33,-3.3970667460891857,-2.8149356797477227,-2.2156754923222235,9.80085536635055,12936,13076,Alcona+Alpena+Presque Isle,Presque Isle,26,141,Michigan,MI
26003,26CS002,94,93,94,78,-16,-16,-15,6,-2.5277937800280252,-2.4283942509671292,-2.327817215029661,-0.41210593415620733,114,113,115,113,-1,-2,-0,3,-0.7384875538003072,-0.5912968851766796,-0.4497467985653261,-8.821307897899421,8868,8823,Alger+Delta+Schoolcraft,Alger,26,3,Michigan,MI
26041,26CS002,403,388,419,502,99,83,114,63,0.572100448923408,0.9730163101765186,1.4322192418321171,0.6329280968837196,497,478,516,555,58,39,77,51,-0.3614259298439153,0.25159225202797114,0.8538959709987176,0.8589289172637783,36680,36828,Alger+Delta+Schoolcraft,Delta,26,41,Michigan,MI
26153,26CS002,93,93,94,110,17,16,17,2,1.729872969479163,1.8231654243507645,1.9194372992796256,0.11320135470669065,114,113,115,131,17,16,18,5,1.5975257405784669,1.7448666415750456,1.895631339104331,0.2832257497391497,8046,8032,Alger+Delta+Schoolcraft,Schoolcraft,26,153,Michigan,MI
26005,26CS003,903,852,955,1042,139,87,190,73,0.09967105664491689,0.5472294447456194,0.9567622930653057,0.5231233060048274,1115,1053,1178,1279,164,101,226,168,-0.713835133804903,-0.04302815636936055,0.5497943901539091,1.0190254665435734,120261,120898,Allegan,Allegan,26,5,Michigan,MI
26009,26CS004,233,223,243,259,26,16,36,5,0.466620977378629,0.9036789459148666,1.360844260993959,0.18332765660167055,288,276,301,332,44,31,56,36,-0.2559723923249659,0.38301478737708117,0.9543994635830204,0.807274505265101,23453,23756,Antrim+Charlevoix+Kalkaska+Otsego,Antrim,26,9,Michigan,MI
26029,26CS004,246,235,257,242,-4,-15,7,12,-1.0468149593873617,-0.6033210389647753,-0.17478274014155568,-4.305492840548784,302,288,315,376,74,61,88,36,1.1368043694407324,1.7870668962250664,2.401853033950678,0.47762812823553663,26047,26075,Antrim+Charlevoix+Kalkaska+Otsego,Charlevoix,26,29,Michigan,MI
26079,26CS004,180,172,188,209,29,21,37,13,0.48234350910106105,0.8889916435934099,1.3165505099475923,0.4354584170746177,221,212,230,251,30,21,39,26,-0.3514854075095211,0.25200721221911077,0.8179361945481083,0.8360302775605117,17939,17971,Antrim+Charlevoix+Kalkaska+Otsego,Kalkaska,26,79,Michigan,MI
26137,26CS004,237,226,248,276,39,28,50,19,0.36725388912128293,0.7958749141759808,1.2014741947081484,0.4780592262653716,293,280,306,366,73,60,86,59,0.08621379793322714,0.6748436085493208,1.2961246183949562,0.7943825189141345,25058,25262,Antrim+Charlevoix+Kalkaska+Otsego,Otsego,26,137,Michigan,MI
26011,26CS005,172,166,179,204,32,25,38,15,0.6895300816624124,1.1350576919905226,1.5913397440581991,0.45614291205819635,210,202,218,254,44,36,52,20,1.3370236096733417,1.9195196457984358,2.5889490234198624,0.44277592905359636,14982,14977,Arenac+Iosco+Ogemaw,Arenac,26,11,Michigan,MI
26069,26CS005,351,340,362,405,54,43,65,43,0.008762510225036064,0.42535724049815343,0.8459637576710186,0.786257521570343,429,416,442,499,70,57,83,56,-0.00970610840398662,0.6427259486054532,1.2290139565939502,0.793003974637598,25217,25343,Arenac+Iosco+Ogemaw,Iosco,26,69,Michigan,MI
26129,26CS005,276,267,285,294,18,9,27,28,-0.9007952059481832,-0.4829421989601304,-0.05865647869676245,1.4806353449595924,336,325,346,385,49,39,60,52,-0.7437370433840435,-0.13985052136956264,0.45252739393656827,1.0311738652697595,20767,20728,Arenac+Iosco+Ogemaw,Ogemaw,26,129,Michigan,MI
26015,26CS006,497,470,524,534,37,10,64,39,-0.44702624262261437,-0.011809081749992898,0.3818613542531467,1.0199541915062529,614,581,646,769,155,123,188,78,0.8764535477840909,1.5000591850810114,2.0639830699884847,0.49887055960137633,62439,62927,Barry,Barry,26,15,Michigan,MI
26017,26CS007,1086,1042,1131,1312,226,181,270,148,0.3468084038864547,0.7333581944555043,1.161268663325827,0.6533122660936301,1326,1273,1379,1559,233,180,286,219,-0.45142477079626514,0.16095926660370038,0.7856988647929812,0.935590795127519,103439,103074,Bay,Bay,26,17,Michigan,MI
26019,26CS008,181,173,189,226,45,37,53,24,0.7302044669527803,1.1735917178699777,1.610587794275271,0.52088758445465555,224,215,234,241,17,7,26,24,-1.0846304661746815,-0.4867010269434335,0.10040147711736547,1.3603517361477235,17970,18187,Benzie+Manistee+Mason,Benzie,26,19,Michigan,MI
26101,26CS008,282,271,292,343,61,51,72,21,1.1928757983720262,1.6161228950143929,2.061636572846138,0.33605126543934716,348,335,361,373,25,12,38,43,-1.498294846583771,-0.8488834768924406,-0.25719008296605456,1.6466646308786426,25028,25308,Benzie+Manistee+Mason,Manistee,26,101,Michigan,MI
26105,26CS008,295,282,307,349,54,42,67,21,0.7211162593971665,1.1314406255859828,1.5680715332261586,0.37972815157712986,364,349,379,441,77,62,92,46,0.6132593001760095,1.270151254241404,1.8491689681587464,0.5911796248747155,29110,29336,Benzie+Manistee+Mason,Mason,26,105,Michigan,MI
26021,26CS009,1485,1419,1551,1652,167,101,233,170,-0.4476750370212874,-0.02178500848354812,0.3985967282180256,1.0128633191932896,1807,1728,1886,2005,198,119,277,204,-0.6284249797121447,-0.06107324819715787,0.5751960837846459,1.024152998459858,153883,153246,Berrien,Berrien,26,21,Michigan,MI
26023,26CS010,419,400,438,468,49,30,68,71,-0.9087882023153342,-0.4968558607110063,-0.10071754230867895,1.4261875710213445,518,495,542,565,47,23,70,75,-1.4063380345110703,-0.7540692496574776,-0.13059343535129736,1.57441238472715,44629,44959,Branch+Hillsdale,Branch,26,23,Michigan,MI
26059,26CS010,427,408,447,545,118,98,137,63,0.7883268015415777,1.1984848596594624,1.630799205492611,0.530657458392594,525,501,548,651,126,103,150,108,-0.1449303868349069,0.4815439280058062,1.1143833008260475,0.8473174698016608,45645,45565,Branch+Hillsdale,Hillsdale,26,59,Michigan,MI
26025,26CS011,1327,1269,1384,1625,298,241,356,158,0.6360332212032117,1.0652421034595732,1.4799113982313015,0.5278611561343446,1622,1552,1691,1841,219,150,289,229,-0.7425980960298871,-0.10707404416707698,0.5291175891004511,1.0388143085733315,134038,133862,Calhoun,Calhoun,26,25,Michigan,MI
26027,26CS012,452,429,474,560,108,86,131,66,0.4200040682947685,0.8100531351143757,1.240730982867523,0.6033823096666616,552,526,579,633,81,54,107,65,-0.2825065470649086,0.3633671042519947,0.947125685438534,0.7943150615113775,51596,51495,Cass,Cass,26,27,Michigan,MI
26031,26CS013,283,272,294,343,60,49,71,39,0.3839078745376252,0.7942999518395437,1.260105673069915,0.6429901522775728,349,335,362,443,94,81,108,52,1.307004190152429,1.995746489182686,2.6115159515733932,0.5454562282448195,25576,25730,Cheboygan+Emmet,Cheboygan,26,31,Michigan,MI
26047,26CS013,325,311,340,374,49,34,63,32,0.07065015200748963,0.4950928758831281,0.8802349647765982,0.6437483443378136,401,384,419,387,-14,-32,3,28,-2.1382179903270884,-1.4672592260106305,-0.8674507173253087,-2.0973230992286003,33994,34205,Cheboygan+Emmet,Emmet,26,47,Michigan,MI
26033,26CS014,309,293,325,308,-1,-17,15,22,-1.0817057926998106,-0.6068546356092731,-0.1957390576104963,92.37749361582864,382,363,401,451,69,50,88,50,0.03288562420275682,0.60252686601209,1.273790126219828,0.7160610281780826,36831,36806,Chippewa+Luce+Mackinac,Chippewa,26,33,Michigan,MI
26095,26CS014,55,55,56,65,10,9,10,4,0.9825913197733364,1.0950339473763526,1.189468987767996,0.3655611956918561,66,65,67,82,16,15,17,6,2.106256816269769,2.2684217493348378,2.403623817797712,0.3514988693737193,5461,5311,Chippewa+Luce+Mackinac,Luce,26,95,Michigan,MI
26097,26CS014,146,141,150,140,-6,-10,-1,8,-1.669890737443517,-1.2637973542360217,-0.8449846663274567,-1.698966352133036,179,174,185,195,16,10,21,14,-0.4050789849142443,0.23670725400769985,0.8325610845859684,0.8335498057290417,10835,10895,Chippewa+Luce+Mackinac,Mackinac,26,97,Michigan,MI
26035,26CS015,392,378,405,434,42,29,56,42,-0.3974614928869999,0.009348527562133679,0.44793730014297417,0.9658827358339307,481,465,497,557,76,60,92,65,-0.17829119256723824,0.41385300702123695,1.000451467054408,0.8459993653656968,30856,31030,Clare+Gladwin,Clare,26,35,Michigan,MI
26051,26CS015,314,303,325,390,76,65,87,36,1.1417164335558758,1.5745990776418075,1.9706603505896167,0.4681894076902032,385,372,398,480,95,82,108,59,1.0937292968576506,1.6736571181002553,2.3436230031146907,0.6163932336463716,25390,25468,Clare+Gladwin,Gladwin,26,51,Michigan,MI
26037,26CS016,526,492,560,638,112,78,146,48,0.3656960997721573,0.7972451728796811,1.226912670975126,0.4247404867881973,650,609,691,771,121,80,162,90,-0.19266850419333026,0.4500470884472574,1.0768961155914674,0.7391281986857983,79230,79383,Clinton,Clinton,26,37,Michigan,MI
26039,26CS017,156,150,161,155,-1,-6,5,2,-0.6609698821664043,-0.23209269818584088,0.21048282687257558,13.200194814022778,192,185,198,219,27,21,34,12,0.8272566535527293,1.4085242043732964,2.03087091215895,0.4221907207157875,13143,13169,Crawford+Montmorency+Oscoda+Roscommon,Crawford,26,39,Michigan,MI
26119,26CS017,143,139,147,159,16,12,20,16,-0.40951780107672275,0.034468718871476234,0.45304163684196896,0.9305598841377741,175,171,180,200,25,20,29,26,-0.7742197488582764,-0.18963058402778205,0.4268343346445861,1.0163474667733416,9192,9276,Crawford+Montmorency+Oscoda+Roscommon,Montmorency,26,119,Michigan,MI
26135,26CS017,106,105,107,148,42,41,43,13,3.418735591433777,3.518693225940588,3.615379151416327,0.3020788816727363,131,130,132,172,41,40,42,33,1.0313687396849085,1.1893705552528249,1.3427447993690955,0.7811379156342039,8254,8300,Crawford+Montmorency+Oscoda+Roscommon,Oscoda,26,135,Michigan,MI
26143,26CS017,345,335,355,389,44,34,54,29,0.2248142671903909,0.6743035040130106,1.1281187960919727,0.6389085964135877,421,409,433,468,47,35,59,61,-1.3087658025040592,-0.710644470353795,-0.12328739669343824,1.2785888539897445,23534,23604,Crawford+Montmorency+Oscoda+Roscommon,Roscommon,26,143,Michigan,MI
26043,26CS018,271,260,282,339,68,57,79,68,-0.42050425968934213,0.0014906068515109934,0.43777299346702253,0.989289845624068,332,319,346,360,28,14,41,30,-0.7378371283842721,-0.081973434481342,0.5087330211431064,1.0410909372013706,25795,25801,Dickinson+Iron+Menominee,Dickinson,26,43,Michigan,MI
26071,26CS018,174,169,179,204,30,25,35,28,-0.2405816874036989,0.16956090295863502,0.5901141029943404,0.9025218725553863,213,207,219,197,-16,-22,-10,25,-4.838201293474425,-4.218931296561412,-3.6257312134444555,-1.6912633363255634,11552,11635,Dickinson+Iron+Menominee,Iron,26,71,Michigan,MI
26109,26CS018,251,240,261,248,-3,-13,8,22,-1.4373332911675305,-1.0646783707344716,-0.6069863010996065,-14.65602242924547,306,294,319,326,20,7,32,33,-1.3028578293613213,-0.6995240694965308,-0.027594399550466185,1.607258284015911,23315,23317,Dickinson+Iron+Menominee,Menominee,26,109,Michigan,MI
26045,26CS019,888,841,935,1071,183,136,230,80,0.5304068949435999,0.9430745642035161,1.38815199264837,0.4353777551756193,1092,1035,1148,1330,238,182,295,183,0.007477604742636599,0.596920770021347,1.2144954536499413,0.7644018967945888,109237,108968,Eaton,Eaton,26,45,Michigan,MI
26049,26CS020,3916,3742,4090,4701,785,611,959,497,0.3115318147221069,0.7023173331650423,1.143360297965887,0.6322781328077213,4789,4580,4998,5635,846,637,1055,670,-0.12763945693547837,0.5382306413186573,1.1208999755170233,0.7907926651925584,405506,404418,Genesee,Genesee,26,49,Michigan,MI
26055,26CS021,789,748,830,899,110,69,151,37,0.3011152848148536,0.7686418021159149,1.2063264880351952,0.33445770636523553,978,929,1027,1121,143,94,192,113,-0.22032776605378815,0.4000577222573766,0.9794032047296903,0.7849516893996011,95039,95781,Grand Traverse+Leelanau,Grand Traverse,26,55,Michigan,MI
26089,26CS021,214,204,223,243,29,20,39,10,0.42540910223235096,0.8660321511812435,1.28705542317905,0.33225249114965194,266,254,277,316,50,39,62,28,0.5286589150418417,1.1795040506770431,1.821652781091726,0.5471684689620017,22246,22576,Grand Traverse+Leelanau,Leelanau,26,89,Michigan,MI
26057,26CS022,408,390,426,484,76,58,94,54,0.14451662813530858,0.5422853990065537,0.9580737472962658,0.6993443628289051,500,478,521,528,28,7,50,48,-1.1629849254166973,-0.5757114365001916,0.08435053264424845,1.6362895093709493,41507,41561,Gratiot+Isabella,Gratiot,26,57,Michigan,MI
26073,26CS022,395,367,423,512,117,89,145,33,0.8701244500440857,1.275983092328885,1.7104054628777958,0.2800176423868274,489,455,522,685,196,163,230,101,1.1581423192850833,1.7653148864269734,2.413068264340365,0.5120286583045739,65272,64766,Gratiot+Isabella,Isabella,26,73,Michigan,MI
26063,26CS023,382,369,396,424,42,28,55,46,-0.5476233709105885,-0.13611614437018577,0.2813613184282542,1.0722415296016379,464,448,480,529,65,49,81,71,-0.8335544207023114,-0.21931915574399372,0.3853674735986671,1.0791281529954184,31276,31266,Huron+Sanilac,Huron,26,63,Michigan,MI
26151,26CS023,419,401,436,492,73,56,91,64,-0.19332080665430415,0.22611265632271976,0.6632813685771629,0.8623910275298241,510,489,531,644,134,113,155,99,0.4186574313682303,1.0484300495156513,1.6346146130073167,0.7322341914955873,40610,40506,Huron+Sanilac,Sanilac,26,151,Michigan,MI
26065,26CS024,1849,1727,1972,2244,395,272,517,157,0.4099136503701053,0.8465244589255718,1.2696873114724343,0.3967499028071923,2277,2130,2424,2847,570,423,717,345,0.31976580874022204,0.9591020539331402,1.5656169885682951,0.6042970711773508,285476,284105,Ingham,Ingham,26,65,Michigan,MI
26067,26CS025,473,444,502,520,47,18,76,31,-0.21116887455729527,0.229121297777736,0.7013925185787534,0.6468005023826215,587,552,621,628,41,7,76,82,-1.3642313940637905,-0.74390656477073,-0.07471238285987632,1.9396109911405877,66574,67148,Ionia,Ionia,26,67,Michigan,MI
26075,26CS026,1489,1420,1558,1706,217,148,286,175,-0.13891620032171056,0.27693173147432065,0.6893388883257487,0.8019038858715556,1824,1742,1907,2158,334,251,416,229,0.1521595771701689,0.8080359916876427,1.4016552964018134,0.6845205002945541,159916,160072,Jackson,Jackson,26,75,Michigan,MI
26077,26CS027,1841,1728,1954,2161,320,207,433,185,0.06671395414989775,0.5113863028693207,0.956161870645417,0.5765112714218622,2261,2127,2396,2657,396,261,530,249,-0.004222069073293809,0.68048435494842,1.2867143473385432,0.6279726280599364,262144,261184,Kalamazoo,Kalamazoo,26,77,Michigan,MI
26081,26CS028,4184,3901,4467,4822,638,355,921,442,-0.13856401926789505,0.2837001938263637,0.7516564550405102,0.6917014688984522,5166,4827,5506,5808,642,302,981,542,-0.43870384712249433,0.18620344520990104,0.7901445075198466,0.8434913774168001,657860,658045,Kent,Kent,26,81,Michigan,MI
26085,26CS029,154,149,159,175,21,16,26,3,1.0412857513614275,1.4783854444124676,1.9042620191137496,0.13704735759221892,190,184,197,194,4,-3,10,20,-2.186851001630659,-1.60492751501882,-0.9999760575363508,4.3921533058457944,12070,12278,Lake+Missaukee+Wexford,Lake,26,85,Michigan,MI
26113,26CS029,149,143,156,167,18,11,24,7,0.28999286322378937,0.6999916474406424,1.1348699239928257,0.37606367701894006,183,175,191,204,21,13,29,30,-1.365658719633964,-0.7221256440858231,-0.06121793417323455,1.3751018058084095,15075,15121,Lake+Missaukee+Wexford,Missaukee,26,113,Michigan,MI
26165,26CS029,308,293,322,329,21,7,36,12,-0.1397398414200924,0.26618238294926716,0.68775335233146,0.5404129989863925,379,361,396,507,128,111,146,66,1.5987269597050695,2.213056746495052,2.8229896366379132,0.5106330758432945,33696,33868,Lake+Missaukee+Wexford,Wexford,26,165,Michigan,MI
26087,26CS030,768,730,806,874,106,68,144,96,-0.3050414827383474,0.10476049857662928,0.5483121242795767,0.8970738759210363,946,900,991,1206,260,215,306,210,0.045961890254782985,0.6865131062935058,1.2901628246392962,0.8031606892637216,88421,88515,Lapeer,Lapeer,26,87,Michigan,MI
26091,26CS031,908,865,950,1037,129,87,172,75,0.11092973661539028,0.5375067147316194,0.9557400862777737,0.5748156254016226,1110,1059,1161,1308,198,147,249,188,-0.4897718219556344,0.1195156452801091,0.7263272986796381,0.9445063865256653,99086,98994,Lenawee,Lenawee,26,91,Michigan,MI
26093,26CS032,1277,1193,1360,1499,222,139,306,80,0.30214696028838683,0.7401452740246448,1.1709112874557828,0.35803160093633146,1584,1483,1685,1911,327,226,428,226,-0.02532107383382525,0.627850089277667,1.3121166711368022,0.6891684610259605,193802,194862,Livingston,Livingston,26,93,Michigan,MI
26099,26CS033,7541,7163,7919,9309,1768,1390,2146,1407,-0.007364127698238251,0.42473077234915685,0.8572973291662817,0.7954402300826288,9230,8777,9683,10657,1427,974,1880,1448,-0.6512229944427975,-0.009878299102527821,0.6168297080227299,1.013833198105884,878818,877311,Macomb,Macomb,26,99,Michigan,MI
26103,26CS034,585,557,613,600,15,-13,43,44,-0.8762703377107299,-0.43173721062902093,4.4174807341796317e-4,2.7512660605211696,717,683,752,793,76,41,110,41,0.017760446174657794,0.6334718371544749,1.225374217067931,0.5356510598984933,66059,66078,Marquette,Marquette,26,103,Michigan,MI
26107,26CS035,323,306,341,412,89,71,106,13,1.4572833340550304,1.8705842677762414,2.2902322857900272,0.1450673711339609,397,376,418,474,77,56,98,59,-0.07594874657402641,0.5372329238877689,1.149286532221512,0.7567889162298147,40362,39995,Mecosta+Osceola,Mecosta,26,107,Michigan,MI
26133,26CS035,211,202,221,223,12,2,21,17,-0.6312862521686853,-0.22917651126154176,0.20515660915773878,1.3504755573583778,261,249,273,285,24,12,36,47,-1.7870045825547336,-1.203960634479431,-0.5800448593012371,1.8758068094305538,22984,23073,Mecosta+Osceola,Osceola,26,133,Michigan,MI
26111,26CS036,648,612,684,767,119,83,155,37,0.5670635498898627,0.9907485645088592,1.4045370969948476,0.30886941092519654,797,754,840,938,141,98,184,103,-0.033858483706852446,0.5439095716798592,1.1572883804667768,0.7246308419339169,83465,83460,Midland,Midland,26,111,Michigan,MI
26115,26CS037,1330,1264,1397,1530,200,133,266,123,0.045529727017323864,0.4924368411815248,0.9274364238687157,0.6133563849834219,1642,1562,1722,1929,287,207,367,207,9.82384369453952e-4,0.5990956201349029,1.2158671823026614,0.7182555605770948,154206,155204,Monroe,Monroe,26,115,Michigan,MI
26117,26CS038,570,541,598,620,50,22,79,70,-0.7190711253697905,-0.2831485112776698,0.12231345947837256,1.3667701875676908,710,675,745,819,109,74,144,90,-0.32523436538620937,0.3426730075541148,0.9323882810149472,0.8185783640710391,66179,67117,Montcalm,Montcalm,26,117,Michigan,MI
26121,26CS039,1517,1442,1593,1878,361,285,436,247,0.2045163833952739,0.6523253460004454,1.077797948869244,0.6827514258053754,1869,1778,1960,2150,281,190,372,230,-0.30729331406986643,0.3606815150585737,0.9892919486131078,0.8154461392789233,175573,176410,Muskegon,Muskegon,26,121,Michigan,MI
26123,26CS040,441,420,463,488,47,25,68,30,-0.0966621657753798,0.3418724424244018,0.788914038635326,0.627500545440489,541,515,567,641,100,74,126,82,-0.20987351454044112,0.46696945254895517,1.0213844746922192,0.810300840616259,49920,50259,Newaygo+Oceana,Newaygo,26,123,Michigan,MI
26127,26CS040,231,219,242,284,53,42,65,41,0.04902621837524101,0.463406140247564,0.914850900660974,0.7527627955181219,282,268,296,330,48,34,62,37,-0.15311384128478067,0.5006236328694522,1.1117856599420397,0.7588348654762611,26683,26796,Newaygo+Oceana,Oceana,26,127,Michigan,MI
26013,26CS041,89,88,90,105,16,15,17,27,-1.48367822712579,-1.3787091986915607,-1.2817706695300741,1.6117612536992276,110,109,111,114,4,3,5,18,-2.2522443803657857,-2.1081266366349807,-1.953678751177492,3.9134176915668184,8154,8202,Northwest Upper Peninsula,Baraga,26,13,Michigan,MI
26053,26CS041,169,163,175,207,38,32,44,38,-0.4027919450734639,0.014461931411062678,0.437496688930935,0.9698944606582351,208,201,215,211,3,-4,10,20,-2.0759544344011327,-1.4144983526667099,-0.812589098480684,5.06927053536423,14270,14354,Northwest Upper Peninsula,Gogebic,26,53,Michigan,MI
26061,26CS041,322,306,338,333,11,-5,27,27,-0.8539274543678129,-0.4411418765819567,0.010745105292838576,2.276918858676165,401,382,420,381,-20,-39,-1,46,-2.7285558488316313,-2.1168709077066707,-1.5101133294418647,-2.4306471821366036,36964,37291,Northwest Upper Peninsula,Houghton,26,61,Michigan,MI
26083,26CS041,24,23,25,26,2,1,3,4,-1.5355360600084622,-1.0969084103046498,-0.664908981471673,1.479132563750994,30,29,31,35,5,4,6,2,0.9092709201324461,1.5426620807389675,2.1228051170368225,0.35212108134131653,2065,2099,Northwest Upper Peninsula,Keweenaw,26,83,Michigan,MI
26131,26CS041,82,81,83,115,33,32,34,20,2.133665573816574,2.2322456951187344,2.33216916940303,0.5892385861225501,102,101,102,101,-1,-1,0,13,-2.964581667411513,-2.812946933978715,-2.6688926900375,47.09771699869749,5797,5859,Northwest Upper Peninsula,Ontonagon,26,131,Michigan,MI
26125,26CS042,9157,8610,9703,10946,1789,1243,2336,1401,-0.1626136852126333,0.3328496009508344,0.742630014565001,0.7825826987213773,11265,10609,11920,12421,1156,501,1812,1189,-0.6241883134716082,-0.02659235692412971,0.6124111273847803,1.0272160661216048,1270018,1270366,Oakland,Oakland,26,125,Michigan,MI
26139,26CS043,1761,1633,1888,2147,386,259,514,221,0.11171090996814563,0.5593747682927778,0.9788294762893099,0.5703529185810768,2198,2044,2352,2544,346,192,500,290,-0.39778398176814944,0.23022343495508965,0.832288808364421,0.8361973378098558,296257,298811,Ottawa,Ottawa,26,139,Michigan,MI
26145,26CS044,1813,1732,1895,2310,497,415,578,328,0.4262210098477482,0.8916724932717393,1.2913939530240581,0.6589520578418386,2218,2120,2316,2583,365,267,463,337,-0.43073526547325924,0.17371248571369835,0.8198788554742895,0.9217601123745857,189901,189626,Saginaw,Saginaw,26,145,Michigan,MI
26147,26CS045,1531,1462,1600,1776,245,176,314,154,0.14207500389436387,0.5761014607441447,1.0255290496511191,0.6268463892309782,1874,1791,1957,2356,482,399,565,411,-0.100818593442137,0.5436310900948423,1.1686484820949863,0.8508821791326331,160108,160084,St. Clair,St. Clair,26,147,Michigan,MI
26149,26CS046,569,542,595,639,70,44,97,59,-0.21371116706307047,0.18709251756323148,0.585966951068367,0.8268218767228951,696,664,727,792,96,65,128,89,-0.4409743158158957,0.14539848405295763,0.7508580575058145,0.9159047656828314,60876,60779,St. Joseph,St. Joseph,26,149,Michigan,MI
26155,26CS047,633,604,663,728,95,65,124,49,0.23874443645317067,0.6656397402916188,1.0867565599287046,0.5124774901336975,777,742,812,879,102,67,137,118,-0.8970414017852374,-0.28407460655460354,0.3358289681467411,1.14184187913053,67984,67892,Shiawassee,Shiawassee,26,155,Michigan,MI
26157,26CS048,534,511,557,647,113,90,136,90,0.00998277940762483,0.44448249410226803,0.8346738601500411,0.7903277437232824,654,626,681,794,140,113,168,118,-0.08779427242958371,0.48998887435118843,1.1577306337736615,0.8356558509743139,53103,52969,Tuscola,Tuscola,26,157,Michigan,MI
26159,26CS049,660,627,692,767,107,75,140,90,-0.15803380933229375,0.21592954824735217,0.6402237063570978,0.830278321733339,809,770,848,979,170,131,209,117,0.23796728009297155,0.8419667795782166,1.4322974319487525,0.6835265147830796,75572,75643,Van Buren,Van Buren,26,159,Michigan,MI
26161,26CS050,2004,1845,2164,2311,307,147,466,179,-0.07797498358774609,0.3381885646424407,0.7866192319116301,0.5819346996338353,2485,2294,2676,2630,145,-46,336,172,-0.7389079779891947,-0.08050052504626125,0.5483511878206843,1.1798271729272451,370922,369720,Washtenaw,Washtenaw,26,161,Michigan,MI
26163,26CS051,15695,14927,16463,19800,4105,3337,4873,3079,0.15182948593240517,0.563828718107424,1.0219534829520265,0.7498776912769727,19152,18234,20069,21672,2520,1603,3438,2477,-0.5988603648826019,0.01937244480580973,0.6330992671232198,0.982510297849765,1782767,1777063,Wayne,Wayne,26,163,Michigan,MI
27001,27CS001,192,185,198,225,33,27,40,29,-0.14199221211103671,0.2823727453471422,0.7017331421354173,0.8434306799045134,236,228,244,248,12,4,20,20,-1.243982133771109,-0.5919069793846402,0.09128179780308947,1.5153761281643512,15735,15859,Aitkin+Itasca,Aitkin,27,1,Minnesota,MN
27061,27CS001,445,426,465,469,24,4,43,36,-0.7181072738011972,-0.27715802600981443,0.16725489809620508,1.4494210433783603,546,523,569,684,138,115,161,64,1.3508548973596841,1.9518963246742131,2.5510326709874067,0.46056480324609494,45028,45057,Aitkin+Itasca,Itasca,27,61,Minnesota,MN
27003,27CS002,1948,1792,2105,2359,411,254,567,331,-0.22635598720538358,0.22660049985797742,0.6656159523845883,0.8042649685344031,2440,2251,2629,2762,322,133,511,307,-0.5372715788591752,0.053616304282789067,0.6463186702145446,0.9498874753568471,363596,366621,Anoka,Anoka,27,3,Minnesota,MN
27005,27CS003,328,312,343,386,58,43,74,40,0.11781550053536102,0.5245538272372653,0.9698810450886407,0.6733110111304847,406,388,424,410,4,-14,22,43,-1.9665539748551135,-1.313803864381965,-0.729949333234987,8.46394657672333,35054,35208,Becker+Hubbard+Mahnomen+Norman,Becker,27,5,Minnesota,MN
27057,27CS003,191,182,200,229,38,29,47,37,-0.3842966347144046,0.038237711322553616,0.42994693003322676,0.954157370375089,239,228,250,236,-3,-14,8,15,-1.6048600558323296,-0.9920366074190342,-0.3656454506376835,-7.630023717518187,21448,21666,Becker+Hubbard+Mahnomen+Norman,Hubbard,27,57,Minnesota,MN
27087,27CS003,55,55,56,68,13,12,13,3,1.6875200636614351,1.788901935395915,1.8886472960380145,0.21962669029960322,68,67,69,88,20,19,21,10,2.0466479156470454,2.207392681539505,2.3596961342240905,0.47715728073173647,5402,5408,Becker+Hubbard+Mahnomen+Norman,Mahnomen,27,87,Minnesota,MN
27107,27CS003,83,83,84,66,-17,-18,-17,5,-3.5677623117089228,-3.4612498892226515,-3.3625091950499497,-0.30809778592695797,102,101,103,85,-17,-18,-16,3,-3.8994245386317425,-3.743359670005834,-3.5974811950365044,-0.18724912483714795,6416,6417,Becker+Hubbard+Mahnomen+Norman,Norman,27,107,Minnesota,MN
27007,27CS004,345,325,364,461,116,97,136,40,1.2145527166345738,1.6375002908199858,2.095228089979289,0.3406074395587666,424,400,448,507,83,59,107,56,0.10169266900173746,0.7034546971142862,1.3662208685584818,0.6649520099195885,46388,46358,Beltrami+Clearwater,Beltrami,27,7,Minnesota,MN
27029,27CS004,82,81,83,92,10,9,11,10,-0.07404852813848127,0.02673837185239418,0.1264008276847849,0.8915355157699195,100,99,101,125,25,24,26,15,1.2790371246053918,1.4230539251567202,1.5677641957726105,0.5722704753966726,8618,8577,Beltrami+Clearwater,Clearwater,27,29,Minnesota,MN
27009,27CS005,327,309,345,397,70,52,88,72,-0.4804916570387924,-0.05016985382216094,0.3932935315197289,1.0116382898130083,403,382,425,407,4,-18,25,51,-1.991001544411392,-1.3820009503777906,-0.7340402618557766,10.544806040765158,41292,41441,Benton+Stearns,Benton,27,9,Minnesota,MN
27145,27CS005,919,851,987,1187,268,200,336,185,0.07598957170828699,0.5184911802360807,0.9627227955446772,0.688218081483458,1142,1060,1224,1277,135,53,217,121,-0.4820419008472165,0.09891391250655741,0.708961199058234,0.8896807467159241,158809,158860,Benton+Stearns,Stearns,27,145,Minnesota,MN
27013,27CS006,434,404,463,456,22,-7,52,27,-0.47994968202374344,-0.05641263644898416,0.37214171442248584,1.158791008977212,535,499,571,593,58,22,94,41,-0.31123395273131654,0.28823941795367686,0.8647400095682153,0.6963957614017843,68995,69264,Blue Earth+Faribault+Martin+Watonwan,Blue Earth,27,13,Minnesota,MN
27043,27CS006,162,156,168,159,-3,-9,3,11,-1.4008916991432945,-0.98140368655055,-0.5281762932139378,-7.012289097797511,197,190,204,184,-13,-20,-6,17,-3.2261431294968554,-2.6005338167622547,-1.9637935900892765,-1.4149210922090047,13859,13906,Blue Earth+Faribault+Martin+Watonwan,Faribault,27,43,Minnesota,MN
27091,27CS006,214,206,223,215,1,-8,9,23,-1.524663704429284,-1.127208109871287,-0.7170592361844894,14.992352474088298,261,251,271,302,41,31,51,25,0.37758634368828947,0.977689984392988,1.5917383800870484,0.5955586906393414,19916,19923,Blue Earth+Faribault+Martin+Watonwan,Martin,27,91,Minnesota,MN
27165,27CS006,103,102,104,134,31,30,32,10,1.8031756871574696,1.9027374855935275,2.001532052065736,0.3105015960544685,126,124,127,128,2,1,4,15,-1.5171225093288012,-1.3609504513836326,-1.2123430760320555,4.485918328824377,11157,11148,Blue Earth+Faribault+Martin+Watonwan,Watonwan,27,165,Minnesota,MN
27015,27CS007,257,246,268,268,11,0,22,30,-1.1600125443673792,-0.7257956196246532,-0.30733503378681054,2.4474240683301085,316,303,330,342,26,12,39,30,-0.8358446308592149,-0.18247444132851867,0.43086321359393365,1.1183601946325457,25744,25829,Brown+Le Sueur+Nicollet,Brown,27,15,Minnesota,MN
27079,27CS007,210,198,223,216,6,-7,18,19,-0.8971724399123482,-0.45891811001046245,-0.03394431286917263,2.8711373869652776,262,247,277,284,22,7,37,32,-1.011671046255606,-0.43318092366841693,0.14645479266611566,1.4063835258202748,28683,28810,Brown+Le Sueur+Nicollet,Le Sueur,27,79,Minnesota,MN
27103,27CS007,224,209,239,238,14,-1,29,30,-0.8639615363947162,-0.4544348084781103,-0.04637756182262584,1.9731825328110462,278,260,296,297,19,1,37,20,-0.6687932109314597,-0.03972362547309978,0.5634975609717467,1.0028016383439653,34447,34355,Brown+Le Sueur+Nicollet,Nicollet,27,103,Minnesota,MN
27019,27CS008,476,430,522,510,34,-12,80,36,-0.42674640959655247,-0.029574134687502446,0.414316535426288,1.0375110610060074,602,546,658,674,72,16,128,53,-0.4105673544341385,0.2033852120647325,0.8532688045886347,0.723979329142812,107111,108431,Carver,Carver,27,19,Minnesota,MN
27021,27CS009,291,278,303,310,19,7,32,24,-0.5720499635791328,-0.15075753148807497,0.3028290442434862,1.1717881703028687,361,345,377,428,67,51,83,40,0.4288751357316297,1.0403546288514078,1.6812624570643753,0.5873721613889362,30105,30564,Cass+Crow Wing,Cass,27,21,Minnesota,MN
27035,27CS009,609,581,638,619,10,-19,38,68,-1.2996597120961542,-0.8858801879632705,-0.4556479249771951,6.3954475420369175,757,722,792,815,58,23,93,67,-0.8252072969996205,-0.17186470238969415,0.4378422893304223,1.1338212844525033,66191,67119,Cass+Crow Wing,Crow Wing,27,35,Minnesota,MN
27025,27CS010,389,364,413,412,23,-1,48,27,-0.5127985894465443,-0.0696001397261022,0.38102595556637725,1.1112059064945838,486,456,515,544,58,29,88,64,-0.7367228643232137,-0.11418950630508842,0.48991989438780625,1.0803840313913402,56735,57352,Chisago+Isanti,Chisago,27,25,Minnesota,MN
27059,27CS010,294,276,312,314,20,2,38,31,-0.6859923098450945,-0.2785596753530019,0.15839870209858903,1.4827463152574003,367,346,389,435,68,46,89,57,-0.33058691943769686,0.2918876638701697,0.8963533806978236,0.8307842459312508,41301,41830,Chisago+Isanti,Isanti,27,59,Minnesota,MN
27027,27CS011,423,395,451,489,66,38,94,83,-0.6668550724843977,-0.27294107779981563,0.1628856594693347,1.2446543282130036,523,490,557,537,14,-20,47,32,-0.968985286040314,-0.32382241515772403,0.3255057624843057,2.1983501151983655,65242,65541,Clay,Clay,27,27,Minnesota,MN
27037,27CS012,2337,2148,2526,2746,409,220,598,285,-0.14230893862633393,0.26979114053892655,0.6687830545867276,0.6957149718981863,2922,2694,3150,3236,314,86,542,333,-0.6973563352161514,-0.05819956625673779,0.5922268805102836,1.057725076622611,438912,441787,Dakota,Dakota,27,37,Minnesota,MN
27039,27CS013,139,137,141,133,-6,-8,-4,7,-0.707418221596888,-0.6160969129157048,-0.5137632826557783,-1.448565398886749,171,169,174,163,-8,-11,-6,11,-1.2681061970325371,-1.1117869861260257,-0.959048631832453,-1.478380053986938,20885,20924,Dodge+Steele+Waseca,Dodge,27,39,Minnesota,MN
27147,27CS013,278,262,294,299,21,5,37,4,0.020484338946575226,0.4576197528422725,0.8952120664678611,0.17809799819027486,344,325,363,382,38,19,57,33,-0.44809900595956914,0.15290523388861005,0.7665593114508897,0.8503855472644053,37255,37349,Dodge+Steele+Waseca,Steele,27,147,Minnesota,MN
27161,27CS013,162,154,170,162,0,-8,8,18,-1.3729512219843705,-0.9547463980871116,-0.5442033929872169,16.943679724577603,200,191,210,188,-12,-22,-3,14,-2.269300442048196,-1.6608567224483868,-1.075700201752341,-1.224691332660578,18901,18993,Dodge+Steele+Waseca,Waseca,27,161,Minnesota,MN
27041,27CS014,386,369,403,433,47,30,64,52,-0.5550680012280559,-0.1295025553186642,0.3003750108840634,1.0801041041332926,473,453,494,447,-26,-47,-6,46,-2.8448416492175492,-2.2084000637914967,-1.5592918773517164,-1.8091592343004912,38948,39215,Douglas+Morrison+Todd,Douglas,27,41,Minnesota,MN
27097,27CS014,281,266,295,323,42,28,57,43,-0.4339884038364547,-0.028811911652841873,0.40487986840664253,0.9901039870484853,344,327,362,415,71,53,88,34,0.6508979515945509,1.313151785464758,1.9101286766228485,0.4740084487148606,33886,33990,Douglas+Morrison+Todd,Morrison,27,97,Minnesota,MN
27153,27CS014,188,178,199,214,26,15,36,31,-0.6804210075225886,-0.20244312627810354,0.19307325245071247,1.1656205147849572,232,219,245,252,20,7,33,28,-0.9857336242064549,-0.34983264266967706,0.20715262328583608,1.3063035002412036,25172,25239,Douglas+Morrison+Todd,Todd,27,153,Minnesota,MN
27045,27CS015,199,189,208,206,7,-2,17,5,-0.30398733476799117,0.10670801560244891,0.5235715626410922,0.5933328321022436,242,231,253,248,6,-5,17,14,-1.057872175284465,-0.4758588988300619,0.17110238769517044,2.0607884861648875,21225,21267,Fillmore+Houston+Winona,Fillmore,27,45,Minnesota,MN
27055,27CS015,165,157,173,179,14,6,22,12,-0.3361769050222347,0.09967102576722073,0.5414204763277692,0.804987520016215,201,191,211,201,-0,-10,10,6,-1.0347987075364533,-0.3753049553897727,0.218539657913817,6.571054804671856,18792,18784,Fillmore+Houston+Winona,Houston,27,55,Minnesota,MN
27169,27CS015,356,335,377,389,33,12,54,41,-0.5970612443421547,-0.15972782423515988,0.24999514263934688,1.2103959227145826,435,409,461,430,-5,-31,21,20,-1.2020076995465745,-0.6043524937286086,-0.010915218192241505,-4.968509998332607,49762,49626,Fillmore+Houston+Winona,Winona,27,169,Minnesota,MN
27047,27CS016,311,297,324,326,15,2,29,17,-0.48376568372181533,-0.0711868352723416,0.38817108904961756,1.0430872353477687,379,363,394,391,12,-3,28,24,-1.0762550760559186,-0.4524602927219612,0.1372626936063939,1.7910498724127022,30796,30769,Freeborn+Mower,Freeborn,27,47,Minnesota,MN
27099,27CS016,354,336,371,354,0,-17,18,30,-1.1864966020246295,-0.7078729169136849,-0.305900391018737,20.549028062725096,433,413,454,446,13,-8,33,21,-0.9408620519262654,-0.28045290821829977,0.27015122408992004,1.5504024646991132,40059,40142,Freeborn+Mower,Mower,27,99,Minnesota,MN
27049,27CS017,427,407,448,482,55,34,75,42,-0.154179375006056,0.25656411059047884,0.714677570837704,0.7542915896267075,529,504,554,566,37,12,62,43,-0.7866495772589691,-0.12553545934189148,0.4540678225920575,1.1270171956107558,47414,47905,Goodhue+Wabasha,Goodhue,27,49,Minnesota,MN
27157,27CS017,168,159,177,194,26,17,35,6,0.5429174910810031,0.926563860499295,1.3819564641598847,0.22099462127426578,207,196,218,219,12,1,23,10,-0.5212083455674071,0.09452127098199405,0.6939027821783854,0.7789364594657695,21446,21496,Goodhue+Wabasha,Wabasha,27,157,Minnesota,MN
27053,27CS018,7636,7086,8185,9067,1431,882,1981,1286,-0.28042819794724083,0.12811864950116986,0.5448548299499991,0.8977366411899065,9379,8723,10034,9900,521,-134,1177,683,-0.7329256570942004,-0.1480712610845817,0.44191388179749114,1.3077526039204854,1277475,1269436,Hennepin,Hennepin,27,53,Minnesota,MN
27065,27CS019,142,135,149,181,39,32,46,19,0.8293957991058963,1.2316085287488499,1.6473030636179682,0.47542986056265685,174,166,182,213,39,31,47,29,0.14586991027013502,0.751759746101192,1.3011837897316505,0.7271955490856681,16099,16142,Kanabec+Mille Lacs+Pine,Kanabec,27,65,Minnesota,MN
27095,27CS019,261,249,272,306,45,34,57,42,-0.27104590388643407,0.12218316116346148,0.5446355613560615,0.9058346287098792,322,308,336,377,55,41,69,47,-0.27040410409853216,0.3504217154561894,0.9935293060116881,0.8389738681680159,26422,26800,Kanabec+Mille Lacs+Pine,Mille Lacs,27,95,Minnesota,MN
27115,27CS019,250,237,262,302,52,40,65,18,0.7509127993613673,1.184340618912582,1.613892757593362,0.33815642998233425,308,293,323,392,84,69,99,38,1.2847375891367574,1.8688157033560988,2.453187958091676,0.44752666839155825,28985,29237,Kanabec+Mille Lacs+Pine,Pine,27,115,Minnesota,MN
27067,27CS020,337,318,356,406,69,50,88,69,-0.41622905521616654,0.00951824950593743,0.42133043752898786,0.9824707411626535,415,392,437,438,23,1,46,48,-1.3350902912182263,-0.6915784221949995,-0.06691378694046755,1.9831642912157832,43614,43755,Kandiyohi+Renville,Kandiyohi,27,67,Minnesota,MN
27129,27CS020,159,152,165,174,15,9,22,34,-1.7104354622963451,-1.2818683570965483,-0.8392457350643494,2.0896215615010028,193,186,201,203,10,2,17,10,-0.6020525368567121,-0.007631593628395713,0.57292573109733,0.9214367217852117,14657,14619,Kandiyohi+Renville,Renville,27,129,Minnesota,MN
27085,27CS021,294,279,310,376,82,66,97,39,0.7592955801096469,1.1597153633688613,1.6148831406718103,0.4719793792273399,361,342,380,417,56,37,75,43,-0.14700881558636328,0.4085011330037882,1.0775682026071551,0.7530095722827461,36577,36730,McLeod+Meeker+Sibley,McLeod,27,85,Minnesota,MN
27093,27CS021,194,184,204,226,32,22,42,29,-0.2901654112183338,0.11275785014556924,0.58152437342071,0.8744062045099026,237,225,249,244,7,-5,19,27,-1.616286455202538,-1.0131745829029937,-0.3956669857496116,3.258431552420333,23384,23384,McLeod+Meeker+Sibley,Meeker,27,93,Minnesota,MN
27143,27CS021,122,121,123,93,-29,-30,-28,3,-2.2656646426406017,-2.159157629553761,-2.068765706079025,-0.10714871086824465,150,148,152,169,19,17,21,12,0.3840228330141122,0.5380781957907677,0.6842908495207476,0.6109483327293053,14824,14900,McLeod+Meeker+Sibley,Sibley,27,143,Minnesota,MN
27069,27CS022,50,49,50,74,24,24,25,19,1.1078908670649963,1.2121746788862064,1.3093227964267522,0.7574552223063137,61,60,61,61,0,-0,1,5,-1.50354857859555,-1.3512358592276523,-1.2022417468218232,3.7935936001892494,4192,4151,Northwest Minnesota,Kittson,27,69,Minnesota,MN
27077,27CS022,39,38,39,45,6,6,7,7,-0.2844463122618075,-0.1900611543459154,-0.09382677971121575,0.9614280959211379,48,48,49,50,2,1,2,3,-0.5591788684271175,-0.3929407549274645,-0.23508204929171903,1.089242789067232,3763,3814,Northwest Minnesota,Lake of the Woods,27,77,Minnesota,MN
27089,27CS022,72,71,73,87,15,14,16,15,-0.08954807252716158,0.011135258681507727,0.1164915729799533,0.931221546288455,88,87,89,97,9,8,10,12,-0.5305238979656496,-0.38692125178846437,-0.24627218522036387,1.1863514089927594,9075,8995,Northwest Minnesota,Marshall,27,89,Minnesota,MN
27113,27CS022,116,114,117,121,5,4,7,13,-0.64360308096862,-0.54318404397775355,-0.4426729611477881,2.025548620683556,141,139,143,155,14,12,16,13,-0.06508623506605356,0.0841739752827302,0.22948718961995965,0.870007433134137,13941,13803,Northwest Minnesota,Pennington,27,113,Minnesota,MN
27119,27CS022,301,288,315,349,48,34,61,60,-0.8180466695570745,-0.38625869478457187,0.026193525834894014,1.233599860997856,368,352,384,378,10,-6,26,35,-1.5948703598797673,-0.986518323190627,-0.3413378571859666,3.2193204742187027,31061,30800,Northwest Minnesota,Polk,27,119,Minnesota,MN
27125,27CS022,28,28,29,27,-1,-2,-1,0,-0.4367977366247649,-0.3348894215245784,-0.2417064851710413,-0,35,34,35,43,8,8,9,8,-0.11774043037876489,0.04602221159486805,0.19381911072328806,0.8743029456900394,3950,3933,Northwest Minnesota,Red Lake,27,125,Minnesota,MN
27135,27CS022,120,118,121,174,54,53,56,17,2.3478130064460268,2.4472906600663604,2.547136969260144,0.3068919715644257,147,146,149,169,22,20,23,15,0.37039041337187817,0.513523915732229,0.6721764480269355,0.6651835669055327,15273,15263,Northwest Minnesota,Roseau,27,135,Minnesota,MN
27109,27CS023,970,900,1040,1055,85,15,155,57,-0.2802135679860479,0.17710515870458593,0.5718521672310666,0.6638205487378438,1206,1122,1290,1261,55,-29,139,51,-0.619680803521275,0.0086711238755846215,0.6510941377303294,0.9107839824570173,162337,163371,Olmsted,Olmsted,27,109,Minnesota,MN
27111,27CS024,582,556,608,675,93,67,119,53,0.22804973680978874,0.6784766061612333,1.1133497857202903,0.5634225841795338,712,681,743,779,67,36,98,82,-0.9263678386545446,-0.27873625790285406,0.3032375473708187,1.2057719079842186,59831,60043,Otter Tail+Wadena+Wilkin,Otter Tail,27,111,Minnesota,MN
27159,27CS024,182,176,189,170,-12,-19,-6,11,-2.075076632690579,-1.664600279245908,-1.2326633700774514,-0.957110775246578,223,216,231,221,-2,-10,5,29,-3.2925419103926945,-2.6444706362437316,-2.0462569383780895,-23.48732325865576,14049,14167,Otter Tail+Wadena+Wilkin,Wadena,27,159,Minnesota,MN
27167,27CS024,71,70,72,76,5,4,6,12,-1.183215780291009,-1.083075418883606,-0.9815385397895725,1.9842953597389197,87,86,87,88,1,1,2,11,-1.9273951218636476,-1.780015110490331,-1.6243434294167995,4.4212718159138245,6434,6408,Otter Tail+Wadena+Wilkin,Wilkin,27,167,Minnesota,MN
27123,27CS025,3669,3432,3905,4354,685,449,922,630,-0.2896435588356679,0.11283713467104539,0.5227084774027726,0.9180032284501014,4478,4197,4760,4968,490,208,771,357,-0.3728291864388675,0.2688454217781804,0.9036572548510953,0.727705791168427,550354,544456,Ramsey,Ramsey,27,123,Minnesota,MN
27131,27CS026,446,417,474,508,62,34,91,52,-0.23658123509921838,0.1438284850222306,0.568791998776998,0.8189393250842963,553,518,587,614,61,27,96,73,-0.8237415389879676,-0.20733421117327266,0.3766805227478438,1.1703706952562436,67052,67228,Rice,Rice,27,131,Minnesota,MN
27017,27CS027,326,310,341,367,41,26,57,41,-0.4041850430525495,0.01764168520979995,0.4037926256048477,0.9650068270121751,401,382,419,470,69,51,88,34,0.5350878341037231,1.1489745867409977,1.7391554604222093,0.48330199415864955,36147,36372,St. Louis and Nearby Counties,Carlton,27,17,Minnesota,MN
27031,27CS027,45,45,46,48,3,2,3,1,0.22574592299174323,0.3298139885393424,0.4393933630386059,0.26050439524918134,56,55,57,49,-7,-8,-6,4,-2.4815334853937765,-2.339256206293998,-2.1833731743313027,-0.6740269104939338,5569,5613,St. Louis and Nearby Counties,Cook,27,31,Minnesota,MN
27071,27CS027,124,123,125,147,23,22,24,3,1.576392916523077,1.6731418796605335,1.7715870001843441,0.1241818462362397,151,149,152,186,35,34,37,22,1.184299409186872,1.3280541325826405,1.4795282908241554,0.6057344128367307,12047,11954,St. Louis and Nearby Counties,Koochiching,27,71,Minnesota,MN
27075,27CS027,135,131,140,135,-0,-5,4,12,-1.5423731465227308,-1.126342522066445,-0.7044105352862056,14.624971239881955,166,160,172,168,2,-4,8,6,-1.068339270697285,-0.45082592983481845,0.23494177143012854,1.9992761708638243,10858,10971,St. Louis and Nearby Counties,Lake,27,75,Minnesota,MN
27137,27CS027,1766,1680,1852,2079,313,227,399,220,0.049468419959728636,0.46714879658517916,0.9035339997566677,0.6998199189975459,2156,2054,2259,2368,212,109,314,185,-0.47094474000781816,0.15227676858893327,0.8116034476638007,0.8703694959751818,199771,199296,St. Louis and Nearby Counties,St. Louis,27,137,Minnesota,MN
27139,27CS028,629,564,694,740,111,46,176,64,-0.12125527607874952,0.3023158696072156,0.7455120114788306,0.5721668464485303,795,716,874,911,116,37,195,109,-0.5433276928010812,0.052047569647844516,0.6616780639294234,0.93132951704194,151144,152976,Scott,Scott,27,139,Minnesota,MN
27141,27CS029,486,444,528,595,109,67,151,57,0.10888134099502698,0.5391182194924115,1.0006086637329525,0.5188785727971015,612,561,663,727,115,64,166,87,-0.2289372614397963,0.3294397386898457,0.9250790304237524,0.749361256736907,97637,98841,Sherburne,Sherburne,27,141,Minnesota,MN
27033,27CS030,136,131,141,150,14,9,19,16,-0.6263400252549113,-0.13306111887478878,0.2806183384007964,1.0376068814727792,167,161,173,166,-1,-7,5,16,-2.35406025975339,-1.7651276089516943,-1.1488055415835774,619.6811063808541,11460,11557,Southwest Minnesota,Cottonwood,27,33,Minnesota,MN
27063,27CS030,91,90,92,96,5,4,6,11,-0.7427812418876938,-0.6384638787571273,-0.5355628221646626,1.9502557683526658,113,112,114,106,-7,-8,-6,8,-1.9493863364214028,-1.8025899732205062,-1.6472706847872116,-1.335980220095267,9946,9987,Southwest Minnesota,Jackson,27,63,Minnesota,MN
27101,27CS030,82,81,83,58,-24,-25,-23,5,-3.633059503808922,-3.528959442908427,-3.423695519524267,-0.21891138607670674,100,99,101,109,9,8,10,1,0.9695348496967305,1.1123090466741223,1.2748974111767073,0.10444421805664597,8170,8148,Southwest Minnesota,Murray,27,101,Minnesota,MN
27105,27CS030,161,152,171,201,40,30,49,43,-0.5890862034583418,-0.14281853690729923,0.29862619083936276,1.0558787288631257,199,187,210,185,-14,-25,-2,18,-2.335042309130065,-1.719734884907353,-1.0679944929252185,-1.4142099760445215,22085,22019,Southwest Minnesota,Nobles,27,105,Minnesota,MN
27117,27CS030,103,102,104,106,3,2,4,17,-1.5824255365771023,-1.4897497510249895,-1.387319638253594,4.169554970476859,126,125,127,128,2,1,3,11,-1.323972171357303,-1.1646681858443864,-1.023811603567591,3.762981712254242,9359,9326,Southwest Minnesota,Pipestone,27,117,Minnesota,MN
27133,27CS030,102,101,103,119,17,16,18,13,0.3236409029954681,0.4216127453900488,0.5284769438797652,0.7189389037520844,126,125,127,122,-4,-5,-3,16,-2.611280312172129,-2.4585459308632527,-2.297695911035128,-5.737731096952191,9648,9684,Southwest Minnesota,Rock,27,133,Minnesota,MN
27011,27CS031,68,67,68,67,-1,-1,-0,3,-0.8088083464511182,-0.7140924864568069,-0.6133438235357476,8.551351880332165,84,83,84,76,-8,-8,-7,1,-2.1317461020515025,-1.9823787292904647,-1.8257307510580465,-0.1537215973198193,5121,5145,Stevens and Nearby Counties,Big Stone,27,11,Minnesota,MN
27023,27CS031,151,145,156,155,4,-1,10,28,-2.328228462642941,-1.9072748985961376,-1.4572313989636887,5.372960821644015,183,177,190,172,-11,-18,-5,4,-2.0559632996202706,-1.5003216785950535,-0.8760515937414792,-0.385088927058768,12446,12391,Stevens and Nearby Counties,Chippewa,27,23,Minnesota,MN
27051,27CS031,60,59,61,73,13,12,14,6,1.0716060089727049,1.1673236805404625,1.2723410090245448,0.4255929765971548,75,74,75,78,3,3,4,1,0.3035732316706872,0.45497374843014715,0.5982631683183753,0.23155560183055168,6073,6142,Stevens and Nearby Counties,Grant,27,51,Minnesota,MN
27121,27CS031,113,112,114,109,-4,-5,-3,8,-1.164166251597,-1.0590761830382802,-0.9564886356130209,-2.683185199444444,140,139,142,148,8,6,9,8,-0.17536350265601006,-0.028522456205781005,0.12346137533818825,0.9162239594295967,11305,11389,Stevens and Nearby Counties,Pope,27,121,Minnesota,MN
27149,27CS031,74,73,75,80,6,5,7,7,-0.21186572242510399,-0.11245946172780837,-0.004085962681596896,1.0111154553371353,92,91,93,74,-18,-19,-17,4,-2.844078676887145,-2.7021025814582686,-2.5493904824576257,-0.23820343707663222,9677,9692,Stevens and Nearby Counties,Stevens,27,149,Minnesota,MN
27151,27CS031,106,105,107,123,17,16,18,17,-0.04916932059954243,0.046330401434113336,0.1400475873258336,0.920732807763456,130,129,132,94,-36,-38,-35,15,-6.495259017438059,-6.330886444232492,-6.180788230599307,-0.42288358840861173,9714,9755,Stevens and Nearby Counties,Swift,27,151,Minnesota,MN
27155,27CS031,48,48,48,56,8,8,8,9,-0.42374994382560777,-0.32516265432171676,-0.23609980560932,1.0104893856336417,58,58,59,61,3,2,3,6,-1.4216600369963006,-1.261462165265124,-1.0958992613068705,1.6921937756914418,3327,3295,Stevens and Nearby Counties,Traverse,27,155,Minnesota,MN
27163,27CS032,1492,1376,1607,1715,223,108,339,172,-0.2304255854149409,0.18978295528052905,0.6157176848749969,0.7672662473484044,1875,1735,2015,2017,142,2,282,182,-0.8027329297739421,-0.18513107061486875,0.4015957752978981,1.272532566964508,267790,271663,Washington,Washington,27,163,Minnesota,MN
27171,27CS033,751,690,812,824,73,12,134,92,-0.5388334556346986,-0.13454551832321596,0.27443764239523083,1.2375656785201228,951,877,1026,1097,146,71,220,146,-0.6251962281579279,-0.0012301476098253807,0.6315200638769065,0.9954681984166367,141611,144395,Wright,Wright,27,171,Minnesota,MN
27073,27CS034,71,70,72,94,23,22,24,16,0.9238992144272298,1.0213829623610688,1.117951058293574,0.6712999058836158,87,86,88,102,15,14,16,2,2.178802936102915,2.329745266131808,2.481098133078792,0.12522966073461364,6689,6686,Yellow Medicine and Nearby Counties,Lac Qui Parle,27,73,Minnesota,MN
27081,27CS034,68,67,69,65,-3,-4,-2,5,-1.521848580636485,-1.425545979779827,-1.3172914258118684,-2.5068119250921197,82,82,83,101,19,18,19,6,2.540105934078697,2.70376512334089,2.8497712696974316,0.30711277042702084,5620,5576,Yellow Medicine and Nearby Counties,Lincoln,27,81,Minnesota,MN
27083,27CS034,188,177,199,226,38,27,49,25,0.0667313762343621,0.5196917429763034,0.9698238591836438,0.6424698499022332,231,218,244,247,16,3,29,37,-1.6098404088763059,-0.9944429294744204,-0.38442696539536275,2.156403270777441,25239,25223,Yellow Medicine and Nearby Counties,Lyon,27,83,Minnesota,MN
27127,27CS034,157,150,163,178,21,15,28,21,-0.40122631915954937,0.01152842209529499,0.4356785922979935,0.9484624933380842,191,183,199,187,-4,-12,4,18,-2.358594205901105,-1.7343417019456948,-1.1284228316167655,-5.374450917732289,15354,15370,Yellow Medicine and Nearby Counties,Redwood,27,127,Minnesota,MN
27173,27CS034,89,89,90,91,2,1,2,14,-1.4120222876711683,-1.3096736727492049,-1.204581203104971,5.5312174005404655,108,107,110,109,1,-1,2,16,-2.1172071032610047,-1.9629964261386945,-1.8085821136100575,10.133163978600829,9519,9423,Yellow Medicine and Nearby Counties,Yellow Medicine,27,173,Minnesota,MN
28001,28CS001,329,317,342,414,85,72,97,61,0.3623236454148472,0.7915834052390828,1.2317912205187245,0.7127007968888487,394,379,409,467,73,58,88,60,-0.0659723357442141,0.5346299026720421,1.1773337844923415,0.8102950105098753,29530,28839,Adams+Amite+Wilkinson,Adams,28,1,Mississippi,MS
28005,28CS001,151,146,157,167,16,10,21,23,-0.9993452317141104,-0.5542146815157742,-0.1421147181853167,1.3579039049869879,184,178,191,224,40,33,46,31,0.20818182789980919,0.8468885544159528,1.4641258104545607,0.7569057992967753,12632,12646,Adams+Amite+Wilkinson,Amite,28,5,Mississippi,MS
28157,28CS001,104,103,105,119,15,14,16,19,-0.5659880190854426,-0.46903184892121613,-0.37084613328432137,1.1880205686741176,125,124,126,123,-2,-3,-1,15,-2.6050907258127354,-2.4466244309597496,-2.2851644849223933,-15.049302978842164,8518,8346,Adams+Amite+Wilkinson,Wilkinson,28,157,Mississippi,MS
28003,28CS002,378,363,393,463,85,70,100,41,0.7835866695484136,1.2570448953854612,1.690208440506198,0.4783439924704624,456,438,474,541,85,67,103,67,0.00979928287359041,0.6326746800729447,1.2417298089778501,0.7797631836913935,34990,34397,Alcorn+Prentiss+Tishomingo,Alcorn,28,3,Mississippi,MS
28117,28CS002,267,256,278,342,75,64,86,45,0.7942133271396655,1.2081951322026767,1.6559222988857865,0.5909921554688623,326,313,339,367,41,28,54,40,-0.6437397190732249,-0.0022348078721247575,0.6395791804196547,0.9605065931698749,24962,24987,Alcorn+Prentiss+Tishomingo,Prentiss,28,117,Mississippi,MS
28141,28CS002,240,232,249,308,68,59,76,44,0.8092143317358627,1.2409428970199272,1.643429311211618,0.6414276008439728,291,282,301,392,101,91,110,39,3.3184887303641424,3.964599137021115,4.572051541087757,0.38336244858897106,18894,18760,Alcorn+Prentiss+Tishomingo,Tishomingo,28,141,Mississippi,MS
28007,28CS003,221,213,229,272,51,43,59,33,0.5631675493782818,1.0013786783839937,1.4058335657492396,0.6344883595316528,268,258,277,305,37,28,47,33,-0.31896479256614985,0.31214228990027637,0.910312121168459,0.857883525307691,17869,17755,Attala+Choctaw+Leake+Webster,Attala,28,7,Mississippi,MS
28019,28CS003,92,92,93,108,16,15,16,10,0.5757142547077829,0.6786191715242648,0.7717379797105252,0.6051008337170511,112,111,113,115,3,2,4,13,-1.6616488803708858,-1.5139880742200362,-1.3695648810174539,3.478920906405886,8191,8120,Attala+Choctaw+Leake+Webster,Choctaw,28,19,Mississippi,MS
28079,28CS003,188,179,198,270,82,72,91,62,0.5001397026337215,0.9141357290486676,1.3477564386814174,0.7500688270196714,229,218,240,316,87,76,98,38,2.189949302719738,2.790107035728172,3.3803814940472825,0.429931848666227,21473,21203,Attala+Choctaw+Leake+Webster,Leake,28,79,Mississippi,MS
28155,28CS003,135,131,139,152,17,13,21,20,-0.7340402065595335,-0.30196334146120973,0.12313891791720384,1.1123648930348486,165,160,170,203,38,33,43,23,1.1243685687983502,1.779011759861206,2.3992771708173026,0.5919038566167014,9896,9974,Attala+Choctaw+Leake+Webster,Webster,28,155,Mississippi,MS
28009,28CS004,88,87,89,119,31,30,32,18,1.6012588850352267,1.7002369818568168,1.8069308022694455,0.5592810498864568,106,105,107,131,25,24,26,24,-0.024757086948759777,0.13096482790680003,0.28837807902857476,0.9290902017282789,7749,7648,Benton+Marshall+Tippah,Benton,28,9,Mississippi,MS
28093,28CS004,339,324,353,437,98,84,113,46,1.1096767247106762,1.5327733972229605,1.9892268705303278,0.4632132368734866,413,395,430,580,167,150,185,72,2.7894767998719305,3.392455864626883,4.008585231223003,0.42789349160298945,33977,33729,Benton+Marshall+Tippah,Marshall,28,93,Mississippi,MS
28139,28CS004,231,221,240,285,54,45,64,43,0.10353650124623272,0.5320907796902041,0.9558638280831122,0.7757261551986132,281,270,292,334,53,42,64,45,-0.14931136146649782,0.43725600196671593,1.0266478060612463,0.8287179093646093,21764,21649,Benton+Marshall+Tippah,Tippah,28,139,Mississippi,MS
28011,28CS005,337,324,350,473,136,123,149,87,1.2067151434251555,1.5896459495222293,2.0078416157313494,0.6362419711625715,409,393,425,491,82,66,98,50,0.6528773804509808,1.2515060080371556,1.903155393375451,0.6018277341402808,30773,30387,Bolivar+Sunflower,Bolivar,28,11,Mississippi,MS
28133,28CS005,267,256,278,367,100,89,111,55,1.33353778804116,1.759827267445957,2.1817252796856126,0.5440355305763909,325,312,338,396,71,58,84,43,0.7103712692045744,1.3209037538337909,1.9226551702073629,0.5965260220563766,25680,25464,Bolivar+Sunflower,Sunflower,28,133,Mississippi,MS
28013,28CS006,143,137,149,209,66,60,72,19,3.097264328649899,3.519062546032364,3.975285092095281,0.2827877809289135,171,164,178,231,60,53,67,32,1.94934539950683,2.5433784546013762,3.16399526369974,0.5246612628100666,13381,13050,Calhoun+Chickasaw+Grenada,Calhoun,28,13,Mississippi,MS
28017,28CS006,171,164,179,210,39,31,46,34,-0.14078005301455337,0.281944328864106,0.6702817754865079,0.8556718636473191,209,200,218,248,39,30,48,33,-0.18815364373248283,0.43467917424479974,1.0354294049990151,0.8228658032514252,17055,17019,Calhoun+Chickasaw+Grenada,Chickasaw,28,17,Mississippi,MS
28043,28CS006,262,252,271,329,67,58,77,48,0.4764750082865743,0.9100784561251495,1.3233330057722719,0.7020886141805882,318,306,329,350,32,21,44,39,-0.9933875607247761,-0.38014386263513933,0.2746400997580156,1.1654555932391382,21435,21396,Calhoun+Chickasaw+Grenada,Grenada,28,43,Mississippi,MS
28015,28CS007,96,95,97,141,45,44,46,20,2.452374312659882,2.549438898874547,2.6563747833054285,0.43148633379556706,117,116,119,155,38,36,39,24,1.5131046362549305,1.6633649389902976,1.8242720935656696,0.6197812768070866,9933,9888,Carroll+Leflore+Montgomery,Carroll,28,15,Mississippi,MS
28083,28CS007,306,294,318,477,171,159,183,91,2.413227156741018,2.840552870408622,3.258561395060703,0.5287658258604785,369,354,383,442,73,59,88,39,0.8859613536031293,1.4854757741020372,2.1002985175098665,0.5240418893902445,28130,27650,Carroll+Leflore+Montgomery,Leflore,28,83,Mississippi,MS
28097,28CS007,133,129,137,184,51,47,55,35,1.2084494868442621,1.61457030987053,2.0678722643576912,0.6744563180451033,162,157,167,169,7,2,12,26,-2.9345733208398284,-2.2896442946622537,-1.719754590905597,3.117628326681396,9782,9738,Carroll+Leflore+Montgomery,Montgomery,28,97,Mississippi,MS
28021,28CS008,91,90,92,113,22,21,23,20,0.13190285402329358,0.23979855267532824,0.3389497071497197,0.8640179859852729,110,109,111,130,20,19,21,20,-0.09523471177374523,0.04490782284648721,0.19684553424804357,0.9367797551665092,9060,8935,Claiborne+Jefferson+Warren,Claiborne,28,21,Mississippi,MS
28063,28CS008,73,73,74,97,24,23,24,17,0.8056098660506156,0.9009224923044896,1.006834185956355,0.6932282048240805,90,89,91,103,13,12,14,20,-1.2984959879352878,-1.1478405715637545,-0.9927788475640975,1.415908163705054,7215,7212,Claiborne+Jefferson+Warren,Jefferson,28,63,Mississippi,MS
28149,28CS008,427,408,446,581,154,135,173,87,1.0625493740075145,1.5021360705668971,1.9222537557213135,0.5611341500744881,511,489,534,653,142,119,164,98,0.5748099823638938,1.1981799957870296,1.8065886513011042,0.6876817057031659,44583,43720,Claiborne+Jefferson+Warren,Warren,28,149,Mississippi,MS
28023,28CS009,183,176,189,237,54,48,61,45,0.21554774842392116,0.5991929867562933,1.0515749695837031,0.8108176357440348,220,212,228,254,34,26,42,35,-0.7242540259337401,-0.0991668867480194,0.513454731860455,1.0120268298283364,15517,15437,Clarke+Jasper+Wayne,Clarke,28,23,Mississippi,MS
28061,28CS009,166,159,173,209,43,36,50,22,0.860555484010569,1.2743417852306944,1.711230529086555,0.5035769386221461,202,193,210,317,115,107,124,37,5.124868053740307,5.7729247336946985,6.375295222306809,0.3181926300372716,16345,16299,Clarke+Jasper+Wayne,Jasper,28,61,Mississippi,MS
28153,28CS009,185,176,193,224,39,31,48,29,0.09343275511868074,0.535745611491598,0.9413119206405978,0.7214059529101684,224,214,234,301,77,67,87,39,1.7356664930952115,2.334868376201854,2.8894622057918786,0.5002532102818008,19830,19719,Clarke+Jasper+Wayne,Wayne,28,153,Mississippi,MS
28025,28CS010,185,177,193,241,56,48,64,29,0.9780465189797656,1.4290417214226445,1.8342389496724691,0.5126517846575803,224,215,234,287,63,53,72,41,0.8176503057371748,1.3748351862892667,2.03037323464349,0.6427521676868477,18736,18551,Clay+Oktibbeha,Clay,28,25,Mississippi,MS
28105,28CS010,284,262,306,397,113,91,135,73,0.3325817918544061,0.7660769398667436,1.2219354191338494,0.6412506678561941,352,325,379,428,76,49,103,61,-0.24037776803737004,0.33824317892811206,0.9780005236566247,0.7945715678807996,51408,51823,Clay+Oktibbeha,Oktibbeha,28,105,Mississippi,MS
28027,28CS011,234,225,243,333,99,90,108,58,1.5458609276067274,1.9333698178463206,2.3676079170248525,0.5779274423002657,282,271,293,389,107,96,118,53,2.4695842799317136,3.106197747108014,3.7282280959931944,0.49162909451240333,21314,20872,Coahoma+Quitman+Tallahatchie+Tunica,Coahoma,28,27,Mississippi,MS
28119,28CS011,72,72,73,123,51,50,51,13,5.9690964914901725,6.068976896148576,6.175979004516817,0.25095423417641854,85,84,86,130,45,44,46,19,5.042755538777913,5.20437971990409,5.355146546945216,0.4142713430006808,6226,5967,Coahoma+Quitman+Tallahatchie+Tunica,Quitman,28,119,Mississippi,MS
28135,28CS011,131,125,136,181,50,45,56,31,1.1263625735121852,1.5159785235084549,1.9064297445874734,0.603213712126378,157,150,163,192,35,29,42,24,0.4731032606761838,1.095224413668897,1.7011203647089355,0.6622757021540344,12822,12410,Coahoma+Quitman+Tallahatchie+Tunica,Tallahatchie,28,135,Mississippi,MS
28143,28CS011,94,93,95,117,23,22,24,15,0.7405171831528676,0.8529451319354806,0.9523030877387119,0.6175321526921393,116,114,117,163,47,46,49,21,3.1092531656454883,3.275357796278428,3.4126939632843922,0.4334860568080662,9700,9700,Coahoma+Quitman+Tallahatchie+Tunica,Tunica,28,143,Mississippi,MS
28029,28CS012,273,261,285,364,91,79,103,42,1.301394915559002,1.7145083811650428,2.1462799721438692,0.45777631211707676,331,316,345,399,68,54,83,46,0.34030812252539305,0.9592682659512755,1.5528268618603356,0.6641353473382944,28234,28038,Copiah+Franklin+Lincoln,Copiah,28,29,Mississippi,MS
28037,28CS012,84,83,84,103,19,19,20,14,0.6219663491177262,0.7151620075731516,0.8228492191227232,0.6830895558780308,103,102,104,141,38,37,39,16,3.3500226619460145,3.509836599081437,3.6556404030461005,0.4056532821852253,7661,7673,Copiah+Franklin+Lincoln,Franklin,28,37,Mississippi,MS
28085,28CS012,362,347,377,474,112,97,127,74,0.6666080990152912,1.1088385787892538,1.555722814151686,0.6541530244223834,443,425,461,536,93,75,111,54,0.7434036330904604,1.332915584893897,1.9578083438138283,0.5717570640334558,34726,34924,Copiah+Franklin+Lincoln,Lincoln,28,85,Mississippi,MS
28031,28CS013,218,210,226,298,80,72,88,50,1.1987592729000796,1.6315249551751547,2.065193692782722,0.6179754776812527,264,255,273,302,38,29,47,30,-0.09131976100124624,0.50466725548243,1.1203934704427958,0.768993790464264,18346,18284,Covington+Simpson+Smith,Covington,28,31,Mississippi,MS
28127,28CS013,252,241,263,350,98,87,109,58,1.0964930123619083,1.5459788614203847,1.9365356264573892,0.585583668947621,304,291,318,400,96,82,109,58,1.1296997762613772,1.7578232245305012,2.3507954460399314,0.6002336412190702,26011,25771,Covington+Simpson+Smith,Simpson,28,127,Mississippi,MS
28129,28CS013,140,134,146,164,24,18,30,16,0.16120669703707477,0.5857656591421022,1.0095428940885747,0.6345473989215291,168,161,176,221,53,45,60,32,1.1390345890385056,1.7521959272262428,2.339976868899825,0.5956414716487047,14441,14193,Covington+Simpson+Smith,Smith,28,129,Mississippi,MS
28033,28CS014,1250,1170,1330,1497,247,167,327,152,0.09257080751589597,0.5221054421810806,0.9195636109418891,0.6118409170991369,1558,1461,1655,2081,523,426,620,275,0.962218917560216,1.575497789082053,2.209062814092453,0.5246964478296033,186111,188235,De Soto,De Soto,28,33,Mississippi,MS
28035,28CS015,682,649,716,780,98,64,131,92,-0.3427259570386881,0.07057519664798564,0.5259728414176167,0.9301411322141968,839,798,879,1029,190,150,231,141,0.17792282107070478,0.7550099904783468,1.3660332258693044,0.7369792444575921,77657,77913,Forrest,Forrest,28,35,Mississippi,MS
28039,28CS016,245,235,256,269,24,13,34,37,-0.9508300254018093,-0.5492700854320839,-0.1460862562661734,1.496419383354104,303,290,316,382,79,66,92,42,1.2030417210677935,1.8188897499355716,2.4163279326913076,0.5235321533123829,24394,24700,George+Greene+Perry+Stone,George,28,39,Mississippi,MS
28041,28CS016,118,117,119,141,23,22,24,22,-0.03242909845799848,0.06598262443513148,0.16466470178443474,0.9205847218047072,146,144,147,143,-3,-4,-1,17,-1.8920038739612814,-1.7422759980347098,-1.5998890431380308,-9.713345169563771,13524,13611,George+Greene+Perry+Stone,Greene,28,41,Mississippi,MS
28111,28CS016,126,121,131,177,51,46,56,25,1.8025475972879443,2.219321289363318,2.6361503118768326,0.48493050876305566,154,148,160,195,41,35,47,26,0.9173911085476899,1.519703343673966,2.1332090326384736,0.6244792248718909,11558,11556,George+Greene+Perry+Stone,Perry,28,111,Mississippi,MS
28131,28CS016,168,160,176,217,49,41,57,14,1.4841307607335106,1.9141550147448307,2.367686480476772,0.27925996055607327,208,198,217,282,74,65,84,47,1.1316190431826592,1.782468576555695,2.3983177369532185,0.6231713916831215,18359,18599,George+Greene+Perry+Stone,Stone,28,131,Mississippi,MS
28045,28CS017,428,408,448,522,94,74,114,54,0.42123471647695554,0.8745186924167024,1.3035861608692538,0.5680111100662151,522,498,546,654,132,108,156,78,0.7722858338929497,1.4122600344921423,1.989059724180081,0.5865747783394871,46306,46058,Hancock+Harrison,Hancock,28,45,Mississippi,MS
28047,28CS017,1808,1719,1898,2084,276,186,365,145,0.1966949843872749,0.6247108513639981,1.0585729360148657,0.5240813487666266,2223,2115,2331,2850,627,519,735,348,0.9811956798043024,1.5938910752567372,2.2217845850383906,0.5539639790667682,208585,209282,Hancock+Harrison,Harrison,28,47,Mississippi,MS
28049,28CS018,1812,1715,1910,2460,648,550,745,268,1.2863999607401657,1.6758036232879174,2.12332513877378,0.4132171785661274,2200,2084,2315,2873,673,558,789,329,1.1866260861155002,1.8544314120826721,2.4559586234837916,0.4877946317590757,226994,223256,Hinds,Hinds,28,49,Mississippi,MS
28057,28CS019,259,248,269,301,42,32,53,43,-0.45206873166728906,-0.0375871498607444,0.3955548081699711,0.992942440872623,318,305,330,357,39,27,52,56,-1.4567538963398035,-0.8490324814839865,-0.1796012653957942,1.384474247206124,23756,23836,Itawamba+Monroe,Itawamba,28,57,Mississippi,MS
28095,28CS019,368,353,382,495,127,113,142,76,1.0648512957299163,1.483877955100324,1.9086530527293293,0.5926739485069039,447,430,465,550,103,85,120,84,0.06421013203988565,0.6848734959502876,1.2772107879849286,0.8095478170188976,34246,33914,Itawamba+Monroe,Monroe,28,95,Mississippi,MS
28059,28CS020,1217,1155,1279,1424,207,145,269,142,-0.0019169428305014227,0.45140979132518166,0.8361457281920046,0.6824039418706795,1502,1428,1576,1820,318,244,392,207,0.312048583634652,0.9394584570613549,1.53492790983921,0.648718504890562,143378,143886,Jackson,Jackson,28,59,Mississippi,MS
28065,28CS021,143,138,148,145,2,-3,7,21,-2.149318166288089,-1.705150303863858,-1.2913749445540064,7.248032991167023,173,168,179,197,24,18,29,17,0.10212471525928186,0.7224551112624514,1.3292696775995092,0.6902642366479198,11220,11152,Jefferson Davis+Lawrence+Marion,Jefferson Davis,28,65,Mississippi,MS
28077,28CS021,142,136,147,176,34,29,40,17,1.0422524125489259,1.442531287972967,1.8506525234138154,0.4810585541671443,170,164,177,202,32,25,38,27,-0.2206782260142669,0.45639175930720105,1.0993333161956163,0.8297185432599276,12057,11837,Jefferson Davis+Lawrence+Marion,Lawrence,28,77,Mississippi,MS
28091,28CS021,275,264,285,397,122,112,133,66,1.8737895113587046,2.3021585209187068,2.7504092836331537,0.535373703582783,335,323,348,407,72,59,84,39,1.0082110050784627,1.5930712318748799,2.165902214879374,0.5376595265268971,24412,24381,Jefferson Davis+Lawrence+Marion,Marion,28,91,Mississippi,MS
28067,28CS022,658,629,687,763,105,76,134,86,-0.13639058684794836,0.2904715446330832,0.7177249453818678,0.8086873247971301,800,765,834,1047,247,213,282,138,1.3680289614649062,1.9759103068158415,2.56771700481105,0.5553612415299961,67267,66802,Jones,Jones,28,67,Mississippi,MS
28069,28CS023,83,82,84,106,23,22,24,20,0.21123086351337833,0.3117365815255069,0.4159005986987011,0.8389310104696686,100,98,101,133,33,32,35,19,1.821174630974876,1.9716751868306952,2.121163110361984,0.5507269871731183,9083,8851,Kemper+Neshoba+Noxubee+Winston,Kemper,28,69,Mississippi,MS
28099,28CS023,336,324,349,497,161,148,173,121,0.9515571396640904,1.3851606007728732,1.781638981162652,0.747234204760466,410,395,425,470,60,45,75,65,-0.8658939344098824,-0.19901649106490976,0.4028449410494102,1.0625977630525676,29015,28993,Kemper+Neshoba+Noxubee+Winston,Neshoba,28,99,Mississippi,MS
28103,28CS023,103,102,104,143,40,39,41,18,2.026928859694265,2.1346381924572073,2.2350381072908783,0.44069005445054693,125,124,126,149,24,23,25,19,0.40697851416043507,0.5738975727919758,0.719116689982592,0.7660717954275778,10248,10139,Kemper+Neshoba+Noxubee+Winston,Noxubee,28,103,Mississippi,MS
28159,28CS023,191,184,199,258,67,59,74,49,0.5308524595455223,0.9743482694904511,1.4225704812881248,0.7256304641501277,233,224,242,298,65,56,74,39,1.190859093330107,1.798150702228694,2.381307635590994,0.5888705731440191,17712,17607,Kemper+Neshoba+Noxubee+Winston,Winston,28,159,Mississippi,MS
28071,28CS024,342,318,366,409,67,43,91,56,-0.204333321984401,0.2011953629778954,0.6356233122846939,0.8202491367421767,428,398,457,523,95,66,125,46,0.45026350730282677,1.0623833102688511,1.700494318227455,0.4769889109005242,55764,56741,Lafayette+Yalobusha,Lafayette,28,71,Mississippi,MS
28161,28CS024,165,160,171,212,47,41,52,25,1.3456714267947172,1.7526668709929738,2.1797963497178503,0.5239948222311354,201,195,207,196,-5,-11,1,16,-2.674086909690232,-2.0256016750341894,-1.3709295647666233,-4.079344810793135,12393,12420,Lafayette+Yalobusha,Yalobusha,28,161,Mississippi,MS
28073,28CS025,387,359,415,484,97,69,125,53,0.24799618551953198,0.6746792505867275,1.1073126681249685,0.5403333111210983,482,448,516,577,95,61,129,86,-0.42714840500933937,0.17313582338589786,0.8071923286436611,0.8946341692175874,64336,65209,Lamar,Lamar,28,73,Mississippi,MS
28075,28CS026,702,671,733,1032,330,299,361,151,2.033923971572053,2.4627261028096092,2.8990788376652943,0.4563798560544073,852,815,889,1068,216,179,253,140,0.6574647293325195,1.267972236828432,1.869763561606052,0.6446598306248987,72921,72178,Lauderdale+Newton,Lauderdale,28,75,Mississippi,MS
28101,28CS026,224,215,233,276,52,43,61,39,0.19894382099528282,0.6387625846576224,1.0577701180996808,0.7307152948805753,272,261,283,324,52,41,63,45,-0.171797701988979,0.4256819504313479,1.0031672721960034,0.8440624961099744,21186,21083,Lauderdale+Newton,Newton,28,101,Mississippi,MS
28081,28CS027,762,726,797,969,207,172,243,116,0.6783503255729632,1.0967559083326843,1.5456299363924555,0.5564815471289657,927,884,970,1167,240,197,283,141,0.8365346742152383,1.4173079984999508,2.024190848260285,0.5845223088668605,83549,82933,Lee,Lee,28,81,Mississippi,MS
28087,28CS028,550,524,575,694,144,119,170,88,0.5156847315687638,0.958555522363289,1.4248801723305895,0.6056074243839541,671,641,701,747,76,46,106,87,-0.8098339543097437,-0.23042167010609002,0.4043989013131547,1.1279622292801268,58651,58234,Lowndes,Lowndes,28,87,Mississippi,MS
28089,28CS029,900,853,947,1018,118,71,165,121,-0.4406988888436122,-0.028196242106183985,0.39153820731382183,1.0168145006501257,1112,1056,1169,1174,62,5,118,131,-1.3785656413586767,-0.7931023438485247,-0.17620045654496022,2.084635773286878,108862,109727,Madison,Madison,28,89,Mississippi,MS
28107,28CS030,327,313,342,403,76,61,90,67,-0.14384230587992375,0.25659385089930736,0.6894127792930248,0.873756191908917,397,380,414,499,102,85,119,61,0.9122988414986564,1.5124267810975294,2.1509180139192767,0.5900807659752404,33231,32889,Panola+Tate,Panola,28,107,Mississippi,MS
28137,28CS030,254,242,266,377,123,111,135,55,1.9837901898616077,2.4300400618719786,2.866290650272069,0.44228791121827105,311,297,326,413,102,87,116,62,1.071787886919583,1.6916039518748556,2.2831412124853916,0.602794977499737,28162,28218,Panola+Tate,Tate,28,137,Mississippi,MS
28109,28CS031,592,568,616,712,120,96,144,84,0.20103678058221167,0.6402354977497454,1.0951372602328011,0.6958219769652961,729,700,758,932,203,174,232,154,0.43291123301489637,1.0402126827816705,1.6516229796512294,0.7547039352843847,56121,56450,Pearl River,Pearl River,28,109,Mississippi,MS
28113,28CS032,448,431,465,543,95,78,112,59,0.5067486515065143,0.8963813929403006,1.3245718095462402,0.6134559785630745,545,524,565,639,94,74,115,78,-0.1721508455688772,0.4775530445348906,1.2021754076237294,0.8189844132242494,40050,40007,Pike+Walthall,Pike,28,113,Mississippi,MS
28147,28CS032,153,147,159,200,47,41,53,33,0.5469380033730028,0.9706261174568023,1.3786717233248755,0.6940844927754379,186,179,193,229,43,36,50,30,0.5034727866063994,1.108925776889981,1.7366445584839239,0.6873350493708877,13926,13840,Pike+Walthall,Walthall,28,147,Mississippi,MS
28115,28CS033,257,243,270,386,129,116,143,38,2.4681758785633825,2.911246146427635,3.3483008930173597,0.2917462953059012,316,300,332,458,142,126,158,63,2.4170523181188144,3.0149176117022884,3.6474946725608444,0.44026984890944704,31388,31410,Pontotoc+Union,Pontotoc,28,115,Mississippi,MS
28145,28CS033,260,248,272,294,34,22,46,40,-0.6512713712195503,-0.20907693328280946,0.2380613395791724,1.1417680548838707,319,304,333,379,60,46,75,46,0.01948887625744602,0.6009970479864857,1.2632067790717494,0.7504925434690702,27934,27928,Pontotoc+Union,Union,28,145,Mississippi,MS
28121,28CS034,1054,986,1122,1391,337,269,405,140,0.8347243729491504,1.2648825025031334,1.677483779012085,0.4141733665171296,1312,1230,1393,1608,296,215,378,209,0.0421003480759966,0.6678303681735497,1.249042975373744,0.7033119712332297,156911,157944,Rankin+Scott,Rankin,28,121,Mississippi,MS
28123,28CS034,257,245,269,302,45,33,57,43,-0.31730409800852155,0.07682265225818947,0.5124320968993855,0.9267553475538426,312,298,326,398,86,72,100,51,0.8919537140401044,1.540728507779628,2.1143751734248672,0.5848987116835933,27956,27650,Rankin+Scott,Scott,28,123,Mississippi,MS
28151,28CS035,492,473,511,687,195,176,214,97,1.7766752184464285,2.193821841280386,2.6488305296166264,0.49555505652126053,596,573,618,713,117,95,140,45,1.3286617022246816,1.950718784265633,2.605829265108609,0.3807310939325735,44423,43822,Washington,Washington,28,151,Mississippi,MS
28051,28CS036,179,172,187,260,81,73,88,62,0.6980173318280392,1.1007632409689891,1.529161524480476,0.7589072956973263,215,207,224,299,84,75,92,27,3.5079321779507753,4.116205336841817,4.754127520194186,0.31870780016638917,16887,16557,Yazoo and Nearby Counties,Holmes,28,51,Mississippi,MS
28053,28CS036,82,81,83,117,35,34,36,25,1.2002760402571075,1.2986703151305883,1.3999451009187274,0.6933376246755841,99,98,100,143,44,43,45,14,4.58820873872638,4.751879361343146,4.889646147938294,0.31120283746201144,7748,7575,Yazoo and Nearby Counties,Humphreys,28,53,Mississippi,MS
28055,28CS036,13,13,13,13,-0,-0,-0,1,-0.9811507022659661,-0.8795365249624447,-0.7883460278619189,1.1948159607985371,16,16,16,13,-3,-3,-3,1,-3.7512365625430797,-3.5951273164111552,-3.4460020892403693,-0.5370503866362598,1321,1287,Yazoo and Nearby Counties,Issaquena,28,55,Mississippi,MS
28125,28CS036,46,46,47,75,29,28,29,14,3.735151673565721,3.834129642279958,3.9235693464980628,0.4715818425755356,55,54,55,76,21,21,22,7,4.4842999924012235,4.644188378229493,4.793083006553286,0.315019625214902,3836,3678,Yazoo and Nearby Counties,Sharkey,28,125,Mississippi,MS
28163,28CS036,244,232,256,307,63,51,75,38,0.49874824713289134,0.9187187366111007,1.3765739171766236,0.5939578362857247,295,281,308,360,65,52,79,33,0.8805797393628507,1.4587887490397242,2.080720992366367,0.49657585472341703,27042,26409,Yazoo and Nearby Counties,Yazoo,28,163,Mississippi,MS
29003,29CS001,159,151,167,175,16,8,24,18,-0.5143376563600103,-0.10740952589506067,0.29192314686302373,1.04826096924166,194,185,204,191,-3,-13,6,16,-1.9590059164496578,-1.2895839210696372,-0.6782955308365428,-6.657366066811085,18019,18014,Andrew+Atchison+Holt+Nodaway,Andrew,29,3,Missouri,MO
29005,29CS001,64,64,65,87,23,22,23,11,2.0797049250598136,2.1844978452044193,2.2832443133170104,0.4679490851197159,79,78,79,95,16,16,17,3,2.9307754829248975,3.077758560635926,3.2276175788034314,0.1718712833221038,5270,5244,Andrew+Atchison+Holt+Nodaway,Atchison,29,5,Missouri,MO
29087,29CS001,47,46,47,64,17,17,18,18,-0.23810647214688827,-0.13757987506465622,-0.03681320148367347,0.9768724309304602,57,57,58,83,26,25,26,5,5.811870246277065,5.956086383252572,6.105345516390647,0.18547157248627627,4219,4220,Andrew+Atchison+Holt+Nodaway,Holt,29,87,Missouri,MO
29147,29CS001,162,153,171,156,-6,-15,3,20,-1.646404691791839,-1.2348872572487306,-0.7856463241026406,-3.9914414941802647,198,187,209,168,-30,-41,-19,15,-3.1825535938152942,-2.5524773162179315,-1.9162431268622944,-0.5147250608405717,21339,21168,Andrew+Atchison+Holt+Nodaway,Nodaway,29,147,Missouri,MO
29007,29CS002,258,247,269,325,67,56,78,42,0.58339258590454,0.998292075756569,1.4092944693614018,0.6182809424429782,317,304,330,330,13,0,26,38,-1.8019115104270869,-1.1872207871268385,-0.5708582118346794,2.6871716692103953,24936,24974,Audrain+Callaway,Audrain,29,7,Missouri,MO
29027,29CS002,353,333,372,452,99,80,119,38,0.9618518775518745,1.3714782509520302,1.8319426615856567,0.37827239576671906,437,414,460,501,64,41,87,57,-0.4556418739581124,0.21090618360514135,0.8055572611583535,0.8773694495653198,44394,44587,Audrain+Callaway,Callaway,29,27,Missouri,MO
29009,29CS003,362,348,377,437,75,60,89,52,0.20688503555705054,0.6656286624432722,1.0812885812163322,0.6878964272196004,444,426,462,501,57,39,75,51,-0.4121907545270695,0.21306446206986068,0.8124276861819105,0.8806942619431667,34739,34687,Barry+Lawrence+McDonald,Barry,29,9,Missouri,MO
29109,29CS003,412,395,428,453,41,25,58,56,-0.8047500635089477,-0.39086536065375277,0.047392745510401624,1.3227660391202443,507,487,527,578,71,51,91,59,-0.29765957317960423,0.3746218923727391,0.9856053669088535,0.8182316195100332,38048,38269,Barry+Lawrence+McDonald,Lawrence,29,109,Missouri,MO
29119,29CS003,210,200,220,260,50,40,60,29,0.46211251263872305,0.8981672000366553,1.345912037947103,0.5702804959701914,259,247,271,304,45,33,57,39,-0.3336097182546152,0.2944489927450108,0.9233370561163278,0.8539986657270783,23241,23369,Barry+Lawrence+McDonald,McDonald,29,119,Missouri,MO
29015,29CS004,262,254,271,308,46,37,54,24,0.7118261260430871,1.1221171117417568,1.5599111002596153,0.5126083204885767,323,313,333,365,42,32,52,42,-0.6902213056397172,-0.0036572384797014085,0.6033387718432842,0.9807725954430665,19471,19835,Benton+Henry+St. Clair,Benton,29,15,Missouri,MO
29083,29CS004,254,244,263,301,47,38,57,33,0.207368104813544,0.6660596849779954,1.0849767631520912,0.6862402737482061,310,299,322,340,30,18,41,34,-0.8921578225482845,-0.23896827304152152,0.3955001202799651,1.1109590747687461,21979,22169,Benton+Henry+St. Clair,Henry,29,83,Missouri,MO
29185,29CS004,118,117,119,140,22,21,23,16,0.5386431483486096,0.6330123165460939,0.7271337285796264,0.6982099532099844,144,143,146,152,8,6,9,12,-0.7079986639745667,-0.5702369656431636,-0.4175591618083604,1.4018851624909587,9360,9371,Benton+Henry+St. Clair,St. Clair,29,185,Missouri,MO
29017,29CS005,113,109,118,166,53,48,57,15,3.0862166952177694,3.4917978294042125,3.8985380708710577,0.27956838834338915,136,131,142,160,24,18,29,15,0.38231200899874473,1.004839858853814,1.5868857059334849,0.6058175145923116,10764,10551,Bollinger+Madison+Stoddard+Wayne,Bollinger,29,17,Missouri,MO
29123,29CS005,153,148,159,174,21,15,26,22,-0.5246330022946493,-0.10814010159901047,0.31306813516620763,1.0216830965158168,187,181,194,215,28,21,34,26,-0.43572842115742605,0.17805008326629304,0.7793899172960701,0.9072572988302353,12535,12644,Bollinger+Madison+Stoddard+Wayne,Madison,29,123,Missouri,MO
29207,29CS005,325,313,338,380,55,42,67,49,-0.23239815320154383,0.19116890567445793,0.6309612345838818,0.8821671687224729,393,378,408,447,54,39,69,65,-1.0233539093830566,-0.47799757280950605,0.1798204447447638,1.1798505551550815,28699,28504,Bollinger+Madison+Stoddard+Wayne,Stoddard,29,207,Missouri,MO
29223,29CS005,138,134,143,188,50,45,54,21,2.153254044713305,2.5462185452221004,2.9762576604856283,0.4154007793501458,165,160,171,242,77,71,82,17,5.8943420138811335,6.557273317219687,7.1883132778414325,0.21897837155861585,11203,10914,Bollinger+Madison+Stoddard+Wayne,Wayne,29,223,Missouri,MO
29019,29CS006,1002,923,1081,1164,162,83,241,83,0.009698526469344756,0.44819552026693954,0.8449920846965026,0.5084795697537727,1258,1162,1354,1365,107,11,203,94,-0.5058449891814627,0.095535943398072,0.6837309890458269,0.8700022440070736,183687,185556,Boone,Boone,29,19,Missouri,MO
29021,29CS007,766,729,802,954,188,152,225,105,0.5293811325622017,0.982511267535022,1.4339851931624796,0.5542642795764092,929,886,973,1116,187,143,230,89,0.7732172998693916,1.4068976057531188,2.0207030881933234,0.4745814942209166,84914,83964,Buchanan,Buchanan,29,21,Missouri,MO
29023,29CS008,484,466,502,575,91,73,109,53,0.45633298353282364,0.9062090117281743,1.294182488256983,0.5767765328846027,592,570,614,704,112,90,134,76,0.41778498943306625,1.0597475941703407,1.6385036421257215,0.6713649383219328,42099,42087,Butler+Carter+Ripley,Butler,29,23,Missouri,MO
29035,29CS008,63,62,63,79,16,16,17,2,2.5613991303521964,2.6684025580844764,2.77231700978764,0.11597187191066961,77,76,77,102,25,25,26,13,2.6519999275380566,2.8004382913165964,2.958210177842829,0.49278597447217404,5332,5304,Butler+Carter+Ripley,Carter,29,35,Missouri,MO
29181,29CS008,133,128,137,185,52,48,57,18,2.6858397623584853,3.096304290369004,3.5086542463663766,0.3373455809544027,158,152,163,236,78,73,84,38,3.916446210524123,4.527974076979581,5.16392177683798,0.4802704082236021,11062,10626,Butler+Carter+Ripley,Ripley,29,181,Missouri,MO
29029,29CS009,401,383,420,549,148,129,166,73,1.2734910399144994,1.7314026288738116,2.1393225092802974,0.4909853354792944,492,470,515,663,171,148,193,74,2.053626116059339,2.6839191234372026,3.3233293028429074,0.4307347303158665,43352,43341,Camden+Miller+Moniteau+Morgan,Camden,29,29,Missouri,MO
29131,29CS009,240,229,251,298,58,47,69,38,0.3814786111321946,0.7861406115179932,1.2299965322271589,0.645598640179874,294,281,307,364,70,57,83,36,1.0448308621532667,1.6380615726017893,2.2447564945061846,0.5051568078758509,24879,24883,Camden+Miller+Moniteau+Morgan,Miller,29,131,Missouri,MO
29135,29CS009,137,130,144,165,28,21,35,21,-0.0026959161879867104,0.44838171170649277,0.8804370842367881,0.7246608374990825,167,159,175,172,5,-3,13,14,-1.3297981881116074,-0.7398083918938362,-0.14795405112330154,2.4752961199136414,15517,15481,Camden+Miller+Moniteau+Morgan,Moniteau,29,135,Missouri,MO
29141,29CS009,257,248,266,305,48,39,57,31,0.36111777777001974,0.7962719064565622,1.2373525784462533,0.637611128917402,318,307,329,324,6,-5,17,36,-2.304724752709911,-1.6469439745118333,-1.0017645691229562,4.806167297127331,20996,21323,Camden+Miller+Moniteau+Morgan,Morgan,29,141,Missouri,MO
29031,29CS010,711,676,746,943,232,197,267,113,1.026727624394625,1.4698517167565814,1.8739197378589683,0.4856943737334561,876,834,919,920,44,1,86,70,-1.0283497956367964,-0.38055887436401803,0.18250953909907924,1.5687264600414261,81411,82066,Cape Girardeau+Perry,Cape Girardeau,29,31,Missouri,MO
29157,29CS010,174,166,182,213,39,31,47,22,0.4803445989726525,0.885831273505154,1.3252686766378716,0.5518664716581199,213,203,222,223,10,1,20,11,-0.6815278342608574,-0.03875435542870227,0.5996062189944956,0.9626430734175583,18986,18928,Cape Girardeau+Perry,Perry,29,157,Missouri,MO
29033,29CS011,92,91,93,123,31,30,32,30,0.035504570046684274,0.14651050565893162,0.24265717267246295,0.9306847972819916,111,110,112,109,-2,-3,-1,10,-1.8946051940557067,-1.7416554650233693,-1.5826390633217735,-8.56552646797669,8487,8388,Carroll+Lafayette+Ray,Carroll,29,33,Missouri,MO
29107,29CS011,339,325,353,383,44,30,58,42,-0.3522669028441831,0.06584288744489158,0.5042718601261187,0.9316143522886546,412,395,429,469,57,40,74,40,-4.8424638986172247e-4,0.5968102214741832,1.1877874063117346,0.6931361098788932,32949,32844,Carroll+Lafayette+Ray,Lafayette,29,107,Missouri,MO
29177,29CS011,225,215,235,284,59,49,69,23,1.1089154998097899,1.5560658011504,1.9758540252645833,0.3841618785597038,274,262,286,353,79,67,91,53,0.7366917275823581,1.3421975331152853,1.9774673926285111,0.6654500309147084,23079,23021,Carroll+Lafayette+Ray,Ray,29,177,Missouri,MO
29037,29CS012,868,821,914,956,88,42,135,69,-0.26794830485936244,0.1920256516415656,0.6147204335930088,0.771300977803861,1081,1025,1138,1244,163,106,219,151,-0.44785502080238115,0.12290570663294803,0.7417048379560057,0.9208857456062892,107924,109416,Cass,Cass,29,37,Missouri,MO
29043,29CS013,603,565,642,708,105,66,143,82,-0.1637059259653907,0.24223788574249672,0.6933239413397607,0.7745856938443342,758,711,805,950,192,145,239,135,0.12124368327880158,0.7348136625861275,1.3663290841837086,0.6993101019903698,89416,91167,Christian,Christian,29,43,Missouri,MO
29047,29CS014,1610,1501,1719,1878,268,159,377,209,-0.21606796013401605,0.22197897288022103,0.665131731245722,0.7770583279711324,1998,1866,2130,2206,208,76,340,265,-0.8954871904203823,-0.2658367866060134,0.34469881981883393,1.2678410770434667,253593,255285,Clay,Clay,29,47,Missouri,MO
29051,29CS015,580,547,613,751,171,138,204,125,0.17518775220310862,0.6052517433806758,1.0175273084642065,0.7264564698134335,715,675,755,772,57,17,97,88,-1.0861154143607994,-0.49071122871820566,0.1370244185181898,1.5242851421461872,77137,77204,Cole,Cole,29,51,Missouri,MO
29055,29CS016,253,243,263,306,53,43,63,27,0.676033047847942,1.1210249851517626,1.5551050593817648,0.5013735266875443,306,295,318,377,71,59,82,55,0.23615802053558188,0.8035075991100223,1.4506652213494133,0.7670364862179758,23124,22839,Crawford+Iron+Reynolds+Washington,Crawford,29,55,Missouri,MO
29093,29CS016,129,125,134,155,26,21,30,12,0.9826237062377204,1.4283005962307704,1.853175528294774,0.4510184324216026,155,151,160,189,34,29,38,19,1.2393482780800176,1.8691507760198856,2.5027125173161053,0.5494350358396407,9597,9424,Crawford+Iron+Reynolds+Washington,Iron,29,93,Missouri,MO
29179,29CS016,72,71,73,79,7,6,8,6,0.044083135778543545,0.1446134093718529,0.24575105584680987,0.7601896606089309,88,87,89,111,23,22,24,13,1.801286763136597,1.9380001253622487,2.093156568895558,0.5451995429928297,6110,6086,Crawford+Iron+Reynolds+Washington,Reynolds,29,179,Missouri,MO
29221,29CS016,240,229,250,322,82,72,93,44,1.2368744227078188,1.6419112074553448,2.0377569673689218,0.527095134525761,292,280,304,400,108,96,120,55,2.1206450781169317,2.7032488091521105,3.3289377407472243,0.5039153391638774,23681,23502,Crawford+Iron+Reynolds+Washington,Washington,29,221,Missouri,MO
29059,29CS017,185,177,192,265,80,73,88,27,2.6894962677726544,3.1096329969013903,3.551254516408665,0.3322847010794542,228,219,237,301,73,64,82,31,2.29904906928137,2.924044604536735,3.5218386421843006,0.41781322980362856,17107,17306,Dallas+Hickory+Polk,Dallas,29,59,Missouri,MO
29085,29CS017,130,126,133,149,19,16,23,27,-1.3271887548050092,-0.9055021514417967,-0.4537483185971669,1.3240384873960953,160,155,164,197,37,33,42,12,2.9181903098865933,3.576444913880054,4.1904802478121,0.31223529620165424,8509,8563,Dallas+Hickory+Polk,Hickory,29,85,Missouri,MO
29167,29CS017,309,295,323,364,55,41,69,41,0.029521180282728342,0.44184966103230755,0.8775081754863845,0.7322326167391074,381,364,397,429,48,32,65,44,-0.4337698298616847,0.16872560204489573,0.7555798855372142,0.8973596992279012,31720,31975,Dallas+Hickory+Polk,Polk,29,167,Missouri,MO
29025,29CS018,85,84,86,92,7,6,8,5,0.09603377286323692,0.2035370442192118,0.3023227010539905,0.6411786904008769,105,104,106,136,31,30,32,17,1.7778405780818334,1.9324052565526983,2.0919306335046786,0.5266743184551218,8849,8884,DeKalb and Nearby Counties,Caldwell,29,25,Missouri,MO
29049,29CS018,220,211,230,270,50,40,59,43,-0.0981860907828745,0.3070759051266841,0.7602739044447766,0.8508686314614211,271,260,282,245,-26,-37,-15,26,-3.532318896497368,-2.9601546555825724,-2.2867982267579507,-1.0333469731073632,21100,21275,DeKalb and Nearby Counties,Clinton,29,49,Missouri,MO
29061,29CS018,78,77,79,99,21,20,22,14,0.7568387909935879,0.8551815095201553,0.9631086330399955,0.6302941459650271,95,94,96,106,11,10,12,11,-0.19810323925448725,-0.03940674949285742,0.11808245877239355,0.9387590390952363,8402,8403,DeKalb and Nearby Counties,Daviess,29,61,Missouri,MO
29063,29CS018,95,94,96,139,44,43,45,22,1.9003870599987627,1.9987336389603663,2.099194213708189,0.48935184759453326,117,116,119,130,13,11,14,12,-0.09248493939240245,0.06003424711514298,0.199901001364042,0.8854997560199563,10992,11086,DeKalb and Nearby Counties,DeKalb,29,63,Missouri,MO
29075,29CS018,71,70,72,92,21,20,22,13,1.1910873538858942,1.2837139840282576,1.3955610215091956,0.5923342964049421,87,86,87,105,18,18,19,2,3.048488155953373,3.1911356437473524,3.351622325287389,0.10305800678558735,6187,6165,DeKalb and Nearby Counties,Gentry,29,75,Missouri,MO
29081,29CS018,92,92,93,105,13,12,13,15,-0.39928456617131614,-0.3001331718871376,-0.19457529371858293,1.105837481149053,113,112,114,111,-2,-3,-1,2,-0.7028867194262687,-0.5555494198265757,-0.40333531458056526,-2.5857110072593223,8184,8163,DeKalb and Nearby Counties,Harrison,29,81,Missouri,MO
29227,29CS018,25,25,26,25,-0,-1,-0,6,-3.365247064759458,-3.268762503190887,-3.169357440402848,10.5846053167499,31,31,32,32,1,0,1,5,-2.745913881086292,-2.5902074235944204,-2.438400556154257,2.896600964480179,1968,1980,DeKalb and Nearby Counties,Worth,29,227,Missouri,MO
29065,29CS019,159,153,165,232,73,67,79,28,2.624530646368407,3.0648846098411275,3.50385919882973,0.3795486194481985,193,186,200,266,73,66,80,45,1.722084732041971,2.331494273601942,2.9190114420838404,0.607723496140652,14584,14430,Dent+Phelps,Dent,29,65,Missouri,MO
29161,29CS019,397,378,416,509,112,93,131,73,0.44047445862795465,0.8837679254897879,1.2992400440561995,0.6457025471182442,489,466,512,599,110,87,133,80,0.1740850936874332,0.7801860271684022,1.454658268609275,0.7198410984577307,44572,44876,Dent+Phelps,Phelps,29,161,Missouri,MO
29067,29CS020,149,144,154,177,28,23,33,24,-0.06852440877822133,0.3555988342693558,0.7888608179152747,0.8226329186233359,182,176,188,228,46,40,52,40,-0.02821156254053041,0.551782076886755,1.23351221295439,0.8553926345702221,11848,11712,Douglas+Ozark+Texas+Wright,Douglas,29,67,Missouri,MO
29153,29CS020,101,101,102,140,39,38,39,11,3.0952442088015744,3.197261971452743,3.296895032424805,0.2777228347847482,126,125,127,188,62,61,63,39,2.992387495262106,3.140649151931943,3.2906830875878192,0.6204115307309493,8635,8743,Douglas+Ozark+Texas+Wright,Ozark,29,153,Missouri,MO
29215,29CS020,265,255,276,346,81,70,91,19,2.057911979446471,2.510121827514038,2.9549612337346964,0.23284198787768184,332,319,345,441,109,96,122,47,2.414261285985004,2.9984160680108087,3.620878310211431,0.42652351718982606,24614,24903,Douglas+Ozark+Texas+Wright,Texas,29,215,Missouri,MO
29229,29CS020,220,212,228,204,-16,-24,-8,27,-2.772790298922425,-2.354663868554809,-1.9353199580305183,-1.7697650251910702,275,266,285,290,15,5,24,43,-2.3927870546183767,-1.8342495688309008,-1.2005062461106557,2.747181501373758,18247,18547,Douglas+Ozark+Texas+Wright,Wright,29,229,Missouri,MO
29069,29CS021,354,342,366,455,101,89,113,55,1.2133746579120663,1.6319175366293983,2.031285537498133,0.5399975913452429,426,412,441,518,92,77,106,47,1.3220844185183513,1.9100137830112167,2.5053214106705872,0.5069795702494604,28275,27784,Dunklin+Pemiscot,Dunklin,29,69,Missouri,MO
29155,29CS021,188,182,195,261,73,66,79,32,2.207264262830763,2.607259148719083,3.014665846939746,0.4353389877833916,226,218,234,292,66,58,74,27,2.439991941116156,3.021866936368749,3.628509918513634,0.40522553613391726,15589,15287,Dunklin+Pemiscot,Pemiscot,29,155,Missouri,MO
29071,29CS022,918,873,963,1087,169,124,214,134,-0.07600874438867301,0.3352670085619583,0.7590639565524914,0.7876966389234846,1132,1078,1186,1325,193,139,247,144,-0.04328263561413295,0.5629570545159955,1.1859947681677099,0.7420275994417062,104685,105164,Franklin,Franklin,29,71,Missouri,MO
29073,29CS023,182,176,189,240,58,51,64,37,0.9352743404377356,1.3879600308145863,1.8316025022639275,0.6318460450009972,223,215,231,247,24,16,32,42,-2.0675012606133274,-1.4475338417269459,-0.8099967927058884,1.6772634544090865,14739,14784,Gasconade+Montgomery+Warren,Gasconade,29,73,Missouri,MO
29139,29CS023,150,145,155,162,12,7,17,15,-0.7138882562994299,-0.2914874070837683,0.13584751863269925,1.181176974164694,184,179,190,185,1,-5,6,17,-2.346607374361366,-1.7427044288313431,-1.0786910366387403,11.304616849142539,11309,11393,Gasconade+Montgomery+Warren,Montgomery,29,139,Missouri,MO
29219,29CS023,271,256,287,315,44,28,59,18,0.3025148626490351,0.7047358550300775,1.1256509890743498,0.404289994574184,340,321,358,461,121,103,140,65,1.2815808907055704,1.8306830038812545,2.467403085475952,0.5308116603650784,35793,36400,Gasconade+Montgomery+Warren,Warren,29,219,Missouri,MO
29077,29CS024,2556,2428,2685,2927,371,242,499,359,-0.40928142126079264,0.04958447898951425,0.4904664326833951,0.9652468870600452,3153,2998,3309,3554,401,245,556,388,-0.6138264568194248,0.04149143509223619,0.6806805906764511,0.9660665864770185,298437,300602,Greene,Greene,29,77,Missouri,MO
29079,29CS025,108,107,109,137,29,28,30,31,-0.2718760170848261,-0.16889773031709202,-0.06473008830780465,1.020931800714114,132,130,133,152,20,19,22,26,-0.8449808688981908,-0.6919250495842055,-0.5441212051335048,1.2151241186167068,9736,9721,Grundy and Nearby Counties,Grundy,29,79,Missouri,MO
29115,29CS025,145,140,150,162,17,12,22,14,-0.14523630822368452,0.2897232826199487,0.7178273455580032,0.7651852976187633,175,169,181,186,11,5,17,38,-3.385297306121025,-2.7686526368202555,-2.151604261054597,3.2278407777334057,11857,11844,Grundy and Nearby Counties,Linn,29,115,Missouri,MO
29117,29CS025,156,149,162,169,13,7,20,30,-1.5347154010598452,-1.1321241031959717,-0.7290106686221918,2.0690685817991694,190,182,198,220,30,22,38,40,-1.4697892601809739,-0.8070800420366671,-0.1611872071858765,1.2927409217331234,14643,14727,Grundy and Nearby Counties,Livingston,29,117,Missouri,MO
29129,29CS025,37,37,37,59,22,22,22,10,3.2742614101476653,3.373121442818322,3.4702081917818988,0.4367795298994293,45,45,45,52,7,7,7,5,0.5308674141833722,0.6960242630190044,0.8375853342866613,0.6244307625528086,3527,3492,Grundy and Nearby Counties,Mercer,29,129,Missouri,MO
29171,29CS025,59,59,60,59,-0,-1,0,5,-1.2249015204040168,-1.1149500431617236,-1.012706355918903,6.415676728018063,73,72,73,88,15,15,16,6,2.1890867792075746,2.33852567020587,2.500181475304107,0.371360523205714,4682,4707,Grundy and Nearby Counties,Putnam,29,171,Missouri,MO
29211,29CS025,57,57,58,72,15,14,15,12,0.3303438281336344,0.42557421772713744,0.5240869847120124,0.7703213656008102,70,69,71,86,16,15,17,11,0.8874151132463522,1.0345502687028219,1.1998292699932354,0.6419841125893965,5984,5940,Grundy and Nearby Counties,Sullivan,29,211,Missouri,MO
29091,29CS026,437,419,454,539,102,85,120,80,0.12631571825029292,0.5556699494003404,0.9973803817371939,0.7737816606699066,535,514,555,637,102,82,123,83,-0.0110084710108816,0.586450342946276,1.2151401298459141,0.8048610492114527,39822,39942,Howell+Oregon+Shannon,Howell,29,91,Missouri,MO
29149,29CS026,115,111,119,140,25,21,29,10,1.2720204464373828,1.6759322643602774,2.108031916494293,0.38551943175241515,138,133,142,178,40,36,45,14,3.0523503460785357,3.661264354375511,4.24744679066685,0.338832132018522,8896,8629,Howell+Oregon+Shannon,Oregon,29,149,Missouri,MO
29203,29CS026,74,73,74,121,47,47,48,13,4.667042104939223,4.768315362471499,4.874450392710668,0.26855728128393164,89,88,90,119,30,29,31,15,2.3739862903648876,2.518593513668501,2.669394976000073,0.4850652636504734,7213,7097,Howell+Oregon+Shannon,Shannon,29,203,Missouri,MO
29095,29CS027,5534,5226,5842,6353,819,511,1127,518,-0.04698692499740179,0.4252792139082302,0.8072036320162143,0.631557816228782,6804,6434,7174,7785,981,611,1351,862,-0.3934767918357274,0.18570593663141352,0.8436068590358564,0.8777566087261475,715323,716918,Jackson,Jackson,29,95,Missouri,MO
29097,29CS028,1064,1011,1116,1291,227,175,280,175,0.01618998723404373,0.4045038628935281,0.8502325602076346,0.7664992049100653,1311,1248,1375,1531,220,156,283,214,-0.5143818592889855,0.07152071785135401,0.6942186881075109,0.9690116190258666,122582,123098,Jasper,Jasper,29,97,Missouri,MO
29099,29CS029,1817,1720,1915,2088,271,173,368,200,-0.09358803642401091,0.31915074000022203,0.7393765390746214,0.7364062834266096,2243,2126,2361,2487,244,126,361,265,-0.7244967931691708,-0.10960518524626954,0.4935802206793185,1.0822419454730337,226794,227648,Jefferson,Jefferson,29,99,Missouri,MO
29101,29CS030,355,332,378,420,65,42,88,46,-0.07800327225822103,0.3571042792428643,0.7417749175853663,0.6994971948760811,437,409,465,565,128,100,156,57,0.9864155945391183,1.5676823866677037,2.2231289416678988,0.4417689026222624,54044,54128,Johnson,Johnson,29,101,Missouri,MO
29105,29CS031,380,364,395,408,28,13,44,52,-1.0523268489827393,-0.6665976983670735,-0.2474279214101656,1.773107382515306,466,448,485,566,100,81,118,74,0.23289604595678387,0.862780771252519,1.4393164571674555,0.7345889943650564,36013,36117,Laclede+Webster,Laclede,29,105,Missouri,MO
29225,29CS031,314,297,331,362,48,31,65,50,-0.46402114292831503,-0.03870882736624143,0.3751588786289974,1.012943687789963,390,370,411,507,117,96,137,63,1.0086262975391942,1.63019497412896,2.232473309908672,0.5352941627039227,39296,39652,Laclede+Webster,Webster,29,225,Missouri,MO
29113,29CS032,447,421,473,480,33,7,59,51,-0.7211096908587084,-0.30733125166806924,0.11504497425825334,1.4984885298913235,559,528,591,602,43,11,74,54,-0.8375990234016659,-0.23546457987018857,0.3690090343546442,1.240778951381155,59897,61330,Lincoln+Pike,Lincoln,29,113,Missouri,MO
29163,29CS032,167,160,175,204,37,29,44,23,0.34713278378522866,0.7770002742054476,1.1769647073104352,0.6104885142461097,205,196,214,210,5,-4,14,27,-2.12587406989969,-1.5090465459704814,-0.8385342782247502,4.645339591741257,17638,17739,Lincoln+Pike,Pike,29,163,Missouri,MO
29125,29CS033,84,84,85,125,41,40,41,13,3.152907689207105,3.2507787989081915,3.3487189492165386,0.31292376380959097,103,102,104,133,30,29,31,11,2.5679689922472,2.7148957732083363,2.8812150069279343,0.35438096756432214,8472,8409,Maries+Osage+Pulaski,Maries,29,125,Missouri,MO
29151,29CS033,111,110,113,119,8,6,9,10,-0.26693919096900315,-0.1616269287879964,-0.06905229921768037,1.1351644944745,137,136,139,165,28,26,29,21,0.4487623436618093,0.6011192461406248,0.7477268215574625,0.7308956673991348,13317,13360,Maries+Osage+Pulaski,Osage,29,151,Missouri,MO
29169,29CS033,293,270,316,342,49,26,72,39,-0.24092357675319376,0.17695501075203388,0.654124503398931,0.7764024397078816,365,337,393,455,90,62,118,50,0.2842286596717845,0.8942732490241291,1.4981920648666647,0.5487321011758088,53755,53838,Maries+Osage+Pulaski,Pulaski,29,169,Missouri,MO
29127,29CS034,295,283,308,310,15,2,27,39,-1.3186877116905174,-0.8448417715227426,-0.44381053618923155,2.504041527497859,363,348,377,395,32,18,47,50,-1.3350422598447165,-0.7343939677257019,-0.13717166635272354,1.4949750127662895,28486,28511,Marion+Monroe+Ralls+Shelby,Marion,29,127,Missouri,MO
29137,29CS034,88,87,89,114,26,25,27,16,1.0281882576060468,1.126370720741149,1.2283835450583436,0.5976176892961017,108,107,110,120,12,10,13,17,-0.902059751830874,-0.7526703308015311,-0.5955629552345466,1.3545014877369541,8665,8705,Marion+Monroe+Ralls+Shelby,Monroe,29,137,Missouri,MO
29173,29CS034,84,83,85,128,44,43,45,14,2.7727378731715415,2.8745360638586557,2.9755731149514215,0.3128254112494851,103,102,105,136,33,31,34,12,2.227743160499355,2.386170547635014,2.542990700952706,0.3570477643396945,10343,10360,Marion+Monroe+Ralls+Shelby,Ralls,29,173,Missouri,MO
29205,29CS034,69,68,70,84,15,14,16,7,1.2146735351439857,1.3204528692797144,1.4228541533641466,0.43741261903060336,83,83,84,87,4,3,4,6,-0.6291892738253222,-0.48492808390919473,-0.34568062385617293,1.311154661666287,6062,5994,Marion+Monroe+Ralls+Shelby,Shelby,29,205,Missouri,MO
29133,29CS035,149,144,155,185,36,30,41,24,0.506319814456995,0.9405670457503612,1.379055921705071,0.6523020953116455,183,176,189,221,38,32,45,26,0.5949221304044205,1.2005296672635954,1.7821781131947454,0.6602122810924724,12635,12538,Mississippi+New Madrid+Scott,Mississippi,29,133,Missouri,MO
29143,29CS035,200,193,207,289,89,82,96,37,2.749679768051248,3.1906888260851813,3.609941604493367,0.4096123611118415,241,233,249,296,55,47,63,24,1.6989007664752447,2.2927767791793285,2.883898406507803,0.4300738875327115,16404,16078,Mississippi+New Madrid+Scott,New Madrid,29,143,Missouri,MO
29201,29CS035,383,367,399,469,86,70,102,60,0.27020325379267224,0.6886639098214977,1.1193750803095839,0.6888026493828535,471,451,490,584,113,94,133,49,1.3749079536521052,2.041487781271838,2.602569296036668,0.4289816470152428,38051,37865,Mississippi+New Madrid+Scott,Scott,29,201,Missouri,MO
29145,29CS036,565,540,590,642,77,52,102,80,-0.47563397163612964,-0.04289132275843168,0.3454601682926898,1.022225738719362,698,668,729,815,117,86,147,115,-0.5802842644722692,0.05565190235241056,0.6631375426565581,0.9780861606527199,58652,59273,Newton,Newton,29,145,Missouri,MO
29159,29CS037,396,378,415,492,96,77,114,51,0.6455407113521323,1.0671987660888902,1.4482226665259603,0.5268124423219674,488,466,511,512,24,1,46,47,-1.284983904642381,-0.6338287257671537,-0.02744629318774612,1.9139011137812787,42898,43153,Pettis+Saline,Pettis,29,159,Missouri,MO
29195,29CS037,219,209,229,255,36,26,46,42,-0.6825393210688371,-0.2892336799297085,0.17209095082047646,1.1479562919490487,269,257,281,325,56,44,68,36,0.41543943242965253,1.014947805696505,1.641678068570874,0.6344384952354535,23244,23293,Pettis+Saline,Saline,29,195,Missouri,MO
29165,29CS038,648,602,694,740,92,46,138,67,-0.17837380644449058,0.2345752962805675,0.673116092462635,0.720529147109217,811,755,867,893,82,26,138,96,-0.7847636688980777,-0.1554939420785645,0.4426011812649663,1.151188678831466,106907,108355,Platte,Platte,29,165,Missouri,MO
29041,29CS039,80,79,81,115,35,34,36,17,2.3669825613675446,2.4638015970434077,2.5623952756030723,0.46964934765665334,98,97,98,117,19,19,20,12,1.067453860132682,1.214996283250541,1.3618552478308126,0.5866998240404697,7390,7360,Randolph and Nearby Counties,Chariton,29,41,Missouri,MO
29053,29CS039,166,159,173,173,7,-0,14,18,-1.077417979707544,-0.6503560361012322,-0.22227418792094364,2.2632070922059677,203,194,212,227,24,15,33,36,-1.464469674662585,-0.8771372234537336,-0.26926674259218975,1.4573062288523826,17161,17111,Randolph and Nearby Counties,Cooper,29,53,Missouri,MO
29089,29CS039,92,91,93,92,0,-1,1,1,-0.19086132495825064,-0.09484809936571151,0.009068989082732237,0.9612601183065145,114,112,115,145,31,30,33,14,1.904077359819721,2.0662341797189336,2.2097628228333064,0.4310694944117031,10123,10164,Randolph and Nearby Counties,Howard,29,89,Missouri,MO
29121,29CS039,175,168,181,235,60,54,67,15,2.554219445282493,2.975612320730677,3.4193738283506128,0.24578652088742914,214,206,222,225,11,3,19,17,-1.0201854382165745,-0.4863215963751204,0.151786243195027,1.4013045764614804,15172,15183,Randolph and Nearby Counties,Macon,29,121,Missouri,MO
29175,29CS039,246,235,256,280,34,24,45,41,-0.6860600960941756,-0.26833825648623416,0.1961523259743207,1.1583685366741132,302,289,315,353,51,38,64,38,0.00981104799237635,0.6434810723415197,1.2902772728638376,0.7279136572400198,24679,24742,Randolph and Nearby Counties,Randolph,29,175,Missouri,MO
29183,29CS040,2589,2415,2764,3221,632,457,806,396,0.1374647894098713,0.5836239097192504,1.004419607928399,0.625886115623727,3215,3004,3427,3634,419,207,630,298,-0.29231701353202943,0.35622230697667134,0.9734398957804375,0.7103581382602501,405970,409438,St. Charles,St. Charles,29,183,Missouri,MO
29186,29CS040,172,164,180,176,4,-4,12,10,-0.7563986958675138,-0.3444581514857307,0.08449304363371793,2.1092765618963356,212,202,222,246,34,24,44,26,-0.0909543459289334,0.5223133237858076,1.0975016843676988,0.7420427792941472,18412,18572,St. Charles,Ste. Genevieve,29,186,Missouri,MO
29187,29CS040,661,632,690,827,166,137,195,103,0.5487395956353742,0.9327197910692783,1.364379946087594,0.6176451809565786,813,778,848,1021,208,173,243,123,0.9449150789330485,1.5145423684487493,2.1513911174344185,0.5882348059039422,66973,67448,St. Charles,St. Francois,29,187,Missouri,MO
29510,29CS042,2506,2377,2635,3132,626,497,755,330,0.5381713838895031,0.9980349074317407,1.4321407408148508,0.5263338879680807,3025,2873,3177,3359,334,182,486,265,-0.3205117476428803,0.27058613950905563,0.8824060616461508,0.7915709475505117,299828,294363,St. Louis (city),St. Louis (city),29,510,Missouri,MO
29189,29CS043,8783,8352,9213,10649,1866,1436,2297,1364,0.06290644457721847,0.500139856938148,0.9303210270495533,0.7304255843898954,10743,10228,11258,11350,607,92,1122,933,-0.9914939418273012,-0.3906691174349832,0.20666540997538171,1.5345596628477405,1001174,998011,St. Louis (county),St. Louis (county),29,189,Missouri,MO
29001,29CS044,193,182,204,196,3,-8,14,11,-0.7199988817572257,-0.31863646227527054,0.08167222307609175,2.8651525161049904,238,225,251,290,52,39,65,35,0.23503821904355898,0.7961113022879974,1.417934401002333,0.662170721491993,25278,25194,Scotland and Nearby Counties,Adair,29,1,Missouri,MO
29045,29CS044,66,65,67,82,16,15,17,17,-0.22484217781327692,-0.12934442297098916,-0.03170133213232469,0.9923264785907248,81,80,82,102,21,20,22,12,1.514377820907098,1.6668510569956014,1.8268236943488372,0.5374404038378123,6668,6721,Scotland and Nearby Counties,Clark,29,45,Missouri,MO
29103,29CS044,36,36,37,45,9,8,9,3,1.4474068600287207,1.5364068235254285,1.6456560622455285,0.30588413934844266,44,44,45,67,23,22,23,6,5.1409035299257315,5.288087615007482,5.444365586459865,0.2527157444213247,3773,3797,Scotland and Nearby Counties,Knox,29,103,Missouri,MO
29111,29CS044,101,100,102,109,8,7,9,7,0.014711584479662573,0.11325647321801266,0.21790597949089788,0.7668617206015172,123,121,124,155,32,31,34,14,2.04224723575204,2.1982087513019875,2.3472795953962637,0.42071385217262086,9992,10005,Scotland and Nearby Counties,Lewis,29,111,Missouri,MO
29197,29CS044,39,39,40,51,12,11,12,5,1.5724765829364689,1.6790582927351951,1.785038034514914,0.3878412121262881,47,46,47,64,17,17,18,23,-1.8251587640864724,-1.672700873756264,-1.5051956095132035,1.2512662808354176,4100,4022,Scotland and Nearby Counties,Schuyler,29,197,Missouri,MO
29199,29CS044,45,45,45,51,6,6,6,6,-0.11042667987231816,-0.003210817051188416,0.09343415498870997,0.8588970279838515,54,54,55,69,15,14,15,11,0.8079974575597836,0.9561394756837746,1.1095639130174606,0.698420908936727,4732,4694,Scotland and Nearby Counties,Scotland,29,199,Missouri,MO
29209,29CS045,342,329,356,386,44,30,57,47,-0.48393527856317986,-0.09577677706270964,0.3481547580073811,1.0508709198715989,421,405,437,498,77,61,93,66,-0.20410655611325448,0.40002926744093925,1.0194541439174583,0.8477035024212709,31334,31494,Stone+Taney,Stone,29,209,Missouri,MO
29213,29CS045,527,502,551,622,95,71,120,72,-0.03943419579194534,0.40967226366142623,0.8389478633162533,0.7467911634139117,649,620,678,793,144,115,173,103,0.302594551545379,0.8609704577676278,1.5233710707213548,0.7093879238463267,56064,56333,Stone+Taney,Taney,29,213,Missouri,MO
29011,29CS046,129,124,134,132,3,-2,8,16,-1.6274731918208913,-1.1721855635824359,-0.7300411831799296,4.52809359577341,157,151,163,167,10,4,16,26,-2.288927334640886,-1.6843049675490862,-1.041665092898156,2.4365525183776717,11628,11651,Vernon and Nearby Counties,Barton,29,11,Missouri,MO
29013,29CS046,174,167,181,191,17,10,24,16,-0.36121041974318946,0.06688223273004712,0.517461991551466,0.878869282206847,211,203,219,244,33,25,41,42,-1.3256823076856945,-0.696580549882477,-0.07205759842246844,1.2413599964895852,16075,16096,Vernon and Nearby Counties,Bates,29,13,Missouri,MO
29039,29CS046,180,174,186,157,-23,-29,-17,13,-2.9564518830986963,-2.544695466983619,-2.1061301195734963,-0.5832276817331571,221,214,229,236,15,7,22,34,-2.2602923177827883,-1.607644136280641,-0.9834075772534506,2.190405447097743,14245,14453,Vernon and Nearby Counties,Cedar,29,39,Missouri,MO
29057,29CS046,91,90,92,111,20,19,21,28,-1.1527249666676738,-1.0567501504232104,-0.9551644424706704,1.3336008264000068,112,111,113,119,7,6,8,10,-0.5549529671380014,-0.4117026229676116,-0.2485940206214414,1.1872609694430185,7582,7597,Vernon and Nearby Counties,Dade,29,57,Missouri,MO
29217,29CS046,197,189,206,251,54,45,62,37,0.4423403482623877,0.8539404833072745,1.2667303653801842,0.6749607393351025,238,228,248,340,102,92,112,44,2.935259704203511,3.5652156572880456,4.166773232621152,0.426724614413476,19785,19602,Vernon and Nearby Counties,Vernon,29,217,Missouri,MO
30001,30CS001,75,74,76,94,19,18,20,4,1.4549939151173954,1.5683470572216447,1.6661374396309607,0.20287441454060773,93,92,95,122,29,27,30,18,1.1940808513650214,1.3422559014583224,1.4983780279867105,0.6070155893086648,9403,9502,Beaverhead+Gallatin+Madison,Beaverhead,30,1,Montana,MT
30031,30CS001,675,616,734,705,30,-29,89,40,-0.5238577146571972,-0.08022634755842126,0.37092820140907906,1.2928473956684037,853,781,925,876,23,-49,95,80,-1.1238939108199804,-0.49780696775471683,0.14367390494860763,3.3793040907160123,136240,139677,Beaverhead+Gallatin+Madison,Gallatin,30,31,Montana,MT
30057,30CS001,76,75,77,91,15,14,16,5,1.038176266434523,1.1395073981872303,1.2404219494654414,0.3136489636734087,95,94,96,105,10,9,11,14,-0.7112896019312646,-0.5692891207288353,-0.41974499538935717,1.296597611586654,8698,8879,Beaverhead+Gallatin+Madison,Madison,30,57,Montana,MT
30013,30CS002,781,745,817,908,127,91,163,137,-0.5907426058572467,-0.11723925901867326,0.2928808698481835,1.0721775449772684,961,918,1005,1029,68,24,111,114,-1.286655483633864,-0.6637646119993991,-0.016167092953507142,1.6631742654143833,83919,84484,Cascade,Cascade,30,13,Montana,MT
30023,30CS003,106,105,107,133,27,26,28,3,2.4819482867308857,2.5760344647638487,2.6748119919496482,0.1063432311915343,131,129,132,125,-6,-7,-4,14,-2.61716177149475,-2.4785475077640364,-2.3256986303323757,-3.073875527524852,9391,9480,Deer Lodge and Nearby Counties,Deer Lodge,30,23,Montana,MT
30039,30CS003,28,27,28,25,-3,-3,-2,5,-2.4027778068157404,-2.2971135457841534,-2.189878805737578,-3.092143413690658,34,34,34,39,5,5,5,4,0.18407420459755428,0.3374351924767985,0.4990607731478525,0.6733813655552319,3316,3339,Deer Lodge and Nearby Counties,Granite,30,39,Montana,MT
30077,30CS003,67,67,68,81,14,13,14,2,1.5717297125857579,1.672727978373091,1.765583642856939,0.1371236992851826,83,82,84,82,-1,-2,-0,14,-2.7676660322855793,-2.609566372975714,-2.4697031439154253,-68.33930417218305,6929,6990,Deer Lodge and Nearby Counties,Powell,30,77,Montana,MT
30081,30CS003,415,395,434,478,63,44,83,35,0.19836153457661343,0.6381387393645599,1.0544473842084863,0.5438274336318674,522,498,545,665,143,120,167,106,0.3671832235442531,0.9589156395982817,1.606874444578168,0.7339547475784308,44489,45724,Deer Lodge and Nearby Counties,Ravalli,30,81,Montana,MT
30093,30CS003,363,348,378,402,39,24,54,54,-0.8546189318289135,-0.43687085538621,0.027494788336350714,1.3577832751707328,447,428,465,536,89,71,108,51,0.7046589901016124,1.30326843300759,1.963342328247386,0.5650064417760964,35154,35376,Deer Lodge and Nearby Counties,Silver Bow,30,93,Montana,MT
30003,30CS004,134,128,139,197,63,58,69,61,-0.2541051455861928,0.1610012184170628,0.6196082139637483,0.9500595119783275,163,156,169,165,2,-4,9,24,-2.5984752492670666,-2.029355454943906,-1.4128200645807731,7.1614046904638675,13070,12971,Eastern Montana,Big Horn,30,3,Montana,MT
30011,30CS004,16,15,16,17,1,1,2,3,-1.1982760821095422,-1.0931957151739347,-0.9925903906586088,1.2117054740644106,20,19,20,12,-8,-8,-7,6,-11.521465870796701,-11.386902846476035,-11.232653761745969,-0.9194462483652012,1390,1426,Eastern Montana,Carter,30,11,Montana,MT
30017,30CS004,120,119,121,119,-1,-2,0,12,-1.1832574291163598,-1.0799614819073668,-0.9835813370229721,56.13469938779287,148,147,150,158,10,8,11,28,-2.0038503544000426,-1.8571509027536712,-1.6974683765737577,2.651761620712794,11792,11908,Eastern Montana,Custer,30,17,Montana,MT
30019,30CS004,17,17,18,25,8,7,8,6,0.8276059553654773,0.9234633156073181,1.026091015322171,0.7031734575533196,22,22,22,20,-2,-2,-2,4,-4.245209815628836,-4.084897586538549,-3.933946478558992,-5.531560419019507,1659,1682,Eastern Montana,Daniels,30,19,Montana,MT
30021,30CS004,79,78,80,115,36,35,37,20,1.7179820691364742,1.8248011815880945,1.9218143205428735,0.5378250889288196,97,96,98,139,42,41,43,22,2.522752302259956,2.6725090675544947,2.823307015481822,0.5134020567699262,8879,8907,Eastern Montana,Dawson,30,21,Montana,MT
30025,30CS004,26,26,27,29,3,2,3,4,-0.5730022652306046,-0.46774563651052686,-0.36591832314532896,1.1149450255316036,33,32,33,34,1,1,2,4,-1.1676382646597616,-1.0196031497117324,-0.8657168964925926,1.6481841289892505,3009,3019,Eastern Montana,Fallon,30,25,Montana,MT
30033,30CS004,12,12,12,12,-0,-0,-0,3,-2.8370687254028235,-2.732612219245106,-2.62573784536048,3.979519919976224,15,15,15,19,4,4,4,5,-1.3430021781346144,-1.1915152521750834,-1.0310794160337142,1.0401717291513797,1190,1204,Eastern Montana,Garfield,30,33,Montana,MT
30055,30CS004,17,17,17,13,-4,-4,-4,4,-4.6113776269529785,-4.517962895371867,-4.41203395608524,-1.4479113003240327,21,20,21,25,4,4,5,3,0.8460198474797109,0.9848065268532554,1.1423821908703409,0.5546118486689128,1719,1720,Eastern Montana,McCone,30,55,Montana,MT
30071,30CS004,46,46,47,46,-0,-1,0,12,-3.065481038580139,-2.9599488701019907,-2.856557295012932,17.071699273353744,57,57,58,67,10,9,10,13,-1.0772231532995709,-0.9334823536693021,-0.7940662660552803,1.2104738388709213,4156,4192,Eastern Montana,Phillips,30,71,Montana,MT
30075,30CS004,17,17,17,15,-2,-2,-2,2,-2.2761657779777833,-2.1778417914291297,-2.076833282862418,-2.8911598658552196,21,20,21,22,1,1,2,1,0.14904429365478172,0.29505416279753505,0.44809269183929307,0.41327702334478117,1693,1701,Eastern Montana,Powder River,30,75,Montana,MT
30079,30CS004,15,14,15,18,3,3,4,3,-0.2923831245509762,0.12651709672035671,0.5862430083182337,0.7227780455826426,18,18,19,12,-6,-7,-6,5,-13.071081195907052,-12.424872391578605,-11.783579612383637,-0.9471527899583266,1076,1089,Eastern Montana,Prairie,30,79,Montana,MT
30083,30CS004,80,79,81,95,15,14,16,15,-0.07295241216637703,0.025407888413582116,0.12924627210395984,0.9211549660726234,98,96,99,128,30,29,32,16,1.3824351333964011,1.5313371226091377,1.6854113278815772,0.5081466276913601,11397,11315,Eastern Montana,Richland,30,83,Montana,MT
30085,30CS004,123,119,128,167,44,39,48,45,-0.53122330784536,-0.1374964536116493,0.33793034487001683,1.0101592119844192,151,145,156,192,41,36,47,22,1.5312411418310328,2.112245973854126,2.765910043878134,0.5222802290851664,10820,10815,Eastern Montana,Roosevelt,30,85,Montana,MT
30087,30CS004,73,72,74,123,50,49,51,35,1.7275746294617162,1.8308127801241811,1.9346389346411876,0.6818582972423833,87,86,88,126,39,38,40,21,2.5166427751991836,2.65785434572925,2.817241187719877,0.5237254551473081,8376,8149,Eastern Montana,Rosebud,30,87,Montana,MT
30091,30CS004,40,39,40,29,-11,-11,-10,6,-4.920119619547683,-4.80992498235842,-4.711866251178831,-0.6127031959842671,49,49,50,61,12,11,12,2,3.134937118893836,3.2992094525219993,3.4671335946934754,0.15734082644463945,3490,3526,Eastern Montana,Sheridan,30,91,Montana,MT
30103,30CS004,10,10,11,5,-5,-6,-5,5,-14.313122839946104,-13.867528670674359,-13.469581449137365,-1.1284045278858685,13,12,13,4,-9,-9,-8,4,-20.81037871909021,-20.140633747208714,-19.497175134143845,-0.5078541457912178,752,767,Eastern Montana,Treasure,30,103,Montana,MT
30105,30CS004,77,76,78,91,14,13,15,17,-0.4670912639255983,-0.36654837573143567,-0.26282611155575,1.11545570822118,94,93,95,102,8,7,9,13,-1.0138092188578078,-0.8506921923248515,-0.705409909559825,1.5044772227161813,7526,7539,Eastern Montana,Valley,30,105,Montana,MT
30109,30CS004,13,12,13,19,6,6,7,6,-0.25760940281985567,0.17401689573129078,0.5887380929496144,0.8376643762926379,16,15,16,20,4,4,5,3,1.1005572721617392,1.746583266653099,2.3224979425189245,0.5624032074805239,932,933,Eastern Montana,Wibaux,30,109,Montana,MT
30029,30CS005,815,770,860,941,126,81,171,62,0.1732239667819446,0.6079345780194632,1.0324836732856095,0.48887480062494626,1026,970,1081,1250,224,169,280,150,0.23326280444004163,0.8371040212894776,1.4481633896392059,0.665960577927024,105026,107917,Flathead,Flathead,30,29,Montana,MT
30043,30CS006,89,88,90,136,47,46,48,7,3.171434231507128,3.2735133575865256,3.3754346949963727,0.14621883390575252,112,110,113,177,65,64,67,18,4.4151717494573965,4.565526805638734,4.724310898967259,0.271532417500825,12179,12421,Jefferson+Lewis and Clark,Jefferson,30,43,Montana,MT
30049,30CS006,552,521,583,604,52,21,83,49,-0.38591975843986376,0.039565582757893264,0.4582353101026323,0.9237908431178972,686,648,723,782,96,59,134,99,-0.6548521409121221,-0.06492069808895816,0.5855982735893263,1.0160509050358228,70990,72058,Jefferson+Lewis and Clark,Lewis and Clark,30,49,Montana,MT
30047,30CS007,274,260,287,319,45,32,59,23,0.2811889803922849,0.7086160515332223,1.1397979692485525,0.49501021357252606,339,323,356,397,58,41,74,62,-0.8100961096191629,-0.18303080168352365,0.45883198918368945,1.05974412180408,31241,31920,Lake+Lincoln+Mineral+Sanders,Lake,30,47,Montana,MT
30053,30CS007,210,202,219,239,29,20,37,12,0.4417734351834124,0.8552374822097011,1.2445715126288674,0.4032398956006644,262,252,273,331,69,58,79,50,0.4421181784951706,1.1154689377873948,1.7309925915361088,0.7167553420998979,19867,20409,Lake+Lincoln+Mineral+Sanders,Lincoln,30,53,Montana,MT
30061,30CS007,50,49,50,54,4,4,5,5,-0.21948571852291165,-0.11693414692194644,-0.02231746101739307,0.9147266714422159,64,63,64,84,20,20,21,13,1.6919331943905767,1.8378740422681998,1.9956400809525552,0.6074978039762955,4575,4817,Lake+Lincoln+Mineral+Sanders,Mineral,30,61,Montana,MT
30089,30CS007,146,141,152,163,17,11,22,14,-0.21049463974184374,0.21327349785285485,0.6989712017764458,0.784909627281556,183,176,190,233,50,43,57,39,0.42465006814701467,1.0112022831187355,1.5776916493863977,0.7662044008196345,12430,12885,Lake+Lincoln+Mineral+Sanders,Sanders,30,89,Montana,MT
30063,30CS008,771,720,822,835,64,13,115,56,-0.36603692670748905,0.07753121505438972,0.4966623601284579,0.8590402868977597,955,893,1017,1090,135,73,197,94,-0.22582993209501862,0.4091799804464951,1.0370320485215867,0.6909146547904726,118639,119344,Missoula,Missoula,30,63,Montana,MT
30005,30CS009,60,59,60,89,29,29,30,24,0.6657695078609068,0.7710003122820939,0.8761633350926689,0.7905602863720146,73,72,74,76,3,2,4,7,-0.8871392367458348,-0.7391021676350896,-0.5977990330628328,1.9034866849063088,6956,6983,North Central Montana,Blaine,30,5,Montana,MT
30015,30CS009,51,50,51,64,13,13,14,1,2.0140522568054307,2.1191022625957667,2.2140278858650366,0.06922326006947309,62,62,63,72,10,9,10,4,0.9909836589700813,1.1409465652864828,1.279374627365628,0.3765816360945337,5869,5914,North Central Montana,Chouteau,30,15,Montana,MT
30027,30CS009,148,143,153,150,2,-3,7,15,-1.5838970868433793,-1.1444711624832902,-0.6999700563269569,5.0279180155792815,182,176,188,172,-10,-16,-4,23,-4.074860062583583,-3.4515443954363816,-2.8496172532758224,-2.4632713189714637,11412,11594,North Central Montana,Fergus,30,27,Montana,MT
30035,30CS009,135,129,141,160,25,19,31,42,-1.635157919633949,-1.2462454639311618,-0.8201975743883217,1.6266600422467954,165,158,173,183,18,10,25,21,-0.9097173714361969,-0.29538344461829985,0.299023070358724,1.1285668086889302,13744,13779,North Central Montana,Glacier,30,35,Montana,MT
30041,30CS009,141,134,148,158,17,10,24,34,-1.4920615739714238,-1.0475238727426728,-0.6483561569415355,1.9278736613542427,172,164,181,205,33,24,41,29,-0.3309393010622342,0.261318995887014,0.9207068394746958,0.857549995948705,16278,16189,North Central Montana,Hill,30,41,Montana,MT
30045,30CS009,16,16,17,16,-0,-1,-0,8,-4.233393262573179,-4.1321098078777725,-4.031653332923158,12.14207166146612,20,20,20,24,4,4,4,2,0.889741845123369,1.0360664804812196,1.1855852421508972,0.4193686039914638,2019,2040,North Central Montana,Judith Basin,30,45,Montana,MT
30051,30CS009,13,13,13,18,5,5,5,5,-0.18254719543932443,-0.09305005972037064,0.006841290578905418,0.8598389489413976,16,15,16,15,-1,-1,-0,5,-3.6050569436163826,-3.448238812110591,-3.301747149504528,12.488216610537721,2021,1948,North Central Montana,Liberty,30,51,Montana,MT
30069,30CS009,7,7,7,3,-4,-4,-4,3,-13.866034402393536,-13.460300990489115,-13.040582860220692,-1.103340437170382,8,8,9,8,-0,-1,-0,8,-20.177502042175327,-19.57833883686958,-18.905290333432923,13.650965360880024,500,516,North Central Montana,Petroleum,30,69,Montana,MT
30073,30CS009,62,61,62,67,5,5,6,1,0.5980102076747923,0.7027152757036997,0.7947329430211536,0.1632794236599912,77,76,78,69,-8,-9,-7,6,-2.9281776816738816,-2.7732143813363495,-2.6360784318037784,-0.8817438490101464,5890,5978,North Central Montana,Pondera,30,73,Montana,MT
30099,30CS009,56,56,57,65,9,8,9,2,0.9939110284117956,1.085277424951949,1.1907131205406454,0.2043640430398289,69,68,70,92,23,22,24,14,1.5391324541805016,1.6901584758747341,1.8294484452375714,0.587982601844452,6231,6265,North Central Montana,Teton,30,99,Montana,MT
30101,30CS009,45,44,45,48,3,3,4,2,0.16996436825836167,0.2692007654612734,0.359920264363411,0.46343170869679606,56,55,56,75,19,19,20,9,2.3644994638708052,2.5135149928222935,2.6661796787978616,0.4391444247065626,4932,5004,North Central Montana,Toole,30,101,Montana,MT
30007,30CS010,58,57,59,43,-15,-16,-14,9,-3.646100805624867,-3.5483420209371257,-3.4459558625676188,-0.6374688980967416,75,74,76,92,17,16,18,20,-0.707600599329924,-0.5425722131318195,-0.39469479246103595,1.1281664349287253,6798,7224,South Central Montana,Broadwater,30,7,Montana,MT
30009,30CS010,89,88,90,104,15,14,16,7,0.6723993431868563,0.7740129315891621,0.8628552314065147,0.43345192873057486,111,109,112,109,-2,-3,-0,18,-2.310071934201784,-2.1841966887775572,-2.02018745862069,-30.39327176611883,10575,10798,South Central Montana,Carbon,30,9,Montana,MT
30037,30CS010,11,11,12,12,1,0,1,4,-4.381564901670976,-3.98015740126168,-3.5483528937001823,2.310690921297766,14,13,14,17,3,3,4,4,-1.8106249278663396,-1.172216144338471,-0.5766684381354078,0.9570265322902853,822,829,South Central Montana,Golden Valley,30,37,Montana,MT
30059,30CS010,20,20,20,18,-2,-2,-2,5,-3.8500995994232152,-3.742955880836225,-3.640935902648492,-4.251661700854554,25,25,25,19,-6,-6,-6,3,-5.738963842074797,-5.5885647905180065,-5.437735303495948,-0.5865036514157171,1917,1958,South Central Montana,Meagher,30,59,Montana,MT
30065,30CS010,51,50,51,60,9,9,10,5,0.7631374124930593,0.8667464248458695,0.9693210924209199,0.4942829677983352,64,63,64,92,28,28,29,17,2.646220928043869,2.7816062015463334,2.939115553054222,0.5799501053741435,4745,4874,South Central Montana,Musselshell,30,65,Montana,MT
30095,30CS010,71,70,72,95,24,23,25,7,1.7778544881572218,1.8849082552101164,1.9841987442866171,0.27823504696188456,86,85,87,133,47,46,48,20,3.4831718333582375,3.6254821381677242,3.7738172696305337,0.41403472638013694,9110,9039,South Central Montana,Stillwater,30,95,Montana,MT
30097,30CS010,31,31,32,46,15,14,15,4,2.823306594537318,2.9223509358596607,3.021690303455374,0.25367437180168845,38,38,39,42,4,3,4,8,-1.56943665144519,-1.4212843802672894,-1.2618144239102085,1.7402336685113042,3683,3715,South Central Montana,Sweet Grass,30,97,Montana,MT
30107,30CS010,23,23,23,32,9,9,9,2,3.3705570794803568,3.471882113940809,3.561499357776961,0.194980901046107,27,27,28,31,4,3,4,2,0.8033590025259745,0.9594805783104665,1.1037642770834277,0.43039514472987855,2091,2064,South Central Montana,Wheatland,30,107,Montana,MT
30111,30CS011,1375,1304,1445,1579,204,134,275,173,-0.22778618117212743,0.18943812563265272,0.6069567523812192,0.8420154679544051,1706,1620,1793,1942,236,149,322,238,-0.6250444671692704,-0.026658927952065068,0.6507058363234075,1.0061779256648797,164725,166840,Yellowstone,Yellowstone,30,111,Montana,MT
31007,31CS001,9,9,10,3,-6,-7,-6,3,-14.094324067725397,-13.649138054760797,-13.25779777408913,-0.5459901480082037,12,11,12,4,-8,-8,-7,4,-20.737590847157243,-20.117366504706837,-19.52054689508133,-0.6082769113451739,695,691,Banner and Nearby Counties,Banner,31,7,Nebraska,NE
31033,31CS001,84,83,85,107,23,22,24,13,0.9859063427388475,1.079731722410129,1.1791066752680959,0.5379824289092009,105,103,106,136,31,30,33,15,1.9326938739570174,2.0726695573363867,2.2244961386285063,0.46193657492738605,9418,9522,Banner and Nearby Counties,Cheyenne,31,33,Nebraska,NE
31105,31CS001,47,46,48,56,9,8,10,3,1.292970775559597,1.7493345419197415,2.1653140484297455,0.3005576966235736,57,55,59,50,-7,-9,-5,6,-5.27790894048871,-4.621935022233131,-4.070109759370922,-0.9739344080985809,3431,3410,Banner and Nearby Counties,Kimball,31,105,Nebraska,NE
31123,31CS001,49,48,49,69,20,20,21,12,1.7319284985016032,1.82910160771309,1.9358216985708088,0.5625524213933063,60,59,61,73,13,12,14,14,-0.4338759712415034,-0.28072158672336545,-0.12902492184906617,1.0045696553929266,4555,4569,Banner and Nearby Counties,Morrill,31,123,Nebraska,NE
31157,31CS001,364,349,380,460,96,80,111,96,-0.444867541159933,-0.011386336711713066,0.4188537520950164,0.9905340909272007,444,426,463,465,21,2,39,48,-1.5655213360858788,-0.9202603296660318,-0.2815454471814723,2.2143557417610644,35914,35782,Banner and Nearby Counties,Scotts Bluff,31,157,Nebraska,NE
31019,31CS002,316,294,337,385,69,48,91,58,-0.22523494523258533,0.22516856219320627,0.6611884888960216,0.8258177918611082,391,365,417,424,33,7,59,35,-0.6308383886109374,-0.0433237157283105,0.5237721607881071,1.0255865631914685,50106,50308,Buffalo+Kearney+Sherman,Buffalo,31,19,Nebraska,NE
31099,31CS002,64,63,65,61,-3,-4,-2,3,-1.002882013854191,-0.9000752393212844,-0.800862975180947,-1.4891773823339707,78,77,79,63,-15,-16,-14,5,-3.7587339729479283,-3.619829372603244,-3.4627106304587314,-0.35442602808181956,6680,6677,Buffalo+Kearney+Sherman,Kearney,31,99,Nebraska,NE
31163,31CS002,34,33,34,43,9,9,10,1,2.6850731311977807,2.7879162621172533,2.8894671239864875,0.0975100943423848,41,41,42,39,-2,-3,-2,5,-3.055560878295149,-2.9167777492908065,-2.769491056319328,-4.184990350814644,2961,2963,Buffalo+Kearney+Sherman,Sherman,31,163,Nebraska,NE
31021,31CS003,81,80,81,94,13,13,14,11,0.2646653293702523,0.35700192504393036,0.4555943921710679,0.7650139922274469,99,98,100,72,-27,-28,-26,5,-5.892663332096367,-5.74606041372363,-5.600921627915052,-0.1912135523146819,6687,6711,Burt+Dakota+Thurston+Washington,Burt,31,21,Nebraska,NE
31043,31CS003,155,146,165,210,55,45,64,68,-1.0340450947225377,-0.6252892574594949,-0.20261960655354883,1.2230182997791972,190,179,201,157,-33,-44,-22,11,-3.0981701061119766,-2.480893105352241,-1.8320555556745515,-0.3454809157751116,21270,21279,Burt+Dakota+Thurston+Washington,Dakota,31,43,Nebraska,NE
31173,31CS003,67,66,68,84,17,16,18,10,0.9173221983468491,1.0167444188960377,1.1126871903348805,0.5580745260487485,80,79,81,102,22,21,23,18,0.539894999396166,0.6851174746028984,0.8342386505622704,0.7884702882162352,6821,6642,Burt+Dakota+Thurston+Washington,Thurston,31,173,Nebraska,NE
31177,31CS003,163,154,172,177,14,5,23,19,-0.6680987669274417,-0.25266453009550827,0.1739991128654815,1.3010422867505178,201,190,211,201,0,-10,11,17,-1.5537973155117883,-0.936833096677697,-0.3318362889725424,11.958689667284203,20879,20960,Burt+Dakota+Thurston+Washington,Washington,31,177,Nebraska,NE
31027,31CS004,86,85,87,95,9,8,10,20,-1.3835639071948462,-1.2787877649730235,-1.1784954652911954,1.9488160083736317,104,103,105,87,-17,-18,-16,12,-4.378409141294205,-4.233270373318821,-4.074029199729957,-0.7320299000297735,8375,8336,Cuming and Nearby Counties,Cedar,31,27,Nebraska,NE
31037,31CS004,66,65,67,65,-1,-2,0,21,-2.173300334650551,-2.078041563665333,-1.9797937063824405,356.43461706592075,81,79,82,65,-16,-17,-14,4,-2.390169802191565,-2.2304139074631406,-2.0776150676513887,-0.2751525460157752,10560,10505,Cuming and Nearby Counties,Colfax,31,37,Nebraska,NE
31039,31CS004,81,80,82,104,23,22,24,12,1.096666998437005,1.1955891623180326,1.3010469904410575,0.5056269392122087,100,98,101,121,21,20,23,5,2.0439960407734916,2.1889446395589633,2.3430557739636453,0.22310604803164988,8979,8988,Cuming and Nearby Counties,Cuming,31,39,Nebraska,NE
31051,31CS004,51,51,52,64,13,12,13,14,-0.3537779872761516,-0.24851754244951582,-0.1474665686917425,1.0292809410955177,63,62,63,64,1,1,2,4,-0.7004763012382834,-0.5452723372104913,-0.3968089983050048,1.6181166926594674,5585,5550,Cuming and Nearby Counties,Dixon,31,51,Nebraska,NE
31167,31CS004,37,36,37,55,18,18,19,6,1.98228877733871,2.0881303459625924,2.1886668292522646,0.31277780632742413,45,44,46,43,-2,-3,-1,4,-1.39480196129013,-1.2432001678740248,-1.0954923526645475,-3.8832122642516715,5839,5817,Cuming and Nearby Counties,Stanton,31,167,Nebraska,NE
31179,31CS004,61,60,62,67,6,5,7,3,0.18190884978768854,0.2743043533137607,0.3704069364529219,0.4508870398509321,76,75,77,72,-4,-5,-3,2,-0.9101554822641257,-0.7575895040151901,-0.6019019331624987,-0.6278043002131046,9657,9770,Cuming and Nearby Counties,Wayne,31,179,Nebraska,NE
31053,31CS005,380,364,396,451,71,55,87,57,-0.028409394150392172,0.3826436899217531,0.8207381369071112,0.7880609099864812,462,443,481,488,26,7,45,41,-1.1040766388263634,-0.4893191252025684,0.1306723779661396,1.5278122598200643,37006,37103,Dodge+Saunders,Dodge,31,53,Nebraska,NE
31155,31CS005,196,186,205,234,38,29,48,18,0.44438921228699996,0.9160499616067789,1.3782591653436125,0.45798062201044476,242,231,254,251,9,-3,20,23,-1.347951091720515,-0.7489812660053633,-0.11973787043091062,2.388188116514748,22289,22725,Dodge+Saunders,Saunders,31,155,Nebraska,NE
31055,31CS006,3658,3407,3910,4168,510,258,761,488,-0.39120355734081236,0.03049922368366813,0.4290033970888485,0.955914183878438,4520,4218,4822,4692,172,-130,474,384,-1.0941902439657711,-0.45116850256102736,0.19739865280968494,2.216459736511852,582946,585008,Douglas,Douglas,31,55,Nebraska,NE
31029,31CS007,44,44,45,46,2,1,2,7,-1.4646737529508678,-1.3587893581335544,-1.2591458155836384,2.5727941405424724,54,53,54,60,6,6,7,5,0.1805971082413421,0.3253096054957892,0.47644681133974953,0.7099894688489456,3878,3834,Frontier and Nearby Counties,Chase,31,29,Nebraska,NE
31047,31CS007,191,181,201,228,37,27,47,36,-0.40696143749943664,0.04507882689280967,0.48075467304536285,0.9438093692185396,235,223,248,241,6,-7,18,29,-1.8062897260568767,-1.1828986834811441,-0.5822943889862154,4.292921217344234,23956,23919,Frontier and Nearby Counties,Dawson,31,47,Nebraska,NE
31057,31CS007,20,20,21,20,-0,-1,-0,3,-2.194491080946351,-2.1053541547409522,-2.0067064291266754,5.6975523975706315,25,25,25,25,0,-0,0,3,-2.3448838142603794,-2.1831312275888055,-2.0346668676629065,2.9565748990242735,1651,1637,Frontier and Nearby Counties,Dundy,31,57,Nebraska,NE
31063,31CS007,17,17,17,19,2,2,2,1,0.24361899185107783,0.3476387242068148,0.44323650289296745,0.34729738413913175,21,21,22,31,10,9,10,7,1.0619618391324621,1.2068672925342299,1.3654861985597544,0.6622941672260031,2532,2548,Frontier and Nearby Counties,Frontier,31,63,Nebraska,NE
31073,31CS007,20,20,20,29,9,9,9,4,2.6440729514180785,2.7474092381990736,2.8426674541661656,0.3917948259383615,24,23,24,22,-2,-2,-1,9,-7.085943739892625,-6.943993081501136,-6.792678741868956,-14.656283341373658,1897,1834,Frontier and Nearby Counties,Gosper,31,73,Nebraska,NE
31085,31CS007,8,8,8,5,-3,-3,-3,5,-9.495523714717294,-9.390385123869752,-9.289792427848104,-2.3891142851997564,10,10,10,2,-8,-8,-8,2,-14.070656053362564,-13.925453346047501,-13.765462688674264,-0.2939200575351086,862,845,Frontier and Nearby Counties,Hayes,31,85,Nebraska,NE
31087,31CS007,31,31,32,44,13,12,13,4,3.151005849285986,3.2499620163870655,3.3547896724879305,0.2952676020819503,38,38,38,45,7,7,7,6,0.23407118374160044,0.3882550969390524,0.5492866832933827,0.7653600822953234,2629,2590,Frontier and Nearby Counties,Hitchcock,31,87,Nebraska,NE
31145,31CS007,114,113,115,119,5,4,6,4,-0.0016187444112047077,0.09537326258587199,0.19308851962057585,0.6635875421491496,140,139,141,171,31,30,32,12,1.9896141068026858,2.135300026813587,2.289645585919774,0.37551456121066473,10673,10630,Frontier and Nearby Counties,Red Willow,31,145,Nebraska,NE
31079,31CS008,488,462,515,549,61,34,87,111,-1.237053636139156,-0.7964501594498534,-0.35178742634854937,1.8022423077984264,594,562,626,624,30,-2,62,53,-1.023450917866296,-0.4438077186496997,0.1313540741416742,1.7340136404986748,62466,62089,Hall,Hall,31,79,Nebraska,NE
31093,31CS009,64,63,65,70,6,5,7,14,-1.3313052382334796,-1.2291487825333347,-1.131283166521835,1.9933090605623223,79,79,80,93,14,13,14,6,1.2462299544735143,1.3925200272590748,1.5338349973614758,0.4116158680600105,6489,6526,Howard+Merrick+Nance+Platte,Howard,31,93,Nebraska,NE
31121,31CS009,73,72,74,90,17,16,18,17,-0.07320458191865957,0.020956817945050776,0.11252288242632533,0.9357271371477862,90,89,91,95,5,4,6,4,0.05452494737812457,0.1995874371617737,0.35801709985364555,0.6389824068753152,7683,7664,Howard+Merrick+Nance+Platte,Merrick,31,121,Nebraska,NE
31125,31CS009,44,44,45,52,8,7,8,3,1.2789227940265058,1.3747951424440208,1.4768061962736765,0.3459651870904305,54,54,55,49,-5,-6,-5,4,-3.463509323877294,-3.3199301972125617,-3.1673394859439385,-0.9118837228606471,3397,3389,Howard+Merrick+Nance+Platte,Nance,31,125,Nebraska,NE
31141,31CS009,264,249,278,305,41,27,56,51,-0.7081076376390292,-0.2914183063099158,0.13441191637973518,1.2075227307666423,326,309,344,344,18,-0,35,32,-1.1120048270989022,-0.4983274555781896,0.08043381653821756,1.7202419757704843,34150,34247,Howard+Merrick+Nance+Platte,Platte,31,141,Nebraska,NE
31109,31CS010,1974,1835,2113,2179,205,66,344,148,-0.236637185516696,0.17224310864462702,0.6050274136900322,0.7184599401015719,2451,2284,2619,2551,100,-68,267,179,-0.895435873007931,-0.31202761678070584,0.35225633884631835,1.7766663088842962,322420,324280,Lancaster,Lancaster,31,109,Nebraska,NE
31049,31CS011,20,19,20,18,-2,-2,-1,7,-4.838313295430169,-4.732807348129878,-4.636923422499871,-10.464605886298097,24,24,25,35,11,10,11,3,4.685934627069727,4.841468687249418,4.997041422828071,0.26071774122427144,1831,1860,Lincoln and Nearby Counties,Deuel,31,49,Nebraska,NE
31101,31CS011,82,81,83,78,-4,-5,-3,1,-0.6947625639859544,-0.5884590668936366,-0.48846333597353,-0.3456449340813353,101,100,102,132,31,30,32,15,2.2189805977252544,2.3802431409974387,2.51441620475411,0.46301890195780365,8274,8285,Lincoln and Nearby Counties,Keith,31,101,Nebraska,NE
31111,31CS011,316,301,331,406,90,75,105,55,0.5789205588049072,1.0115061747510532,1.4313632297917707,0.6052221955969629,383,366,401,501,118,100,135,60,1.4133297255896602,2.0379289666908913,2.6344640113671014,0.5055031305352288,34552,34194,Lincoln and Nearby Counties,Lincoln,31,111,Nebraska,NE
31113,31CS011,9,9,9,12,3,3,3,6,-4.767521345796365,-4.337660549603187,-3.9095669458941735,1.5366117690069658,11,10,11,6,-5,-5,-4,6,-19.203052469132516,-18.624797025058644,-18.015822295715687,-1.6121719626394257,716,691,Lincoln and Nearby Counties,Logan,31,113,Nebraska,NE
31117,31CS011,5,5,5,2,-3,-3,-3,2,-12.983754893801814,-12.559257578793844,-12.169523158390883,-0.9414093479164299,6,6,6,8,2,2,2,8,-19.294766995285364,-18.632072751823287,-17.99766095587416,2.597213892032191,408,381,Lincoln and Nearby Counties,McPherson,31,117,Nebraska,NE
31135,31CS011,29,29,29,28,-1,-1,-1,11,-4.248368024552557,-4.145275432078041,-4.049718096227106,64.78163340404636,35,35,35,36,1,1,1,3,-1.0580173260743213,-0.9002019478081552,-0.7489900195425011,1.6001722417677244,2854,2835,Lincoln and Nearby Counties,Perkins,31,135,Nebraska,NE
31005,31CS012,6,6,6,8,2,2,2,8,-14.494088084865407,-14.046307053878975,-13.591870691131279,2.7953548344039367,8,7,8,6,-2,-2,-1,6,-21.21308917175228,-20.588682215464445,-19.930626093887224,-11.668663175428147,437,438,Northwest Nebraska,Arthur,31,5,Nebraska,NE
31009,31CS012,6,6,6,4,-2,-2,-2,4,-14.493748678507615,-14.06513299809598,-13.671072827829072,-3.4427579737248353,8,8,8,3,-5,-5,-5,3,-21.214581692921566,-20.571153635205913,-20.001943516645685,-0.7822111597513741,438,457,Northwest Nebraska,Blaine,31,9,Nebraska,NE
31013,31CS012,98,97,99,112,14,13,15,5,0.7222417331644057,0.8166815385843365,0.9207398018558935,0.3372146500569837,117,116,119,130,13,11,14,15,-0.4295474064449483,-0.2827957566911183,-0.12310687421047475,1.1076330229482112,10796,10636,Northwest Nebraska,Box Butte,31,13,Nebraska,NE
31017,31CS012,30,30,30,40,10,10,10,7,0.8920983094695835,0.9880546123381606,1.0865933831163248,0.6438025995090686,37,36,37,50,13,13,14,4,3.763325832348663,3.911617755891598,4.060627028147246,0.27632733631274486,2913,2907,Northwest Nebraska,Brown,31,17,Nebraska,NE
31031,31CS012,52,51,52,70,18,18,19,10,1.4308437622739336,1.5356976567195006,1.6382296706234953,0.5137917428857521,62,61,63,79,17,16,18,10,1.377096316835449,1.5225785580923488,1.664734995475767,0.5575617909876665,5505,5459,Northwest Nebraska,Cherry,31,31,Nebraska,NE
31041,31CS012,100,99,101,126,26,25,27,15,0.9428206360505539,1.0511075545993165,1.1533961569540334,0.5534566939685117,121,119,122,144,23,22,25,14,0.9366628047893243,1.0832826372105302,1.2531863888629504,0.571743340032405,10535,10465,Northwest Nebraska,Custer,31,41,Nebraska,NE
31045,31CS012,70,70,71,90,20,19,20,16,0.327785677445324,0.424912648700502,0.5356674504892818,0.7804358541425077,85,84,86,107,22,21,23,4,2.503978095922497,2.6529097595986637,2.808488975452075,0.17363348808749401,8210,8148,Northwest Nebraska,Dawes,31,45,Nebraska,NE
31069,31CS012,26,26,27,24,-2,-3,-2,2,-2.7763880140475594,-2.3677216478688234,-1.9301914571152017,-1.4043156272966981,32,31,33,36,4,3,5,6,-1.8223914614117913,-1.169374760925955,-0.5544897017707069,1.1523693578972825,1870,1852,Northwest Nebraska,Garden,31,69,Nebraska,NE
31075,31CS012,9,9,9,14,5,5,5,4,1.5206072747575359,1.6226530591422768,1.7265473018723276,0.667580080920968,10,10,11,7,-3,-4,-3,7,-21.656141234710997,-21.499980602139637,-21.346076315189908,-2.8414392165053917,611,584,Northwest Nebraska,Grant,31,75,Nebraska,NE
31091,31CS012,13,13,13,10,-3,-3,-3,2,-7.297232024093023,-7.195375071537371,-7.093065384297353,-0.9684431537994802,16,16,17,15,-1,-2,-1,7,-14.060956762150557,-13.918037758957453,-13.757544417035984,-15.088617508985786,704,730,Northwest Nebraska,Hooker,31,91,Nebraska,NE
31103,31CS012,11,11,11,6,-5,-5,-5,6,-14.548055887628925,-14.104376801753093,-13.650427820948707,-1.5662903881951888,13,13,14,3,-10,-11,-10,3,-21.207030137749502,-20.59025173420527,-19.937037879215612,-0.3175956490195063,769,784,Northwest Nebraska,Keya Paha,31,103,Nebraska,NE
31115,31CS012,10,10,10,8,-2,-2,-2,8,-16.472609595147116,-16.368723403530947,-16.268836621514104,-7.607092173578344,12,12,12,1,-11,-11,-11,1,-24.06295759309094,-23.906920527724417,-23.756060159228465,-0.09968660572525871,614,604,Northwest Nebraska,Loup,31,115,Nebraska,NE
31149,31CS012,18,17,19,15,-3,-4,-2,6,-7.463658074420607,-7.0168818953516165,-6.579168034901768,-3.0153612381132535,22,21,22,24,2,2,3,3,-1.2530368641239769,-0.6673820277276693,-0.09934771740921144,0.9097212352592167,1282,1264,Northwest Nebraska,Rock,31,149,Nebraska,NE
31161,31CS012,62,62,63,86,24,23,24,16,1.3834362687987203,1.484387451250374,1.5890766152880544,0.6505434830492529,76,75,76,71,-5,-5,-4,13,-4.273059208891918,-4.125148796372698,-3.970546475326379,-3.707090970151968,5116,5095,Northwest Nebraska,Sheridan,31,161,Nebraska,NE
31165,31CS012,9,9,9,10,1,1,1,6,-4.141260337571143,-4.042218777111317,-3.9459396471836192,2.5336756357187515,10,10,11,13,3,2,3,8,-5.877686739138814,-5.724039459967655,-5.570079291119089,2.25565972733451,1146,1143,Northwest Nebraska,Sioux,31,165,Nebraska,NE
31171,31CS012,10,9,10,7,-3,-3,-2,7,-14.450824092862469,-14.034302794059213,-13.594583738857795,-4.573006220009101,12,11,12,6,-6,-6,-5,6,-21.21375388054133,-20.60757255219896,-19.9803350860701,-1.3198841450272523,679,673,Northwest Nebraska,Thomas,31,171,Nebraska,NE
31059,31CS013,69,68,69,71,2,2,3,13,-2.0018943495535106,-1.9001744605538102,-1.796197401326358,3.76744262369227,84,83,85,82,-2,-3,-1,2,-1.0355988040980142,-0.8915203262240345,-0.7482031189724592,-1.8119650411890664,5553,5549,Saline and Nearby Counties,Fillmore,31,59,Nebraska,NE
31067,31CS013,234,225,243,252,18,9,27,25,-0.7526883626652382,-0.31315233093651595,0.1288871249547632,1.3039125301951915,286,274,297,330,44,33,56,30,0.19289135017052572,0.7679717661587666,1.4170704983020086,0.6613737357728307,21640,21623,Saline and Nearby Counties,Gage,31,67,Nebraska,NE
31095,31CS013,91,90,92,96,5,4,6,3,0.17637363016604002,0.2751516675653198,0.37748123749109097,0.5025960856198155,111,110,112,123,12,11,13,10,0.1266484052423186,0.2812472918525469,0.4368530029188946,0.7876684732982998,7216,7188,Saline and Nearby Counties,Jefferson,31,95,Nebraska,NE
31129,31CS013,52,51,52,70,18,18,19,12,1.43173538879329,1.5322034826847948,1.6439576744425421,0.6227863754291089,63,63,64,62,-1,-2,-1,5,-1.9552954523196493,-1.7959935386012909,-1.6618967238342108,-54.227657938543274,4089,4063,Saline and Nearby Counties,Nuckolls,31,129,Nebraska,NE
31151,31CS013,125,124,127,102,-23,-25,-22,2,-1.8726870182596747,-1.7635930533100368,-1.6708853441558713,-0.09022510313362479,154,152,156,133,-21,-23,-19,8,-2.5788847534665846,-2.436829046844126,-2.2844993605562323,-0.40264271150766784,14235,14200,Saline and Nearby Counties,Saline,31,151,Nebraska,NE
31169,31CS013,67,66,67,65,-2,-2,-1,3,-1.0902887134015482,-0.9895344835808946,-0.8835513856687809,-3.1729450443884097,81,80,82,95,14,13,15,8,1.3025423304556931,1.45982310925711,1.6160428343515831,0.5328395396479789,4997,4928,Saline and Nearby Counties,Thayer,31,169,Nebraska,NE
31153,31CS014,916,834,998,1136,220,138,302,116,0.09345959338410385,0.5529316533896024,0.9478051840407313,0.5242589428826425,1155,1055,1254,1298,143,44,243,105,-0.4109487743278084,0.22425614600812513,0.8594847567410915,0.7268763573442995,190738,193082,Sarpy,Sarpy,31,153,Nebraska,NE
31001,31CS015,265,252,278,337,72,59,85,47,0.368669761917359,0.8029234073821274,1.2365058058682337,0.6431703984990845,323,307,339,363,40,24,56,32,-0.32031974970877536,0.29204611850875745,0.9387417577494168,0.7824836047060217,31158,31044,South Central Nebraska,Adams,31,1,Nebraska,NE
31035,31CS015,58,57,59,74,16,15,17,12,0.5306495580071443,0.6359874714389562,0.7402404841930966,0.7106234733706402,70,70,71,83,13,12,13,11,0.18360457447358033,0.32488670775391515,0.47542730310843184,0.8067333580906021,6116,6081,South Central Nebraska,Clay,31,35,Nebraska,NE
31061,31CS015,32,32,33,40,8,7,8,6,0.4944829247883141,0.5896432647708058,0.6872664665881274,0.6887156561407554,39,39,40,65,26,25,26,7,7.536147791533639,7.7066972920984735,7.853965925656235,0.2629066214358553,2896,2900,South Central Nebraska,Franklin,31,61,Nebraska,NE
31065,31CS015,52,52,52,57,5,5,5,7,-0.5282628650642198,-0.4345027468638277,-0.330932723806002,1.1661850832263843,63,62,64,79,16,15,17,10,1.4150518051677785,1.5514632640461592,1.7071520441095909,0.5897166981639425,4625,4606,South Central Nebraska,Furnas,31,65,Nebraska,NE
31083,31CS015,32,32,32,37,5,5,5,3,0.5768004896172821,0.67676963270045,0.7693986196810589,0.49205899834749917,39,38,39,62,23,23,24,2,8.175450227204621,8.31448364823215,8.474850410096101,0.08200579828528534,3104,3086,South Central Nebraska,Harlan,31,83,Nebraska,NE
31137,31CS015,94,93,95,98,4,3,5,12,-0.984417886581602,-0.8839045197140112,-0.7832329388173671,2.364793765620897,114,113,115,141,27,26,28,11,1.983998107343071,2.1454492015003597,2.3085659655798283,0.3931391192710621,8968,8942,South Central Nebraska,Phelps,31,137,Nebraska,NE
31181,31CS015,48,48,48,54,6,6,6,7,-0.40860412134394847,-0.31106066760717366,-0.20964492798851922,1.008024113319417,59,58,59,63,4,4,5,7,-1.0661740989478135,-0.9180408156304319,-0.7806026974056699,1.2984666661431514,3401,3408,South Central Nebraska,Webster,31,181,Nebraska,NE
31025,31CS016,202,190,213,266,64,53,76,17,1.3291539802250858,1.7775682080625985,2.2256936018581097,0.26087605771206956,250,236,264,265,15,1,29,22,-0.9050612756164781,-0.3021613009894775,0.2733138604688891,1.3859611967325254,26578,26955,Southeast Nebraska,Cass,31,25,Nebraska,NE
31097,31CS016,59,58,59,51,-8,-8,-7,4,-2.329657482990927,-2.2271016213084565,-2.1267989881192255,-0.5967135486838641,73,72,73,67,-6,-6,-5,6,-2.8063745211397833,-2.657040442501012,-2.50555383373226,-1.2595017335094896,5256,5312,Southeast Nebraska,Johnson,31,97,Nebraska,NE
31127,31CS016,72,71,72,81,9,9,10,14,-0.7419034619007788,-0.6514387160450279,-0.5512184143620199,1.3440891376832147,88,87,89,90,2,1,3,10,-1.4942421678372095,-1.3443585925253443,-1.1843339429562612,3.239067504114325,7064,7068,Southeast Nebraska,Nemaha,31,127,Nebraska,NE
31131,31CS016,153,146,160,148,-5,-12,2,4,-1.0154492898560232,-0.5810524361013575,-0.16360757973571077,-0.9458913653699569,187,179,195,193,6,-2,14,14,-1.1802678737788979,-0.6049690449341557,0.03222656615444483,1.9847968736047648,15911,15924,Southeast Nebraska,Otoe,31,131,Nebraska,NE
31133,31CS016,34,33,35,43,9,8,10,4,1.704717099722604,2.0824168563669065,2.518958753709944,0.3865406619660963,41,40,42,41,0,-1,1,6,-3.3613039735453754,-2.7417930120718217,-2.106069703519957,5.162486995974466,2552,2546,Southeast Nebraska,Pawnee,31,133,Nebraska,NE
31147,31CS016,98,97,98,129,31,31,32,18,1.621516690332868,1.7217075653958467,1.8208892484987989,0.5540709911273348,119,118,120,131,12,11,13,12,-0.08381299737793287,0.07196076584066848,0.21245262822089,0.8940326271360446,7831,7770,Southeast Nebraska,Richardson,31,147,Nebraska,NE
31003,31CS017,62,61,63,75,13,12,14,10,0.40182878649630493,0.4964892370925057,0.5951153649486018,0.708382523188384,75,75,76,82,7,6,7,7,-0.23530648572452645,-0.08559407114333946,0.07602238274791938,0.9216479715287366,6282,6279,Wheeler and Nearby Counties,Antelope,31,3,Nebraska,NE
31011,31CS017,56,56,57,62,6,5,6,5,0.01975561654419934,0.1153011419709521,0.21970682864017435,0.7553483246198771,69,69,70,82,13,12,13,5,1.5366314074046719,1.6985034129232044,1.8549489084487685,0.36756476290212897,5329,5381,Wheeler and Nearby Counties,Boone,31,11,Nebraska,NE
31015,31CS017,26,26,27,33,7,6,7,6,-0.10447435115178971,0.33971817008349725,0.7300866633511309,0.7896542541115237,32,31,33,38,6,5,7,2,2.1923819755839826,2.8237010137100516,3.382391591174725,0.2767312294358342,1817,1791,Wheeler and Nearby Counties,Boyd,31,15,Nebraska,NE
31071,31CS017,27,26,27,23,-4,-4,-3,1,-2.9061024004002745,-2.5192210456404536,-2.072764730254609,-0.3864406049574524,33,32,33,40,7,7,8,4,1.668094819928967,2.2832396709008433,2.850582347906892,0.47208290219975674,1833,1834,Wheeler and Nearby Counties,Garfield,31,71,Nebraska,NE
31077,31CS017,23,23,23,27,4,4,4,7,-1.5349479983680945,-1.4403675682138104,-1.330686234870822,1.44854138483629,28,28,28,28,0,-0,0,5,-2.8079763540806604,-2.6459808461470153,-2.4971506114223856,4.117682625328982,2206,2171,Wheeler and Nearby Counties,Greeley,31,77,Nebraska,NE
31089,31CS017,105,104,106,112,7,6,8,17,-1.1320786453555955,-1.0353578529394336,-0.938327992901605,2.2408015305026834,128,127,129,123,-5,-6,-4,5,-1.3661743216039872,-1.211417803141573,-1.0584648288904845,-1.1967639015258689,10080,10054,Wheeler and Nearby Counties,Holt,31,89,Nebraska,NE
31107,31CS017,89,88,90,104,15,14,16,12,0.24288536194334168,0.34832014480713813,0.4529462050054262,0.7556616331669042,109,108,110,122,13,12,14,12,0.004289301725896723,0.15857824410973853,0.3176120406798293,0.8510682144317427,8378,8398,Wheeler and Nearby Counties,Knox,31,107,Nebraska,NE
31119,31CS017,320,305,336,327,7,-9,22,41,-1.3891362899166646,-0.956950532256041,-0.5516373259633002,5.38402843796261,392,374,411,356,-36,-55,-18,24,-2.6993536636765882,-2.040606991457023,-1.354178862040491,-0.6781304019541249,35398,35357,Wheeler and Nearby Counties,Madison,31,119,Nebraska,NE
31139,31CS017,62,62,63,64,2,1,2,17,-2.203656982417794,-2.1001285804308694,-1.9985044374257679,6.388323256241649,76,75,77,82,6,5,7,4,0.14894433713529504,0.2986598789188343,0.4357821376907953,0.5888721531425344,7298,7315,Wheeler and Nearby Counties,Pierce,31,139,Nebraska,NE
31175,31CS017,44,43,44,41,-3,-3,-2,6,-2.277150337541641,-2.1690602276659474,-2.0709937763810236,-3.304167919559725,53,53,54,73,20,19,20,4,4.440096806605453,4.5936092036083,4.74734294314167,0.1946997143007824,4060,4063,Wheeler and Nearby Counties,Valley,31,175,Nebraska,NE
31183,31CS017,11,11,12,6,-5,-6,-5,6,-15.032979594972076,-14.57716392728707,-14.154402899636223,-1.3899929839656027,14,14,14,5,-9,-9,-9,5,-21.85143337181989,-21.27199434465472,-20.668024278085802,-0.621822631815685,776,792,Wheeler and Nearby Counties,Wheeler,31,183,Nebraska,NE
31023,31CS018,94,94,95,90,-4,-5,-4,11,-1.959522705662664,-1.850960785407294,-1.7566913851801762,-3.2232992914774625,117,116,118,109,-8,-9,-7,6,-2.178643421931562,-2.0265826303287695,-1.8702052424464553,-0.8294522847047581,8307,8430,York and Nearby Counties,Butler,31,23,Nebraska,NE
31081,31CS018,72,71,73,101,29,28,30,20,0.8118466719682622,0.9140535936259947,1.0123017066021662,0.6762316725351983,89,88,90,112,23,22,24,1,2.673869673199492,2.8245568038548945,2.980944628263502,0.04149402735553671,9384,9388,York and Nearby Counties,Hamilton,31,81,Nebraska,NE
31143,31CS018,50,50,51,90,40,39,40,10,5.566191552374921,5.664143495774177,5.7638398443919066,0.24685051851466344,62,61,62,63,1,1,2,3,-0.502930723753536,-0.34768823287627737,-0.19862968494466632,1.2029416049129138,5209,5181,York and Nearby Counties,Polk,31,143,Nebraska,NE
31159,31CS018,156,149,164,155,-1,-9,6,23,-1.8358097803663105,-1.3812346208750998,-0.9682022077727916,-47.85694820128887,190,181,200,177,-13,-23,-4,19,-2.808493196187589,-2.2116147457064517,-1.627197175853683,-1.526685194636922,17563,17603,York and Nearby Counties,Seward,31,159,Nebraska,NE
31185,31CS018,145,139,151,137,-8,-14,-2,10,-1.6962367016557176,-1.2960023737604849,-0.8720950300750663,-1.3861056328642565,178,171,185,179,1,-6,8,11,-1.4389439822464356,-0.8688849107739867,-0.25056237169661383,5.922825874591958,14032,14221,York and Nearby Counties,York,31,185,Nebraska,NE
32005,32CS001,451,429,472,522,71,50,93,43,0.16141001608226407,0.5692533710109012,1.0340493805107123,0.5947460919337829,555,530,581,660,105,79,130,53,0.6855459957429382,1.2362524188039723,1.9095331389840706,0.5014580949699651,49441,49811,Carson City (city)+Douglas,Douglas,32,5,Nevada,NV
32510,32CS001,708,683,734,786,78,52,103,68,-0.2500795129269558,0.16475758497556287,0.62035124806354,0.8652013938675687,870,839,900,985,115,85,146,110,-0.521318079625294,0.10244770805398636,0.7202765083938858,0.9457989051420597,58304,58947,Carson City (city)+Douglas,Carson City (city),32,510,Nevada,NV
32003,32CS002,15108,14130,16087,18083,2975,1996,3953,2428,-0.20591085817122282,0.23271420345272095,0.6789242962688672,0.8159214136062567,18894,17712,20076,22825,3931,2749,5113,3895,-0.6132379519181773,0.022529529188755414,0.6918202979605476,0.9906716514262967,2275739,2289692,Clark+Nye,Clark,32,3,Nevada,NV
32023,32CS002,753,731,776,783,30,7,52,66,-1.1641028238385265,-0.7207063615910277,-0.27231294479558454,2.1575463327041904,946,918,973,1087,141,114,169,187,-1.6391331368319841,-1.0446614009193391,-0.3889381397914244,1.3141265603858798,51375,53234,Clark+Nye,Nye,32,23,Nevada,NV
32001,32CS003,252,241,263,325,73,62,84,46,0.6359423164301578,1.0740680135339171,1.4968751931698734,0.6187642331614203,310,296,323,388,78,65,92,50,0.7338367347011626,1.2995529106888386,1.9394497446412413,0.6300328688921261,25487,25696,Lyon and Nearby Counties,Churchill,32,1,Nevada,NV
32009,32CS003,9,9,9,6,-3,-3,-3,6,-12.236000731265104,-11.803342447007942,-11.37612070387002,-3.198699039896892,11,10,11,12,1,1,2,8,-11.550901590725266,-10.985564343778671,-10.385587573448337,3.5974222563958063,752,741,Lyon and Nearby Counties,Esmeralda,32,9,Nevada,NV
32019,32CS003,576,550,601,699,123,98,149,61,0.6608851880846137,1.0548840197377278,1.4755765585353617,0.49099296939069825,718,687,750,892,174,142,205,108,0.711102269029337,1.308203644890211,1.8993417317647263,0.6183898642545342,59303,60688,Lyon and Nearby Counties,Lyon,32,19,Nevada,NV
32021,32CS003,63,62,63,78,15,15,16,2,2.8232068205487613,2.926444264364399,3.02411114529651,0.1226997667372991,77,77,78,87,10,9,10,14,-1.2821740184195856,-1.1279630747286222,-0.9723278336286016,1.3086061579472779,4551,4581,Lyon and Nearby Counties,Mineral,32,21,Nevada,NV
32029,32CS003,33,33,34,36,3,2,3,5,-0.699560582243553,-0.5965838938641087,-0.4892711843050824,1.4142485652823842,41,41,42,48,7,6,7,1,1.4946458416179247,1.6435267036705212,1.8031558565796322,0.13044194353568644,4123,4138,Lyon and Nearby Counties,Storey,32,29,Nevada,NV
32007,32CS004,283,260,306,340,57,34,80,42,-0.14788557456455476,0.2824287979686289,0.73079677441227,0.7209305943734425,354,326,382,506,152,124,180,101,0.5206543874832532,1.1510611789464624,1.793812237548441,0.659526225076141,53640,53891,"Northern Nevada, excluding Washoe",Elko,32,7,Nevada,NV
32011,32CS004,12,12,13,11,-1,-2,-1,6,-4.0551198578443275,-3.9480903990882132,-3.846003814496811,-13.340205602674898,15,15,16,28,13,12,13,1,7.153926366899561,7.317550581036385,7.461459146354933,0.07380277114402281,1887,1895,"Northern Nevada, excluding Washoe",Eureka,32,11,Nevada,NV
32013,32CS004,130,123,138,124,-6,-14,1,10,-1.362182260276586,-0.9560111164066576,-0.5370948931272922,-1.823998855176073,164,155,173,207,43,34,52,36,-0.14189625294468675,0.5087386732042782,1.1310397283582616,0.8112183959122817,17263,17595,"Northern Nevada, excluding Washoe",Humboldt,32,13,Nevada,NV
32015,32CS004,43,43,44,55,12,11,12,4,1.2202558588064387,1.3288467993528885,1.436129583818176,0.31847593481514563,54,54,55,70,16,15,16,12,0.6011816809303234,0.7499738502313937,0.8970605456350301,0.721250895565988,5702,5787,"Northern Nevada, excluding Washoe",Lander,32,15,Nevada,NV
32017,32CS004,40,39,40,51,11,11,12,3,1.7404140860621504,1.8388434001735394,1.9402304399050663,0.24040585778302173,48,47,48,63,15,15,16,1,3.6133743052183225,3.76852301364007,3.9175505378553686,0.06170531748592542,4603,4522,"Northern Nevada, excluding Washoe",Lincoln,32,17,Nevada,NV
32027,32CS004,47,46,48,54,7,6,8,11,-0.7024585429751805,-0.6094421300906137,-0.5146971351938764,1.3849181255151193,59,58,60,86,27,26,28,19,1.3210302801205154,1.4696227523708754,1.6111198605400916,0.6728942350402636,6648,6726,"Northern Nevada, excluding Washoe",Pershing,32,27,Nevada,NV
32033,32CS004,74,73,75,79,5,4,6,0,0.4056625326147254,0.5046098291522654,0.6058216977597423,0,92,91,93,105,13,12,14,18,-0.7807082080151738,-0.6277330864695149,-0.4755733007194455,1.2676912369848607,9148,9167,"Northern Nevada, excluding Washoe",White Pine,32,33,Nevada,NV
32031,32CS005,3511,3302,3720,3998,487,278,696,441,-0.30430880433612095,0.09482036797550177,0.5124542451206913,0.9034952068613034,4362,4108,4617,4847,485,230,739,522,-0.6728760948183736,-0.08575028452319898,0.5491669850347277,1.074695555556909,485825,492516,Washoe,Washoe,32,31,Nevada,NV
33001,33CS001,660,632,687,697,37,10,65,44,-0.544706264150061,-0.09487826864187085,0.33204170303890657,1.146738853120465,818,785,851,823,5,-28,38,80,-2.047627521653997,-1.3991735582575848,-0.7599747246567645,13.56126981805417,63476,64355,Belknap+Carroll,Belknap,33,1,New Hampshire,NH
33003,33CS001,505,483,526,489,-16,-37,6,3,-0.7916957692703623,-0.3638856036052826,0.04004633014577567,-0.2062973734857119,632,606,659,611,-21,-48,5,36,-1.9450655305207971,-1.3390885945041815,-0.7191376464320415,-1.7817539187413287,50132,51312,Belknap+Carroll,Carroll,33,3,New Hampshire,NH
33005,33CS002,646,613,679,631,-15,-48,18,6,-0.7154713727663345,-0.2645262664996972,0.15984002431664165,-0.4266845230547803,800,761,840,900,100,60,139,76,-0.227748355782259,0.36162305714298953,0.9771604173836018,0.7561258907792154,76497,77208,Cheshire,Cheshire,33,5,New Hampshire,NH
33007,33CS003,382,368,395,402,20,7,34,20,-0.40875760011146434,0.005911451141094711,0.4240914324997664,0.944922867341345,467,451,483,573,106,90,122,62,1.0469252133471938,1.6779782069420341,2.2446834272798357,0.5810818449262553,31221,31272,Coos+Grafton,Coos,33,7,New Hampshire,NH
33009,33CS003,744,704,783,734,-10,-49,30,11,-0.6114042699578877,-0.23185167202832338,0.1881987170827367,-1.2874142358420373,925,877,972,935,10,-37,58,44,-1.074907430796124,-0.41603584910914115,0.18870840667909197,3.843008401679694,91125,92044,Coos+Grafton,Grafton,33,9,New Hampshire,NH
33011,33CS004,3003,2822,3185,3420,417,235,598,412,-0.43076017028138885,0.012239179809890977,0.41937110438842917,0.9866684275872838,3712,3493,3931,3961,249,30,468,297,-0.7380705474457108,-0.14801600797126216,0.49787966641257636,1.1866631253104651,422124,423879,Hillsborough,Hillsborough,33,11,New Hampshire,NH
33013,33CS005,1236,1170,1302,1280,44,-22,110,58,-0.527468686184079,-0.08711426412801668,0.3188164882240709,1.2953228080541002,1530,1450,1610,1560,30,-50,110,101,-1.1209299296331467,-0.5427334853110324,0.07360330482195179,3.2148801701759333,153721,155046,Merrimack+Sullivan,Merrimack,33,13,New Hampshire,NH
33019,33CS005,390,371,408,405,15,-3,34,3,-0.17179969087995373,0.2756643743369049,0.703781360974475,0.18466827956991486,481,459,504,516,35,12,57,45,-0.8814130088434919,-0.2898674400963216,0.3619231921866722,1.2581147213310682,43119,43460,Merrimack+Sullivan,Sullivan,33,19,New Hampshire,NH
33015,33CS006,2224,2089,2359,2461,237,102,372,183,-0.2541451470272126,0.16744060027793806,0.6140408176285951,0.7687703075209946,2760,2597,2923,2969,209,46,372,256,-0.808967214229831,-0.1808998705422068,0.47506143303326664,1.2190231691320619,313995,316580,Rockingham,Rockingham,33,15,New Hampshire,NH
33017,33CS007,1001,945,1058,1019,18,-39,74,26,-0.47882517481086323,-0.06588906187775008,0.3501262332319468,1.3771091045326367,1243,1175,1312,1338,95,26,163,114,-0.7869355131565086,-0.19359666747542395,0.4350105161783795,1.1906644584608468,131111,132210,Strafford,Strafford,33,17,New Hampshire,NH
34001,34CS001,2421,2303,2538,2830,409,292,527,286,0.02116055597998642,0.4713505691891594,0.8677397581964598,0.6969837935915376,2988,2846,3130,3402,414,272,556,413,-0.6569029072424931,-0.0054487995047517975,0.5960794247685439,0.9947525035452406,272735,274853,Atlantic,Atlantic,34,1,New Jersey,NJ
34003,34CS002,6316,5906,6726,8114,1798,1388,2208,1962,-0.6072965159035708,-0.17189144655751645,0.24522546528167166,1.0905354692794988,7806,7313,8298,7612,-194,-686,299,626,-1.6296644274794672,-1.0338604851569564,-0.4583189279412652,-3.2490028622968885,951391,953958,Bergen,Bergen,34,3,New Jersey,NJ
34005,34CS003,3622,3423,3820,4075,453,255,652,523,-0.556680978632345,-0.15502863069670342,0.23555312407077547,1.1509197922680912,4479,4240,4719,4556,77,-163,316,341,-1.265337011413713,-0.6745501662766291,-0.029323679833036943,4.3951810501703985,459823,463918,Burlington,Burlington,34,5,New Jersey,NJ
34007,34CS004,4264,4040,4489,5018,754,529,978,700,-0.3070277024830278,0.1017743610123467,0.5367520161261182,0.9273975620776843,5265,4995,5536,5642,377,106,647,516,-0.8889764784482305,-0.30419335009436543,0.31729304257447194,1.3663546469410348,520828,523688,Camden,Camden,34,7,New Jersey,NJ
34009,34CS005,1129,1088,1170,1224,95,54,136,112,-0.5718171798346073,-0.19276274965526302,0.2579926090105212,1.1688048336083545,1389,1340,1439,1436,47,-3,96,97,-1.2571341287266533,-0.646324851238607,-0.010804121364521647,2.0308124182292664,94725,95576,Cape May,Cape May,34,9,New Jersey,NJ
34011,34CS006,1369,1303,1435,1630,261,195,327,180,0.12107995510557058,0.5359787744064912,0.9604722872871119,0.6859338774203552,1684,1604,1763,1920,236,157,316,239,-0.6050785829339349,-0.023300843591049895,0.6073151151589883,1.0067458157181524,153117,153659,Cumberland,Cumberland,34,11,New Jersey,NJ
34013,34CS007,5450,5081,5818,7733,2283,1915,2652,2055,-0.17575093459393384,0.27519922642503625,0.6850232487516249,0.8995985265159738,6727,6286,7169,6760,33,-409,474,721,-1.6050977843268235,-0.9715730518459343,-0.3378907858849035,21.51094586280887,852560,855955,Essex,Essex,34,13,New Jersey,NJ
34015,34CS008,2401,2271,2531,2802,401,271,531,343,-0.2473966815018288,0.20611205923707412,0.6327108000993916,0.8525470016916058,2978,2821,3135,3183,205,48,362,321,-1.0924319688064557,-0.4356779746565287,0.11075205020545814,1.5586671997317776,301232,304204,Gloucester,Gloucester,34,15,New Jersey,NJ
34017,34CS009,3422,3114,3730,5136,1714,1406,2022,1511,-0.17106251937436928,0.28453989180954886,0.7202059977948774,0.88121277753567,4200,3835,4564,4532,332,-32,697,635,-1.1370761164841634,-0.5180548352307102,0.0764928337424842,1.9040783550501095,713461,705408,Hudson,Hudson,34,17,New Jersey,NJ
34019,34CS010,793,738,848,925,132,77,187,144,-0.5197794975576387,-0.09138764388092746,0.3466961151786604,1.0831437641132486,989,922,1056,996,7,-60,74,66,-1.1356235158038612,-0.5444213852265456,0.05326991479335436,7.805145561273949,128421,129766,Hunterdon,Hunterdon,34,19,New Jersey,NJ
34021,34CS011,2595,2429,2760,3247,652,487,818,607,-0.2971474217535214,0.12935626639973177,0.5235316410827339,0.9291900172795569,3209,3009,3408,3438,229,30,429,296,-0.836800183515027,-0.21197391433854898,0.3964789988681568,1.2856302890196147,383940,386024,Mercer,Mercer,34,21,New Jersey,NJ
34023,34CS012,5282,4913,5651,6749,1467,1098,1836,1445,-0.41491398900876714,0.02505428589868039,0.432864344797714,0.9843398627255482,6552,6107,6996,6779,227,-217,672,741,-1.3615270807874542,-0.7187422653872142,-0.1028534181506402,3.2470338790157602,856323,860968,Middlesex,Middlesex,34,23,New Jersey,NJ
34025,34CS013,4894,4618,5170,5879,985,709,1261,937,-0.35029873409755596,0.06713347924811755,0.5110449256825792,0.9505687438776818,6065,5732,6398,6320,255,-78,588,647,-1.2994403986891603,-0.7129880833168918,-0.13150215052335637,2.5252697569226203,639968,645034,Monmouth,Monmouth,34,25,New Jersey,NJ
34027,34CS014,3392,3173,3610,4288,896,678,1115,829,-0.29816492258832233,0.13989037451128844,0.5358507900159775,0.9238252135066725,4213,3950,4477,4197,-16,-280,247,314,-1.3873135129670535,-0.7818037343297213,-0.1736242888036096,-20.36530834037649,506666,510692,Morris,Morris,34,27,New Jersey,NJ
34029,34CS015,6582,6308,6856,7343,761,487,1035,1136,-0.9981902718057367,-0.5948731537103243,-0.1504791964156927,1.491408248508332,8164,7829,8498,8281,117,-217,452,891,-2.0536837907758896,-1.4560091348717603,-0.8056450807133655,7.520871765835471,635315,647514,Ocean,Ocean,34,29,New Jersey,NJ
34031,34CS016,3297,3073,3521,4800,1503,1279,1727,1352,-0.11101903509584628,0.29836741358627344,0.7187716623996575,0.8989602978667862,4061,3793,4329,4211,150,-118,418,514,-1.4454427594600652,-0.8415547749608154,-0.2347455371798314,3.4059410297465327,519480,518844,Passaic,Passaic,34,31,New Jersey,NJ
34033,34CS017,651,623,679,789,138,110,166,94,0.22349338846563974,0.6708926595609092,1.1083847386785934,0.6775451891495533,802,768,835,911,109,76,143,98,-0.3902413975952365,0.2023067138420087,0.7813088502707869,0.8877869844431633,64511,65019,Salem,Salem,34,33,New Jersey,NJ
34035,34CS018,2146,1998,2293,2624,478,331,626,525,-0.6096158743252507,-0.14748776022550417,0.28904178123335333,1.09499927932535,2667,2489,2845,2636,-31,-209,147,218,-1.4799556493038135,-0.8828240232844624,-0.19086508556353607,-7.285164007329696,342890,345555,Somerset,Somerset,34,35,New Jersey,NJ
34037,34CS019,1081,1019,1143,1321,240,178,302,217,-0.26302991029631734,0.15103608211960534,0.6231994402975751,0.9016570984178272,1347,1272,1422,1477,130,55,205,122,-0.5539404727550316,0.05258266600889064,0.6861779136321206,0.9306224171351396,143742,145330,Sussex,Sussex,34,37,New Jersey,NJ
34039,34CS020,3498,3251,3744,5073,1575,1329,1822,1389,-0.11497153132128785,0.3323082108370608,0.7161388110901097,0.8811358340197708,4322,4027,4618,4416,94,-202,389,480,-1.4551752805709028,-0.7936529530529675,-0.24709639805618655,5.063040611119586,571537,572440,Union,Union,34,39,New Jersey,NJ
34041,34CS021,901,854,948,1062,161,114,208,150,-0.3366323860205931,0.09908577746401842,0.5426965440615598,0.9254818104464166,1118,1061,1175,1192,74,17,131,106,-0.9793250559931135,-0.3429623640378825,0.2842056022677377,1.408949587289953,109110,110565,Warren,Warren,34,41,New Jersey,NJ
35001,35CS001,4930,4639,5221,6092,1162,871,1453,602,0.391844498516351,0.8251237551153944,1.2603288551895935,0.5176509172563655,6064,5715,6412,7313,1249,901,1598,797,0.20299073587491218,0.7850052699479557,1.4385884571609107,0.6374884338411754,676768,674712,Bernalillo,Bernalillo,35,1,New Mexico,NM
35003,35CS002,37,36,39,38,1,-1,2,4,-1.37239795317135,-0.9531791359072521,-0.5213285729702889,2.4572734661393345,47,45,49,71,24,22,26,10,3.9463806985251093,4.566058229716992,5.217324748497243,0.396985697279398,3609,3714,Catron+Cibola+Sierra+Socorro,Catron,35,3,New Mexico,NM
35006,35CS002,220,208,232,321,101,89,113,69,0.747417537924424,1.1903316898344107,1.616194537011104,0.6768734093982943,271,257,285,390,119,105,133,85,0.8559086478383722,1.491100084762936,2.105218365024314,0.7079086568592199,27030,27168,Catron+Cibola+Sierra+Socorro,Cibola,35,6,New Mexico,NM
35051,35CS002,219,214,224,264,45,40,50,42,-0.1320301220173671,0.30202268946283667,0.7327811200870501,0.906905241207596,266,260,272,275,9,3,15,29,-2.6422850247637206,-2.0527683048235437,-1.4816755998696283,2.8169400190545804,11430,11506,Catron+Cibola+Sierra+Socorro,Sierra,35,51,New Mexico,NM
35053,35CS002,150,143,157,194,44,37,51,48,-0.6939702521005208,-0.26455648844004087,0.1807574430279611,1.075456834007637,182,173,190,220,38,30,47,30,-0.013082060652475561,0.5892740629217951,1.2188825753647172,0.7666531448532176,16546,16348,Catron+Cibola+Sierra+Socorro,Socorro,35,53,New Mexico,NM
35005,35CS003,570,542,598,734,164,136,192,106,0.47565943103130115,0.8973612217006226,1.3073010621685361,0.6406010799178776,696,663,730,842,146,112,179,142,-0.5495593153013778,0.07611264906361423,0.7030587414193565,0.9671481847672463,65027,64708,Chaves,Chaves,35,5,New Mexico,NM
35009,35CS004,348,328,369,400,52,31,72,57,-0.5374613652973141,-0.11574064313110101,0.3356170510741919,1.0832945429440544,427,402,452,551,124,99,149,102,-0.061491455494368005,0.5611659948982107,1.1877225756178194,0.8151460689172103,48402,48047,Curry+Roosevelt,Curry,35,9,New Mexico,NM
35041,35CS004,145,137,154,162,17,8,25,40,-1.6644965873065871,-1.2307372294671548,-0.7873527263571912,2.269218304273082,179,169,189,219,40,30,50,47,-1.0317970612084215,-0.4450042823094338,0.13868804667776735,1.140666215135972,19018,19033,Curry+Roosevelt,Roosevelt,35,41,New Mexico,NM
35013,35CS005,1391,1296,1486,1984,593,498,688,329,0.7531638622110284,1.1899607074859813,1.6509456880128546,0.5539391983063328,1732,1617,1846,2307,575,461,690,323,0.7921804787673901,1.3909906177698768,2.0245690591282655,0.5604012476009274,219916,221273,Do�a Ana,Do�a Ana,35,13,New Mexico,NM
35015,35CS006,530,504,557,534,4,-23,30,77,-1.6044650638199378,-1.1826299272993464,-0.7456278442832099,16.720924168705963,645,614,677,785,140,108,171,149,-0.8212200663034505,-0.19161201946808423,0.44209634654307006,1.059560432301613,61553,61107,Eddy,Eddy,35,15,New Mexico,NM
35017,35CS007,303,291,315,374,71,59,83,23,1.2821334147335866,1.710804508608261,2.187630431847205,0.31954817498679056,370,356,385,424,54,39,68,58,-0.8135868026749792,-0.16482041139789375,0.3812967353929455,1.0574789566527183,27991,27936,Grant+Hidalgo+Luna,Grant,35,17,New Mexico,NM
35023,35CS007,45,45,46,47,2,1,2,6,-1.1371431638327667,-1.0355020795359435,-0.93567704218992,2.2190753630969278,55,54,55,61,6,6,7,7,-0.4064286390716563,-0.2588087422659341,-0.10786217382293473,0.9835376208177359,4149,4085,Grant+Hidalgo+Luna,Hidalgo,35,23,New Mexico,NM
35029,35CS007,274,263,285,337,63,52,74,59,-0.27375433108793223,0.15681450914073,0.6097286908389891,0.9228345963122393,339,326,352,421,82,69,95,57,0.5084744232789099,1.1490779410623795,1.7853597944797062,0.6881425021077908,25192,25516,Grant+Hidalgo+Luna,Luna,35,29,New Mexico,NM
35011,35CS008,21,21,21,28,7,7,7,7,-0.08175174493422885,0.014229689759297953,0.12016302076096656,0.8717493432045922,26,25,26,38,12,12,13,6,4.4244294166982,4.5772404334622125,4.734118281135868,0.447444626472698,1687,1680,Guadalupe and Nearby Counties,De Baca,35,11,New Mexico,NM
35019,35CS008,42,42,42,55,13,13,13,5,1.7055758742110432,1.8066384298946006,1.9039674361392882,0.3575215121469492,52,51,52,58,6,6,7,4,0.4022319221690956,0.5624212297365397,0.6964127216146213,0.5662532910048567,4423,4449,Guadalupe and Nearby Counties,Guadalupe,35,19,New Mexico,NM
35027,35CS008,205,197,214,208,3,-6,11,18,-1.2061410625999935,-0.7569670313043962,-0.312419152123159,4.939524702128564,254,244,265,317,63,52,73,40,0.7805542111839321,1.3559096701957623,1.9689691656115793,0.6258173789887126,20228,20416,Guadalupe and Nearby Counties,Lincoln,35,27,New Mexico,NM
35037,35CS008,104,103,105,140,36,35,37,10,2.865826824044453,2.966655121214071,3.0678403485843333,0.27287055536124327,128,127,129,173,45,44,46,39,0.6459858077290113,0.7933030461486462,0.9430587274898401,0.8527781772014256,8645,8665,Guadalupe and Nearby Counties,Quay,35,37,New Mexico,NM
35057,35CS008,142,136,149,151,9,2,15,10,-0.49270907706500966,-0.094161781074988,0.34608459902341093,1.0264284907808232,177,169,185,234,57,49,65,45,0.4018813667926505,0.9574835951297787,1.5916021203737092,0.7730030264869524,15135,15270,Guadalupe and Nearby Counties,Torrance,35,57,New Mexico,NM
35025,35CS009,502,470,533,604,102,71,134,134,-0.8488226303057833,-0.42233681788384597,-0.027165392503311445,1.2960622112954647,614,576,652,742,128,90,166,163,-1.1525243787282768,-0.5862196083527569,0.0669791807013281,1.2650770992331326,73916,73235,Lea,Lea,35,25,New Mexico,NM
35028,35CS010,117,115,119,116,-1,-3,1,5,-0.42519437747094346,-0.3206931190645004,-0.22715774025503901,-18.944183794714306,144,141,146,139,-5,-7,-2,10,-1.0769279406392183,-0.9192899637323626,-0.7734446475503274,-2.6044037424060744,19408,19344,Los Alamos+Santa Fe,Los Alamos,35,28,New Mexico,NM
35049,35CS010,1071,1005,1138,1215,144,77,210,87,-0.05150680531440178,0.3643363523281683,0.7966876766054886,0.6013135457125987,1324,1244,1404,1582,258,178,338,133,0.3647747433653904,0.9681663854440892,1.5279933870651012,0.5137944645066607,154413,155168,Los Alamos+Santa Fe,Santa Fe,35,49,New Mexico,NM
35031,35CS011,569,562,577,1056,487,479,494,374,1.4556594077505804,1.5598648826011778,1.6588594256109515,0.76699860287536,696,687,705,1008,312,303,321,179,2.063336260432767,2.2179472319578326,2.3629857711049977,0.572264294263508,72373,71904,McKinley,McKinley,35,31,New Mexico,NM
35007,35CS012,123,122,124,150,27,26,28,30,-0.363092613359089,-0.25987783013023597,-0.17014454458800468,1.0793294978609573,152,151,154,176,24,22,25,32,-0.9602493943082226,-0.8087733986182757,-0.6531947467003149,1.2972679135410583,12297,12364,Northeast New Mexico,Colfax,35,7,New Mexico,NM
35021,35CS012,9,9,10,12,3,2,3,5,-3.867932043171827,-3.764125711388397,-3.658783570839613,1.412659021456095,11,11,11,14,3,3,3,2,1.0132723814872133,1.1619947158133246,1.31379481244026,0.552230140546995,654,642,Northeast New Mexico,Harding,35,21,New Mexico,NM
35033,35CS012,41,39,43,43,2,0,4,4,-0.8589395126852922,-0.4450995647606074,-0.0035181862032612555,1.2827169383757828,50,48,52,56,6,4,8,8,-1.1202257509741764,-0.47005569585333234,0.11177662307593554,1.1058367717612485,4230,4194,Northeast New Mexico,Mora,35,33,New Mexico,NM
35047,35CS012,243,232,255,264,21,9,32,10,-0.010727189907698286,0.38741133925929594,0.812002452407378,0.4646532856813206,298,284,312,391,93,79,107,45,1.5135575184029912,2.1162505545904846,2.723462968290908,0.4794232169089106,27151,27145,Northeast New Mexico,San Miguel,35,47,New Mexico,NM
35059,35CS012,40,38,41,48,8,7,10,3,0.9213516573809928,1.3479902616806612,1.7703314661519964,0.3160310652515289,49,47,51,55,6,4,8,6,-0.5073152625221296,0.12711359097864613,0.6993029592934599,0.8173661308148288,4068,4101,Northeast New Mexico,Union,35,59,New Mexico,NM
35035,35CS013,542,512,571,640,98,69,128,45,0.38498979816233597,0.7880337929010967,1.2079627949962153,0.45274372967909277,670,634,705,850,180,145,216,122,0.3811270743960425,0.9909089621736523,1.6491762583456218,0.6724711210770692,67889,68438,Otero,Otero,35,35,New Mexico,NM
35039,35CS014,367,350,385,438,71,53,88,45,0.22599808126226856,0.6334787496353499,1.078746058553336,0.6290682790185181,451,430,471,594,143,123,164,70,1.5461954405647742,2.2054689925444797,2.8426414127907678,0.48455900876752417,40054,40191,Rio Arriba+Taos,Rio Arriba,35,39,New Mexico,NM
35055,35CS014,282,267,296,344,62,48,77,44,0.12412897592776183,0.5483364032762265,0.9685156332622444,0.6951795393941221,349,331,367,422,73,55,91,36,0.6863040025664213,1.2920727745037155,1.9209193871221415,0.48505678891371473,34177,34589,Rio Arriba+Taos,Taos,35,55,New Mexico,NM
35043,35CS015,1029,965,1093,1237,208,144,272,153,-0.03479981252951792,0.3728648592135795,0.8190921847692506,0.7318740728365458,1288,1210,1366,1536,248,170,326,177,-0.023924830480438145,0.5525341954624974,1.1602960775001663,0.7106530966032913,149125,151055,Sandoval,Sandoval,35,43,New Mexico,NM
35045,35CS016,905,853,958,1336,431,378,483,327,0.43002281057084,0.8319405162205464,1.2980292174233672,0.7576101509592394,1115,1052,1177,1696,581,519,644,369,1.4398778287067533,2.0997526692788426,2.705999895908418,0.633890929853007,121762,121057,San Juan,San Juan,35,45,New Mexico,NM
35061,35CS017,598,565,631,740,142,109,175,73,0.47674536851025673,0.8882867538784519,1.30114320412583,0.5115450536932493,743,703,783,954,211,171,251,142,0.4595270170635325,1.0898124865486662,1.7127525613372332,0.6694791347873223,76510,77064,Valencia,Valencia,35,61,New Mexico,NM
36001,36CS001,2389,2255,2524,2634,245,110,379,209,-0.3167069796265113,0.13284945386279173,0.5789576279891705,0.8513202259734948,2939,2777,3101,3188,249,87,411,256,-0.650090771227036,-0.021747657780725196,0.6259189172576628,1.0247690758888848,312901,313834,Albany+Greene,Albany,36,1,New York,NY
36039,36CS001,449,428,469,461,12,-8,33,28,-0.7462680790215757,-0.3161454905046127,0.1026337520934314,2.1269058852817593,555,530,580,653,98,73,123,67,0.17706026573866035,0.7728353670906679,1.3733884701507804,0.6749481727911597,47854,48410,Albany+Greene,Greene,36,39,New York,NY
36003,36CS002,418,398,438,474,56,36,76,69,-0.7174751698389835,-0.27666668229280683,0.15603375465504504,1.2133319457151517,512,488,536,562,50,26,74,81,-1.4054177817735847,-0.7956905411139119,-0.23725034527285588,1.598115118195162,46278,46145,Allegany+Steuben,Allegany,36,3,New York,NY
36101,36CS002,852,811,892,972,120,80,161,123,-0.4761931494292443,-0.016801243313567474,0.3999892848262465,1.0123786892797655,1041,993,1089,1267,226,178,274,145,0.4262048920051527,1.0513514588702215,1.6773993960855633,0.6396877783070655,93606,93009,Allegany+Steuben,Steuben,36,101,New York,NY
36005,36CS003,8329,7702,8955,14136,5807,5181,6434,4277,0.6450908045886916,1.0509920575118523,1.5135415101340035,0.7363820475992693,10144,9405,10882,11761,1617,879,2356,1456,-0.4528300337671162,0.11490725103476376,0.7584730595231126,0.899692910078762,1455080,1430999,Bronx,Bronx,36,5,New York,NY
36007,36CS004,1842,1757,1927,2054,212,127,297,211,-0.439895945681955,0.02320719868871684,0.42534134996775336,0.9912756412966989,2257,2155,2359,2510,253,151,355,298,-0.8963315794480327,-0.2770473154107672,0.35981676076566255,1.1745159940295766,197011,197380,Broome,Broome,36,7,New York,NY
36009,36CS005,722,689,755,789,67,34,100,53,-0.2496385243872869,0.18553198140651256,0.6038469088465792,0.7773789421947692,880,841,920,1156,276,236,315,161,1.1859935151529006,1.7996638777883944,2.4365502031115276,0.5816424270209433,76758,76496,Cattaraugus+Wyoming,Cattaraugus,36,9,New York,NY
36121,36CS005,326,308,343,373,47,30,65,28,0.06047604684149404,0.4776994480684553,0.902353091648059,0.5778184152216582,401,380,422,428,27,6,48,54,-1.4239850259834566,-0.7917846583167187,-0.1847674153330268,1.9194079316140849,40331,40478,Cattaraugus+Wyoming,Wyoming,36,121,New York,NY
36011,36CS006,644,611,676,759,115,83,148,29,0.7015303998305406,1.1401494564669832,1.582515665141915,0.2494378861393142,787,748,826,940,153,114,192,111,0.0672435914475664,0.6584926257570519,1.2158736892417645,0.7194911260666109,76124,75911,Cayuga,Cayuga,36,11,New York,NY
36013,36CS007,1279,1224,1333,1291,12,-42,67,41,-0.6500952020646807,-0.2315276778377861,0.24090277481817204,3.09150319985633,1559,1494,1625,1873,314,248,379,286,-0.3240904410932418,0.28932586069831945,0.8750445301094444,0.9081562402174762,127245,126897,Chautauqua,Chautauqua,36,13,New York,NY
36015,36CS008,864,828,900,942,78,42,114,100,-0.6819796378320727,-0.26250878200774963,0.18275786137000935,1.2583573418175031,1052,1009,1095,1138,86,43,129,123,-1.145012612995055,-0.5357046713952425,0.0899776497139529,1.4122976256525577,83725,83167,Chemung,Chemung,36,15,New York,NY
36017,36CS009,487,467,507,519,32,12,52,29,-0.3743639192992873,0.06544234087431594,0.5228694464062276,0.8830478243669633,589,565,613,698,109,85,133,83,0.010820026470158924,0.6470939632168842,1.3014764362741205,0.7556746122697228,47041,46615,Chenango+Cortland,Chenango,36,17,New York,NY
36023,36CS009,373,353,393,425,52,32,72,28,0.0694821097594541,0.505310115457123,0.9351052211360705,0.5307369300042463,454,430,478,556,102,78,126,54,0.6683723765395408,1.2398559054248575,1.7980137145348718,0.5242184967310718,46780,46371,Chenango+Cortland,Cortland,36,23,New York,NY
36019,36CS010,619,585,654,676,57,22,91,10,0.14890480950643736,0.5848746340611256,0.9764216066243011,0.1736792562833957,763,722,805,866,103,61,144,57,0.08990728014370926,0.6926386775014578,1.3031445728132645,0.5502402099716064,79749,79613,Clinton,Clinton,36,19,New York,NY
36021,36CS011,588,561,614,579,-9,-35,18,44,-1.281615116784589,-0.8581942304517849,-0.44491425645197774,-5.627842691510093,723,691,755,762,39,7,71,65,-1.1348004185791876,-0.4875678689182765,0.1480573210450239,1.6098625011953127,61287,61745,Columbia,Columbia,36,21,New York,NY
36025,36CS012,452,433,471,476,24,5,43,23,-0.41490284234277586,0.019358569655576304,0.44113269943060673,0.9211225259607,557,534,580,673,116,93,139,70,0.6091555344401909,1.2754742599873081,1.8816261444032323,0.5966868741711197,44231,44350,Delaware+Schoharie,Delaware,36,25,New York,NY
36095,36CS012,246,233,259,258,12,-1,25,2,-0.13858929873466613,0.3369894516320192,0.7750648419596298,0.15333386144960723,304,288,319,357,53,38,69,33,0.18632600778088612,0.7967852508686908,1.4496776545257488,0.6066334970818745,29929,29842,Delaware+Schoharie,Schoharie,36,95,New York,NY
36027,36CS013,2180,2053,2307,2497,317,190,444,264,-0.24349531382586037,0.1960845916433395,0.6119453171789144,0.8304350244067578,2700,2547,2853,3136,436,283,589,335,-0.22481699479735545,0.40321300959396605,1.0370435200107033,0.7667160185942997,295621,296912,Dutchess,Dutchess,36,27,New York,NY
36029,36CS014,8523,8114,8931,9465,942,534,1351,1189,-0.6944990160529114,-0.25521922151163756,0.20255724953835208,1.2604471206397236,10445,9954,10936,10896,451,-40,942,1200,-1.5496464698059087,-0.9432432660950864,-0.29306144691988234,2.6529451243656097,947964,951058,Erie,Erie,36,29,New York,NY
36031,36CS015,366,350,382,403,37,21,53,3,0.49055387278723844,0.9196113714595197,1.3554434786706928,0.07821161400619556,447,428,466,490,43,24,62,33,-0.32879155269904486,0.3180758875967069,0.9432044273993687,0.754011253964874,37278,37278,Essex+Franklin,Essex,36,31,New York,NY
36033,36CS015,380,360,401,413,33,12,53,11,3.2249735070165374e-4,0.45441287396631236,0.8875322803733217,0.3255007541193985,465,440,489,546,81,57,106,37,0.4686431919784194,1.135097480740261,1.7212483817671196,0.44965060932934015,47895,47466,Essex+Franklin,Franklin,36,33,New York,NY
36035,36CS016,514,491,537,565,51,28,74,48,-0.36627781233365925,0.051998876156974495,0.4704934955925836,0.9199554388240403,630,602,657,803,173,146,201,117,0.6608214900936961,1.2877954414401063,1.8953223397666885,0.6720270092683805,53181,53122,Fulton+Hamilton,Fulton,36,35,New York,NY
36041,36CS016,57,56,57,64,7,7,8,2,0.9051844449269204,1.0019357197004535,1.0980375932728195,0.24962929639834697,72,71,72,79,7,7,8,4,0.6146586404438567,0.7585258740068237,0.9062810964304715,0.48584314774349624,4989,5113,Fulton+Hamilton,Hamilton,36,41,New York,NY
36037,36CS017,539,514,564,607,68,43,93,57,-0.2492362089894668,0.16997966818685697,0.6017926618978923,0.8301191161024659,661,631,691,734,73,43,103,121,-1.6246101790487237,-0.9926891306054983,-0.3856996796006398,1.627349339287744,58093,57912,Genesee+Orleans,Genesee,36,37,New York,NY
36073,36CS017,356,339,373,418,62,45,79,49,-0.07059114706594219,0.32520271018650676,0.7283518515329916,0.7785021294319522,438,417,459,487,49,28,70,52,-0.689574337204478,-0.08442098100758058,0.49183600296994556,1.0369370069155135,40248,40198,Genesee+Orleans,Orleans,36,73,New York,NY
36043,36CS018,559,533,585,609,50,24,76,35,-0.17704320390269618,0.2434813762294356,0.6736303549274036,0.6826237137955949,680,649,711,834,154,123,185,139,-0.3193592829921569,0.3036646477091032,0.9233679488395088,0.8966547818413675,60196,59947,Herkimer,Herkimer,36,43,New York,NY
36045,36CS019,814,765,864,793,-21,-71,28,13,-0.7415221280260278,-0.2882091686878996,0.10815344295335046,-0.638161546749036,1015,955,1075,1081,66,6,126,119,-1.146620944116627,-0.5365071338077613,0.0733989730838325,1.7849139754372847,115277,116272,Jefferson+Lewis,Jefferson,36,45,New York,NY
36049,36CS019,223,211,234,205,-18,-29,-6,6,-1.3174972295273188,-0.8948076408686648,-0.4854346291432799,-0.3583498228913751,275,261,289,304,29,15,43,40,-1.1224303428506646,-0.49521976992184813,0.04770197023610201,1.3427290087424386,26511,26568,Jefferson+Lewis,Lewis,36,49,New York,NY
36047,36CS020,14153,12990,15315,22012,7859,6697,9022,6645,0.03522249886118933,0.4439045472754984,0.8997667997615554,0.8453693772327548,17265,15895,18636,18745,1480,109,2850,2754,-1.2139200165137658,-0.559503343852222,0.00845354068792378,1.8601645341298363,2694327,2653643,Kings,Kings,36,47,New York,NY
36051,36CS021,482,456,509,482,-0,-27,26,33,-0.9546681303761159,-0.5483881279742667,-0.10799524192269128,54.51173341593124,593,561,625,678,85,53,117,74,-0.42299560229948263,0.18159112106483447,0.8106472034966611,0.8632270608810506,61861,61596,Livingston,Livingston,36,51,New York,NY
36053,36CS022,486,457,516,612,126,96,155,70,0.35623869545830045,0.7980708775988085,1.2323552520416095,0.5521236112173189,594,559,629,716,122,87,157,71,0.2731506645592408,0.8979795528876289,1.4924811147502473,0.5785769855742293,68301,67692,Madison,Madison,36,53,New York,NY
36055,36CS023,5834,5508,6159,6541,707,382,1033,654,-0.38530000591204894,0.05611564803098262,0.5055518190295285,0.9236057348761404,7167,6777,7557,8101,934,544,1324,896,-0.5405388228842578,0.04793396824955952,0.6730452322553805,0.9586456723304013,755875,755655,Monroe,Monroe,36,55,New York,NY
36057,36CS024,492,471,513,560,68,47,89,33,0.2655638715800199,0.7135204028115583,1.153805680081767,0.4782347371893935,601,576,627,737,136,110,161,116,-0.15843111736877863,0.466739190351659,1.087424025172349,0.8495686252859121,49435,49540,Montgomery,Montgomery,36,57,New York,NY
36059,36CS025,9511,8913,10109,12307,2796,2198,3394,2756,-0.36727930873841425,0.041874266860138544,0.4701087327030058,0.985298713790878,11722,11003,12440,12164,442,-276,1161,1300,-1.353452224879139,-0.7553211114155599,-0.13166979171266913,2.9329802941468475,1388130,1391355,Nassau,Nassau,36,59,New York,NY
36061,36CS026,8712,7994,9429,12306,3594,2877,4312,2787,0.05448400078251658,0.4829512560121989,0.8830193316266858,0.7751702402863231,10331,9508,11153,11300,969,147,1792,1124,-0.7355084863985927,-0.12255880025771149,0.5098418609988205,1.1585051105702313,1668181,1593057,New York (county),New York (county),36,61,New York,NY
36063,36CS027,2043,1952,2134,2390,347,256,438,234,0.09413905611605126,0.5421572354406875,0.9541794071129177,0.6727436967251688,2498,2389,2607,2967,469,360,578,372,-0.025390947865469384,0.5449831461382939,1.170486158228632,0.7912379945421525,211797,211740,Niagara,Niagara,36,63,New York,NY
36065,36CS028,2204,2104,2303,2455,251,152,351,246,-0.3913371889466289,0.02614844873069807,0.43576732331913787,0.9749552377748513,2691,2572,2810,3040,349,230,468,471,-1.2235899007507895,-0.6394938686556527,-0.005585162705077162,1.344847367716222,231043,230481,Oneida,Oneida,36,65,New York,NY
36067,36CS029,3786,3582,3990,4339,553,349,757,474,-0.2716862210550518,0.16999007329070906,0.6008092535485401,0.8556774907399339,4643,4399,4888,5172,529,284,773,514,-0.5570450137260281,0.045725875182273244,0.6591506855268519,0.9699178146392956,473245,473588,Onondaga,Onondaga,36,67,New York,NY
36069,36CS030,944,896,993,935,-9,-58,39,74,-1.207180945603692,-0.7506543546084525,-0.31368052070320346,-8.794035090078056,1161,1103,1219,1193,32,-26,90,103,-1.3538482743442979,-0.7570827554489254,-0.13973606449796724,3.136760291214994,112115,112503,Ontario,Ontario,36,69,New York,NY
36071,36CS031,2455,2283,2627,3006,551,379,723,594,-0.5369308850659799,-0.12021014300313272,0.3183178640135112,1.0759638924776505,3060,2851,3269,3163,103,-106,312,393,-1.4873957050240134,-0.8660414682989522,-0.239154220165439,3.7803688034478213,399268,404058,Orange,Orange,36,71,New York,NY
36075,36CS032,932,882,983,981,49,-2,99,48,-0.4225138329110165,0.015228223284449368,0.4426003522952831,0.9657047202317164,1149,1088,1210,1328,179,118,240,138,-0.21892858006481072,0.41632430208794463,0.9921483387271172,0.7666837967822387,117294,117382,Oswego,Oswego,36,75,New York,NY
36077,36CS033,515,490,540,571,56,31,81,19,0.23727416006177618,0.634340077838362,1.031381214461579,0.3329525321654718,630,600,660,735,105,75,135,85,-0.2550037397228746,0.4058605042058716,0.9919270543987517,0.8046538416222064,58472,58156,Otsego,Otsego,36,77,New York,NY
36079,36CS034,601,559,643,777,176,134,218,116,0.16140489187784687,0.6259912663986335,1.0557711517566621,0.6541378027082237,742,691,792,753,11,-39,62,53,-1.0978412885098412,-0.5101497749258608,0.1969696618858501,4.397470740005732,97813,97896,Putnam,Putnam,36,79,New York,NY
36081,36CS035,12854,11833,13876,20419,7565,6543,8586,6559,0.013383932608862805,0.42052277301578145,0.8484246130026222,0.8669614428708055,15723,14514,16931,17198,1475,267,2684,2511,-1.1390472058316925,-0.5612329173136649,0.0951390354560678,1.7010443264773136,2368371,2340571,Queens,Queens,36,81,New York,NY
36083,36CS036,1267,1198,1336,1393,126,57,195,78,-0.12585110802253668,0.3062322205036293,0.7814571737658905,0.6130510334917827,1552,1470,1635,1786,234,151,316,167,-0.12114619698057227,0.5149478380318305,1.0999019210092884,0.7117837448059123,160568,160333,Rensselaer,Rensselaer,36,83,New York,NY
36085,36CS037,3289,3077,3501,4420,1131,919,1343,1125,-0.39415186615662345,0.01421422544632793,0.44015343541424634,0.993791329090319,4058,3803,4313,4367,309,54,564,594,-1.3157743404112303,-0.6874370659242874,-0.08897481362871082,1.9174812615064867,492484,493790,Richmond,Richmond,36,85,New York,NY
36087,36CS038,1979,1833,2124,2791,812,667,958,819,-0.46058416224186877,-0.02644581676728164,0.4160109760237936,1.0067682031709724,2464,2289,2639,2476,12,-163,187,273,-1.5330628587653576,-0.9254564434843339,-0.33897415445457446,20.46793247555161,336520,339066,Rockland,Rockland,36,87,New York,NY
36089,36CS039,855,809,902,939,84,37,130,47,-0.10512553136936703,0.33372609459253877,0.7585404690830776,0.5552004095567548,1054,998,1110,1261,207,151,263,139,0.12587123948522597,0.7290909356516165,1.3707746802634448,0.6681932599209106,108204,108089,St. Lawrence,St. Lawrence,36,89,New York,NY
36091,36CS040,1671,1570,1772,1689,18,-83,119,64,-0.6105043709013784,-0.19680054093902297,0.22861955852056393,3.386131215085904,2074,1952,2196,2364,290,168,412,252,-0.41482991044686074,0.19930127084206883,0.8429059941094096,0.8661485832177477,234980,237115,Saratoga,Saratoga,36,91,New York,NY
36093,36CS041,1341,1274,1409,1453,112,44,179,88,-0.2941058982904693,0.14919150752202817,0.6022628217112013,0.7809638751777772,1648,1566,1729,1851,203,122,285,188,-0.5338166837505738,0.13435419932726286,0.7323423531674766,0.9197933581912755,157547,158056,Schenectady,Schenectady,36,93,New York,NY
36097,36CS042,176,169,184,192,16,8,23,11,-0.15998012060271743,0.2598374860440637,0.6895055831924073,0.6567384597016344,215,206,224,259,44,35,53,17,1.1496128084149246,1.7864382396860363,2.3957550629304945,0.3802695744211763,17840,17767,Schuyler+Seneca+Yates,Schuyler,36,97,New York,NY
36099,36CS042,310,295,324,324,14,-0,29,30,-0.8851969397833107,-0.4674749068932416,-0.03600945578607033,1.982463316834648,380,363,397,410,30,13,47,52,-1.4199939492366884,-0.7777614534559216,-0.1774696221834188,1.6769756557213886,33781,33692,Schuyler+Seneca+Yates,Seneca,36,99,New York,NY
36123,36CS042,231,221,242,256,25,14,35,16,-0.09335658655884078,0.34834374533306867,0.7600504236509964,0.6244661622699695,283,270,296,279,-4,-17,9,25,-2.051861401508402,-1.3951316521796056,-0.8571037403287178,-7.98277705003333,24727,24627,Schuyler+Seneca+Yates,Yates,36,123,New York,NY
36103,36CS043,10827,10173,11481,13547,2720,2066,3374,2805,-0.4666452995764496,-0.06252158837253459,0.364113884799877,1.0309221164399707,13397,12609,14185,14310,913,125,1701,1770,-1.2715598259723258,-0.6776037845729858,-0.0354560880884343,1.9366896777399625,1517657,1526017,Suffolk,Suffolk,36,103,New York,NY
36105,36CS044,648,614,681,739,91,58,125,63,-0.08293997514398377,0.3506787860849162,0.8017279886858971,0.6820095549298898,807,766,848,875,68,27,109,81,-0.8024709067956988,-0.19787147936648636,0.3978378262731319,1.1703442691982402,78313,79636,Sullivan,Sullivan,36,105,New York,NY
36107,36CS045,403,382,423,492,89,69,110,57,0.2243670639595338,0.6716181856514637,1.0902297635680285,0.6309840627396948,492,467,517,559,67,42,92,59,-0.4191090622396226,0.19039733486234017,0.7944715607609285,0.8693988447854868,48296,48035,Tioga,Tioga,36,107,New York,NY
36109,36CS046,612,567,657,584,-28,-73,17,22,-0.926172009858303,-0.46356550540110186,-0.030306068184877296,-0.8186789252032499,758,704,813,759,1,-54,55,54,-1.2165352080100127,-0.6059499619929166,-0.01486679175635549,32.99126514463329,104878,105197,Tompkins,Tompkins,36,109,New York,NY
36111,36CS047,1504,1426,1582,1664,160,82,238,149,-0.3363308397711083,0.060225367963620685,0.47324723795540846,0.9267819801344294,1858,1764,1953,2042,184,89,278,209,-0.7825909209645852,-0.1817264110052966,0.4318570624418454,1.131502286634244,181271,182767,Ulster,Ulster,36,111,New York,NY
36113,36CS048,632,604,660,671,39,11,67,37,-0.37193130004151914,0.034451807840720175,0.47142541416475636,0.929363307997121,776,742,810,883,107,73,141,71,-0.009993992347397286,0.6452251811975674,1.3236626638720788,0.658427513601754,65394,65621,Warren,Warren,36,113,New York,NY
36115,36CS049,552,526,578,627,75,49,101,16,0.5575465055992318,0.9711657495590567,1.3720597793780924,0.2102503708866507,678,647,710,781,103,71,134,91,-0.3607656380162552,0.24270053205422945,0.8488237719116645,0.8754819462750524,61127,60983,Washington,Washington,36,115,New York,NY
36117,36CS050,768,729,807,832,64,25,103,50,-0.2645768313868916,0.15027108179235765,0.5968194702308157,0.7655733559680684,943,896,990,1039,96,49,143,106,-0.7784433826311792,-0.12503653383077493,0.4560705086193878,1.0925627142310435,90897,90949,Wayne,Wayne,36,117,New York,NY
36119,36CS051,6302,5872,6732,8319,2017,1587,2447,1926,-0.3266819041032576,0.08151017945713285,0.5074318671884023,0.954542360927597,7779,7263,8294,8014,235,-280,751,930,-1.462883254874668,-0.8602450985588896,-0.17979102111461379,3.9376827766761306,997616,998675,Westchester,Westchester,36,119,New York,NY
37001,37CS001,1520,1446,1594,1726,206,132,280,149,-0.08852830628893923,0.34147962847769403,0.7627857865519296,0.7184244255100696,1880,1791,1970,1881,1,-89,90,173,-1.8462735857743655,-1.1870571118374895,-0.5921774437344777,97.89307417081795,171665,173580,Alamance,Alamance,37,1,North Carolina,NC
37003,37CS002,335,319,351,440,105,89,121,44,1.1812654072539124,1.6678246698621544,2.101067361582824,0.4154992205568789,410,391,429,586,176,157,195,97,1.9534674762189654,2.5806312447575226,3.1393844670277415,0.5492441736386618,36596,36613,Alexander+Catawba,Alexander,37,3,North Carolina,NC
37035,37CS002,1454,1385,1524,1706,252,182,321,174,0.06030707849030179,0.47425880962254474,0.9239801833446334,0.6888647868830207,1787,1704,1871,2029,242,158,325,320,-1.1720793317402027,-0.5766737354697764,0.03045098194050462,1.3185689102226004,160647,161581,Alexander+Catawba,Catawba,37,35,North Carolina,NC
37005,37CS003,121,120,123,129,8,6,9,4,0.2196499086777025,0.32452213862176105,0.4200209994618826,0.46692790293362707,150,149,152,160,10,8,11,14,-0.6131133604598894,-0.47057693994000815,-0.3147686169151231,1.3038144546174435,10949,11027,Alleghany+Ashe+Avery+Watauga,Alleghany,37,5,North Carolina,NC
37009,37CS003,289,277,300,343,54,43,66,34,0.33898511491938715,0.7459286407643243,1.163074015842785,0.6160089892084951,355,341,368,412,57,44,71,57,-0.6334881319814729,0.0018049518471961994,0.6409214976456267,0.9773533690632611,26678,26690,Alleghany+Ashe+Avery+Watauga,Ashe,37,9,North Carolina,NC
37011,37CS003,187,180,195,187,-0,-8,7,19,-1.5055971915064772,-1.0875137228909248,-0.6140791339559502,23.383595131083183,231,221,240,239,8,-1,18,32,-2.1611769060388633,-1.5797902588071457,-0.9617748459352599,3.3913945591313994,17761,17854,Alleghany+Ashe+Avery+Watauga,Avery,37,11,North Carolina,NC
37189,37CS003,308,284,331,361,53,30,77,24,0.10412948476250884,0.5418079132524561,0.9774599013321692,0.4420222604950799,384,356,412,422,38,10,66,39,-0.6450652015726027,-0.007004756469458227,0.6036900818943921,0.9988768994869762,54410,54210,Alleghany+Ashe+Avery+Watauga,Watauga,37,189,North Carolina,NC
37007,37CS004,239,229,248,286,47,38,57,34,0.1577357136746187,0.588496998054742,1.0115617616585186,0.7068796628912632,290,278,301,384,94,83,106,73,0.5667483113214804,1.1679582161733977,1.7827166194445574,0.7649798553785672,22253,22056,Anson+Richmond,Anson,37,7,North Carolina,NC
37153,37CS004,460,442,479,575,115,96,133,57,0.9427352220650971,1.3449869083540245,1.8087682525672328,0.4915158782833984,557,535,579,694,137,115,159,104,0.28703656883184414,0.954117409593632,1.562256271809936,0.7526503999843456,43138,42747,Anson+Richmond,Richmond,37,153,North Carolina,NC
37013,37CS005,489,470,508,571,82,63,101,65,-0.039551739270420126,0.3674132970236985,0.8165747628166082,0.7814497769781741,593,570,615,602,9,-13,32,80,-2.5283893272996516,-1.9059316878286179,-1.2669082926827029,7.631728992645777,44964,44490,Beaufort+Martin+Pamlico,Beaufort,37,13,North Carolina,NC
37117,37CS005,254,244,263,341,87,78,97,30,2.1726444954617374,2.6021125412584367,3.015714768399043,0.34039259583137466,307,296,318,345,38,27,49,54,-1.513056370380886,-0.8606015101099309,-0.31485097632974807,1.3861831309869266,22002,21782,Beaufort+Martin+Pamlico,Martin,37,117,North Carolina,NC
37137,37CS005,149,144,154,152,3,-2,8,1,-0.2782969802107222,0.15195111215694027,0.5916769017095272,0.25666834103953484,182,176,188,187,5,-1,11,21,-2.181035423028025,-1.574214379026015,-0.9578632639039014,3.4671799341027225,12341,12335,Beaufort+Martin+Pamlico,Pamlico,37,137,North Carolina,NC
37017,37CS006,320,307,333,421,101,88,114,27,2.0457214169437568,2.4719487174542043,2.8996848542751037,0.2638417352763946,387,372,402,518,131,116,146,87,1.1872550217090807,1.7871947580330652,2.3970648923138302,0.6588301801340745,30067,29536,Bladen+Columbus,Bladen,37,17,North Carolina,NC
37047,37CS006,549,528,571,753,204,182,225,85,1.9259793271598293,2.321476763579986,2.7556674048203518,0.4155478333372791,663,637,689,836,173,147,199,154,-0.15768485079634761,0.4741837753767135,1.0958233446934142,0.8847102441923382,51183,50152,Bladen+Columbus,Columbus,37,47,North Carolina,NC
37019,37CS007,1325,1265,1385,1530,205,145,265,84,0.4528684996525431,0.8602022539552852,1.3111918991954343,0.4074618082168046,1669,1595,1743,1926,257,183,331,203,-0.16436744890809288,0.4272224518226247,1.0323486375028395,0.7872087584274416,139438,143321,Brunswick,Brunswick,37,19,North Carolina,NC
37021,37CS008,2394,2279,2510,2542,148,32,263,158,-0.4756526361420133,-0.030058711973088324,0.3687766430063797,1.0635012426439068,2968,2828,3108,3016,48,-92,188,264,-1.5941072091581168,-0.9520841493431065,-0.3580898721252174,5.431723416456645,268716,271255,Buncombe+Madison,Buncombe,37,21,North Carolina,NC
37115,37CS008,221,212,231,239,18,8,27,14,-0.25748160828023214,0.15205808791101944,0.5994927778373758,0.7535484798951508,274,263,285,282,8,-3,19,40,-2.4120922707475816,-1.7733886940631745,-1.1653884737634168,4.301410884148425,21302,21459,Buncombe+Madison,Madison,37,115,North Carolina,NC
37023,37CS009,859,821,897,1016,157,119,195,85,0.39283345376371853,0.8354305444798023,1.255894985486502,0.5377578233582695,1049,1003,1094,1194,145,100,191,178,-1.0682593227634445,-0.43857914617280563,0.15211562821343233,1.2154089638767125,87972,87602,Burke,Burke,37,23,North Carolina,NC
37025,37CS010,1467,1369,1564,1580,113,16,211,127,-0.49842496117983603,-0.05769155366937186,0.32547503804305916,1.1116988206303298,1835,1716,1954,1870,35,-84,154,272,-1.8486235027223215,-1.2316840005721585,-0.5980349816482291,7.499821223233866,225940,230664,Cabarrus,Cabarrus,37,25,North Carolina,NC
37027,37CS011,820,785,855,976,156,121,191,108,0.14621592187143595,0.5871944858555936,1.0346973025733206,0.6877484412461039,1002,961,1044,1152,150,108,191,173,-0.9534061195881334,-0.3477637520289893,0.2704121953391445,1.1480881085655674,80764,80470,Caldwell,Caldwell,37,27,North Carolina,NC
37029,37CS012,77,76,78,95,18,17,19,6,1.062925677241924,1.1629394848891865,1.2574645924605896,0.31269436922399335,97,95,98,105,8,7,10,10,-0.3488455795230381,-0.19863788558636028,-0.04857961990048946,1.0838456130819,10498,10771,Camden+Currituck+Pasquotank,Camden,37,29,North Carolina,NC
37053,37CS012,207,194,219,262,55,43,68,13,1.0743928761305273,1.490550746387187,1.891835234590828,0.23112387913543175,262,247,277,301,39,24,54,27,-0.06522935523418905,0.4864154286351643,1.0810651677647423,0.6724680700963548,28449,29468,Camden+Currituck+Pasquotank,Currituck,37,53,North Carolina,NC
37139,37CS012,371,354,389,442,71,53,88,41,0.33009485525395793,0.715855018494188,1.1607479315092069,0.5703616917584386,455,434,476,531,76,55,97,56,-0.024991596002892923,0.5830320847838514,1.239512791086154,0.7265942846886517,40565,40795,Camden+Currituck+Pasquotank,Pasquotank,37,139,North Carolina,NC
37031,37CS013,710,681,739,754,44,15,73,31,-0.20337539756909406,0.19840248952654882,0.6255414614802056,0.6910016397807164,878,842,913,973,95,60,131,79,-0.31573439166448897,0.2948126660739759,0.8854851174385692,0.8213114984531809,68019,68412,Carteret,Carteret,37,31,North Carolina,NC
37033,37CS014,238,229,248,279,41,31,50,16,0.6783254436124786,1.0920324391847496,1.508313241900739,0.3841233491335967,293,281,305,347,54,42,66,44,-0.09774007424459666,0.5127308788509961,1.1039885859363705,0.8000890178623111,22681,22711,Caswell+Person,Caswell,37,33,North Carolina,NC
37145,37CS014,385,368,402,449,64,47,81,26,0.5334444472383778,0.9683609718921018,1.3786405661295298,0.40009443569205355,473,453,493,515,42,22,62,76,-1.608688040212733,-1.0325623582027335,-0.4433178745691338,1.7640240145860193,39213,39130,Caswell+Person,Person,37,145,North Carolina,NC
37037,37CS015,647,614,680,727,80,47,113,51,-0.08227354361922018,0.37277998453110295,0.7958757035331376,0.6268878279923465,806,766,846,795,-11,-51,29,55,-1.6692129125596953,-1.0013769657207443,-0.3715734976734728,-5.389236118730217,76424,77703,Chatham,Chatham,37,37,North Carolina,NC
37039,37CS016,346,334,358,351,5,-7,17,28,-1.238994701391667,-0.7933953381332223,-0.36125034391279115,4.6229154619742365,430,415,445,531,101,86,116,94,-0.36447978655859425,0.28231714465149504,0.9026672574769528,0.924271298311569,28850,29118,Cherokee+Clay+Graham+Swain,Cherokee,37,39,North Carolina,NC
37043,37CS016,136,134,137,111,-25,-26,-23,5,-2.7473745932622284,-2.6401354850340337,-2.5388600309208287,-0.21268980039707722,169,167,170,184,15,14,17,42,-2.973311184261522,-2.8323620711189057,-2.695662427909413,2.568290787137922,11161,11281,Cherokee+Clay+Graham+Swain,Clay,37,43,North Carolina,NC
37075,37CS016,86,85,87,113,27,26,28,10,1.9771123521345941,2.072648479503532,2.16800966248922,0.36029548218099355,106,105,107,110,4,3,5,15,-1.7506663586761855,-1.606338363691761,-1.4528468579396396,2.866717688434798,8085,8039,Cherokee+Clay+Graham+Swain,Graham,37,75,North Carolina,NC
37173,37CS016,173,167,179,211,38,32,44,10,1.5548729417591498,1.9964983950026112,2.3873829819923933,0.25612001958723035,213,206,221,242,29,21,36,30,-0.7465057206018335,-0.11388394021372183,0.48799410763714596,1.0143623174018597,14122,14128,Cherokee+Clay+Graham+Swain,Swain,37,173,North Carolina,NC
37045,37CS017,1069,1026,1112,1263,194,151,237,162,-0.09179967525525823,0.32430991672513226,0.7908592726959474,0.8299726116529224,1314,1262,1366,1316,2,-50,54,218,-3.1990209491948334,-2.5929475860538322,-1.942778429335015,70.0262845028039,99534,100267,Cleveland,Cleveland,37,45,North Carolina,NC
37049,37CS018,928,885,971,1121,193,150,236,102,0.47297870987283425,0.90330700731363045,1.3162990109073,0.5253166395972,1137,1085,1189,1114,-23,-75,29,108,-2.158945362152979,-1.5465402121995768,-0.9620997969676338,-4.957736311140876,100780,100656,Craven,Craven,37,49,North Carolina,NC
37051,37CS019,2225,2081,2369,2594,369,225,513,148,0.23925980930190785,0.6382640797129474,1.0819513980589825,0.39973827925143446,2754,2581,2927,3245,491,318,664,444,-0.4620650967203904,0.1842486494114228,0.8072762400950982,0.9029408692220185,334803,335342,Cumberland,Cumberland,37,51,North Carolina,NC
37055,37CS020,314,298,330,324,10,-6,26,5,-0.269482377342131,0.14994439223275077,0.5725355994226401,0.455170699028797,394,375,414,393,-1,-21,18,26,-1.4481570777568846,-0.869983267129196,-0.25508775825195384,-540.5504621790518,37097,37706,Dare+Hyde+Tyrrell+Washington,Dare,37,55,North Carolina,NC
37095,37CS020,49,49,50,49,-0,-1,-0,4,-1.0776358034482862,-0.9744366668510598,-0.8739358435354578,7.579699598205576,60,59,60,47,-13,-13,-12,4,-4.586104028298197,-4.4279661036898945,-4.280644265242105,-0.3436084233144293,4601,4514,Dare+Hyde+Tyrrell+Washington,Hyde,37,95,North Carolina,NC
37177,37CS020,32,32,32,39,7,7,7,2,1.3666222019564385,1.4613691257907615,1.5648450908223717,0.2547859187623404,39,38,39,47,8,8,9,5,1.0453604343625376,1.201147700211519,1.3542255509196812,0.5395534698803751,3319,3251,Dare+Hyde+Tyrrell+Washington,Tyrrell,37,177,North Carolina,NC
37187,37CS020,134,129,139,167,33,28,38,12,1.4928178122647715,1.879881896145158,2.295058499963416,0.35483978850290054,163,157,168,197,34,29,40,33,-0.47119743463853053,0.1411505083259982,0.7502770384716703,0.9364990028651007,11048,10901,Dare+Hyde+Tyrrell+Washington,Washington,37,187,North Carolina,NC
37057,37CS021,1583,1510,1655,1849,266,194,339,137,0.341221060787098,0.7797062085659614,1.1763677965148591,0.5123637211348728,1951,1863,2039,2256,305,217,393,349,-0.892257827846456,-0.30638273741109817,0.3094601412868043,1.140037246145,169158,170417,Davidson,Davidson,37,57,North Carolina,NC
37059,37CS022,411,393,429,438,27,9,45,34,-0.5893212914785769,-0.16720846507202844,0.30456625910773494,1.2136754138620014,508,486,531,548,40,17,62,84,-1.8350907290844596,-1.2410555174139166,-0.60443559806132,2.0729608653465768,42866,43427,Davie+Yadkin,Davie,37,59,North Carolina,NC
37197,37CS022,373,357,389,433,60,44,76,40,0.12034753554816678,0.5440202836211355,0.9564855979991028,0.6558379514041877,455,436,474,472,17,-2,36,66,-2.2156509937809346,-1.5851129408343236,-0.9969577351562631,3.6867430326024504,37246,37191,Davie+Yadkin,Yadkin,37,197,North Carolina,NC
37061,37CS023,390,369,411,596,206,185,227,74,2.2137937793762488,2.6349670788124864,3.0525995554151697,0.3575847187339354,469,444,494,678,209,184,234,107,1.8778191595576117,2.5250997229181027,3.1269840930616795,0.509321763818726,50135,48538,Duplin,Duplin,37,61,North Carolina,NC
37063,37CS024,1829,1689,1969,2037,208,68,348,138,-0.20026172076585796,0.22001114285427867,0.6327751774976867,0.6607331532816131,2270,2102,2439,1984,-286,-455,-118,133,-2.1763782007066137,-1.533474656855081,-0.9336761115303108,-0.46622320993550875,325273,326050,Durham,Durham,37,63,North Carolina,NC
37065,37CS025,546,525,567,680,134,113,155,85,0.5650290845854834,1.0064441764711203,1.4203504856881752,0.6274061934099139,663,638,688,629,-34,-59,-9,61,-2.976101656482481,-2.355200514794907,-1.7434722736889297,-1.8523625189440591,49060,48408,Edgecombe,Edgecombe,37,65,North Carolina,NC
37067,37CS026,2987,2822,3152,3325,338,173,503,244,-0.21288755013265756,0.21625698119566464,0.6913709836696412,0.7201074631157874,3693,3494,3892,3903,210,11,409,409,-1.1847091019484421,-0.640326777212303,0.03320363044508327,1.940254323893607,382934,385116,Forsyth+Stokes,Forsyth,37,67,North Carolina,NC
37169,37CS026,469,450,488,554,85,66,104,35,0.6858348744337202,1.122835824932124,1.5407040406401133,0.40824061569140063,573,550,596,637,64,41,87,76,-0.9263798122213739,-0.32250654762042397,0.2910641499587467,1.1617355521664088,44684,44548,Forsyth+Stokes,Stokes,37,169,North Carolina,NC
37069,37CS027,544,515,574,593,49,19,78,43,-0.2956791809999136,0.08856507486410442,0.514292188812196,0.8666598281798025,688,651,725,686,-2,-39,35,73,-1.8588627870976049,-1.2602312891282021,-0.6429906130057935,-106.52545466438674,69440,71318,Franklin+Warren,Franklin,37,69,North Carolina,NC
37185,37CS027,205,197,214,262,57,48,65,14,1.866839590602631,2.254608802324195,2.7191078370100294,0.2433720149316342,251,242,261,275,24,14,33,29,-0.930153459202651,-0.3434015739370018,0.2843876490527098,1.1789674663832967,18775,18738,Franklin+Warren,Warren,37,185,North Carolina,NC
37071,37CS028,2085,1987,2183,2346,261,163,359,226,-0.27213225854396134,0.15773759414110267,0.5799519481292702,0.8633730784899635,2580,2461,2699,2769,189,70,308,452,-2.003999842726827,-1.385424488085217,-0.8112385219970212,2.3781803932932695,228011,230479,Gaston,Gaston,37,71,North Carolina,NC
37015,37CS029,200,192,207,261,61,54,69,38,0.8660631772048569,1.2752191760938665,1.6974695146416867,0.610850626494591,242,233,251,275,33,24,42,28,-0.22182923881050906,0.3718799685489144,0.9580305309671295,0.8136811817424865,17977,17555,Gates and Nearby Counties,Bertie,37,15,North Carolina,NC
37041,37CS029,167,161,173,194,27,21,33,22,-0.0687796146987305,0.37914752692272014,0.7604709141422283,0.7873297391007912,206,199,213,222,16,9,23,21,-1.0364681875227146,-0.4142771598846626,0.21240201765437622,1.2201340526952178,13708,13714,Gates and Nearby Counties,Chowan,37,41,North Carolina,NC
37073,37CS029,105,104,106,126,21,20,22,18,0.14557608857844848,0.25464748925838504,0.3487834078712035,0.8311429998557465,127,126,128,155,28,27,29,19,0.8785531147536642,1.0329626958878344,1.1706400907363483,0.6569797966464069,10601,10379,Gates and Nearby Counties,Gates,37,73,North Carolina,NC
37091,37CS029,215,206,224,315,100,91,109,47,2.006251938789147,2.4390303978582577,2.8569010895325366,0.4652233101989579,262,251,273,267,5,-6,16,30,-2.0073783421120592,-1.3974117680233917,-0.6951967727905696,5.065087394500622,21752,21303,Gates and Nearby Counties,Hertford,37,91,North Carolina,NC
37143,37CS029,151,145,156,182,31,26,37,15,0.7680058146595347,1.2598814596772645,1.647840578186896,0.4664028886281645,186,180,193,188,2,-5,8,26,-2.8573979217329906,-2.237124528924178,-1.634566670977478,10.283089912399086,13096,13111,Gates and Nearby Counties,Perquimans,37,143,North Carolina,NC
37077,37CS030,483,457,510,594,111,84,137,48,0.6130364976024946,1.0274722987391918,1.4202818838697933,0.4303916768653306,601,569,633,613,12,-20,44,67,-1.7274443356969202,-1.051280062575881,-0.48946967516987516,5.230231251852466,61040,61848,Granville+Vance,Granville,37,77,North Carolina,NC
37181,37CS030,430,411,448,566,136,118,155,71,1.0940858060269394,1.5179785449658638,1.9670120885382754,0.5173285365833544,520,498,542,596,76,54,98,60,-0.15254921647274225,0.4505371695877421,1.090151432622644,0.7799242550931499,42805,42235,Granville+Vance,Vance,37,181,North Carolina,NC
37079,37CS031,173,164,182,206,33,24,42,26,-0.07398073536413965,0.33973435982119693,0.7623167410053152,0.7649513847839676,212,202,223,229,17,6,27,21,-0.9093833893827035,-0.29080442490791897,0.3496082407989132,1.1998615106234451,20510,20421,Greene+Jones+Lenoir,Greene,37,79,North Carolina,NC
37103,37CS031,98,97,99,135,37,36,38,17,2.084187884155037,2.1816446544764885,2.279056785166187,0.44710401688938556,121,120,122,149,28,27,29,16,1.4322196361989274,1.5793387916849713,1.7243130489322471,0.5486297988019816,9193,9241,Greene+Jones+Lenoir,Jones,37,103,North Carolina,NC
37107,37CS031,607,584,631,733,126,102,149,78,0.43420473702087825,0.8740918572030754,1.3150448981132388,0.6161120845152929,740,711,768,801,61,33,90,111,-1.7059729981826972,-1.0868869446429854,-0.48330769235751775,1.7794508665900486,55122,54748,Greene+Jones+Lenoir,Lenoir,37,107,North Carolina,NC
37081,37CS032,3938,3705,4171,4378,440,207,673,346,-0.28977963850804084,0.17195834184583075,0.6093933354711775,0.7847072237548032,4862,4583,5142,5634,772,492,1051,547,-0.10674408682736533,0.5131303804488073,1.0782131363430378,0.7080750119853888,540951,542255,Guilford,Guilford,37,81,North Carolina,NC
37083,37CS033,541,520,562,696,155,134,176,53,1.651354875846979,2.1079941886988274,2.516334627018039,0.3403873704872972,659,634,683,761,102,78,127,92,-0.3512274457039699,0.27806248409242285,0.8990740194716402,0.889014481007294,48702,48305,Halifax+Northampton,Halifax,37,83,North Carolina,NC
37131,37CS033,202,194,209,305,103,96,111,43,3.006044089525855,3.4245383718407956,3.8354246812949846,0.41162617461588147,241,232,250,307,66,57,75,45,0.8634410002095746,1.4541722695177561,2.0970831160975614,0.6711513070115263,17706,17174,Halifax+Northampton,Northampton,37,131,North Carolina,NC
37085,37CS034,878,820,935,1068,190,133,248,97,0.2575846816406899,0.690975729903245,1.1141383513567895,0.5069966545066311,1094,1024,1164,1265,171,101,241,187,-0.8199231315640101,-0.15576619266933742,0.5111574452906442,1.087441865453727,134342,135644,Harnett,Harnett,37,85,North Carolina,NC
37087,37CS035,696,669,722,806,110,84,137,72,0.19337737121686419,0.6070463143685771,0.9999675556586014,0.6470962127455097,853,821,886,868,15,-18,47,107,-2.417959283031831,-1.7691596278500599,-1.1539675193713659,6.813392566388805,62222,62426,Haywood,Haywood,37,87,North Carolina,NC
37089,37CS036,1215,1165,1265,1298,83,33,133,98,-0.5475664472375283,-0.13957965163027097,0.2822529797239919,1.1712448385463714,1485,1425,1545,1520,35,-25,95,149,-1.769313294462433,-1.1666948721561305,-0.6110161046306439,4.146419968796953,116653,116780,Henderson,Henderson,37,89,North Carolina,NC
37093,37CS037,297,274,319,410,113,91,136,40,0.9708959147721352,1.3969099215180167,1.7895122466868965,0.34980204018597977,373,346,400,449,76,49,103,77,-0.5805996142537921,-0.0342838027531779,0.5766075466179487,1.001134183531223,52745,52984,Hoke+Scotland,Hoke,37,93,North Carolina,NC
37165,37CS037,337,322,352,484,147,132,162,56,2.1844657087497996,2.652364041618916,3.1075971552587935,0.37815415960341103,414,396,432,532,118,100,136,78,0.8239613055044209,1.4138467745355068,1.988972591464257,0.6554420776849991,34219,34210,Hoke+Scotland,Scotland,37,165,North Carolina,NC
37097,37CS038,1422,1341,1503,1614,192,111,273,134,-0.14880348019187098,0.3039756328087473,0.7330422391394587,0.6936874432605152,1779,1681,1878,1757,-22,-121,76,302,-2.664610452120447,-2.041811901932525,-1.4509200916908715,-14.152272311360754,187241,191335,Iredell,Iredell,37,97,North Carolina,NC
37099,37CS039,339,320,357,381,42,24,61,31,-0.15950325403460455,0.2612825464629897,0.6901851587871987,0.7140695588662576,417,395,439,396,-21,-43,1,50,-2.6016089930699993,-1.9646626253097308,-1.3231312843037621,-2.4934360740255075,43251,43370,Jackson+Macon+Transylvania,Jackson,37,99,North Carolina,NC
37113,37CS039,422,406,438,463,41,25,57,16,0.2459853119850392,0.6769903687000066,1.1095256013274108,0.38182059357089504,521,502,541,577,56,36,75,90,-1.7288568861987637,-1.0821704468114477,-0.45720568795995614,1.5856453036853537,36910,37489,Jackson+Macon+Transylvania,Macon,37,113,North Carolina,NC
37175,37CS039,353,339,368,369,16,1,30,14,-0.3891931178446498,0.043566091405333345,0.4676453555514687,0.8434924571289167,431,414,448,490,59,42,76,47,-0.17244215980360053,0.40129682247423526,1.0448287977364357,0.7873853764829238,33209,33142,Jackson+Macon+Transylvania,Transylvania,37,175,North Carolina,NC
37101,37CS040,1416,1322,1509,1536,120,27,214,121,-0.45800510145284407,-0.0028285201352702236,0.39824298354512616,0.9964404153129877,1801,1685,1917,1894,93,-23,209,249,-1.5005867449950183,-0.8352003611929488,-0.2114442786685996,2.6477702039033035,217397,225207,Johnston,Johnston,37,101,North Carolina,NC
37105,37CS041,533,506,560,646,113,86,140,46,0.6083688641479499,1.0620715462486752,1.4806574150787952,0.40326822153308656,659,626,692,674,15,-18,48,85,-1.9414914707042266,-1.3119786572146634,-0.7113181020721204,5.4354279172810775,63230,64028,Lee,Lee,37,105,North Carolina,NC
37109,37CS042,733,695,770,850,117,80,155,74,0.07450659889401345,0.5035850805117302,0.9336963635495724,0.6248543470584712,915,869,962,849,-66,-113,-20,174,-3.8199767765029766,-3.219788186582459,-2.6328502570652788,-2.6579462891864365,87366,89308,Lincoln,Lincoln,37,109,North Carolina,NC
37111,37CS043,448,429,467,541,93,74,112,64,0.227552023222041,0.6647522832118465,1.0821576752775037,0.6793716386313058,551,528,574,598,47,24,70,110,-2.3275370358988585,-1.6572866457874036,-1.095208953075096,2.276599282765948,44737,44691,McDowell+Mitchell+Yancey,McDowell,37,111,North Carolina,NC
37121,37CS043,200,194,206,214,14,8,20,26,-1.2417043238762435,-0.8006088502188422,-0.3940960976013433,1.741040846026774,245,238,253,249,4,-4,11,36,-3.223925913170973,-2.6063759914094824,-2.0187127641666844,7.713714680649644,14896,14951,McDowell+Mitchell+Yancey,Mitchell,37,121,North Carolina,NC
37199,37CS043,207,199,215,234,27,19,35,19,0.00705118463590082,0.45211884506580285,0.8909014974360886,0.6728215175629393,257,247,266,288,31,22,41,50,-1.8333757410845282,-1.2052697400075112,-0.5872023137954014,1.5519725502072863,18444,18716,McDowell+Mitchell+Yancey,Yancey,37,199,North Carolina,NC
37119,37CS044,5557,5076,6038,6552,995,514,1476,611,-0.10037600993637426,0.33300567147492316,0.7722277151834062,0.6135377075891422,6926,6347,7505,7610,684,105,1263,847,-0.787434133707485,-0.16253457629970616,0.46408632213572615,1.2370845149714849,1118013,1121702,Mecklenburg,Mecklenburg,37,119,North Carolina,NC
37123,37CS045,252,241,263,314,62,51,73,38,0.48913176105211853,0.9477684837216873,1.3465874697538343,0.5997833626390144,308,294,321,384,76,63,90,65,-0.10965828244277549,0.5193045726755322,1.158834161094991,0.841947107101958,25945,25787,Montgomery+Moore,Montgomery,37,123,North Carolina,NC
37125,37CS045,1005,962,1048,1118,113,70,156,97,-0.2569498580873203,0.15256180045471257,0.5570915926928022,0.8516465686623146,1254,1201,1307,1307,53,0,106,149,-1.749554002357447,-1.11888146467369,-0.4890353785410163,2.757362366113686,100584,102385,Montgomery+Moore,Moore,37,125,North Carolina,NC
37127,37CS046,934,893,975,1058,124,83,165,115,-0.32496457770703263,0.10026315263409605,0.5058088994387463,0.9185527398126314,1147,1098,1196,1183,36,-13,85,133,-1.8069620747810444,-1.251407450671237,-0.5593154678746235,3.5831084392287647,94930,95154,Nash,Nash,37,127,North Carolina,NC
37129,37CS047,1684,1586,1781,1952,268,171,366,88,0.39098788117652383,0.8023186298362407,1.1914054493715627,0.32679847856120847,2084,1966,2202,2278,194,76,312,205,-0.6376735387066566,-0.056109023054820004,0.5651525573639693,1.0500900396769766,227566,228587,New Hanover,New Hanover,37,129,North Carolina,NC
37133,37CS048,1081,993,1169,1205,124,36,212,79,-0.21458263103566927,0.2179765744888278,0.6575798579258548,0.6317008109609671,1353,1247,1459,1527,174,68,280,220,-0.8571893004308395,-0.259451943893244,0.3850000905727669,1.2574963794956706,204601,205952,Onslow,Onslow,37,133,North Carolina,NC
37135,37CS049,717,653,781,754,37,-27,101,52,-0.5196022677056393,-0.09820326317384284,0.3542878969721283,1.355592782138838,892,816,969,887,-5,-82,71,51,-1.0690253057867063,-0.46070408466650437,0.16175865977481133,-11.42959521929144,148714,148871,Orange,Orange,37,135,North Carolina,NC
37141,37CS050,509,482,535,579,70,44,97,31,0.23056646134824804,0.6373250101013849,1.0859257306183714,0.4338744676920924,639,606,671,745,106,74,139,88,-0.26301137752978304,0.3550803633802458,0.9486956559848159,0.8190610674142021,61160,62487,Pender,Pender,37,141,North Carolina,NC
37147,37CS051,1074,1000,1148,1393,319,245,393,126,0.6593407408469636,1.111589034722052,1.5784817382282188,0.39399392669677313,1330,1241,1419,1608,278,189,367,180,0.14069826798675467,0.6806380748602313,1.3051915331409172,0.6451123565746388,172295,171936,Pitt,Pitt,37,147,North Carolina,NC
37149,37CS052,244,236,253,275,31,22,39,17,0.2945403013758994,0.714570445063193,1.121759663091036,0.5351637210887936,299,289,309,344,45,35,55,53,-1.1408350285508189,-0.47933926475025634,0.08264094442718871,1.1543527542467504,19599,19615,Polk+Rutherford,Polk,37,149,North Carolina,NC
37161,37CS052,713,685,741,889,176,148,204,115,0.5270500685891109,0.9546853217141917,1.3563239049146267,0.6493524725903592,869,836,903,1058,189,155,222,210,-0.9728118928018478,-0.4025931063235943,0.18655981309881545,1.1076385925136012,64819,64562,Polk+Rutherford,Rutherford,37,161,North Carolina,NC
37151,37CS053,1345,1283,1407,1564,219,157,281,137,0.12756011422736285,0.5656538308851495,0.9932099668222053,0.623229769572301,1658,1583,1733,1988,330,255,405,294,-0.378861127110035,0.2940294498606474,0.9252118723866003,0.8875641461022331,144299,145050,Randolph,Randolph,37,151,North Carolina,NC
37155,37CS054,1083,1032,1133,1529,446,396,497,194,1.7100742842646255,2.1426065539121106,2.5702453724533725,0.4338378625531949,1317,1257,1377,1872,555,495,615,300,2.039024553426961,2.6374470374742716,3.2542596739251466,0.5394071836319131,118411,116333,Robeson,Robeson,37,155,North Carolina,NC
37157,37CS055,998,958,1037,1204,206,167,246,104,0.6958387924615447,1.1185077832761747,1.5302325584895857,0.5015889619817909,1222,1175,1269,1475,253,206,300,167,0.5380936463977783,1.1455345231199416,1.699345024882761,0.6578208001171632,91105,91239,Rockingham,Rockingham,37,157,North Carolina,NC
37159,37CS056,1449,1386,1512,1687,238,175,301,157,0.18594987986438744,0.5645386463389993,0.969054368888834,0.6559601344989182,1785,1709,1862,2073,288,211,364,349,-1.151803473195699,-0.4866657456639827,0.08742020581941617,1.2096795493468622,146384,147986,Rowan,Rowan,37,159,North Carolina,NC
37163,37CS057,557,531,582,647,90,65,116,57,0.14420766057537995,0.556837841732207,0.9867182268853962,0.6241887575150964,677,646,707,813,136,106,167,118,-0.23253148722679132,0.3832061262643024,0.9704635153917825,0.8590052082700241,59652,58995,Sampson,Sampson,37,163,North Carolina,NC
37167,37CS058,623,596,650,718,95,68,122,74,-0.09389135818591386,0.33098971042298125,0.7588123229196088,0.7703490820933444,768,735,800,861,93,61,126,138,-1.4464855300271617,-0.8560694076326791,-0.20272989930957414,1.4630367653624974,62699,63306,Stanly,Stanly,37,167,North Carolina,NC
37171,37CS059,805,775,836,919,114,83,144,86,-0.06524690980526879,0.3808835626900884,0.7871393649372452,0.7508639721661117,985,948,1021,1034,49,13,86,169,-2.625278662913424,-2.0447807754162373,-1.4102313596210678,3.355806933862867,71314,71167,Surry,Surry,37,171,North Carolina,NC
37179,37CS060,1303,1199,1406,1448,145,42,249,117,-0.29712382406096194,0.12014290663218258,0.5487325181992918,0.7988296408827523,1637,1511,1762,1909,272,147,398,292,-0.7207651961437032,-0.09688520369586295,0.512359218300771,1.0684229624370272,239849,243012,Union,Union,37,179,North Carolina,NC
37183,37CS061,5162,4674,5650,5693,531,43,1019,449,-0.38541289910281284,0.08672204374484077,0.505112260490865,0.8439563784766014,6523,5930,7115,6581,58,-534,651,525,-1.0962407906112925,-0.4926304140106838,0.13457016271885944,8.843849132178628,1132260,1147776,Wake,Wake,37,183,North Carolina,NC
37191,37CS062,1041,990,1091,1316,275,225,326,149,0.6689598956962237,1.0738626233548478,1.5136386872827359,0.5389112075235891,1273,1213,1334,1422,149,88,209,191,-1.0560043031886537,-0.44566036495518885,0.1805961196085469,1.2761114866659093,118159,116892,Wayne,Wayne,37,191,North Carolina,NC
37193,37CS063,688,660,717,827,139,110,167,77,0.49104457692547165,0.9424562667522626,1.3329336128234137,0.5512939400594747,839,805,873,987,148,114,182,157,-0.8259987954331238,-0.14484566811018734,0.4460198530733733,1.0511302674265999,66218,65815,Wilkes,Wilkes,37,193,North Carolina,NC
37195,37CS064,741,707,775,942,201,167,235,110,0.7148244201805787,1.1578689089012313,1.5868708912252099,0.5439760941843007,904,864,945,1123,219,178,259,136,0.6603928202800257,1.262442612850004,1.8428087349791908,0.6195656050719521,79197,78433,Wilson,Wilson,37,195,North Carolina,NC
38005,38CS001,51,50,51,91,40,40,41,15,4.098005613411242,4.194188420589439,4.2949417875028075,0.3619928659653064,60,59,60,89,29,29,30,4,5.0702490147057615,5.218187612544498,5.365020300056321,0.1317579504150382,6067,5830,Benson and Nearby Counties,Benson,38,5,North Dakota,ND
38027,38CS001,39,38,40,32,-7,-8,-6,4,-5.23759235664103,-4.77096324350322,-4.3434462871149595,-0.6573654031660368,48,47,49,47,-1,-2,0,5,-3.5933213751450737,-2.9602047193730048,-2.350665440579164,21.784808684889413,2320,2336,Benson and Nearby Counties,Eddy,38,27,North Dakota,ND
38031,38CS001,37,37,38,52,15,14,15,21,-2.0103817274195723,-1.913334896179667,-1.8175183560312473,1.3491119183651745,46,46,46,40,-6,-6,-6,3,-3.343599520159815,-3.1854635182215407,-3.030024182404689,-0.60837796925358,3361,3368,Benson and Nearby Counties,Foster,38,31,North Dakota,ND
38039,38CS001,33,33,33,30,-3,-3,-3,5,-3.5728375680752196,-3.464760453255158,-3.3721915838689873,-2.6191163959200936,40,40,41,22,-18,-19,-18,1,-10.26786201383414,-10.108108537887292,-9.960719129371295,-0.05799589336447197,2283,2283,Benson and Nearby Counties,Griggs,38,39,North Dakota,ND
38069,38CS001,43,43,43,53,10,10,10,21,-2.89165763621628,-2.7876101569382588,-2.69101641721033,1.9222381491468865,53,52,53,56,3,3,4,4,-0.3272340427196611,-0.1665977184725809,-0.016295244925941234,0.9003079222026187,3971,3955,Benson and Nearby Counties,Pierce,38,69,North Dakota,ND
38071,38CS001,115,114,117,150,35,33,36,20,1.160483149534626,1.2587868693481352,1.3558208597838135,0.5624709491593837,142,140,143,120,-22,-23,-20,16,-4.073380758952456,-3.918027608402215,-3.7762961129590424,-0.7705048664598249,11547,11570,Benson and Nearby Counties,Ramsey,38,71,North Dakota,ND
38079,38CS001,110,105,115,159,49,44,54,21,1.8421208206082855,2.2515374647816797,2.6732832010251912,0.4198795595763386,133,126,139,187,54,48,61,13,3.526117432816682,4.106474727912898,4.769781507207172,0.2344348737809105,12458,12065,Benson and Nearby Counties,Rolette,38,79,North Dakota,ND
38095,38CS001,23,23,23,35,12,12,12,4,3.5933664159823784,3.6953268555491405,3.7895955369764156,0.30978817383338364,28,28,29,30,2,1,2,4,-1.4133707528663337,-1.2620910420087406,-1.1002259412982902,1.453269663126672,2142,2140,Benson and Nearby Counties,Towner,38,95,North Dakota,ND
38103,38CS001,55,54,55,60,5,5,6,8,-0.7629505244882838,-0.654219295656563,-0.5523473281454963,1.2430880040112655,66,66,67,52,-14,-15,-14,3,-5.512777222989687,-5.3665630293059285,-5.223947471812783,-0.22230652992192163,3926,3912,Benson and Nearby Counties,Wells,38,103,North Dakota,ND
38017,38CS002,1012,933,1092,1197,185,105,264,153,-0.25219622728723995,0.15676764994790174,0.6322803531840202,0.8241732933786355,1267,1171,1363,1230,-37,-133,59,104,-1.5463819970698418,-0.9031058013073783,-0.3192151585330441,-2.900994618592121,184661,186315,Cass,Cass,38,17,North Dakota,ND
38003,38CS003,111,110,112,151,40,39,41,26,1.1926004676951096,1.293891385755315,1.3925017705029719,0.6351167359809307,136,135,138,149,13,11,14,12,-0.06172166786357904,0.0680156315765602,0.22122263732417913,0.8780570874268805,10771,10810,LaMoure and Nearby Counties,Barnes,38,3,North Dakota,ND
38021,38CS003,58,58,59,82,24,23,24,35,-2.403748804088543,-2.3087684044972847,-2.2128942910332556,1.4219166401024774,71,70,72,64,-7,-8,-6,5,-3.059903475776634,-2.911885336582898,-2.7650966228728606,-0.8451545812483937,4937,4906,LaMoure and Nearby Counties,Dickey,38,21,North Dakota,ND
38045,38CS003,36,36,37,50,14,13,14,14,-0.18150695982219364,-0.08718329874488866,0.010162189246450936,0.9556357163537148,44,44,45,31,-13,-14,-13,2,-4.69933355372486,-4.545824934262953,-4.405257764917344,-0.16111688506388375,4076,4068,LaMoure and Nearby Counties,LaMoure,38,45,North Dakota,ND
38073,38CS003,72,71,72,73,1,1,2,5,-0.754143438178106,-0.6619753797642454,-0.561146787049486,2.2052537878754053,88,88,89,67,-21,-22,-21,4,-5.528892290335766,-5.371463494770006,-5.216936348909148,-0.19588461445155514,5629,5679,LaMoure and Nearby Counties,Ransom,38,73,North Dakota,ND
38077,38CS003,128,126,129,136,8,7,10,20,-0.8127916909338728,-0.6993713471332753,-0.6042865996673589,2.120526253095397,157,155,159,115,-42,-44,-40,3,-3.421902214477809,-3.2610458647671168,-3.1023926836271887,-0.07310163463350915,16479,16555,LaMoure and Nearby Counties,Richland,38,77,North Dakota,ND
38081,38CS003,30,30,31,38,8,7,8,5,0.6245585654730023,0.7268702102242697,0.8289552222023177,0.5684975603158801,37,36,37,44,7,7,8,4,0.859503525245002,1.0155771213906544,1.164863486883139,0.4856608088010673,3856,3831,LaMoure and Nearby Counties,Sargent,38,81,North Dakota,ND
38093,38CS003,211,201,220,244,33,24,43,65,-1.9212713562497525,-1.4901768991510356,-1.0462241845019438,1.8940158641937446,260,249,271,242,-18,-29,-7,15,-2.464080618033308,-1.8412619016890563,-1.223754602519621,-0.8754029162244529,21412,21569,LaMoure and Nearby Counties,Stutsman,38,93,North Dakota,ND
38009,38CS004,70,69,71,68,-2,-3,-1,21,-3.697443647880749,-3.5959945983906616,-3.489681714975831,-23.9217756979279,87,86,87,63,-24,-24,-23,4,-5.3345926630582445,-5.171749216323548,-5.013744971722876,-0.1775735982688269,6366,6388,McHenry and Nearby Counties,Bottineau,38,9,North Dakota,ND
38049,38CS004,51,50,51,80,29,29,30,11,3.266431414555289,3.375707851356679,3.473793600815739,0.36487730233653853,62,61,62,72,10,10,11,4,1.3314580887285532,1.4795008335788455,1.6443657437656662,0.34838752182182076,5377,5260,McHenry and Nearby Counties,McHenry,38,49,North Dakota,ND
38055,38CS004,96,95,97,114,18,17,19,22,-0.520072600315561,-0.42097370212599,-0.3306793024537233,1.1652423249020294,120,119,121,108,-12,-13,-11,10,-2.8255437920993676,-2.6680133686702474,-2.5158289186038356,-0.9281496739657528,9709,9789,McHenry and Nearby Counties,McLean,38,55,North Dakota,ND
38075,38CS004,24,23,24,30,6,6,7,12,-2.5638429716952014,-2.457482130031302,-2.353187494204665,1.6227033564200923,29,29,29,28,-1,-1,-1,4,-2.802024279133738,-2.642833420374887,-2.49616611983269,1702.1824435741244,2279,2267,McHenry and Nearby Counties,Renville,38,75,North Dakota,ND
38083,38CS004,10,10,10,18,8,8,8,3,3.842261211090911,3.942633006766755,4.037324612130991,0.3340278865586239,12,12,13,18,6,5,6,3,2.2627224592963473,2.413645877281025,2.5724797643531088,0.45811028327518044,1264,1267,McHenry and Nearby Counties,Sheridan,38,83,North Dakota,ND
38101,38CS004,412,382,442,638,226,196,256,159,0.5225686476323597,0.96670218143271,1.4029023662509876,0.6994168104291576,509,473,545,541,32,-4,68,50,-0.9580923061610342,-0.3216409193350373,0.35604700840308856,1.5245493254857712,69562,69184,McHenry and Nearby Counties,Ward,38,101,North Dakota,ND
38019,38CS005,39,39,39,40,1,1,1,4,-0.9410581110133336,-0.8446888015341046,-0.7413230123457633,2.120981294302734,48,47,48,48,0,-0,1,3,-1.016136384729567,-0.8755143000303102,-0.7324697912963127,2.2735508446331867,3696,3667,Northeast North Dakota,Cavalier,38,19,North Dakota,ND
38035,38CS005,456,425,488,486,30,-2,61,66,-0.9234128369672329,-0.5030573963658435,-0.06782872208416901,2.159359234138025,568,530,605,513,-55,-92,-17,37,-2.0909939256353587,-1.4928793501631343,-0.8951912619254969,-0.6905542393445535,72530,72757,Northeast North Dakota,Grand Forks,38,35,North Dakota,ND
38063,38CS005,47,47,47,52,5,5,5,11,-2.10484565210928,-2.0016622668406976,-1.9073325760755555,1.8210963346150588,59,58,59,41,-18,-18,-17,6,-9.538613296760456,-9.386548033548928,-9.230388409867455,-0.3565992542644971,2976,3045,Northeast North Dakota,Nelson,38,63,North Dakota,ND
38067,38CS005,67,67,68,77,10,9,10,10,-0.16320571291116662,-0.055607800646536316,0.04645432338119295,0.9422563411656563,82,82,83,79,-3,-4,-3,5,-1.6401394182904672,-1.4990612861387733,-1.358022463989027,-2.0485856901245048,6810,6776,Northeast North Dakota,Pembina,38,67,North Dakota,ND
38091,38CS005,15,14,15,13,-2,-2,-1,5,-3.7836994165411015,-3.6854030424297832,-3.5862753660674684,-7.365220997279223,18,18,18,25,7,7,7,1,3.808131732786997,3.9545045115729582,4.10904367496681,0.12562405758047632,1813,1808,Northeast North Dakota,Steele,38,91,North Dakota,ND
38097,38CS005,81,80,81,87,6,6,7,14,-1.045268714178517,-0.9407523042793149,-0.8413108128882278,1.8725856167028025,99,98,100,90,-9,-10,-8,2,-1.824367171548881,-1.6721912951650448,-1.5257401705876457,-0.2454864511057501,7986,7999,Northeast North Dakota,Traill,38,97,North Dakota,ND
38099,38CS005,121,120,122,128,7,6,8,22,-1.5132516642180582,-1.4156977580698868,-1.317218560472543,2.7219877762309808,148,146,149,112,-36,-37,-34,11,-5.514894924480621,-5.360388025840262,-5.221911205536213,-0.31603991789206887,10523,10476,Northeast North Dakota,Walsh,38,99,North Dakota,ND
38007,38CS006,8,8,8,4,-4,-4,-4,4,-8.602167153296115,-8.501203311937697,-8.39980296942486,-1.3605747647161832,10,10,10,3,-7,-7,-7,3,-12.590786590408605,-12.441046638195541,-12.297037514887288,-0.5112941491748497,934,952,Northwest North Dakota,Billings,38,7,North Dakota,ND
38013,38CS006,16,15,16,19,3,3,4,3,0.045926421186015684,0.15536738825012306,0.26118668438473047,0.6916410542140661,19,19,19,20,1,1,1,5,-2.3651582796971784,-2.2183258427327877,-2.0630813572641777,2.495120686726107,2177,2163,Northwest North Dakota,Burke,38,13,North Dakota,ND
38023,38CS006,22,22,23,18,-4,-5,-4,3,-3.4973229087362205,-3.394866671280663,-3.29767651177234,-0.8609870264521523,27,27,28,28,1,0,1,4,-1.9330909932211404,-1.7796651212780026,-1.6278030733266584,2.2827425169780633,2204,2189,Northwest North Dakota,Divide,38,23,North Dakota,ND
38025,38CS006,27,27,28,34,7,6,7,4,0.5353184260574065,0.6275594651964942,0.7270304678155051,0.5259791633667731,33,32,33,38,5,5,6,5,-0.05532327612080931,0.08887422673158486,0.23527042269686813,0.7921891530627847,4141,4045,Northwest North Dakota,Dunn,38,25,North Dakota,ND
38033,38CS006,10,10,10,12,2,2,2,1,0.44159967491845487,0.5430706544251941,0.6403062100725971,0.33971163189483466,12,12,13,19,7,6,7,3,2.2410090457493665,2.4027928727410335,2.541913743971989,0.3984604756082775,1739,1764,Northwest North Dakota,Golden Valley,38,33,North Dakota,ND
38053,38CS006,66,65,68,90,24,22,25,11,0.7651170739930205,0.8669159702604626,0.9655493931484591,0.4438594011896568,77,75,79,91,14,12,16,17,-0.41350148028128486,-0.2546994489520223,-0.09639962803572838,1.1322926366695705,14691,13954,Northwest North Dakota,McKenzie,38,53,North Dakota,ND
38061,38CS006,77,76,78,108,31,30,32,18,1.2654010803478901,1.360700306846614,1.4681782645574226,0.5546622827889881,91,90,92,89,-2,-3,-1,16,-2.4097082786855606,-2.2660399230347337,-2.117961151524695,-14.849838494016383,9854,9604,Northwest North Dakota,Mountrail,38,61,North Dakota,ND
38089,38CS006,213,199,228,258,45,30,59,45,-0.43844333588078316,-0.006611783245505401,0.4125162825699978,0.9857254939878282,259,242,277,245,-14,-32,3,28,-2.1068731839656025,-1.5239934567388662,-0.875043849247323,-2.087051475869183,33387,33157,Northwest North Dakota,Stark,38,89,North Dakota,ND
38105,38CS006,224,207,242,193,-31,-49,-14,31,-1.9468450079548976,-1.5446962159231676,-1.102487976320993,-1.0263827949177933,265,245,285,220,-45,-65,-25,30,-2.9540523385035953,-2.332629708611452,-1.7033607779450621,-0.6768090184287233,40397,38873,Northwest North Dakota,Williams,38,105,North Dakota,ND
38015,38CS007,662,620,704,871,209,167,251,161,0.05245091452958124,0.48267482230062964,0.9393743600055713,0.7661194482024689,825,774,876,841,16,-35,67,87,-1.4680886625062606,-0.8614151520410853,-0.2513430344297955,5.002047522780014,98129,98865,South Central North Dakota,Burleigh,38,15,North Dakota,ND
38029,38CS007,39,39,39,52,13,13,13,11,0.5390678247003958,0.6361961935741626,0.740916360268962,0.7809913762107981,48,47,48,42,-6,-6,-5,7,-4.803782111802261,-4.653125259832154,-4.50152803155044,-1.4910582797190268,3274,3273,South Central North Dakota,Emmons,38,29,North Dakota,ND
38043,38CS007,18,18,19,24,6,5,6,3,0.966119540413253,1.067933439000327,1.1657585419309728,0.4576976393880564,22,22,23,33,11,10,11,6,2.1409493730065345,2.287689519351502,2.4441631625396907,0.520566878317744,2397,2371,South Central North Dakota,Kidder,38,43,North Dakota,ND
38047,38CS007,22,22,22,25,3,3,3,4,-0.7247480832691743,-0.623976368412637,-0.5160826187887415,1.0434265229349964,27,27,27,25,-2,-2,-2,2,-2.8425843657142518,-2.693346527508733,-2.5328453970833835,-1.6252581819529923,1880,1883,South Central North Dakota,Logan,38,47,North Dakota,ND
38051,38CS007,39,39,40,51,12,11,12,4,2.9299784606694876,3.030104746043467,3.122882928645647,0.31770838815736224,48,48,49,40,-8,-9,-8,3,-5.575510846999848,-5.417185302251393,-5.263411334479573,-0.40811241700906487,2506,2513,South Central North Dakota,McIntosh,38,51,North Dakota,ND
38001,38CS008,28,27,29,24,-4,-5,-3,3,-3.5633104723436837,-3.167595809719627,-2.7448855652385804,-1.0276722792585131,34,33,35,38,4,3,5,2,0.6035525029598567,1.2407398876524909,1.8455963926333614,0.38347797065747613,2192,2170,Southwest North Dakota,Adams,38,1,North Dakota,ND
38011,38CS008,28,28,29,41,13,12,13,6,2.139007279845697,2.246361579605413,2.3436725749055056,0.43824333398149684,34,34,34,34,-0,-0,0,5,-2.230312625006359,-2.068791112551197,-1.9133334387312058,5.139956018253202,2981,2914,Southwest North Dakota,Bowman,38,11,North Dakota,ND
38037,38CS008,29,28,30,37,8,7,9,5,0.783893471320593,1.2566583015085837,1.668521835404104,0.5653214636688838,36,35,37,44,8,7,9,4,1.4318779567634399,2.0493623361848297,2.6750580466628042,0.4477273169760529,2284,2317,Southwest North Dakota,Grant,38,37,North Dakota,ND
38041,38CS008,24,24,24,38,14,14,14,8,2.2268545414192777,2.3277285158003878,2.430785449272407,0.542028706061925,29,29,30,23,-6,-7,-6,6,-6.229039926446355,-6.066640302274088,-5.898480890326544,-1.129268062499469,2476,2436,Southwest North Dakota,Hettinger,38,41,North Dakota,ND
38057,38CS008,66,65,67,60,-6,-7,-5,6,-1.569611785609858,-1.4620931619516464,-1.3623279100814873,-1.1580693998007487,82,81,83,87,5,4,6,10,-0.8183906317267854,-0.6669520362149352,-0.501102198675497,1.5690795618346458,8314,8324,Southwest North Dakota,Mercer,38,57,North Dakota,ND
38059,38CS008,280,265,294,326,46,32,61,61,-0.8689658645056558,-0.4388645407209193,-0.020498339999025974,1.2889872922239254,348,331,365,353,5,-12,22,32,-1.5730644946919958,-0.9616936602013819,-0.39756828140893063,5.449824949503093,33066,33570,Southwest North Dakota,Morton,38,59,North Dakota,ND
38065,38CS008,11,10,11,16,5,5,6,2,1.719473255938436,1.8156236115962343,1.914824908616993,0.31169461475435856,13,13,13,13,-0,-0,0,5,-3.3803655204650354,-3.2415803215874206,-3.0837449483912756,5.30208463101195,1879,1872,Southwest North Dakota,Oliver,38,65,North Dakota,ND
38085,38CS008,33,32,33,53,20,20,21,3,4.257993670415306,4.359795599644299,4.457998839444575,0.1421091832002188,39,38,39,51,12,12,13,5,2.1487910585436643,2.2978851955713693,2.458115495681293,0.3787329048143053,3923,3759,Southwest North Dakota,Sioux,38,85,North Dakota,ND
38087,38CS008,9,9,9,4,-5,-5,-5,4,-13.102853402625792,-12.696091694473017,-12.277738089081405,-1.0045720690681408,11,10,11,2,-9,-9,-8,2,-19.301268428815206,-18.667661089007048,-18.082722758521527,-0.2574827943566884,708,692,Southwest North Dakota,Slope,38,87,North Dakota,ND
39001,39CS001,305,294,317,347,42,30,53,30,0.010548801637126272,0.43197162484157536,0.8559911040805454,0.70438276340024,375,360,389,515,140,126,155,95,1.396530204093519,1.9839560999759165,2.5802202028522903,0.6723532358020083,27475,27526,Adams+Brown,Adams,39,1,Ohio,OH
39015,39CS001,457,438,475,544,87,69,106,30,0.8862051638059665,1.3160510049108112,1.745487035320213,0.3391817159228594,560,538,583,681,121,98,143,118,-0.5335829496124692,0.08378235992478102,0.720389620662291,0.9678119947642083,43610,43657,Adams+Brown,Brown,39,15,Ohio,OH
39003,39CS002,969,925,1013,1178,209,165,253,172,-0.03177155050305279,0.3639063552219749,0.7980658811958508,0.8176555808945828,1184,1132,1237,1359,175,122,227,215,-1.0765373979106623,-0.48619275836816234,0.15270403554936848,1.2232160461753114,102076,101727,Allen,Allen,39,3,Ohio,OH
39005,39CS003,489,467,512,570,81,58,103,69,-0.19549396750231654,0.22526035302181108,0.6398284520799423,0.8440271412494733,598,571,625,724,126,99,153,104,-0.05976567687090124,0.4970203244190257,1.1421990985889408,0.8196730503933205,52555,52331,Ashland,Ashland,39,5,Ohio,OH
39007,39CS004,1034,992,1076,1111,77,35,119,125,-0.8976779828045591,-0.5027928956133377,-0.06299765303948808,1.6073226627050583,1265,1215,1316,1539,274,223,324,229,-0.04592112417265093,0.5275552822370536,1.1850214456113388,0.833686682925605,97358,97348,Ashtabula,Ashtabula,39,7,Ohio,OH
39009,39CS005,415,388,442,494,79,52,106,25,0.4592805187166807,0.8441284504494382,1.250962845669818,0.3136226634062952,514,482,546,648,134,102,166,77,0.5014430475541066,1.0935903262799838,1.703576480164921,0.5685382394996877,62791,62099,Athens+Hocking,Athens,39,9,Ohio,OH
39073,39CS005,273,261,285,328,55,43,67,42,0.0365573735398209,0.4857398501777147,0.8927808395290557,0.7448148334175895,336,322,351,434,98,83,112,68,0.6313726960916438,1.2633416025691888,1.8766323934644156,0.6894000426202282,28044,28083,Athens+Hocking,Hocking,39,73,Ohio,OH
39011,39CS006,416,396,436,541,125,105,145,66,0.8670976107125133,1.2971867759742446,1.710950296421821,0.5236819563111931,507,483,531,609,102,78,126,86,-0.23704025545760024,0.4211703531386134,1.0301425262907828,0.8347384750329071,46266,46180,Auglaize+Mercer,Auglaize,39,11,Ohio,OH
39107,39CS006,355,337,373,456,101,83,119,75,0.20650016316250616,0.6103832155021321,1.0068199592449547,0.736593231485799,434,413,456,459,25,3,46,37,-0.9353455407108228,-0.36765540831896165,0.31699218684611086,1.4507287441864531,42277,42333,Auglaize+Mercer,Mercer,39,107,Ohio,OH
39013,39CS007,741,712,769,879,138,110,167,98,0.1567617428764621,0.6070379930012552,1.0044390112820465,0.7045218911742493,901,867,935,1106,205,171,239,166,0.11285908159667268,0.6988141696020216,1.31657364796317,0.805895539924219,66303,65905,Belmont,Belmont,39,13,Ohio,OH
39017,39CS008,3004,2837,3172,3648,644,476,811,399,0.19129210973141658,0.6211729583225306,1.0588978128903654,0.619058523095549,3699,3498,3901,4219,520,318,721,547,-0.6940671779011887,-0.059897530279385686,0.5408393089701513,1.050243245395157,389541,390287,Butler,Butler,39,17,Ohio,OH
39019,39CS009,275,263,286,331,56,45,68,27,0.6489437347147852,1.1002472672306278,1.545493023646426,0.4707250692116729,338,324,351,398,60,47,74,81,-1.5264684717048167,-0.9227299370198364,-0.2980252698523523,1.3171610478997857,26732,26691,Carroll+Harrison+Tuscarawas,Carroll,39,19,Ohio,OH
39067,39CS009,169,163,175,198,29,23,35,17,0.3656688955226348,0.8114617423154151,1.2387160801312833,0.5707375288192654,207,199,214,288,81,74,89,46,2.3126476058356173,2.933044585777098,3.5156259448578497,0.5588854927912864,14573,14479,Carroll+Harrison+Tuscarawas,Harrison,39,67,Ohio,OH
39157,39CS009,949,909,989,1157,208,168,248,178,-0.13843315271733767,0.33257440555727014,0.7438932673989352,0.8505800623347926,1163,1115,1211,1374,211,163,259,266,-1.3342466259929886,-0.7269719138411801,-0.13621085097745034,1.2556077537456067,92848,92582,Carroll+Harrison+Tuscarawas,Tuscarawas,39,157,Ohio,OH
39021,39CS010,350,334,367,432,82,65,98,36,0.76875238206723,1.182045861461845,1.6121507991128692,0.43518080523946545,428,408,448,500,72,52,92,77,-0.7803851207299777,-0.15675656878967625,0.4951043698327591,1.0563034605076027,38737,38700,Champaign+Logan+Madison+Shelby,Champaign,39,21,Ohio,OH
39091,39CS010,440,420,459,473,33,14,53,43,-0.6311432323915311,-0.20099836967316537,0.21264154699200644,1.2472276749889755,537,513,561,624,87,63,111,98,-0.8938764925203323,-0.29919129659673677,0.30752714978719964,1.1160798573254773,45993,46039,Champaign+Logan+Madison+Shelby,Logan,39,91,Ohio,OH
39097,39CS010,362,343,381,395,33,14,52,45,-0.716829763831917,-0.27969414139713394,0.19171706541957612,1.3256948102711807,447,424,470,557,110,87,133,68,0.5445577375060776,1.1569770602071825,1.75297346373981,0.6116474871540852,44026,44304,Champaign+Logan+Madison+Shelby,Madison,39,97,Ohio,OH
39149,39CS010,396,375,416,518,122,102,143,54,0.97904797625583,1.4182177226689912,1.866045942547531,0.4380567152572136,483,459,508,597,114,89,138,104,-0.4202809096727864,0.25027594100326245,0.8136147441956817,0.907694771921215,48173,47998,Champaign+Logan+Madison+Shelby,Shelby,39,149,Ohio,OH
39023,39CS011,1505,1447,1563,1775,270,212,328,209,-9.259757577793594e-4,0.4541719584903313,0.8876000707948125,0.7713925986230482,1836,1766,1906,2134,298,228,368,235,-0.0729829984786574,0.5776679050133167,1.1860541539816436,0.7853829852351385,135505,135646,Clark,Clark,39,23,Ohio,OH
39025,39CS012,1600,1510,1690,1865,265,175,355,147,0.13151598185617544,0.5791077070203745,0.9677656824855063,0.5526399297886307,1977,1869,2086,2407,430,321,538,288,0.17198826418984176,0.7860996983407286,1.425069601621387,0.6689438025958769,208480,209495,Clermont,Clermont,39,25,Ohio,OH
39027,39CS013,388,370,406,475,87,69,105,45,0.5655511991264544,1.004811350830527,1.4564090898736943,0.5098478149476766,475,454,497,574,99,77,120,85,-0.22863170340072275,0.38281528223996664,0.9880912255630243,0.8521663161692364,41972,41998,Clinton+Fayette+Highland,Clinton,39,27,Ohio,OH
39047,39CS013,321,309,333,336,15,3,27,31,-0.9680904878695634,-0.5516538926160915,-0.14726912838722458,1.9433969961743491,392,377,407,440,48,33,63,65,-1.2841207552660026,-0.7145341102623818,-0.11568425680658646,1.3295476450896115,28870,28911,Clinton+Fayette+Highland,Fayette,39,47,Ohio,OH
39071,39CS013,431,413,450,486,55,36,73,41,-0.1087968112604891,0.31852355111132075,0.7479412703855013,0.7357526457947636,528,506,550,642,114,92,136,102,-0.28962454928046194,0.32171359226379803,0.9171476466627205,0.8869371133131997,43296,43349,Clinton+Fayette+Highland,Highland,39,71,Ohio,OH
39029,39CS014,1105,1061,1148,1284,179,136,223,161,-0.24501386229651953,0.17353232978541375,0.6185129081770844,0.892413929877316,1348,1295,1400,1624,276,224,329,251,-0.28754927769997946,0.30207461892396587,0.9132700864140838,0.9049481631736389,101603,101353,Columbiana,Columbiana,39,29,Ohio,OH
39031,39CS015,360,345,376,426,66,50,81,37,0.348037185022147,0.7881329423789255,1.2124019072005463,0.5547416638579079,444,425,463,549,105,86,124,98,-0.39227243747952895,0.26488906630049075,0.8899894927879365,0.921522150584934,36555,36608,Coshocton+Holmes,Coshocton,39,31,Ohio,OH
39075,39CS015,295,276,314,372,77,58,96,75,-0.36761778909976317,0.0434944351837006,0.46662690139498225,0.9651430739079252,368,345,391,418,50,27,73,77,-1.30490228670759,-0.7537011068402835,-0.0630572781052146,1.5051741758365997,44177,44260,Coshocton+Holmes,Holmes,39,75,Ohio,OH
39033,39CS016,488,470,506,584,96,78,114,75,0.11771054259635604,0.5046356296048768,0.9504834819270821,0.7727307027482756,596,574,617,722,126,105,148,100,0.13199612589193985,0.7518277815635478,1.3569214648538945,0.7852597556955854,41832,41779,Crawford+Richland,Crawford,39,33,Ohio,OH
39139,39CS016,1292,1238,1346,1455,163,109,217,141,-0.2717636239928287,0.17868282733067856,0.5878957747509519,0.8596827750296,1591,1526,1656,1785,194,129,259,281,-1.4589817283131854,-0.8359386580217469,-0.17887126404328726,1.4405238429286693,124373,125143,Crawford+Richland,Richland,39,139,Ohio,OH
39035,39CS017,11937,11396,12478,13820,1883,1342,2424,1496,-0.1373271338934907,0.30445981772039876,0.7495798486370998,0.7939538684165174,14539,13893,15185,15948,1409,763,2055,1677,-0.8777968469775934,-0.25418415842189773,0.35484228368721893,1.1893293221412555,1256604,1251182,Cuyahoga,Cuyahoga,39,35,Ohio,OH
39037,39CS018,542,520,564,607,65,43,87,98,-1.059144993437286,-0.6349656803046042,-0.18857182343343948,1.4850333977626193,663,637,690,727,64,37,90,106,-1.6055496738633812,-0.9844243612894943,-0.38159377514302056,1.63701464183094,51750,51639,Darke+Preble,Darke,39,37,Ohio,OH
39135,39CS018,414,396,431,486,72,55,90,70,-0.3825224738823968,0.05781652508390061,0.5164539285178067,0.9564901868482153,507,486,529,631,124,102,145,92,0.31323768443189726,0.9246997685198064,1.54478644549508,0.7387509023918144,40937,40881,Darke+Preble,Preble,39,135,Ohio,OH
39039,39CS019,352,335,368,409,57,41,74,70,-0.7640478299335144,-0.3162783520527973,0.082197584281381,1.2023388827313148,432,412,452,486,54,34,74,65,-1.0034417214879319,-0.3372803864231836,0.2546830008760669,1.1834582360868893,38182,38156,Defiance+Williams,Defiance,39,39,Ohio,OH
39171,39CS019,368,353,384,368,-0,-16,15,51,-1.8087214229154922,-1.4088432157133248,-0.9771407611793329,90.64622147318832,450,431,469,517,67,48,86,87,-1.2529803398075134,-0.6556840112466893,-0.07057584080155475,1.2739925242234407,36955,36761,Defiance+Williams,Williams,39,171,Ohio,OH
39041,39CS020,1050,957,1142,1241,191,99,284,89,0.043480746943685464,0.4839365087719584,0.9082580082592777,0.46264480515120104,1339,1225,1452,1525,186,73,300,132,-0.3299133405872896,0.3046997965454855,0.8701758804686223,0.7044918720506472,214881,219912,Delaware,Delaware,39,41,Ohio,OH
39043,39CS021,827,795,859,1025,198,166,230,114,0.7060810461968654,1.1248053441715196,1.5346099944402098,0.5727080876650614,1006,967,1044,1136,130,92,169,111,-0.3173333535087231,0.3082803055259545,0.9348618454156565,0.844476561519782,75187,74936,Erie,Erie,39,43,Ohio,OH
39045,39CS022,1214,1146,1283,1439,225,156,293,136,0.12854355717376434,0.550120546198139,0.9462174184590437,0.6026723710050891,1511,1428,1594,1816,305,222,388,221,0.0211213410378903,0.616928534979604,1.2098540343682052,0.7230182291830934,159294,160815,Fairfield,Fairfield,39,45,Ohio,OH
39049,39CS023,8660,8091,9229,10063,1403,834,1972,1033,-0.13314053601381232,0.2865341545964002,0.6683706029038804,0.7355314335365379,10669,9987,11352,11848,1179,496,1861,1056,-0.44134140043022296,0.11551980246971105,0.7330266673011092,0.8950243540405827,1322977,1321793,Franklin,Franklin,39,49,Ohio,OH
39051,39CS024,378,360,396,450,72,54,90,47,0.1846801251866729,0.5983187136664557,0.9889992364742802,0.6423082682630852,463,441,485,545,82,60,104,103,-1.2311578523605828,-0.6088720537564223,0.018440191184958998,1.2425111169641254,42537,42475,Fulton+Henry,Fulton,39,51,Ohio,OH
39069,39CS024,255,244,267,315,60,48,71,50,-0.05744850692406976,0.35252020727843775,0.7819704333310039,0.8260407750322737,313,299,328,370,57,42,71,45,-0.1016541845259409,0.5008592478040197,1.0988686099545026,0.7807874395731852,27519,27551,Fulton+Henry,Henry,39,69,Ohio,OH
39053,39CS025,324,311,336,381,57,45,70,30,0.46864069525836377,0.9361247007019419,1.3763146878962615,0.5132417196191524,395,380,410,438,43,28,58,63,-1.4447824658441735,-0.8093106622769481,-0.25213111474805566,1.439434149919536,29285,29163,Gallia+Meigs,Gallia,39,53,Ohio,OH
39105,39CS025,251,242,261,299,48,38,57,22,0.7450473173917072,1.157144943695689,1.5640182877434987,0.4525455155455622,306,295,318,379,73,61,84,49,0.6364977778227602,1.2806057285459258,1.913729816847096,0.6640356909453868,22220,22059,Gallia+Meigs,Meigs,39,105,Ohio,OH
39055,39CS026,732,691,773,887,155,114,196,118,-0.06996256075919932,0.3905725987737764,0.7850244593876028,0.754869865959357,904,855,953,1094,190,141,239,109,0.3945755286590816,1.0451518714049444,1.6453770732885982,0.5701677791985529,95090,95531,Geauga,Geauga,39,55,Ohio,OH
39057,39CS027,1320,1248,1393,1595,275,202,347,169,0.1910783625303032,0.6337409138230584,1.0446920638515997,0.6131702077410369,1629,1542,1716,1912,283,196,370,255,-0.4426664739131698,0.2115239931107573,0.82362991513801,0.896972301383537,168259,168356,Greene,Greene,39,57,Ohio,OH
39059,39CS028,407,391,424,458,51,34,67,38,-0.0940325713602949,0.3239928935692251,0.7366189777376788,0.7339932572482141,497,477,517,656,159,139,179,74,2.0222947666392166,2.65502616458969,3.2322784889084484,0.46282274859868267,38450,38302,Guernsey+Monroe+Noble,Guernsey,39,59,Ohio,OH
39111,39CS028,146,140,152,163,17,11,23,27,-1.1307855250634442,-0.7382608536964093,-0.30938944313727096,1.4873839628675276,178,171,185,235,57,50,64,37,1.211443392415152,1.8046203368087828,2.3971153547538395,0.6361339447502656,13403,13333,Guernsey+Monroe+Noble,Monroe,39,111,Ohio,OH
39121,39CS028,120,118,121,135,15,14,17,32,-1.274017327588466,-1.1694283396757568,-1.074357673461198,1.9493807975161086,148,146,149,162,14,13,16,19,-0.5384259216594026,-0.3836027992546719,-0.2301641461908644,1.2283211009498116,14152,14163,Guernsey+Monroe+Noble,Noble,39,121,Ohio,OH
39061,39CS029,6946,6590,7302,7950,1004,648,1360,802,-0.22362176609993123,0.2394447034792434,0.6732988303137949,0.7981144233405778,8496,8069,8923,9021,525,98,952,928,-1.1805681982377019,-0.5851285609526761,-0.004343934744730351,1.76425953756254,827875,826689,Hamilton,Hamilton,39,61,Ohio,OH
39063,39CS030,663,631,695,766,103,71,135,96,-0.331137407584903,0.07490046402994097,0.509810603268696,0.9257240081746647,811,772,849,920,109,71,148,136,-1.0474458383749017,-0.4430985122944944,0.1955866037953249,1.235492325430518,74937,74681,Hancock,Hancock,39,63,Ohio,OH
39065,39CS031,267,254,280,340,73,60,86,47,0.4050170526773449,0.8355033749282408,1.254597432704803,0.6372834253421693,327,311,343,486,159,143,175,80,2.550496004776952,3.0788598560858658,3.7028056600577512,0.4992991478771075,30808,30636,Hardin+Wyandot,Hardin,39,65,Ohio,OH
39175,39CS031,218,209,227,274,56,47,65,34,0.5972953753098784,1.0015618093454395,1.409632170527522,0.5953448076006924,266,254,277,304,38,27,50,49,-1.1734468938030231,-0.5706134850603825,0.02721284306923511,1.241655875170004,21830,21729,Hardin+Wyandot,Wyandot,39,175,Ohio,OH
39077,39CS032,527,502,553,652,125,99,150,79,0.37256897086386837,0.7740402609793149,1.1883734007709394,0.6293206514503863,649,619,679,733,84,54,114,107,-1.0909858725029842,-0.4658717576527597,0.10654249472273793,1.2564480715391775,58407,58378,Huron,Huron,39,77,Ohio,OH
39079,39CS033,373,359,387,405,32,18,46,36,-0.5082220261955218,-0.1158038802435352,0.3134876779490779,1.0886781611128429,458,441,475,518,60,43,77,80,-1.3760199500505563,-0.7348694266722342,-0.10553627266570684,1.309647751359286,32589,32530,Jackson+Pike+Vinton,Jackson,39,79,Ohio,OH
39131,39CS033,315,304,327,363,48,36,59,14,0.77507345374972,1.2570012151028778,1.6610202645041192,0.2866667526730563,387,373,401,481,94,80,108,74,0.23720939130125224,0.8923458436541998,1.5385092213104852,0.7805333569359445,27161,27083,Jackson+Pike+Vinton,Pike,39,131,Ohio,OH
39163,39CS033,137,132,143,163,26,20,31,10,0.7904720784906518,1.2252969729485412,1.6591586772247529,0.376118686115876,168,162,175,226,58,51,64,35,1.5197002971086042,2.1553469112552044,2.7633509241504592,0.59579070211623,12810,12709,Jackson+Pike+Vinton,Vinton,39,163,Ohio,OH
39081,39CS034,783,755,811,867,84,56,112,91,-0.5205975340331819,-0.13007837560837532,0.33017132775944985,1.0767791409951852,951,918,985,1173,222,188,255,170,0.37268016141153754,0.9589471416087717,1.5568863342335724,0.7627886848406599,65130,64835,Jefferson,Jefferson,39,81,Ohio,OH
39083,39CS035,532,505,559,642,110,83,137,73,0.14248658694491292,0.5744970009599927,1.027219554892503,0.6599204330614277,650,618,683,816,166,133,198,125,0.1059395023489953,0.769138109241696,1.4126285106271343,0.7507284289884881,62702,62878,Knox+Morrow,Knox,39,83,Ohio,OH
39117,39CS035,276,261,291,320,44,29,59,26,0.04992789249127194,0.5147161367999162,0.9319067463878961,0.578773370243681,338,320,356,416,78,60,96,58,0.0849948725120994,0.6879650657408339,1.3594510399607243,0.7338362163313132,35039,35124,Knox+Morrow,Morrow,39,117,Ohio,OH
39085,39CS036,2183,2083,2283,2476,293,193,393,246,-0.20581228357579529,0.21624372310056642,0.6008019214976388,0.8371630796350422,2675,2555,2795,3086,411,291,531,359,-0.3674914553015265,0.27407272262432636,0.8938646934361504,0.8712351153608393,231980,232079,Lake,Lake,39,85,Ohio,OH
39087,39CS037,703,678,728,814,111,86,136,59,0.45505227731470255,0.9069287360089636,1.3500268721357331,0.5250303878912673,851,821,880,1078,227,198,257,137,1.2442944138688579,1.8926639437194814,2.49002618825048,0.6002063986517149,58268,57545,Lawrence,Lawrence,39,87,Ohio,OH
39089,39CS038,1477,1401,1554,1618,141,64,217,156,-0.506575962481854,-0.07923676583628862,0.3239186653579228,1.1023167314271056,1830,1737,1923,2178,348,255,441,247,0.05666314692161556,0.6715533111121951,1.3186722023017465,0.7078330892496673,178640,180150,Licking,Licking,39,89,Ohio,OH
39093,39CS039,2763,2628,2898,3103,340,205,475,314,-0.36944618830097764,0.0820713425114282,0.5096693202137125,0.9213732838053225,3412,3249,3575,4042,630,467,793,497,-0.14847616082380063,0.49701592869081745,1.1877860591086242,0.787919855925926,313123,315270,Lorain,Lorain,39,93,Ohio,OH
39095,39CS040,3935,3750,4120,4860,925,740,1110,591,0.3575276123126216,0.7677773798805234,1.2078115693766065,0.6380327691936887,4823,4601,5045,5496,673,451,895,602,-0.3676130687678045,0.20517153935610777,0.7878232121336013,0.893161986075291,430300,429415,Lucas+Ottawa,Lucas,39,95,Ohio,OH
39123,39CS040,429,412,446,506,77,60,94,54,0.17030567072354952,0.5808460960287727,1.0183303553222078,0.6909214159281016,523,503,544,626,103,82,123,72,0.2828954013051252,0.9094246359759087,1.5263892442775917,0.694446515146154,40283,40127,Lucas+Ottawa,Ottawa,39,123,Ohio,OH
39099,39CS041,2566,2468,2664,3285,719,621,817,476,0.6330148494806335,1.0721078583169072,1.47352430373443,0.6608418044690488,3118,3001,3235,3615,497,380,614,459,-0.4084666442253597,0.21094424722587202,0.8470327902002174,0.9222553177408318,227761,226935,Mahoning,Mahoning,39,99,Ohio,OH
39101,39CS042,665,637,693,709,44,16,72,111,-1.4753382744838537,-1.0172909005955661,-0.5828095347361144,2.455035757164446,814,780,847,934,120,87,154,120,-0.5860722399114873,-0.01148782949363516,0.5629364787599169,0.9891480547970579,65311,65302,Marion,Marion,39,101,Ohio,OH
39103,39CS043,1338,1259,1416,1593,255,177,334,182,-0.024194099942555225,0.39443809796110485,0.8166107101639005,0.7107353712622484,1653,1559,1748,2003,350,255,444,245,0.08421033590810569,0.6803081251216511,1.3096632170318254,0.6987304015688961,182252,183013,Medina,Medina,39,103,Ohio,OH
39109,39CS044,989,943,1036,1096,107,60,153,130,-0.654665722868562,-0.20935707666521425,0.21432907893956973,1.2077915058912678,1219,1163,1275,1465,246,190,302,257,-0.7391478446001752,-0.11936096694965814,0.47710995463903155,1.0400302792918232,108601,109199,Miami,Miami,39,109,Ohio,OH
39113,39CS045,5413,5182,5643,6341,928,698,1159,692,0.033883765054279286,0.44929023890148884,0.8686368118524476,0.7445884659481343,6624,6347,6900,7357,733,457,1010,886,-0.9663296424431407,-0.33709713811631764,0.2268525443761834,1.2063376223969358,535892,535955,Montgomery,Montgomery,39,113,Ohio,OH
39115,39CS046,149,144,155,188,39,33,44,16,1.1984156926527199,1.6264356402606917,2.0563060642246604,0.4047398851840676,182,175,189,267,85,78,92,36,3.691515466990901,4.3016618472338575,4.888456780782837,0.41753192761395214,13846,13691,Morgan+Perry,Morgan,39,115,Ohio,OH
39127,39CS046,312,296,327,372,60,45,76,36,0.22294768485092908,0.6880950691580185,1.1378495818113767,0.5862620987081046,383,365,402,491,108,89,126,66,0.8064466130542519,1.4045816796315314,2.036983978273771,0.6073710575493523,35542,35457,Morgan+Perry,Perry,39,127,Ohio,OH
39119,39CS047,865,828,902,983,118,81,155,84,-0.03435733537379845,0.4018599960638672,0.8156564917736729,0.7039031706887191,1059,1015,1104,1180,121,76,165,165,-1.235430958590536,-0.6107023381360714,0.007658610473657798,1.3544690300688556,86305,86398,Muskingum,Muskingum,39,119,Ohio,OH
39125,39CS048,182,173,190,204,22,14,31,28,-0.6951643897998145,-0.30239329537405135,0.12116366936683101,1.1947392806175294,223,213,233,220,-3,-13,7,42,-3.4707176806606297,-2.883425249612416,-2.2871779074329104,-20.081118221351463,18792,18861,Paulding+Putnam+Van Wert,Paulding,39,125,Ohio,OH
39137,39CS048,272,257,287,350,78,63,93,81,-0.5129273473850365,-0.08062201620059903,0.33363878320620716,1.023063034737909,334,317,352,381,47,29,64,56,-0.980140503421487,-0.32130667797331375,0.24523657605351232,1.1774382677046895,34295,34327,Paulding+Putnam+Van Wert,Putnam,39,137,Ohio,OH
39161,39CS048,282,269,294,342,60,48,73,56,-0.30084805942148996,0.13298546701820685,0.5533287835498499,0.9147942790742897,344,330,359,402,58,43,72,66,-0.9908296510502843,-0.34406796382372523,0.3006483436849825,1.1272344074860323,28768,28753,Paulding+Putnam+Van Wert,Van Wert,39,161,Ohio,OH
39129,39CS049,530,505,556,627,97,71,122,83,-0.19314680729742892,0.2126086382550985,0.6702174586017061,0.8505077215416751,658,627,688,766,108,78,139,104,-0.5237895607589007,0.06135950505521819,0.6644718217757623,0.9498061135501298,58686,59230,Pickaway,Pickaway,39,129,Ohio,OH
39133,39CS050,1286,1217,1356,1453,167,97,236,125,-0.13608585476694196,0.2648727032480849,0.6900647605212794,0.7450609148523947,1584,1501,1668,1947,363,279,446,250,0.2065254902337666,0.8396986172273881,1.4585754513984146,0.6875360702313758,161933,162293,Portage,Portage,39,133,Ohio,OH
39141,39CS051,749,715,782,948,199,166,233,102,0.8270753687882874,1.2696680700876712,1.7203214744290294,0.5087748046350874,916,877,956,1144,228,188,267,154,0.5101557629207656,1.1390420437920235,1.7711205457587365,0.6737146504209081,76921,76905,Ross,Ross,39,141,Ohio,OH
39143,39CS052,586,561,611,633,47,22,72,87,-1.116940564549661,-0.6783781043138595,-0.24899159747760283,1.810764769492689,718,687,748,859,141,111,172,115,-0.12387248398032029,0.517992757675076,1.167378489061548,0.8084301361904653,58774,58732,Sandusky,Sandusky,39,143,Ohio,OH
39145,39CS053,876,845,908,1092,216,184,247,66,1.6094588499501057,2.0223266139606646,2.4674651617549364,0.30475440978344476,1068,1030,1106,1313,245,207,283,142,1.0731650130405588,1.6868129571924646,2.3042911950402747,0.5775151809912558,73875,73401,Scioto,Scioto,39,145,Ohio,OH
39147,39CS054,521,498,545,609,88,64,111,76,-0.21182149504731843,0.22144125858289307,0.6377299387933134,0.8571509702623513,638,610,666,774,136,108,164,129,-0.45377131094158224,0.1438112696738173,0.7810324107436302,0.9407205182291651,55015,54918,Seneca,Seneca,39,147,Ohio,OH
39151,39CS055,3753,3593,3914,4484,731,570,891,643,-0.2097708782730519,0.2193939777592821,0.6788900336718796,0.878906408220355,4599,4406,4792,5401,802,609,995,796,-0.5762017305602511,0.031504060404247074,0.685074680219256,0.9908280527245915,373773,373910,Stark,Stark,39,151,Ohio,OH
39153,39CS056,5004,4772,5236,5794,790,558,1022,651,-0.16315798714907861,0.2628098275138958,0.6575165675456577,0.823231271040056,6112,5835,6390,7029,917,639,1194,805,-0.38340444825692727,0.2614427638013291,0.8877517688474826,0.8772973108451312,539520,537910,Summit,Summit,39,153,Ohio,OH
39155,39CS057,2225,2138,2311,2647,422,336,509,353,-0.0843912290840519,0.3294081776118689,0.7612982934551751,0.833767678228547,2721,2617,2825,3251,530,426,634,435,-0.05834828650442189,0.5803319183133042,1.1975288227935492,0.8188495731765615,200911,201345,Trumbull,Trumbull,39,155,Ohio,OH
39159,39CS058,377,350,404,412,35,8,62,27,-0.3193414186586313,0.13967997431056012,0.5557585916909868,0.7443651058982104,479,446,512,493,14,-19,47,56,-1.4304921092226957,-0.7727418008542445,-0.139684746477504,3.727914197631833,62688,64695,Union,Union,39,159,Ohio,OH
39165,39CS059,1615,1510,1719,1888,273,169,378,208,-0.15653862880109665,0.27245455567878163,0.7280197666616761,0.7588556098241953,2024,1897,2151,2348,324,197,451,291,-0.4502535381751377,0.1533765492590608,0.7943473515561068,0.8965582120454613,242294,246035,Warren,Warren,39,165,Ohio,OH
39167,39CS060,636,610,662,696,60,34,86,80,-0.7550129518943124,-0.32595250755173,0.11239300167774285,1.3085328871684345,774,743,804,875,101,71,132,88,-0.39407798461525045,0.2672084297942712,0.9519485278258195,0.8589787145788829,59652,59451,Washington,Washington,39,167,Ohio,OH
39169,39CS061,1009,959,1060,1153,144,93,194,156,-0.5512450322406645,-0.09343346758061823,0.33136443722303865,1.0788913757735867,1242,1182,1303,1494,252,191,312,208,-0.16870344955340222,0.4480573575285802,1.12351052922176,0.8235639920920116,116678,116729,Wayne,Wayne,39,169,Ohio,OH
39173,39CS062,1013,956,1070,1197,184,127,241,145,-0.15206761051552278,0.30700751339400284,0.7189690679386036,0.7836456062894998,1250,1181,1318,1361,111,43,180,152,-0.9959315689752205,-0.35992594738226763,0.2554035820436124,1.3516259959195414,132075,132434,Wood,Wood,39,173,Ohio,OH
40001,40CS001,191,182,199,241,50,42,59,28,0.7008542594723317,1.1064189086899003,1.5248525062871967,0.5473412085480402,230,220,240,343,113,103,123,61,2.6442224534996783,3.2094624862748873,3.852289475319651,0.5354675555372539,19825,19414,Adair+Cherokee+Sequoyah,Adair,40,1,Oklahoma,OK
40021,40CS001,405,384,425,514,109,89,130,52,0.7691270975893363,1.2014564811222237,1.6185030581893918,0.47144179165500316,498,473,522,632,134,110,159,72,0.9621061487375687,1.5692819298815062,2.2218089813918693,0.5318593547686786,47391,47547,Adair+Cherokee+Sequoyah,Cherokee,40,21,Oklahoma,OK
40135,40CS001,420,403,437,560,140,123,157,54,1.7320486751107818,2.145505861817906,2.593680250784836,0.3835126740375831,512,492,532,689,177,157,197,108,1.4687491965726438,2.1125438137417167,2.7571655004406534,0.6063525080916475,39623,39471,Adair+Cherokee+Sequoyah,Sequoyah,40,135,Oklahoma,OK
40005,40CS002,150,144,156,180,30,24,36,20,0.2654006708879672,0.7025924294030107,1.1141087129989482,0.6495518144580972,185,177,192,195,10,3,18,33,-2.5442591578811418,-1.8901983183098756,-1.2883306492908946,2.88393264465405,14126,14302,Atoka+Bryan+Coal,Atoka,40,5,Oklahoma,OK
40013,40CS002,436,416,456,524,88,68,108,68,0.04748916086576101,0.4345861011437434,0.8525789417270142,0.7601499990826547,536,511,560,713,177,153,202,110,1.1040082017742963,1.7178587145462851,2.3082658648097754,0.6164783205532942,46640,46987,Atoka+Bryan+Coal,Bryan,40,13,Oklahoma,OK
40029,40CS002,70,70,71,93,23,22,23,10,2.2958725898729844,2.39021717556463,2.496930993657248,0.4217527113455038,85,85,86,93,8,7,8,6,0.2463681144031492,0.39038214162966034,0.5509464749072864,0.6880469811919304,5313,5276,Atoka+Bryan+Coal,Coal,40,29,Oklahoma,OK
40009,40CS003,206,196,215,249,43,34,53,49,-0.6908043036046524,-0.2518232591633884,0.1576032969357763,1.1114738237323674,252,240,263,298,46,35,58,46,-0.6600048323551034,0.007829068480841687,0.6624011232154875,0.9762750491905126,22207,22083,Beckham+Custer+Roger Mills+Washita,Beckham,40,9,Oklahoma,OK
40039,40CS003,261,248,273,341,80,68,93,72,-0.1456353696450387,0.3023477052671149,0.703458957758075,0.8837752874447256,318,304,333,332,14,-1,28,55,-2.3687624054866485,-1.7606743784467227,-1.1105275153328829,3.7362286077818747,28467,28201,Beckham+Custer+Roger Mills+Washita,Custer,40,39,Oklahoma,OK
40129,40CS003,30,30,30,47,17,17,17,11,1.640432296373967,1.7373723840695137,1.8432227021666985,0.6111587091485001,36,36,37,52,16,15,16,3,4.307301416704871,4.469415521081352,4.6150007695131565,0.18045169783843162,3447,3392,Beckham+Custer+Roger Mills+Washita,Roger Mills,40,129,Oklahoma,OK
40149,40CS003,119,118,120,138,19,18,20,20,-0.19563969306182327,-0.09417757319918725,0.006000467842848036,1.0017508117746685,146,145,148,162,16,14,17,27,-1.3954975911954364,-1.2482145307174664,-1.0969905449353772,1.6191500094816558,10910,10913,Beckham+Custer+Roger Mills+Washita,Washita,40,149,Oklahoma,OK
40015,40CS004,298,286,309,413,115,104,127,81,0.8250597919384193,1.2842205586120714,1.6834858040517433,0.6957588700897808,358,344,371,437,79,66,93,73,-0.3392361969036772,0.2621993869284296,0.9133455087208554,0.9085520473733358,27109,26439,Caddo+Grady,Caddo,40,15,Oklahoma,OK
40051,40CS004,482,458,505,608,126,103,150,92,0.2064892154299706,0.6279349653065525,1.0247135124396562,0.7219496394583024,598,570,627,747,149,120,177,114,0.16194777843957567,0.7606969437762517,1.3665808317473993,0.7610559140131165,55018,55405,Caddo+Grady,Grady,40,51,Oklahoma,OK
40017,40CS005,984,917,1051,1086,102,35,169,157,-0.7733110976100732,-0.3845691479213067,0.06153398720555474,1.5281354472194801,1257,1174,1340,1355,98,15,181,186,-1.3107435535655687,-0.6396883552444796,-0.007644265338147415,1.8751848564586613,155154,160828,Canadian,Canadian,40,17,Oklahoma,OK
40019,40CS006,482,461,503,590,108,87,129,51,0.7608678379639604,1.1835445209447348,1.6044298121920635,0.46782139677059104,587,562,612,814,227,202,252,153,1.2100700682221635,1.841949592331717,2.496604271512158,0.6699671290861227,48080,48249,Carter+Johnston+Love+Marshall,Carter,40,19,Oklahoma,OK
40069,40CS006,121,117,126,125,4,-1,8,19,-1.8551026512850493,-1.4551325463702174,-1.0269492147003951,3.9136097121120694,146,141,152,177,31,25,36,34,-0.9555544701184625,-0.40103459791002527,0.21861208663941406,1.0786214955665892,10352,10289,Carter+Johnston+Love+Marshall,Johnston,40,69,Oklahoma,OK
40085,40CS006,100,99,101,119,19,18,20,17,0.09723008997209971,0.19660949807060385,0.29246919510955244,0.8494920644370887,123,122,125,148,25,23,26,25,-0.18392593631595436,-0.021855607591074723,0.13615896222896867,0.9698493826704649,10156,10205,Carter+Johnston+Love+Marshall,Love,40,85,Oklahoma,OK
40095,40CS006,159,153,166,220,61,54,67,19,2.235065055359503,2.674551783677768,3.1375780389591896,0.30784116264976336,194,186,202,267,73,65,81,34,2.369125845644528,3.034845823645672,3.6746210087594497,0.4573224867316289,15602,15557,Carter+Johnston+Love+Marshall,Marshall,40,95,Oklahoma,OK
40023,40CS007,170,164,176,232,62,56,68,22,2.3641594233847267,2.790762230979689,3.223833964670678,0.3503491443291113,206,199,214,294,88,80,95,54,2.217272795509799,2.8335487250593356,3.4388141996122887,0.6098154945078923,14273,14291,Choctaw+McCurtain+Pushmataha,Choctaw,40,23,Oklahoma,OK
40089,40CS007,325,312,338,476,151,138,164,84,1.7356205121728079,2.166932883448113,2.585968431354868,0.552066788625269,392,376,408,602,210,194,226,114,3.098914584085101,3.7152523746699497,4.356651477761471,0.540402482912023,31082,30870,Choctaw+McCurtain+Pushmataha,McCurtain,40,89,Oklahoma,OK
40127,40CS007,138,133,143,159,21,16,26,10,0.5944011750830154,1.0266144579454932,1.4519563046166775,0.4526844949780162,167,161,172,253,86,81,92,45,4.013114428234886,4.60648394944367,5.253772644036469,0.5148449072899988,10833,10812,Choctaw+McCurtain+Pushmataha,Pushmataha,40,127,Oklahoma,OK
40027,40CS008,1824,1697,1951,2071,247,120,374,238,-0.41075351814330713,0.018702884418654576,0.4475063580677013,0.9609200915530732,2274,2121,2428,2565,291,137,444,309,-0.717604106671707,-0.07379164392549986,0.5131973994750475,1.0600000513064123,294509,297367,Cleveland,Cleveland,40,27,Oklahoma,OK
40031,40CS009,883,831,935,1077,194,142,246,92,0.42411513083866187,0.8446699769514165,1.3104659851051852,0.471926572745635,1092,1029,1155,1424,332,269,395,224,0.42326603086343184,1.0594679884318876,1.6562688990586973,0.6719637640514645,121240,121927,Comanche,Comanche,40,31,Oklahoma,OK
40033,40CS010,62,61,62,84,22,22,23,13,1.540694171050132,1.6386745808666652,1.7316758065327196,0.5628886243863856,75,74,76,107,32,31,33,15,3.559677780797565,3.701335818966899,3.8594398218117214,0.4552821231300389,5552,5489,Cotton+Jefferson+Stephens,Cotton,40,33,Oklahoma,OK
40067,40CS010,65,64,65,88,23,23,24,5,3.2629411393230936,3.3570517215748135,3.4617619277041682,0.20615669522280491,79,78,80,97,18,17,19,12,1.1375576822332052,1.2876227507719284,1.4350407011386836,0.6373845175793309,5434,5422,Cotton+Jefferson+Stephens,Jefferson,40,67,Oklahoma,OK
40137,40CS010,484,465,502,541,57,39,76,56,-0.4044515544891983,0.025692268765195266,0.43342649337773664,0.9615300126624698,597,574,619,697,100,78,123,110,-0.8548800174042805,-0.2651198590949769,0.35468099556098737,1.0848804719808054,42866,43074,Cotton+Jefferson+Stephens,Stephens,40,137,Oklahoma,OK
40035,40CS011,172,166,178,196,24,18,30,19,-0.04943337134929375,0.3797833649827446,0.8070400638105457,0.7487574679975781,209,201,216,225,16,9,24,27,-1.505288209412228,-0.9074252119084376,-0.32172350125361465,1.5522462753500061,14138,14120,Craig+Mayes,Craig,40,35,Oklahoma,OK
40097,40CS011,402,385,419,470,68,51,85,53,-0.015632426908903915,0.36671856715835655,0.8148659009178197,0.7688136053894186,489,469,509,649,160,140,180,86,1.6094659232925732,2.2534223511787337,2.8885423602512237,0.5350859679201154,39378,39145,Craig+Mayes,Mayes,40,97,Oklahoma,OK
40037,40CS012,733,703,764,801,68,37,98,100,-0.8825059308818061,-0.4557241162694122,-0.009871902894549199,1.4578076098486918,898,861,935,1070,172,135,209,188,-0.8570338059481778,-0.25045191265695166,0.35845554341295166,1.0875612426524481,71742,71992,Creek,Creek,40,37,Oklahoma,OK
40041,40CS013,450,433,468,612,162,144,179,88,1.3946193300083327,1.8049684613661028,2.241770782799465,0.540008484107349,551,530,573,751,200,178,221,118,1.7891221663960777,2.375684869093191,3.000356337688701,0.5885105530375433,40843,40912,Delaware+Ottawa,Delaware,40,41,Oklahoma,OK
40115,40CS013,360,347,373,408,48,35,61,53,-0.5926873427414338,-0.16513003969561008,0.2537386888104557,1.0776580572078578,438,423,454,566,128,112,143,74,1.5135931332607302,2.144890644321376,2.716638114239067,0.5752605112533653,30364,30321,Delaware+Ottawa,Ottawa,40,115,Oklahoma,OK
40047,40CS014,600,573,627,709,109,82,136,128,-0.7731786222711193,-0.3069279842088403,0.1368481095721675,1.1644666265526809,730,698,762,861,131,99,163,92,0.16534549928306835,0.7704868900202047,1.363647298422984,0.6953907930181081,62367,62029,Garfield,Garfield,40,47,Oklahoma,OK
40049,40CS015,285,274,296,361,76,65,87,47,0.6750641387875165,1.1058042580975052,1.547767440254778,0.6112551118385412,349,336,362,452,103,90,116,72,0.8250287299646274,1.4524674115930527,2.023153182436208,0.6922078391262476,25946,25778,Garvin+McClain+Murray,Garvin,40,49,Oklahoma,OK
40087,40CS015,349,331,367,389,40,22,58,62,-0.9753994054783182,-0.5112341794925199,-0.09748145356713761,1.5063501941312474,444,422,466,437,-7,-29,15,51,-2.281685477391445,-1.6051493837130906,-1.00287642816293,-8.387695819170663,41849,43278,Garvin+McClain+Murray,McClain,40,87,Oklahoma,OK
40099,40CS015,165,159,171,183,18,12,24,16,-0.29970682098046564,0.11915932989142991,0.5385902651964044,0.8576898605678095,201,193,208,242,41,34,49,42,-0.6593546587025367,-0.06909642033036105,0.5939392870583071,0.990178278815198,13884,13740,Garvin+McClain+Murray,Murray,40,99,Oklahoma,OK
40053,40CS016,50,50,51,66,16,15,16,5,2.431311495792104,2.5348752414594538,2.637423381928636,0.30085953146791156,61,61,62,70,9,8,9,4,1.259022925623445,1.4096992127253156,1.5669966008801366,0.4060333524573853,4187,4136,Grant+Kay,Grant,40,53,Oklahoma,OK
40071,40CS016,500,481,518,606,106,88,125,102,-0.3335272588483385,0.10955575099484303,0.5349607638116284,0.9490954278300764,614,591,637,680,66,43,89,90,-1.2529723702335376,-0.662760087151808,-0.06931343693246818,1.3420684353804362,43579,43704,Grant+Kay,Kay,40,71,Oklahoma,OK
40061,40CS017,137,132,142,152,15,10,20,13,-0.29651291319619805,0.1391792852193383,0.5819757317855674,0.8271810801956752,166,160,172,196,30,24,36,34,-1.0879424545027316,-0.4603411253289822,0.22714109490610412,1.110145460701344,11718,11594,Haskell+Latimer+Pittsburg,Haskell,40,61,Oklahoma,OK
40077,40CS017,116,115,117,100,-16,-17,-15,10,-2.847650247878473,-2.747984349458963,-2.6474854891087154,-0.6574907391899146,140,139,142,167,27,25,28,27,-0.20942435719676705,-0.05939915863511015,0.08503883340938745,0.9811872334471468,9542,9432,Haskell+Latimer+Pittsburg,Latimer,40,77,Oklahoma,OK
40121,40CS017,509,490,528,586,77,58,96,52,0.14509545645556238,0.5655889437994539,0.982644884133916,0.6677121887113368,619,597,642,810,191,168,213,136,0.9183868734524785,1.5107990933427704,2.138002322374335,0.7092127674985262,43709,43647,Haskell+Latimer+Pittsburg,Pittsburg,40,121,Oklahoma,OK
40063,40CS018,167,161,173,183,16,10,22,26,-1.1784692373360295,-0.7519722477957862,-0.333435444349122,1.5376781702693272,205,198,212,228,23,16,30,29,-1.2003628023080826,-0.5591264057680183,0.05734267136960689,1.2245758030461795,13328,13395,Hughes+Okfuskee+Pontotoc+Seminole,Hughes,40,63,Oklahoma,OK
40107,40CS018,153,149,158,174,21,16,25,28,-1.0803227965038324,-0.6609847124261458,-0.19032548933305138,1.2947218714032562,186,180,192,191,5,-1,11,30,-3.293742802239098,-2.6571385347868626,-2.0560011495208825,4.8776126699069655,11338,11203,Hughes+Okfuskee+Pontotoc+Seminole,Okfuskee,40,107,Oklahoma,OK
40123,40CS018,376,360,393,429,53,36,69,43,-0.1613660598327418,0.25852751348702396,0.6885150613709734,0.7981532740370443,463,443,483,596,133,113,153,79,1.0783993181154756,1.685063588344386,2.278749967309232,0.58939228059131,38126,38150,Hughes+Okfuskee+Pontotoc+Seminole,Pontotoc,40,123,Oklahoma,OK
40133,40CS018,282,272,292,353,71,61,81,41,0.8644274668530215,1.2535160499876647,1.689560951606761,0.5713272140756869,345,333,357,427,82,70,94,62,0.4463237918403728,0.9987608583472334,1.6268860878725069,0.7487414675361184,23633,23558,Hughes+Okfuskee+Pontotoc+Seminole,Seminole,40,133,Oklahoma,OK
40079,40CS019,524,503,545,630,106,85,127,59,0.5158815291504008,0.967290242786891,1.413350294333278,0.552540606670555,643,618,668,796,153,128,178,104,0.6211906885958061,1.2053364337904002,1.8816038752709694,0.6745675919241516,48411,48426,Le Flore,Le Flore,40,79,Oklahoma,OK
40081,40CS020,321,307,335,382,61,47,75,50,-0.07364401129004843,0.33008939451428615,0.7668659938990015,0.8065073995216022,393,376,411,484,91,73,108,69,0.1310153933143727,0.7500082600581948,1.424350704386207,0.7532117456403898,33721,33776,Lincoln+Logan,Lincoln,40,81,Oklahoma,OK
40083,40CS020,343,322,365,366,23,1,44,31,-0.6406922565431233,-0.17406122834427926,0.24674438925746872,1.3067889504672932,430,404,456,509,79,53,105,84,-0.7306046322568645,-0.13435374516547308,0.4819873560178928,1.0497879506428274,49607,50716,Lincoln+Logan,Logan,40,83,Oklahoma,OK
40091,40CS021,249,241,258,306,57,48,65,34,0.734350597638797,1.1901986819118113,1.60651214915203,0.5898761660141436,308,298,318,416,108,98,118,67,1.994855922574975,2.5833370647296543,3.169234909717992,0.6130356855680931,19072,19201,McIntosh+Okmulgee,McIntosh,40,91,Oklahoma,OK
40111,40CS021,426,410,442,538,112,96,128,57,1.047645315266454,1.4986751544457706,1.9289923234523252,0.5048055448991285,522,503,541,668,146,127,165,103,0.764761932455356,1.3858763446193807,2.031854700500896,0.7020581383808773,36950,36819,McIntosh+Okmulgee,Okmulgee,40,111,Oklahoma,OK
40003,40CS022,51,51,52,66,15,14,15,5,1.5622335345303104,1.6671065113704484,1.7702581190872386,0.32201706166154515,64,63,64,53,-11,-11,-10,2,-2.8157377622801696,-2.6584143460173686,-2.5155088988935104,-0.20703285527891238,5706,5710,Major and Nearby Counties,Alfalfa,40,3,Oklahoma,OK
40011,40CS022,104,103,105,135,31,30,32,17,1.4852576555599624,1.5858006190985174,1.6828391599605939,0.5320147720936601,125,124,126,162,37,36,38,21,2.1059301363636513,2.2540725834438273,2.4157297060033462,0.5509643568103407,8804,8584,Major and Nearby Counties,Blaine,40,11,Oklahoma,OK
40043,40CS022,54,53,54,61,7,7,8,13,-1.3232532185903845,-1.2287936530284425,-1.1242999615498963,1.5391162625829076,64,64,65,85,21,20,21,10,2.7007757449392913,2.8555424285579627,3.0182694592018713,0.464688755868069,4524,4424,Major and Nearby Counties,Dewey,40,43,Oklahoma,OK
40073,40CS022,138,132,145,152,14,7,20,33,-1.680329695273414,-1.2640361583069197,-0.8179182044051276,2.231174606244511,170,162,177,173,3,-4,11,19,-1.8583618750441917,-1.2223789989335834,-0.5731519477112089,4.267662042111544,15266,15196,Major and Nearby Counties,Kingfisher,40,73,Oklahoma,OK
40093,40CS022,89,88,90,99,10,9,11,20,-1.3922919671006042,-1.2912584563023006,-1.1943565256472233,1.816034565696946,109,108,110,120,11,10,12,14,-0.6069301635635962,-0.46227483047412765,-0.3132666350818473,1.1631589301577336,7724,7680,Major and Nearby Counties,Major,40,93,Oklahoma,OK
40151,40CS022,84,84,85,93,9,8,9,3,0.5447726965174996,0.6433884622883528,0.7401837323112687,0.3143585346406107,104,103,105,100,-4,-5,-3,21,-3.6209074616626236,-3.4758317204003832,-3.3311831747357443,-7.395628035531368,8616,8584,Major and Nearby Counties,Woods,40,151,Oklahoma,OK
40101,40CS023,751,723,780,896,145,116,173,108,0.1283376706695782,0.5435015472640705,0.9742598747394792,0.740613306049962,912,878,947,1147,235,200,269,185,0.29998297262067886,0.8838326654325916,1.5018259417067679,0.7854512606861448,66441,66148,Muskogee,Muskogee,40,101,Oklahoma,OK
40103,40CS024,118,117,119,123,5,4,6,12,-0.7305858308554561,-0.6298894944243912,-0.5283693482635984,1.9675745477604838,145,143,146,178,33,32,35,23,1.0042810194577316,1.1457657547564282,1.3087705335536954,0.6680774265244857,10943,10928,Noble+Osage+Pawnee,Noble,40,103,Oklahoma,OK
40113,40CS024,388,368,407,442,54,35,74,43,-0.1891947767135852,0.23832449964590988,0.6520655018284887,0.7772272328708676,477,453,500,615,138,115,162,99,0.4081780140671344,1.0204428095031464,1.6380548380912667,0.7097671055719316,45919,45767,Noble+Osage+Pawnee,Osage,40,113,Oklahoma,OK
40117,40CS024,174,167,181,211,37,30,44,26,0.27736932228148814,0.7145685831467221,1.148729742979756,0.6821542340874795,214,206,222,258,44,36,52,31,0.41539317024681266,1.002139219860293,1.6104156564107053,0.685470026073594,15686,15712,Noble+Osage+Pawnee,Pawnee,40,117,Oklahoma,OK
40105,40CS025,106,105,107,120,14,13,15,14,-0.06327742135187646,0.033390222064365545,0.13002025139339196,0.9147856721171865,128,127,129,164,36,35,37,21,1.7986274308421244,1.9524054722962738,2.095638938030916,0.565865175791884,9417,9302,Nowata+Washington,Nowata,40,105,Oklahoma,OK
40147,40CS025,556,534,579,598,42,19,64,70,-0.9672513788115746,-0.5472831863086293,-0.11270963902214887,1.6463464316091487,683,656,711,786,103,75,130,135,-1.3441608961808964,-0.7374562821706263,-0.13346350410420757,1.3040772263794256,52476,52746,Nowata+Washington,Washington,40,147,Oklahoma,OK
40109,40CS026,6263,5920,6606,7521,1258,915,1601,864,0.03363458904555883,0.4885516520654441,0.9353204447638349,0.6863651107157941,7705,7293,8117,8922,1217,805,1629,1058,-0.4102235088726402,0.22809397879450757,0.8376209320576399,0.8686092081820345,797468,798388,Oklahoma (county),Oklahoma (county),40,109,Oklahoma,OK
40007,40CS027,44,43,44,56,12,12,13,10,0.37229453878015245,0.4726363586433907,0.5726301601393358,0.7469832717300404,52,52,53,63,11,10,11,8,0.4672989430734219,0.6285411637947408,0.771419503264926,0.6904007364134497,5052,4985,Oklahoma Panhandle,Beaver,40,7,Oklahoma,OK
40025,40CS027,24,24,24,22,-2,-2,-2,0,-1.0178562018405954,-0.9220556368612551,-0.8121120707851924,-0,29,29,29,31,2,2,2,4,-1.3269064127618437,-1.1705444588051497,-1.0186348409108699,1.4240413626748514,2265,2254,Oklahoma Panhandle,Cimarron,40,25,Oklahoma,OK
40045,40CS027,42,42,42,44,2,2,2,6,-1.1817852294418658,-1.0712848623743074,-0.9634235757802061,2.0238191552424425,51,51,52,50,-1,-2,-1,5,-2.102166057012955,-1.950157086593147,-1.803694946825474,-42.66469944156037,3764,3760,Oklahoma Panhandle,Ellis,40,45,Oklahoma,OK
40059,40CS027,29,29,30,51,22,21,22,7,4.279433073834895,4.375281626223638,4.477388585304094,0.31109828792990746,35,34,35,38,3,3,4,7,-1.5046713910048641,-1.3567896385128575,-1.2032260313409038,1.591817648664575,3313,3191,Oklahoma Panhandle,Harper,40,59,Oklahoma,OK
40139,40CS027,157,154,159,159,2,0,5,38,-1.78591802420926,-1.6873731614543965,-1.580985629606883,10.900608005250255,189,187,192,161,-28,-31,-26,25,-3.209568639371303,-3.049866124524208,-2.9080112382924974,-0.917700705387894,21084,20926,Oklahoma Panhandle,Texas,40,139,Oklahoma,OK
40153,40CS027,171,162,180,215,44,35,53,28,0.34539600740296755,0.80614824336191,1.2185060157732304,0.6218216515153486,209,199,219,251,42,32,52,34,-0.1579795784063899,0.4606537084430269,1.1305970008216089,0.7915666076953316,20330,20231,Oklahoma Panhandle,Woodward,40,153,Oklahoma,OK
40119,40CS028,512,477,547,568,56,21,91,55,-0.45489695812590775,0.0031645189825746257,0.4509973261467902,0.970078763717491,638,595,680,764,126,84,169,82,0.06334274318150357,0.63838435434854,1.2648353690323189,0.6438627959473382,81647,81931,Payne,Payne,40,119,Oklahoma,OK
40125,40CS029,732,701,764,850,118,86,149,80,0.1103170185003338,0.5212465068680655,0.9640445207376541,0.6741365810833179,900,863,938,1139,239,201,276,146,0.9153831868839788,1.5399164388633384,2.199343422841291,0.6091269079492901,72539,72935,Pottawatomie,Pottawatomie,40,125,Oklahoma,OK
40131,40CS030,792,751,833,929,137,96,178,114,-0.21838937480333329,0.22992116261762402,0.6714995789289031,0.8273769108563572,983,933,1033,1122,139,89,189,167,-0.9427470241850063,-0.3450474040979797,0.2462690019913022,1.1951273547824839,95065,96494,Rogers,Rogers,40,131,Oklahoma,OK
40055,40CS031,57,56,57,73,16,16,17,19,-0.6313437785648794,-0.5331495371065569,-0.43138284043620173,1.1138097413628216,70,69,70,97,27,27,28,4,4.958171543947924,5.114449382084366,5.270493500649591,0.14085484873493267,5519,5487,Southwest Oklahoma,Greer,40,55,Oklahoma,OK
40057,40CS031,25,24,25,39,14,14,15,6,3.317531663677046,3.418228450927072,3.520297712849965,0.3872227317776702,29,29,30,45,16,15,16,7,4.105249233575023,4.255959623504107,4.419709842035314,0.42154183180767313,2486,2425,Southwest Oklahoma,Harmon,40,57,Oklahoma,OK
40065,40CS031,220,210,231,281,61,50,71,55,-0.1555166028464564,0.23589356926840085,0.6470078884642332,0.8898655966298973,272,259,285,287,15,2,28,35,-1.5670360658645626,-0.9825818852316833,-0.35590014801693043,2.161850006505541,24692,24770,Southwest Oklahoma,Jackson,40,65,Oklahoma,OK
40075,40CS031,126,122,129,160,34,31,38,27,0.42690814501112256,0.8680434790573994,1.3123807565746572,0.764694868912531,152,147,156,140,-12,-16,-7,20,-5.1689536981950885,-4.527423135734907,-3.9463363363733626,-1.8439984686512618,8514,8421,Southwest Oklahoma,Kiowa,40,75,Oklahoma,OK
40141,40CS031,77,76,77,106,29,29,30,18,1.4967713272092533,1.5992557517197274,1.6893908266221425,0.5955761893137579,95,94,96,122,27,26,28,18,1.3970658334098671,1.5320395176093857,1.698346904222078,0.6415155187254667,7013,7058,Southwest Oklahoma,Tillman,40,141,Oklahoma,OK
40143,40CS032,5207,4919,5495,5987,780,492,1068,621,-0.16933512993890293,0.23170872349729868,0.670493016087782,0.7952145198591658,6434,6086,6781,7784,1350,1003,1698,1169,-0.3543291954727797,0.318416552789173,0.9058859001928534,0.8650089554427173,667815,672464,Tulsa,Tulsa,40,143,Oklahoma,OK
40145,40CS033,556,521,592,648,92,56,127,64,-0.11108085386241383,0.32809212631412876,0.750882139765202,0.6914507837457543,703,659,746,906,203,160,247,169,-0.13495401193521908,0.4807467112981233,1.1138770768239916,0.8266643081632035,81668,83660,Wagoner,Wagoner,40,145,Oklahoma,OK
41001,41CS001,188,180,195,206,18,11,26,1,0.6236425397810723,1.0587808394153917,1.4483174107182726,0.05149640307820783,231,222,240,274,43,34,52,31,0.15792825902014787,0.8524542570710737,1.4760343839417953,0.7063816284250153,16623,16824,Baker+Harney+Lake+Malheur,Baker,41,1,Oregon,OR
41025,41CS001,75,75,76,78,3,2,3,5,-0.4318193018502108,-0.32926965345595893,-0.2269817744221866,1.4197978285354251,94,93,94,124,30,30,31,30,-0.07842848411287705,0.07829063163816004,0.22745701670808594,0.9524940101787223,7483,7563,Baker+Harney+Lake+Malheur,Harney,41,25,Oregon,OR
41037,41CS001,87,86,88,98,11,10,12,4,0.7995420136392163,0.8986742182742836,0.9992171795188776,0.3253226517072165,108,107,109,144,36,35,37,16,2.7744884377744277,2.9263023756719395,3.0671405039802657,0.43099089122276957,8132,8257,Baker+Harney+Lake+Malheur,Lake,41,37,Oregon,OR
41045,41CS001,269,255,282,326,57,44,71,42,0.06514221643449225,0.48560587653675313,0.9196599561985985,0.7182601553067948,331,314,347,392,61,45,78,46,-0.03443754366337299,0.5789315067373242,1.1929473142983138,0.7401896679360446,31484,31681,Baker+Harney+Lake+Malheur,Malheur,41,45,Oregon,OR
41003,41CS002,519,478,560,504,-15,-56,26,10,-0.6771928697003787,-0.26164938516661373,0.16228897486239963,-0.69975770433841,649,600,699,741,92,42,141,23,0.24011481897253717,0.8594638286938456,1.504698238417122,0.24788412519094788,94956,95893,Benton,Benton,41,3,Oregon,OR
41005,41CS003,2989,2807,3170,3188,199,18,381,116,-0.21746131821422757,0.19794458232907036,0.6556722761129604,0.5792140671402298,3680,3462,3898,4003,323,105,541,302,-0.5142953262117933,0.06496638862644075,0.7060711062172681,0.9317880651910804,421622,422482,Clackamas,Clackamas,41,5,Oregon,OR
41007,41CS004,350,333,368,348,-2,-20,15,5,-0.636030676526138,-0.18447985137593695,0.25232844869523874,-3.508438251662984,433,412,455,542,109,87,130,29,1.627566061425117,2.293908664902174,2.9136114588078006,0.26463075994359303,41036,41705,Clatsop+Lincoln+Tillamook,Clatsop,41,7,Oregon,OR
41041,41CS004,538,517,560,592,54,32,75,14,0.36298070951013367,0.7819553085610549,1.242621575774686,0.25646499911023696,658,632,685,729,71,44,97,34,0.2196319630568618,0.8440595633980392,1.4735752986270796,0.47474978171401955,50462,50805,Clatsop+Lincoln+Tillamook,Lincoln,41,41,Oregon,OR
41057,41CS004,266,254,278,303,37,25,49,1,0.8863837223713132,1.3019079277916126,1.7308699530980456,0.02647013121508492,327,312,341,412,85,71,100,42,1.2457986758349116,1.8818694286164708,2.4670701833340107,0.48642678335819206,27450,27708,Clatsop+Lincoln+Tillamook,Tillamook,41,57,Oregon,OR
41009,41CS005,402,380,425,447,45,22,67,22,-0.02978653884252076,0.42815152462622236,0.8446493893734439,0.4824811277101745,497,469,524,630,133,106,161,58,1.117644511968015,1.6876472103253086,2.352900349615186,0.4319012668660517,52675,53009,Columbia+Washington,Columbia,41,9,Oregon,OR
41067,41CS005,2960,2701,3218,3194,234,-24,493,131,-0.27417053673853886,0.18335942081128584,0.5836316700279154,0.5566205771550012,3675,3365,3986,4150,475,164,785,243,-0.12080326024079341,0.46843419813993503,1.0736607531140039,0.5109786012517712,600737,600793,Columbia+Washington,Washington,41,67,Oregon,OR
41011,41CS006,783,755,811,777,-6,-34,22,10,-0.6675335881149741,-0.2615764704383674,0.19973472469898598,-1.9672669135203842,953,919,986,1138,185,152,219,98,0.9922239928698845,1.604256286836972,2.2321791790411782,0.5263486683664769,64868,64983,Coos+Curry,Coos,41,11,Oregon,OR
41015,41CS006,336,326,346,393,57,47,67,5,1.8157551657112196,2.2364324874260673,2.682770898779984,0.08564656122953047,410,398,422,512,102,90,114,36,2.788259503755533,3.346398791433025,3.975526894710349,0.3494796266946637,23446,23657,Coos+Curry,Curry,41,15,Oregon,OR
41017,41CS007,1368,1282,1454,1333,-35,-121,51,24,-0.7359823241459599,-0.2926003434929961,0.1389559317119658,-0.7152457381197287,1713,1608,1818,1820,107,2,212,167,-0.9268571088805239,-0.3525645390720319,0.2340884888629455,1.5463763069544114,199640,204007,Deschutes,Deschutes,41,17,Oregon,OR
41019,41CS008,1302,1254,1350,1421,119,71,167,35,0.33736936875442675,0.7667304748719234,1.181164937292668,0.2917435933298847,1596,1539,1654,2052,456,398,513,244,1.6349467933846187,2.264781550584272,2.8790522230289453,0.5344748855656712,111267,111870,Douglas,Douglas,41,19,Oregon,OR
41027,41CS009,166,155,176,156,-10,-20,1,12,-1.3436064266893708,-0.9178684852129486,-0.478893597337103,-1.3871398862794446,204,192,217,200,-4,-17,8,17,-1.68424197993376,-1.0408248821684727,-0.4262013434747965,-5.451151896924642,23868,24040,Hood River+Jefferson+Sherman+Wasco,Hood River,41,27,Oregon,OR
41031,41CS009,182,171,192,272,90,80,101,19,2.460049045891373,2.8896912070379943,3.313156460096585,0.20857880819057512,226,213,239,327,101,88,114,37,2.4721844023142685,3.0439631469753134,3.665964967341193,0.3630842965042498,24594,24988,Hood River+Jefferson+Sherman+Wasco,Jefferson,41,31,Oregon,OR
41055,41CS009,17,16,17,16,-1,-1,0,2,-1.8785966007129142,-1.4555599796930614,-1.0122834664549532,6.430800232722243,21,20,22,26,5,4,6,5,-0.41512349091021183,0.19852766291324409,0.8006221818168446,0.7944967161996958,1864,1902,Hood River+Jefferson+Sherman+Wasco,Sherman,41,55,Oregon,OR
41065,41CS009,278,266,289,295,17,6,29,27,-0.7783941993226069,-0.37024594163459573,0.07712946514276786,1.4722059890274282,339,325,353,374,35,21,49,28,-0.3104471291966717,0.3034978846990656,0.9023176858183306,0.7781074877660565,26611,26709,Hood River+Jefferson+Sherman+Wasco,Wasco,41,65,Oregon,OR
41029,41CS010,2084,1988,2180,2242,158,62,254,68,-0.006690395701682678,0.39517478371332393,0.8497272875953487,0.4272024820576492,2551,2435,2666,2925,374,259,490,292,-0.14982761290839705,0.43665021229117773,1.0905269408210414,0.7785092350434724,223053,223684,Jackson,Jackson,41,29,Oregon,OR
41033,41CS011,1068,1030,1106,1112,44,6,82,25,-0.22476921737499217,0.20516069979877083,0.6447973963536616,0.5586540014632234,1305,1259,1350,1583,278,233,324,224,0.1264223801931492,0.7254919490489415,1.350416087453781,0.8022434813885864,88068,88311,Josephine,Josephine,41,33,Oregon,OR
41035,41CS012,719,689,748,779,60,31,90,25,0.11611381658331345,0.5073688016593836,0.9697039314272676,0.40698386038335443,887,851,924,1065,178,141,214,150,-0.16650682394123828,0.47219103209900215,1.0822333460587168,0.8399578617730056,69403,70068,Klamath,Klamath,41,35,Oregon,OR
41039,41CS013,3182,3017,3346,3372,190,26,355,76,-0.12661514824973116,0.286029810203735,0.7366029544191334,0.39754796827313926,3910,3712,4108,4522,612,414,810,233,0.5388051154219302,1.199049825949175,1.7919772000206406,0.38016420813197715,382838,383153,Lane,Lane,41,39,Oregon,OR
41043,41CS014,1155,1099,1210,1247,92,37,148,35,0.016466763371906192,0.4482055925599271,0.8744804447746517,0.3743361735327399,1420,1353,1487,1721,301,234,368,152,0.765841872613326,1.3656703367736955,1.9815487062311774,0.5034518855816272,129127,129707,Linn,Linn,41,43,Oregon,OR
41047,41CS015,2445,2296,2594,2685,240,91,389,182,-0.24917202749369144,0.17034698743756962,0.5678265978508686,0.7552324800934862,3013,2834,3192,3456,443,264,622,304,-0.16956254308705906,0.49757595801361276,1.082410860852843,0.6845380423390778,346495,346985,Marion,Marion,41,47,Oregon,OR
41051,41CS016,4978,4628,5328,5449,471,121,821,389,-0.3229062521256047,0.10339129228700508,0.5165215201086781,0.8236671774922589,6081,5665,6497,6883,802,386,1218,422,-0.027843295100703984,0.5567201489943681,1.1926347308250365,0.5254810705379731,814069,805199,Multnomah,Multnomah,41,51,Oregon,OR
41053,41CS017,631,593,668,669,38,1,76,25,-0.26646476302875133,0.16557828731888627,0.570359401563218,0.6333617108434386,786,740,832,842,56,10,102,68,-0.7916667221162296,-0.1571929486989328,0.41273125568555913,1.1961170161873622,87705,88974,Polk,Polk,41,53,Oregon,OR
41013,41CS018,245,234,256,211,-34,-45,-23,2,-1.8803876735044447,-1.449446207396018,-1.0053432083640632,-0.06069949660569293,308,295,321,321,13,0,26,46,-2.159023465986669,-1.510214377693251,-0.8609474988032364,3.2309078413461907,24930,25620,Umatilla and Nearby Counties,Crook,41,13,Oregon,OR
41021,41CS018,18,18,18,14,-4,-4,-4,5,-4.600426349217578,-4.498483477087577,-4.397736337573523,-1.6702010444966298,22,22,22,37,15,15,15,5,5.826804044750005,5.977823647717827,6.120944640624359,0.31250965062154074,2000,2007,Umatilla and Nearby Counties,Gilliam,41,21,Oregon,OR
41023,41CS018,77,77,78,85,8,7,8,5,0.24922815985922042,0.35495897607635934,0.45623947850842567,0.5854208343547054,95,94,96,111,16,15,17,14,0.19038289350544932,0.34303217109715556,0.49243806612555985,0.8205216152040943,7220,7265,Umatilla and Nearby Counties,Grant,41,23,Oregon,OR
41049,41CS018,77,75,78,96,19,18,21,11,0.5954864023230585,0.6984017025020179,0.8024468479664272,0.5378541621873228,95,93,96,122,27,26,29,14,1.149707044026142,1.3098864031542714,1.4480376672610513,0.49355802807764654,12118,12287,Umatilla and Nearby Counties,Morrow,41,49,Oregon,OR
41059,41CS018,593,559,627,709,116,82,150,60,0.22875863936503033,0.6986805166150307,1.117555689697406,0.5133953877685848,733,692,775,885,152,110,193,101,0.12383246477331647,0.7729981840502183,1.422915307463892,0.6610248105379088,79678,79991,Umatilla and Nearby Counties,Umatilla,41,59,Oregon,OR
41061,41CS018,242,231,254,247,5,-7,16,5,-0.45128390313901445,-0.009161636194619995,0.40009443547299783,0.8751500424382584,297,284,311,373,76,62,89,49,0.555034331621777,1.2232483940928327,1.8181845885618437,0.6380225320706883,26241,26203,Umatilla and Nearby Counties,Union,41,61,Oregon,OR
41063,41CS018,77,76,78,61,-16,-17,-15,3,-2.680415572889587,-2.5813256750888103,-2.4750761732440436,-0.19997100023372208,96,95,97,103,7,6,8,1,0.8444502663243754,1.0052273734008645,1.1597449427407691,0.12059940817948235,7372,7522,Umatilla and Nearby Counties,Wallowa,41,63,Oregon,OR
41069,41CS018,16,15,16,17,1,1,2,6,-3.6002079417943804,-3.167197880324459,-2.7321606141128285,2.455126516219484,19,18,20,21,2,1,3,1,0.15973849473722462,0.760062102955227,1.3827994911385029,0.3438357765741661,1440,1452,Umatilla and Nearby Counties,Wheeler,41,69,Oregon,OR
41071,41CS019,828,781,874,883,55,9,102,37,-0.2635648637550164,0.18012741115846234,0.6046781879114416,0.6566739450231287,1018,962,1074,1251,233,177,289,102,0.8353203909213317,1.4373726061511376,2.0194772147389037,0.4361167028108466,107742,108180,Yamhill,Yamhill,41,71,Oregon,OR
42001,42CS001,907,862,952,996,89,44,134,81,-0.33889934840465663,0.07838088192882804,0.47445569872020654,0.9009349814495708,1114,1060,1168,1232,118,64,172,172,-1.2156968647293995,-0.6387882665781444,0.005097246888283187,1.447350733935822,103681,104079,Adams,Adams,42,1,Pennsylvania,PA
42003,42CS002,11874,11339,12410,12850,976,440,1511,1108,-0.5164642104469473,-0.11535780033654162,0.33092500737288216,1.1346311944718364,14463,13823,15103,15230,767,127,1407,1390,-1.2228065899585912,-0.6116027643385514,-0.011180453492935463,1.8108302377248193,1242797,1239640,Allegheny,Allegheny,42,3,Pennsylvania,PA
42005,42CS003,727,699,755,785,58,30,86,43,-0.20711077317236815,0.22391115431182232,0.6645340955021652,0.733315433038038,885,851,919,1096,211,177,245,185,-0.12241098961717913,0.4744303843795923,1.1417045780128643,0.8727203572378229,65300,65144,Armstrong,Armstrong,42,5,Pennsylvania,PA
42007,42CS004,1872,1800,1944,2109,237,165,309,243,-0.46655374378227155,-0.041198990868173156,0.39718688398626606,1.020719316149537,2279,2193,2366,2431,152,65,238,310,-1.7759039118572912,-1.1356444230274847,-0.525610461666661,2.0324744499394556,167066,166786,Beaver,Beaver,42,7,Pennsylvania,PA
42009,42CS005,479,459,500,635,156,135,176,98,0.765134936854096,1.228853817810482,1.6112959463090815,0.6260374157649443,582,558,607,709,127,102,151,138,-0.9096064494925666,-0.2736907821933645,0.37829319693798424,1.0797059909239866,47573,47470,Bedford+Fulton,Bedford,42,9,Pennsylvania,PA
42057,42CS005,146,139,152,146,0,-6,7,13,-1.279754337705838,-0.8641958607155437,-0.45221377072312624,9.991453058646645,177,170,185,237,60,52,67,44,0.7002339135573955,1.3299449054880796,1.9429329541842435,0.7218069663741712,14539,14527,Bedford+Fulton,Fulton,42,57,Pennsylvania,PA
42011,42CS006,3470,3286,3654,3927,457,273,641,575,-0.6868142065501579,-0.2769756795793822,0.11803974896648621,1.2561249476433742,4268,4046,4489,4822,554,333,776,678,-0.9703968777152829,-0.31989417851975593,0.2637346792720882,1.2210548974730426,427548,429248,Berks,Berks,42,11,Pennsylvania,PA
42013,42CS007,1353,1300,1406,1613,260,207,313,193,0.08933767781509594,0.5389452146238719,0.9507442062509837,0.7396430927484009,1643,1580,1706,1855,212,149,275,302,-1.5005756993653043,-0.914732207548728,-0.27727879635010677,1.4198908824915064,122356,121877,Blair,Blair,42,13,Pennsylvania,PA
42015,42CS008,587,562,613,592,5,-21,30,57,-1.2566525724935247,-0.8841507690952362,-0.45161549907310167,10.107984432953327,720,689,751,837,117,86,148,106,-0.4575380431398707,0.23601008190225678,0.8116138104757019,0.8966014801442905,59945,59887,Bradford+Sullivan,Bradford,42,15,Pennsylvania,PA
42113,42CS008,80,79,80,88,8,8,9,3,0.8190822004444809,0.9239979330777676,1.0263898539378398,0.31884889181606135,98,97,98,131,33,33,34,23,1.9718016003336154,2.133628765476119,2.285075884537879,0.6685181044561707,5859,5864,Bradford+Sullivan,Sullivan,42,113,Pennsylvania,PA
42017,42CS009,5337,5060,5614,6046,709,432,986,875,-0.6769905474315542,-0.26843221659827704,0.13619714422061405,1.232536458862604,6569,6235,6902,6903,334,1,668,589,-1.1239076657856157,-0.4648069066354204,0.1744944251688016,1.7560747018022902,643464,646085,Bucks,Bucks,42,17,Pennsylvania,PA
42019,42CS010,1774,1691,1857,1973,199,116,282,226,-0.5651682591542393,-0.1348545722093308,0.263855044884453,1.1294114193621418,2184,2084,2284,2417,233,133,333,332,-1.1826708719028578,-0.6155733892374838,0.016904221542886837,1.417625130334012,193087,194211,Butler,Butler,42,19,Pennsylvania,PA
42021,42CS011,1594,1537,1651,1844,250,193,307,280,-0.6728477462298711,-0.231599215303402,0.20532218068984348,1.1152365681529024,1938,1869,2006,2069,131,63,200,297,-2.1080775409247994,-1.4944788503114685,-0.8539170654073807,2.244930741261492,132459,132282,Cambria,Cambria,42,21,Pennsylvania,PA
42025,42CS012,685,657,712,827,142,115,170,93,0.3172485798339283,0.7558824507391778,1.1957337441129423,0.6485557315850509,839,805,873,995,156,122,190,143,-0.35571698128006235,0.25326689405277464,0.8978352586776353,0.9109277930652707,64729,65316,Carbon,Carbon,42,25,Pennsylvania,PA
42027,42CS013,826,758,894,1047,221,153,289,141,0.058268633025109415,0.5102676469472939,0.930366178672515,0.6343042997205273,1021,940,1102,1217,196,115,277,127,-0.0768283059516258,0.522897629995405,1.1327170799833994,0.6444730203655114,158495,157586,Centre,Centre,42,27,Pennsylvania,PA
42029,42CS014,3516,3286,3745,3919,403,174,633,555,-0.7142914684406421,-0.28959822291328174,0.13864441424526733,1.3727624775913896,4368,4090,4645,4398,30,-247,308,351,-1.3181137121302093,-0.7071020879392348,-0.11884562862369082,11.193578711511687,533664,538065,Chester,Chester,42,29,Pennsylvania,PA
42031,42CS015,341,325,357,451,110,94,126,48,1.2209978532486676,1.6528938562702777,2.080847604049057,0.43300904320078765,416,397,436,596,180,160,199,116,1.4557256936965732,2.0619295040524768,2.643301150024581,0.6421462166445976,37368,37159,Clarion+Jefferson,Clarion,42,31,Pennsylvania,PA
42065,42CS015,475,456,494,526,51,32,70,58,-0.5777236410329287,-0.14591230116105167,0.25341595708965137,1.1138753401629,578,555,601,635,57,34,80,123,-2.404044238613724,-1.8023782117387994,-1.200857049698847,2.127354753085896,44233,44160,Clarion+Jefferson,Jefferson,42,65,Pennsylvania,PA
42033,42CS016,826,792,861,878,52,17,86,54,-0.43165264675474735,-0.03837717844756436,0.4112840643434655,1.0192414304234327,1011,969,1052,1195,184,143,226,206,-0.9532357595387535,-0.3241554956680497,0.28328508050881723,1.1106325037284452,80185,80128,Clearfield,Clearfield,42,33,Pennsylvania,PA
42035,42CS017,346,330,362,371,25,9,41,29,-0.5035241971218022,-0.11658215854582957,0.30180593975702547,1.126866766103547,426,407,445,481,55,36,74,74,-1.1977584934908836,-0.6321579102323067,0.02802577286936364,1.3200355079333468,37501,37448,Clinton+Potter+Tioga,Clinton,42,35,Pennsylvania,PA
42105,42CS017,181,174,188,188,7,0,14,15,-0.8996296070631188,-0.4702030946887644,-0.05393901364110008,1.7924573042917729,220,212,229,297,77,68,85,63,0.4508096848250031,1.0156311383100205,1.6084758376637383,0.8091276938270106,16373,16273,Clinton+Potter+Tioga,Potter,42,105,Pennsylvania,PA
42117,42CS017,396,379,414,463,67,49,84,79,-0.7182108560902462,-0.2909788249144823,0.12994015488878438,1.1644425441797843,487,466,508,596,109,88,130,103,-0.400799291903651,0.17315981837469807,0.8003636345730161,0.9340531995014728,40920,40935,Clinton+Potter+Tioga,Tioga,42,117,Pennsylvania,PA
42037,42CS018,592,564,620,659,67,39,95,83,-0.6612878014455109,-0.24677230729651578,0.15467707344422268,1.2228716817339687,727,693,760,866,139,106,173,113,-0.13266679488629793,0.4721505048010518,1.0641801674441247,0.8050602090003142,64740,64842,Columbia,Columbia,42,37,Pennsylvania,PA
42039,42CS019,836,800,872,921,85,49,121,90,-0.48063501990636825,-0.0628880198340568,0.37857118601574885,1.0478569518200638,1018,975,1061,1215,197,154,240,153,0.008322066385590646,0.6238250621732762,1.2005061817579283,0.7735525837731141,83786,83405,Crawford,Crawford,42,39,Pennsylvania,PA
42041,42CS020,2098,1986,2209,2361,263,152,375,321,-0.6568071239106821,-0.2201067145778308,0.19667388784964338,1.2141972357049524,2593,2458,2729,2784,191,55,326,365,-1.3725336635100187,-0.7902795569112125,-0.1314391759170663,1.9018480038647325,259300,262493,Cumberland+Perry,Cumberland,42,41,Pennsylvania,PA
42099,42CS020,386,367,406,450,64,44,83,42,0.02788780661214294,0.4698611167809301,0.8907387580753138,0.6505817866199672,473,449,497,580,107,83,131,102,-0.45507112643495734,0.15098582743944064,0.7550218909739085,0.9463965941277754,45912,45962,Cumberland+Perry,Perry,42,99,Pennsylvania,PA
42043,42CS021,2247,2124,2370,2589,342,219,465,329,-0.41334633431874096,0.033843352844379504,0.473692936360635,0.9598027078837369,2770,2622,2919,3169,399,250,547,386,-0.578606704039487,0.062075503325529816,0.6440421264940529,0.965791309154832,285449,287275,Dauphin,Dauphin,42,43,Pennsylvania,PA
42045,42CS022,4758,4511,5006,5578,820,572,1067,979,-0.7021333716751238,-0.2738208097384933,0.13956292772504456,1.1930505414063628,5828,5531,6124,5904,76,-220,373,544,-1.5753324040099947,-0.9719756936164536,-0.31357621661571805,7.028159620821967,574682,574219,Delaware,Delaware,42,45,Pennsylvania,PA
42049,42CS023,2451,2335,2567,2777,326,210,442,259,-0.15912237259429343,0.242967420097735,0.6877698759875129,0.7919828092182707,2994,2855,3133,3384,390,251,529,358,-0.48132530174378646,0.148968301188517,0.8116807405901083,0.9167164798298583,270149,269218,Erie,Erie,42,49,Pennsylvania,PA
42051,42CS024,1507,1452,1562,1679,172,117,227,164,-0.37265946950926904,0.07385654592367895,0.47224371128363507,0.9471351566172691,1821,1756,1887,2251,430,364,495,378,-0.12823328603591094,0.4813956216750612,1.0873836894572035,0.8776102674630958,128391,127144,Fayette+Greene,Fayette,42,51,Pennsylvania,PA
42059,42CS024,375,359,390,401,26,11,42,34,-0.6343861331047946,-0.2046858438299288,0.2074426401233272,1.240460770454775,453,435,472,538,85,66,103,68,-0.02197183657377802,0.5671603133920402,1.1740201963919017,0.7939417750070478,35803,35434,Fayette+Greene,Greene,42,59,Pennsylvania,PA
42055,42CS025,1363,1296,1430,1699,336,269,403,235,0.23097439505835618,0.6507517677625922,1.0627798428153354,0.6964710457281243,1673,1592,1754,2035,362,281,443,289,-0.04288156908908193,0.5479986603850527,1.1371389612498592,0.7958301599680941,155866,156228,Franklin,Franklin,42,55,Pennsylvania,PA
42061,42CS026,395,376,414,489,94,75,113,75,-0.0034094937522333568,0.4238456372516223,0.8710323666423908,0.7919974871055321,482,459,504,567,85,63,108,101,-1.028799705884398,-0.418791015145758,0.20581199025841374,1.1682688964131263,44141,43910,Huntingdon+Juniata+Mifflin,Huntingdon,42,61,Pennsylvania,PA
42067,42CS026,208,198,218,295,87,77,97,64,0.558276837582533,0.9853156376120036,1.4158480972015361,0.725593774586257,252,240,264,355,103,91,115,73,0.9803169676722436,1.556540416357207,2.2204083282729083,0.7006633003494118,23626,23319,Huntingdon+Juniata+Mifflin,Juniata,42,67,Pennsylvania,PA
42087,42CS026,474,454,494,614,140,120,160,126,-0.11178400988588778,0.31677897904554964,0.7254622050106945,0.8940412342016664,579,555,603,656,77,53,101,105,-1.3432415918073277,-0.7060880087197803,-0.14638968556108647,1.3453532368730179,46082,46127,Huntingdon+Juniata+Mifflin,Mifflin,42,87,Pennsylvania,PA
42063,42CS027,761,725,797,935,174,138,210,116,0.24215747766108364,0.6730679434361165,1.1320802426705847,0.6620548518049039,929,886,972,1115,186,143,229,159,-0.20582458577106005,0.3862579348044191,1.0090579070270846,0.8498393570230988,83224,82920,Indiana,Indiana,42,63,Pennsylvania,PA
42069,42CS028,2323,2231,2415,2524,201,109,293,267,-0.7148522086224515,-0.3027666664874031,0.10915853014863024,1.3218161795091434,2853,2741,2964,2904,51,-60,163,315,-2.080955761395821,-1.454664661829047,-0.8713184057482949,6.009732012932004,214699,215642,Lackawanna+Wyoming,Lackawanna,42,69,Pennsylvania,PA
42131,42CS028,269,258,280,278,9,-2,20,30,-1.2616666976341067,-0.7994954442221645,-0.4057102364446303,3.008907307727633,329,316,343,393,64,50,77,54,-0.13904998317210016,0.429859016916794,1.0818955514534934,0.8335305529035186,26120,26029,Lackawanna+Wyoming,Wyoming,42,131,Pennsylvania,PA
42071,42CS029,4410,4172,4647,5188,778,541,1016,748,-0.35038217564544694,0.060834863355170486,0.46832824399228123,0.9595897850139045,5424,5138,5710,5905,481,195,767,739,-1.1843436470081725,-0.5647228440798591,0.059594773957078455,1.5328206579948531,551663,553498,Lancaster,Lancaster,42,71,Pennsylvania,PA
42073,42CS030,994,957,1031,1217,223,186,260,140,0.5431849851191712,0.9703235243374688,1.3959806068986182,0.6244793991934439,1210,1166,1254,1371,161,117,205,196,-1.1214850701666657,-0.4647550468082409,0.1171799749119206,1.2082548485855518,85774,85551,Lawrence,Lawrence,42,73,Pennsylvania,PA
42075,42CS031,1321,1260,1383,1523,202,140,263,156,-0.08943235165297432,0.31866106191557875,0.7870011514500825,0.7696646813609601,1622,1548,1696,1872,250,176,324,226,-0.452888331912547,0.1838929015062893,0.8025420767250581,0.9005834368984026,142988,143456,Lebanon,Lebanon,42,75,Pennsylvania,PA
42077,42CS032,2961,2800,3122,3397,436,275,597,518,-0.6859475235311485,-0.21526235235249697,0.2441814440020904,1.1846567447405882,3646,3452,3840,3968,322,128,516,472,-1.0905424621361601,-0.4713767358227814,0.12519553814379886,1.4621266158188195,373854,375388,Lehigh,Lehigh,42,77,Pennsylvania,PA
42079,42CS033,3543,3404,3683,3970,427,287,566,463,-0.5283901409450122,-0.11985275867475517,0.3153599673883353,1.0830296148934653,4351,4183,4519,4572,221,53,389,534,-1.7633464677119632,-1.161057240490844,-0.535627092860675,2.4062471551657287,324050,325908,Luzerne,Luzerne,42,79,Pennsylvania,PA
42081,42CS034,1096,1047,1145,1268,172,123,221,130,-0.06329093838167209,0.356176578253781,0.8090273158519644,0.7514355722706914,1341,1282,1399,1547,206,148,265,261,-1.2147961490363526,-0.5643783872094249,0.013351635986392241,1.2592034625421196,113883,113660,Lycoming,Lycoming,42,81,Pennsylvania,PA
42023,42CS035,53,52,53,57,4,4,5,5,-0.27603014121887365,-0.17336641043741668,-0.06504530281488152,0.9561831766841881,64,64,65,75,11,10,11,3,1.9117985860243056,2.061164018488457,2.201992351773175,0.2566965723659392,4499,4468,McKean and Nearby Counties,Cameron,42,23,Pennsylvania,PA
42047,42CS035,334,321,347,317,-17,-30,-4,21,-1.6563004578839915,-1.2101558664767804,-0.772032889985436,-1.3182208397155928,408,392,424,467,59,43,75,57,-0.51078366310484,0.07416025075945627,0.666680106928338,0.9485727621348132,30761,30804,McKean and Nearby Counties,Elk,42,47,Pennsylvania,PA
42053,42CS035,71,70,72,87,16,15,17,4,1.6323212389724957,1.7293756755412095,1.8398231189410077,0.23392789419944227,88,87,89,108,20,19,21,21,-0.2697537627812838,-0.12697765596603358,0.02776353072612777,0.9877753039239517,6972,7020,McKean and Nearby Counties,Forest,42,53,Pennsylvania,PA
42083,42CS035,435,418,452,444,9,-8,26,26,-0.8453784161764434,-0.4253177892246764,-0.01316043324424868,2.5576234936773345,528,507,548,630,102,82,123,97,-0.437512992412548,0.16704338074594485,0.7836256401159764,0.9384660185462904,40315,39994,McKean and Nearby Counties,McKean,42,83,Pennsylvania,PA
42123,42CS035,414,398,431,501,87,70,103,40,0.7895809317532252,1.2069802395994496,1.639565166384912,0.4568642256559655,503,483,522,681,178,159,198,90,2.1331802704996963,2.769639799459836,3.4051474784969216,0.5014599528040332,38545,38184,McKean and Nearby Counties,Warren,42,123,Pennsylvania,PA
42085,42CS036,1251,1204,1298,1446,195,148,242,170,-0.19619192995371929,0.23253092997062513,0.6670971865215559,0.8669414957491943,1526,1470,1583,1833,307,250,363,244,0.059413897266870096,0.6732449917268102,1.340186241804936,0.7930456872929464,110144,110025,Mercer,Mercer,42,85,Pennsylvania,PA
42089,42CS037,1281,1209,1354,1540,259,186,331,213,-0.1460679555707752,0.2641655867870441,0.7233205229998496,0.8193681182329188,1579,1492,1667,1808,229,141,316,202,-0.455354021592747,0.1920790152061734,0.8016101179741986,0.8797208526817164,168622,169124,Monroe,Monroe,42,89,Pennsylvania,PA
42091,42CS038,6737,6369,7105,7627,890,522,1258,1168,-0.7425008221301057,-0.3268567739532505,0.10263169448208949,1.3109896146923483,8327,7883,8771,8365,38,-406,482,715,-1.5888605275361005,-0.9609666471808723,-0.3177141596841979,18.50040830765215,853453,860048,Montgomery,Montgomery,42,91,Pennsylvania,PA
42093,42CS039,197,189,205,217,20,12,28,28,-0.8720268843888129,-0.4359670985288861,-0.05245241668180471,1.3220550061199168,240,231,249,253,13,4,22,48,-2.910099173517276,-2.3604296205280595,-1.683156066054473,3.4503715718961074,18122,18091,Montour+Northumberland,Montour,42,93,Pennsylvania,PA
42097,42CS039,996,957,1035,1265,269,230,308,239,-0.12160266034711409,0.3427492086586308,0.7467874945001172,0.8846263354553933,1215,1168,1262,1269,54,7,101,206,-2.604858744708947,-2.028193220822679,-1.4117755764051836,3.7682913214685265,91335,91296,Montour+Northumberland,Northumberland,42,97,Pennsylvania,PA
42095,42CS040,2661,2527,2795,3032,371,237,505,417,-0.5414385828621027,-0.13863198485212724,0.28044951819135355,1.120720317877639,3275,3113,3437,3542,267,105,429,381,-1.031764254332879,-0.4374612439156637,0.19087150755008242,1.4202139974490389,311865,313515,Northampton,Northampton,42,95,Pennsylvania,PA
42101,42CS041,12228,11541,12914,15527,3299,2613,3986,2461,0.10076374645577821,0.5343062691948446,0.9453005920344741,0.7456809061894608,14859,14044,15675,16376,1517,701,2332,1576,-0.6628279416653524,-0.07075207625622695,0.5766671408001206,1.0384781185708911,1596011,1579861,Philadelphia,Philadelphia,42,101,Pennsylvania,PA
42103,42CS042,477,452,502,525,48,23,73,45,-0.3726728596278804,0.06528047901745913,0.502115893153332,0.9122816294506743,597,566,628,684,87,56,118,77,-0.4393506575788754,0.19894137036019452,0.8064723277060496,0.8750249415677952,58330,59754,Pike,Pike,42,103,Pennsylvania,PA
42107,42CS043,1647,1585,1708,1916,269,208,331,239,-0.20244136456953915,0.21980781455065562,0.6480660481703835,0.8838529363074807,2014,1940,2088,2132,118,44,192,261,-1.8086294697784324,-1.1903728316715854,-0.6168147715154091,2.190821467109209,142593,143193,Schuylkill,Schuylkill,42,107,Pennsylvania,PA
42109,42CS044,304,287,321,361,57,40,74,42,-0.05919658666649246,0.3727753224055165,0.7993796939483483,0.724168616691065,374,354,394,428,54,34,74,79,-1.343047140420535,-0.7526764984056619,-0.20386615686750448,1.4360850304269261,39806,39635,Snyder+Union,Snyder,42,109,Pennsylvania,PA
42119,42CS044,306,288,325,390,84,65,102,42,0.5238264305797228,0.9600672432530147,1.4224719177677352,0.49624132020263545,377,355,399,483,106,84,128,78,0.19750170341246615,0.7855060404556204,1.4160872985103863,0.7291118253136585,42892,42576,Snyder+Union,Union,42,119,Pennsylvania,PA
42111,42CS045,824,793,856,950,126,94,157,103,-0.09445166169651545,0.3053459217762964,0.7525014957890689,0.813421809070589,1003,965,1041,1189,186,148,224,212,-1.020929152511248,-0.42821073133076853,0.16000977210578346,1.1348773220973465,73818,73669,Somerset,Somerset,42,111,Pennsylvania,PA
42115,42CS046,394,378,411,465,71,54,87,37,0.47939203894360916,0.8869727269177918,1.306189081857324,0.515729464684429,480,460,500,575,95,75,115,56,0.6146301270976274,1.211910705410757,1.797613978028175,0.5816184476675487,38633,38384,Susquehanna+Wayne,Susquehanna,42,115,Pennsylvania,PA
42127,42CS046,517,495,539,594,77,55,99,29,0.5509907873570673,0.9393416139406524,1.3505669907862743,0.37072796978841366,634,607,660,828,194,168,221,109,1.3303744701687659,1.9912869966717417,2.6256456929736407,0.5587343230347918,51160,51383,Susquehanna+Wayne,Wayne,42,127,Pennsylvania,PA
42121,42CS047,538,516,559,635,97,76,119,58,0.3981951166171834,0.7624827633109652,1.2072113709497123,0.5897018289482345,654,628,680,872,218,192,244,136,1.3185864459814511,1.9704155601245745,2.595443856520874,0.6203744015720154,50327,49987,Venango,Venango,42,121,Pennsylvania,PA
42125,42CS048,2203,2113,2293,2308,105,15,195,135,-0.5763262764985677,-0.13799004268157447,0.29995957047813365,1.27404923139372,2696,2588,2804,2989,293,185,401,354,-0.9967457448666378,-0.3574124506010981,0.2940989144302898,1.2036549313959481,208856,209424,Washington,Washington,42,125,Pennsylvania,PA
42129,42CS049,3880,3728,4032,4253,373,221,525,425,-0.5847933490616911,-0.1616734781449457,0.28431747773096183,1.1367146477521552,4736,4554,4918,5195,459,277,641,589,-1.0702160375158274,-0.4404210410063911,0.12917468929291093,1.2804891988378444,353162,353194,Westmoreland,Westmoreland,42,129,Pennsylvania,PA
42133,42CS050,3645,3449,3841,4231,586,390,782,424,-0.07602564697562095,0.35250735934991717,0.7703470567134093,0.7225218275721758,4495,4259,4732,5251,756,519,992,684,-0.4317938206652036,0.17382986905129447,0.8399592279405399,0.9038286199187896,455601,458360,York,York,42,133,Pennsylvania,PA
44001,44CS001,460,438,481,495,35,14,57,63,-0.9582212099049152,-0.5463907858873784,-0.12182502929807257,1.7336620327536583,564,537,590,591,27,1,54,66,-1.561225045193044,-0.9154631844675508,-0.28777083148565447,2.334436571978005,50433,50808,Bristol+Providence,Bristol,44,1,Rhode Island,RI
44007,44CS001,4959,4676,5242,5966,1007,724,1290,1192,-0.7463162780143348,-0.2836671076791625,0.15952842831551856,1.182562763928002,6080,5741,6420,6213,133,-207,472,626,-1.495535306447479,-0.8869270140287049,-0.2735742324501546,4.688610113052389,656479,658483,Bristol+Providence,Providence,44,7,Rhode Island,RI
44003,44CS002,1556,1483,1629,1691,135,62,208,205,-0.8511846029656951,-0.42248172077779905,0.039336437082185795,1.503427322589344,1917,1828,2005,2092,175,87,264,163,-0.5333432989078247,0.06203130514175652,0.6835682803686521,0.9238896868629681,169476,170658,Kent,Kent,44,3,Rhode Island,RI
44005,44CS003,721,684,757,719,-2,-38,35,38,-0.8806043657187549,-0.4836746271336265,-0.04655570080326396,-71.50322564740961,885,841,929,884,-1,-45,43,52,-1.368549301651573,-0.7516904683024634,-0.12810074738352742,-175.47450358220672,84950,85282,Newport,Newport,44,5,Rhode Island,RI
44009,44CS004,1055,999,1111,1163,108,52,164,87,-0.28949599300706114,0.1584540787099828,0.6162950046216372,0.7978841743799617,1307,1239,1374,1365,58,-9,126,71,-0.7139891376920552,-0.10386309221790263,0.48929948238807613,1.1934926415666454,129275,130470,Washington,Washington,44,9,Rhode Island,RI
45001,45CS001,262,251,272,301,39,29,50,34,-0.2077466234578838,0.20935112753503948,0.6570348423049684,0.8467729472793177,322,310,335,418,96,83,108,41,2.063612820664594,2.70841139944575,3.3187422091804915,0.4240969653929822,24275,24286,Abbeville+Edgefield+Greenwood+McCormick,Abbeville,45,1,South Carolina,SC
45037,45CS001,196,185,207,275,79,68,90,27,1.5571435686791124,1.987141426156889,2.4190771616519418,0.33902266816224785,246,232,259,369,123,110,137,56,2.4762020451858784,3.097466071777512,3.6933384686780597,0.4506139579791033,25969,26083,Abbeville+Edgefield+Greenwood+McCormick,Edgefield,45,37,South Carolina,SC
45047,45CS001,687,657,717,838,151,121,181,84,0.5109831625118145,0.9710444504712576,1.3831652105918115,0.5523912509444243,843,808,879,1014,171,135,206,131,0.05894129416621749,0.6899797357357074,1.3297557671155413,0.7638438200072929,69596,69261,Abbeville+Edgefield+Greenwood+McCormick,Greenwood,45,47,South Carolina,SC
45065,45CS001,138,134,142,136,-2,-6,2,13,-2.005006804690933,-1.5652060432687405,-1.1634926093593152,-13.699879365779976,172,167,177,180,8,3,13,19,-1.9223328529480777,-1.3560865383143337,-0.7585221542958077,2.0652860331823604,9531,9724,Abbeville+Edgefield+Greenwood+McCormick,McCormick,45,65,South Carolina,SC
45003,45CS002,1553,1480,1625,1928,375,303,448,157,0.8589187043985262,1.2898682365046348,1.7485241875781345,0.4170141030575801,1919,1831,2007,2498,579,491,667,390,0.7184970960233017,1.3370678541527041,1.9605016227198084,0.6724970015940852,169544,170522,Aiken,Aiken,45,3,South Carolina,SC
45007,45CS003,1947,1860,2035,2446,499,411,586,295,0.5761083505332047,0.9838101019199634,1.4092273886053412,0.5905788781559083,2405,2298,2512,3024,619,512,726,504,0.029265539881898055,0.6778170014999377,1.256307972193406,0.8127882724858514,204097,206489,Anderson,Anderson,45,7,South Carolina,SC
45013,45CS004,1381,1300,1462,1638,257,176,338,100,0.41162703087777985,0.8420689255113449,1.3135809285918973,0.3870297850814773,1723,1624,1821,2106,383,285,482,184,0.624705085093453,1.2517693858046035,1.8360253883010247,0.47858723693723115,188835,191156,Beaufort,Beaufort,45,13,South Carolina,SC
45015,45CS005,1399,1299,1499,1617,218,118,318,126,-0.010943442449008568,0.38816756550441295,0.8130915700156743,0.5760144388800674,1760,1638,1882,2139,379,257,501,282,-0.15194796574320263,0.4978133774183829,1.092561785511611,0.7426793662918502,231721,235952,Berkeley,Berkeley,45,15,South Carolina,SC
45017,45CS006,149,143,156,193,44,37,50,15,1.6057210280364118,1.999117789906666,2.440656713741442,0.3367730624923528,183,175,190,235,52,45,60,39,0.5220572025868525,1.1180178750582055,1.7374917431776307,0.7316709121927203,14186,14159,Calhoun+Richland,Calhoun,45,17,South Carolina,SC
45079,45CS006,2673,2494,2852,3272,599,420,778,304,0.29786518626242736,0.7149901775102556,1.1403142045101293,0.5066656384726174,3317,3102,3533,3978,661,445,876,429,0.002362102901823099,0.6531273254737918,1.2658983039107121,0.6484583909142205,416785,418047,Calhoun+Richland,Richland,45,79,South Carolina,SC
45019,45CS007,2865,2688,3041,3276,411,235,588,274,-0.10010921741351567,0.3355135351304713,0.7792540758245676,0.6646838685492442,3549,3336,3762,3831,282,69,495,378,-0.9225579013133134,-0.28139707869616193,0.33854453442551163,1.33661528130612,410260,412498,Charleston,Charleston,45,19,South Carolina,SC
45021,45CS008,561,537,585,680,119,95,143,85,0.1649752324310418,0.5983645368061798,1.0266704281302987,0.7077124858637448,685,656,714,929,244,215,273,187,0.6078997839012167,1.2230716491079985,1.8060688655376882,0.7622365823047129,56334,56071,Cherokee,Cherokee,45,21,South Carolina,SC
45023,45CS009,365,351,379,474,109,95,123,46,1.5178100306524291,1.9678661802537265,2.398979024976774,0.41796039630400694,447,430,463,544,97,81,114,85,-0.15868711271472272,0.46301395227661274,1.0715055581365913,0.8658412475556068,32256,32219,Chester+Fairfield,Chester,45,23,South Carolina,SC
45039,45CS009,236,227,245,329,93,84,102,41,2.0234631522373845,2.459515150552388,2.9003543019306437,0.4375792939579924,286,276,297,391,105,94,115,50,2.5341840351308376,3.1865762189067532,3.749250494622455,0.4731037815135851,21054,20714,Chester+Fairfield,Fairfield,45,39,South Carolina,SC
45025,45CS010,432,413,450,597,165,147,184,67,1.845353718220218,2.2642174984497987,2.6842191720231114,0.4024629841111253,526,504,549,687,161,138,183,113,0.716734718709104,1.345101236066361,1.9267727159444217,0.6995196925733089,43605,43267,Chesterfield+Marlboro,Chesterfield,45,25,South Carolina,SC
45069,45CS010,300,289,312,356,56,44,67,38,0.2086800679448788,0.6640104846530768,1.1090415999021825,0.6689077481272547,366,352,379,450,84,71,98,73,-0.09090417508318828,0.5041089961172178,1.1273023553751755,0.8571232903481355,26465,26405,Chesterfield+Marlboro,Marlboro,45,69,South Carolina,SC
45027,45CS011,321,308,335,501,180,166,193,77,2.824215221421945,3.243677138879073,3.6934466992662998,0.426335949970826,391,375,407,563,172,156,188,70,3.2881355649290787,3.942935591766844,4.572242278461613,0.40505382269810475,31481,31034,Clarendon+Williamsburg,Clarendon,45,27,South Carolina,SC
45089,45CS011,357,344,370,469,112,99,125,79,0.6488915065401422,1.080066649835888,1.522754853581995,0.6988541535318042,434,418,450,537,103,87,119,72,0.5961642722800787,1.2616730058389383,1.8134367304237926,0.6905900926758569,30764,30545,Clarendon+Williamsburg,Williamsburg,45,89,South Carolina,SC
45031,45CS012,690,663,717,879,189,162,216,101,0.9816687641162498,1.372564074865822,1.82868043015194,0.5322441698007304,840,807,872,1097,257,225,290,154,1.3648989769564257,1.9806269259562286,2.5560838671293995,0.5958420608582361,63382,62766,Darlington,Darlington,45,31,South Carolina,SC
45033,45CS013,304,292,316,461,157,145,169,48,3.3919094187066556,3.8138350469282343,4.242315495858721,0.30385598813592024,368,354,383,500,132,117,146,65,2.274749231156493,2.8193259473707553,3.4647009451339432,0.49021038722005483,28565,28116,Dillon+Marion,Dillon,45,33,South Carolina,SC
45067,45CS013,340,328,353,468,128,115,140,80,1.2413691167539078,1.636010230956996,2.0394231545987975,0.6205556542245733,412,397,426,517,105,91,120,80,0.4738186236782366,1.0621485274582467,1.6658044312175653,0.7512487982778958,29238,28822,Dillon+Marion,Marion,45,67,South Carolina,SC
45035,45CS014,1037,967,1107,1252,215,145,285,103,0.2494998150843286,0.6872329794002545,1.0966557978695501,0.4774683366838717,1288,1204,1372,1587,299,215,383,229,-0.07985874119006199,0.5139336128260785,1.164758233531535,0.7638927206055369,162341,163130,Dorchester,Dorchester,45,35,South Carolina,SC
45041,45CS015,1317,1259,1376,1751,434,375,492,240,1.000955777228663,1.4287068561668328,1.850882914495946,0.5522656388784594,1616,1546,1687,2058,442,371,512,275,0.8633810698582678,1.4515859804818347,2.0426445026008486,0.6210617921927133,136967,136548,Florence,Florence,45,41,South Carolina,SC
45043,45CS016,687,660,714,885,198,171,225,91,1.2454595378779931,1.706146048887209,2.1197512280170603,0.4571606448796111,845,812,878,1052,207,174,240,126,0.9101434805871366,1.5305148616581876,2.1642486811820536,0.6050176019575875,63430,63851,Georgetown,Georgetown,45,43,South Carolina,SC
45045,45CS017,3872,3645,4099,4546,674,447,901,449,-0.005248279732456333,0.4242680583753612,0.849111151646153,0.665085689678147,4801,4526,5076,5772,971,696,1246,881,-0.38649605613041016,0.19910167617007452,0.8859030839143904,0.9064112853228026,527368,532834,Greenville,Greenville,45,45,South Carolina,SC
45005,45CS018,91,90,92,119,28,27,29,14,1.5990417247960753,1.6987516508521587,1.8007440198426243,0.48805692050920024,110,109,111,154,44,43,45,17,3.980011155047515,4.1291689929657105,4.284844890338219,0.37682511822758163,8069,7877,Hampton and Nearby Counties,Allendale,45,5,South Carolina,SC
45009,45CS018,160,154,166,205,45,39,51,31,0.6707327763865268,1.0667253576697973,1.4890063314021496,0.6709585622175752,195,188,201,237,42,36,49,24,1.093245022556256,1.6684709537852893,2.3187118850074975,0.5527370808732329,13370,13198,Hampton and Nearby Counties,Bamberg,45,9,South Carolina,SC
45011,45CS018,219,210,228,296,77,68,86,34,1.627608982899256,2.0802993655633384,2.5057518837679558,0.437755351954879,270,259,281,317,47,36,58,51,-0.8610781129065002,-0.23821182186285142,0.3634138058892859,1.0618456556849576,20620,20578,Hampton and Nearby Counties,Barnwell,45,11,South Carolina,SC
45029,45CS018,474,458,491,558,84,67,100,59,0.19663422789970456,0.6437597273337279,1.0801293508733303,0.6974625393057889,583,563,603,729,146,126,166,122,0.11889306676169953,0.7780036835987973,1.3948371056951243,0.8279076789598055,38412,38474,Hampton and Nearby Counties,Colleton,45,29,South Carolina,SC
45049,45CS018,199,191,207,250,51,43,59,31,0.6806869881255913,1.0879703449105724,1.506513960122924,0.5957684444701565,241,232,250,294,53,44,62,36,0.48754215253662425,1.1319544176897895,1.6899685310607144,0.6670199288905735,18595,18228,Hampton and Nearby Counties,Hampton,45,49,South Carolina,SC
45053,45CS018,227,214,240,269,42,29,55,24,0.17495838258023258,0.6108019600188369,1.020439716303807,0.5591654158505083,290,275,306,386,96,80,111,68,0.5330180440897005,1.1010519251847457,1.6925126781486084,0.7024258303310544,29381,30142,Hampton and Nearby Counties,Jasper,45,53,South Carolina,SC
45051,45CS019,3289,3137,3442,4023,734,581,886,353,0.649159090170996,1.083769201406701,1.5004567801421773,0.48059519020582014,4129,3941,4317,5244,1115,927,1303,639,0.9471329361284712,1.5788295929386744,2.245935190909148,0.5724805036974943,354891,363817,Horry,Horry,45,51,South Carolina,SC
45055,45CS020,598,569,626,716,118,90,147,73,0.2507484268195714,0.6892676014946448,1.107637971666057,0.6114250487380606,739,705,773,984,245,211,279,124,1.5733887144154544,2.18539819400673,2.777232924647073,0.5042644017603175,65775,66043,Kershaw+Lee,Kershaw,45,55,South Carolina,SC
45061,45CS020,202,195,209,267,65,58,72,51,0.385966368785776,0.8327809213906835,1.2363840597270006,0.7773729479342175,245,237,253,297,52,44,60,53,-0.7257497470131741,-0.061955144239257846,0.5481286055343481,1.0005124173000666,16498,16306,Kershaw+Lee,Lee,45,61,South Carolina,SC
45057,45CS021,816,774,858,968,152,110,194,94,0.1575673510134131,0.59019273002011,1.0172171893428334,0.6150418698368746,1026,975,1078,1273,247,195,298,174,0.25610701318733514,0.8612768040482988,1.4659811181115028,0.7028375578370953,97273,99799,Lancaster,Lancaster,45,57,South Carolina,SC
45059,45CS022,745,716,774,851,106,77,135,79,-0.030657514544885772,0.39603654581727366,0.8128894913110895,0.7376169806833173,915,880,950,1127,212,177,247,180,-0.04719143878780443,0.5686111731498998,1.1815292416563392,0.8458117638536042,67562,67766,Laurens,Laurens,45,59,South Carolina,SC
45063,45CS023,2200,2073,2327,2618,418,291,545,235,0.21150293148928573,0.6103728939679189,1.051190305301981,0.5607740599977467,2740,2585,2894,3290,550,396,705,405,-0.06218604622624982,0.5592452948831655,1.2183235494401055,0.7348447833308543,296098,299372,Lexington,Lexington,45,63,South Carolina,SC
45071,45CS024,364,348,381,488,124,107,140,67,1.0447571236589293,1.4973976329889913,1.9137300123261602,0.5379163386441205,444,425,464,561,117,97,136,71,0.8594368103593713,1.4591818673479597,2.053047559480981,0.6030808243574202,37845,37955,Newberry+Saluda,Newberry,45,71,South Carolina,SC
45081,45CS024,168,160,177,267,99,90,107,30,3.176605847538999,3.5959329496501367,4.015274578342031,0.30131489934847516,203,194,213,285,82,72,91,44,1.7854015543719404,2.403719807097048,3.0493144505281222,0.5317729507456507,19055,18822,Newberry+Saluda,Saluda,45,81,South Carolina,SC
45073,45CS025,801,767,835,869,68,34,102,75,-0.4910982910810575,-0.08279866721784397,0.35683473229001134,1.0822302240879165,985,944,1025,1192,207,167,248,205,-0.5331131481449386,0.058088935709613335,0.6630882739001135,0.9834296216114897,78815,79121,Oconee,Oconee,45,73,South Carolina,SC
45075,45CS026,881,845,918,1155,274,237,310,132,1.2346296185114962,1.6797166761198792,2.0909183776408957,0.48083663514017566,1069,1026,1112,1416,347,304,390,190,1.6697803996309704,2.2553659459346007,2.890996319722827,0.5462712096560078,84186,83107,Orangeburg,Orangeburg,45,75,South Carolina,SC
45077,45CS027,1108,1052,1165,1319,211,154,267,145,0.04010013301940925,0.49600651640581506,0.9136554608371971,0.6844772657353357,1370,1302,1438,1697,327,259,395,296,-0.3447435209025481,0.30124836868590166,0.9174539654141106,0.9022661868260342,130992,132138,Pickens,Pickens,45,77,South Carolina,SC
45083,45CS028,2833,2691,2975,3356,523,381,665,382,-0.032202964212645485,0.43485058615636124,0.8734395956277183,0.7288718673255442,3518,3345,3691,4304,786,613,959,803,-0.6526392573403442,-0.05143444018451344,0.589187772040517,1.020703679516805,328713,334916,Spartanburg+Union,Spartanburg,45,83,South Carolina,SC
45087,45CS028,328,317,340,409,81,69,92,43,0.9409217039825022,1.3997724693954223,1.8259007117279977,0.5271299968088438,398,384,412,516,118,104,132,71,1.4526822548141411,2.0863634491397645,2.730371530041311,0.5950232294376413,27145,27035,Spartanburg+Union,Union,45,87,South Carolina,SC
45085,45CS029,963,917,1008,1223,260,215,306,127,0.8246983451031773,1.2662462219674404,1.6970210849587677,0.48580606920336866,1173,1119,1227,1510,337,283,391,206,0.8890985818342505,1.4868720938231161,2.142058664057794,0.6094417957466636,105526,104854,Sumter,Sumter,45,85,South Carolina,SC
45091,45CS030,1932,1810,2055,2240,308,185,430,224,-0.1411300322206472,0.2802422491595748,0.7395211888471322,0.7259473380074761,2408,2259,2556,2795,387,239,536,370,-0.5431777822490816,0.08118051478362485,0.7061207920909514,0.9524228096183831,284038,287910,York,York,45,91,South Carolina,SC
46005,46CS001,174,166,182,195,21,13,29,36,-1.1828281854732567,-0.7738370868490163,-0.3718495187177939,1.6351245739999631,213,204,223,184,-29,-39,-20,13,-3.3116415272057944,-2.6914092149029836,-2.0745254573094076,-0.45779809467506116,19033,19125,Clark and Nearby Counties,Beadle,46,5,South Dakota,SD
46025,46CS001,35,35,36,34,-1,-2,-1,0,-0.4467812586362432,-0.3433010113355886,-0.24867905218945807,-0,43,43,44,31,-12,-13,-12,6,-5.856111042602836,-5.697251947375989,-5.527947594842171,-0.5308795501663185,3834,3854,Clark and Nearby Counties,Clark,46,25,South Dakota,SD
46029,46CS001,210,198,223,300,90,77,102,68,0.344611709846823,0.7657183895636738,1.1800281630550564,0.7507061716434018,260,245,274,280,20,6,35,17,-0.46603658021008204,0.13735324382420092,0.7214567469642755,0.7916238543746432,28290,28410,Clark and Nearby Counties,Codington,46,29,South Dakota,SD
46039,46CS001,40,40,40,40,-0,-0,0,4,-1.0338908658474986,-0.9352193890009033,-0.830006414172719,4.111263483779964,49,48,49,41,-8,-8,-7,4,-3.3726439805901656,-3.2284221956158388,-3.091813622659874,-0.61328846393054,4301,4276,Clark and Nearby Counties,Deuel,46,39,South Dakota,SD
46057,46CS001,54,54,55,90,36,35,36,28,1.1189037751305118,1.2187790329371597,1.3167289287411363,0.7666935446305471,67,66,68,53,-14,-15,-13,5,-3.8187180787527244,-3.6655977817855163,-3.5099785912585872,-0.38276313244536597,6184,6242,Clark and Nearby Counties,Hamlin,46,57,South Dakota,SD
46077,46CS001,56,56,57,57,1,0,1,12,-2.2844087474545867,-2.18881737347706,-2.0809119077103624,6.9603928285995105,69,68,70,72,3,2,4,8,-1.2993207982831692,-1.1586048817639873,-0.992361059448934,1.9991570712448459,5165,5195,Clark and Nearby Counties,Kingsbury,46,77,South Dakota,SD
46115,46CS001,61,60,61,95,34,34,35,20,2.1258988741035996,2.2304049094720098,2.322764474005152,0.5688606332323628,73,73,74,68,-5,-6,-5,10,-3.1033796758557894,-2.955909425536386,-2.8034345795859563,-2.2354435859090964,6340,6279,Clark and Nearby Counties,Spink,46,115,South Dakota,SD
46027,46CS002,94,93,96,98,4,2,5,12,-0.6504443838757918,-0.5472949951173758,-0.45157858894705794,2.4643241675374767,118,116,119,115,-3,-4,-1,5,-0.7495881861079434,-0.5966213222270729,-0.4246651192824477,-3.3296936552002667,14882,15128,Clay+Turner+Union+Yankton,Clay,46,27,South Dakota,SD
46125,46CS002,92,92,93,127,35,34,35,37,-0.37789362944106814,-0.2749167616877838,-0.1690732389153495,1.0391029357562083,114,113,115,109,-5,-6,-4,4,-1.399229009818043,-1.249376501022548,-1.0845921683927298,-0.9892662700147787,8625,8703,Clay+Turner+Union+Yankton,Turner,46,125,South Dakota,SD
46127,46CS002,119,117,121,142,23,21,25,26,-0.2730054900409946,-0.1723791630669639,-0.07530950155847022,1.078081680680287,147,145,149,130,-17,-19,-15,8,-1.9495165314000076,-1.7843228079388156,-1.6409945760625102,-0.4952407040077985,16715,16866,Clay+Turner+Union+Yankton,Union,46,127,South Dakota,SD
46135,46CS002,215,205,225,228,13,3,23,27,-1.0284185438279372,-0.6140725493242577,-0.1467828034084462,1.9220110315182677,263,251,275,268,5,-7,17,13,-1.0341451647812547,-0.4106257252140058,0.181847209035491,2.3204221669696214,23186,23288,Clay+Turner+Union+Yankton,Yankton,46,135,South Dakota,SD
46003,46CS003,25,24,25,41,16,16,17,11,1.8360521304797552,1.9314648349783008,2.029804704259761,0.6363627693494497,31,30,31,46,15,15,16,6,3.988092653388425,4.143370947314518,4.2965867094281,0.3642639991496348,2737,2746,Douglas and Nearby Counties,Aurora,46,3,South Dakota,SD
46009,46CS003,69,68,69,95,26,26,27,21,0.6512640147632685,0.7590533320953449,0.8472123304989888,0.7701338862007242,85,84,86,105,20,19,21,2,2.935921238495478,3.0798569008442622,3.2447885788791857,0.09513989148495366,6973,7009,Douglas and Nearby Counties,Bon Homme,46,9,South Dakota,SD
46015,46CS003,47,46,47,48,1,1,2,4,-0.5822973078236284,-0.48159483705609635,-0.3797766968696319,1.6253657421657628,57,57,58,49,-8,-9,-8,5,-3.1663909366450156,-3.02224124776336,-2.874363970240899,-0.6936797370055444,5255,5245,Douglas and Nearby Counties,Brule,46,15,South Dakota,SD
46023,46CS003,97,96,98,130,33,32,34,16,1.7248220093234479,1.821013607598483,1.9296296627242038,0.47086992580372894,118,116,119,117,-1,-2,1,13,-1.924376525818486,-1.7742921663603175,-1.6351904774429575,31.057931609934737,9322,9190,Douglas and Nearby Counties,Charles Mix,46,23,South Dakota,SD
46035,46CS003,193,184,201,221,28,20,37,52,-1.6389121178538868,-1.1855959193055639,-0.7420667197236435,1.7731335845220946,236,225,246,235,-1,-11,10,14,-1.4438443862780719,-0.8704395224774811,-0.233380772331814,40.89234713996449,19920,19886,Douglas and Nearby Counties,Davison,46,35,South Dakota,SD
46043,46CS003,38,37,39,44,6,5,7,10,-1.7395501294865272,-1.347428712639404,-0.8905052635397979,1.3930151619071358,46,44,47,47,1,-0,3,7,-3.138274121255336,-2.5116188263655843,-1.9177222010753048,3.3698684918660202,2836,2821,Douglas and Nearby Counties,Douglas,46,43,South Dakota,SD
46067,46CS003,96,95,97,103,7,6,8,16,-1.3074006891284176,-1.210469369737407,-1.1106451940826165,1.9859537380768486,118,117,119,109,-9,-10,-8,5,-2.420664608211054,-2.2608735027153517,-2.1071147224584013,-0.6263962420558111,7393,7411,Douglas and Nearby Counties,Hutchinson,46,67,South Dakota,SD
46083,46CS004,267,239,295,323,56,28,84,66,-0.5911629569408077,-0.16203974673681454,0.31535421971909045,1.1607816191170202,345,310,380,309,-36,-71,-1,14,-1.5237844841214359,-0.8824541267388237,-0.27198275171250197,-0.39599489780721886,65210,67541,Lincoln+Minnehaha,Lincoln,46,83,South Dakota,SD
46099,46CS004,1301,1216,1386,1619,318,233,403,267,-0.1812489602560854,0.2323599530599263,0.7030447425262945,0.8372376155129114,1620,1517,1723,1684,64,-39,167,124,-0.9467337982795755,-0.3652751361640206,0.26491156240329883,1.9186964555125858,197248,199368,Lincoln+Minnehaha,Minnehaha,46,99,South Dakota,SD
46011,46CS005,166,152,181,221,55,40,69,29,0.28460970256617274,0.7394899114528836,1.1671757122416322,0.5217293230939243,208,190,226,202,-6,-24,12,5,-1.0147717170100388,-0.3730452756953146,0.2392081032922762,-0.9414406357746082,34534,34595,Miner and Nearby Counties,Brookings,46,11,South Dakota,SD
46061,46CS005,21,21,22,19,-2,-3,-2,4,-1.9079061936421702,-1.810611364510167,-1.7031547078783786,-3.151494741738499,27,26,27,34,7,7,8,2,1.7251714599395944,1.8793410059271136,2.0214727335005165,0.236087919604357,3466,3499,Miner and Nearby Counties,Hanson,46,61,South Dakota,SD
46073,46CS005,20,19,21,32,12,11,13,15,-2.259042762969031,-1.8430014518903206,-1.438123174618888,1.168691865503861,24,23,25,12,-12,-13,-11,2,-10.840544352778958,-10.196749847188087,-9.575969445335646,-0.18313545365759662,1707,1639,Miner and Nearby Counties,Jerauld,46,73,South Dakota,SD
46079,46CS005,89,88,90,91,2,1,3,14,-1.1368817876069195,-1.043991773254062,-0.9488125391943832,4.29598102048829,106,104,107,118,12,11,14,4,0.7761360531507913,0.9200221401989175,1.077095167970805,0.29895036511513967,11250,10874,Miner and Nearby Counties,Lake,46,79,South Dakota,SD
46087,46CS005,63,63,64,80,17,16,17,23,-1.2106845278755538,-1.1134317542840895,-1.016908981090209,1.2982206561667087,78,77,79,74,-4,-5,-3,2,-1.445755080673008,-1.3078661607003066,-1.1585531200139143,-0.6260224770833993,5650,5690,Miner and Nearby Counties,McCook,46,87,South Dakota,SD
46097,46CS005,27,26,28,26,-1,-2,-0,2,-1.9231994347157155,-1.4896065109520416,-1.0283257039888918,-4.818608814351461,34,33,35,40,6,5,7,3,1.0413339925407439,1.6954067282348586,2.2924718180274235,0.41238554710688835,2285,2311,Miner and Nearby Counties,Miner,46,97,South Dakota,SD
46101,46CS005,49,48,49,67,18,18,19,15,0.3931697423701521,0.49499814461474384,0.592862149847359,0.7834661977152393,60,59,61,71,11,10,12,11,-0.10884891145717275,0.043229951156202526,0.18496920393202085,0.9010742514882126,6357,6316,Miner and Nearby Counties,Moody,46,101,South Dakota,SD
46111,46CS005,22,22,22,18,-4,-4,-4,3,-3.1346497234313384,-3.032709823461378,-2.929241964522633,-0.9781664634892591,28,27,28,30,2,2,3,6,-1.970600552218085,-1.8201482512518063,-1.679220535202064,1.7618127726024186,2328,2369,Miner and Nearby Counties,Sanborn,46,111,South Dakota,SD
46017,46CS006,26,25,27,31,5,4,6,12,-3.9010465727466355,-3.4496579267939844,-3.0102594380654324,1.918784340282408,31,30,32,53,22,21,23,3,11.217367707254526,11.755907368668723,12.383326126756447,0.13109701613646155,1947,1926,North Central South Dakota,Buffalo,46,17,South Dakota,SD
46021,46CS006,13,12,13,16,3,3,4,8,-3.431191734102532,-3.333371371609902,-3.2279431485906063,1.8102807873532005,15,15,15,25,10,10,10,8,1.3519360090053383,1.5089548499774401,1.6565474216072409,0.74535624842847,1376,1379,North Central South Dakota,Campbell,46,21,South Dakota,SD
46045,46CS006,34,34,35,42,8,7,8,10,-0.7329328799536761,-0.6306395265379373,-0.522419596044667,1.175596425816198,42,42,43,59,17,16,17,4,3.6141350769607117,3.7633533080908914,3.924689168671397,0.226807472050811,3965,4025,North Central South Dakota,Edmunds,46,45,South Dakota,SD
46049,46CS006,24,24,25,38,14,13,14,4,4.371001719702858,4.469291719089804,4.571930881980883,0.27333235165108877,29,29,30,30,1,0,1,6,-3.109407172269009,-2.950242511647918,-2.7927351550853916,3.434841219862362,2155,2136,North Central South Dakota,Faulk,46,49,South Dakota,SD
46059,46CS006,41,40,43,42,1,-1,2,3,-1.19605286254463,-0.7856136092864124,-0.30841505813157777,1.9077578699991522,50,48,52,58,8,6,10,4,0.9300271527684322,1.533722271007609,2.189442423881198,0.44859638479917063,3132,3100,North Central South Dakota,Hand,46,59,South Dakota,SD
46065,46CS006,156,148,163,175,19,12,27,28,-0.9249778560803661,-0.47134203361012955,-0.010827183855867574,1.3793180755661696,192,183,201,209,17,8,26,20,-0.808346558744288,-0.18522974065008746,0.3742671211165634,1.0915519473732602,17671,17695,North Central South Dakota,Hughes,46,65,South Dakota,SD
46069,46CS006,18,18,18,20,2,2,2,5,-2.707700947723619,-2.6120969558101685,-2.5061756787625327,1.8450919966091373,22,22,22,36,14,14,14,8,5.8581023117199775,6.01177231705694,6.166349025376603,0.5260507861876613,1261,1239,North Central South Dakota,Hyde,46,69,South Dakota,SD
46085,46CS006,30,29,30,51,21,21,22,3,4.77401305111991,4.879010448500888,4.976642242477814,0.13518131578585804,36,36,37,50,14,13,14,1,3.893611714191548,4.05531696269174,4.21682461098655,0.06807496318985934,3730,3757,North Central South Dakota,Lyman,46,85,South Dakota,SD
46089,46CS006,32,31,33,30,-2,-3,-1,2,-1.9824942639715977,-1.57952094247217,-1.137406722283899,-2.615017433365659,39,38,40,37,-2,-3,-1,1,-2.122471814448827,-1.5061309940512178,-0.8553847587883083,-0.9629469133392179,2398,2417,North Central South Dakota,McPherson,46,89,South Dakota,SD
46107,46CS006,32,31,33,34,2,1,3,5,-1.8216050804978399,-1.3841622755621004,-0.9506364910063065,1.894925871970698,40,39,41,32,-8,-9,-7,1,-5.008974574833869,-4.333715289264106,-3.7353132834304725,-0.14341043712127466,2424,2474,North Central South Dakota,Potter,46,107,South Dakota,SD
46117,46CS006,17,16,17,18,1,1,2,6,-1.6273484509786873,-1.5187690860733765,-1.4205343745606958,2.4622932611596435,20,20,20,33,13,13,13,2,4.16041400964053,4.316088319275931,4.474642357885093,0.1440110716200705,3004,3024,North Central South Dakota,Stanley,46,117,South Dakota,SD
46119,46CS006,11,11,11,10,-1,-1,-1,3,-2.9390521491453274,-2.841523047697251,-2.736925439864783,-34.539064474238224,14,14,14,15,1,1,1,8,-5.622693258577242,-5.4627500603384656,-5.314837303860491,3.4926808874390165,1439,1472,North Central South Dakota,Sully,46,119,South Dakota,SD
46129,46CS006,61,61,62,69,8,7,8,14,-1.2557984377523692,-1.1517652069903563,-1.0426371983334672,1.5733375287537048,73,73,74,86,13,12,13,5,1.6033739542804204,1.7546115173133177,1.8973727261229447,0.36576955627951857,5304,5254,North Central South Dakota,Walworth,46,129,South Dakota,SD
46013,46CS007,299,283,316,390,91,74,107,58,0.4668468755544165,0.8402490866963481,1.29186956639353,0.6328205419350613,366,346,385,372,6,-13,26,38,-1.6594539873405647,-0.9814706334184682,-0.3182271606721993,5.0952240361500465,38297,38117,Northeast South Dakota,Brown,46,13,South Dakota,SD
46037,46CS007,63,63,64,93,30,29,30,25,0.7478518293975933,0.8454712193515601,0.9421432691064164,0.8180158469923511,77,77,78,71,-6,-7,-6,6,-2.9234144214082347,-2.7724067418589264,-2.6175660327632624,-1.0936705412242476,5422,5416,Northeast South Dakota,Day,46,37,South Dakota,SD
46051,46CS007,78,77,78,94,16,16,17,33,-2.3222648403169384,-2.2251225595608286,-2.1243777008368223,1.896882008379089,96,95,97,96,0,-1,1,2,-0.4117228814238223,-0.2573070099132773,-0.11019280526911865,1.4727599936994729,7468,7521,Northeast South Dakota,Grant,46,51,South Dakota,SD
46091,46CS007,33,33,34,41,8,7,8,7,0.018801517394350178,0.11581184488227217,0.21622087485053856,0.8216419171829624,40,40,41,53,13,12,13,5,2.006769562605265,2.1610271110768626,2.299819476680134,0.36376315071735266,4390,4303,Northeast South Dakota,Marshall,46,91,South Dakota,SD
46109,46CS007,95,94,96,108,13,12,14,29,-1.6854135181227656,-1.578083427255935,-1.4721107725796774,2.1013354704314873,116,114,117,120,4,3,6,10,-0.7859478878370348,-0.655439646921473,-0.5089251413571908,1.8356677461909858,10268,10177,Northeast South Dakota,Roberts,46,109,South Dakota,SD
46019,46CS008,95,94,96,101,6,5,7,19,-1.3264424391130556,-1.2273549246269266,-1.1276752627748987,2.5707962859680062,117,116,119,141,24,22,25,22,0.02383836744123654,0.18400240070598214,0.3336109734968342,0.8944901793093867,10295,10426,Northwest South Dakota,Butte,46,19,South Dakota,SD
46031,46CS008,40,40,40,56,16,16,16,14,0.3939485064604454,0.4852426265041273,0.590055222928081,0.827855784036855,49,48,49,56,7,7,8,4,0.9103444523268693,1.0678961543561718,1.21230035310461,0.473709408766236,3918,3875,Northwest South Dakota,Corson,46,31,South Dakota,SD
46041,46CS008,46,45,47,82,36,35,37,16,3.6544121711743243,3.757247363869443,3.8499391276800927,0.43259022550817766,56,55,56,92,36,36,37,11,5.6765656912236775,5.818367166466232,5.974871838161166,0.29389534067842443,5322,5243,Northwest South Dakota,Dewey,46,41,South Dakota,SD
46063,46CS008,11,11,11,11,0,0,0,6,-4.499028376936412,-4.4019735737581005,-4.304209714113561,4.985885797252127,13,13,14,10,-3,-4,-3,5,-7.69506372365616,-7.547277333388859,-7.38479728680305,-2.1440052874969,1317,1326,Northwest South Dakota,Harding,46,63,South Dakota,SD
46081,46CS008,210,199,221,248,38,27,49,36,-0.3239883443114277,0.0857696517316173,0.49743072948509653,0.9150353104333103,261,247,274,303,42,29,56,36,-0.3889942104106827,0.2925731362615184,0.8630639350891319,0.8279821230040915,25863,26114,Northwest South Dakota,Lawrence,46,81,South Dakota,SD
46093,46CS008,195,182,208,193,-2,-15,11,18,-1.0769351828667266,-0.6759495574460089,-0.2281522968545532,-14.488647615081309,245,229,260,245,0,-15,16,28,-1.776967325180928,-1.0981272330586513,-0.4656753207427463,19.75786883288594,29684,30126,Northwest South Dakota,Meade,46,93,South Dakota,SD
46105,46CS008,32,32,32,45,13,13,13,11,0.5812524736102431,0.686095703379152,0.7886631352526693,0.7889758426261151,39,39,40,33,-6,-7,-6,2,-3.6271708335097776,-3.474119149709397,-3.328550383158914,-0.3877428644123794,2825,2820,Northwest South Dakota,Perkins,46,105,South Dakota,SD
46137,46CS008,14,13,14,23,9,9,10,3,2.489046692776962,2.5882597383535173,2.6857399811245646,0.29055508740461916,16,16,17,41,25,24,25,4,10.241083263275831,10.391343934477375,10.546866775578012,0.15613815537356054,2447,2381,Northwest South Dakota,Ziebach,46,137,South Dakota,SD
46103,46CS009,815,768,862,1003,188,141,235,129,0.11343741742814682,0.5237240948859186,0.9645420859868459,0.6826917513502097,1017,960,1075,1251,234,176,291,130,0.4939865141328484,1.1380348875178419,1.7027990138488414,0.5537485393764767,110437,111466,Pennington,Pennington,46,103,South Dakota,SD
46007,46CS010,32,31,32,32,0,0,1,2,-0.5822989642626257,-0.48375102146177107,-0.37696836520223964,1.4704043256912536,39,38,39,50,11,11,12,3,2.7275649084004234,2.883544605752859,3.037536151923894,0.2466559187867256,3385,3403,Southwest Central South Dakota,Bennett,46,7,South Dakota,SD
46033,46CS010,82,81,83,91,9,8,10,11,-0.37128821160705866,-0.268165187623273,-0.1683833845717514,1.1311480161525704,102,101,103,95,-7,-8,-6,5,-1.8207964023077596,-1.6684931014170414,-1.5189779442662232,-0.8474723520727521,8445,8568,Southwest Central South Dakota,Custer,46,33,South Dakota,SD
46047,46CS010,100,100,101,109,9,8,9,3,0.7301521716258997,0.8272311281829349,0.929371980838592,0.3079234031621543,126,125,127,149,23,22,24,18,0.6638791394645285,0.8222602913340396,0.9693255440415414,0.7528809770459552,6949,7167,Southwest Central South Dakota,Fall River,46,47,South Dakota,SD
46053,46CS010,48,47,48,76,28,28,29,26,0.4414288484651459,0.5429773357738027,0.6402835947389787,0.891234502793241,58,57,58,75,17,17,18,3,4.1318794548143085,4.293559891989772,4.453629031810845,0.16447759829165362,4020,3979,Southwest Central South Dakota,Gregory,46,53,South Dakota,SD
46055,46CS010,22,21,22,24,2,2,3,5,-1.4993472211414218,-1.4035275282753923,-1.3062397762136522,1.474580083994262,26,26,26,28,2,2,2,7,-3.4052782413273497,-3.265634101752942,-3.133585118548119,2.3407621467797557,1865,1840,Southwest Central South Dakota,Haakon,46,55,South Dakota,SD
46071,46CS010,25,25,25,42,17,17,17,13,1.3464624321069123,1.4438680367112535,1.543304182619836,0.7151922408860842,30,30,30,70,40,40,40,3,15.297178717678307,15.460671806059842,15.616188744570213,0.07325868589743999,2894,2868,Southwest Central South Dakota,Jackson,46,71,South Dakota,SD
46075,46CS010,10,10,11,4,-6,-7,-6,4,-11.4399621513485,-11.34163825411175,-11.237327564462456,-0.7390519037329356,12,12,12,13,1,1,1,2,-1.8538347559182997,-1.6987862086740835,-1.5472311206628433,1.1461713222300083,918,886,Southwest Central South Dakota,Jones,46,75,South Dakota,SD
46095,46CS010,23,23,23,27,4,4,4,3,0.31785932159106417,0.4151666090209296,0.5179281771615488,0.6244353288006882,28,28,28,30,2,2,2,4,-1.3384511965980965,-1.1887497516204153,-1.0413141282339926,1.2841697750078067,1937,1909,Southwest Central South Dakota,Mellette,46,95,South Dakota,SD
46102,46CS010,134,128,140,191,57,51,63,33,1.3098436982215882,1.761808741646634,2.168942419585677,0.5676861228515218,162,155,169,191,29,22,36,6,1.3352567542123959,2.0080491878933495,2.628582098822544,0.20220845111832278,13736,13599,Southwest Central South Dakota,Southwest Central South Dakota,46,102,South Dakota,SD
46121,46CS010,72,71,73,118,46,45,47,23,2.2915025776558275,2.3935846148983506,2.4851968212910824,0.49323533992135327,87,86,88,139,52,51,53,15,4.64876686647387,4.799426210924177,4.9390771072721495,0.28225848724252695,9459,9291,Southwest Central South Dakota,Todd,46,121,South Dakota,SD
46123,46CS010,65,64,66,81,16,15,17,13,0.44343200340926153,0.5435011046243265,0.6485697109998859,0.7641030430811122,79,79,80,68,-11,-12,-11,2,-3.0094386725208304,-2.8638506173509377,-2.711251715396735,-0.19422844535893635,5573,5574,Southwest Central South Dakota,Tripp,46,123,South Dakota,SD
47001,47CS001,863,830,897,928,65,31,98,69,-0.47270743939073173,-0.06953110161348126,0.3352950336863741,1.0514176878915131,1062,1022,1102,1272,210,170,250,140,0.48997521923831516,1.0766616515013814,1.7429193016803186,0.6622643153147928,77215,77522,Anderson,Anderson,47,1,Tennessee,TN
47003,47CS002,450,428,472,514,64,42,86,68,-0.4885716907099101,-0.08743679068835443,0.35648603306165116,1.0472995976245163,560,533,586,668,108,82,135,112,-0.7068185339989294,-0.06888899829152455,0.5136023371822298,1.0247134470584582,50297,51000,Bedford+Lincoln+Moore,Bedford,47,3,Tennessee,TN
47103,47CS002,385,369,400,461,76,61,92,42,0.5565376455828455,0.9711696551352932,1.4064916105169407,0.5425940156167695,473,454,491,550,77,59,96,94,-1.1798368884336892,-0.5512661006614082,0.09431680279638867,1.1974679416974818,35195,35415,Bedford+Lincoln+Moore,Lincoln,47,103,Tennessee,TN
47127,47CS002,59,58,60,68,9,8,10,4,0.6533836262154467,0.7593568057492747,0.8567565264399842,0.40414385564284533,74,73,75,95,21,20,22,17,0.5377800847984815,0.6874373554935834,0.8524180310610334,0.7803341072408986,6474,6617,Bedford+Lincoln+Moore,Moore,47,127,Tennessee,TN
47005,47CS003,215,208,222,264,49,42,56,34,0.5486364419570212,0.9723708580808943,1.405804906552228,0.6765893800818236,261,253,269,331,70,62,78,56,0.4403345494565476,1.0478000666068565,1.681811264577515,0.7895486653896644,15875,15863,Benton+Carroll+Henry,Benton,47,5,Tennessee,TN
47017,47CS003,367,355,379,459,92,80,104,53,0.9629987357456483,1.3746328624015935,1.7830415032781917,0.5690705419966609,447,432,462,484,37,22,52,73,-2.161025138765718,-1.5120371123404417,-0.9312218344485179,1.9260631765987237,28314,28430,Benton+Carroll+Henry,Carroll,47,17,Tennessee,TN
47079,47CS003,401,387,415,473,72,58,86,46,0.3561884968211244,0.8042472543320354,1.232220955048099,0.630264603170647,489,472,505,567,78,62,95,71,-0.3829608017406038,0.28039236403046147,0.880438633155519,0.8966889788366466,32156,32221,Benton+Carroll+Henry,Henry,47,79,Tennessee,TN
47007,47CS004,131,129,132,150,19,18,21,6,0.7963630928419804,0.9030555175315507,0.9978085522434318,0.29268938630482555,163,161,165,184,21,19,23,37,-1.398834873771533,-1.2528185603770303,-1.1070368334674023,1.6684785967909717,14984,15190,Bledsoe+Rhea+Van Buren+White,Bledsoe,47,7,Tennessee,TN
47143,47CS004,360,346,374,431,71,57,85,46,0.3193641340459509,0.7377085891801638,1.2102145651912815,0.6396819544476455,439,422,456,552,113,96,130,66,1.0821274934375344,1.7070068383643682,2.3285784524077875,0.5806621962242154,32971,33102,Bledsoe+Rhea+Van Buren+White,Rhea,47,143,Tennessee,TN
47175,47CS004,78,77,79,77,-1,-2,-0,7,-1.4128962904133109,-1.3122324645016676,-1.209622218341907,-124.7120719660906,98,97,99,146,48,47,49,36,2.0990973588304422,2.251633568650689,2.40052027964769,0.737397399062368,6144,6302,Bledsoe+Rhea+Van Buren+White,Van Buren,47,175,Tennessee,TN
47185,47CS004,320,308,332,346,26,14,38,32,-0.6810788577115022,-0.22094205895586466,0.2290917506466827,1.1828778560449411,391,376,405,482,91,77,106,73,0.17378898070545173,0.803949365338039,1.4129349878163882,0.7913177239635073,27441,27617,Bledsoe+Rhea+Van Buren+White,White,47,185,Tennessee,TN
47009,47CS005,1284,1226,1342,1417,133,75,191,105,-0.21820333807306655,0.20639051792892943,0.6384818311264665,0.7844681549262068,1594,1523,1665,1917,323,252,394,192,0.5302431346988192,1.131305298713308,1.7156880827531222,0.5929696411642682,135462,137308,Blount+Loudon,Blount,47,9,Tennessee,TN
47105,47CS005,596,572,620,600,4,-20,28,47,-1.2069283437051015,-0.7947937125743839,-0.34559017166851524,9.45257230291611,745,716,775,835,90,60,119,94,-0.7745660479321852,-0.10165692006976064,0.5652843605438093,1.0381278018667137,55109,56458,Blount+Loudon,Loudon,47,105,Tennessee,TN
47011,47CS006,970,923,1017,1194,224,177,271,72,0.9678441919733631,1.3945611149602395,1.8002353487738658,0.3200920689181599,1204,1147,1261,1597,393,336,450,219,1.2410382467163596,1.8764724236632082,2.475278787995593,0.5561207169744383,108815,109955,Bradley+Polk,Bradley,47,11,Tennessee,TN
47139,47CS006,216,209,224,246,30,22,37,13,0.565230056631469,0.9600364209252183,1.409002869364694,0.4205534038370703,267,258,276,346,79,70,88,41,1.9496269907647155,2.5706962722310918,3.12268541894145,0.513558086889069,17473,17746,Bradley+Polk,Polk,47,139,Tennessee,TN
47013,47CS007,505,488,522,548,43,26,60,41,-0.3783957783385922,0.04782996066311052,0.4970647266695893,0.9276704146862269,616,596,637,777,161,140,181,80,1.8579168571910523,2.460576122991603,3.072019812480252,0.49438973983086104,39381,39534,Campbell+Claiborne+Hancock+Scott,Campbell,47,13,Tennessee,TN
47025,47CS007,368,354,382,409,41,27,55,24,0.09728798324944629,0.5472075348407757,0.959575916841921,0.5725855302695312,450,434,467,598,148,131,164,111,0.7475193249110738,1.3630253769943932,1.9852393146546206,0.7470656040101054,32044,32234,Campbell+Claiborne+Hancock+Scott,Claiborne,47,25,Tennessee,TN
47067,47CS007,85,85,86,94,9,8,9,5,0.43185412096182335,0.5342348086143529,0.6310750563511613,0.5244146819313303,106,106,107,125,19,18,19,18,-0.05558806255371709,0.09770060628573232,0.2552761582316306,0.9196571473753843,6637,6763,Campbell+Claiborne+Hancock+Scott,Hancock,47,67,Tennessee,TN
47151,47CS007,232,223,242,242,10,0,19,28,-1.264250358348572,-0.8403613732423734,-0.4098090539320962,2.615108197437843,283,272,295,377,94,82,105,56,1.4174227157542858,2.0493388270448807,2.6557298699439857,0.5922137297102398,21888,21906,Campbell+Claiborne+Hancock+Scott,Scott,47,151,Tennessee,TN
47015,47CS008,159,152,165,181,22,16,29,16,0.017275538666801996,0.4432935432069117,0.8267877469924665,0.6865978917919586,193,186,201,215,22,14,29,27,-1.0820279172764897,-0.43089297391499093,0.21036764226876972,1.1822203395790987,14553,14552,Cannon+DeKalb+Warren,Cannon,47,15,Tennessee,TN
47041,47CS008,215,206,224,274,59,50,68,30,1.0005850738521258,1.4311539414419943,1.8601049612988623,0.4997243553986538,264,254,275,335,71,60,81,45,0.8883350777195825,1.5121693792306348,2.1545875022256173,0.6278930361183237,20238,20433,Cannon+DeKalb+Warren,DeKalb,47,41,Tennessee,TN
47177,47CS008,434,416,451,503,69,52,87,51,0.0138473082940091,0.46314120407140813,0.8525428569356701,0.7264631375174778,533,511,554,612,79,58,101,90,-0.9415489539118861,-0.3011478670720269,0.25950826738203053,1.1190939909347115,41111,41450,Cannon+DeKalb+Warren,Warren,47,177,Tennessee,TN
47019,47CS009,654,630,678,786,132,108,156,87,0.3849611093467391,0.7973741973560696,1.2456972241328235,0.6546054928910605,804,775,833,955,151,122,180,128,-0.1256006342919632,0.5061313237480021,1.1659015593703483,0.8408857149910726,56308,56160,Carter+Johnson+Unicoi,Carter,47,19,Tennessee,TN
47091,47CS009,224,216,232,258,34,26,42,33,-0.42937827702874953,0.03331527661930278,0.48351653590725907,0.9479064959565057,278,269,288,299,21,11,30,44,-2.1850718798158812,-1.538438678177704,-0.8614119470143856,2.0173952240163815,17959,18140,Carter+Johnson+Unicoi,Johnson,47,91,Tennessee,TN
47171,47CS009,251,244,259,291,40,32,47,26,0.36590952983320174,0.778613856871656,1.1877649674460722,0.637908768744247,306,297,315,375,69,60,78,34,1.7399754582829607,2.371923274923422,2.964195517579883,0.48513256881494976,17856,17723,Carter+Johnson+Unicoi,Unicoi,47,171,Tennessee,TN
47021,47CS010,374,356,392,434,60,42,78,29,0.32002171130274415,0.7518777973858912,1.1619372862018391,0.47591066454895087,461,440,483,565,104,82,125,64,0.490416379113067,1.1329943891314425,1.7485531932456522,0.6116334535356641,41095,41459,Cheatham+Dickson,Cheatham,47,21,Tennessee,TN
47043,47CS010,516,492,539,565,49,26,73,68,-0.771661653940477,-0.33087768640087667,0.07217355919213216,1.350904918783985,638,610,667,772,134,105,162,140,-0.7746465052638363,-0.12770753210855498,0.5617687853949709,1.0379837342135467,54438,55167,Cheatham+Dickson,Dickson,47,43,Tennessee,TN
47023,47CS011,167,160,174,195,28,21,35,27,-0.3723779374384283,0.05767118025630339,0.4748933361700291,0.9306968675789739,206,197,215,262,56,47,65,41,0.39046910133802365,1.0094127750922357,1.6092141949350398,0.7226034307267442,17357,17481,Chester+Madison,Chester,47,23,Tennessee,TN
47113,47CS011,909,867,952,1128,219,176,261,155,0.22872015628417144,0.6488276402060505,1.0967864581299318,0.705950089699226,1118,1067,1169,1297,179,128,230,171,-0.4641435751617625,0.12323779586364664,0.679612346982836,0.9477622799338398,98670,98775,Chester+Madison,Madison,47,113,Tennessee,TN
47029,47CS012,461,445,476,571,110,95,126,65,0.8473876500051506,1.272514686378087,1.689446265136037,0.5830545787710166,566,547,585,737,171,152,190,97,1.8231613561087947,2.44676432077746,3.0805443649261073,0.5631703677250208,36063,36360,Cocke+Jefferson,Cocke,47,29,Tennessee,TN
47089,47CS012,565,541,589,642,77,53,101,61,-0.13999120385705813,0.2671224308578535,0.7266804908164131,0.7821338703576937,698,670,727,891,193,164,221,132,0.7203647939106065,1.2934870913025964,1.9705820762145645,0.6818193672459283,54904,55514,Cocke+Jefferson,Jefferson,47,89,Tennessee,TN
47031,47CS013,604,579,629,669,65,40,90,70,-0.540473283958618,-0.09489110455160706,0.2989021908181987,1.0579036821975096,745,715,776,876,131,100,161,129,-0.5614920482370863,0.03911155258538353,0.6600974213577883,0.9797377656500565,57997,58896,Coffee+Franklin,Coffee,47,31,Tennessee,TN
47051,47CS013,436,418,455,546,110,91,128,51,0.9304012463082433,1.3698159692333984,1.7775663069036267,0.46055885476125835,536,514,558,651,115,93,137,81,0.31950215098595086,0.9424949850184234,1.6428262821637005,0.6975437246754586,42750,43152,Coffee+Franklin,Franklin,47,51,Tennessee,TN
47033,47CS014,167,161,173,208,41,35,47,27,0.5651879280077173,1.0029510244669932,1.4529005061314442,0.6454165107586701,205,198,212,212,7,-0,14,23,-2.001569711781098,-1.3912507112369163,-0.7201174082021263,2.902204718143328,13938,13965,Crockett+Gibson+Haywood,Crockett,47,33,Tennessee,TN
47053,47CS014,597,575,618,724,127,106,149,87,0.3766635049556827,0.8056205179711041,1.2194159262626878,0.6774333677577039,733,707,759,919,186,160,212,102,1.3424323881767717,2.0152073845706777,2.5989320483372125,0.5456907780553304,50208,50517,Crockett+Gibson+Haywood,Gibson,47,53,Tennessee,TN
47075,47CS014,190,182,197,230,40,33,48,40,-0.41274814101960605,0.025115196782975684,0.43220846048512157,0.9700723065568561,232,223,241,286,54,45,63,41,0.2954410185103175,0.8747741925806622,1.5061818199089088,0.7492497095951489,17704,17709,Crockett+Gibson+Haywood,Haywood,47,75,Tennessee,TN
47035,47CS015,738,712,765,865,127,100,153,64,0.6154197828123584,1.021849106311085,1.440747268301937,0.5015438731173427,912,880,944,1246,334,302,366,182,2.318044703423993,2.95049527417556,3.574545125231961,0.5429287739870806,61331,62279,Cumberland+Fentress,Cumberland,47,35,Tennessee,TN
47049,47CS015,222,214,230,273,51,43,59,32,0.583677464149765,1.0425367871104716,1.417829806137244,0.614551342011984,274,264,283,378,104,95,114,62,2.100584980668194,2.6868097202427923,3.3585475538405083,0.5879251971738015,18563,18802,Cumberland+Fentress,Fentress,47,49,Tennessee,TN
47037,47CS016,4782,4476,5088,5572,790,484,1096,539,-0.06939486264281136,0.35990380669227134,0.7939586194795952,0.6812920982158568,5843,5478,6207,5937,94,-270,459,687,-1.5968273152472927,-1.0097617166260462,-0.40751509976046263,7.216121059953032,711005,705635,Davidson,Davidson,47,37,Tennessee,TN
47039,47CS017,151,146,156,199,48,43,53,22,1.828692658727494,2.2376114612924995,2.6993477043513843,0.45267601136546537,183,178,189,211,28,22,33,22,-0.025700642365903588,0.5854976405528197,1.1519704810561047,0.7694297263152204,11431,11393,Decatur+Henderson+Lewis+Perry,Decatur,47,39,Tennessee,TN
47077,47CS017,293,281,305,366,73,61,85,55,0.19568334308858634,0.6497804514779344,1.0787184304983473,0.7418747622038175,358,343,372,436,78,64,93,74,-0.43416351021671157,0.19622505378916294,0.8213276522825109,0.9324973123664207,27866,27933,Decatur+Henderson+Lewis+Perry,Henderson,47,77,Tennessee,TN
47101,47CS017,152,147,158,171,19,13,24,15,-0.0818326895577614,0.2890876521556364,0.7176721376833631,0.7579899133710455,188,182,195,224,36,29,42,27,0.19919365495673225,0.8169084234811843,1.4612960807535749,0.7323930351774562,12580,12820,Decatur+Henderson+Lewis+Perry,Lewis,47,101,Tennessee,TN
47135,47CS017,109,108,110,112,3,2,4,17,-1.764090489569265,-1.671145402546421,-1.556574381019606,4.136497101756847,135,134,136,145,10,9,11,21,-1.7532467812638637,-1.6077112742232047,-1.459772023024057,1.9604321530461306,8331,8456,Decatur+Henderson+Lewis+Perry,Perry,47,135,Tennessee,TN
47045,47CS018,407,392,423,533,126,110,141,63,1.2900173758916686,1.6987543897507007,2.1364774585652007,0.4978627633573142,498,480,517,627,129,110,147,85,0.7896024259492992,1.425326528185819,2.074299982252433,0.6561011286857303,36712,36620,Dyer+Lake+Lauderdale,Dyer,47,45,Tennessee,TN
47095,47CS018,80,79,81,93,13,12,14,12,0.0319584338023781,0.12405245580613704,0.22656571621562152,0.8642371351555789,100,99,101,137,37,36,38,16,3.4399446409831747,3.5846438563785328,3.7399415885659497,0.4184005849388538,7000,7106,Dyer+Lake+Lauderdale,Lake,47,95,Tennessee,TN
47097,47CS018,255,244,265,296,41,31,52,32,-0.06473101784812009,0.3826727757864947,0.7833676957744923,0.7558004575148692,312,299,325,357,45,32,58,51,-0.8799202754052846,-0.2929237383268459,0.3109399236632024,1.1140731153143029,25175,25107,Dyer+Lake+Lauderdale,Lauderdale,47,97,Tennessee,TN
47047,47CS019,378,360,396,461,83,65,101,41,0.5841273443573743,0.9990333860890827,1.4572737310135744,0.4861311681748818,468,446,491,565,97,74,119,83,-0.23638675599439818,0.391577380475205,0.9705090170630855,0.8510667554454747,42052,42731,Fayette+Hardeman,Fayette,47,47,Tennessee,TN
47069,47CS019,259,248,270,333,74,63,85,50,0.5012995133458039,0.9302877210922019,1.3671134774679843,0.6694922428041923,317,304,330,383,66,53,79,42,0.5138447224284726,1.1381311268551646,1.7451292315935332,0.6268340573017371,25359,25424,Fayette+Hardeman,Hardeman,47,69,Tennessee,TN
47055,47CS020,343,330,356,413,70,57,83,43,0.5111495684959079,0.9072179875483618,1.3130472795693624,0.6018790858025974,423,407,439,526,103,87,119,79,0.3433621620128669,0.9293578692735112,1.5690591905692362,0.7587431301026175,30202,30506,Giles+Marshall,Giles,47,55,Tennessee,TN
47117,47CS020,325,310,340,369,44,29,59,31,-0.03492981163985772,0.3790760450303536,0.7899742840068965,0.6847140472290886,404,386,422,466,62,44,80,67,-0.7286553315166212,-0.167078892869042,0.4410242502182038,1.0583300890980474,34507,34905,Giles+Marshall,Marshall,47,117,Tennessee,TN
47057,47CS021,258,248,269,332,74,63,84,27,1.548625730305223,1.9592136018011919,2.401489735088847,0.36187024959788744,319,306,331,394,75,63,88,59,0.2133326590121207,0.8124373690549316,1.4559224681910765,0.7720376977893895,23532,23728,Grainger+Hamblen,Grainger,47,57,Tennessee,TN
47063,47CS021,664,636,692,859,195,167,223,79,1.3668301124277615,1.8000479882971794,2.2163997677261746,0.4029319049873518,813,780,846,1110,297,264,330,169,1.7755293984461111,2.3948712357967503,2.972104966575329,0.5674491146444944,64502,64463,Grainger+Hamblen,Hamblen,47,63,Tennessee,TN
47059,47CS022,837,807,867,931,94,64,124,88,-0.3391825311226875,0.09510953370722204,0.5359111247945071,0.9283366915138302,1030,993,1066,1285,255,219,292,167,0.8905248131744115,1.5032037565894312,2.0770962368819075,0.6516977376790404,70102,70563,Greene,Greene,47,59,Tennessee,TN
47061,47CS023,181,175,186,197,16,11,22,17,-0.4640625326067254,-0.05868640087420529,0.3731938683301468,0.9727656901320055,220,213,227,246,26,19,33,42,-2.0359948560837533,-1.3757387692916978,-0.7689382393897128,1.5448953401708556,13523,13609,Grundy+Marion+Sequatchie,Grundy,47,61,Tennessee,TN
47115,47CS023,314,301,326,359,45,33,58,36,-0.10676276012880564,0.30967974861298,0.7585105704130098,0.7748384293192793,381,366,396,475,94,79,109,72,0.2877030765170602,0.9271291258606287,1.5281686852245204,0.756082634242597,28845,28871,Grundy+Marion+Sequatchie,Marion,47,115,Tennessee,TN
47153,47CS023,155,148,162,165,10,3,17,12,-0.5638770879764882,-0.1268930531880993,0.3354085557861568,1.0800503951461502,194,185,202,229,35,27,44,48,-1.5444834479834897,-0.9367183182554921,-0.2795981427057259,1.3157902911951036,15803,16318,Grundy+Marion+Sequatchie,Sequatchie,47,153,Tennessee,TN
47065,47CS024,3189,3031,3347,3584,395,237,553,257,-0.04951408910269837,0.36879080772709977,0.8056049771404786,0.649722758007277,3932,3741,4122,4508,576,386,767,527,-0.4839169046252078,0.1644092005143236,0.805984601815905,0.912883419216611,367329,368822,Hamilton,Hamilton,47,65,Tennessee,TN
47071,47CS025,348,336,359,404,56,45,68,36,0.3453804532892222,0.7612525966755044,1.1969891161928286,0.6287512573505656,427,413,441,527,100,86,114,71,0.6802785813011359,1.2967572001249852,1.9023494866667083,0.7044517738513935,26639,26879,Hardin+McNairy,Hardin,47,71,Tennessee,TN
47109,47CS025,329,318,340,404,75,64,86,35,1.122504382823398,1.5686876980782039,1.97855011611309,0.4590251812483114,402,389,415,462,60,47,73,50,-0.11095369448364133,0.46097049522400857,1.1051845589239957,0.8198225322175008,25815,25857,Hardin+McNairy,McNairy,47,109,Tennessee,TN
47073,47CS026,639,614,663,767,128,104,153,55,0.8730895053520499,1.2799488746246812,1.7307152402296502,0.42514113034635254,787,758,817,1038,251,221,280,155,1.3794920138134037,2.0052379452587186,2.634675981101439,0.6158759030571902,56761,57198,Hawkins,Hawkins,47,73,Tennessee,TN
47081,47CS027,252,241,262,326,74,64,85,34,1.1706006317419855,1.6173827478940443,2.0328229455063624,0.4516903441141971,311,298,324,378,67,54,80,60,-0.32776687999880477,0.3308588246812364,0.9886797034467105,0.8852711192499044,25011,25254,Hickman+Houston+Humphreys+Stewart,Hickman,47,81,Tennessee,TN
47083,47CS027,102,101,103,128,26,25,27,17,1.0185424407369628,1.1154947585927424,1.2124759106659027,0.6244458544307792,125,124,126,141,16,15,17,23,-1.2128405796167134,-1.0620278843211803,-0.8966055712174896,1.382216025307861,8277,8312,Hickman+Houston+Humphreys+Stewart,Houston,47,83,Tennessee,TN
47085,47CS027,223,215,231,241,18,10,26,19,-0.4747177154430084,-0.05427427959286452,0.3831082214555425,0.9955447966719787,275,265,285,350,75,65,85,43,1.3985350309800686,1.992375915805566,2.5887858434107667,0.5662778158717404,18944,19176,Hickman+Houston+Humphreys+Stewart,Humphreys,47,85,Tennessee,TN
47161,47CS027,151,146,157,158,7,1,12,20,-1.443034187336875,-0.9808519611942982,-0.5627031012244625,2.6516081793156565,187,180,194,208,21,14,28,25,-0.979189863169205,-0.34514115957660824,0.3006364440945412,1.1244882705770127,13703,13830,Hickman+Houston+Humphreys+Stewart,Stewart,47,161,Tennessee,TN
47087,47CS028,146,141,151,170,24,19,29,23,-0.3654080416403004,0.04926534823274789,0.4939925524056767,0.9331868797745061,179,173,185,182,3,-3,9,21,-2.4887839280380235,-1.8372367188541308,-1.2346969125533507,5.580945228424088,11663,11731,Jackson+Putnam+Smith,Jackson,47,87,Tennessee,TN
47141,47CS028,734,700,769,924,190,155,224,118,0.44817073725682,0.8910806456340807,1.355681004207821,0.6183031482089717,907,866,949,1043,136,94,177,91,0.055365977664752035,0.6713180779439624,1.2527481449277935,0.666481595127339,80104,81012,Jackson+Putnam+Smith,Putnam,47,141,Tennessee,TN
47159,47CS028,184,175,193,217,33,24,42,21,0.17908143885974376,0.6062252051792381,1.0303972975896396,0.6178800332486333,227,216,237,286,59,49,70,39,0.5599932460262136,1.2086156052818626,1.8541185810361673,0.6468208316774611,19989,20138,Jackson+Putnam+Smith,Smith,47,159,Tennessee,TN
47093,47CS029,3993,3787,4200,4556,563,356,769,287,0.176695171045324,0.5927968777701483,1.004860556047089,0.5091171376755919,4946,4696,5197,5782,836,585,1086,606,-0.0716643954486129,0.5433921376414619,1.1740606572944012,0.7242785646521221,479352,485722,Knox+Union,Knox,47,93,Tennessee,TN
47173,47CS029,194,185,202,247,53,45,62,17,1.4052139424550887,1.8185922647216264,2.247300962439631,0.31320370380288265,238,228,249,348,110,99,120,48,3.092085568541396,3.7209835255564014,4.320143584969598,0.43351279248764596,19860,20008,Knox+Union,Union,47,173,Tennessee,TN
47099,47CS030,484,465,503,595,111,92,130,62,0.6784370665190224,1.0914635294476394,1.5189601431360102,0.5546790354530601,597,574,620,694,97,74,120,102,-0.7561763115740967,-0.12799168859329674,0.4372139089477357,1.0401317498227125,44252,44735,Lawrence+Wayne,Lawrence,47,99,Tennessee,TN
47181,47CS030,176,169,183,196,20,13,27,19,-0.38764327718614827,0.06850223312633778,0.5188787329137723,0.8985084707801043,216,208,225,264,48,39,56,32,0.6335179656571338,1.165050442374632,1.7617730513936967,0.6538197401110075,16288,16379,Lawrence+Wayne,Wayne,47,181,Tennessee,TN
47107,47CS031,600,577,623,708,108,85,131,61,0.450441196961021,0.8720214171361782,1.2961210023210095,0.5585860994257634,743,715,771,947,204,176,232,123,1.14634458836856,1.7986657594887043,2.4079963153147093,0.6006213896699933,53465,53950,McMinn+Meigs+Monroe,McMinn,47,107,Tennessee,TN
47121,47CS031,162,157,168,156,-6,-12,-1,17,-2.212379179174758,-1.8228009814526909,-1.3755355672740242,-3.3319225702475577,202,195,209,210,8,1,15,29,-2.5756136973041723,-1.9339332225247687,-1.3458002247879137,3.232094894160387,12750,13010,McMinn+Meigs+Monroe,Meigs,47,121,Tennessee,TN
47123,47CS031,516,496,536,606,90,70,110,53,0.37060946420416274,0.8081484923554436,1.2025296686087894,0.5812165815503089,636,612,660,824,188,164,212,127,0.9796999452814553,1.557209148371778,2.1945994722443065,0.6727115256191123,46456,46652,McMinn+Meigs+Monroe,Monroe,47,123,Tennessee,TN
47119,47CS032,894,850,938,909,15,-29,59,105,-1.3068959112758916,-0.8921969197118488,-0.4744682480920351,6.612317151371091,1124,1070,1178,1197,73,19,127,143,-1.4320338112600912,-0.8299297934809788,-0.1679616062797818,1.924373214320433,101303,104314,Maury,Maury,47,119,Tennessee,TN
47125,47CS033,1274,1179,1369,1493,219,124,314,112,0.051351088280554354,0.486632090422651,0.9176643500879718,0.5084905208240514,1621,1504,1739,1947,326,208,443,304,-0.5294892610628866,0.12217100947230325,0.6992025677636955,0.9309711691014927,220206,226917,Montgomery,Montgomery,47,125,Tennessee,TN
47129,47CS034,214,205,223,227,13,4,22,11,-0.3380016509017811,0.10325089858059962,0.5448710405051937,0.7915454151730329,265,254,276,335,70,59,81,42,0.97476306622643,1.5814076853219692,2.195709165122242,0.5898105149919463,21098,21220,Morgan+Roane,Morgan,47,129,Tennessee,TN
47145,47CS034,659,636,682,750,91,68,114,54,0.23237183408742518,0.678711134090664,1.1153618920505413,0.589097924316236,812,784,840,922,110,82,138,114,-0.7249554348044103,-0.10155861178292944,0.49135944272919463,1.0278298334054956,53558,53922,Morgan+Roane,Roane,47,145,Tennessee,TN
47027,47CS035,96,95,97,137,41,40,42,19,2.815310986223226,2.920164310181615,3.0288376110299144,0.4514970061271749,117,116,118,139,22,21,23,16,0.7972574722834332,0.9535339861545471,1.0997198997082558,0.6951132226177131,7560,7555,North Central Tennessee,Clay,47,27,Tennessee,TN
47111,47CS035,241,230,252,301,60,49,71,41,0.2897520499640042,0.7601272735386868,1.2087441752765897,0.6734021736347776,298,285,312,341,43,29,56,59,-1.379595592981883,-0.7539617476403366,-0.16797221427876646,1.3495171986975396,25200,25632,North Central Tennessee,Macon,47,111,Tennessee,TN
47133,47CS035,268,259,278,343,75,65,84,42,1.0356608368585913,1.455554528892695,1.9105347396174428,0.5542162749440899,329,317,341,404,75,63,87,55,0.44382465781417896,1.079081016474902,1.7062402592840034,0.7226666605485358,22568,22802,North Central Tennessee,Overton,47,133,Tennessee,TN
47137,47CS035,63,63,64,79,16,15,16,18,-0.5593689456250283,-0.4521063484490289,-0.3506862134705554,1.0761424826463781,78,77,79,80,2,1,3,1,0.08043426076461199,0.22680234195170565,0.3876165196509293,0.3370600027607863,5014,5067,North Central Tennessee,Pickett,47,137,Tennessee,TN
47169,47CS035,98,96,99,107,9,8,11,13,-0.4086449448026161,-0.30874248370627233,-0.2032186550493941,1.2466508652821189,123,121,124,152,29,28,31,20,0.7770842428152853,0.9264906740931526,1.074562087010448,0.6610214978912211,11644,11980,North Central Tennessee,Trousdale,47,169,Tennessee,TN
47131,47CS036,336,323,349,455,119,106,132,72,1.1175779295579522,1.5501213664588944,1.9645951296853223,0.5992438031650024,410,395,426,497,87,71,102,74,-0.16306568963329418,0.4953370331928395,1.1471781547272661,0.8439857851641467,30622,30502,Obion+Weakley,Obion,47,131,Tennessee,TN
47183,47CS036,338,323,352,380,42,28,57,35,-0.20211218139358839,0.20541965812019142,0.619195317110407,0.8065287827074232,416,399,433,496,80,63,97,59,0.19561942462471474,0.7643600478422985,1.3021672285234631,0.7296107963414112,32941,33011,Obion+Weakley,Weakley,47,183,Tennessee,TN
47147,47CS037,608,576,639,769,161,130,193,73,0.8012398341941892,1.2164037462225048,1.640222267755357,0.4494984457989343,755,717,794,959,204,165,242,116,0.7559240047685132,1.4217714682632419,2.055134994897126,0.5670890423251239,72819,73917,Robertson,Robertson,47,147,Tennessee,TN
47149,47CS038,1913,1766,2061,2287,374,226,521,235,-0.011589137966709104,0.4078637423323023,0.8528564699295645,0.6274352620606596,2426,2245,2607,2886,460,279,641,432,-0.530668922390964,0.10101155313133149,0.7184593897239109,0.9365646078534656,342467,350862,Rutherford,Rutherford,47,149,Tennessee,TN
47155,47CS039,942,899,984,1105,163,121,206,86,0.36983500579686246,0.7840150594824455,1.2214107873201268,0.5233354478684392,1164,1112,1215,1479,315,264,367,219,0.5396665311427031,1.1493059689015754,1.7497181463546916,0.6920903838949302,98589,99368,Sevier,Sevier,47,155,Tennessee,TN
47157,47CS040,7068,6669,7468,9054,1986,1586,2385,955,0.6823231336156581,1.1090285633557069,1.5284638248244977,0.48066122444872106,8666,8188,9143,12526,3860,3383,4338,1620,2.357926920722685,2.914674140024115,3.5301607668897534,0.4195485725196215,929436,925065,Shelby,Shelby,47,157,Tennessee,TN
47163,47CS041,1807,1739,1875,2145,338,270,406,184,0.5411051190097981,0.975562071591459,1.3654598546275571,0.5432748015887142,2218,2136,2300,2690,472,390,554,319,0.5489225253546446,1.1625261679413488,1.7312947299065038,0.674481989924341,158269,159094,Sullivan,Sullivan,47,163,Tennessee,TN
47165,47CS042,1486,1402,1571,1729,243,158,327,188,-0.1375583215764739,0.28927846697520365,0.7374402469692141,0.7718057532829601,1855,1752,1959,2298,443,339,546,337,0.03645548723649877,0.6294310392224752,1.2509615488041352,0.7594530240079067,196772,200078,Sumner,Sumner,47,165,Tennessee,TN
47167,47CS043,519,492,545,598,79,53,106,64,-0.1734901064959923,0.2546443518195967,0.7029817443200227,0.7960621565078211,635,603,666,804,169,138,201,126,0.18711428753292952,0.8546246166157072,1.5401183720099145,0.7404954343864333,61075,60998,Tipton,Tipton,47,167,Tennessee,TN
47179,47CS044,1297,1240,1354,1539,242,185,299,151,0.270825525904319,0.6793987633304491,1.1090016242713736,0.6206857393268559,1602,1532,1671,1901,299,230,369,199,0.30640709768706603,0.9080183631456924,1.4969457653048643,0.6623419347136337,132703,134067,Washington,Washington,47,179,Tennessee,TN
47187,47CS045,1254,1147,1362,1390,136,28,243,138,-0.42713338034606446,-0.003050621288834328,0.39308843692239503,1.0108895861663818,1598,1466,1729,1671,73,-58,205,173,-1.0967348377233328,-0.4718227928458028,0.17818922249180952,2.332960441523711,248496,254815,Williamson,Williamson,47,187,Tennessee,TN
47189,47CS046,1045,981,1109,1283,238,174,302,144,0.19570486844190116,0.6477115115602341,1.06314984212403,0.6018776282005752,1312,1234,1390,1558,246,168,324,244,-0.5879940302339977,0.02154580627197184,0.6934964141171792,0.9868828188590599,148322,151428,Wilson,Wilson,47,189,Tennessee,TN
48001,48CS001,566,541,591,612,46,21,71,76,-0.9636397579454644,-0.5314452838822176,-0.08309366248173283,1.623563567228909,697,667,727,883,186,156,216,138,0.3504085949954681,0.9836055687463634,1.6354183801541295,0.7373832692013034,57926,58326,Anderson+Houston,Anderson,48,1,Texas,TX
48225,48CS001,237,227,246,308,71,62,81,27,1.554042687488124,1.9873674294884478,2.404152092403276,0.37471336732275556,290,279,301,392,102,91,113,70,1.0674568132219497,1.7369313989439024,2.3724506152876463,0.679523052229233,22204,22216,Anderson+Houston,Houston,48,225,Texas,TX
48005,48CS002,769,732,807,990,221,183,258,163,0.1986592480032189,0.6534032856821811,1.0782954883474911,0.7357694155097207,945,901,990,1256,311,266,355,262,0.05719039944922181,0.6575134890186957,1.2785354906222433,0.8407345172208105,86422,86483,Angelina,Angelina,48,5,Texas,TX
48007,48CS003,285,274,295,380,95,85,106,23,2.5843485873764984,3.0393138113011444,3.4433662618913385,0.23855464162836718,354,341,366,428,74,62,87,46,0.7794223022505096,1.3741312654489606,1.9678847827663553,0.6117603664790346,23897,24423,Aransas+Calhoun+Refugio,Aransas,48,7,Texas,TX
48057,48CS003,163,154,172,216,53,44,62,11,1.662974269969394,2.0860567423595775,2.4754165634406564,0.20404962537965776,197,187,207,268,71,61,81,29,1.953745431431997,2.5571055923478085,3.1694373550422728,0.4024373777212003,20187,19774,Aransas+Calhoun+Refugio,Calhoun,48,57,Texas,TX
48391,48CS003,72,71,73,100,28,27,29,17,1.5153516906846196,1.618373703606908,1.7125146751041131,0.5875183398650734,88,87,89,112,24,23,25,13,1.7914577639869484,1.9278884373717484,2.076800647533791,0.5220847375049056,6759,6755,Aransas+Calhoun+Refugio,Refugio,48,391,Texas,TX
48009,48CS004,76,75,77,76,0,-1,1,4,-0.5622034206033106,-0.46164801326090554,-0.36394145727905597,3.8569395182140824,94,93,95,112,18,17,19,22,-0.7176250490367134,-0.5602575678416672,-0.4045497403577399,1.1598502741351515,8590,8663,Archer+Wichita,Archer,48,9,Texas,TX
48485,48CS004,1163,1107,1219,1403,240,184,296,240,-0.43239329738348303,-0.011221061600281801,0.4153349804299026,0.9970660293641607,1430,1362,1497,1775,345,278,413,306,-0.25114299130480006,0.36722209600474354,0.9989009684337034,0.8833215529187604,130006,129993,Archer+Wichita,Wichita,48,485,Texas,TX
48013,48CS005,350,328,371,485,135,114,157,89,0.5221486453819825,0.9420860610666308,1.3692538290477594,0.6521867222747609,434,409,460,627,193,167,218,136,0.757771224230414,1.372332314865444,1.9514766668199122,0.7027202784572217,49477,49815,Atascosa+Live Oak+McMullen,Atascosa,48,13,Texas,TX
48297,48CS005,101,100,102,131,30,29,31,17,1.0329415097402854,1.144101710754809,1.2470078679824115,0.5463754696358886,122,121,124,155,33,31,34,30,0.11770424226762084,0.2684972839014671,0.4171348396524892,0.8937479237969832,11477,11372,Atascosa+Live Oak+McMullen,Live Oak,48,297,Texas,TX
48311,48CS005,8,8,8,17,9,9,9,6,5.398064905658075,5.494468782454915,5.595358378388091,0.5768341781233343,9,9,9,14,5,5,5,3,3.6078836876137337,3.7608258009532296,3.9194405939300365,0.508152519415786,619,607,Atascosa+Live Oak+McMullen,McMullen,48,311,Texas,TX
48015,48CS006,241,228,254,271,30,17,43,19,-0.05763496407478893,0.3581749936205866,0.8124133132627308,0.6196422315555253,297,282,313,365,68,52,83,42,0.39366949649153793,1.0149937199270087,1.620871959387332,0.6103674827700377,30137,30340,Austin+Waller+Washington,Austin,48,15,Texas,TX
48473,48CS006,305,280,329,395,90,66,115,27,0.6736778430959913,1.103818526630993,1.5590844397704982,0.2953457432893485,389,358,420,501,112,81,143,78,0.11626915186554058,0.6880502812255836,1.3474321529210984,0.6893958671965432,57305,59426,Austin+Waller+Washington,Waller,48,473,Texas,TX
48477,48CS006,320,305,336,416,96,80,111,65,0.4267105216048134,0.862629299426121,1.2749578684684988,0.6726452947186577,392,373,410,521,129,111,148,76,1.1388824612534878,1.763188562402324,2.4049540576376938,0.5837321261042182,35812,35883,Austin+Waller+Washington,Washington,48,477,Texas,TX
48019,48CS007,204,194,213,264,60,51,70,15,1.667566258103836,2.129708208494171,2.5644455702759332,0.24390761358765956,251,240,262,329,78,67,89,49,0.9806097835130834,1.6148035784087293,2.253569608691072,0.6209325439951945,21367,21481,Bandera+Kendall+Kerr,Bandera,48,19,Texas,TX
48259,48CS007,329,310,349,379,50,30,69,38,-0.1486831647433978,0.26333900066711907,0.6808735915413361,0.7481613512368622,416,392,440,457,41,17,65,58,-1.0524490080229219,-0.4401573763293515,0.1916589757844964,1.3908636225426556,45184,46458,Bandera+Kendall+Kerr,Kendall,48,259,Texas,TX
48265,48CS007,635,612,657,699,64,42,87,51,-0.18554034342423215,0.24972771531645205,0.6655625984798145,0.7822524228993093,778,750,805,863,85,58,113,92,-0.782606420117659,-0.13227522491025323,0.46577819383356395,1.0652589499822072,52689,53090,Bandera+Kendall+Kerr,Kerr,48,265,Texas,TX
48021,48CS008,680,638,722,697,17,-25,59,53,-0.8027573849248283,-0.37257875119391287,-0.0041611355530266105,3.001736054981377,870,817,922,943,73,21,126,144,-1.4240560342349338,-0.8350925519406194,-0.2650266448073516,1.939500745264708,97059,101464,Bastrop+Caldwell,Bastrop,48,21,Texas,TX
48055,48CS008,332,312,352,414,82,62,102,50,0.27331334571871235,0.7186720716837945,1.121561813165597,0.6012259008467308,415,391,439,489,74,50,98,102,-1.3097515252956462,-0.7457720467436704,-0.07084202758842159,1.366500156765798,45705,46671,Bastrop+Caldwell,Caldwell,48,55,Texas,TX
48025,48CS009,224,211,238,276,52,38,65,49,-0.3266240710598429,0.08780211953503998,0.5324506380421078,0.9286778551022817,276,260,292,398,122,106,138,90,0.6338035850948145,1.2533858757155472,1.8227007017431798,0.730852520720183,31221,30934,Bee+Goliad+Karnes,Bee,48,25,Texas,TX
48175,48CS009,67,67,68,64,-3,-4,-3,4,-1.1397986621111544,-1.0383751909916108,-0.948055402379718,-1.6907888896525962,83,82,84,98,15,14,16,19,-0.8202998123858788,-0.6655295645780919,-0.5118959680573086,1.1860476314095203,7109,7140,Bee+Goliad+Karnes,Goliad,48,175,Texas,TX
48255,48CS009,133,127,140,156,23,16,29,24,-0.527272832045667,-0.08549562785632459,0.3327168712825169,1.015274803732627,164,156,171,175,11,4,19,30,-2.068806733878355,-1.513516031735275,-0.8956196052852426,2.439959542188853,14817,14749,Bee+Goliad+Karnes,Karnes,48,255,Texas,TX
48027,48CS010,2089,1929,2249,2385,296,136,456,202,-0.20594252873343774,0.2469684269668618,0.6824021182062051,0.6809827259119493,2632,2437,2828,3349,717,521,912,551,-0.09234215747294496,0.5149430111667901,1.1452159382321792,0.767595183487543,371568,378503,Bell,Bell,48,27,Texas,TX
48029,48CS011,11851,10985,12718,14275,2424,1557,3290,1952,-0.18700989173567428,0.24448296681529033,0.706047527788154,0.8050664077547547,14736,13690,15782,18940,4204,3158,5250,3396,-0.10049724414377788,0.47941862773345206,1.1603909765150462,0.8076534247367099,2013837,2026168,Bexar+Wilson,Bexar,48,29,Texas,TX
48493,48CS011,356,334,377,382,26,5,48,37,-0.6418346109302466,-0.21771758558432439,0.24565434433284755,1.3491075816197968,445,418,471,641,196,170,223,115,1.336888658742034,1.9117752875815384,2.5295983428063935,0.5828136775162159,50265,51073,Bexar+Wilson,Wilson,48,493,Texas,TX
48035,48CS012,209,201,217,274,65,57,73,20,2.0311387602247617,2.4708709110992038,2.8799998501430006,0.3020022234202581,255,246,265,305,50,40,59,36,0.2792713565289261,0.8913893782460787,1.4834780541800494,0.7104223010070367,18318,18464,Bosque+Hamilton+Hill,Bosque,48,35,Texas,TX
48193,48CS012,115,115,116,105,-10,-11,-10,16,-3.30751979377859,-3.1977551320164905,-3.104232190971609,-1.6969015275123231,140,139,141,157,17,16,18,6,1.3956874871443479,1.5426704193605731,1.6939000616813384,0.3412393369702882,8264,8229,Bosque+Hamilton+Hill,Hamilton,48,193,Texas,TX
48217,48CS012,381,365,396,451,70,55,86,40,0.3946991912464376,0.8228432486206039,1.254635381818558,0.562687273421066,466,447,485,673,207,188,226,139,1.631483151751384,2.224729301272793,2.8534045143466016,0.6690031157284749,36101,36397,Bosque+Hamilton+Hill,Hill,48,217,Texas,TX
48037,48CS013,891,851,931,1063,172,132,212,126,0.08242482305170243,0.5060904691052112,0.9205090736449834,0.7291051753175043,1089,1042,1137,1379,290,242,337,228,0.16665741329241338,0.7961808026462331,1.440032422541969,0.7846545512196345,92874,92612,Bowie,Bowie,48,37,Texas,TX
48039,48CS014,2077,1916,2238,2443,366,205,527,239,-0.10249378971391808,0.34017522786684407,0.7711265939106013,0.6514736927467779,2603,2408,2799,3457,854,658,1049,605,0.11123358466138508,0.7756642116084146,1.3800644326188947,0.7077693601550533,374221,378767,Brazoria,Brazoria,48,39,Texas,TX
48041,48CS015,931,830,1032,1141,210,109,311,146,-0.15401731783782313,0.2509586075967425,0.6889548330912026,0.6918859451855037,1172,1050,1294,1414,242,120,364,216,-0.48141474648716853,0.13592825156380228,0.7370407401214772,0.8883969585855285,234008,236660,Brazos+Burleson+Grimes+Robertson,Brazos,48,41,Texas,TX
48051,48CS015,193,186,201,211,18,10,25,20,-0.5279745419148896,-0.13090687608863358,0.29303839179310504,1.0626739484373293,238,229,247,297,59,50,68,41,0.5591652683399816,1.1787830376724688,1.7543340207018943,0.6847372016922137,17800,17992,Brazos+Burleson+Grimes+Robertson,Burleson,48,51,Texas,TX
48185,48CS015,252,240,265,314,62,49,74,47,0.04171777893142734,0.4869155794682894,0.9491752737048694,0.7501826231496528,315,300,331,395,80,64,95,64,0.008488995863080877,0.6404551527755115,1.2372195665580417,0.7929590700350737,29436,30160,Brazos+Burleson+Grimes+Robertson,Grimes,48,185,Texas,TX
48395,48CS015,162,154,169,202,40,33,48,23,0.6147143302572016,1.033153987060511,1.4545420485884546,0.5556902550396843,199,190,207,267,68,60,77,48,0.8391848715286063,1.450390285680705,2.075234997592259,0.6909457870550011,16816,16926,Brazos+Burleson+Grimes+Robertson,Robertson,48,395,Texas,TX
48049,48CS016,432,416,448,584,152,136,168,73,1.6690109195520082,2.07317916153077,2.510034641045535,0.47712018006941675,531,512,551,647,116,96,135,107,-0.2936766634937903,0.24757949682923625,0.8715563384736515,0.9176823023978806,37988,38164,Brown+Coleman+Mills,Brown,48,49,Texas,TX
48083,48CS016,127,124,130,124,-3,-6,0,16,-2.9012096962443956,-2.451769921652398,-2.034443653442988,-7.814627831646428,155,151,159,214,59,55,63,42,2.055696402771765,2.6718599467807636,3.268680387067147,0.6978363539775743,7744,7726,Brown+Coleman+Mills,Coleman,48,83,Texas,TX
48333,48CS016,57,57,58,74,17,16,17,14,0.49105986907449406,0.5954095236978584,0.7002744599714675,0.7910012851781174,70,70,71,92,22,21,22,14,1.953911668068187,2.1159163966830716,2.2594116526334194,0.6121074510812007,4506,4474,Brown+Coleman+Mills,Mills,48,333,Texas,TX
48053,48CS017,473,452,495,498,25,3,46,30,-0.5788461071054206,-0.10864988578641145,0.3286331568458814,1.1763494950865485,596,570,622,691,95,69,121,114,-1.0452041226975566,-0.45566618355126326,0.11157608034056585,1.1840833536767101,49419,50731,Burnet+Lampasas+Llano,Burnet,48,53,Texas,TX
48281,48CS017,197,187,206,252,55,46,65,13,1.5433027191169877,1.939379082109192,2.42761224175419,0.23014764971883134,246,235,258,331,85,73,96,54,1.0423377608885536,1.6350769748865441,2.237606194444875,0.6304784281514875,21723,22173,Burnet+Lampasas+Llano,Lampasas,48,281,Texas,TX
48299,48CS017,283,274,292,302,19,10,28,17,-0.3199624013282849,0.0788267475964294,0.5244320633831304,0.8502751046001884,353,342,364,412,59,48,70,67,-1.0531856995628435,-0.43934271574393863,0.12078474228558472,1.119683556290529,21407,21872,Burnet+Lampasas+Llano,Llano,48,299,Texas,TX
48059,48CS018,146,140,152,196,50,44,56,26,1.314835947927085,1.706670307522253,2.142835618457673,0.5126214558816838,181,173,188,231,50,43,58,36,0.6345005738089038,1.2237794754216897,1.8562202028735806,0.6996832278268478,13816,14062,Callahan and Nearby Counties,Callahan,48,59,Texas,TX
48133,48CS018,210,202,217,230,20,13,28,18,-0.32010221114144055,0.14781845108970093,0.5773927395643526,0.8392191305601304,254,245,264,383,129,119,138,70,3.351097890771562,3.9570945947272285,4.5622018324486975,0.5398819182700452,17840,17848,Callahan and Nearby Counties,Eastland,48,133,Texas,TX
48253,48CS018,153,145,162,221,68,59,76,39,1.0307700075817727,1.4599611778434372,1.878131695652143,0.5676307430523009,188,178,198,261,73,63,83,62,0.03706136984848159,0.675665873716619,1.317731774160316,0.8351279330702509,19724,19844,Callahan and Nearby Counties,Jones,48,253,Texas,TX
48417,48CS018,25,24,25,38,13,13,14,8,1.6385652354323315,1.7460052241285322,1.8399697226643879,0.5519382905298778,30,30,31,42,12,11,12,6,1.9341772528098957,2.0825593923729264,2.229273733112005,0.47752822277997076,3153,3199,Callahan and Nearby Counties,Shackelford,48,417,Texas,TX
48429,48CS018,91,90,92,123,32,31,33,17,1.5236069112650137,1.630714499117435,1.7300864252681964,0.5170321578000899,112,111,113,144,32,31,33,24,0.9222130473508051,1.0758656666615305,1.2309355438910021,0.7217494022136405,9130,9159,Callahan and Nearby Counties,Stephens,48,429,Texas,TX
48061,48CS019,2342,2161,2523,3734,1392,1211,1573,1075,0.3496695499456533,0.7549856984985773,1.1812991757287428,0.7716971189243801,2911,2693,3130,3805,894,675,1112,740,-0.20462023602592616,0.4361366207278712,1.0158997158991576,0.8270562516129522,421595,422761,Cameron,Cameron,48,61,Texas,TX
48067,48CS020,331,319,343,455,124,112,136,60,1.7852428012172008,2.2225284771354366,2.6295773925643133,0.48082866370326327,403,388,418,586,183,168,198,111,2.3728884403723693,3.045682659014883,3.6333949488168282,0.6036045867724824,28650,28537,Cass+Marion+Morris,Cass,48,67,Texas,TX
48315,48CS020,144,140,148,163,19,15,23,21,-0.6361840018224421,-0.22165236380047285,0.22619347450226418,1.0571000381563993,173,168,178,212,39,34,44,40,-0.8282463028868763,-0.18393920948385348,0.4567642033935257,1.0113165235511414,9755,9661,Cass+Marion+Morris,Marion,48,315,Texas,TX
48343,48CS020,155,150,160,168,13,8,18,15,-0.5993898138139514,-0.18529128702668946,0.26067612949651564,1.0745114999405163,189,183,195,228,39,33,45,43,-0.989020139203797,-0.37381657676862795,0.23535626656511546,1.069510456783947,12025,12020,Cass+Marion+Morris,Morris,48,343,Texas,TX
48071,48CS021,277,257,297,334,57,37,77,28,0.190184245594827,0.6343084873841235,1.0222237457453656,0.48057891049761686,352,327,377,418,66,41,91,86,-1.0920218586761365,-0.48801191364460983,0.10106353919610639,1.2809688683302294,46755,48600,Chambers+Liberty,Chambers,48,71,Texas,TX
48291,48CS021,764,724,804,768,4,-36,44,92,-1.3789919204644554,-0.9558808723875153,-0.4933955653646999,17.889172389590904,975,925,1025,1153,178,128,228,240,-1.388666256344076,-0.7741952908072,-0.12267735683673163,1.3371612016677488,92332,96852,Chambers+Liberty,Liberty,48,291,Texas,TX
48073,48CS022,464,442,486,601,137,115,159,97,0.3659999164454795,0.7818311235480813,1.2181402316272394,0.701516866322128,570,544,597,794,224,197,250,148,1.1515753280436458,1.7631575861205173,2.339195958387284,0.6587015923844254,50846,51007,Cherokee,Cherokee,48,73,Texas,TX
48077,48CS023,108,107,109,128,20,19,21,13,0.5733605078992958,0.678562043144759,0.7789525933517985,0.6199196779309037,132,131,134,151,19,17,20,16,0.14674106183518398,0.2882829016032342,0.4490902082655794,0.8204190317723986,10279,10260,Clay+Cooke+Montague,Clay,48,77,Texas,TX
48097,48CS023,373,355,391,424,51,33,69,39,-0.1308360653530184,0.30629180891623203,0.7121680943427876,0.7451644469891585,463,442,485,520,57,35,78,85,-1.466966293177601,-0.8077938382442782,-0.19734207791875266,1.4747113070623776,41663,42164,Clay+Cooke+Montague,Cooke,48,97,Texas,TX
48337,48CS023,245,237,254,325,80,71,88,41,1.4750328222057474,1.9267354103237746,2.3299809121833803,0.5086881062864574,305,294,315,368,63,53,74,55,-0.1281038408758316,0.47305864935708286,1.0698374390192669,0.8566700958881407,19997,20345,Clay+Cooke+Montague,Montague,48,337,Texas,TX
48085,48CS024,4222,3759,4684,4832,610,148,1073,443,-0.3020622507231162,0.16243905908016118,0.6069773419903424,0.7244778229732565,5448,4878,6018,6210,762,192,1332,819,-0.7010750967890188,-0.06628055039074628,0.543852957508484,1.0738355587391448,1071379,1104166,Collin,Collin,48,85,Texas,TX
48091,48CS025,1215,1144,1285,1357,142,72,213,137,-0.4013565714245467,0.032970955963265554,0.4666917291352742,0.9557581587747257,1574,1484,1663,1785,211,122,301,289,-1.1605078454049498,-0.54485322004187,0.06472925745001021,1.3621180130186765,163721,173322,Comal,Comal,48,91,Texas,TX
48093,48CS026,158,152,164,194,36,30,42,36,-0.39546051983952724,0.01724323588867121,0.43006973225958683,0.9684408918461118,193,186,200,220,27,20,34,32,-1.0665739137269623,-0.4523594569518103,0.22135555080909047,1.151415019650125,13622,13749,Comanche+Erath+Somervell,Comanche,48,93,Texas,TX
48143,48CS026,288,270,307,315,27,8,45,37,-0.6327312409642825,-0.22344270154291457,0.17987412732218663,1.327926602850816,356,334,379,462,106,83,128,79,0.12815795288353135,0.7253833738417268,1.3104380045423516,0.7405443338289487,42758,43281,Comanche+Erath+Somervell,Erath,48,143,Texas,TX
48425,48CS026,82,82,83,99,17,16,17,3,1.3639713352730007,1.4672669354354675,1.5729792513913392,0.1709661360143973,103,102,104,123,20,19,21,17,0.1883566956626152,0.34809285870057977,0.5044087519676829,0.8200352635323465,9227,9432,Comanche+Erath+Somervell,Somervell,48,425,Texas,TX
48099,48CS027,464,429,500,534,70,34,105,40,-0.04059267945634008,0.36442989807276677,0.8028047303373473,0.5652256758872497,585,542,628,704,119,76,162,130,-0.7288150761222912,-0.14811835909653673,0.463477267149622,1.0826140177532322,82259,84066,Coryell,Coryell,48,99,Texas,TX
48105,48CS028,30,29,32,56,26,24,27,10,4.540551234991034,4.964137693863051,5.406273781860302,0.3751748804697592,37,35,38,55,18,17,20,6,4.2553227173784975,4.895308825997481,5.454377617009629,0.3079833427205446,3159,3074,Crockett+Kinney+Terrell+Val Verde,Crockett,48,105,Texas,TX
48271,48CS028,31,29,32,45,14,13,16,4,2.769153906977581,3.1928364838101997,3.6196986209280175,0.26159432916505276,37,36,39,53,16,14,17,2,4.688459797057717,5.293981015586892,5.922689853609272,0.11885058078026403,3206,3130,Crockett+Kinney+Terrell+Val Verde,Kinney,48,271,Texas,TX
48443,48CS028,9,9,9,12,3,3,3,3,-0.6350811710993199,-0.5333784600614757,-0.4272750544482448,0.8321267108732969,11,11,11,20,9,9,9,4,7.635913207013283,7.791626677216172,7.933241257290677,0.4115444683980179,743,727,Crockett+Kinney+Terrell+Val Verde,Terrell,48,443,Texas,TX
48465,48CS028,328,308,349,498,170,149,190,162,-0.26331855550948624,0.16156805635537672,0.5891938953728133,0.949805396660866,406,381,430,499,93,69,118,99,-0.7519715833446481,-0.13270565656191444,0.46451872077269335,1.049029115242291,47793,47567,Crockett+Kinney+Terrell+Val Verde,Val Verde,48,465,Texas,TX
48107,48CS029,55,54,55,83,28,28,29,23,0.9208895020365668,1.0205900748343504,1.1220097960849185,0.7851318771610228,66,65,67,99,33,32,34,20,2.8972378450056846,3.0448459056573585,3.200099169721603,0.589302386971224,5187,5105,Crosby+Floyd+Hale+Swisher,Crosby,48,107,Texas,TX
48153,48CS029,50,50,51,93,43,42,43,27,2.7981559470510566,2.902812191100261,3.000328809223969,0.6169659061736331,61,60,62,93,32,31,33,15,3.683017470795323,3.837381211056434,3.9925994700562843,0.4525250440948961,5430,5354,Crosby+Floyd+Hale+Swisher,Floyd,48,153,Texas,TX
48189,48CS029,265,251,279,392,127,113,141,129,-0.5290822646962441,-0.06711184467430606,0.367124271742757,1.0076804687682037,326,309,342,394,68,52,85,76,-0.9076598733307307,-0.298953178814458,0.3214589551293553,1.094830020020473,32512,32252,Crosby+Floyd+Hale+Swisher,Hale,48,189,Texas,TX
48437,48CS029,69,69,70,99,30,29,30,12,2.390609824548614,2.4963674108767018,2.592617884632299,0.3929179721835633,85,84,86,96,11,10,12,13,-0.49680221261980295,-0.33552067984404715,-0.17963920225483337,1.0793504253627366,7027,7001,Crosby+Floyd+Hale+Swisher,Swisher,48,437,Texas,TX
48113,48CS030,13906,12784,15028,17173,3267,2145,4389,2301,-0.04780715815693603,0.3743810117846067,0.7751085056200426,0.7041271532156845,17124,15787,18461,20545,3421,2084,4758,3389,-0.6406225730109614,0.020247640932154375,0.654343188161682,0.9902485017507032,2611957,2589682,Dallas,Dallas,48,113,Texas,TX
48121,48CS031,3553,3160,3947,4109,556,162,949,405,-0.2646717299038434,0.18142431004710102,0.596799633228126,0.727714612868149,4571,4087,5056,5335,764,279,1248,693,-0.5417632868084776,0.09885381657676584,0.7454453353291248,0.9064576350855886,913125,937601,Denton,Denton,48,121,Texas,TX
48127,48CS032,67,66,68,91,24,23,25,13,1.138913104149969,1.238954005828854,1.3404754795348306,0.5223767419326212,79,78,81,154,75,73,76,35,5.432627847435176,5.587616650373578,5.727565897614729,0.46357383927841467,8778,8486,Dimmit+La Salle+Maverick,Dimmit,48,127,Texas,TX
48283,48CS032,44,43,45,68,24,23,25,19,0.6222925307826598,0.7213497689778288,0.8222409707683486,0.7635195134515763,53,52,54,84,31,30,32,25,0.8830220722031374,1.042626789649749,1.1890220086028815,0.7871644453696635,6777,6666,Dimmit+La Salle+Maverick,La Salle,48,283,Texas,TX
48323,48CS032,344,338,350,611,267,261,273,216,0.7768240405150909,0.8758732638226904,0.9856905182105274,0.8064377401191332,423,416,431,612,189,181,196,201,-0.4069805530633417,-0.24869167006002132,-0.09221839089188542,1.0590840554994823,57941,58025,Dimmit+La Salle+Maverick,Maverick,48,323,Texas,TX
48047,48CS033,67,67,68,101,34,33,34,28,0.7092285244808235,0.8032032448519705,0.9080043915346483,0.807549486534901,82,81,83,97,15,14,16,20,-1.0505695735485887,-0.894517088412566,-0.7514138083010532,1.2656734425534855,7035,6999,Duval and Nearby Counties,Brooks,48,47,Texas,TX
48131,48CS033,98,97,99,123,25,24,26,25,-0.09191138671992118,0.01651276322593217,0.1219754306805874,0.95459017064557,117,116,118,172,55,54,56,31,2.7697382950643976,2.924642869224159,3.0688851892562807,0.5556597285334172,9997,9764,Duval and Nearby Counties,Duval,48,131,Texas,TX
48247,48CS033,40,39,40,54,14,14,15,12,0.3334163895601972,0.42834008394898354,0.527810889905699,0.7955898063894309,48,48,49,69,21,20,21,4,4.021927592635048,4.172918192944446,4.322011712402956,0.18434112178680245,4882,4807,Duval and Nearby Counties,Jim Hogg,48,247,Texas,TX
48249,48CS033,330,313,346,429,99,83,116,68,0.35225213953821277,0.8074515873671595,1.2378568792060964,0.6777835276134985,403,383,423,594,191,171,211,109,1.9320028626154246,2.528145436105318,3.183125517621406,0.5673602974616876,39073,38842,Duval and Nearby Counties,Jim Wells,48,249,Texas,TX
48505,48CS033,82,81,84,115,33,31,34,22,0.6610214025328792,0.7664377397155561,0.8608914454235267,0.6537120360010712,101,100,103,139,38,36,39,23,1.1028021428121169,1.261913047404226,1.4171620858940053,0.5955655072911303,13936,13904,Duval and Nearby Counties,Zapata,48,505,Texas,TX
48011,48CS034,24,24,24,34,10,10,10,7,1.482845479925388,1.577533491466726,1.6814941414327271,0.6413058030545553,29,29,29,31,2,2,2,4,-1.5619593479983716,-1.4141740569255825,-1.245247201770002,1.4102937846770998,1847,1840,Eastern Central Panhandle,Armstrong,48,11,Texas,TX
48023,48CS034,51,51,52,57,6,5,6,6,-0.2404901689621331,-0.13394542625403044,-0.033238983370438326,0.9178517724838342,63,62,63,81,18,18,19,17,0.33970277387261466,0.4959394830924926,0.6503896883917809,0.8749024006409591,3474,3475,Eastern Central Panhandle,Baylor,48,23,Texas,TX
48045,48CS034,15,15,15,22,7,7,7,3,2.637601797574429,2.7271243893818515,2.8323476177436113,0.37855004836268413,18,18,18,16,-2,-2,-2,5,-6.054223689967838,-5.912052281076371,-5.748950143752404,-5.424585895401107,1437,1406,Eastern Central Panhandle,Briscoe,48,45,Texas,TX
48075,48CS034,61,61,62,72,11,10,11,13,-0.44136352986408384,-0.3407739161757716,-0.23377233481156812,1.1102991629452605,74,73,75,84,10,9,11,13,-0.7374203137537527,-0.5784907086884573,-0.4341114012921835,1.2119619737629983,6741,6723,Eastern Central Panhandle,Childress,48,75,Texas,TX
48101,48CS034,21,21,22,27,6,5,6,6,-0.6793539439052909,-0.28006519109252087,0.1364443443461522,0.9059964219063779,26,26,27,21,-5,-6,-5,8,-12.086292009343877,-11.475682637578478,-10.870432339687744,-1.897080871331775,1376,1380,Eastern Central Panhandle,Cottle,48,101,Texas,TX
48125,48CS034,19,19,19,38,19,19,19,7,6.371380177264448,6.465741749828531,6.567396221745156,0.3541172022098704,22,22,23,30,8,7,8,4,2.337122063004998,2.4911467324147476,2.6487610175412,0.4641740976263463,1820,1743,Eastern Central Panhandle,Dickens,48,125,Texas,TX
48129,48CS034,41,40,41,47,6,6,7,5,0.29894847042509465,0.39329515746113786,0.5000733991280892,0.6855271544596999,49,49,50,64,15,14,15,12,0.787377436413979,0.9219847055548557,1.0731348463013712,0.772931497515192,3268,3268,Eastern Central Panhandle,Donley,48,129,Texas,TX
48155,48CS034,17,16,17,27,10,10,11,4,5.109609096463487,5.520191397586846,5.93253040693346,0.3621381315350495,21,20,21,25,4,4,5,3,1.0009243625915414,1.6039394057732077,2.285475240111914,0.54898240444964,1096,1081,Eastern Central Panhandle,Foard,48,155,Texas,TX
48191,48CS034,35,34,35,47,12,12,13,7,1.8389360836120907,1.9384799226882226,2.0333826080261264,0.5186429598776764,42,42,42,52,10,10,10,5,1.9661584124802636,2.1164415816040196,2.2640138547689452,0.45492585252518175,2833,2839,Eastern Central Panhandle,Hall,48,191,Texas,TX
48197,48CS034,37,37,37,68,31,31,31,10,5.711361351173028,5.813506157703051,5.92075132670768,0.31256342897267203,44,44,45,45,1,0,1,4,-1.2388258016188873,-1.0981647243280035,-0.9377937978371726,2.2662258102454946,3612,3553,Eastern Central Panhandle,Hardeman,48,197,Texas,TX
48207,48CS034,59,58,59,71,12,12,13,15,-0.6183259993468913,-0.5158431347728591,-0.420870311436722,1.1388506321401064,71,70,72,111,40,39,41,20,4.305418748524049,4.458720179104112,4.60565921062266,0.4866324298722886,5458,5413,Eastern Central Panhandle,Haskell,48,207,Texas,TX
48269,48CS034,4,4,4,4,-0,-0,-0,4,-15.980795116361003,-15.553667753884504,-15.121618463118379,4.806261326153113,5,5,5,8,3,3,3,8,-23.345204836380635,-22.767425787936357,-22.17954695546525,1.9683276309303388,268,260,Eastern Central Panhandle,King,48,269,Texas,TX
48275,48CS034,41,40,41,66,25,25,26,12,3.8413436731217843,3.941405319366079,4.046071667456842,0.4542975941756098,49,48,49,71,22,22,23,10,4.296998061847736,4.451076141949741,4.604119876965041,0.4269391057139534,3404,3352,Eastern Central Panhandle,Knox,48,275,Texas,TX
48345,48CS034,17,16,17,18,1,1,2,5,-3.726388850328438,-3.3145440630071064,-2.9020609576173877,2.057563846574043,20,20,21,31,11,10,11,2,9.213526742746641,9.88890620672271,10.472058770161524,0.1699062313912385,1075,1065,Eastern Central Panhandle,Motley,48,345,Texas,TX
48433,48CS034,19,19,20,25,6,5,6,6,-0.7228202207415493,-0.3187094672639031,0.09202211263602954,0.9103892569951443,23,23,24,24,1,0,1,6,-5.748401653681803,-5.1067154979014076,-4.487186789077461,3.3343164631623394,1255,1221,Eastern Central Panhandle,Stonewall,48,433,Texas,TX
48447,48CS034,18,18,18,15,-3,-3,-3,6,-6.403106106584754,-6.304988405106045,-6.2064188562669385,-2.7784819298252463,23,22,23,23,0,0,1,8,-6.285478133638106,-6.1315757448856125,-5.977276943227386,5.699292284914894,1453,1487,Eastern Central Panhandle,Throckmorton,48,447,Texas,TX
48487,48CS034,151,146,157,182,31,25,36,38,-0.9849954354207697,-0.5529052265840174,-0.13066423014998055,1.1885228379250572,185,178,191,198,13,7,20,37,-2.853027980076586,-2.2398472725897665,-1.603660011407307,2.5941414356301538,12812,12748,Eastern Central Panhandle,Wilbarger,48,487,Texas,TX
48135,48CS035,1070,999,1141,1393,323,252,394,268,-0.1049533562542269,0.33312867047184147,0.7334457136125707,0.828027137272186,1295,1212,1379,1614,319,235,402,317,-0.5767986693908342,-0.02113958364806776,0.5853546929080312,0.9912172284403551,165119,161729,Ector,Ector,48,135,Texas,TX
48139,48CS036,1211,1127,1294,1420,209,126,293,184,-0.30064215407407596,0.12903129188447932,0.5465315905855681,0.8751216957686296,1545,1441,1649,1820,275,171,379,283,-0.6980432497340787,-0.05711400274938052,0.5770557752824896,1.0268456926313274,193761,201452,Ellis,Ellis,48,139,Texas,TX
48141,48CS037,4833,4462,5205,7370,2537,2165,2908,2091,0.0936335457216549,0.5215701684298376,0.9647818342845488,0.8239083915815472,6026,5578,6474,7290,1264,816,1712,1193,-0.5959487247758996,0.11735606060085042,0.7165344355549345,0.9431791469404445,862116,867677,El Paso,El Paso,48,141,Texas,TX
48145,48CS038,157,150,165,168,11,3,18,22,-1.0836290186636082,-0.6716676404456968,-0.19715556247826976,1.9076287737295472,195,186,204,245,50,41,59,38,0.23300077066284927,0.8497241089101164,1.4551688361040496,0.7398310222880216,17044,17262,Falls+Lee+Milam,Falls,48,145,Texas,TX
48287,48CS038,163,155,170,196,33,26,41,29,-0.22601848416822873,0.24753904354318979,0.6859332256175735,0.8474292040964838,200,191,210,209,9,-1,18,27,-1.875144007855484,-1.261015443267074,-0.6556654366072435,2.8228385425821414,17491,17676,Falls+Lee+Milam,Lee,48,287,Texas,TX
48331,48CS038,249,238,259,256,7,-3,18,19,-0.8906542938139146,-0.48054033071665525,-0.05134356604055921,2.3199015141203922,306,294,319,414,108,95,120,74,0.970840081991268,1.5940591652154135,2.2403936750921454,0.6819683239043144,24763,25050,Falls+Lee+Milam,Milam,48,331,Texas,TX
48147,48CS039,395,380,411,427,32,16,47,65,-1.374700210668135,-0.9384194866184343,-0.48110687506264604,1.989232276389134,492,473,511,597,105,86,124,103,-0.5315844709262288,0.06841196169435247,0.6937928147629168,0.970754829248099,35793,36447,Fannin+Lamar+Red River,Fannin,48,147,Texas,TX
48277,48CS039,535,514,557,675,140,118,161,97,0.3938210894040666,0.8739021057367526,1.266048556634684,0.689752773583005,656,630,682,823,167,141,193,126,0.3780517050483474,0.9893370027748765,1.5811758728811345,0.7488778820918421,50036,50095,Fannin+Lamar+Red River,Lamar,48,277,Texas,TX
48387,48CS039,156,151,161,213,57,52,62,28,2.012565948408947,2.4541734287638333,2.904437930690682,0.4853480027933881,190,184,196,230,40,34,46,29,0.49815254583461444,1.146196998933377,1.8033645794477282,0.7044285851630124,11630,11554,Fannin+Lamar+Red River,Red River,48,387,Texas,TX
48157,48CS040,3118,2761,3476,3864,746,388,1103,429,-0.02402887013767942,0.383174020247929,0.8162412936272374,0.5745529886305797,4031,3590,4472,4852,821,380,1262,640,-0.34798472212826725,0.26800203759968627,0.8267447731981835,0.7789053334711717,829428,854167,Fort Bend,Fort Bend,48,157,Texas,TX
48161,48CS041,187,179,196,245,58,49,66,31,0.9559188393311764,1.3451636221797465,1.842359435378842,0.5285972723890892,232,222,242,255,23,13,33,46,-1.9832491327470632,-1.4093746972569925,-0.8078759580585624,1.9380896309288997,19524,19726,Freestone+Leon+Limestone+Navarro,Freestone,48,161,Texas,TX
48289,48CS041,172,165,179,217,45,38,52,22,0.999724456826801,1.4351062121869513,1.8812145867599608,0.4771509608819063,211,202,219,274,63,55,72,38,1.2933994547622416,1.910376182063258,2.526530473796684,0.5902333076782983,15998,15925,Freestone+Leon+Limestone+Navarro,Leon,48,289,Texas,TX
48293,48CS041,226,217,236,297,71,61,80,28,1.4527667955226093,1.908104717899894,2.3750377072520132,0.3913511586840073,276,265,288,399,123,111,134,78,1.8336683959451234,2.4179626926690756,3.0182293581675896,0.629849462433433,22292,22117,Freestone+Leon+Limestone+Navarro,Limestone,48,293,Texas,TX
48349,48CS041,512,490,535,527,15,-8,37,74,-1.5643263997166084,-1.1383806408565067,-0.7008137628164665,4.73234183144788,638,610,666,685,47,19,75,136,-2.6184923512179425,-1.9869645855849822,-1.398066742467488,2.8337861559799125,52459,53473,Freestone+Leon+Limestone+Navarro,Navarro,48,349,Texas,TX
48163,48CS042,129,121,137,157,28,20,36,21,-0.06734671559557241,0.36546967161124577,0.7603587515091206,0.7340345309858526,159,150,169,223,64,54,73,57,-0.13802325887614653,0.4506105157281878,1.0631509116841353,0.8778157083418778,18641,18426,Frio+Medina+Uvalde+Zavala,Frio,48,163,Texas,TX
48325,48CS042,386,364,408,447,61,39,83,57,-0.36590889047641134,0.0655533548869632,0.4497797904947617,0.9216905590196917,483,456,510,587,104,77,131,120,-0.9863498692701117,-0.35600479932195506,0.2697109407313323,1.1426555181067322,51131,51826,Frio+Medina+Uvalde+Zavala,Medina,48,325,Texas,TX
48463,48CS042,202,192,213,281,79,68,89,40,1.1195889064570674,1.5388963449082145,1.9638681985242883,0.5017866870220583,248,236,261,350,102,89,114,72,0.8245406547135371,1.4420025213720566,2.0388933997803265,0.7022999047124289,24888,24701,Frio+Medina+Uvalde+Zavala,Uvalde,48,463,Texas,TX
48507,48CS042,79,78,80,140,61,60,62,27,3.3236070528952766,3.4214379802067243,3.5244359991808025,0.4351849336398511,93,92,94,149,56,55,57,26,3.5952397972266357,3.7477046305926907,3.8896022346153525,0.45797827424395643,9954,9551,Frio+Medina+Uvalde+Zavala,Zavala,48,507,Texas,TX
48003,48CS043,117,116,119,128,11,9,12,32,-1.243173335347065,-1.1516360082151578,-1.0437433039519473,2.7643039906484805,143,141,146,158,15,12,17,35,-1.4742613495677528,-1.325781504318492,-1.1736701597880645,2.2521470322175507,18625,18465,Gaines and Nearby Counties,Andrews,48,3,Texas,TX
48115,48CS043,124,119,129,169,45,40,50,52,-0.9796016435532187,-0.5612527886910548,-0.14597228358214334,1.1296629492330739,151,145,157,166,15,9,21,31,-2.1625704403230865,-1.556501053201968,-0.9197966113016897,1.9448571064705698,12516,12417,Gaines and Nearby Counties,Dawson,48,115,Texas,TX
48165,48CS043,112,110,114,147,35,33,37,33,-0.013435495452792321,0.08559578883303166,0.18136284186296683,0.9200471297300252,140,137,142,176,36,34,39,40,-0.33901905761676226,-0.20618217760906943,-0.05637264215066926,1.070958421927131,21698,21867,Gaines and Nearby Counties,Gaines,48,165,Texas,TX
48305,48CS043,50,49,50,82,32,32,33,16,2.750456296913543,2.848666013625145,2.942462767439267,0.4829338727643129,61,61,62,85,24,23,24,14,1.9081029111626473,2.039869571029421,2.186233260823679,0.567716141002702,5666,5676,Gaines and Nearby Counties,Lynn,48,305,Texas,TX
48317,48CS043,41,40,41,56,15,15,16,17,-0.41232447483103,-0.3125365937491568,-0.2183629599935389,1.0400979019855499,49,48,50,52,3,2,4,2,0.06533766452515653,0.21850982928772453,0.3671826303744458,0.5043046857667206,5318,5217,Gaines and Nearby Counties,Martin,48,317,Texas,TX
48445,48CS043,123,118,129,155,32,26,37,44,-1.4725352620988579,-1.046177504903279,-0.6133368907392499,1.3508314479359016,150,144,156,148,-2,-8,4,26,-3.4680362875409485,-2.8880950837730555,-2.2791470661887305,-23.975764064455333,11870,11760,Gaines and Nearby Counties,Terry,48,445,Texas,TX
48501,48CS043,50,49,50,81,31,31,32,22,1.1007067369293808,1.1960905249121345,1.2933036104679143,0.680439630091752,60,59,61,78,18,17,19,13,0.698327997393314,0.8459058470342982,0.9928688038957016,0.6725795464810064,7811,7616,Gaines and Nearby Counties,Yoakum,48,501,Texas,TX
48167,48CS044,2504,2353,2655,2863,359,208,510,220,-0.01927292076182461,0.39629681290371255,0.8116192122838283,0.6104488266913705,3110,2927,3293,3687,577,394,760,474,-0.26563256076873537,0.36092793382296295,0.9895491900303374,0.8199255356838915,350387,354536,Galveston,Galveston,48,167,Texas,TX
48181,48CS045,1290,1232,1349,1533,243,184,301,192,-0.033080474787101445,0.3736563811154298,0.8168679672178346,0.787922192722489,1605,1534,1677,1971,366,294,437,339,-0.3823852946886543,0.22206975044009264,0.8354396070546017,0.9242210254516533,136379,138852,Grayson,Grayson,48,181,Texas,TX
48183,48CS046,1128,1074,1181,1404,276,223,330,175,0.42015305990653395,0.8146807065612335,1.2367029930574567,0.630763564524077,1384,1320,1448,1827,443,379,507,325,0.5150776050229641,1.1345936654559814,1.7802223376457755,0.7323783825813969,124166,124197,Gregg,Gregg,48,183,Texas,TX
48187,48CS047,1041,967,1116,1169,128,53,202,119,-0.3675078159389715,0.0413705249969788,0.4725891502887347,0.9234593569569542,1311,1220,1402,1617,306,215,397,249,-0.23422556900368102,0.3986692423029372,0.9884669506005834,0.8105128316097832,172947,176526,Guadalupe,Guadalupe,48,187,Texas,TX
48199,48CS048,504,480,528,574,70,46,94,54,-0.17194378857771875,0.2880319756286561,0.7051132835250012,0.7601895677985342,623,594,653,806,183,153,212,162,-0.18416255036310333,0.4287009605048291,1.1111580864309312,0.8814018190880724,56571,56872,Hardin,Hardin,48,199,Texas,TX
48201,48CS049,22991,20958,25025,28388,5397,3363,7430,3653,-0.044306208071054724,0.36500409623586505,0.7812521187686207,0.6767922158227888,28606,26165,31047,36171,7565,5124,10006,6096,-0.23132188706278473,0.36270052222811244,0.9819098512228289,0.8057000596644445,4728636,4728681,Harris,Harris,48,201,Texas,TX
48203,48CS050,585,556,615,669,84,54,113,84,-0.46473073664320014,-0.019686318105131592,0.42755574280410247,0.9917353441400987,721,685,756,945,224,189,260,159,0.4962272544101054,1.156019081172995,1.7404279306230188,0.7051254879941354,68482,69096,Harrison+Upshur,Harrison,48,203,Texas,TX
48459,48CS050,403,385,421,474,71,53,89,49,0.15328625045724809,0.5459332407352844,0.96041564874654,0.679385383120838,498,476,519,659,161,140,183,137,0.07257317577142398,0.7160350507708363,1.3528056677010287,0.8434380115695541,41165,41657,Harrison+Upshur,Upshur,48,459,Texas,TX
48209,48CS051,1093,988,1198,1140,47,-58,152,102,-0.6794805821096345,-0.22410169015988923,0.1749765016068452,2.12527617848835,1415,1284,1546,1649,234,103,365,238,-0.6482242103342203,-0.007829490696062726,0.6430641474755473,1.013112581881109,243061,253707,Hays,Hays,48,209,Texas,TX
48213,48CS052,953,917,988,1130,177,142,213,99,0.5037300699867578,0.9600422962202386,1.3847910478126662,0.5559367052669001,1175,1132,1218,1566,391,348,434,288,0.8713111906585249,1.4700935922043772,2.093258701023365,0.7348493258324243,82555,83475,Henderson,Henderson,48,213,Texas,TX
48215,48CS053,3904,3529,4280,6443,2539,2163,2914,2013,0.17161284783592887,0.6162575330469711,1.0556575296678843,0.7926448736479877,4917,4464,5371,6403,1486,1032,1939,1202,-0.1966486904962296,0.3803546512543469,1.0149938736186273,0.8086013378654617,872326,879167,Hidalgo,Hidalgo,48,215,Texas,TX
48221,48CS054,651,624,678,767,116,89,143,74,0.2435827501143172,0.6814557846643217,1.098259981891791,0.6323593318411557,814,781,847,991,177,144,210,128,0.3113047605645919,0.9035993143044431,1.4969114415277234,0.7207049723360981,62162,63891,Hood,Hood,48,221,Texas,TX
48063,48CS055,136,131,142,173,37,31,42,23,0.6613229433771671,1.079657077382698,1.521250254783602,0.6124306395801876,168,162,175,232,64,57,70,41,1.5794801285621656,2.189663967468202,2.8629112018800593,0.6318002478743096,12559,12592,Hopkins and Nearby Counties,Camp,48,63,Texas,TX
48119,48CS055,59,59,60,79,20,19,20,1,3.447245588874238,3.5537001704674007,3.660286363821639,0.048316782414979206,74,73,75,91,17,16,18,17,-0.1600567737574892,-0.018116313139813305,0.14935223527466387,0.9471240244100001,5263,5369,Hopkins and Nearby Counties,Delta,48,119,Texas,TX
48159,48CS055,100,99,102,137,37,35,38,14,2.052717228744632,2.158254199036936,2.2571047338799204,0.3732499097480989,123,122,125,128,5,3,6,23,-2.263940144848058,-2.1001431596880424,-1.956690318831609,4.075742015999985,10432,10450,Hopkins and Nearby Counties,Franklin,48,159,Texas,TX
48223,48CS055,357,341,373,448,91,75,107,87,-0.324144306636829,0.10276064559035139,0.5386102464475127,0.9434544267864413,442,423,461,523,81,62,100,67,-0.18104279711937965,0.4691551836258404,1.05033466738137,0.8140854760862374,36877,37150,Hopkins and Nearby Counties,Hopkins,48,223,Texas,TX
48449,48CS055,250,236,263,288,38,25,52,57,-1.0428496332664057,-0.6048229580903203,-0.21095912322812274,1.4559030225505332,307,291,323,357,50,34,66,60,-1.0579522685618576,-0.3630303737960333,0.20288808246379914,1.1702816468267783,31471,31195,Hopkins and Nearby Counties,Titus,48,449,Texas,TX
48499,48CS055,550,531,570,644,94,74,113,77,-0.01603036359584538,0.3717411891955382,0.8306514927492621,0.8128595767485943,681,658,705,912,231,207,254,155,1.3424217026241492,1.9818923972915747,2.6123246318402362,0.6693720148305032,45189,45749,Hopkins and Nearby Counties,Wood,48,499,Texas,TX
48231,48CS056,863,819,906,981,118,75,162,97,-0.2103474897928597,0.228730847444941,0.6355283768179101,0.8121758102861736,1080,1027,1133,1303,223,170,276,244,-0.8935831780600595,-0.2530634800170966,0.42055737170896956,1.089677439745592,100317,102933,Hunt,Hunt,48,231,Texas,TX
48237,48CS057,81,80,81,97,16,16,17,12,0.41109556578028356,0.5157743615936392,0.6171169630334452,0.6884905614668525,100,99,101,108,8,7,9,10,-0.4079928985890358,-0.2598044193861154,-0.12203554262860919,1.0971187254688624,8581,8680,Jack+Palo Pinto+Young,Jack,48,237,Texas,TX
48363,48CS057,283,270,295,389,106,94,119,49,1.597198753014721,2.005464377427159,2.4230777169197237,0.45660269484551524,346,331,361,457,111,96,126,83,0.5867178420163517,1.1647468750478598,1.766323433448023,0.7403746624959486,28554,28648,Jack+Palo Pinto+Young,Palo Pinto,48,363,Texas,TX
48503,48CS057,212,204,220,272,60,52,68,30,1.272463786172583,1.6876775492147964,2.119947470805462,0.4906883385751773,259,249,268,323,64,55,74,39,1.0503131483623735,1.6818760938112884,2.2990522497513632,0.5977929818067268,17868,17957,Jack+Palo Pinto+Young,Young,48,503,Texas,TX
48239,48CS058,147,141,153,158,11,5,17,23,-1.249415353942553,-0.8011701327275712,-0.37342367179948527,1.9211083260171045,181,173,189,170,-11,-19,-3,28,-3.6895913946740926,-3.1131401961866874,-2.4582273816934785,-2.8120394444417305,14978,15103,Jackson+Matagorda+Wharton,Jackson,48,239,Texas,TX
48321,48CS058,340,325,356,408,68,52,83,67,-0.4160124912589207,0.015083063423411012,0.40722077428462933,0.9750722966753093,416,398,435,467,51,32,69,95,-2.0999433661335902,-1.4600464026501125,-0.8726337703428967,1.8416222659610726,36333,36333,Jackson+Matagorda+Wharton,Matagorda,48,321,Texas,TX
48481,48CS058,367,349,385,465,98,80,116,77,0.031613983876085563,0.49805389436058733,0.9647410640965143,0.7786424911865654,451,429,472,568,117,96,139,116,-0.5845468471757325,0.05750465536873218,0.6773820714855909,0.9806964062535064,41585,41696,Jackson+Matagorda+Wharton,Wharton,48,481,Texas,TX
48241,48CS059,348,333,362,447,99,85,114,53,0.9882855689788658,1.3831715228314703,1.8312960363615365,0.5283545898315787,422,405,440,604,182,164,199,122,1.528059714035547,2.1599967308807595,2.7578755331074394,0.668453671284879,33303,32964,Jasper+Newton,Jasper,48,241,Texas,TX
48351,48CS059,128,123,133,174,46,41,51,19,1.771756951229664,2.194923235276098,2.6216051777006983,0.4028468104782454,155,149,162,231,76,69,82,45,2.4116815343902784,3.0136853634252128,3.628745494178788,0.5865376031801958,12391,12230,Jasper+Newton,Newton,48,351,Texas,TX
48245,48CS060,2130,2021,2240,2570,440,330,549,271,0.23766717981274998,0.6622962732693164,1.0744218306088653,0.615042071544312,2598,2467,2729,3168,570,439,701,474,-0.20672419124744087,0.4411533894353971,1.1184107802760546,0.8302265957362303,255062,254036,Jefferson,Jefferson,48,245,Texas,TX
48251,48CS061,1325,1247,1403,1556,231,153,309,175,-0.11283885765919326,0.3126588520036212,0.7150024355001539,0.7539459651692285,1677,1581,1773,2034,357,261,453,388,-0.83488024304033015,-0.1863730117344066,0.39884260076104916,1.0835044235322409,180724,186325,Johnson,Johnson,48,251,Texas,TX
48257,48CS062,999,936,1062,1078,79,16,142,132,-0.8080404695149377,-0.3657942743777516,0.0867987638261318,1.650271775060047,1305,1224,1385,1466,161,81,242,261,-1.4136862414679998,-0.7630962786881068,-0.12643674431341606,1.6079100364321899,146574,156196,Kaufman,Kaufman,48,257,Texas,TX
48261,48CS063,3,3,4,5,2,1,2,5,-10.00540392548954,-9.594409330200344,-9.154312936607036,1.8985283096045946,4,4,4,5,1,1,1,5,-14.860446706303067,-14.250849332976678,-13.617541781058586,2.565272298968155,351,341,Kenedy+Kleberg+Willacy,Kenedy,48,261,Texas,TX
48273,48CS063,243,230,257,295,52,38,65,62,-0.7742938303734528,-0.35642562465538846,0.11922598961221453,1.1797982808972467,299,283,315,333,34,18,50,69,-2.0013814778703396,-1.3736545548698171,-0.728653822149005,1.988800615237792,30858,30682,Kenedy+Kleberg+Willacy,Kleberg,48,273,Texas,TX
48489,48CS063,149,140,158,222,73,64,82,64,0.017927359322247698,0.45799997559327343,0.8227125963340189,0.8659445089624821,185,175,196,228,43,32,53,46,-0.7779446960348204,-0.17860732894775183,0.46172395439376884,1.0495761685038827,20316,20289,Kenedy+Kleberg+Willacy,Willacy,48,489,Texas,TX
48089,48CS064,212,203,221,260,48,39,57,16,1.1031673955902186,1.5348176562665141,1.9851455012592782,0.3268195866112972,258,247,269,343,85,74,96,41,1.9290334178104669,2.5632700046011556,3.1400803973643643,0.4770840868375599,20704,20621,Lavaca and Nearby Counties,Colorado,48,89,Texas,TX
48123,48CS064,220,211,228,259,39,31,48,50,-0.9598231858801176,-0.5431094637732816,-0.09634610885671911,1.2426981970294444,268,258,279,289,21,10,31,38,-1.6624938326412992,-1.0304419672973073,-0.4433269641613956,1.7492580157131856,19864,19902,Lavaca and Nearby Counties,DeWitt,48,123,Texas,TX
48149,48CS064,260,249,271,323,63,52,74,39,0.5501873478125365,0.9736978376789778,1.4045109676703516,0.609690761818735,318,305,331,391,73,60,86,52,0.43352656719172383,1.034704745785876,1.6670203124214318,0.7030342032949484,24601,24653,Lavaca and Nearby Counties,Fayette,48,149,Texas,TX
48177,48CS064,170,162,179,222,52,43,60,24,0.9470903101198028,1.390771936976397,1.8041857009400466,0.45638239938156405,207,197,217,272,65,55,75,63,-0.5364762984892252,0.0921818527796361,0.7243200970393235,0.9559834397758871,19833,19643,Lavaca and Nearby Counties,Gonzales,48,177,Texas,TX
48285,48CS064,221,212,230,274,53,44,62,48,-0.2127191667702716,0.2419059049899911,0.6767831178031406,0.8928826119087568,272,261,282,296,24,14,35,38,-1.3984147134385507,-0.811565044452913,-0.15990189424279241,1.495947233764531,20333,20514,Lavaca and Nearby Counties,Lavaca,48,285,Texas,TX
48303,48CS065,2220,2086,2354,3014,794,660,928,616,0.12059001126778729,0.5708260328342826,0.9805879410076875,0.7751520512088207,2756,2594,2918,3346,590,428,752,519,-0.38671891470570907,0.27017509989496336,0.9050748795109961,0.8781425347914739,311686,314009,Lubbock,Lubbock,48,303,Texas,TX
48309,48CS066,1922,1809,2034,2338,416,304,529,304,0.001869946102063267,0.4327095333218098,0.8644091527891096,0.7283415536620452,2382,2246,2518,2941,559,423,695,462,-0.1674933361429928,0.46453587384822026,1.088419642593499,0.8250200960252586,260666,262810,McLennan,McLennan,48,309,Texas,TX
48313,48CS067,115,114,117,140,25,23,26,21,0.17328697525558803,0.27575008771368564,0.3827354097194814,0.8161655527207626,142,141,144,177,35,33,36,30,0.2578092613209064,0.3996098845875781,0.542328771058158,0.8439987325663029,13610,13678,Madison+Trinity+Walker,Madison,48,313,Texas,TX
48455,48CS067,194,188,200,216,22,16,28,12,0.29453192491758073,0.7183840006630222,1.1485089459692344,0.5221108994991331,237,230,244,326,89,82,96,48,2.9344309524511494,3.5656595291921884,4.135635956373967,0.5338817971726931,13798,13797,Madison+Trinity+Walker,Trinity,48,455,Texas,TX
48471,48CS067,490,458,523,579,89,56,121,93,-0.4784082142578768,-0.05497000750471595,0.37630781067124575,1.03748771985787,618,578,658,711,93,53,133,105,-0.8127660138459322,-0.16273197889810284,0.43350274646336817,1.1179415544681193,75986,77768,Madison+Trinity+Walker,Walker,48,471,Texas,TX
48031,48CS068,111,109,112,111,0,-1,2,7,-0.6739321089704864,-0.5741716978223267,-0.4761786247025798,5.030389689728437,139,138,141,157,18,16,19,22,-0.5899406461755936,-0.4280885043614625,-0.2781530130312333,1.172034884643579,11574,11823,Menard and Nearby Counties,Blanco,48,31,Texas,TX
48081,48CS068,45,44,46,55,10,9,11,10,-0.42077942963439874,-0.021038272116803394,0.4247553574747507,0.9111595611908745,55,53,57,69,14,12,16,7,1.8083865404582145,2.443956773777085,3.026787512101386,0.47328025648378585,3296,3316,Menard and Nearby Counties,Coke,48,81,Texas,TX
48095,48CS068,29,29,29,28,-1,-1,-1,4,-1.6157469815261847,-1.5078952410800834,-1.407288123524115,32.412876746517945,37,36,37,34,-3,-3,-2,7,-3.6462259809589628,-3.490387721426635,-3.3371387928705345,-4.0860587084503415,3238,3338,Menard and Nearby Counties,Concho,48,95,Texas,TX
48137,48CS068,18,18,18,28,10,10,10,8,1.4571201712161221,1.5612684365818446,1.6615939887940574,0.7062040206226752,21,21,21,31,10,10,10,0,8.284054096854161,8.4376603915595485,8.589947807083243,0,1490,1434,Menard and Nearby Counties,Edwards,48,137,Texas,TX
48171,48CS068,306,295,318,329,23,11,34,25,-0.5489021263809885,-0.09663513292210626,0.3325767457568101,1.0637625544799731,380,366,394,417,37,23,51,58,-1.5357044812326377,-0.9167512765315489,-0.3022465640390171,1.5245112719551843,26819,27215,Menard and Nearby Counties,Gillespie,48,171,Texas,TX
48173,48CS068,12,12,12,6,-6,-6,-6,6,-10.341935238722092,-10.241708834106634,-10.13998302776905,-1.2191137485427301,14,14,15,12,-2,-3,-2,2,-4.806908582358402,-4.648726959969733,-4.512707533923195,-1.4006289579293885,1164,1144,Menard and Nearby Counties,Glasscock,48,173,Texas,TX
48235,48CS068,12,11,12,14,2,2,3,2,0.13065092116016522,0.22880757876120572,0.32845685681852826,0.59705050050859,15,14,15,24,9,9,10,5,3.2890678106737403,3.446344945524097,3.58529267863148,0.47877663854357355,1531,1548,Menard and Nearby Counties,Irion,48,235,Texas,TX
48267,48CS068,50,49,50,51,1,1,2,4,-0.722124537359053,-0.613642136843332,-0.5127130912655696,1.6912720456797026,62,61,62,63,1,1,2,1,-0.06939544535460354,0.0908584983163334,0.24182852117629292,0.4321663535989384,4308,4354,Menard and Nearby Counties,Kimble,48,267,Texas,TX
48307,48CS068,87,87,88,109,22,21,22,12,1.1707139674056062,1.2728247611541486,1.372843220225102,0.5285516380420019,106,105,107,166,60,59,61,28,4.9272473920288915,5.083353305417258,5.241685692963322,0.459578255827096,7628,7538,Menard and Nearby Counties,McCulloch,48,307,Texas,TX
48319,48CS068,41,41,42,39,-2,-3,-2,6,-2.148929513827084,-2.042875952482751,-1.941337503518844,-4.997781138967722,50,49,50,67,17,17,18,6,3.2152777780601247,3.3678351181754422,3.523360480786469,0.3320336091452871,4009,3946,Menard and Nearby Counties,Mason,48,319,Texas,TX
48327,48CS068,27,26,28,33,6,5,7,6,-0.46403527400205624,-0.04632479144802047,0.3726104908890448,0.8700603547043992,33,32,34,38,5,4,6,6,-1.2348675373633033,-0.5896511045665274,0.04600456556935082,0.9952277109070167,1991,1980,Menard and Nearby Counties,Menard,48,327,Texas,TX
48383,48CS068,23,22,23,28,5,5,6,7,-0.5448131779170223,-0.4456904070590675,-0.34776272854268103,1.0830184101129101,27,26,27,32,5,5,6,5,-0.026821294398347902,0.13073769605160784,0.2904491077982098,0.7850438530222366,3431,3271,Menard and Nearby Counties,Reagan,48,383,Texas,TX
48385,48CS068,36,35,36,64,28,28,29,12,5.595991526800832,5.693481842924459,5.791413684299357,0.41015082294934163,43,43,44,63,20,19,20,11,3.576921344592151,3.7322347173652646,3.8768374673641985,0.5303681094022004,2856,2814,Menard and Nearby Counties,Real,48,385,Texas,TX
48399,48CS068,127,123,132,137,10,5,14,20,-1.49307393118465,-1.0457823084006295,-0.6269640177021517,1.8831233942293166,155,150,160,190,35,30,40,36,-0.7400562474442022,-0.1412050821690102,0.5039779539282939,1.0036281267662608,9973,9940,Menard and Nearby Counties,Runnels,48,399,Texas,TX
48411,48CS068,58,57,59,83,25,24,26,15,1.626172504288088,1.71842876257922,1.8143942459099696,0.5784471126543616,72,71,73,90,18,17,19,14,0.6852614956375089,0.8448712865659821,0.9993258748817111,0.7333190705320974,5781,5813,Menard and Nearby Counties,San Saba,48,411,Texas,TX
48413,48CS068,21,21,21,25,4,4,4,8,-1.6966922360806496,-1.598926576095704,-1.4943435994278926,1.5934327360448155,25,25,26,33,8,7,8,2,2.680509582432023,2.8303440622745497,2.9957145926643185,0.22864833267273493,2493,2431,Menard and Nearby Counties,Schleicher,48,413,Texas,TX
48431,48CS068,13,13,13,13,0,0,0,7,-5.04499273732719,-4.951223554847272,-4.850742547260842,5.7668668503036296,16,16,16,16,0,-0,0,3,-2.657642786487315,-2.514719130822025,-2.355443081640534,2.7064289300922377,1370,1381,Menard and Nearby Counties,Sterling,48,431,Texas,TX
48435,48CS068,25,25,25,38,13,13,13,3,2.853470762005704,2.952995838897418,3.0594753131664545,0.21278441986084726,30,30,30,47,17,17,17,4,4.547565167543481,4.697197346494404,4.864342315797061,0.22186145733282908,3418,3325,Menard and Nearby Counties,Sutton,48,435,Texas,TX
48329,48CS069,967,894,1041,1106,139,65,212,200,-0.780621608506075,-0.3558459606390749,0.08847728896629273,1.4313118572739285,1182,1095,1269,1403,221,134,308,233,-0.6949988679787572,-0.06757454095557267,0.555637809454799,1.04805911014135,170894,168297,Midland,Midland,48,329,Texas,TX
48339,48CS070,3578,3308,3847,4026,448,179,718,290,-0.17900033415005795,0.26453795019766785,0.6833677790175415,0.6456095822726765,4558,4224,4891,5406,848,515,1182,850,-0.6465201660305944,0.0029613669791987225,0.6389241559983773,1.000644320785601,624902,645394,Montgomery,Montgomery,48,339,Texas,TX
48347,48CS071,492,465,520,635,143,115,170,103,0.16465503273014645,0.6091711530122792,1.0243627110619669,0.7170602964014325,606,573,640,789,183,149,216,128,0.44619963115447586,1.0015921671539398,1.656138799194873,0.6962804131869618,64661,64662,Nacogdoches,Nacogdoches,48,347,Texas,TX
48087,48CS072,30,29,31,43,13,12,14,4,2.978678591863105,3.3934193514614286,3.810070057120961,0.28387736556925697,36,35,37,42,6,5,7,8,-1.587203703766395,-0.9606044187151248,-0.3323911753274625,1.1566271161120525,2675,2618,Northeast Panhandle,Collingsworth,48,87,Texas,TX
48179,48CS072,218,209,227,245,27,18,36,41,-1.0926183168131274,-0.6482600430970525,-0.235514634954677,1.4696895985038223,265,255,276,349,84,73,94,63,0.5486705134880865,1.1662657725307986,1.7937362113859225,0.7451091218510447,21261,21052,Northeast Panhandle,Gray,48,179,Texas,TX
48195,48CS072,41,41,42,50,9,8,9,19,-2.038548043195886,-1.9404022124949087,-1.8383669770205713,1.936342448208697,50,49,50,61,11,11,12,10,0.1455381918299034,0.2915568748198079,0.44078888398330496,0.8154917246072976,5263,5173,Northeast Panhandle,Hansford,48,195,Texas,TX
48211,48CS072,26,26,27,20,-6,-7,-6,4,-3.093223839943424,-2.9963889142546973,-2.900363800935932,-0.7586352064649002,31,31,31,24,-7,-7,-7,6,-4.891386286844065,-4.738174991656477,-4.589572137529646,-1.0060114140824765,3425,3285,Northeast Panhandle,Hemphill,48,211,Texas,TX
48295,48CS072,22,22,22,34,12,12,12,2,3.123087626976254,3.2302992615320676,3.3325894445994733,0.1554140878628277,26,26,27,40,14,13,14,2,4.637160004509702,4.783665885399053,4.935393609564716,0.13557845846101294,3056,2947,Northeast Panhandle,Lipscomb,48,295,Texas,TX
48357,48CS072,63,62,64,93,30,29,31,20,0.895052019896483,0.9999991330486182,1.1094287505694345,0.6461618670588001,77,76,78,90,13,12,14,24,-1.4757066959743,-1.312571126642341,-1.167927564037411,1.6858520322873765,9920,9808,Northeast Panhandle,Ochiltree,48,357,Texas,TX
48393,48CS072,9,9,10,12,3,2,3,1,1.7434625410585578,2.14238076918039,2.5605532897520735,0.26605496562862785,11,11,11,1,-10,-10,-10,1,-17.15520064375265,-16.53345170178689,-15.889892061069279,-0.11063416649219122,822,801,Northeast Panhandle,Roberts,48,393,Texas,TX
48483,48CS072,52,51,52,62,10,10,11,11,-0.28715790835278093,-0.18815915667113906,-0.08900727980013817,0.9943441024183424,63,62,64,92,29,28,30,5,5.6786346761153,5.821846974741458,5.96971353649367,0.16699666215361633,4981,4935,Northeast Panhandle,Wheeler,48,483,Texas,TX
48065,48CS073,49,49,50,80,31,30,31,12,3.1104134717017793,3.210086368124857,3.3141062646879225,0.3790389194461691,60,59,60,84,24,24,25,13,2.202005639745368,2.3539971459585973,2.502845098507727,0.5143553255901662,5810,5755,Northwest Panhandle,Carson,48,65,Texas,TX
48111,48CS073,37,36,38,68,31,30,32,14,2.2601534465001447,2.3512973930731564,2.4526436695917524,0.4399828689410565,46,45,47,79,33,32,34,2,5.07573590409351,5.244747236720326,5.392981303291908,0.058326144237211414,7142,7164,Northwest Panhandle,Dallam,48,111,Texas,TX
48205,48CS073,37,36,37,48,11,11,12,11,-0.012050921561958894,0.09130068472795679,0.1910638356707581,0.8804112690805491,45,44,45,45,0,-0,1,4,-0.9750656957745297,-0.8258112807860286,-0.6756175611618117,3.0948836108211104,5387,5392,Northwest Panhandle,Hartley,48,205,Texas,TX
48233,48CS073,209,200,218,274,65,56,74,56,-0.008242484194920803,0.44599405101957124,0.8553840578683428,0.8478774980053193,255,244,265,347,92,82,103,64,1.0547673241694535,1.6401008072486354,2.2852367984298336,0.6869401196014312,20587,20501,Northwest Panhandle,Hutchinson,48,233,Texas,TX
48341,48CS073,145,136,154,175,30,21,39,63,-1.986784325478691,-1.532026434778534,-1.1185780224309945,2.0167804020279325,178,167,189,190,12,1,23,35,-1.967118748926537,-1.305355466191633,-0.7144582332209116,2.7021359707812707,21207,21141,Northwest Panhandle,Moore,48,341,Texas,TX
48359,48CS073,12,12,12,17,5,5,5,2,1.5045975400722789,1.6056390157938687,1.7050700639294398,0.3386522228040146,14,14,14,19,5,5,5,1,2.555079653996231,2.717220507815686,2.86653617099598,0.16966132078667615,1808,1723,Northwest Panhandle,Oldham,48,359,Texas,TX
48421,48CS073,21,20,21,27,6,6,7,12,-2.130137710784176,-2.031695065101207,-1.9299594673405984,1.6484501283732462,25,25,26,33,8,7,8,7,0.21685540005247014,0.36046931498402807,0.5175062615000396,0.79099580117622,2816,2795,Northwest Panhandle,Sherman,48,421,Texas,TX
48355,48CS074,2465,2313,2617,3260,795,643,947,510,0.3400026377974804,0.7994162812365114,1.2486550907571974,0.6405966221999271,3029,2846,3211,4047,1018,836,1201,621,0.6659990692053992,1.3620386689580368,1.9736263004483758,0.6092164531897903,354439,353081,Nueces,Nueces,48,355,Texas,TX
48361,48CS075,840,804,877,977,137,100,173,75,0.29482967210571676,0.7330323003175233,1.16566079582476,0.5447991634496251,1029,985,1073,1234,205,161,249,234,-0.9965627134008382,-0.40000199788470864,0.19793656680509658,1.135712632737874,84470,84736,Orange,Orange,48,361,Texas,TX
48365,48CS076,227,218,237,333,106,96,115,45,2.259795209440743,2.6843479079399644,3.092623433439088,0.42158794391388416,278,267,290,368,90,78,101,74,0.20813048102277273,0.8257926223102459,1.441637268835871,0.8159520887332876,22616,22651,Panola+Sabine+San Augustine+Shelby,Panola,48,365,Texas,TX
48403,48CS076,142,138,146,156,14,10,18,16,-0.638608650374498,-0.21219649811977334,0.2084872842935236,1.0777855914041627,174,169,179,258,84,79,89,52,3.2680340979718103,3.8536781858594824,4.4786911141375265,0.6101894196919246,9986,10016,Panola+Sabine+San Augustine+Shelby,Sabine,48,403,Texas,TX
48405,48CS076,104,103,105,149,45,44,46,28,2.0166971343532025,2.123141441432271,2.221619097373254,0.6097712880158477,127,126,128,190,63,62,64,13,7.476075106541897,7.630622435304148,7.76732876968791,0.20201425229589617,7963,7922,Panola+Sabine+San Augustine+Shelby,San Augustine,48,405,Texas,TX
48419,48CS076,237,227,247,295,58,48,68,44,0.18112086690196927,0.569339607564493,1.0269230993282297,0.7473353245946831,288,276,301,386,98,85,110,75,0.5468477776012992,1.1515606720720115,1.7710635499097989,0.760184520740078,24127,23937,Panola+Sabine+San Augustine+Shelby,Shelby,48,419,Texas,TX
48367,48CS077,1100,1036,1165,1222,122,57,186,109,-0.3227451875427686,0.08912274140518547,0.5510179510263723,0.8873719876722004,1406,1325,1486,1614,208,128,289,287,-1.231014671461256,-0.6030635530023372,0.02229088191815773,1.3724480351714665,149279,155695,Parker,Parker,48,367,Texas,TX
48373,48CS078,580,558,602,719,139,117,161,66,1.0133321874244408,1.4346675381948868,1.8421149945376853,0.4716762020067104,719,692,745,961,242,216,269,163,1.2761217036165085,1.8171369247818254,2.427278016276945,0.669923599195751,50759,51696,Polk+San Jacinto+Tyler,Polk,48,373,Texas,TX
48407,48CS078,268,256,280,323,55,43,67,24,0.7140364289812408,1.1308678717647744,1.5289693787222165,0.42740568345029073,329,314,343,482,153,139,168,79,2.664514208335256,3.2011668331136462,3.797269507187314,0.5115061702020741,27726,27820,Polk+San Jacinto+Tyler,San Jacinto,48,407,Texas,TX
48457,48CS078,218,209,226,272,54,46,63,17,1.4301712865815264,1.8527247838088194,2.2515046542561064,0.307381417094571,266,255,276,410,144,134,155,60,4.410148510498387,5.0340185925918854,5.639562770692512,0.4129392863609062,20078,20036,Polk+San Jacinto+Tyler,Tyler,48,457,Texas,TX
48375,48CS079,1049,998,1099,1402,353,303,404,299,0.04501532354247046,0.45928470901553703,0.8920108063061934,0.8435291091389975,1278,1218,1338,1579,301,241,361,269,-0.2833936716873029,0.3507599501069468,0.9248759930857466,0.8904894389740431,117806,116784,Potter,Potter,48,375,Texas,TX
48379,48CS080,147,142,152,170,23,18,28,20,-0.1457302228957959,0.26001548341029657,0.673542696946379,0.8292869821060226,181,175,188,205,24,17,30,32,-1.3820030379397288,-0.7809696924737328,-0.18244059182030947,1.2997053230706945,12261,12464,Rains+Van Zandt,Rains,48,379,Texas,TX
48467,48CS080,590,564,615,698,108,83,134,71,0.18632971201616658,0.6145703798882491,1.0302836372588011,0.6504205966090528,735,703,766,983,248,217,280,174,0.8608543243449007,1.4751854349436677,2.074435420788367,0.6984005135691577,59425,61044,Rains+Van Zandt,Van Zandt,48,467,Texas,TX
48381,48CS081,955,894,1016,1200,245,184,306,206,-0.16397414382309436,0.26348411446665626,0.7186317895930147,0.8381868922786228,1195,1121,1269,1476,281,207,355,218,-0.049459732852071336,0.5327681132720239,1.1754804372181937,0.7724556348711391,141000,143471,Randall,Randall,48,381,Texas,TX
48397,48CS082,583,536,630,632,49,2,96,54,-0.43696439190950814,-0.04117809762952483,0.3665986280177024,1.078524931291092,762,702,821,877,115,56,175,168,-1.140408295979666,-0.5484272934579771,0.12071239167689413,1.44555632700812,109233,115318,Rockwall,Rockwall,48,397,Texas,TX
48401,48CS083,450,428,473,577,127,104,149,76,0.5382484573839447,0.962286178028216,1.3658445066474112,0.5960367054820837,554,527,581,767,213,186,240,151,0.7784150560764774,1.4291521498981206,2.0322074913662274,0.7059973365345399,52594,52667,Rusk,Rusk,48,401,Texas,TX
48409,48CS084,557,527,586,661,104,75,134,98,-0.3458195469809435,0.08578904269700502,0.5244383729347344,0.9308287312852106,692,656,728,881,189,153,225,195,-0.6772088567858894,-0.10881257977150412,0.5380158553647776,1.0246883118552388,68560,69564,San Patricio,San Patricio,48,409,Texas,TX
48033,48CS085,8,8,8,7,-1,-1,-1,7,-13.054902831287531,-12.955264684246504,-12.861210056743277,-22.9335211295904,10,10,10,3,-7,-7,-7,3,-19.162379272887367,-19.01081561312673,-18.848010480679367,-0.515240076610313,641,620,Scurry and Nearby Counties,Borden,48,33,Texas,TX
48151,48CS085,38,36,40,59,21,19,23,12,2.049529922614392,2.444278274974002,2.8570773117791695,0.5447466528327105,47,45,49,66,19,17,21,13,1.4199631951135057,2.0695543079290326,2.6769599123147336,0.6380115553148645,3699,3702,Scurry and Nearby Counties,Fisher,48,151,Texas,TX
48169,48CS085,38,38,39,53,15,14,15,15,-0.1333664125889029,-0.029840821670904554,0.06740427462889526,0.9479045161051644,47,46,47,64,17,17,18,11,1.1379212528324452,1.2934993353814037,1.4560676941346553,0.6010517096768867,5866,5853,Scurry and Nearby Counties,Garza,48,169,Texas,TX
48227,48CS085,311,296,326,414,103,88,118,85,0.08549383559354123,0.5095839111944699,0.9190432331690727,0.8200787913618469,375,358,393,458,83,65,100,70,-0.17293499161597567,0.44841712630990554,1.0644532612254702,0.8370941051329387,35010,34226,Scurry and Nearby Counties,Howard,48,227,Texas,TX
48263,48CS085,12,11,12,16,4,4,5,7,-3.450421370530597,-3.3506789960368826,-3.24652347088862,1.2820100547822857,14,14,14,20,6,6,6,3,4.738028482198554,4.890705619904391,5.053803287019432,0.4253564036466102,758,750,Scurry and Nearby Counties,Kent,48,263,Texas,TX
48335,48CS085,84,83,85,76,-8,-9,-7,16,-2.772617296886464,-2.679766218421715,-2.5807770013635074,-2.35682418766691,105,103,106,109,4,3,6,27,-3.160709270630319,-2.9963951693817363,-2.83263087911893,4.995961414499699,8874,9058,Scurry and Nearby Counties,Mitchell,48,335,Texas,TX
48353,48CS085,162,156,168,202,40,34,46,32,0.10975134223061923,0.5312506568448362,0.9779703776068914,0.7813321384743996,197,189,204,214,17,10,25,51,-3.407622761641629,-2.766434616817771,-2.1050653390094882,2.8107373508443083,14724,14615,Scurry and Nearby Counties,Nolan,48,353,Texas,TX
48415,48CS085,150,143,157,201,51,44,58,38,0.36784318424621293,0.7754036936583681,1.2157243616353648,0.7277154560502513,183,175,192,223,40,31,48,55,-1.693445646135989,-1.1128465184447631,-0.48684750651254727,1.3561933919634082,16880,16840,Scurry and Nearby Counties,Scurry,48,415,Texas,TX
48423,48CS086,1862,1762,1963,2318,456,355,556,286,0.27613800409095823,0.7294447568455706,1.1833119410926012,0.6263112846904031,2310,2187,2432,2977,667,545,790,531,0.08568822072232164,0.6637910405615909,1.3458660433585166,0.7944811200672485,234221,236731,Smith,Smith,48,423,Texas,TX
48427,48CS087,380,373,386,641,261,255,268,210,0.6838561472312663,0.7807033564294554,0.8863063307694102,0.8001943179555309,471,462,479,632,161,153,170,126,0.48323253469065913,0.6410760467404288,0.7832822003875612,0.7769855682050507,65633,66018,Starr,Starr,48,427,Texas,TX
48439,48CS088,11529,10620,12439,13952,2423,1513,3332,1732,-0.1402168236374284,0.31454236192889234,0.7679904139623592,0.7145951548821609,14368,13271,15465,17727,3359,2262,4456,2929,-0.35110759709843997,0.2336688535116628,0.8912557245279159,0.8716594449850454,2113977,2124761,Tarrant,Tarrant,48,439,Texas,TX
48441,48CS089,1235,1174,1297,1390,155,93,216,218,-0.8743650219441846,-0.4544002932091345,-0.013802718569785018,1.4013655056945138,1521,1447,1595,1838,317,243,391,391,-1.2262318465352624,-0.6185708639362585,-0.011357768087255218,1.2305632002260838,142613,143334,Taylor,Taylor,48,441,Texas,TX
48451,48CS090,928,876,979,1222,294,243,346,190,0.46599009763561533,0.8678670889589641,1.2698551852109399,0.6435333498486064,1139,1077,1201,1456,317,255,379,211,0.46198928570105907,1.0686797971430568,1.6792879922534178,0.6631313004912799,119934,119512,Tom Green,Tom Green,48,451,Texas,TX
48453,48CS091,5142,4585,5699,5943,801,244,1358,586,-0.2663050422480725,0.1575610531044924,0.5964783293550683,0.7304396634480643,6490,5817,7163,7382,892,219,1565,874,-0.608149748748961,0.018152930129602826,0.6340928034454938,0.9790161636650786,1293757,1303834,Travis,Travis,48,453,Texas,TX
48469,48CS092,705,666,744,906,201,162,240,129,0.3419491336549134,0.7871933933119543,1.2182473732434664,0.6384564149870414,864,817,911,1117,253,206,300,231,-0.3087113310134545,0.2948175444127504,0.8559103885084915,0.9090790681424361,91322,91004,Victoria,Victoria,48,469,Texas,TX
48479,48CS093,1176,1061,1291,1897,721,606,836,526,0.2858700850759703,0.7251876542460618,1.1590197904727244,0.7283818250196707,1467,1329,1605,1973,506,368,644,423,-0.22989725845684195,0.3808686209885916,0.9501303097700762,0.8341681216427915,268643,267841,Webb,Webb,48,479,Texas,TX
48017,48CS094,49,49,50,59,10,9,10,14,-0.7252748645496809,-0.6229570048037046,-0.5181506354581572,1.303900275918402,60,60,61,81,21,20,21,19,0.10513773719965992,0.2614445663723959,0.41408022414034396,0.8828462712665321,6856,6838,Western Central Panhandle,Bailey,48,17,Texas,TX
48069,48CS094,51,51,52,75,24,23,24,24,-0.12844770552949322,-0.033364440108090636,0.060714033944850046,0.9696873844971737,63,62,64,96,33,32,34,19,2.108863366958065,2.2521782774623444,2.4098190101868924,0.5614912026100132,7362,7369,Western Central Panhandle,Castro,48,69,Texas,TX
48079,48CS094,21,21,22,34,13,12,13,10,0.8943051443342515,1.002128446433857,1.1039456039595616,0.7356576737039956,26,25,26,45,19,19,20,10,4.332933786380588,4.476875910422774,4.6485953224475995,0.48991767349054416,2593,2522,Western Central Panhandle,Cochran,48,79,Texas,TX
48117,48CS094,138,130,146,173,35,27,43,60,-1.7633103587161696,-1.3317407351424981,-0.922633341771539,1.6509264136206891,169,160,179,216,47,37,56,41,-0.22227066669009965,0.37701130358697493,1.0427645808784831,0.8554582970073327,18493,18354,Western Central Panhandle,Deaf Smith,48,117,Texas,TX
48219,48CS094,177,167,186,285,108,99,118,91,0.38969422588699715,0.8116969395388307,1.2002759048414828,0.8312424565319826,215,204,227,294,79,67,90,58,0.5684612687510618,1.143979260489174,1.7527237070671442,0.7295314357283267,21705,21382,Western Central Panhandle,Hockley,48,219,Texas,TX
48279,48CS094,140,134,146,194,54,48,60,67,-1.403082387031497,-1.0103727631712254,-0.547694343197428,1.2193549835779172,171,164,178,173,2,-5,9,28,-3.013904438075151,-2.4196971449572953,-1.772142837341372,9.019414055783043,12963,12911,Western Central Panhandle,Lamb,48,279,Texas,TX
48369,48CS094,67,66,68,105,38,37,39,36,0.1120887299778515,0.21599993387641878,0.31136776501817925,0.9198082080055214,82,81,84,103,21,19,22,10,1.1446724643452444,1.2822715536159848,1.4262952426376285,0.4645800171479081,9804,9819,Western Central Panhandle,Parmer,48,369,Texas,TX
48043,48CS095,77,76,78,81,4,3,5,12,-0.9008327294272114,-0.7930604709177604,-0.6961547506682378,2.2002785145296393,95,93,96,108,13,12,15,14,-0.22524114113387841,-0.07032831137924027,0.08290508125327159,0.9692640099742125,9492,9467,"West Texas, excluding El Paso",Brewster,48,43,Texas,TX
48103,48CS095,32,32,33,39,7,6,7,4,0.4574710311509594,0.5587518193513,0.661403267591969,0.5239466950703464,40,40,41,48,8,7,8,10,-0.6982792181116676,-0.5549471480046332,-0.4028649185224925,1.1327215185962045,4683,4678,"West Texas, excluding El Paso",Crane,48,103,Texas,TX
48109,48CS095,18,17,18,27,9,9,10,2,3.2989465536510667,3.3984382862682496,3.496921604548091,0.19177500415996845,22,22,22,30,8,8,8,5,1.5860662157215566,1.7355913060977768,1.8746146013211433,0.5454449110458858,2186,2193,"West Texas, excluding El Paso",Culberson,48,109,Texas,TX
48229,48CS095,18,17,18,35,17,17,18,6,3.1870202813041146,3.2947341259376834,3.3949121773015025,0.3267758412745182,21,21,21,39,18,18,18,5,4.619992055323238,4.787007268266036,4.931254934840007,0.26239173855285,3450,3274,"West Texas, excluding El Paso",Hudspeth,48,229,Texas,TX
48243,48CS095,16,16,16,19,3,3,3,5,-0.9426693457928241,-0.8450476520722983,-0.7390648125217545,1.1642787010872218,19,19,19,28,9,9,9,3,3.642908563375695,3.784116451350338,3.9409476490100444,0.2952198385878969,2018,1953,"West Texas, excluding El Paso",Jeff Davis,48,243,Texas,TX
48301,48CS095,1,1,1,7,6,6,6,7,-9.859069977317652,-9.485261099534704,-9.06842270348611,0.9665505293340442,1,1,1,5,4,4,4,5,-15.716003538882926,-15.082888602067108,-14.45031340640301,0.9486758083623417,80,58,"West Texas, excluding El Paso",Loving,48,301,Texas,TX
48371,48CS095,106,104,107,164,58,57,60,28,1.895103678695395,1.9940746708147363,2.0938506989797503,0.47136165628158755,130,128,132,176,46,44,48,33,0.8662643181989561,1.0210057034872018,1.1695341946325477,0.7041360775095674,15246,15125,"West Texas, excluding El Paso",Pecos,48,371,Texas,TX
48377,48CS095,37,36,38,55,18,17,19,20,-0.40721909259707706,-0.3101422833089678,-0.20778214021564131,1.047058745523293,46,45,46,69,23,23,24,14,1.6748208546498176,1.8303900185784696,1.9762918681072363,0.5749485642140798,6180,6134,"West Texas, excluding El Paso",Presidio,48,377,Texas,TX
48389,48CS095,97,96,99,128,31,29,32,28,0.06956031744593913,0.166631375815197,0.2657435363951086,0.8887147696200375,118,116,120,157,39,37,41,32,0.40080127991766257,0.5499942206634869,0.6952823205307311,0.8064986858420825,14883,14522,"West Texas, excluding El Paso",Reeves,48,389,Texas,TX
48461,48CS095,25,25,25,34,9,9,9,5,1.0521271793367717,1.1474390075424066,1.2454093198637914,0.5080434905271413,31,30,31,32,1,1,2,5,-1.4352769442206954,-1.291495372656742,-1.1431274271359348,2.0086916958481975,3344,3270,"West Texas, excluding El Paso",Upton,48,461,Texas,TX
48475,48CS095,101,100,102,115,14,13,15,13,-0.006446254575097551,0.096726570507083,0.20103098696884994,0.8608272647087518,121,119,122,122,1,-0,3,24,-2.5591908238002454,-2.40142029784816,-2.2567806098586787,9.977969368336067,11656,11261,"West Texas, excluding El Paso",Ward,48,475,Texas,TX
48495,48CS095,61,61,62,75,14,13,14,15,-0.2612058094502515,-0.16874138517579879,-0.0698938132746228,1.0209372288462457,73,72,74,88,15,14,16,17,-0.5047883744941172,-0.34781211628142295,-0.193986506699559,1.0752158691635612,7746,7464,"West Texas, excluding El Paso",Winkler,48,495,Texas,TX
48491,48CS096,2781,2515,3046,3106,325,60,591,256,-0.31744780359598584,0.12007320488752299,0.5769042034193225,0.7843139613916571,3594,3264,3924,4064,470,140,800,564,-0.7511157778728949,-0.1736011643198805,0.40765328060431044,1.1982302223937813,614739,638978,Williamson,Williamson,48,491,Texas,TX
48497,48CS097,552,523,582,665,113,83,142,78,0.05396745315040717,0.5099750694736125,0.9431877730703628,0.686827327934203,698,661,734,832,134,98,171,153,-0.9438186386414855,-0.2947920682587541,0.3020633883113966,1.129765139171626,69310,71299,Wise,Wise,48,497,Texas,TX
49001,49CS001,55,54,55,43,-12,-12,-11,5,-2.458864040261477,-2.3561751187458126,-2.251599309631203,-0.4717900989474017,69,68,69,91,22,22,23,13,1.4148675632327115,1.5642481518963054,1.7257319932910138,0.5543647916806185,7043,7224,Beaver+Iron+Millard,Beaver,49,1,Utah,UT
49021,49CS001,307,282,332,337,30,5,55,16,-0.19775339212707513,0.22833885055361994,0.6468825174472435,0.5171723791725232,393,362,424,446,53,22,84,65,-0.8976615928449776,-0.23847026991255182,0.3721869248374523,1.2077513403395208,57594,60099,Beaver+Iron+Millard,Iron,49,21,Utah,UT
49027,49CS001,90,88,91,111,21,20,23,7,0.9915925926971538,1.0969110182022461,1.2017537055072864,0.313586638344522,111,109,112,154,43,42,45,31,0.9826051306443169,1.1244343019220169,1.2596631534892022,0.6997597839308275,13043,13142,Beaver+Iron+Millard,Millard,49,27,Utah,UT
49003,49CS002,357,332,382,417,60,35,85,29,0.06692481971596567,0.5271713199573278,0.9565021176151197,0.4759538476615265,452,421,483,511,59,28,90,77,-0.992026649749785,-0.35729177980674354,0.2668966513775055,1.283071446501183,57809,59428,Box Elder+Cache+Rich,Box Elder,49,3,Utah,UT
49005,49CS002,525,468,582,529,4,-53,61,31,-0.6529463318129991,-0.20821355239620934,0.22019551927851147,6.212490725238089,675,604,745,732,57,-13,128,60,-0.6427181621586755,-0.01733746092333475,0.6026736583617743,1.0299004738674435,133171,136850,Box Elder+Cache+Rich,Cache,49,5,Utah,UT
49033,49CS002,15,15,15,11,-4,-4,-4,5,-3.698140320337559,-3.6031818677618888,-3.495072693550097,-1.6525984756247178,19,19,19,20,1,1,1,2,-0.6027252853293175,-0.4602422918034057,-0.3148197304186228,0.9954754116909277,2508,2583,Box Elder+Cache+Rich,Rich,49,33,Utah,UT
49007,49CS003,191,182,199,220,29,21,38,6,0.7202375434173438,1.1468397839212647,1.5798240565506056,0.19709914840764062,233,222,243,292,59,49,70,30,1.0754821216859523,1.7197506941202318,2.273753365979349,0.4959038439295483,20457,20386,Carbon+Daggett+Duchesne+Uintah,Carbon,49,7,Utah,UT
49009,49CS003,10,10,10,3,-7,-7,-7,3,-10.338691699972289,-10.237177837993775,-10.135506973608253,-0.5182450846720585,12,12,12,5,-7,-7,-7,5,-15.22943056848646,-15.062036759753276,-14.918614316831079,-0.8059221012495476,956,972,Carbon+Daggett+Duchesne+Uintah,Daggett,49,9,Utah,UT
49013,49CS003,135,127,144,137,2,-7,10,1,-0.4395412208801091,0.021869691877347077,0.451153730784887,0.38498381631922124,168,158,178,195,27,17,37,16,0.03501585478422837,0.6876810556934536,1.302535692303781,0.5707586243195424,19646,19760,Carbon+Daggett+Duchesne+Uintah,Duchesne,49,13,Utah,UT
49047,49CS003,213,198,228,254,41,26,56,15,0.2944224631869914,0.7290012629265383,1.1546751833731157,0.35783242262901177,267,248,285,339,72,54,91,43,0.34102932742792386,0.9768013452264727,1.6216411166871931,0.5868390826736505,35706,36119,Carbon+Daggett+Duchesne+Uintah,Uintah,49,47,Utah,UT
49011,49CS004,1636,1480,1792,1840,204,48,360,92,-0.13164040020041634,0.3204611578789413,0.7533149951253699,0.44850848395890663,2061,1872,2250,2333,272,83,461,212,-0.4194161545980994,0.20189615359663526,0.8352961719349085,0.7761363892481635,362693,366732,Davis,Davis,49,11,Utah,UT
49023,49CS005,67,66,68,72,5,4,6,7,-0.27084280807382793,-0.1745960194178842,-0.07386870630100302,1.1817864108084435,84,83,86,84,-0,-2,1,3,-0.48746068258353575,-0.3285971893932656,-0.17777978116258017,4.534837514555412,11884,12107,Juab+Sanpete+Tooele,Juab,49,23,Utah,UT
49039,49CS005,161,149,174,208,47,34,59,14,0.7144697433170156,1.1342408777027189,1.5489509624065607,0.2944211868869764,201,186,216,280,79,64,94,32,1.2714956661173122,1.9131992686543633,2.563669216395143,0.40138033017375757,28932,29019,Juab+Sanpete+Tooele,Sanpete,49,39,Utah,UT
49045,49CS005,351,319,382,352,1,-30,33,20,-0.6642580431860605,-0.24856654100684314,0.16900759220947176,8.314829680462639,451,412,490,526,75,36,114,64,-0.4388495983911148,0.19373253392248957,0.7826909365345066,0.8421525417442827,73460,76150,Juab+Sanpete+Tooele,Tooele,49,45,Utah,UT
49029,49CS006,59,57,60,72,13,12,15,8,0.32331784977767103,0.4344784236561798,0.5267137747606154,0.5579102441272501,74,72,75,65,-9,-10,-7,2,-1.1826671624806437,-1.019036133832128,-0.8768455977405039,-0.25914218552534474,12379,12618,Morgan+Summit+Wasatch,Morgan,49,29,Utah,UT
49043,49CS006,143,124,161,147,4,-14,23,5,-0.4059113861780283,-0.012924700206373539,0.39586228032353765,0.9318881682178886,181,159,203,207,26,4,48,13,-0.2931134239407586,0.35694212008658566,0.986001658671503,0.4860224057121151,42465,43000,Morgan+Summit+Wasatch,Summit,49,43,Utah,UT
49051,49CS006,138,135,142,166,28,24,31,16,0.23348745199046783,0.33697944685184217,0.43143053102221995,0.5535844622946905,175,171,180,173,-2,-7,2,12,-0.6324286151836004,-0.4826635495534616,-0.32599679633250056,-8.156867142933548,35031,36007,Morgan+Summit+Wasatch,Wasatch,49,51,Utah,UT
49035,49CS007,5972,5463,6482,6695,723,213,1232,576,-0.2664170385923838,0.13325523522973157,0.5615353131391914,0.7960982948213278,7437,6825,8050,7930,493,-120,1105,623,-0.7227168683641915,-0.14075554831968848,0.5077899944154298,1.2622432682347093,1182223,1186394,Salt Lake,Salt Lake,49,35,Utah,UT
49049,49CS008,2406,2120,2691,2649,243,-42,529,223,-0.40119109617521315,0.023727987035223972,0.47833864396902,0.9132390478129271,3108,2756,3460,3245,137,-215,489,389,-1.0738554709215244,-0.46448989925289813,0.21619516785458665,2.8212579383920193,661413,681801,Utah (county),Utah (county),49,49,Utah,UT
49053,49CS009,1283,1204,1361,1478,195,117,274,111,0.051097999642850354,0.4484103003732012,0.8826664066827287,0.5653835693486562,1642,1543,1740,1888,246,148,345,249,-0.6290671636530312,-0.03339049811796375,0.5932748674707854,1.006129139053644,182312,189869,Washington,Washington,49,53,Utah,UT
49015,49CS010,84,83,85,96,12,11,13,7,0.3845569686141481,0.486744568189378,0.5840908545779319,0.5474342152011054,104,103,106,127,23,21,24,20,0.16476331613520973,0.3167699330273999,0.46583581048039524,0.845704489202756,9883,9948,Wayne and Nearby Counties,Emery,49,15,Utah,UT
49017,49CS010,43,42,43,51,8,8,9,4,0.7246284815841632,0.8241781485994802,0.9382019472160091,0.43550588697577086,53,53,54,61,8,7,8,3,0.9871343222649147,1.1402869862908762,1.2888094019660568,0.3391629415345591,5081,5123,Wayne and Nearby Counties,Garfield,49,17,Utah,UT
49019,49CS010,76,75,77,61,-15,-16,-14,4,-2.0593942172363637,-1.9705476303541969,-1.8696971729292322,-0.28423129308058315,93,92,95,85,-8,-10,-7,7,-2.072271000901421,-1.924282254737911,-1.7700043149824778,-0.9351004949487365,9693,9666,Wayne and Nearby Counties,Grand,49,19,Utah,UT
49025,49CS010,67,67,68,57,-10,-11,-10,4,-1.956088209569384,-1.8539250247710115,-1.7649544662549832,-0.4277539143279082,85,84,86,108,23,22,24,13,1.3396335312911833,1.4940713545284983,1.6408040498954441,0.5449153838326622,7735,7945,Wayne and Nearby Counties,Kane,49,25,Utah,UT
49031,49CS010,15,15,16,15,-0,-1,0,1,-1.3375857675831215,-0.9201381285844621,-0.48614752664837557,1.4339242584108802,19,18,20,23,4,3,5,2,0.8455763441730731,1.4401583663375468,2.047824919433593,0.4181632847622061,1447,1480,Wayne and Nearby Counties,Piute,49,31,Utah,UT
49037,49CS010,99,97,100,147,48,47,50,43,0.261491638410281,0.3725945228057522,0.4795217381237772,0.8699592827158626,121,119,122,153,32,31,34,27,0.29994893409421775,0.43849143599184504,0.5942563731160436,0.8096812291870908,14624,14494,Wayne and Nearby Counties,San Juan,49,37,Utah,UT
49041,49CS010,182,172,191,198,16,7,26,2,0.20949416855777575,0.6658857885906206,1.1013271710208674,0.11565748792338856,227,216,238,230,3,-8,14,14,-1.2063579593686684,-0.609731225266305,0.008160807409930377,3.4929132729497554,21597,21854,Wayne and Nearby Counties,Sevier,49,41,Utah,UT
49055,49CS010,21,20,21,33,12,12,13,2,4.018587145827724,4.1147591300645985,4.217983389252994,0.14899134218869647,26,25,26,33,7,7,8,1,2.9147343300222746,3.0583512073251837,3.2124183083930307,0.11768498088444806,2533,2549,Wayne and Nearby Counties,Wayne,49,55,Utah,UT
49057,49CS011,1592,1479,1705,1773,181,68,294,110,-0.1792634080236436,0.26959355596908086,0.6841021529390644,0.6044712848417864,1987,1850,2125,2138,151,13,288,213,-0.8729064334823883,-0.27950840423981343,0.30974051904760547,1.4044800653111353,262810,266448,Weber,Weber,49,57,Utah,UT
50001,50CS001,272,256,288,287,15,-1,31,3,-0.09471628506047965,0.3268070825346546,0.7489824365880595,0.18558352059172367,334,315,353,370,36,17,55,7,0.3460709283563041,0.9293572030118905,1.5315997253229199,0.19016385652667955,37245,37265,Addison+Chittenden,Addison,50,1,Vermont,VT
50007,50CS001,1011,938,1083,1048,37,-35,110,62,-0.577620203632161,-0.15270962778662722,0.2907324285211844,1.6135559894083071,1254,1167,1342,1318,64,-24,151,42,-0.45321486413800866,0.1657964466802251,0.7720050994899781,0.6509080577684833,167712,168781,Addison+Chittenden,Chittenden,50,7,Vermont,VT
50003,50CS002,407,391,423,399,-8,-24,8,2,-0.6663889873544033,-0.2773498877463737,0.15523686812596363,-0.29927989993669724,498,479,518,547,49,29,68,25,0.08387242785132813,0.7722204756334364,1.3759470349917469,0.5044654734501482,37022,37306,Bennington+Windham,Bennington,50,3,Vermont,VT
50025,50CS002,414,394,434,390,-24,-44,-4,6,-1.1070938733631612,-0.6649808091004962,-0.23821828506099926,-0.26010191311055164,512,488,536,536,24,0,48,24,-0.6151488077632608,-0.007266392473665827,0.6044416166564572,0.9666115063126052,45342,46054,Bennington+Windham,Windham,50,25,Vermont,VT
50005,50CS003,271,258,284,268,-3,-16,10,2,-0.6012613500392723,-0.1655538703860467,0.24439119550861338,-0.8163051325028425,336,320,351,387,51,36,67,14,0.8535687723584656,1.4844648411136445,2.081434445445409,0.266774128897643,30160,30371,Caledonia+Essex+Orange,Caledonia,50,5,Vermont,VT
50009,50CS003,61,61,62,68,7,6,7,5,0.21810958970474806,0.3110232844721184,0.41318562900295797,0.6366455408394244,75,74,76,87,12,11,13,6,1.1009302261957685,1.2579921011899893,1.4121278641287194,0.45401963446504773,5946,5923,Caledonia+Essex+Orange,Essex,50,9,Vermont,VT
50017,50CS003,241,229,254,240,-1,-14,11,7,-0.7253775617750448,-0.29486427353189365,0.12878737229577514,-16.425369166166973,300,284,315,295,-5,-20,11,3,-0.9508244713709753,-0.29063387165707344,0.3173362660322397,-0.8198374851399673,29223,29500,Caledonia+Essex+Orange,Orange,50,17,Vermont,VT
50011,50CS004,380,359,402,404,24,2,45,25,-0.4486300360590937,-0.029350164551612608,0.4039548127869249,1.0164237807423508,470,444,496,481,11,-15,37,24,-0.9230199685388656,-0.33820090619399196,0.30127890924564293,2.075483646106633,49941,50277,Franklin+Grand Isle,Franklin,50,11,Vermont,VT
50013,50CS004,53,52,54,57,4,3,5,4,-0.1276389705230501,-0.030177844691151957,0.06806490409547637,0.8380057594462438,66,65,67,95,29,28,30,5,3.6974826698729313,3.847402178185159,3.997636969099327,0.1682164222858071,7283,7400,Franklin+Grand Isle,Grand Isle,50,13,Vermont,VT
50015,50CS005,181,170,192,214,33,22,44,5,0.6655065628972242,1.0750831560945229,1.5112044524681654,0.1470241987496483,223,210,237,245,22,8,35,6,0.09445436788542953,0.7302030127778386,1.2870227040386297,0.2656799970555586,25864,26095,Lamoille+Orleans,Lamoille,50,15,Vermont,VT
50019,50CS005,275,263,287,277,2,-10,14,4,-0.48937235830470693,-0.07739494843396741,0.3295907426384078,1.4363774326337828,337,323,351,428,91,77,105,24,2.260471921310275,2.9040031834258655,3.5247231446897267,0.2614359619905997,27314,27518,Lamoille+Orleans,Orleans,50,19,Vermont,VT
50021,50CS006,612,586,638,650,38,12,64,2,0.19545619650212614,0.5802939525118946,0.9979898626585146,0.05178321212939179,754,722,785,803,49,18,81,34,-0.30819099259134447,0.29447796595023906,0.901053760462919,0.6759583559851712,60129,60571,Rutland,Rutland,50,21,Vermont,VT
50023,50CS007,472,446,498,536,64,38,90,2,0.5814586772261184,1.0351141590507096,1.4548165337552292,0.030737625118130014,582,551,613,610,28,-3,59,20,-0.4626378546024101,0.16681947750639783,0.7236120485119598,0.6986751478409268,59583,59937,Washington,Washington,50,23,Vermont,VT
50027,50CS008,522,497,547,554,32,7,57,6,-0.024347462819451028,0.451464940721839,0.8876571325803698,0.181475701344502,645,615,675,675,30,0,60,27,-0.5273246057553168,0.08047605108300634,0.6862000397623241,0.8606268313810912,57363,58124,Windsor,Windsor,50,27,Vermont,VT
51001,51CS001,375,361,390,423,48,33,62,32,0.017459657697285837,0.4629381027785889,0.9207077866006815,0.6567958721453618,459,441,476,555,96,79,114,50,1.0243399633605026,1.6832718001418918,2.2578534176272576,0.5132792842938066,33188,33261,Accomack+Northampton+Virginia Beach (city),Accomack,51,1,Virginia,VA
51131,51CS001,162,157,167,194,32,27,37,23,0.3068101686114179,0.7343599774752511,1.1977473419872258,0.6975706376877463,196,190,203,213,17,10,23,20,-0.9672755202203288,-0.3202539136826328,0.2428512065450643,1.1273457294932165,12154,12106,Accomack+Northampton+Virginia Beach (city),Northampton,51,131,Virginia,VA
51810,51CS001,2761,2564,2958,3056,295,98,492,163,-0.13339227662018757,0.28300557842164265,0.7110752688823329,0.5501568036006961,3421,3184,3657,4056,635,399,872,403,-0.016354921561396472,0.6034962034104124,1.2364064251460123,0.6332288901672175,457941,457920,Accomack+Northampton+Virginia Beach (city),Virginia Beach (city),51,810,Virginia,VA
51003,51CS002,746,697,794,852,106,58,155,46,0.12229058605278456,0.5450162593583496,0.9785054954591509,0.4290297447113303,925,866,983,1022,97,39,156,73,-0.3754986202935426,0.24729469429813683,0.8636475951481226,0.7437339969723823,112217,113383,Albemarle+Charlottesville (city),Albemarle,51,3,Virginia,VA
51540,51CS002,242,222,262,259,17,-3,37,26,-0.6206456366760295,-0.20152069833545128,0.21010096436648942,1.4380335327767255,295,272,319,329,34,10,57,23,-0.36560222499127565,0.2786944604592735,0.9248894092987265,0.6651868361961419,46470,45782,Albemarle+Charlottesville (city),Charlottesville (city),51,540,Virginia,VA
51510,51CS003,629,560,697,705,76,8,145,87,-0.47849184902470054,-0.07245239566733021,0.35041088870392634,1.1236839560093057,774,693,854,798,24,-56,105,58,-0.8952021200042914,-0.2673969427934314,0.3636445488891968,2.2830856714312384,158633,155346,Alexandria (city),Alexandria (city),51,510,Virginia,VA
51005,51CS004,182,175,188,211,29,23,36,25,-0.16135855765233853,0.30096956766842853,0.7321736897842251,0.8208919545938449,220,213,228,318,98,90,105,49,3.2964007948722225,3.8764085487023525,4.438161214869155,0.4972952706620802,15104,15012,Alleghany and Nearby Counties and Independent Cities,Alleghany,51,5,Virginia,VA
51017,51CS004,55,55,56,65,10,9,10,1,1.9341051979173174,2.0378235613854367,2.137245051432795,0.09496886462070983,67,67,68,77,10,9,10,12,-0.7856158640379827,-0.6312187079714079,-0.48042812541242985,1.1079729664745535,4184,4126,Alleghany and Nearby Counties and Independent Cities,Bath,51,17,Virginia,VA
51023,51CS004,308,293,322,321,13,-1,28,20,-0.625347877730643,-0.19695450438841638,0.2181288731535453,1.3820848393369356,380,363,398,484,104,86,121,56,1.089317212268698,1.6721757123654868,2.3237852271665043,0.5353961007404019,33624,33829,Alleghany and Nearby Counties and Independent Cities,Botetourt,51,23,Virginia,VA
51091,51CS004,25,25,26,25,-0,-1,-0,3,-1.593878401664206,-1.4908402232052058,-1.3947148285632125,4.431571992464986,31,31,31,33,2,2,2,7,-2.9396113046889893,-2.7757127451903965,-2.6291101681344067,2.4624849893285394,2226,2227,Alleghany and Nearby Counties and Independent Cities,Highland,51,91,Virginia,VA
51580,51CS004,97,96,97,88,-9,-9,-8,4,-2.363472653046164,-2.257903560607037,-2.1584349527503655,-0.5069205151517218,119,118,120,117,-2,-3,-1,25,-5.79833989971337,-5.662002277321565,-5.503864741823459,-26.12345849574547,5706,5718,Alleghany and Nearby Counties and Independent Cities,Covington (city),51,580,Virginia,VA
51007,51CS005,144,138,150,156,12,6,18,3,0.2748847823051906,0.699533682281483,1.1003861197568514,0.2278086555785439,177,170,184,224,47,40,54,29,1.0063891520837775,1.6231548320006943,2.2856660062917613,0.605190524815058,13221,13265,Amelia+Brunswick+Lunenburg+Nottoway,Amelia,51,7,Virginia,VA
51025,51CS005,180,173,187,193,13,6,20,13,-0.45084299216956303,-0.01928105134668991,0.43341434884027435,0.9411683771767995,222,214,230,274,52,44,60,27,1.1889135426070259,1.8863267050933419,2.4955294134760178,0.509420101667468,15874,15920,Amelia+Brunswick+Lunenburg+Nottoway,Brunswick,51,25,Virginia,VA
51111,51CS005,134,129,139,136,2,-3,7,2,-0.458148452263992,-0.018267086690111095,0.39492838871270214,0.7203975879768564,164,158,170,177,13,7,19,18,-1.162312959937125,-0.5287066638047134,0.13336818613797585,1.3157456552782913,11976,11927,Amelia+Brunswick+Lunenburg+Nottoway,Lunenburg,51,111,Virginia,VA
51135,51CS005,180,173,186,184,4,-2,11,21,-1.5219215199685534,-1.0831769273961311,-0.6301024547477947,4.022939863877027,221,213,229,261,40,32,48,29,0.2333363825723905,0.854599450801327,1.4824744424778602,0.703872589061113,15552,15597,Amelia+Brunswick+Lunenburg+Nottoway,Nottoway,51,135,Virginia,VA
51009,51CS006,294,280,307,324,30,17,44,18,-0.029816462013069558,0.39443732919089214,0.837462439063075,0.5740959588641067,360,344,376,478,118,102,134,49,2.045411500689188,2.6668468270101657,3.330696395510114,0.4122706381410036,31324,31271,Amherst+Lynchburg (city)+Nelson,Amherst,51,9,Virginia,VA
51125,51CS006,166,159,172,186,20,14,27,4,0.715847169118062,1.110831303338041,1.5319267913316896,0.18750158969056396,203,195,211,206,3,-5,11,24,-2.388365393537194,-1.7191547050658191,-1.0521832607343227,6.045143088604479,14758,14782,Amherst+Lynchburg (city)+Nelson,Nelson,51,125,Virginia,VA
51680,51CS006,674,640,708,779,105,71,139,56,0.1562331890068567,0.6031672162369103,1.053868331712731,0.5301379940066229,828,787,869,976,148,107,189,116,-0.15398536612460023,0.5074956904418203,1.10472473334405,0.7792896634237436,79306,78989,Amherst+Lynchburg (city)+Nelson,Lynchburg (city),51,680,Virginia,VA
51011,51CS007,165,158,172,156,-9,-16,-2,3,-1.2204126786201146,-0.7652566376337663,-0.3540504138896389,-0.35974706760175823,204,196,213,201,-3,-12,5,24,-2.6269898772699896,-2.0155652584944654,-1.4287403238650918,-9.975764906733591,16122,16321,Appomattox+Campbell,Appomattox,51,11,Virginia,VA
51031,51CS007,492,468,516,603,111,87,135,46,0.7378871532425444,1.1712813967893743,1.5940950023126619,0.4093473220952537,602,573,631,766,164,135,193,105,0.675974208144882,1.2773288584789664,1.8567879508473775,0.6364434744533528,55584,55513,Appomattox+Campbell,Campbell,51,31,Virginia,VA
51013,51CS008,779,677,882,986,207,104,309,152,-0.19468790779893813,0.21732422710538624,0.6665855663868594,0.7315540008825125,965,844,1086,1016,51,-70,172,75,-0.7586469011124078,-0.11580465710894397,0.4633520135358353,1.443927401156603,238107,233811,Arlington,Arlington,51,13,Virginia,VA
51015,51CS009,602,568,635,715,113,80,147,50,0.3843727702550052,0.8157438709105174,1.265423569977855,0.4374558791239694,733,693,773,965,232,192,272,97,1.4558688538042963,2.1043019190494547,2.7051418170620205,0.4164675210635234,77314,77556,Augusta+Rockbridge and Independent Cities,Augusta,51,15,Virginia,VA
51163,51CS009,220,210,230,271,51,41,61,21,0.9124951445581585,1.3456231441706716,1.7454463912075828,0.40231962678956606,267,255,278,346,79,68,91,63,0.26722687419619673,0.8737721199235562,1.479486826308303,0.784163235169958,22637,22636,Augusta+Rockbridge and Independent Cities,Rockbridge,51,163,Virginia,VA
51530,51CS009,69,68,69,89,20,20,21,10,1.4686424297524445,1.5735130555498724,1.682174884516443,0.467769894490131,84,83,85,112,28,27,29,17,1.8536232939520874,2.0009027123960257,2.150631632711682,0.585709927821216,6598,6604,Augusta+Rockbridge and Independent Cities,Buena Vista (city),51,530,Virginia,VA
51678,51CS009,74,73,75,67,-7,-8,-6,1,-1.1677829293082933,-1.0763321342154162,-0.979242638111083,-0.17050090736232804,92,91,93,72,-20,-21,-19,14,-5.594604989180038,-5.451055218715445,-5.294927916138829,-0.7459637948990907,7318,7435,Augusta+Rockbridge and Independent Cities,Lexington (city),51,678,Virginia,VA
51790,51CS009,330,319,341,345,15,4,26,36,-1.2289971300911753,-0.8069544109257402,-0.3889779063892912,2.226306403843439,399,385,412,423,24,11,38,43,-1.4786262819285545,-0.8318797505173074,-0.22008889737717502,1.691433865009866,25657,25681,Augusta+Rockbridge and Independent Cities,Staunton (city),51,790,Virginia,VA
51820,51CS009,236,227,246,225,-11,-21,-2,15,-1.5897676048841973,-1.170696564469323,-0.7341140671298277,-1.4745314346837144,289,277,300,317,28,17,40,28,-0.6161281607646556,0.03386771608703409,0.6510414601798231,0.9499857568082009,22327,22510,Augusta+Rockbridge and Independent Cities,Waynesboro (city),51,820,Virginia,VA
51019,51CS010,704,670,738,817,113,79,147,42,0.4547580519303101,0.8902812079059693,1.3363968797646972,0.36769351922385896,869,827,910,1066,197,156,239,126,0.41148946601448494,1.0480316432986536,1.6696233833463,0.6350634737825145,79559,80040,Bedford (county)+Bedford (city),Bedford (county),51,19,Virginia,VA
51021,51CS011,69,69,70,80,11,10,11,6,0.6361714479046864,0.738024939793368,0.8291660171782782,0.5164497791193673,84,83,85,98,14,13,15,7,1.1718676225574531,1.328577261716947,1.4668330826224922,0.47218681636846094,6246,6184,Bland+Smyth+Wythe,Bland,51,21,Virginia,VA
51173,51CS011,376,363,388,441,65,53,78,46,0.20025596323116318,0.6585704374299126,1.0913551519315767,0.693293956819723,456,440,471,601,145,130,161,77,2.192437931324041,2.7786025107708814,3.4778824304064213,0.5257120690163093,29770,29514,Bland+Smyth+Wythe,Smyth,51,173,Virginia,VA
51197,51CS011,344,332,356,398,54,42,66,39,0.10988024414914906,0.530498871056276,0.9741322129030802,0.710708830662727,419,405,434,505,86,71,100,75,-0.14593436676977106,0.4662157913145196,1.101944939557357,0.8645973669495495,28314,28192,Bland+Smyth+Wythe,Wythe,51,197,Virginia,VA
51191,51CS012,540,517,563,687,147,124,170,65,1.116140998800245,1.5449605559547968,1.95354119050528,0.4383395226994356,651,624,679,886,235,207,262,111,2.1060969037845627,2.7594951311015614,3.3815588929152787,0.4709261294605487,53820,53665,Bristol (city)+Washington,Washington,51,191,Virginia,VA
51520,51CS012,232,225,240,249,17,9,24,20,-0.6269061820673669,-0.18602214657644187,0.2572298244943179,1.1231237565744852,278,269,287,306,28,19,37,38,-1.3241937634133454,-0.728279243386392,-0.08543828614400276,1.3223293509258705,17205,17084,Bristol (city)+Washington,Bristol (city),51,520,Virginia,VA
51027,51CS013,254,246,263,333,79,70,87,29,1.992979774613208,2.4339439140873207,2.8386528580236225,0.364432059481819,306,295,316,394,88,78,99,64,0.8909637412638769,1.4513925660913958,2.0379882130066806,0.7166333681960719,20293,19874,Buchanan+Dickenson+Russell+Tazewell,Buchanan,51,27,Virginia,VA
51051,51CS013,179,173,185,195,16,10,22,16,-0.41889143986577015,0.039067900606590863,0.4508517895892907,0.9177874139380418,215,208,222,230,15,8,22,24,-1.423305225254833,-0.7924102143790757,-0.16835484682470822,1.5129047692849749,14055,13825,Buchanan+Dickenson+Russell+Tazewell,Dickenson,51,51,Virginia,VA
51167,51CS013,296,285,307,341,45,34,56,23,0.4100181418001392,0.8400028572997735,1.2758066711492495,0.4985493754943244,360,346,373,463,103,90,117,59,1.5102224671794124,2.0939291974713354,2.713270150547891,0.5649013525172337,25855,25576,Buchanan+Dickenson+Russell+Tazewell,Russell,51,167,Virginia,VA
51185,51CS013,511,493,528,609,98,81,116,31,1.2444115268544789,1.6674742542428163,2.086248961826186,0.3122328573082656,619,599,640,785,166,145,186,94,1.5504545767938578,2.159420582158505,2.7256162656507508,0.5642702885873392,40356,39986,Buchanan+Dickenson+Russell+Tazewell,Tazewell,51,185,Virginia,VA
51035,51CS014,303,290,315,394,91,79,104,49,0.9978866650540907,1.4553636780846657,1.8808350356900807,0.5304762066877489,369,354,384,524,155,140,170,70,2.821093126066304,3.5013491649519386,4.088872568078778,0.44984952805707906,29252,29060,Carroll+Galax (city)+Grayson,Carroll,51,35,Virginia,VA
51077,51CS014,171,165,178,214,43,36,49,29,0.4896950362208508,0.9046829876063872,1.3552140098709067,0.6609364078125668,210,202,218,281,71,63,79,41,1.7785979640317486,2.3536427921798775,2.9923108609402127,0.5677754081617684,15346,15350,Carroll+Galax (city)+Grayson,Grayson,51,77,Virginia,VA
51640,51CS014,140,139,141,123,-17,-18,-16,19,-5.516105855987153,-5.423413263151111,-5.325173655602914,-1.1892753399688607,172,171,173,165,-7,-8,-6,24,-5.686608670385259,-5.52536834905873,-5.3884344270866835,-4.22255321937067,6634,6665,Carroll+Galax (city)+Grayson,Galax (city),51,640,Virginia,VA
51036,51CS015,71,70,72,89,18,17,19,2,2.273199603790203,2.3749447224710747,2.4723612573918206,0.1051241077914351,86,85,86,115,29,29,30,14,2.657690690097112,2.8029739952938435,2.952708695023066,0.45973698397224266,6753,6614,Charles City+Goochland+Henrico+New Kent,Charles City,51,36,Virginia,VA
51075,51CS015,191,180,201,207,16,6,27,12,-0.25193471808045204,0.16233238204654946,0.5991456638058155,0.6926276161348229,240,227,253,277,37,24,50,33,-0.44049747992489957,0.19304254610830285,0.7872133908596473,0.86892613052533485,24769,25392,Charles City+Goochland+Henrico+New Kent,Goochland,51,75,Virginia,VA
51087,51CS015,2453,2310,2597,2929,476,332,619,275,0.1802806663178795,0.5935365080880369,1.015481833895692,0.5768585404092537,3021,2849,3194,3583,562,389,734,364,0.09598465237023421,0.703583635575601,1.2952798734128321,0.6469087300650513,333960,333662,Charles City+Goochland+Henrico+New Kent,Henrico,51,87,Virginia,VA
51127,51CS015,170,160,180,178,8,-2,18,12,-0.5779915242181395,-0.17189039395063435,0.24553790760850874,1.3105246983017824,215,202,227,245,30,18,43,20,-0.0820329659917249,0.5036342764149362,1.1079832522227497,0.640370420773326,23156,23779,Charles City+Goochland+Henrico+New Kent,New Kent,51,127,Virginia,VA
51550,51CS016,1615,1508,1723,1810,195,87,302,138,-0.20330013844485523,0.23633199219255704,0.6807859732428295,0.7056727597543699,2007,1878,2137,2388,381,251,510,237,0.06919354937683693,0.7117254074808254,1.3007809799246057,0.6212306165185308,249221,251037,Chesapeake (city),Chesapeake (city),51,550,Virginia,VA
51041,51CS017,2286,2129,2443,2583,297,140,454,185,-0.08644618765043899,0.30799098736626607,0.7296575615530364,0.6206009786739303,2851,2660,3042,3333,482,291,673,362,-0.2343627812254925,0.40498276811187217,1.0314961019117899,0.7500483282264678,364322,369941,Chesterfield+Colonial Heights (city)+Powhatan,Chesterfield,51,41,Virginia,VA
51145,51CS017,195,182,208,245,50,37,63,10,0.8548672098352156,1.3076413519617713,1.7468691445130298,0.19657829809477706,245,229,261,315,70,54,86,30,0.9455675832232557,1.5701026663597009,2.1304415784063075,0.4201728114211051,30404,31033,Chesterfield+Colonial Heights (city)+Powhatan,Powhatan,51,145,Virginia,VA
51570,51CS017,229,221,236,229,0,-7,8,13,-1.1180605473177092,-0.6827481447621744,-0.27204312530551994,8.819535556582485,280,271,290,320,40,30,49,38,-0.47358710605342813,0.12701520019936594,0.6850674546210763,0.9299648130309579,18039,18261,Chesterfield+Colonial Heights (city)+Powhatan,Colonial Heights (city),51,570,Virginia,VA
51043,51CS018,145,139,152,153,8,1,14,10,-0.5983592587875514,-0.16086805180351874,0.28466196521884535,1.1635805141629654,179,171,187,185,6,-2,14,19,-1.68453862921424,-1.076118259930748,-0.4184018906644207,2.734403196052893,14767,14867,Clarke+Warren,Clarke,51,43,Virginia,VA
51187,51CS018,340,323,358,351,11,-7,28,29,-0.8987290221401765,-0.44110695901679514,-0.004007687206187665,2.4258637165147685,419,398,440,532,113,92,134,77,0.40800936004092814,1.0466404357493433,1.6398284454007104,0.6774989420204498,40717,40904,Clarke+Warren,Warren,51,187,Virginia,VA
51045,51CS019,45,45,46,55,10,9,10,7,0.45213481978939524,0.5416076664713567,0.6472935314068373,0.6559610941833287,55,54,56,72,17,16,18,7,2.279607999444571,2.437865323394237,2.589197020783811,0.3913881353477099,4914,4867,Craig+Franklin (county)+Roanoke (county)+Salem (city),Craig,51,45,Virginia,VA
51067,51CS019,503,480,527,618,115,91,138,41,0.9262883046718192,1.334019675632605,1.7773538455032492,0.35452466841145697,618,590,646,795,177,149,205,88,1.3515819159797895,1.965538812503943,2.581344287549477,0.4944207626604164,54768,54870,Craig+Franklin (county)+Roanoke (county)+Salem (city),Franklin (county),51,67,Virginia,VA
51161,51CS019,888,846,929,1003,115,74,157,92,-0.17616681274808987,0.22302305806980846,0.6278917677987258,0.790610435610052,1086,1036,1136,1350,264,214,314,113,1.3148628157711015,1.8846272569167322,2.52071034338406,0.42693241944384225,96465,96626,Craig+Franklin (county)+Roanoke (county)+Salem (city),Roanoke (county),51,161,Virginia,VA
51775,51CS019,301,291,312,348,47,36,57,25,0.4251566983948358,0.8293861437130886,1.2895970079394479,0.526220024463943,367,354,381,395,28,14,41,51,-1.689788401254221,-1.1095938554847802,-0.517429311075986,1.7876523979009458,25350,25373,Craig+Franklin (county)+Roanoke (county)+Salem (city),Salem (city),51,775,Virginia,VA
51047,51CS020,389,366,412,406,17,-6,40,33,-0.7633438053547269,-0.2978742941429054,0.10739422279083033,1.8389353344710873,484,457,512,557,73,45,100,56,-0.24296332665955114,0.3679813710787289,0.9919150035350777,0.761539400508084,52809,53468,Culpeper+Madison+Rappahannock,Culpeper,51,47,Virginia,VA
51113,51CS020,133,131,134,121,-12,-13,-10,7,-1.469931803307043,-1.3668342847929527,-1.2690308183545842,-0.6463679181027898,165,163,167,177,12,10,14,27,-1.452192993287262,-1.3087302574441317,-1.1626823498390688,2.1100984545392483,13757,13927,Culpeper+Madison+Rappahannock,Madison,51,113,Virginia,VA
51157,51CS020,59,58,59,63,4,4,5,7,-0.4350392014382043,-0.3401312240801659,-0.23396021975554704,1.2747196119518764,73,72,74,96,23,22,24,1,3.479107715353825,3.6201962090910236,3.7759632822144473,0.04106169438552245,7331,7393,Culpeper+Madison+Rappahannock,Rappahannock,51,157,Virginia,VA
51143,51CS021,615,589,641,694,79,53,105,55,-0.024516581157130818,0.39311290639215735,0.8261375800216055,0.687809067624704,754,723,785,890,136,105,167,105,-0.0010514400297124708,0.6180895253702002,1.2563837734599343,0.7660665436504184,60300,60022,Danville (city)+Pittsylvania,Pittsylvania,51,143,Virginia,VA
51590,51CS021,612,594,630,669,57,39,75,69,-0.6718317675396986,-0.25260564884923836,0.15330750158625653,1.1836774156958414,748,726,770,883,135,113,157,109,0.11950964862335711,0.7535225275299635,1.3885473383747975,0.800855220134746,42085,42251,Danville (city)+Pittsylvania,Danville (city),51,590,Virginia,VA
51053,51CS022,229,217,241,277,48,36,60,18,0.6553404258845388,1.0641299889513267,1.4919497104501447,0.36876122651374194,283,269,298,371,88,73,102,42,1.3269922173188389,1.974014864295528,2.5882672436430476,0.47353486378280973,28033,27910,Dinwiddie+Petersburg (city),Dinwiddie,51,53,Virginia,VA
51730,51CS022,489,475,503,522,33,19,47,38,-0.6017995949983815,-0.13583118815094936,0.2969676146875192,1.1124743311605592,602,584,619,667,65,48,83,73,-0.9063750267221229,-0.26933250352128046,0.31385154744801064,1.0992497904470269,33015,33429,Dinwiddie+Petersburg (city),Petersburg (city),51,730,Virginia,VA
51059,51CS023,4547,4053,5040,5343,796,303,1290,688,-0.33444807438056057,0.09903090100169414,0.5293324295065613,0.8627558834379109,5720,5131,6309,6027,307,-282,896,423,-0.7066836246976675,-0.13168087292829792,0.47212728512673385,1.3731522854012161,1148127,1140996,Fairfax (county)+Fairfax (city)+Falls Church (city),Fairfax (county),51,59,Virginia,VA
51600,51CS023,217,207,227,217,0,-10,10,15,-1.0831707524128835,-0.6090089240641675,-0.21557372314604412,14.34834708111854,269,256,281,233,-36,-48,-23,19,-3.3636429680493087,-2.6972527449579586,-2.118179302407453,-0.5501088183655939,24023,24255,Fairfax (county)+Fairfax (city)+Falls Church (city),Fairfax (city),51,600,Virginia,VA
51610,51CS023,83,82,85,84,1,-1,2,10,-0.7408706030803863,-0.6389866229103464,-0.5361014652496896,6.02364153444611,102,101,104,99,-3,-5,-2,3,-0.6925127167458114,-0.5315333098911036,-0.373007149476372,-1.219806918590147,14622,14516,Fairfax (county)+Fairfax (city)+Falls Church (city),Falls Church (city),51,610,Virginia,VA
51061,51CS024,494,463,526,524,30,-2,61,23,-0.359591025075569,0.08159572284563774,0.4842410358341267,0.7466120308019931,615,577,653,707,92,54,130,58,-0.062472891746160414,0.547485407817008,1.1855526766468185,0.6255714918867745,72790,73687,Fauquier,Fauquier,51,61,Virginia,VA
51063,51CS025,147,140,153,198,51,45,58,12,2.1265026846532966,2.55168569207241,2.983809542549508,0.22894272587093825,180,172,188,212,32,24,40,15,0.7091029593270503,1.3331524696723145,1.9581831979606164,0.45410016292533617,15531,15553,Floyd+Giles+Montgomery,Floyd,51,63,Virginia,VA
51071,51CS025,198,191,205,244,46,39,53,13,1.5438225358302224,1.9609000496398017,2.3698567994230237,0.2782486855400976,240,231,248,299,59,51,68,31,1.4530191846968974,2.0348354476914707,2.6597331875692882,0.5158200769340303,16725,16590,Floyd+Giles+Montgomery,Giles,51,71,Virginia,VA
51121,51CS025,554,511,597,604,50,7,93,54,-0.4728285866177884,-0.02194612996554572,0.4010080552343273,1.0579771520352672,683,632,734,799,116,65,167,74,-0.08689887392875055,0.5346205594481553,1.1365205034917356,0.6333009770461379,99307,98624,Floyd+Giles+Montgomery,Montgomery,51,121,Virginia,VA
51069,51CS026,661,621,700,762,101,62,141,53,0.09875614074939762,0.5345217113542986,0.9496421389864873,0.5193562941136968,830,782,879,1026,196,147,244,132,0.1860021468602525,0.8050854172459551,1.412191823554351,0.6715510133209832,91636,93432,Frederick+Winchester (city),Frederick,51,69,Virginia,VA
51840,51CS026,221,209,233,269,48,36,60,25,0.38579644269525853,0.8095010154075423,1.2948105731423196,0.5142179059429054,274,259,288,323,49,35,64,41,-0.24262553860868644,0.3810890015965797,0.9859468458409184,0.8131644094174909,28025,28117,Frederick+Winchester (city),Winchester (city),51,840,Virginia,VA
51177,51CS027,849,788,909,982,133,73,194,71,0.05366759530267265,0.43266878603059183,0.8628760094122798,0.5284131146968258,1070,996,1144,1226,156,82,230,115,-0.26697555665327305,0.33576802037632514,0.9641268630291582,0.7328025985331091,140221,143209,Fredericksburg (city)+Spotsylvania,Spotsylvania,51,177,Virginia,VA
51630,51CS027,174,162,187,202,28,15,40,1,0.5129848906014091,0.9466815775664399,1.3243737622999412,0.03503704067282186,217,202,232,257,40,25,55,11,0.6233639181890331,1.2523023694590554,1.8498621656299268,0.2680449551143605,28217,28313,Fredericksburg (city)+Spotsylvania,Fredericksburg (city),51,630,Virginia,VA
51079,51CS028,149,140,158,154,5,-4,14,5,-0.4622873514524591,0.002835719610108681,0.42171790655077496,0.8182824785708155,187,176,198,236,49,38,60,37,0.12745356876938346,0.6891397932145862,1.3224951840889092,0.7388065754084034,20530,20913,Greene+Louisa+Orange,Greene,51,79,Virginia,VA
51109,51CS028,314,297,330,341,27,11,44,14,-0.11419557293671832,0.35916024417623943,0.8147255488384815,0.49377243798446346,394,374,414,492,98,78,118,41,1.1749370860958768,1.739174793398452,2.373553773114226,0.41574434560276713,37830,38689,Greene+Louisa+Orange,Louisa,51,109,Virginia,VA
51137,51CS028,352,336,367,379,27,12,43,12,-0.03528053647718102,0.4295920372513753,0.8384948645637821,0.42238473745407495,438,418,457,472,34,15,54,52,-1.126277058370219,-0.5318542345208321,0.08078661640090498,1.4652480149397724,36558,37072,Greene+Louisa+Orange,Orange,51,137,Virginia,VA
51083,51CS029,403,388,418,494,91,76,106,64,0.38724041404130566,0.7963334368987262,1.2354251802861582,0.6952673326823217,492,475,510,605,113,95,130,70,0.9358303089042537,1.5207084928672674,2.1481451004113303,0.6149574974986611,33904,33762,Halifax+Mecklenburg,Halifax,51,83,Virginia,VA
51117,51CS029,393,380,406,443,50,37,63,51,-0.4546348139049592,-0.016460382465698375,0.39681555588154005,0.9952929112385945,480,464,495,553,73,58,89,49,0.3276145989856946,0.9693094258736689,1.6170580523347073,0.6593465790002963,30347,30254,Halifax+Mecklenburg,Mecklenburg,51,117,Virginia,VA
51650,51CS030,1105,1047,1164,1250,145,86,203,73,0.08854973815865122,0.5184698357371237,0.9835307766701997,0.5015432548100763,1362,1291,1433,1623,261,190,332,179,0.10789880970326757,0.7092177549362986,1.3407800386472497,0.6842795122982319,136891,137656,Hampton (city)+Poquoson (city),Hampton (city),51,650,Virginia,VA
51735,51CS030,107,105,108,110,3,2,5,4,-0.1505622140934554,-0.04956581413095615,0.05536087480551499,0.9147929591605446,132,131,134,137,5,3,6,12,-0.8288534055931233,-0.689601492214383,-0.5389617858836943,2.063099693194044,12434,12557,Hampton (city)+Poquoson (city),Poquoson (city),51,735,Virginia,VA
51085,51CS031,842,794,889,955,113,66,161,75,-0.045104838800290356,0.3506381932639901,0.7645673901535264,0.6564050024930677,1048,991,1106,1251,203,145,260,103,0.43368590643901805,1.0860147595728318,1.657727474508802,0.5056858294254268,109884,111384,Hanover,Hanover,51,85,Virginia,VA
51165,51CS032,641,605,677,788,147,111,183,76,0.40404631137408636,0.8609375722631958,1.2854526669016069,0.5134018979321132,792,749,836,1018,226,182,269,145,0.5451734004667744,1.1809694764816547,1.7877976264786817,0.6390128473660445,83588,84301,Harrisonburg (city)+Rockingham,Rockingham,51,165,Virginia,VA
51660,51CS032,261,239,283,292,31,9,53,37,-0.571429321393391,-0.11546330759826812,0.3123578694383369,1.1510801918966627,322,295,348,368,46,20,73,40,-0.48722935155380476,0.14509604590651076,0.7690941438661987,0.8461035602899724,51898,51466,Harrisonburg (city)+Rockingham,Harrisonburg (city),51,660,Virginia,VA
51089,51CS033,575,553,597,732,157,135,179,76,1.1935382370585856,1.5889269797405008,2.0236728054728643,0.4817933467890533,697,671,723,976,279,253,305,148,2.471503546867973,3.11118364932923,3.7389463105939003,0.5291626635663584,50718,50326,Henry+Martinsville (city)+Patrick,Henry,51,89,Virginia,VA
51141,51CS033,221,214,229,273,52,44,59,32,0.7241245225443648,1.1288114228655797,1.5595116046137323,0.606614045898108,270,261,279,359,89,80,98,47,2.2477438859032803,2.862768177445386,3.483862126683903,0.5232554592182856,17569,17596,Henry+Martinsville (city)+Patrick,Patrick,51,141,Virginia,VA
51690,51CS033,277,271,282,261,-16,-21,-10,31,-3.929207158230973,-3.5307923462981816,-3.0991258255882252,-2.1142024159841353,339,332,346,293,-46,-53,-39,57,-9.684551239913256,-9.135673401199888,-8.574660925248892,-1.265800890664928,13289,13503,Henry+Martinsville (city)+Patrick,Martinsville (city),51,690,Virginia,VA
51149,51CS034,231,213,250,243,12,-7,30,12,-0.42150879482932324,-0.003992508259165487,0.41687219349470195,0.9480867504983542,289,267,311,364,75,53,97,48,0.13796648925753852,0.7485275087005815,1.3603725456075322,0.6339773268766602,42353,42901,Hopewell (city)+Prince George,Prince George,51,149,Virginia,VA
51670,51CS034,269,259,279,273,4,-6,14,19,-1.0669574607124739,-0.6536153077788207,-0.2642725389343082,3.860504806696014,330,319,342,426,96,84,107,62,1.1219858525586506,1.7440441436653298,2.355672944017939,0.6422404080935362,22920,23115,Hopewell (city)+Prince George,Hopewell (city),51,670,Virginia,VA
51095,51CS035,682,649,716,762,80,46,113,35,0.14785475451969937,0.5879866994924388,0.9787136746337329,0.4334569593017552,846,805,887,956,110,69,151,56,0.20529606169624143,0.8071114588969197,1.4258228468042995,0.5053006885021021,78336,79668,James City +Williamsburg (city),James City,51,95,Virginia,VA
51830,51CS035,69,68,71,84,15,13,16,4,0.5878956525809941,0.6935586634757573,0.7891536110538198,0.25586167032871,88,86,89,84,-4,-5,-2,3,-0.6530307050494231,-0.4986283613012841,-0.339294382626423,-1.191535203106241,15398,15569,James City +Williamsburg (city),Williamsburg (city),51,830,Virginia,VA
51033,51CS036,250,236,263,278,28,15,42,23,-0.2757216825700718,0.1546497385288606,0.5953051177749364,0.7857536438872211,311,294,327,376,65,49,82,38,0.4273060652767458,1.0377186704012615,1.6452770315681116,0.5724109577316626,30926,31270,King and Queen and Nearby Counties,Caroline,51,33,Virginia,VA
51057,51CS036,111,110,112,132,21,20,22,5,1.369623705032124,1.473090485975481,1.5772178283532805,0.23068559681232698,136,135,137,183,47,46,48,18,3.137946137878399,3.2803735898019992,3.446561732911972,0.3754957363630364,10639,10576,King and Queen and Nearby Counties,Essex,51,57,Virginia,VA
51073,51CS036,362,345,378,417,55,39,72,13,0.6631678580840654,1.100720609133154,1.5261295285975074,0.23019128493640575,448,428,468,497,49,29,69,56,-0.826000419835235,-0.21373824159082647,0.3850225618764269,1.1160947969500559,38554,39013,King and Queen and Nearby Counties,Gloucester,51,73,Virginia,VA
51097,51CS036,74,74,75,93,19,18,19,5,1.962473660671974,2.0614923159300527,2.1567462631969585,0.2532805872444437,91,90,92,102,11,10,12,5,0.8964014731856667,1.0578794626063057,1.2051193080946339,0.42179194729226194,6659,6652,King and Queen and Nearby Counties,King and Queen,51,97,Virginia,VA
51101,51CS036,148,141,156,152,4,-4,11,7,-0.5996236103393202,-0.19683927370230614,0.26643252594972006,1.5192757676911877,185,176,194,220,35,26,44,17,0.5724687855608795,1.1835066503684493,1.8223189548116776,0.47383334413661166,17830,18132,King and Queen and Nearby Counties,King William,51,101,Virginia,VA
51115,51CS036,122,118,126,119,-3,-7,1,10,-1.9620777750517207,-1.5253124088163654,-1.1072581757914277,-4.809343757397589,149,144,153,178,29,25,34,15,1.3909355834128196,2.049689275874136,2.6427318107751048,0.49233768282263635,8564,8543,King and Queen and Nearby Counties,Mathews,51,115,Virginia,VA
51119,51CS036,141,137,146,162,21,16,25,4,1.1346060602546997,1.5840468582060012,1.9837214079959329,0.18434469711861035,174,169,180,212,38,32,43,24,0.9439335974227872,1.5443322351269064,2.1582936507890045,0.6179452125717977,10630,10758,King and Queen and Nearby Counties,Middlesex,51,119,Virginia,VA
51105,51CS037,244,234,254,315,71,61,81,33,1.2881042419698825,1.7130202934564445,2.11601323576522,0.45820822883264567,296,285,308,412,116,104,127,53,2.8044800661307874,3.402661167134263,4.0402960530767205,0.45446277853733547,22286,21998,Lee+Norton (city)+Scott+Wise,Lee,51,105,Virginia,VA
51169,51CS037,277,267,286,302,25,16,35,37,-1.005010575039575,-0.5555235799892629,-0.14191110450960473,1.4098595281925166,337,326,348,390,53,42,64,56,-0.7645764030732825,-0.1200776859679408,0.4645741710458592,1.0309269625238833,21538,21438,Lee+Norton (city)+Scott+Wise,Scott,51,169,Virginia,VA
51195,51CS037,414,398,429,490,76,61,92,43,0.4767711363957652,0.9170760819483738,1.339139950855416,0.5561780091750288,501,483,520,659,158,139,176,73,2.222116551348678,2.8509337206133254,3.4650623075130635,0.45955185419694955,36185,35701,Lee+Norton (city)+Scott+Wise,Wise,51,195,Virginia,VA
51720,51CS037,43,43,43,58,15,15,15,3,3.1105617240921632,3.2199037665949435,3.3234105700842265,0.18777818761949627,52,52,53,95,43,42,43,13,9.656605721769965,9.800440324970179,9.955537853542241,0.2958232345221657,3722,3668,Lee+Norton (city)+Scott+Wise,Norton (city),51,720,Virginia,VA
51107,51CS038,1324,1142,1505,1543,219,38,401,162,-0.2946783870363664,0.14441421436529456,0.554048295881099,0.7351489584451802,1697,1477,1918,1751,54,-167,274,130,-0.8683551291858385,-0.20098077716197915,0.3959665063717089,2.3740146625042513,421991,426864,Loudoun,Loudoun,51,107,Virginia,VA
51683,51CS039,222,204,241,251,29,10,47,45,-0.8316103081413375,-0.38112504596482444,0.043328180385332316,1.5208221404061548,278,256,300,288,10,-12,32,27,-1.063078385357676,-0.5077778499632113,0.13631331568511884,2.544812582367904,42460,42711,Manassas (city)+Manassas Park (city),Manassas (city),51,683,Virginia,VA
51685,51CS039,37,36,39,33,-4,-6,-3,8,-0.825846422078815,-0.7208496191085162,-0.6241817700775086,-2.3168198614589226,47,44,49,49,2,0,5,5,-0.33100123375098256,-0.1884718918052959,-0.03495911789487627,1.4943040315773157,17261,17022,Manassas (city)+Manassas Park (city),Manassas Park (city),51,685,Virginia,VA
51700,51CS040,1376,1297,1456,1599,223,143,302,94,0.2350843962282181,0.6864257003143382,1.1037295799848053,0.4205435908955089,1690,1594,1785,1972,282,187,378,201,-0.09100568043520645,0.5096614534807319,1.107850910695342,0.7094568593754911,184876,184781,Newport News (city),Newport News (city),51,700,Virginia,VA
51710,51CS041,1663,1561,1765,1896,233,131,335,123,0.06054701166372485,0.4658651644765718,0.8935064974780818,0.5256436311882048,2030,1909,2152,2445,415,293,536,216,0.4112425666490573,1.0206410324924666,1.6125208046115116,0.5197323063859396,238204,235454,Norfolk (city),Norfolk (city),51,710,Virginia,VA
51139,51CS042,252,242,262,319,67,57,77,36,0.8803720486178486,1.3065523476092729,1.7360879378139789,0.528583700403617,309,297,321,358,49,37,61,53,-0.9093360810383072,-0.22201915097046748,0.46021823829591424,1.0642429243166909,23740,23790,Page+Shenandoah,Page,51,139,Virginia,VA
51171,51CS042,431,412,450,544,113,94,132,62,0.6793533651189654,1.1437880757587364,1.6047896208404802,0.5455276679768352,534,511,557,639,105,82,128,103,-0.5889294108291094,0.07575140999376843,0.6759303647413144,0.9721073771591371,44205,44680,Page+Shenandoah,Shenandoah,51,171,Virginia,VA
51740,51CS043,914,872,956,1065,151,109,193,85,0.2938451100024959,0.67576744282038,1.1144116213062483,0.5585207117717412,1116,1066,1167,1342,226,175,276,151,0.33765273312036986,0.9380430077514461,1.54703491102329,0.6656904031184281,97496,97866,Portsmouth (city),Portsmouth (city),51,740,Virginia,VA
51029,51CS044,146,139,153,174,28,21,35,23,-0.15190508590437735,0.30104010225965744,0.7338018986973619,0.7996907134318159,181,173,190,222,41,32,49,21,0.7958077858628588,1.4094870152779535,1.988920977983255,0.5032993659190532,16879,16928,Prince Edward and Nearby Counties,Buckingham,51,29,Virginia,VA
51037,51CS044,144,140,149,161,17,12,21,13,-0.1402916838243779,0.2991324770428487,0.7384017324443911,0.7419559697901124,176,170,182,236,60,54,66,32,2.3164289354830023,2.958674380711028,3.5487626569810855,0.5226066140519898,11550,11456,Prince Edward and Nearby Counties,Charlotte,51,37,Virginia,VA
51049,51CS044,83,82,84,102,19,18,20,8,1.0134925112079642,1.113683981034065,1.2142260697562732,0.4039158769545491,102,101,103,130,28,27,29,13,1.680928384353312,1.8340691884276439,1.9891589449949219,0.45099680297116607,9704,9677,Prince Edward and Nearby Counties,Cumberland,51,49,Virginia,VA
51065,51CS044,209,197,221,223,14,2,26,14,-0.4335549410999511,0.012837693416157637,0.4068568482741116,0.9324209451076875,262,248,276,290,28,14,42,19,-0.2681281928638705,0.4081660960420124,1.0077987659700798,0.6568723826300841,27324,27658,Prince Edward and Nearby Counties,Fluvanna,51,65,Virginia,VA
51147,51CS044,199,190,209,222,23,13,32,17,-0.16935206727015878,0.2562975786558495,0.6763976116247872,0.7220875821153253,246,234,257,273,27,16,39,25,-0.49967303222467124,0.15025593507213394,0.7312702152706847,0.8829829479907838,22003,21920,Prince Edward and Nearby Counties,Prince Edward,51,147,Virginia,VA
51153,51CS045,1768,1561,1975,2300,532,325,739,324,0.011170605335071547,0.44114177027783447,0.8588423902104976,0.6081225132866864,2242,1992,2492,2641,399,149,649,274,-0.3099067018054056,0.3097583077628511,0.9332570789155147,0.6843511509384674,481320,484219,Prince William,Prince William,51,153,Virginia,VA
51155,51CS046,385,370,399,452,67,53,82,47,0.15042799271863863,0.5965675586514353,1.0588356231354998,0.6904221878892022,471,454,489,578,107,89,124,60,1.052220279871488,1.6520675371830236,2.2618912528147597,0.5568607805518262,33796,33759,Pulaski+Radford (city),Pulaski,51,155,Virginia,VA
51750,51CS046,102,100,103,103,1,-0,3,3,-0.1960465837521097,-0.09405064074851895,0.007857504280848715,1.2251589670957577,126,123,128,139,13,11,16,16,-0.332219512993526,-0.189191582921471,-0.0269286422800816,1.1092210976363532,16426,16439,Pulaski+Radford (city),Radford (city),51,750,Virginia,VA
51760,51CS047,1575,1477,1673,1732,157,59,255,138,-0.3385986555068953,0.09119988379064801,0.5227260666059568,0.8733244143424653,1941,1824,2058,2295,354,237,471,224,0.05400783742960844,0.6902651106406843,1.349677883354422,0.631354092045062,227299,226614,Richmond (city),Richmond (city),51,760,Virginia,VA
51770,51CS048,1042,1000,1085,1284,242,199,284,107,0.9174287428038898,1.3538286176093994,1.7333763076093651,0.4410987792017296,1269,1218,1320,1468,199,148,250,117,0.3551332378037715,0.9965745558212818,1.6115801418926432,0.583899870120417,99674,99012,Roanoke (city),Roanoke (city),51,770,Virginia,VA
51081,51CS049,128,126,129,138,10,9,12,21,-1.0150301518141407,-0.928064849369056,-0.8184808262665083,1.8284888085405668,157,156,159,161,4,2,5,16,-1.4404348414106398,-1.2914360517038468,-1.1453427808798717,3.4406996372876644,11382,11431,Southampton and Nearby Counties and Independent Cities,Greensville,51,81,Virginia,VA
51093,51CS049,314,297,330,352,38,22,55,27,-0.14750953495815167,0.2870122962369005,0.6758334069128517,0.687481902274621,390,370,411,476,86,65,106,55,0.3179361673439454,0.9561861367396174,1.5192770476434998,0.634671076028161,38539,39188,Southampton and Nearby Counties and Independent Cities,Isle of Wight,51,93,Virginia,VA
51175,51CS049,159,151,167,194,35,27,43,33,-0.2981948589374985,0.12362304249890653,0.5584538248042782,0.9154156677738524,195,186,204,258,63,54,72,29,1.647177992835763,2.2533112524146217,2.840218969450318,0.4545868152360922,17933,17998,Southampton and Nearby Counties and Independent Cities,Southampton,51,175,Virginia,VA
51181,51CS049,69,68,69,74,5,5,6,6,-0.2190465461265641,-0.12302265388859111,-0.02753095235334229,0.9693106178338009,85,84,86,101,16,15,17,3,2.2861317045015537,2.442168992208605,2.597016333319393,0.173532888198828,6524,6532,Southampton and Nearby Counties and Independent Cities,Surry,51,181,Virginia,VA
51183,51CS049,114,113,115,125,11,10,12,17,-0.6825658553581507,-0.579210996926062,-0.4743797893813861,1.4485693332708882,140,138,141,176,36,35,38,20,1.6535048693778638,1.8086041219708724,1.9541496270509888,0.5380361584861727,10815,10764,Southampton and Nearby Counties and Independent Cities,Sussex,51,183,Virginia,VA
51595,51CS049,51,50,51,110,59,59,60,21,6.616478962414111,6.719756840094435,6.819283128947556,0.34956799275224554,63,62,64,95,32,31,33,7,5.184361162485986,5.329288485351095,5.465706096675728,0.21097799978282136,5666,5674,Southampton and Nearby Counties and Independent Cities,Emporia (city),51,595,Virginia,VA
51620,51CS049,136,132,139,132,-4,-7,-0,20,-3.3342654948493973,-2.9033953282343576,-2.4872659542253244,-7.462599690276145,166,162,170,179,13,9,17,18,-1.3128850644631833,-0.7044480531759775,-0.0961173760768744,1.2648806156340722,8131,8210,Southampton and Nearby Counties and Independent Cities,Franklin (city),51,620,Virginia,VA
51179,51CS050,719,651,787,751,32,-36,100,36,-0.43978884856486233,-0.036814281124539223,0.42735611328232465,1.0868254486233653,915,832,998,1028,113,30,196,87,-0.4371314484636218,0.1886804575015351,0.8136514556677771,0.762305336122273,157387,160400,Stafford,Stafford,51,179,Virginia,VA
51800,51CS051,685,644,725,838,153,113,194,83,0.3022260816867287,0.739190184895263,1.1872966766022288,0.5379038279833388,855,805,905,1062,207,157,257,140,0.25004096852383545,0.8280298924088796,1.4915247918819057,0.672992422758851,94491,95974,Suffolk (city),Suffolk (city),51,800,Virginia,VA
51099,51CS052,170,158,181,196,26,15,38,16,-0.07171390420367363,0.38046385721564535,0.8576795142608561,0.5840028752209497,216,202,230,201,-15,-29,-1,17,-2.074304370146363,-1.4139281626090756,-0.7519365739634879,-1.2103964668762868,26903,27389,Westmoreland and Nearby Counties,King George,51,99,Virginia,VA
51103,51CS052,189,185,194,196,7,2,11,5,-0.2743346598962718,0.15343461398327143,0.6002309789034788,0.6484552809131195,231,226,237,241,10,4,15,17,-1.4267969947611876,-0.8255189109894072,-0.2066327689940679,1.6182739152754455,10869,10925,Westmoreland and Nearby Counties,Lancaster,51,103,Virginia,VA
51133,51CS052,154,149,160,177,23,17,28,12,0.4519543519210002,0.883516804072984,1.3012787936663353,0.5097418929979887,191,185,197,245,54,48,60,28,1.966502691432605,2.584520838035226,3.1738840233231773,0.510050704202463,11892,12001,Westmoreland and Nearby Counties,Northumberland,51,133,Virginia,VA
51159,51CS052,106,105,107,106,-0,-1,1,5,-0.6586408850418243,-0.5622717283665125,-0.4611899329070859,5.366634100351677,131,130,132,132,1,-0,2,10,-1.360208833907732,-1.1971807793920712,-1.0531428120845014,4.966757616579553,8951,9003,Westmoreland and Nearby Counties,Richmond (county),51,159,Virginia,VA
51193,51CS052,214,206,221,230,16,9,24,16,-0.40100083082630933,0.032832020973485775,0.44820814618771104,0.9165970532270105,265,256,275,256,-9,-19,0,28,-2.985002317105289,-2.3933371304593676,-1.7835436724794882,-3.392260380197071,18452,18697,Westmoreland and Nearby Counties,Westmoreland,51,193,Virginia,VA
51199,51CS053,401,371,431,453,52,22,82,21,0.019749586963982026,0.43611007243806765,0.9011721705816474,0.39394599483665316,504,467,540,628,124,88,161,63,0.39567652078584786,1.047521832526749,1.6147566918036491,0.5035491895812625,70004,70804,York,York,51,199,Virginia,VA
53001,53CS001,110,108,112,110,0,-2,2,18,-0.9681009276066059,-0.8665792168314718,-0.7674215751973895,14.685518953937352,136,133,138,155,19,17,22,18,-0.08341135917859734,0.0800306151679353,0.22859381872981976,0.8850518458701987,20512,20619,Adams+Grant,Adams,53,1,Washington,WA
53025,53CS001,614,571,657,710,96,53,139,82,-0.26403836072775094,0.12955434484388265,0.5532008029116977,0.8470032181815813,763,712,815,911,148,96,199,120,-0.25336810581488484,0.3298727381425641,0.9488833740099301,0.8075266239657259,99257,100161,Adams+Grant,Grant,53,25,Washington,WA
53003,53CS002,217,208,227,266,49,39,58,22,0.7583894654618488,1.1745531459599223,1.636594666786523,0.444144419565747,266,255,278,289,23,11,34,29,-0.9614886161180747,-0.32138146136684276,0.290190932279545,1.2222294325852754,22359,22381,Asotin+Columbia+Garfield+Whitman,Asotin,53,3,Washington,WA
53013,53CS002,48,47,48,52,4,4,5,3,0.24553994135797666,0.3431706573984898,0.4451582614172962,0.5588862813019057,59,59,60,74,15,14,15,1,4.002358387261304,4.158497582636091,4.314123010536737,0.06265638404362718,3969,4028,Asotin+Columbia+Garfield+Whitman,Columbia,53,13,Washington,WA
53023,53CS002,24,23,25,24,0,-1,1,5,-2.550299678612002,-2.1152586394227395,-1.6865543132300875,4.370666726859662,30,28,31,32,2,1,4,5,-1.9769334062032615,-1.3472381742737671,-0.679145965752917,1.4893374386015845,2294,2338,Asotin+Columbia+Garfield+Whitman,Garfield,53,23,Washington,WA
53075,53CS002,230,209,250,270,40,20,61,25,-0.10007038368656357,0.3218997646214858,0.7625589272541341,0.6076617480095332,285,261,310,396,111,86,135,44,1.0376572041328915,1.6610212735737437,2.2513738144460795,0.39386624934421677,48138,47860,Asotin+Columbia+Garfield+Whitman,Whitman,53,75,Washington,WA
53005,53CS003,1299,1210,1388,1520,221,132,310,149,-0.06409310705091445,0.353209639535375,0.7818820681981004,0.6701453230826799,1618,1510,1726,1904,286,178,394,227,-0.25373615529497046,0.3565377380603878,0.9957565489448174,0.790358281187567,207075,209617,Benton,Benton,53,5,Washington,WA
53007,53CS004,616,582,650,653,37,3,71,40,-0.47598839098444,-0.05352873074238807,0.4100667494973766,1.0644345691989932,763,722,804,832,69,28,110,73,-0.6714526020979681,-0.08703955782193959,0.5483909155086154,1.0422476064298776,78922,79579,Chelan+Kittitas,Chelan,53,7,Washington,WA
53037,53CS004,268,249,288,302,34,14,53,29,-0.2861922073317432,0.09301129539575102,0.540928754809714,0.8384855690827409,335,312,359,384,49,25,72,30,-0.14605563370486566,0.49846358037443894,1.114777468620373,0.6030284246232844,45160,45366,Chelan+Kittitas,Kittitas,53,37,Washington,WA
53009,53CS005,895,861,928,917,22,-11,56,6,-0.2195284660298744,0.21072495033458255,0.6353386625149233,0.2578258373032843,1105,1065,1145,1255,150,110,190,75,0.5692740649498892,1.1222734338612745,1.784050524703895,0.497055445723761,77403,78074,Clallam+Jefferson,Clallam,53,9,Washington,WA
53031,53CS005,347,333,361,350,3,-11,17,3,-0.4246316909224155,-0.002237717334759173,0.3918314163467184,0.7964842447826027,432,415,449,448,16,-1,33,18,-0.6746005611628011,-0.08081208186945485,0.5519495602172874,1.0645352323647514,33004,33524,Clallam+Jefferson,Jefferson,53,31,Washington,WA
53011,53CS006,3225,3008,3442,3577,352,135,569,137,0.014483433734095257,0.4140433686800444,0.8647631254876875,0.3877326376419608,4033,3769,4296,4642,609,346,873,409,-0.11548855020878546,0.4568073465588719,1.1136270403221613,0.6701462739482918,503383,510472,Clark,Clark,53,11,Washington,WA
53015,53CS007,1055,1007,1103,1084,29,-19,77,25,-0.37830261832435397,0.03422536350047104,0.4650756065465376,0.8362490125496104,1300,1242,1358,1587,287,229,345,229,0.0414111906575089,0.6100718042201572,1.2768595083926646,0.7950753995312559,110908,111436,Cowlitz+Klickitat+Skamania+Wahkiakum,Cowlitz,53,15,Washington,WA
53039,53CS007,183,173,193,177,-6,-16,4,5,-0.9060301854174526,-0.4666980154282207,-0.049925528930739226,-1.0394738587529302,228,216,240,296,68,56,80,26,1.613241710171955,2.197542398616164,2.792372076566716,0.3760406247689649,22767,23069,Cowlitz+Klickitat+Skamania+Wahkiakum,Klickitat,53,39,Washington,WA
53059,53CS007,82,81,83,86,4,3,5,7,-0.36753899720493644,-0.2691381092117018,-0.1737647474528901,1.47526078164627,102,101,104,105,3,1,4,2,-0.07675835410240342,0.07739934072578275,0.23323804320087538,0.5382944971696486,12057,12150,Cowlitz+Klickitat+Skamania+Wahkiakum,Skamania,53,59,Washington,WA
53069,53CS007,43,43,44,41,-2,-3,-2,2,-1.090326128830282,-0.9890105668315442,-0.8921027598141241,-1.4254594616228895,55,54,55,68,13,13,14,2,2.8473012739276276,2.988925466043399,3.1401876409362046,0.13905619032622446,4454,4562,Cowlitz+Klickitat+Skamania+Wahkiakum,Wahkiakum,53,69,Washington,WA
53017,53CS008,267,249,286,283,16,-3,34,13,-0.37193658243117933,0.06070471948904647,0.5209145746510435,0.7714087248767927,333,311,356,387,54,31,76,42,-0.32135064877595715,0.2961552044944681,0.9258828912113669,0.7694257304148365,43108,43594,Douglas+Okanogan,Douglas,53,17,Washington,WA
53047,53CS008,385,366,403,413,28,10,47,33,-0.5490485384122941,-0.10511173128875648,0.3499969668245968,1.1204701085989819,474,452,496,562,88,66,110,76,-0.3471655034609319,0.3495678207862379,0.9964075764443139,0.85697347808398,42213,42559,Douglas+Okanogan,Okanogan,53,47,Washington,WA
53019,53CS009,67,67,68,85,18,17,18,6,1.508075652657545,1.6133272947459383,1.7151117317493305,0.3209803246329005,83,82,83,133,50,50,51,12,6.202074760593094,6.358494527330634,6.504684616087041,0.23321986301637018,7261,7259,Ferry+Lincoln+Pend Oreille+Stevens,Ferry,53,19,Washington,WA
53043,53CS009,100,99,101,102,2,1,3,9,-0.7678050854762231,-0.6699742883037527,-0.5593522303909961,3.394258063881585,126,124,127,144,18,17,20,20,-0.32968777618481465,-0.18369177983497095,-0.030911122405821542,1.036500118982997,10955,11186,Ferry+Lincoln+Pend Oreille+Stevens,Lincoln,53,43,Washington,WA
53051,53CS009,141,135,146,144,3,-2,9,5,-0.5476817754368066,-0.12613786595400545,0.30048377327981884,1.1505078923586718,175,168,182,236,61,54,68,23,2.689209623212508,3.3285827648419515,3.9070811055684844,0.36947878256505534,13560,13827,Ferry+Lincoln+Pend Oreille+Stevens,Pend Oreille,53,51,Washington,WA
53065,53CS009,408,388,428,432,24,4,44,21,-0.370444876871994,0.06376570086252988,0.5022431108889424,0.8395299156051185,506,481,530,631,125,101,150,101,-0.0275055907181026,0.6280926018640501,1.2736998026576782,0.7992738038463321,46546,47301,Ferry+Lincoln+Pend Oreille+Stevens,Stevens,53,65,Washington,WA
53021,53CS010,366,324,408,454,88,46,130,69,-0.20699998196141314,0.19448867992441532,0.6710736896482411,0.773829368221861,466,416,517,554,88,37,138,95,-0.6901594830356645,-0.09708583884081737,0.5316397345177728,1.069298009730607,96962,98094,Franklin,Franklin,53,21,Washington,WA
53027,53CS011,756,723,788,800,44,12,77,28,-0.2270698505071087,0.21808503949978625,0.6523044597323441,0.6157896446392797,935,895,974,1133,198,159,238,116,0.6727490630657935,1.3109864702069576,1.922606789337967,0.5818651878886772,75807,76691,Grays Harbor+Pacific,Grays Harbor,53,27,Washington,WA
53049,53CS011,298,288,308,268,-30,-40,-20,4,-1.8470699282814171,-1.4586677885161627,-1.0196772328410988,-0.13799047315312116,370,357,382,412,42,30,55,30,-0.003549254336473151,0.5963456808408473,1.2300113374857764,0.6944682525803384,23381,23878,Grays Harbor+Pacific,Pacific,53,49,Washington,WA
53029,53CS012,689,651,726,704,15,-22,53,30,-0.6152937599289855,-0.1651860302933884,0.2424067757155335,1.8315770736087857,851,806,896,907,56,11,101,41,-0.4261248598980212,0.19581724345416082,0.7441638909282754,0.7217191910341784,86764,87361,Island,Island,53,29,Washington,WA
53033,53CS013,11600,10625,12576,12136,536,-440,1511,976,-0.6029320598560317,-0.185625263012178,0.21732893425042044,1.8185870895360552,14326,13162,15491,15033,707,-458,1871,734,-0.6135952610826657,-0.014563283622697131,0.6348510407484528,1.037161529877806,2267118,2255260,King,King,53,33,Washington,WA
53035,53CS014,1972,1854,2091,2012,40,-79,158,41,-0.45047104372335567,0.0012964464071957573,0.4088076456854791,1.0053393682792797,2423,2281,2565,2647,224,82,366,192,-0.4090333314853527,0.12603474116910762,0.7518102758562027,0.8524928797498076,275030,274510,Kitsap,Kitsap,53,35,Washington,WA
53041,53CS015,816,781,852,863,47,11,82,31,-0.26763605336364205,0.1978317279005596,0.5897335792562661,0.6489440928144367,1016,973,1060,1129,113,69,156,145,-1.061132367580369,-0.45931543759846394,0.14853676412288766,1.2770371294566687,82401,84117,Lewis,Lewis,53,41,Washington,WA
53045,53CS016,604,576,633,623,19,-10,47,13,-0.34801448868383617,0.0841791158899983,0.5265423479223772,0.663597388322157,751,716,786,875,124,89,159,75,0.2865329317998797,0.8720040675892771,1.4922210026335108,0.5990387249747711,66326,67384,Mason,Mason,53,45,Washington,WA
53053,53CS017,6022,5625,6418,6198,176,-220,573,304,-0.5748908759711392,-0.15398643160440967,0.3267828896469,1.7160043572094787,7454,6976,7932,8216,762,284,1240,627,-0.4812509880970635,0.14423467434053028,0.8288933566337865,0.8219559378987366,920633,925288,Pierce,Pierce,53,53,Washington,WA
53055,53CS018,131,130,133,124,-7,-9,-6,7,-0.899010625623693,-0.8024279691729841,-0.7019179816067621,-1.1075205582054601,167,164,169,159,-8,-10,-5,7,-1.1065393775283128,-0.951229397367964,-0.8047348650122259,-1.0601325333347762,17827,18449,San Juan+Skagit,San Juan,53,55,Washington,WA
53057,53CS018,1063,1007,1119,1128,65,9,121,43,-0.30420498687303904,0.16450138076787812,0.6252321525455438,0.6536512683210278,1305,1237,1372,1535,230,163,298,96,0.6055813642340292,1.235733523827176,1.841064065043384,0.41529364618520065,129842,130573,San Juan+Skagit,Skagit,53,57,Washington,WA
53061,53CS019,4825,4468,5182,5226,401,44,758,368,-0.3726149372865302,0.05326798788395751,0.4709269295319783,0.9153838850193665,5994,5564,6424,6381,387,-43,817,348,-0.5215183578963553,0.03800258130993766,0.6772824775189854,0.8969925131197042,828761,832926,Snohomish,Snohomish,53,61,Washington,WA
53063,53CS020,4176,3944,4408,4498,322,90,554,289,-0.37232976946561475,0.06012008984740189,0.4983454565957619,0.8939658734058079,5174,4893,5456,5861,687,405,968,641,-0.5438481973769862,0.08816994846410947,0.7154865161022057,0.9319800937810333,538563,545261,Spokane,Spokane,53,63,Washington,WA
53067,53CS021,2063,1935,2190,2101,38,-89,166,57,-0.4927386192138316,-0.05255761904626967,0.3767877822058726,1.4448529691071534,2560,2406,2714,2906,346,192,500,201,-0.009025531498519456,0.5830024129883554,1.1721270574021923,0.5792143079074459,295078,297649,Thurston,Thurston,53,67,Washington,WA
53071,53CS022,508,481,535,541,33,6,60,37,-0.49507326322021933,-0.06458430410290265,0.3826571928282731,1.096804290233324,624,591,656,711,87,55,120,63,-0.11599141655862759,0.45115762188672415,1.0646871779566083,0.7141017208852473,62365,62666,Walla Walla,Walla Walla,53,71,Washington,WA
53073,53CS023,1489,1391,1587,1570,81,-17,179,56,-0.34748381351298063,0.1152628011908451,0.49418120712433994,0.6858070818188429,1845,1727,1963,2081,236,118,354,129,0.008023105079139153,0.5770098526475828,1.1749088472300244,0.5432338583183594,227663,228608,Whatcom,Whatcom,53,73,Washington,WA
53077,53CS024,1765,1655,1875,2127,362,252,472,303,-0.172548076623037,0.220523953063223,0.6258808124237236,0.8341224729150863,2176,2043,2308,2535,359,227,492,308,-0.33331717881639983,0.2355776207218479,0.8613921870731784,0.8548111673207317,255755,256108,Yakima,Yakima,53,77,Washington,WA
54001,54CS001,155,149,162,211,56,49,62,12,2.367867505697806,2.7917012108902624,3.2610632661158916,0.2117694356033506,189,181,197,251,62,54,70,35,1.4652704022921685,2.078607767215079,2.684194072481497,0.5582757363279327,15593,15464,Barbour+Pocahontas+Randolph+Tucker,Barbour,54,1,West Virginia,WV
54075,54CS001,84,83,85,99,15,14,16,3,1.4329134010807592,1.5280890669294753,1.623327951824139,0.18645102085127158,102,101,103,134,32,31,33,14,2.539695035333167,2.6905261520596913,2.8399393456803534,0.42983020504605185,7909,7842,Barbour+Pocahontas+Randolph+Tucker,Pocahontas,54,75,West Virginia,WV
54083,54CS001,300,288,312,323,23,11,35,4,0.24195298495008496,0.6631456904402506,1.095381452734354,0.16854323569589738,366,351,380,448,82,68,97,55,0.6055022988323466,1.1764379005496441,1.8695045919619524,0.6600332036413954,27966,27813,Barbour+Pocahontas+Randolph+Tucker,Randolph,54,83,West Virginia,WV
54093,54CS001,76,76,77,101,25,24,25,4,2.962829286461717,3.061416925976169,3.1639999498434244,0.15562836650608702,93,92,94,112,19,18,20,24,-1.0054825108882162,-0.8541912523469374,-0.7078187663007226,1.1851196957101002,6764,6684,Barbour+Pocahontas+Randolph+Tucker,Tucker,54,93,West Virginia,WV
54003,54CS002,958,905,1011,1158,200,147,253,65,0.6946829810022362,1.0919385100114989,1.5276565667304816,0.32298936820458696,1204,1139,1269,1449,245,180,310,186,-0.0548930379129432,0.5426977767462888,1.2462112276071735,0.7558391413301729,122568,125571,Berkeley+Morgan,Berkeley,54,3,West Virginia,WV
54065,54CS002,186,179,194,203,17,9,24,4,0.2847537433130221,0.7284518733684008,1.1832703304894092,0.22794848823508018,229,220,237,272,43,35,52,48,-0.9260082179010486,-0.3267486544194467,0.2808983540204592,1.0797167662783411,17178,17194,Berkeley+Morgan,Morgan,54,65,West Virginia,WV
54005,54CS003,273,263,282,298,25,16,35,14,0.06223505836129536,0.5034548760218748,0.9387604347675091,0.5343552695475715,331,320,342,379,48,37,59,35,0.07327390245622968,0.7516586663828152,1.3323342190484235,0.7129897924684571,21619,21371,Boone+Lincoln+Logan,Boone,54,5,West Virginia,WV
54043,54CS003,242,233,251,271,29,20,38,11,0.4462373739822861,0.8956770749993994,1.3022920701089165,0.36724540083598106,295,285,306,365,70,59,80,46,0.8035247191186607,1.4323535485094567,2.081267268729451,0.6496774152196164,20332,20157,Boone+Lincoln+Logan,Lincoln,54,43,West Virginia,WV
54045,54CS003,467,453,481,518,51,37,65,56,-0.5437379026506802,-0.1485786397354777,0.2912388107684915,1.0716417941232317,565,548,581,669,104,88,121,77,0.37765511872642293,1.020182474627303,1.6576782931260414,0.732915506333032,32344,31991,Boone+Lincoln+Logan,Logan,54,45,West Virginia,WV
54007,54CS004,138,132,143,153,15,10,21,4,0.4556817940609832,0.8926442829203379,1.332396464914114,0.24614111688376075,165,158,171,199,34,28,41,22,0.6049399827010445,1.185033393119135,1.8619018296858945,0.6243799043506235,12591,12267,Braxton+Gilmer+Lewis+Upshur,Braxton,54,7,West Virginia,WV
54021,54CS004,69,68,70,80,11,10,12,1,1.2363813296882036,1.3407813050590016,1.4432206930692955,0.08335805697721602,84,83,85,85,1,0,2,13,-2.0938055160432474,-1.9460045244788033,-1.792573138869807,6.278729435900508,7452,7377,Braxton+Gilmer+Lewis+Upshur,Gilmer,54,21,West Virginia,WV
54041,54CS004,209,202,217,214,5,-3,12,5,-0.4543061145492182,-0.03118324479406852,0.3758524134668098,0.8895734697855469,255,246,264,331,76,67,85,59,0.5660822823643549,1.2237821767872619,1.8234901071371874,0.7648366943949189,16832,16909,Braxton+Gilmer+Lewis+Upshur,Lewis,54,41,West Virginia,WV
54097,54CS004,224,213,234,255,31,21,42,8,0.5569157615013501,0.9659586579581045,1.4031010316470558,0.24727659993896164,273,260,285,334,61,49,74,61,-0.5883860273196094,0.022287239387366705,0.5903583694088285,0.9800899992020745,23861,23790,Braxton+Gilmer+Lewis+Upshur,Upshur,54,97,West Virginia,WV
54009,54CS005,275,266,285,350,75,65,84,37,1.272162919387927,1.6869608997661738,2.1267556475496883,0.48903354285933626,333,321,344,418,85,74,97,57,0.9334168615433365,1.516457254347704,2.1331910543884467,0.6607986928856776,22355,22188,Brooke+Hancock,Brooke,54,9,West Virginia,WV
54029,54CS005,362,350,374,452,90,78,102,63,0.4806463785720284,0.9468157175110509,1.369946573315399,0.6920938081153001,437,423,452,501,64,49,78,84,-1.460502533480651,-0.8243848057716504,-0.2307554191095153,1.2991375696677188,28954,28709,Brooke+Hancock,Hancock,54,29,West Virginia,WV
54011,54CS006,1100,1059,1140,1171,71,31,112,95,-0.6658115111476818,-0.2611490620540917,0.198132197941973,1.3118645710685084,1341,1293,1389,1490,149,101,197,154,-0.6677642367108966,-0.07773739674943,0.5708500304503386,1.026694787787925,93735,93523,Cabell,Cabell,54,11,West Virginia,WV
54015,54CS007,96,95,96,112,16,16,17,6,1.1989598751901978,1.3000977485615597,1.401534538371178,0.3433429024829183,115,114,116,146,31,30,32,20,1.513846816849932,1.65686123697578,1.7970555792170457,0.6264312360887896,8067,7909,Clay+Fayette+Nicholas+Webster,Clay,54,15,West Virginia,WV
54019,54CS007,518,500,535,574,56,39,74,39,-0.003476535600453334,0.4241390054630332,0.8689927387139272,0.6826052029868441,627,607,648,752,125,104,145,82,0.6453911661978438,1.2902126312693667,1.9096697162547112,0.6527250233092527,40625,39990,Clay+Fayette+Nicholas+Webster,Fayette,54,19,West Virginia,WV
54067,54CS007,284,274,295,291,7,-4,17,4,-0.3397043603672228,0.12551997541728854,0.5659167596757783,0.5097690381993577,347,334,359,419,72,60,85,70,-0.4671606480802899,0.11863597873010621,0.7503032343325454,0.9576647418786319,24506,24333,Clay+Fayette+Nicholas+Webster,Nicholas,54,67,West Virginia,WV
54101,54CS007,105,104,106,103,-2,-3,-1,8,-1.2848539997494957,-1.1868200018847244,-1.0802804749822827,-9.434923027418565,128,127,129,144,16,15,17,26,-1.6344215088391942,-1.4770770042024988,-1.3284097341574375,1.5440126158191827,8299,8261,Clay+Fayette+Nicholas+Webster,Webster,54,101,West Virginia,WV
54025,54CS008,408,394,422,472,64,50,78,41,0.2599804133851889,0.6874971825303032,1.1085350853660698,0.6322591241875167,495,478,512,609,114,97,131,78,0.6626278602101786,1.3042579571196056,1.9221052005190185,0.6786229528704668,33097,32646,Greenbrier+Monroe+Summers,Greenbrier,54,25,West Virginia,WV
54063,54CS008,148,142,153,183,35,30,41,16,1.1056425053428627,1.5503404339834015,1.9597623498334074,0.4407422278599887,180,174,186,220,40,34,46,18,1.5577360519850323,2.138196363166478,2.7633874381966654,0.4386915835020806,12471,12332,Greenbrier+Monroe+Summers,Monroe,54,63,West Virginia,WV
54089,54CS008,163,158,168,187,24,19,29,10,0.7547477776164156,1.2019726108731474,1.6140557945599983,0.39549425790573034,198,192,204,247,49,43,55,23,2.023726791520102,2.6297009031745375,3.237835181013638,0.46060308946806655,12005,11909,Greenbrier+Monroe+Summers,Summers,54,89,West Virginia,WV
54023,54CS009,115,114,116,143,28,27,29,22,0.4332887838664323,0.5355454531595154,0.6303332064303939,0.76131898429432,141,139,142,168,27,26,29,27,-0.1266715919284219,0.01801886444722143,0.16876584618027748,0.9576467331182388,11035,10979,Hardy and Nearby Counties,Grant,54,23,West Virginia,WV
54027,54CS009,238,228,247,268,30,21,40,23,-0.13246337702470734,0.307742132537638,0.7762070529683724,0.7305941774872707,294,282,306,341,47,35,59,46,-0.5521010796511426,0.0552112755287251,0.658793098395512,0.9517707786432192,23113,23268,Hardy and Nearby Counties,Hampshire,54,27,West Virginia,WV
54031,54CS009,150,144,157,171,21,14,27,9,0.3759104337668014,0.7987187031591215,1.2192484162554589,0.4177039009809329,184,177,192,200,16,8,23,36,-2.322042394431261,-1.7354337541208276,-1.1115666217091495,2.161508286731059,14171,14172,Hardy and Nearby Counties,Hardy,54,31,West Virginia,WV
54057,54CS009,287,276,299,353,66,54,77,70,-0.5672715603523506,-0.15002346571485395,0.268152162633758,1.0460403417684867,352,338,366,405,53,39,67,69,-1.2891453135709106,-0.7153799748537536,-0.11581887121884124,1.278404732340932,26879,26860,Hardy and Nearby Counties,Mineral,54,57,West Virginia,WV
54071,54CS009,73,73,74,100,27,26,27,0,4.13254739756543,4.237535319381063,4.34454288636483,0,89,88,89,110,21,21,22,10,2.072577442434835,2.2279094980969614,2.369681363700734,0.44650485228996234,6255,6141,Hardy and Nearby Counties,Pendleton,54,71,West Virginia,WV
54033,54CS010,715,686,743,724,9,-19,38,27,-0.7419435550309997,-0.2640614283765549,0.13165640281621582,2.591061689955759,865,831,898,1044,179,146,213,149,-0.012950075835101542,0.5584418556881269,1.1910182892617018,0.8255980958496415,65936,65247,Harrison+Taylor,Harrison,54,33,West Virginia,WV
54091,54CS010,172,165,179,209,37,30,44,10,1.182583567307318,1.6088780315638809,2.036664308394246,0.264353396192716,208,200,217,250,42,33,50,35,-0.16271737044067214,0.460969469065951,1.0925936837745738,0.8218132946940138,16680,16522,Harrison+Taylor,Taylor,54,91,West Virginia,WV
54013,54CS011,70,69,71,86,16,15,17,3,1.936906976087171,2.0344389675588324,2.140142378200766,0.1777586014440827,84,83,85,115,31,30,32,5,4.864839996991992,5.011471021922195,5.174812091946582,0.15720586350018131,6325,6179,Jackson and Nearby Counties,Calhoun,54,13,West Virginia,WV
54035,54CS011,305,293,317,347,42,30,54,28,0.06129325053821002,0.4898292768117312,0.9288038090515646,0.6550390814168655,375,360,389,439,64,50,79,62,-0.5303596941072118,0.10774908015167353,0.6825668763403193,0.9486532952652729,27870,27738,Jackson and Nearby Counties,Jackson,54,35,West Virginia,WV
54053,54CS011,297,286,308,332,35,24,46,22,0.10454055038235534,0.503276406595165,0.9491425570519891,0.6133795869234228,362,349,375,466,104,91,117,54,1.7530966934944967,2.405456561839434,3.0000745192910454,0.5122531511930503,25513,25186,Jackson and Nearby Counties,Mason,54,53,West Virginia,WV
54087,54CS011,180,174,186,170,-10,-16,-4,5,-1.548901194405545,-1.1036955432809805,-0.682413525052054,-0.5343889292278236,221,213,228,223,2,-5,10,22,-2.3354612223298803,-1.6777271664034912,-1.0630510002222926,6.582149868709794,13921,13910,Jackson and Nearby Counties,Roane,54,87,West Virginia,WV
54105,54CS011,48,48,49,53,5,4,5,7,-0.5124599616977207,-0.4110830385025306,-0.31480285221972976,1.201382207360073,57,57,58,83,26,25,26,13,2.835018143937932,2.990039289803035,3.142014873999775,0.4873414936958576,5258,5080,Jackson and Nearby Counties,Wirt,54,105,West Virginia,WV
54037,54CS012,430,405,455,505,75,50,100,36,0.2610826606670206,0.6884674997441138,1.0996116740555844,0.47419679824749283,534,504,564,579,45,15,75,66,-1.0591748464847568,-0.4310878484400827,0.18660394481662151,1.4460405620178733,57742,58277,Jefferson,Jefferson,54,37,West Virginia,WV
54039,54CS013,2135,2058,2213,2484,349,271,426,189,0.4421000702560607,0.8800113171553224,1.3034595913670717,0.5404431292711486,2589,2497,2681,2966,377,285,469,303,-0.09409713538747323,0.4779706244275058,1.0922189095884345,0.8008058499222149,179588,178258,Kanawha,Kanawha,54,39,West Virginia,WV
54047,54CS014,285,277,293,309,24,16,32,5,0.6186606628342775,0.9901739609731097,1.4583137903246777,0.20145234971018638,342,333,352,388,46,36,55,60,-1.5124292268014397,-0.905601437785988,-0.3106069636791515,1.2829576296092788,18666,18444,McDowell+Mercer,McDowell,54,47,West Virginia,WV
54055,54CS014,754,729,780,884,130,104,155,50,0.9114454964467105,1.3316497744888254,1.8035741044478462,0.38221193502726375,919,888,949,1100,181,151,212,149,0.033996960852011794,0.6537987190205622,1.2999721825140151,0.8178370065854028,59331,59150,McDowell+Mercer,Mercer,54,55,West Virginia,WV
54049,54CS015,602,578,626,608,6,-18,30,18,-0.6323888354770475,-0.21562162816523547,0.2086197303300084,2.5859843700837795,734,705,763,841,107,78,136,118,-0.8352669908038661,-0.21737922159555503,0.4136231358478137,1.0924153788692057,56129,56024,Marion,Marion,54,49,West Virginia,WV
54051,54CS016,331,318,344,398,67,54,80,58,-0.11514833233112501,0.29333887153906724,0.6995621274790635,0.8557394122313003,402,386,417,487,85,70,101,76,-0.2688800903238709,0.3665755834164769,0.9971852467758768,0.8826326309732223,30426,30163,Marshall+Ohio,Marshall,54,51,West Virginia,WV
54069,54CS016,499,481,517,600,101,83,119,47,0.8459225218432631,1.2861176267526722,1.7326005991349527,0.4600205351408136,605,583,627,692,87,65,109,73,-0.20661602235597054,0.4250703835249814,1.0178463992640234,0.8293904780231166,42120,41847,Marshall+Ohio,Ohio,54,69,West Virginia,WV
54059,54CS017,294,284,304,337,43,33,53,25,0.3131741847350552,0.7526043157391248,1.1760720624762249,0.5732587690619331,356,344,368,472,116,104,128,89,0.8450883884224515,1.4353024207090694,1.9908607989574496,0.7589557142504602,23399,23071,Mingo+Wayne,Mingo,54,59,West Virginia,WV
54099,54CS017,438,421,455,527,89,72,106,29,1.1358608699609656,1.5555271900003862,2.017641613753104,0.3217794171632324,534,514,553,678,144,125,164,88,1.12002519360906,1.7702242581189194,2.384219104343124,0.605094836392432,38901,38546,Mingo+Wayne,Wayne,54,99,West Virginia,WV
54061,54CS018,606,560,652,671,65,19,111,33,-0.11952182380315876,0.31406530762037393,0.718710153324613,0.5005981158119823,749,694,804,796,47,-8,102,99,-1.1964378565791873,-0.5820614259721066,0.013654290892137086,2.0737011584981313,106018,106318,Monongalia+Preston,Monongalia,54,61,West Virginia,WV
54077,54CS018,320,305,335,343,23,8,38,36,-0.8012641816605838,-0.378040446747812,0.03883799498944562,1.4957256100606107,392,375,410,460,68,50,85,78,-1.035511493126284,-0.35467070452986643,0.23126639565367524,1.1383266951909217,34093,34331,Monongalia+Preston,Preston,54,77,West Virginia,WV
54079,54CS019,528,504,553,595,67,42,91,54,-0.2070412018672349,0.22738178462829017,0.665052362092464,0.7989402886844995,648,619,678,706,58,28,87,62,-0.6882746284314057,-0.09839137228421753,0.5039722397364602,1.0588954515701654,57254,57280,Putnam,Putnam,54,79,West Virginia,WV
54081,54CS020,900,868,932,1019,119,87,151,28,0.8306527290328161,1.2294170505288213,1.6563997552125032,0.23357235633700962,1093,1055,1131,1290,197,159,235,140,0.31692568242051095,0.924021173834362,1.493228591588374,0.70644024320904375,74188,73855,Raleigh+Wyoming,Raleigh,54,81,West Virginia,WV
54109,54CS020,270,261,280,319,49,39,58,23,0.7707728702040374,1.2219680082333904,1.6228495311242546,0.46391042615542954,328,317,339,388,60,49,71,58,-0.4596045783506625,0.1505655167401292,0.746707749931824,0.9463978166800637,21169,21091,Raleigh+Wyoming,Wyoming,54,109,West Virginia,WV
54017,54CS021,64,63,65,78,14,13,15,2,1.431496848069868,1.5241544806068483,1.636393722614839,0.13309265594338862,77,76,78,93,16,15,17,12,0.4191708593549149,0.5589694617882807,0.7115236462102656,0.722108510811866,7878,7742,Tyler and Nearby Counties,Doddridge,54,17,West Virginia,WV
54073,54CS021,83,82,84,88,5,4,6,7,-0.40034315514351393,-0.29654564772753084,-0.20306266708519477,1.2192416219439124,102,101,103,121,19,18,20,19,-0.17559099995699265,-0.023253608447005344,0.1357063003253674,0.9563555797327772,7610,7608,Tyler and Nearby Counties,Pleasants,54,73,West Virginia,WV
54085,54CS021,90,89,91,113,23,22,24,5,1.9834391610489697,2.0869342386884173,2.187062458270766,0.2090070055910667,108,107,109,135,27,26,28,16,1.4361726495696518,1.5860537200518485,1.7308869970675107,0.5701362267320833,8594,8389,Tyler and Nearby Counties,Ritchie,54,85,West Virginia,WV
54095,54CS021,92,91,93,86,-6,-7,-5,9,-1.9252745722533173,-1.8168030154824295,-1.7220849559982143,-1.7570957607199233,111,110,112,137,26,25,27,21,0.5686844532899816,0.7205477003794044,0.8708152544610157,0.7800774539438236,8316,8173,Tyler and Nearby Counties,Tyler,54,95,West Virginia,WV
54103,54CS021,178,172,184,195,17,11,23,14,-0.20719266286169452,0.21127457355333548,0.6362979907466513,0.7780056137209924,214,207,222,300,86,78,93,49,2.4198049348295716,3.092654397208364,3.6925224911460304,0.5664154101062271,14469,14201,Tyler and Nearby Counties,Wetzel,54,103,West Virginia,WV
54107,54CS022,928,892,964,1004,76,40,112,74,-0.4262010402549873,0.026883077981705427,0.44270461049580834,0.9600311481932059,1132,1088,1175,1292,160,117,204,167,-0.7466497624534746,-0.08434170784125418,0.5348275512963253,1.0345398435697817,83909,83678,Wood,Wood,54,107,West Virginia,WV
55001,55CS001,229,221,238,241,12,3,20,16,-0.6378831713042875,-0.22182921818528661,0.21279164235978837,1.2748516177882458,282,271,292,322,40,30,51,30,-0.03351990411561967,0.6023071165380027,1.2360419831901375,0.7230298258737292,20635,20846,Adams+Juneau+Monroe+Vernon,Adams,55,1,Wisconsin,WI
55057,55CS001,254,243,266,257,3,-9,14,18,-0.9841165962318581,-0.5675752167212489,-0.14367127176293104,5.027224999111686,311,297,324,382,71,58,85,37,0.9248481317066402,1.5072780074718368,2.1430170629551366,0.5108151029792504,26753,26796,Adams+Juneau+Monroe+Vernon,Juneau,55,57,Wisconsin,WI
55081,55CS001,362,342,381,419,57,38,77,27,0.22424676561344944,0.6557116942240843,1.0878415232330843,0.46157855404738457,441,417,465,547,106,82,130,41,1.076068199349395,1.6760696145888048,2.3135628437744926,0.38405317647947407,46329,46206,Adams+Juneau+Monroe+Vernon,Monroe,55,81,Wisconsin,WI
55123,55CS001,253,240,266,318,65,52,78,22,0.9379483926842668,1.400323393126159,1.8406553641704433,0.3332224333957313,311,295,327,355,44,28,60,33,-0.21322314547252635,0.4401763043180812,1.0662169859286827,0.7264711443180137,30743,30883,Adams+Juneau+Monroe+Vernon,Vernon,55,123,Wisconsin,WI
55003,55CS002,166,159,173,163,-3,-10,4,11,-1.31613790412523,-0.8809708011515336,-0.4566333434326181,-5.126746019578771,205,196,213,206,1,-7,10,18,-1.9024882805422063,-1.245281386862438,-0.596036495375816,7.771537559490117,15922,16088,Ashland+Bayfield+Douglas+Price,Ashland,55,3,Wisconsin,WI
55007,55CS002,164,157,171,163,-1,-8,6,17,-1.5532749333798175,-1.118593112833515,-0.6382982674718628,107.97398794133711,202,194,211,189,-13,-22,-5,13,-2.59310108452253,-1.941300499542571,-1.318575238039354,-1.066310162294911,16084,16307,Ashland+Bayfield+Douglas+Price,Bayfield,55,7,Wisconsin,WI
55031,55CS002,363,344,382,466,103,84,122,53,0.7484405431076759,1.122037750499653,1.5828206760773187,0.5073430863140233,445,422,468,497,52,29,75,36,-0.21372605698941166,0.44548937280659145,1.0457160354364163,0.6814255904280704,44155,44214,Ashland+Bayfield+Douglas+Price,Douglas,55,31,Wisconsin,WI
55099,55CS002,169,163,175,177,8,2,14,3,-0.05649400793194109,0.3658682881676716,0.7826151322005098,0.3341639896940681,207,200,214,213,6,-1,13,18,-1.6153042056689628,-1.0486143442873137,-0.4311509064652021,2.6438736978357205,13921,14045,Ashland+Bayfield+Douglas+Price,Price,55,99,Wisconsin,WI
55005,55CS003,459,439,479,503,44,24,64,55,-0.6964278477151087,-0.23152053044675597,0.19336766819266865,1.2177349233753407,565,541,589,618,53,29,77,51,-0.5659454617894543,0.054942395706737514,0.6602357664773081,0.9489783239340376,46444,46708,Barron+Sawyer+Washburn,Barron,55,5,Wisconsin,WI
55113,55CS003,199,191,207,217,18,10,26,16,-0.3088923904727589,0.13285634247590988,0.5495070696701215,0.8360933047598345,247,238,257,278,31,21,40,34,-0.8436672241867204,-0.20050337820865705,0.3769073489145093,1.0666073572022206,17898,18268,Barron+Sawyer+Washburn,Sawyer,55,113,Wisconsin,WI
55129,55CS003,184,177,191,203,19,12,26,13,-0.07642441956938463,0.38628761151636115,0.8168648884909054,0.6393073917403543,227,219,236,278,51,42,59,25,1.2310626945567724,1.8532782328734478,2.503785244114671,0.48392213981934495,16492,16729,Barron+Sawyer+Washburn,Washburn,55,129,Wisconsin,WI
55009,55CS004,1802,1687,1918,2060,258,142,373,216,-0.25942378484016915,0.15985817019357546,0.566239966048146,0.8342773335653408,2232,2093,2371,2374,142,3,281,196,-0.8398557179927161,-0.2120262847488598,0.4226492944458171,1.3684721938843158,268123,269467,Brown,Brown,55,9,Wisconsin,WI
55011,55CS005,113,112,114,109,-4,-5,-3,11,-1.2332724163749986,-1.130063944024298,-1.029189769480546,-3.6224061993664733,139,137,141,143,4,2,6,5,-0.24030913081539435,-0.09311373970984697,0.050470182039285265,1.00575675736506,13273,13305,Buffalo+Jackson+Pepin+Trempealeau,Buffalo,55,11,Wisconsin,WI
55053,55CS005,183,174,193,224,41,31,50,18,0.6181441044580473,1.0667631158706101,1.4804531851207068,0.4331359016822294,225,214,236,236,11,0,22,15,-0.8134485393496795,-0.21834366980888537,0.40508305426566016,1.2549967254186085,21042,21118,Buffalo+Jackson+Pepin+Trempealeau,Jackson,55,53,Wisconsin,WI
55091,55CS005,60,59,60,61,1,1,2,3,-0.31834802736112605,-0.2196146868042264,-0.11583049093489323,1.2466844709985723,73,73,74,81,8,7,8,10,-0.5585436497659134,-0.4021531401992823,-0.2512197278118726,1.172721614290177,7328,7360,Buffalo+Jackson+Pepin+Trempealeau,Pepin,55,91,Wisconsin,WI
55121,55CS005,260,247,273,269,9,-4,22,33,-1.2189761111722046,-0.7699340288701323,-0.3356843142712604,3.282479402981445,319,303,335,303,-16,-32,-0,16,-1.8792756695248438,-1.2422479460434004,-0.6468811239440967,-1.0676358605079015,30597,30732,Buffalo+Jackson+Pepin+Trempealeau,Trempealeau,55,121,Wisconsin,WI
55013,55CS006,178,171,185,170,-8,-15,-1,27,-2.5212521759317923,-2.1029322115743154,-1.6299174078450367,-4.085821031561587,220,212,229,229,9,0,17,23,-1.624006110635089,-1.029424175672709,-0.407211093189468,2.369999379464427,16430,16721,Burnett+Polk,Burnett,55,13,Wisconsin,WI
55095,55CS006,407,388,426,423,16,-3,35,29,-0.7127288042349336,-0.28426053241230254,0.1527799560977387,1.6925087442235769,505,481,528,580,75,52,99,83,-0.8090654999011144,-0.1944422338505046,0.4478685477222325,1.0877632063264933,44861,45369,Burnett+Polk,Polk,55,95,Wisconsin,WI
55015,55CS007,323,300,345,353,30,8,53,34,-0.4797963546714975,-0.08289302436659984,0.35633956443527315,1.0956172227279877,401,374,428,404,3,-24,30,57,-1.846170866086626,-1.2224486628546527,-0.6028030798931148,14.430068469657595,52138,52530,Calumet+Winnebago,Calumet,55,15,Wisconsin,WI
55139,55CS007,1306,1233,1380,1525,219,145,292,172,-0.1438712290197018,0.28708217653552004,0.6782603067206888,0.7832483141771303,1605,1517,1694,1729,124,35,212,137,-0.709164139060931,-0.10201069766510418,0.5385790459262557,1.0998645195497903,171666,171626,Calumet+Winnebago,Winnebago,55,139,Wisconsin,WI
55017,55CS008,535,507,564,584,49,20,77,56,-0.5450244504118539,-0.09916954522783553,0.33100206464535825,1.1285716795911636,662,628,697,674,12,-23,46,64,-1.5378782039299124,-0.9375726788945823,-0.33512674550538907,5.0713315549810165,66109,66780,Chippewa+Rusk,Chippewa,55,17,Wisconsin,WI
55107,55CS008,160,154,166,163,3,-3,9,17,-1.3720412106391386,-0.9675530780940207,-0.5469798097504043,4.0506712013812685,194,187,202,234,40,32,47,28,0.3632216728356293,0.9733578313460496,1.5544080853007542,0.6910668952938265,14152,14130,Chippewa+Rusk,Rusk,55,107,Wisconsin,WI
55019,55CS009,290,275,305,332,42,27,57,52,-0.747666639875533,-0.2706340673016644,0.15930339048499856,1.2069979073012609,355,338,373,389,34,16,51,45,-0.9831287888030981,-0.3981435292899645,0.20681609004026263,1.3018268531735337,34663,34729,Clark+Taylor,Clark,55,19,Wisconsin,WI
55119,55CS009,162,153,170,175,13,5,22,24,-0.980550047387594,-0.516116824100017,-0.07221082797283676,1.670728251058563,198,187,208,226,28,18,39,29,-0.6378130724280807,-0.028903472242418474,0.5879231384588747,0.9891836900792333,19964,19919,Clark+Taylor,Taylor,55,119,Wisconsin,WI
55021,55CS010,484,459,509,528,44,19,69,40,-0.4062238719826162,0.08858107426019962,0.46305735034742107,0.8820348479903155,595,564,625,631,36,6,67,50,-0.8686824927507953,-0.27629947535033483,0.3222502351654536,1.3352296703846995,58366,58491,Columbia,Columbia,55,21,Wisconsin,WI
55023,55CS011,155,148,162,165,10,3,17,11,-0.46523594667959084,-0.05923813272666724,0.3792736498807723,0.998210000241484,190,182,199,197,7,-2,15,11,-0.9262405185789474,-0.3300683707818327,0.32454402768170715,1.4103485095989576,16090,16077,Crawford+Grant+Richland,Crawford,55,23,Wisconsin,WI
55043,55CS011,436,413,458,503,67,45,90,51,-0.12016668847052113,0.2963788362772063,0.7836932022794736,0.746808001314653,539,512,565,578,39,13,66,35,-0.4929313228264588,0.11372851299266375,0.708766328785741,0.8660796657765927,51890,52084,Crawford+Grant+Richland,Grant,55,43,Wisconsin,WI
55103,55CS011,167,160,174,191,24,17,31,11,0.33852150816658566,0.746008399479584,1.2570258655025812,0.4406951357766156,205,196,213,226,21,13,30,24,-0.7857775694126542,-0.1603648453989023,0.41737613328289586,1.0690324130716093,17273,17221,Crawford+Grant+Richland,Richland,55,103,Wisconsin,WI
55025,55CS012,2977,2735,3218,3366,389,148,631,216,-0.09856641266938108,0.31318004489645734,0.7416693084061955,0.5532727464864896,3713,3422,4004,3767,54,-237,345,147,-0.8354498810543909,-0.20292683499407266,0.3936939857745983,2.656417668056161,560338,563711,Dane,Dane,55,25,Wisconsin,WI
55027,55CS013,818,780,856,1019,201,163,239,126,0.42151159085543816,0.8539750719148479,1.247931723624293,0.6235918377925109,1005,959,1051,1111,106,60,152,112,-0.7140591445172616,-0.09972456642624894,0.5060388604965558,1.0495820600284274,89029,89306,Dodge,Dodge,55,27,Wisconsin,WI
55029,55CS014,311,298,324,325,14,1,27,25,-0.8128382194192516,-0.3583928452057443,0.04071182373939031,1.6848467924856199,384,368,400,381,-3,-19,13,22,-1.6217969521164137,-0.9973269894436043,-0.372483635689488,-11.121586151018732,29787,30330,Door+Kewaunee+Manitowoc,Door,55,29,Wisconsin,WI
55061,55CS014,163,154,172,191,28,19,37,26,-0.3237457701434313,0.09223554554916896,0.515639545495578,0.9007101339231994,200,189,210,206,6,-4,17,15,-1.1314833234951407,-0.5208841206016278,0.1535077343373513,2.0574738548206755,20527,20542,Door+Kewaunee+Manitowoc,Kewaunee,55,61,Wisconsin,WI
55071,55CS014,763,728,798,844,81,46,116,56,-0.12214505123535273,0.30535962212129075,0.7384348756828325,0.6807718168817916,935,893,977,948,13,-29,55,71,-1.4296462162454795,-0.8689428072669171,-0.26393931627411776,5.073675737857007,80917,81468,Door+Kewaunee+Manitowoc,Manitowoc,55,71,Wisconsin,WI
55033,55CS015,302,283,322,306,4,-16,23,23,-0.8539421216056606,-0.423825549984619,0.022250023844679796,4.821304089366152,373,349,396,414,41,18,65,33,-0.44259553889047765,0.2288077664664928,0.822333505104479,0.7765979434908669,45443,45531,Dunn+Eau Claire,Dunn,55,33,Wisconsin,WI
55035,55CS015,758,712,803,846,88,43,134,81,-0.3037396827244538,0.07264694941313087,0.5059015405494104,0.9054612406721122,935,880,990,998,63,8,118,68,-0.6622014974999513,-0.06242376685230046,0.4976168728296487,1.0693452879147758,105687,106360,Dunn+Eau Claire,Eau Claire,55,35,Wisconsin,WI
55037,55CS016,59,58,59,63,4,4,5,13,-2.036031089098875,-1.9359625617049268,-1.8332400357188479,2.4804415488375895,73,72,74,67,-6,-7,-5,8,-3.8309535640169368,-3.682724208161921,-3.53487768371042,-1.5780398604907302,4523,4588,Florence+Forest+Marinette+Oconto,Florence,55,37,Wisconsin,WI
55041,55CS016,107,106,108,99,-8,-9,-7,21,-3.2452700959132272,-3.1382233818758842,-3.04010597338523,-3.110300094663319,132,131,133,152,20,19,21,15,0.45885441375546376,0.6139641560046394,0.7635413968416521,0.7246007358367932,9152,9244,Florence+Forest+Marinette+Oconto,Forest,55,41,Wisconsin,WI
55075,55CS016,475,457,492,538,63,46,81,63,-0.39697984557537336,0.009084176429990225,0.41541792053118437,0.9771057266782327,583,561,604,615,32,11,54,44,-0.9452917738397683,-0.33099126832156495,0.2775343619612106,1.3253785824350524,41634,41874,Florence+Forest+Marinette+Oconto,Marinette,55,75,Wisconsin,WI
55083,55CS016,332,315,348,396,64,48,81,49,-0.032017811776970065,0.3926144826178189,0.841152063923339,0.7482138504439839,412,391,432,414,2,-18,23,34,-1.589593878155918,-0.9765053953237026,-0.3053078134049944,10.350903603640283,38932,39310,Florence+Forest+Marinette+Oconto,Oconto,55,83,Wisconsin,WI
55039,55CS017,836,792,881,999,163,118,207,108,0.10969625371621083,0.529561119545734,0.9664415212323848,0.6596836210222485,1033,979,1087,1182,149,95,203,106,-0.12765128201110293,0.48854485974781203,1.0847072688054968,0.7064751086561644,103960,104320,Fond du Lac,Fond du Lac,55,39,Wisconsin,WI
55045,55CS018,296,280,312,340,44,28,60,14,0.36813151753335965,0.802649207601396,1.2194078772530341,0.31365673822821577,362,343,381,397,35,16,54,29,-0.4229592150568554,0.1931810008085642,0.8314714496601665,0.8120836248827425,36971,36989,Green+Iowa+Lafayette,Green,55,45,Wisconsin,WI
55049,55CS018,178,168,188,197,19,9,29,3,0.28351643545079913,0.6901538883923718,1.0998683792968038,0.14771169071618595,218,206,230,212,-6,-18,6,12,-1.5198065420459816,-0.9041008026594717,-0.31557972698055103,-2.4089351695441814,23680,23744,Green+Iowa+Lafayette,Iowa,55,49,Wisconsin,WI
55065,55CS018,121,120,123,142,21,19,22,3,0.9517754451119133,1.0563439648113253,1.1525238979887595,0.139235143545008,150,148,152,165,15,13,17,14,-0.10649079843320951,0.047151434811679674,0.1921235451469343,0.8927355148516076,16633,16758,Green+Iowa+Lafayette,Lafayette,55,65,Wisconsin,WI
55047,55CS019,203,195,212,221,18,9,26,19,-0.4981536932710359,-0.09107622835270729,0.33346045569937305,1.0226124155421417,251,241,260,286,35,26,45,31,-0.3539764564590798,0.27589199127106967,0.868443894407636,0.8509234229576175,19008,19195,Green Lake+Marquette+Waushara,Green Lake,55,47,Wisconsin,WI
55077,55CS019,173,166,180,210,37,30,44,24,0.4030371468825544,0.8482523068064199,1.2459269578580743,0.6300836285037383,213,205,221,250,37,29,45,25,0.2911623407119485,0.9007499158804051,1.5630766873620456,0.6580216815367319,15599,15762,Green Lake+Marquette+Waushara,Marquette,55,77,Wisconsin,WI
55137,55CS019,246,235,257,289,43,32,54,25,0.295192264208176,0.7183375174636244,1.1712906510143144,0.5682556431970307,304,291,316,331,27,15,40,41,-1.2842783976399037,-0.6595054160878016,-0.023489525559993854,1.4402341052686818,24526,24782,Green Lake+Marquette+Waushara,Waushara,55,137,Wisconsin,WI
55051,55CS020,79,79,80,93,14,13,14,19,-0.9815109561804332,-0.8845970419106982,-0.7833259580245431,1.2975013835788822,99,98,100,109,10,9,11,5,0.8519612663008334,1.0101240217976637,1.1697143005491522,0.44733940640613196,6069,6171,Iron+Oneida+Vilas,Iron,55,51,Wisconsin,WI
55085,55CS020,424,408,441,499,75,58,91,46,0.3416116258612929,0.7533215951348389,1.1870220912057055,0.6088961065513436,526,506,545,531,5,-14,25,45,-1.8658284488280816,-1.2740469255851825,-0.5800358482657684,7.169835594679249,37557,38198,Iron+Oneida+Vilas,Oneida,55,85,Wisconsin,WI
55125,55CS020,280,270,290,282,2,-8,12,29,-1.5892627562581967,-1.1602131620524239,-0.7356388155110786,8.639872025228815,347,335,359,365,18,6,30,42,-1.892659914889062,-1.2549156971337458,-0.5937683287263796,2.252150056552271,22988,23455,Iron+Oneida+Vilas,Vilas,55,125,Wisconsin,WI
55055,55CS021,608,571,644,713,105,69,142,83,-0.16322547634364112,0.25595710308656544,0.7036910198973313,0.7828356684586396,751,707,795,891,140,96,184,85,0.16206874710344518,0.7643860514813992,1.3875621145046082,0.6029434122507858,84863,84931,Jefferson,Jefferson,55,55,Wisconsin,WI
55059,55CS022,1250,1177,1323,1488,238,165,311,229,-0.3799727396267519,0.041484458902638785,0.46319926008241613,0.9583059861772593,1538,1451,1625,1707,169,82,256,180,-0.6935054752454834,-0.06667259228572003,0.5660381425974147,1.0606903511730261,169138,168782,Kenosha,Kenosha,55,59,Wisconsin,WI
55063,55CS023,893,842,945,1004,111,59,162,69,-0.08971185078014722,0.3537475236083798,0.800690235390545,0.6186648759448735,1101,1039,1163,1140,39,-23,101,68,-0.8896030864176431,-0.2936840054169874,0.34266537887061405,1.7088120149571004,120414,120494,La Crosse,La Crosse,55,63,Wisconsin,WI
55067,55CS024,200,192,209,256,56,47,64,35,0.6386044837497659,1.0693906366309267,1.50144999269678,0.618065336133988,246,236,256,306,60,50,70,18,1.9967823051091926,2.5792547401416366,3.1502414968000485,0.295246426744472,19411,19493,Langlade+Lincoln+Menominee+Shawano,Langlade,55,67,Wisconsin,WI
55069,55CS024,294,281,306,372,78,66,91,68,-0.07406677297542696,0.35607099470750087,0.7764461758537559,0.8569812238077855,362,347,376,437,75,61,90,50,0.49399149205917203,1.0714864785755063,1.6537248183983002,0.655216725161365,28278,28517,Langlade+Lincoln+Menominee+Shawano,Lincoln,55,69,Wisconsin,WI
55078,55CS024,41,39,43,59,18,16,20,14,0.4416299124810271,0.8537497386807306,1.2564345981042548,0.7495274585626813,51,48,53,65,14,12,17,5,2.05797611134304,2.649529604144099,3.230570886166491,0.32519425409885394,4302,4284,Langlade+Lincoln+Menominee+Shawano,Menominee,55,78,Wisconsin,WI
55115,55CS024,407,389,424,477,70,53,88,63,-0.24085541108061703,0.1764137249604649,0.6298855542551347,0.8843941264831429,498,477,519,505,7,-14,28,39,-1.59553350764899,-0.9546926009309488,-0.3491927879253773,5.097575537138328,40834,40856,Langlade+Lincoln+Menominee+Shawano,Shawano,55,115,Wisconsin,WI
55073,55CS025,1065,1006,1124,1209,144,85,203,156,-0.5170226896176113,-0.09249287800409961,0.34721525095116007,1.074909765093788,1309,1238,1381,1444,135,63,206,190,-1.1072963464652423,-0.48404721366924397,0.1421985690582956,1.4018718442231972,137593,137693,Marathon,Marathon,55,73,Wisconsin,WI
55079,55CS026,7061,6658,7464,8848,1787,1384,2190,898,0.5102792634392735,0.9537881481149418,1.3565218232873593,0.5022701805014568,8623,8143,9103,9486,863,383,1343,274,0.1761136381825583,0.753041208699626,1.3622822895988576,0.31698250807431855,938390,929530,Milwaukee,Milwaukee,55,79,Wisconsin,WI
55087,55CS027,1295,1213,1377,1498,203,121,285,164,-0.22176540871488787,0.21287822673477902,0.6121753059250566,0.8049290908974455,1604,1505,1702,1673,69,-29,168,140,-1.06078366003666,-0.4489833579375816,0.1740436516167961,1.9893429459879712,190483,191441,Outagamie,Outagamie,55,87,Wisconsin,WI
55089,55CS028,703,664,742,781,78,39,117,85,-0.5070426852928429,-0.07114985672585379,0.33290498069830804,1.0751833315970705,872,824,920,906,34,-14,82,71,-1.0845418537342582,-0.4952489366273769,0.1187108975990107,2.035324214777144,91378,92362,Ozaukee,Ozaukee,55,89,Wisconsin,WI
55093,55CS029,247,229,265,287,40,22,58,25,-0.0570133227294829,0.35400052465981463,0.7808825246853289,0.6082005559569005,306,284,328,370,64,42,86,30,0.335419769009863,0.9490791621807408,1.582551460249215,0.46149056640303443,42316,42529,Pierce+St. Croix,Pierce,55,93,Wisconsin,WI
55109,55CS029,545,505,586,628,83,42,123,41,0.03393540955241807,0.46431065115288866,0.8572622876417333,0.4898080246718436,680,632,729,812,132,83,180,90,-0.08586591554998581,0.5254372151567935,1.156761526037413,0.6792256336725702,93474,94862,Pierce+St. Croix,St. Croix,55,109,Wisconsin,WI
55097,55CS030,455,425,486,520,65,34,95,45,-0.1658663392112442,0.27247344379614186,0.7011268539794431,0.6843094711199559,562,526,599,717,155,118,191,76,0.6890669743905037,1.3072617249653715,1.9100668669418948,0.4883607760606513,70470,70455,Portage,Portage,55,97,Wisconsin,WI
55101,55CS031,1611,1526,1695,1934,323,239,408,267,-0.1599359043994084,0.2870163385658782,0.7425665699690789,0.8228454218037392,1977,1876,2079,2230,253,151,354,217,-0.4120734703901723,0.22056368380135624,0.797972829760809,0.85590992836256,197203,196975,Racine,Racine,55,101,Wisconsin,WI
55105,55CS032,1326,1256,1397,1564,238,167,308,139,0.19296506184409895,0.5955418147031357,1.0264507494411486,0.5820626362793876,1636,1551,1720,1770,134,50,219,127,-0.5661895499656251,0.05539387295159749,0.6727754286369092,0.9379403404938291,163644,164273,Rock,Rock,55,105,Wisconsin,WI
55111,55CS033,565,537,593,631,66,38,94,44,-0.08199125862099044,0.3601384374501794,0.7832994350077084,0.65772828193946,692,658,726,753,61,27,95,67,-0.7367882698250606,-0.12997002612650677,0.5338884514220172,1.0834560248596556,65527,65700,Sauk,Sauk,55,111,Wisconsin,WI
55117,55CS034,986,935,1037,1137,151,100,202,127,-0.21756390167351825,0.19813139360174878,0.6486544459395924,0.8355413672013033,1211,1150,1272,1251,40,-21,101,102,-1.2268520614197211,-0.6297050926776416,0.03549263667450708,2.47343470455752,117523,117775,Sheboygan,Sheboygan,55,117,Wisconsin,WI
55127,55CS035,835,790,881,998,163,117,208,116,-0.0038334522950640585,0.439361995279375,0.8484073479512468,0.7083009683223943,1033,978,1088,1095,62,7,117,95,-0.988141987964827,-0.3763415797093649,0.24685581205881862,1.5034761587030172,106151,106755,Walworth,Walworth,55,127,Wisconsin,WI
55131,55CS036,1017,958,1076,1188,171,112,230,117,-0.051024499538981645,0.3933006627963473,0.8524920844981136,0.6813285435585297,1258,1187,1329,1387,129,58,200,129,-0.5907749350993091,0.013496978063903315,0.6113259863715484,0.991521499120236,136715,137110,Washington,Washington,55,131,Wisconsin,WI
55133,55CS037,3024,2848,3199,3670,646,471,822,421,0.10271769711576312,0.561032803197959,0.9988359225568645,0.6502082029216886,3739,3528,3950,4148,409,198,620,329,-0.4525116366298502,0.24737951425169755,0.869365405882289,0.8019189044205931,406936,408522,Waukesha,Waukesha,55,133,Wisconsin,WI
55135,55CS038,621,599,643,716,95,73,117,118,-0.8725218419468815,-0.44064683483799116,-0.030484395253291875,1.232032590154377,756,729,783,759,3,-24,30,71,-2.232614258162348,-1.6013255052379325,-0.9824391172737652,18.303477753643303,51574,51591,Waupaca,Waupaca,55,135,Wisconsin,WI
55141,55CS039,721,689,753,824,103,71,135,52,0.26908431481781875,0.688527811800549,1.127524284489499,0.49969487286770436,885,847,923,1051,166,128,204,122,0.08344622135206571,0.704996573482143,1.3387003957326324,0.729454583356588,73900,74073,Wood,Wood,55,141,Wisconsin,WI
56003,56CS001,118,117,119,127,9,8,10,14,-0.5173553595342807,-0.41118873666397027,-0.31277057431494043,1.3656021019466313,146,145,147,190,44,43,45,32,1.0874204184959673,1.2386889186567147,1.3950915219501472,0.7111123778307386,11525,11608,Big Horn+Hot Springs+Park+Washakie,Big Horn,56,3,Wyoming,WY
56017,56CS001,63,63,64,80,17,16,17,2,3.1011222637186617,3.1977817620187454,3.2985678434122314,0.1131734578313043,78,77,78,87,9,9,10,10,-0.39981864720311644,-0.24241973365158548,-0.0845527716446257,0.9912890047258476,4589,4601,Big Horn+Hot Springs+Park+Washakie,Hot Springs,56,17,Wyoming,WY
56029,56CS001,257,244,270,303,46,33,59,14,0.6275807226366612,1.0759518748110808,1.5091902929150938,0.29871437098798403,322,307,338,441,119,103,134,103,-0.011616403354029886,0.6413263803526387,1.2336765809715522,0.8605338552245207,29635,30042,Big Horn+Hot Springs+Park+Washakie,Park,56,29,Wyoming,WY
56043,56CS001,72,71,73,87,15,14,16,21,-0.9107660318623392,-0.8075299299488137,-0.7052997567804253,1.3311642913969248,89,88,90,113,24,23,25,18,0.7558022125230824,0.9176065223987953,1.064300390585167,0.7238692284758284,7687,7698,Big Horn+Hot Springs+Park+Washakie,Washakie,56,43,Wyoming,WY
56013,56CS002,362,345,379,486,124,107,141,64,1.1100701934948076,1.5356756828346207,1.9553780549979847,0.5106226331192484,445,425,466,579,134,113,154,91,0.6550340452352629,1.2939347571857254,1.854078343627748,0.6755598546057386,39236,39313,Fremont+Lincoln+Sublette+Teton,Fremont,56,13,Wyoming,WY
56023,56CS002,123,121,125,155,32,30,34,10,1.0109558415409907,1.1066221285976678,1.2028156355989572,0.30372637217938403,155,152,157,173,18,16,21,15,0.04535335080177102,0.20010794478181726,0.35689051691941137,0.7735152461933409,19762,20083,Fremont+Lincoln+Sublette+Teton,Lincoln,56,23,Wyoming,WY
56035,56CS002,47,46,48,67,20,19,21,4,1.662250054936456,1.7627988392870106,1.8693632916525966,0.19366695361593203,57,56,59,78,21,19,22,16,0.4722124737185775,0.624038384910015,0.7807593536453123,0.7425446924044838,8887,8701,Fremont+Lincoln+Sublette+Teton,Sublette,56,35,Wyoming,WY
56039,56CS002,87,85,90,79,-8,-11,-6,8,-0.799983243443446,-0.6965820367420572,-0.5983897370346477,-1.099797162801721,110,107,113,89,-21,-24,-18,5,-1.4675327713186954,-1.3184309005704051,-1.1637817056813262,-0.25246074250383854,23376,23542,Fremont+Lincoln+Sublette+Teton,Teton,56,39,Wyoming,WY
56021,56CS003,744,700,787,821,77,34,121,63,-0.2969420470144358,0.14306182078373467,0.5588617670852687,0.8044109168516955,919,867,971,1258,339,287,391,173,1.335470880105379,1.977330028372677,2.5731101067473108,0.5086223898106401,100588,100838,Laramie,Laramie,56,21,Wyoming,WY
56025,56CS004,622,587,656,761,139,105,174,95,0.15026993912925143,0.5539253441941563,0.9630191497251446,0.6764844693222771,761,720,802,934,173,132,214,131,-0.0018704009629766794,0.6444705393977194,1.2743564049965446,0.753299764499998,80087,79653,Natrona,Natrona,56,25,Wyoming,WY
56005,56CS005,218,198,238,276,58,38,78,39,-0.014694002256419696,0.39650098420323865,0.8216984549644454,0.6642721616707117,270,246,294,367,97,73,121,86,-0.30213671071312775,0.2849431584834132,0.890908077720153,0.8788794076221873,46940,46505,Northeast Wyoming,Campbell,56,5,Wyoming,WY
56011,56CS005,53,52,53,99,46,46,47,10,4.909443348335108,5.004374947664465,5.105943263479254,0.21148843494083705,65,64,66,82,17,16,18,13,0.4619811827036047,0.6201894848114559,0.7686059300788812,0.7318278017261932,7250,7295,Northeast Wyoming,Crook,56,11,Wyoming,WY
56019,56CS005,83,82,83,84,1,1,2,6,-0.6430598685896396,-0.5409601196153954,-0.44047336015774985,2.493907793804101,103,102,104,110,7,6,8,0,0.8815196885743052,1.0254856488402417,1.1955809546206524,0,8489,8599,Northeast Wyoming,Johnson,56,19,Wyoming,WY
56033,56CS005,286,272,299,300,14,1,28,18,-0.5189092358652055,-0.12406372321087182,0.3542256506611818,1.1623427672199973,355,339,372,384,29,12,45,43,-1.1253822367369002,-0.5560480500908674,0.06523364368527938,1.4539522317219369,31006,31551,Northeast Wyoming,Sheridan,56,33,Wyoming,WY
56045,56CS005,55,54,56,68,13,12,14,7,0.795662588339419,0.8975595630916192,1.0035881624268344,0.49627609533190437,67,66,68,106,39,38,40,11,4.835892222077062,5.003801363273343,5.154285771133344,0.2740551486948236,6813,6754,Northeast Wyoming,Weston,56,45,Wyoming,WY
56001,56CS006,172,156,188,213,41,25,57,10,0.3969379858510467,0.8362825140477452,1.2613344720242943,0.23788772082814413,218,199,237,267,49,30,68,34,-0.12022616903671153,0.49019682475618315,1.0800615906822963,0.6815361971980491,37388,37531,"Southeast Wyoming, excluding Laramie",Albany,56,1,Wyoming,WY
56007,56CS006,108,107,110,137,29,27,30,17,0.7093600445128462,0.809449414404011,0.9126916392853279,0.5708547453727572,133,131,135,162,29,27,31,31,-0.3372566873108404,-0.18053434610974603,-0.025626795435196675,1.0414105777409866,14563,14627,"Southeast Wyoming, excluding Laramie",Carbon,56,7,Wyoming,WY
56009,56CS006,103,101,104,127,24,23,26,4,1.3860127264079671,1.481856542289425,1.5855872822349564,0.15764261677178992,125,124,127,164,39,37,40,36,0.08734454867848909,0.2418358922867853,0.3990228772363482,0.9055062504932566,13739,13680,"Southeast Wyoming, excluding Laramie",Converse,56,9,Wyoming,WY
56015,56CS006,135,129,140,160,25,20,31,19,0.12175349862739077,0.5113575019864791,0.9362043109106384,0.7208279293875474,165,158,171,188,23,17,30,31,-1.381808003536064,-0.715634409452398,-0.12004511012344703,1.2707993149663412,12612,12532,"Southeast Wyoming, excluding Laramie",Goshen,56,15,Wyoming,WY
56027,56CS006,24,23,25,33,9,8,10,6,0.9377126470116554,1.3584778337496266,1.7669679511500203,0.5849326472566162,29,28,31,36,7,5,8,8,-1.2181382540038908,-0.616710637188169,0.05208604110347906,1.0341835145845137,2424,2438,"Southeast Wyoming, excluding Laramie",Niobrara,56,27,Wyoming,WY
56031,56CS006,84,83,85,96,12,11,13,6,0.575553001558614,0.6706938138599694,0.7686034825576317,0.46935857001002057,104,103,105,171,67,66,68,25,5.660607307037352,5.8026297396145,5.960827957816911,0.36752754222685524,8609,8688,"Southeast Wyoming, excluding Laramie",Platte,56,31,Wyoming,WY
56037,56CS007,253,235,271,357,104,86,122,22,1.518288741735548,1.9456655472198021,2.3768006520823493,0.2096586551476405,311,289,332,414,103,82,125,82,-0.0055852187901277335,0.606504447614766,1.2825020895716726,0.7874074865078896,42212,41693,Sweetwater+Uinta,Sweetwater,56,37,Wyoming,WY
56041,56CS007,139,130,148,154,15,6,24,2,0.19986518375144843,0.6201928786857471,1.046146164816439,0.12650250896590137,174,163,184,186,12,2,23,23,-1.2653256259745502,-0.5987200737956574,-8.361204124554121e-4,1.704730332765402,20425,20607,Sweetwater+Uinta,Uinta,56,41,Wyoming,WY
