FIPSCode,csCode,expDeathsMed2020,expDeathsLow2020,expDeathsUp2020,deaths2020,excDeathsLow2020,excDeathsMed2020,excDeathsUp2020,excCDR2020,COVIDDeaths2020,COVIDCDR2020,nonCovidExcCDRLow2020,nonCovidExcCDRMed2020,nonCovidExcCDRUp2020,COVIDExcRatio2020,expDeathsMed2021,expDeathsLow2021,expDeathsUp2021,deaths2021,excDeathsLow2021,excDeathsMed2021,excDeathsUp2021,excCDR2021,COVIDDeaths2021,COVIDCDR2021,nonCovidExcCDRLow2021,nonCovidExcCDRMed2021,nonCovidExcCDRUp2021,COVIDExcRatio2021,pop2020,pop2021,csName,countyName,stateFIPS,countyFIPS,state,stateStr
01001,01CS001,475,450,500,565,65,90,115,185.0670920714162,55,112.92475105225336,0.2090503570604501,0.7269352204465972,1.2463275129263016,0.6034875400538314,587,557,618,707,89,120,150,202.7026152061186,107,181.16248751333322,-0.29274781755777374,0.1937276003820094,0.7483385037758842,0.8863320877705031,58446,59063,Autauga,Autauga,1,1,Alabama,AL
01003,01CS002,2020,1920,2121,2277,156,257,357,132.46274160528046,165,85.20343395658068,-0.04889504029348594,0.4711763300900111,1.0152593704939454,0.6407278832792175,2535,2412,2658,3096,438,561,684,235.4008359759474,435,182.46873912003926,0.04467115696841318,0.5174057508808239,1.0694514403560387,0.7737617828514607,232385,238397,Baldwin,Baldwin,1,3,Alabama,AL
01005,01CS003,257,246,268,324,56,67,78,321.0643306439202,38,181.81093257844586,0.8988143793993669,1.3958652365474633,1.9003351531415529,0.5579609821189985,314,301,327,373,46,59,72,236.309324540613,52,208.0332853256521,-0.2170383548770643,0.288283624191025,0.8067973698794053,0.8656873036233724,25081,24996,Barbour+Bullock+Henry,Barbour,1,5,Alabama,AL
01011,01CS003,103,102,104,132,28,29,30,337.38314271881796,20,233.326852031888,0.9214973859503958,1.0390962504633985,1.1611894989303924,0.668463532664155,127,126,128,141,13,14,15,135.72147298886685,13,125.99340957549913,-0.030548744123916557,0.10300649016895853,0.22122063775768386,0.8664505402263935,10286,10318,Barbour+Bullock+Henry,Bullock,1,11,Alabama,AL
01067,01CS003,193,185,200,228,28,35,43,247.519145299416,24,167.52952126112498,0.2768457866438433,0.7898572396119401,1.292970280241133,0.6582704233269768,239,230,248,271,23,32,41,184.7445029065855,37,212.44832338079928,-0.8056075742944934,-0.29282665445844125,0.20077106777291268,1.1152942137627964,17191,17416,Barbour+Bullock+Henry,Henry,1,67,Alabama,AL
01007,01CS004,220,210,229,252,23,32,42,173.51568204378876,40,215.60436598841125,-0.9500924885147033,-0.39194214587552834,0.07614394385027898,1.2051279310194052,273,261,284,339,55,66,78,295.91371043720045,46,204.99108734402853,0.43380169789437667,0.9083228192977976,1.4061322032195975,0.6824618341440167,22263,22440,Bibb+Chilton+Coosa+Perry,Bibb,1,7,Alabama,AL
01021,01CS004,445,425,464,529,65,84,104,224.8247431763378,76,202.91015885729541,-0.28845139821642696,0.22684437508621452,0.7905619368986763,0.8919339037007686,550,527,574,653,79,103,126,227.22065350479593,107,236.5268137406605,-0.615726382913919,-0.09526486806098494,0.4248190893953853,1.0309270480496493,44946,45238,Bibb+Chilton+Coosa+Perry,Chilton,1,21,Alabama,AL
01037,01CS004,130,126,135,144,9,14,18,159.06587718177096,19,218.53733346113293,-1.0866010071346552,-0.5935776725722205,-0.09677863053393632,1.2812340870913568,160,154,165,184,19,24,30,232.79790284215306,21,201.1494252873563,-0.16289213898811086,0.33033205151147244,0.8469367774145115,0.829905000494866,10433,10440,Bibb+Chilton+Coosa+Perry,Coosa,1,37,Alabama,AL
01105,01CS004,97,96,98,141,43,44,45,617.3362752337787,23,324.2100317161988,2.81331186074244,2.929351991352946,3.044419087352249,0.5134517177478094,117,116,118,160,42,43,44,512.4148504894005,21,250.92603656350818,2.4959566208200865,2.6126821673513554,2.7450868135207713,0.47853433042376026,8513,8369,Bibb+Chilton+Coosa+Perry,Perry,1,105,Alabama,AL
01009,01CS005,597,572,622,731,109,134,159,272.8737845520424,92,187.4490627546862,0.3595811864333956,0.8497263459320994,1.399323303280774,0.6818529476026042,733,703,764,841,77,108,138,182.65199217040202,98,165.9694819381171,-0.3928907323295479,0.16839578830460905,0.6858139573749898,0.9003172273706371,58896,59047,Blount,Blount,1,9,Alabama,AL
01013,01CS006,215,206,223,256,33,41,50,260.722974795272,52,326.7871170463472,-1.1569634118685403,-0.6611199305238377,-0.15373729910286743,1.2238881300841618,260,250,270,308,38,48,58,254.82076588035727,47,248.5851800920294,-0.4285029824220999,0.0729302367806285,0.5649578328170453,0.9556932048318487,19095,18907,Butler+Crenshaw+Pike,Butler,1,13,Alabama,AL
01041,01CS006,155,150,161,209,48,54,59,487.4786738775008,29,262.74065685164214,1.7381965205840553,2.2462560823150057,2.764920639985467,0.5291443722091864,188,181,195,241,46,53,60,406.20290578070524,30,229.1125706430426,1.2485740082870196,1.7611876208837158,2.2387768715580587,0.5536259795238084,13245,13094,Butler+Crenshaw+Pike,Crenshaw,1,41,Alabama,AL
01109,01CS006,268,254,282,359,77,91,105,330.3567884850116,45,163.68596544407393,1.1657529620926468,1.6743026245949981,2.196565024021952,0.4900861715303467,330,313,347,457,110,127,144,385.89638318693756,74,224.31039709002727,1.122449503671985,1.6191734142187755,2.1363312136752417,0.576740746451049,32990,32990,Butler+Crenshaw+Pike,Pike,1,109,Alabama,AL
01015,01CS007,1265,1215,1315,1535,220,270,320,279.889656535786,175,181.16723461156883,0.45344383103280933,0.9900043389291868,1.5223279805003394,0.6448956143832533,1544,1484,1604,1865,261,321,381,276.5427428810828,302,260.3111666594837,-0.33673588407185845,0.1507641019386315,0.6990355855513234,0.9383805187753727,115915,116015,Calhoun,Calhoun,1,15,Alabama,AL
01017,01CS008,374,359,389,516,127,142,157,494.4851234384223,73,254.2446669569003,1.8329914911078566,2.4081556512323465,2.894605779856273,0.5105643418440676,455,437,473,576,103,121,139,350.04398640381856,77,222.79447932640838,0.7847241755323546,1.2728677393728407,1.793286291015184,0.6312577412979659,34455,34561,Chambers+Cleburne+Randolph,Chambers,1,17,Alabama,AL
01029,01CS008,169,162,175,189,14,20,27,162.8548248413061,25,199.60079840319358,-0.8413856741548935,-0.3571499907007044,0.12445137654893917,1.168357141743405,206,198,213,262,49,56,64,373.32853561109096,41,271.6491088584112,0.4935249983684936,1.0205741390837513,1.5567651066430501,0.7149523902035441,15030,15093,Chambers+Cleburne+Randolph,Cleburne,1,29,Alabama,AL
01111,01CS008,250,241,260,306,46,56,65,301.6640233991911,54,293.33212620524193,-0.43055663551176504,0.08406238220608248,0.6005027177673462,0.9551802396264388,304,292,315,356,41,52,64,238.56824218195828,55,250.1591922132266,-0.6565245818590235,-0.1153705793786812,0.3781159189885985,1.0289679986428146,22091,21986,Chambers+Cleburne+Randolph,Randolph,1,111,Alabama,AL
01019,01CS009,291,281,302,398,96,107,117,508.6631962764194,34,162.2201900520854,2.934492474917018,3.456481953928769,3.9595746734313413,0.31595116512763194,354,342,367,469,102,115,127,458.30502340132847,64,256.10244097639054,1.4640743113872916,2.029796492849003,2.5757647814576723,0.5539666266026811,25151,24990,Cherokee+Etowah,Cherokee,1,19,Alabama,AL
01055,01CS009,1201,1156,1245,1446,201,245,290,285.09320051659034,222,258.057016651652,-0.26656127824977577,0.2804654244727366,0.789119750549798,0.9014915308664233,1464,1411,1518,1820,302,356,409,344.7187777342136,287,278.1115547114229,0.17306658804322414,0.6758923149996235,1.1761867183040229,0.8045165280467081,103233,103196,Cherokee+Etowah,Etowah,1,55,Alabama,AL
01023,01CS010,154,149,160,160,0,6,11,52.6638620776159,31,295.1443986036179,-2.9410064803863407,-2.4207956089962375,-1.9235004761791847,4.7462581639676165,188,182,195,210,15,22,28,174.50777979234692,23,183.32536266539137,-0.6079494261683678,-0.08795767790155135,0.39850695040265033,1.0046411778573652,12604,12546,Choctaw+Clarke+Washington,Choctaw,1,23,Alabama,AL
01025,01CS010,251,242,261,371,110,120,129,621.9711282484104,43,223.7058874533946,3.478015764045652,3.973231092774851,4.529469437298996,0.35668894665483525,305,294,317,389,72,84,95,367.06232745270097,53,232.5173291216987,0.8647951202087768,1.373359419656426,1.8648525388676112,0.6259730121580123,23066,22794,Choctaw+Clarke+Washington,Clarke,1,25,Alabama,AL
01129,01CS010,165,158,172,188,16,23,30,178.58504063425292,24,186.7219917012448,-0.5894275599278056,-0.07385656694294546,0.4339306484812431,1.0019148866080985,200,192,208,243,35,43,51,283.8092950726729,32,210.95655613422107,0.20863911376451413,0.7094950089712353,1.1968966200778715,0.7264302008203245,15424,15169,Choctaw+Clarke+Washington,Washington,1,129,Alabama,AL
01027,01CS011,163,157,169,218,49,55,61,468.26572608592477,40,341.46688482606527,0.7415580452850683,1.2574095680706507,1.7989887701078995,0.7161601663717377,200,193,207,235,28,35,42,246.5838782667274,24,169.13319238900633,0.2121712656446746,0.7890440510086132,1.3039627287071185,0.6668472280376192,14057,14190,Clay+Talladega,Clay,1,27,Alabama,AL
01121,01CS011,872,837,907,1038,131,166,201,243.62086450292082,130,190.8420292869114,0.04816816460322476,0.521218090216015,1.0301421729234443,0.7786645775159704,1062,1020,1104,1366,262,304,346,372.9506533877608,203,248.7653640184797,0.7757895626237339,1.2336527283136407,1.7653743442595908,0.6648349934571338,81743,81603,Clay+Talladega,Talladega,1,121,Alabama,AL
01031,01CS012,477,454,500,616,116,139,162,312.50942297971875,70,157.02989176153886,1.0463618289243215,1.5521240061927195,2.081475563945221,0.4988992570851223,592,564,620,716,96,124,152,229.29941314993573,128,236.6645095682722,-0.6201859191354492,-0.08127341340624422,0.46336651557137293,1.0238641323929891,53493,54085,Coffee+Geneva,Coffee,1,31,Alabama,AL
01061,01CS012,315,304,327,402,75,87,98,391.1450935585448,54,243.3894230769231,0.8969126191332348,1.4785079227370868,1.9433761930381257,0.6151598763395266,386,372,400,528,128,142,156,531.5622978057439,81,303.40487695246657,1.7413759711637113,2.2889181684603317,2.786823755303678,0.5667855813211868,26624,26697,Coffee+Geneva,Geneva,1,61,Alabama,AL
01033,01CS013,649,624,674,675,1,26,51,54.75571526037798,83,174.82885729331227,-1.7096718281654033,-1.1880583850694895,-0.6984637221732354,3.0746120378190223,797,768,827,884,57,87,116,151.0597340505474,117,203.6943540103414,-1.0649005748907208,-0.5315596064274897,-0.047113397275252024,1.3330720262821305,56970,57439,Colbert,Colbert,1,33,Alabama,AL
01035,01CS014,148,143,153,183,30,35,40,358.4454679534154,27,279.26219617307356,0.2656704018322901,0.8028369618705747,1.2942043237910683,0.7572421235809194,179,173,185,224,39,45,51,394.56544652303677,35,308.07147258163894,0.33950135217951,0.8777803934721846,1.3750746745075544,0.763748892240505,11602,11361,Conecuh+Marengo+Monroe+Wilcox,Conecuh,1,35,Alabama,AL
01091,01CS014,237,229,246,281,35,44,52,273.1437391724552,35,218.90962159908264,0.06881626102340761,0.5453511801332146,1.0184510374588425,0.7835037713685229,290,280,299,350,51,60,70,317.43179570395284,60,315.20882584712376,-0.5032598716532763,0.0324295202519877,0.5459816945369719,0.9768305192688969,19186,19035,Conecuh+Marengo+Monroe+Wilcox,Marengo,1,91,Alabama,AL
01099,01CS014,219,210,227,283,56,64,73,388.3686305615598,30,181.3053988718775,1.598522256250029,2.0633753946374997,2.5882068902841056,0.4596851331673997,268,258,278,374,96,106,116,538.5013772664081,52,264.50989368736964,2.207190869321057,2.749693295819739,3.2521314617548556,0.4865998552434638,19856,19659,Conecuh+Marengo+Monroe+Wilcox,Monroe,1,99,Alabama,AL
01131,01CS014,139,135,144,150,6,11,15,120.86885584713113,22,251.59630229676927,-1.8080361821006725,-1.319967978395076,-0.771403731769937,1.9016379164886252,171,165,176,182,6,11,17,108.84617760185972,25,239.09716908951796,-1.816552651887053,-1.3071927704765067,-0.7821249317626685,2.0192301251657936,10493,10456,Conecuh+Marengo+Monroe+Wilcox,Wilcox,1,131,Alabama,AL
01039,01CS015,463,447,479,591,112,128,144,410.4733936932571,90,288.63114009300335,0.6955527861587293,1.2332883550206044,1.737274076538909,0.6977152788840525,566,546,585,723,138,157,177,419.3981602137364,126,335.85670114084655,0.32124381040924005,0.8416464204902625,1.3581312484130494,0.7957488630893562,37418,37516,Convington+Escambia,Covington,1,39,Alabama,AL
01053,01CS015,407,391,423,515,92,108,124,352.8549301261288,58,189.87859773564315,1.122146521774597,1.6234410402452049,2.1869856878670855,0.533174097568574,498,479,517,658,141,160,179,436.38558403258037,108,294.3260478552352,0.8892291647299837,1.4329543076019051,1.9599146852546978,0.670277367245889,36655,36694,Convington+Escambia,Escambia,1,53,Alabama,AL
01043,01CS016,945,907,982,1043,61,98,136,134.90935392036107,121,165.8405098567741,-0.8525592293932928,-0.2948517925684947,0.1823777094797692,1.2169106761988944,1174,1128,1220,1308,88,134,180,149.79390803307982,187,209.44402132520943,-1.1333879209275246,-0.5989061790253136,-0.10133905725917769,1.3878375705085304,87554,89284,Cullman,Cullman,1,43,Alabama,AL
01045,01CS017,454,433,475,555,80,101,122,246.4719673688327,86,209.58995917869981,-0.18131992498879046,0.35557992461369914,0.8782898358385567,0.8420342724697651,557,532,583,736,153,179,204,362.16709690524675,96,194.635362812481,1.1731528997204064,1.661564049161883,2.1855338996482248,0.5344268978215955,49239,49323,Dale,Dale,1,45,Alabama,AL
01047,01CS018,436,419,452,560,108,124,141,392.87843272616794,100,315.9224936815501,0.26026161511695434,0.7673105129582072,1.2849531097588007,0.797708216803946,527,508,547,678,131,151,170,399.86372398125866,101,267.89029759694444,0.7732448065844303,1.316748639575584,1.8432822410680982,0.6655393299553857,37984,37702,Dallas+Lowndes,Dallas,1,47,Alabama,AL
01085,01CS018,134,129,138,156,18,22,27,262.1710369874765,39,459.7701149425287,-2.499303673241348,-1.98543310157053,-1.4358542858417709,1.6782380309326392,160,155,165,184,19,24,29,240.88596031155672,33,329.5715569759313,-1.4038373172730094,-0.9145378743667226,-0.40169389013110773,1.3136989111698305,10179,10013,Dallas+Lowndes,Lowndes,1,85,Alabama,AL
01049,01CS019,701,670,731,868,137,167,198,280.4181258930907,123,206.0560371906018,0.25180541420536007,0.7381784012104186,1.3087784705302516,0.730453293462556,859,822,896,1119,223,260,297,361.88526231757595,172,239.6010364137854,0.7010609726785005,1.2095998454132906,1.73267596340872,0.6595523100461835,71631,71786,DeKalb,DeKalb,1,49,Alabama,AL
01051,01CS020,728,691,766,850,84,122,159,167.19252950156022,93,127.85555530096465,-0.07557327420141889,0.39417491151975675,0.8836869223447645,0.7584836431126196,909,863,955,1087,132,178,224,200.16757907404528,157,176.14522444491814,-0.26602890751168146,0.24233975884046877,0.7623819334071977,0.8750839172511821,87286,89131,Elmore,Elmore,1,51,Alabama,AL
01057,01CS021,193,186,200,236,36,43,50,314.1227429500313,41,302.0999631585411,-0.37958746890806927,0.1117864495655207,0.614761292578772,0.9396839430005702,233,225,242,316,74,83,91,510.54514222416447,51,315.3793828458351,1.4366528287432234,1.965453979860936,2.4316100340197404,0.6103380133424046,16286,16171,Fayette+Lamar+Marion,Fayette,1,57,Alabama,AL
01075,01CS021,168,162,174,220,46,52,58,448.2513089053701,45,388.54511440495037,0.08761815829774251,0.5727615390977507,1.1285734451595837,0.8504209288325577,202,195,209,242,33,40,47,293.3072165306923,34,247.7050852396911,-0.06963846764460188,0.45667147361033084,0.9488772806800271,0.8240556674376812,13898,13726,Fayette+Lamar+Marion,Lamar,1,75,Alabama,AL
01093,01CS021,346,333,359,444,85,98,111,400.2622652718359,61,249.31030959435986,1.0002490167316005,1.5313413053556615,2.0272134680076617,0.6165716066635195,420,405,435,510,75,90,105,308.90209885425105,72,246.13701627239163,0.13822467759484197,0.6476756663668131,1.1492517725765246,0.7880907063725917,29361,29252,Fayette+Lamar+Marion,Marion,1,93,Alabama,AL
01059,01CS022,320,306,334,385,51,65,79,243.15335130066035,49,183.8189320995373,0.06840741021294466,0.5998802910195211,1.0621180246633541,0.7444932755865179,391,375,408,491,83,100,116,310.883605397552,57,178.01374141161773,0.8325652829456883,1.3326720471046196,1.8474988775461982,0.5669107308131409,31988,32020,Franklin+Lawrence,Franklin,1,59,Alabama,AL
01079,01CS022,349,335,363,461,98,112,126,406.48801459110354,59,214.31814741940363,1.416104862664947,1.9090584602320082,2.4513410037502124,0.5225735705973462,427,410,444,583,139,156,173,472.0652936383334,96,290.1529347760382,1.2953484196214526,1.8131135324019085,2.311329120064035,0.6107354969104112,33035,33086,Franklin+Lawrence,Lawrence,1,79,Alabama,AL
01063,01CS023,86,85,87,133,46,47,48,729.6304582246408,21,324.95164410058027,3.9230642628972956,4.046522921632668,4.172206147377172,0.4361156203531146,104,103,105,137,32,33,34,433.521810061593,23,301.0471204188481,1.2015372605047068,1.322774797904274,1.4412434063433324,0.6740703765055885,7755,7640,Greene+Hale+Pickens+Sumter,Greene,1,63,Alabama,AL
01065,01CS023,169,163,176,216,40,47,53,379.8892866356169,37,300.6093432633717,0.21340355427146981,0.7927481759782,1.3068436519627167,0.7747386667240116,208,200,215,262,47,54,62,369.00590517546283,40,271.00271002710025,0.45494295780227384,0.9734542173282581,1.4889868521029117,0.7211719846187257,14770,14760,Greene+Hale+Pickens+Sumter,Hale,1,65,Alabama,AL
01107,01CS023,208,200,216,277,61,69,77,431.3756815375389,37,231.69649846057504,1.4708930400385514,1.9858958139450638,2.523503170279014,0.5294253042759259,252,243,262,340,78,88,97,465.704041481175,48,254.7905939805722,1.5517842617376418,2.0936441334822127,2.5903681342443092,0.5409426877231389,19163,18839,Greene+Hale+Pickens+Sumter,Pickens,1,107,Alabama,AL
01119,01CS023,143,138,148,171,23,28,33,273.64645619916064,27,263.607517695875,-0.4091057779949494,0.10271646729293318,0.5912814171301556,0.9301287850505886,174,168,180,163,-17,-11,-5,-90.54176527618824,14,114.91422473939095,-2.586162087626554,-2.0468156945899865,-1.4939322358303748,-1.395714700364708,12291,12183,Greene+Hale+Pickens+Sumter,Sumter,1,119,Alabama,AL
01069,01CS024,983,937,1029,1210,181,227,273,254.64545100221574,171,191.63421399153896,0.11261990058933402,0.6359824912735772,1.112308767545097,0.7492556668589027,1208,1152,1263,1602,339,394,450,367.0935114202871,244,227.14789748554725,0.8720667101438074,1.4154972707706912,1.8895797548410802,0.6172087216173497,107079,107419,Houston,Houston,1,69,Alabama,AL
01071,01CS025,613,591,636,747,111,134,156,306.2946144944639,69,157.94895272976996,0.9848192656116974,1.4865148514997337,2.0161783052623705,0.5118512011537595,751,724,779,985,206,234,261,443.1372270109263,159,301.50182038834953,0.8909043075178144,1.4248532302670702,1.9623436812933457,0.6774812327271432,52422,52736,Jackson,Jackson,1,71,Alabama,AL
01073,01CS026,6243,5954,6532,7235,703,992,1281,177.4974438410455,747,133.6699437971867,-0.13381161233766695,0.42498345082650174,0.9358253479118388,0.7523225041568113,7614,7269,7959,9012,1053,1398,1743,209.09722600861704,1033,154.4961675079454,0.05899506863606821,0.5325725317957266,1.067296405395888,0.7383442774130914,670607,668625,Jefferson,Jefferson,1,73,Alabama,AL
01077,01CS027,962,922,1002,1121,119,159,199,204.17134661418874,130,166.72010259698624,-0.11366956181488753,0.3662220396931102,0.8603340759087199,0.8114724348778899,1180,1131,1228,1306,78,126,175,134.22347532734545,174,185.1457756969568,-1.0496456439286281,-0.5124577495392211,0.004737531471684002,1.368535397394988,93570,93980,Lauderdale,Lauderdale,1,77,Alabama,AL
01081,01CS028,1013,938,1088,1123,35,110,185,76.20765001391791,130,89.92598399778643,-0.6423593819177983,-0.12107273377856048,0.40926163014341443,1.169397909717234,1277,1186,1369,1442,73,165,256,93.05482527924468,189,106.87868985953085,-0.6853189684972029,-0.13035069368467897,0.3864245550169857,1.1416184939994507,173476,176836,Lee,Lee,1,81,Alabama,AL
01083,01CS029,768,723,813,925,112,157,202,181.59387142954725,91,105.10207027979095,0.2222865106613825,0.7543946685674502,1.3259895664266075,0.5751175806087722,971,916,1026,1149,123,178,233,166.0996488918772,122,113.964372121699,0.031396097558802884,0.5196038392730127,1.0706624894321783,0.682283368152951,103899,107051,Limestone,Limestone,1,83,Alabama,AL
01087,01CS030,221,213,229,289,60,68,76,424.75582589147405,38,237.37636647579382,1.3740483271503838,1.8895814681078789,2.379625899839345,0.5507539436859453,268,258,278,246,-32,-22,-12,-115.24164425768627,30,158.06111696522655,-3.25084312712265,-2.740655349079105,-2.2313448565908485,-1.4372728095608596,19210,18980,Macon+Tallapoosa,Macon,1,87,Alabama,AL
01123,01CS030,481,464,499,534,35,53,70,153.37820849727225,79,230.7860846702534,-1.2788545189284042,-0.7675490891340122,-0.26056349480489355,1.4765626816576776,591,570,613,729,116,138,159,335.0273904823289,99,241.15168197208487,0.4165743911942401,0.9391887461607997,1.4912998438412441,0.7146012802791333,41077,41053,Macon+Tallapoosa,Tallapoosa,1,123,Alabama,AL
01089,01CS031,2949,2781,3116,3158,42,209,377,64.79876023393327,217,67.15320937669236,-0.5460384238110984,-0.02248606243614477,0.4877936561235843,1.0314090491905572,3677,3474,3881,4090,209,413,616,104.598592308876,466,118.15206119566842,-0.637861541478339,-0.1414791464152107,0.36345668007735693,1.1268445642370744,387770,394407,Madison,Madison,1,89,Alabama,AL
01095,01CS032,988,946,1030,1227,197,239,281,293.6997520988139,147,180.83405092877354,0.6409351516820225,1.1301560463875395,1.6353610335488475,0.6131424494293509,1213,1163,1264,1424,160,211,261,214.58890458907624,152,154.8839389431209,0.10936269970053898,0.6124246283149477,1.0734618422597226,0.718359368275776,97548,98138,Marshall,Marshall,1,95,Alabama,AL
01097,01CS033,3742,3564,3921,4423,502,681,859,197.23863928825986,473,137.0948263368919,0.09634426023765348,0.5851903625103858,1.1125504006441185,0.6940509342648129,4582,4369,4796,5832,1036,1250,1463,302.39805708713004,844,204.23719585233943,0.4771190612546212,0.9829422613150929,1.4703090751200572,0.6748518568789492,414020,413245,Mobile,Mobile,1,97,Alabama,AL
01101,01CS034,1812,1713,1910,2377,467,565,664,297.61827572489017,337,177.37153283390938,0.6595539407640376,1.1831928649391286,1.708697019305134,0.5949178096428036,2217,2099,2334,2780,446,563,681,247.59622282982153,384,168.73039168299778,0.2528635713287721,0.7925300080111539,1.2909426832724724,0.6802667631184409,227996,227582,Montgomery,Montgomery,1,101,Alabama,AL
01103,01CS035,1203,1150,1256,1492,236,289,342,282.5293960004631,169,165.1062444028332,0.6756632341053028,1.1665170194904482,1.7134513221612908,0.5823722851116303,1481,1417,1545,1693,148,212,276,171.35279859060367,214,173.11114706358194,-0.5393530915414377,0.010359604099307092,0.4644019936336914,1.0055146860090292,122830,123620,Morgan,Morgan,1,103,Alabama,AL
01113,01CS036,546,521,572,637,65,91,116,184.77009574928053,70,142.35116677117048,-0.06602615703863861,0.4011815408514977,0.9597816768156944,0.7620361860128801,664,634,695,854,159,190,220,322.78302681724756,124,210.898700591877,0.5972868065607108,1.1142289714645746,1.658029098242274,0.6499513559063345,59009,58796,Russell,Russell,1,113,Alabama,AL
01115,01CS037,835,795,874,1035,161,200,240,263.30426847496864,136,178.85519523929557,0.36341699898261226,0.834633179492479,1.3287845613594451,0.6758960553114453,1035,987,1083,1312,229,277,325,299.0754295729017,219,236.64930518035055,0.13607089128051975,0.6397238584189529,1.120211139646965,0.7884209857740831,91247,92542,St. Clair,St. Clair,1,115,Alabama,AL
01117,01CS038,1347,1251,1444,1592,148,245,341,131.4330848581297,148,79.55777345744823,0.0164594797100703,0.5027728900322453,1.0380826472924978,0.6028445041715498,1692,1575,1809,1935,126,243,360,107.2171061930564,225,99.36582522213783,-0.4470415269856811,0.07592392634269392,0.5725211480887423,0.9229704205098154,223234,226436,Shelby,Shelby,1,117,Alabama,AL
01125,01CS039,1620,1523,1717,1887,170,267,364,142.45489735493507,252,134.58962182274584,-0.4015604049370185,0.07902767606960737,0.6131381375911676,0.9412586819788755,2003,1886,2120,2344,224,341,458,150.09209944634603,362,159.4516975879627,-0.5879357331872302,-0.08699215533003563,0.448944526859324,1.0592504573379244,224683,227028,Tuscaloosa,Tuscaloosa,1,125,Alabama,AL
01127,01CS040,877,849,905,1111,206,234,262,432.59134452606503,165,305.2540700542674,0.7535124598305919,1.2798863057826015,1.7944327919826215,0.702635825453851,1065,1032,1099,1294,195,229,262,352.87997945730547,201,309.9030203980943,-0.08657317418376358,0.4408278516729004,0.9467964120201466,0.874390438317995,64864,64859,Walker+Winston,Walker,1,127,Alabama,AL
01133,01CS040,264,254,274,327,53,63,73,321.6602115150268,37,188.6311496303849,0.8282363217498148,1.319668880445629,1.8171885128886727,0.5772802721938758,323,311,335,424,89,101,113,427.14737200315494,71,300.47822590884084,0.7911107355973184,1.2643009367880684,1.7807608271010058,0.696552001162435,23538,23629,Walker+Winston,Winston,1,133,Alabama,AL
02020,02CS001,1470,1345,1595,1748,153,278,403,115.00520233771599,117,48.39610349320593,0.11984069210154516,0.6767767183101594,1.1577102923946723,0.4193085090096149,1823,1674,1972,2370,398,547,696,189.7310287547782,278,96.36449349712987,0.4591889470122223,0.9322304286745303,1.4609266892716355,0.5069743159723356,290106,288488,Anchorage,Anchorage,2,20,Alaska,AK
02090,02CS002,396,355,437,473,36,77,118,97.06920228075009,19,23.85411326518869,0.2700514206488082,0.7358401081824465,1.2394375872216372,0.24260554723250496,495,446,545,684,139,189,238,197.40845540644264,90,94.19349436932222,0.517156613135226,1.003489165759522,1.5968958694546047,0.4746339005724008,95581,95548,Fairbanks North Star,Fairbanks North Star,2,90,Alaska,AK
02122,02CS003,392,366,417,393,-24,1,27,2.721277385875899,18,36.61823791682913,-0.8554540698807966,-0.3665796399886619,0.19821173518231006,7.699986038295857,488,457,519,589,70,101,132,169.37111903601922,66,110.66398390342052,0.038719779283593526,0.5884751975376729,1.0798202740320995,0.646976775500922,58987,59640,Kenai Peninsula,Kenai Peninsula,2,122,Alaska,AK
02170,02CS004,535,488,581,639,58,104,151,115.90419586264402,33,36.680591706110654,0.2765474909376739,0.7872642015919931,1.2956488743876384,0.31346718972679205,679,622,736,991,255,312,369,282.98768049936336,165,149.7060317921173,0.8607228389906805,1.3327918126712992,1.8541627051985663,0.5273288968804029,107959,110216,Matanuska-Susitna,Matanuska-Susitna,2,170,Alaska,AK
02140,02CS005,48,47,49,52,3,4,5,64.69438412397811,4,61.98347107438016,-0.09748005092665082,0.02867083860208577,0.1423838049991853,0.7729551860918993,58,57,59,69,10,11,12,148.48331617589199,7,92.1901751613328,0.4452883069225084,0.5657475470580638,0.681882169382536,0.5702955130873446,7744,7593,Northern Alaska,Northern Alaska,2,140,Alaska,AK
02180,02CS005,63,62,64,66,2,3,4,30.57285615595256,8,95.84664536741214,-0.7754966764678164,-0.6537809123707614,-0.5357938448585906,2.252369947575741,77,76,78,94,16,17,18,170.84666618969067,2,20.224491859642026,1.3754441136441928,1.507101865418543,1.6290738522794963,0.1117628948072204,10016,9889,Northern Alaska,Nome,2,180,Alaska,AK
02185,02CS005,55,54,56,45,-11,-10,-9,-108.45723051047953,8,89.19446251045247,-2.0959356048386257,-1.9753546406695874,-1.8515051034420569,-0.9166207646677272,69,67,70,59,-11,-10,-8,-90.03310225781905,6,54.66970387243736,-1.5711371203238853,-1.4465460021004215,-1.3223462382465097,-0.6755894792228626,10763,10975,Northern Alaska,North Slope,2,185,Alaska,AK
02240,02CS005,91,90,92,108,16,17,18,146.7256323836513,6,52.07203297895422,0.8321459577473588,0.944892939117721,1.0758959763238463,0.3350745858089746,112,110,114,146,32,34,36,245.66723338858247,10,72.33796296296296,1.611697356499619,1.7313609765586118,1.8562930304057614,0.28603269450147334,13827,13824,Northern Alaska,Southeast Fairbanks,2,240,Alaska,AK
02261,02CS005,53,52,54,3,-51,-50,-49,-627.0310208921522,3,37.367656217562796,-6.763025172793889,-6.6427681474466755,-6.530476245271652,-0.06080242115228873,65,64,67,4,-63,-61,-60,-640.9007035803633,4,41.71881518564873,-6.946190569947064,-6.827872193969086,-6.7030431236503505,-0.06617087098366915,9634,9588,Northern Alaska,Valdez-Cordova,2,261,Alaska,AK
02100,02CS006,10,10,10,19,9,9,9,501.88842125766456,7,390.15327450069674,0.9988164467672704,1.1224856046442286,1.2397225615031566,0.699670122464755,12,12,12,21,9,9,9,441.44368878119957,5,241.196333815726,1.8871677802098004,1.999069911244364,2.12540434696234,0.49255611428746926,2153,2073,Southeast Alaska,Haines,2,100,Alaska,AK
02110,02CS006,166,152,180,171,-9,5,19,17.83116400147424,4,14.930479952720148,-0.47501861040951526,0.03474746526355305,0.5230999414922833,0.6923868259802357,205,188,221,218,-3,13,30,41.95610833175011,13,40.61865333541634,-0.48242805357456037,0.014956076171919977,0.5143379370496974,0.9010225063715359,32149,32005,Southeast Alaska,Juneau,2,110,Alaska,AK
02195,02CS006,192,181,203,231,28,39,50,184.82613652750882,8,38.03185167577846,0.9443268536989515,1.4638386702352333,1.972887069718547,0.20061097165468686,233,220,246,348,102,115,128,461.7180073428608,16,64.17455478902615,3.4414430484341874,3.972894640003049,4.493777567144077,0.13779379472513953,25242,24932,Southeast Alaska,Petersburg,2,195,Alaska,AK
02220,02CS006,51,50,52,56,4,5,6,70.17203993214129,3,42.67425320056899,0.15731794215951686,0.2713156779446401,0.39329209047335556,0.505638338797453,62,61,64,76,12,14,15,160.5440681646626,1,11.890606420927467,1.3574149959705966,1.4833754792378888,1.6041769983886232,0.06895716566000429,8436,8410,Southeast Alaska,Sitka,2,220,Alaska,AK
02232,02CS006,32,30,34,20,-14,-12,-10,-350.3459654394731,2,56.91249703580745,-4.584617475152338,-4.096744370317791,-3.5266405265552216,-0.17680744069769264,39,37,41,44,3,5,7,117.25427556945013,6,143.36917562724014,-0.7709214751481863,-0.24410660107652124,0.24862064665178163,1.0157283103671055,4217,4185,Southeast Alaska,Southeast Alaska,2,232,Alaska,AK
02010,02CS007,35,34,36,18,-18,-17,-16,-236.49800795748828,7,96.88581314878893,-3.4515387997236635,-3.3329455031490505,-3.2097989066567134,-0.43513447099838143,43,42,44,28,-16,-15,-14,-172.42801944298998,7,82.53743662303974,-2.672558149255268,-2.547853373340361,-2.4290464830318013,-0.51381349677809,8670,8481,Southwest Alaska,Southwest Alaska,2,10,Alaska,AK
02050,02CS007,108,106,110,115,5,7,9,45.90473382123981,15,96.69101847872797,-0.6310087272672946,-0.5111464856283462,-0.3912665756307958,1.8469825733751408,133,130,135,146,11,13,16,71.04488103748577,22,118.47065158858373,-0.5953200155262954,-0.47374679876195935,-0.355197622699395,1.5500561308140561,18616,18570,Southwest Alaska,Bethel,2,50,Alaska,AK
02060,02CS007,7,7,7,5,-2,-2,-2,-343.96873976205865,5,720.2881152460984,-10.76499196434841,-10.64468490022616,-10.527284454591696,-3.60304182723741,9,9,9,15,6,6,6,703.1588379684333,4,477.89725209080046,2.1333277245919993,2.2499214256876763,2.3762267743885186,0.5809360484865159,833,837,Southwest Alaska,Bristol Bay,2,60,Alaska,AK
02070,02CS007,44,43,45,53,8,9,10,171.10856359326755,3,57.01615457713018,1.0207226764117177,1.1360483161198316,1.2573699292665341,0.2999051623581022,53,52,54,65,11,12,13,190.0410105102935,11,177.33354828308885,0.00476796556882195,0.12825810223746342,0.2598751338490294,0.8601650157394138,6314,6203,Southwest Alaska,Dillingham,2,70,Alaska,AK
02150,02CS007,54,53,55,66,11,12,13,110.43472018805423,1,9.212344541685859,0.8833831977049693,1.012469977194563,1.1292379706697921,0.07699599286029113,66,64,68,104,36,38,40,296.4825504794114,6,46.798221667576634,2.367597183850395,2.498159581603243,2.620018877185164,0.1537987215436858,13026,12821,Southwest Alaska,Kodiak Island,2,150,Alaska,AK
02158,02CS007,53,52,54,52,-2,-1,-0,-18.103748979467714,4,57.40940078937926,-0.8736670552867121,-0.7576843356480466,-0.6231532671050387,-15.303465220216207,66,65,67,84,17,18,19,219.72121584452566,10,119.61722488038276,0.8678712944546828,0.9944721456997215,1.1295079367109084,0.5162970814392943,8361,8360,Southwest Alaska,Southwest Alaska,2,158,Alaska,AK
04001,04CS001,564,557,571,1042,471,478,485,858.9313548331374,300,539.3500831498045,3.071578221254213,3.196041731048264,3.3200035488731823,0.6266199524673407,682,674,690,1194,504,512,520,779.8710753304491,270,411.1904725644579,3.561918369945765,3.687686565308532,3.815502257990764,0.5262268087319549,66747,65663,Apache,Apache,4,1,Arizona,AZ
04003,04CS002,1150,1096,1204,1387,183,237,291,225.96593374031116,171,163.1990837946173,0.10418351317495153,0.6058451279581148,1.1416844782950772,0.7191911586410206,1417,1352,1482,1833,351,416,481,330.26095903445196,311,246.91358024691357,0.321844768786823,0.8364726586541326,1.3367301253743222,0.7458387874255558,125736,125955,Cochise+Graham+Greenee,Cochise,4,3,Arizona,AZ
04009,04CS002,256,240,273,322,49,66,82,203.41644182744045,50,155.0387596899225,-0.008146007338054564,0.48666242427394074,0.9889501947165986,0.7507304326785392,320,300,340,489,149,169,189,432.75075841009743,88,225.72205407069205,1.5709892717631722,2.058576511215067,2.5842421074872926,0.5185248583507244,38700,38986,Cochise+Graham+Greenee,Graham,4,9,Arizona,AZ
04011,04CS002,56,55,57,62,5,6,7,79.33955306941694,5,63.14460113660282,0.03782500514480525,0.16074954061685118,0.2941896996001701,0.6865896417880715,68,67,69,96,27,28,29,294.88336917265,25,265.36461097548033,0.1749410391545824,0.2950207113807888,0.4258330963243465,0.8686297496866247,9502,9421,Cochise+Graham+Greenee,Greenlee,4,11,Arizona,AZ
04005,04CS003,747,685,810,1027,217,280,342,231.69362139683568,207,171.37889638614064,0.08815467117789781,0.5964584549836515,1.1358545505361675,0.7370452530643131,929,854,1004,1194,190,265,340,182.86666156523026,184,126.84319010623118,0.03787430239587376,0.5619717829192064,1.0869740936362202,0.6910325548373516,144942,145061,Coconino,Coconino,4,5,Arizona,AZ
04007,04CS004,659,636,682,834,152,175,198,392.65250394256014,118,264.93039964077235,0.7460977739307957,1.293589926255883,1.7431589768765399,0.6708836622529601,804,776,831,1054,223,250,278,467.27638909587046,157,293.194890565474,1.2284429009987567,1.7387165623358318,2.2597854327415634,0.6249573057802864,53448,53548,Gila,Gila,4,7,Arizona,AZ
04025,04CS005,2665,2563,2768,3143,375,478,580,241.38172027691363,252,127.34722754473366,0.6229677774483554,1.1265730332900667,1.6758250101361343,0.5264739013564554,3304,3179,3428,4118,690,814,939,337.2092326440353,595,246.37987221373348,0.39468310660531636,0.9120350240632396,1.4505481557092978,0.729747799396492,237461,241497,La Paz+Yavapai,Yavapai,4,25,Arizona,AZ
04013,04CS006,27383,25469,29296,34979,5683,7596,9510,204.73721097539828,4403,118.67199488261272,0.3541626248471365,0.8544131916873757,1.3737822944921596,0.5795545121292061,34149,31832,36466,44161,7695,10012,12329,223.08415397089297,6755,150.50932533944254,0.2051551201954656,0.7490671943994841,1.2305017301230585,0.6746077281105719,4452272,4488094,Maricopa,Maricopa,4,13,Arizona,AZ
04015,04CS007,2859,2767,2951,3445,494,586,678,327.9086290279523,326,182.44992188046547,0.9855289181066957,1.4485741431489254,1.9486490528889187,0.5554567264994196,3529,3417,3641,4621,980,1092,1204,502.9444204459216,767,353.1892947265661,0.9794586831385901,1.4976255123132935,2.02543850123037,0.7016008254503172,214415,217164,Mohave,Mohave,4,15,Arizona,AZ
04017,04CS008,901,890,912,1519,607,618,629,689.309704713326,365,407.21457791000364,2.6973798721526863,2.8231944344964943,2.933344403333762,0.5898024621610566,1113,1100,1127,1845,718,732,745,677.7677205437312,366,339.0427138238646,3.2590724672294624,3.3906317970381834,3.5193935375536842,0.4995516101153319,107560,107951,Navajo,Navajo,4,17,Arizona,AZ
04019,04CS009,8313,7863,8763,10505,1742,2192,2642,251.3106818242982,1182,135.49827426937065,0.67678797045911,1.1533190402642883,1.7269346541734814,0.5389205674100641,10256,9713,10799,12824,2025,2568,3111,244.3114806253039,1745,166.01781766010967,0.2835446201949397,0.7886641153044017,1.3139691547460133,0.6792689077422881,1046803,1051092,Pima+Santa Cruz,Pima,4,19,Arizona,AZ
04023,04CS009,264,243,284,413,129,149,170,376.87399896808284,103,259.98064868957977,0.6548428597581907,1.1702990697380176,1.6467406951341033,0.68524502463939585,329,304,354,427,73,98,123,204.8837314502632,79,165.10271897009343,-0.07164354381870314,0.38434765852826785,0.9223103664757758,0.7976992603511586,47542,47849,Pima+Santa Cruz,Santa Cruz,4,23,Arizona,AZ
04021,04CS010,2671,2485,2858,3650,792,979,1165,269.1145220980585,389,106.98103997121504,1.1211647660128692,1.6132335738007566,2.1011762230040985,0.3971239600260413,3386,3155,3616,4938,1322,1552,1783,347.58965346743844,880,197.0249236528421,1.0212733126772973,1.4966630068603048,2.0359091797966347,0.5664670805487196,436339,446644,Pinal,Pinal,4,21,Arizona,AZ
04027,04CS011,1530,1434,1626,2445,819,915,1011,491.62053131785416,576,309.44450413667136,1.3249268903501064,1.8226158061343898,2.3523304886181817,0.6287506332963693,1895,1779,2010,2633,623,738,854,331.0557404559687,468,209.81748568712987,0.7018651331548142,1.1909723859973012,1.7094684198687582,0.6329258240755644,223368,223051,Yuma,Yuma,4,27,Arizona,AZ
05001,05CS001,205,197,212,259,47,54,62,380.399767858328,22,154.16058394160584,1.7327542885587963,2.2571183141119,2.7839538306150446,0.3979291990832768,247,239,256,336,80,89,97,529.0820864026956,30,178.80557873405652,3.0135503193375723,3.4970714846853905,4.031326599312083,0.3341896294384417,17125,16778,Arkansas (county)+Monroe+Phillips+Prairie,Arkansas (county),5,1,Arkansas,AR
05095,05CS001,98,97,99,116,17,18,19,316.84058213120454,11,195.55555555555554,1.09731611150195,1.2124144786414395,1.3373487298202804,0.5844137052394481,119,119,120,136,16,17,17,247.489149533149,20,298.7303958177745,-0.6478001993517624,-0.5112032994154596,-0.38819027445916976,1.138342893769696,6750,6695,Arkansas (county)+Monroe+Phillips+Prairie,Monroe,5,95,Arkansas,AR
05107,05CS001,197,190,204,266,62,69,76,498.49645490874116,38,274.9969846821855,1.727348281680526,2.226077403920013,2.7452249154957467,0.5437589920485332,235,227,243,311,68,76,84,474.7888217238418,52,325.30497341257427,0.9569732994741683,1.492633672980932,1.9632071630078878,0.6762468903122782,16582,15985,Arkansas (county)+Monroe+Phillips+Prairie,Phillips,5,107,Arkansas,AR
05117,05CS001,93,93,94,127,33,34,34,490.851418421308,14,204.52885317750182,2.742071138036088,2.859193831213478,2.9779148636101507,0.4046385498425678,114,113,115,145,30,31,32,380.846184585931,20,245.36866642129797,1.233852454891545,1.3569237028329157,1.4830109421595314,0.6241657146398661,8214,8151,Arkansas (county)+Monroe+Phillips+Prairie,Prairie,5,117,Arkansas,AR
05005,05CS002,581,563,599,708,109,127,145,364.35855064869577,75,215.55337341029386,0.9884740108815997,1.4898779408523655,1.9948815972609872,0.5869668868635485,711,689,732,928,196,217,239,516.5279644167106,125,297.10265490932426,1.6989117022919038,2.184538169587173,2.7135658541936802,0.5725571687178318,41753,42073,Baxter+Marion,Baxter,5,5,Arkansas,AR
05089,05CS002,224,217,231,268,37,44,51,314.3305035209332,23,163.8760242251514,0.9735981947497678,1.4891187102765244,1.9988110241952552,0.5097937342130018,273,265,282,305,23,32,40,186.2045210266762,43,253.52278757148753,-1.1798575324252722,-0.6775551813747449,-0.1515951505033929,1.3197410719897433,16842,16961,Baxter+Marion,Marion,5,89,Arkansas,AR
05007,05CS003,1706,1583,1830,1959,129,253,376,105.99603408028707,282,118.2526287098093,-0.6410709912175374,-0.09878687549454612,0.370846570471606,1.1112363665739555,2150,1999,2301,2520,219,370,521,126.47457814055554,372,127.12646349215028,-0.5572764063024849,-0.01835218103588867,0.49284007086196857,1.0024456438763074,286167,292622,Benton,Benton,5,7,Arkansas,AR
05009,05CS004,385,369,401,478,77,93,109,298.5392463891645,63,201.9230769230769,0.4563941946090053,0.9531382337031701,1.4683334497751008,0.6691858868771638,473,454,493,582,89,109,128,287.6538762256519,68,180.08474576271186,0.5380095001044348,1.0558503192658693,1.5666895226556423,0.6203354895572113,37440,37760,Boone+Carroll+Madison,Boone,5,9,Arkansas,AR
05015,05CS004,280,268,292,314,22,34,46,145.54973876294636,38,161.4273576890399,-0.6665724809752775,-0.14534561232462326,0.3095727358540829,1.0776348415006867,343,329,358,394,36,51,65,178.76278367223057,40,140.8401112636879,-0.09939464003161064,0.38573578515104207,0.8987391892750108,0.7726420105902637,28248,28401,Boone+Carroll+Madison,Carroll,5,15,Arkansas,AR
05087,05CS004,169,162,176,154,-22,-15,-8,-109.20158810937656,10,72.33709084332992,-2.3339192157720112,-1.813786897791292,-1.295737671344096,-0.7094105666899645,210,201,219,260,41,50,59,296.16824450533454,32,189.3491124260355,0.5772768527153769,1.0811794673565918,1.5886660865875872,0.6268065578489356,16589,16900,Boone+Carroll+Madison,Madison,5,87,Arkansas,AR
05011,05CS005,132,128,137,167,30,35,39,393.1800708766044,27,307.63387770603873,0.3157980466363031,0.8494356477051538,1.3676674141863299,0.7603897924894973,160,155,166,165,-1,5,10,45.502551771981345,18,172.7281450916419,-1.743579609663507,-1.275797459565207,-0.7964843827971204,3.134894008415737,10532,10421,Bradley+Calhoun+Cleveland+Union,Bradley,5,11,Arkansas,AR
05013,05CS005,59,59,60,69,9,10,10,241.90944457151755,4,100.27156883225402,1.303131876973149,1.415779711080506,1.5434098357210562,0.3755808266041666,72,72,73,89,16,17,17,356.34284940949215,5,105.50749103186325,2.3819371688447672,2.5067658450870334,2.6442610539755504,0.2795312519535756,4787,4739,Bradley+Calhoun+Cleveland+Union,Calhoun,5,13,Arkansas,AR
05025,05CS005,87,86,87,110,23,23,24,368.834491967213,20,315.872598052119,0.40867631785914144,0.5296871331802895,0.654792491814337,0.8212415579925513,105,104,106,135,29,30,31,394.8691079772736,11,146.31550944400107,2.36392202424405,2.4870453968632877,2.612139490478348,0.3584666285727832,7598,7518,Bradley+Calhoun+Cleveland+Union,Cleveland,5,25,Arkansas,AR
05139,05CS005,439,422,456,539,83,100,117,308.82716102789885,70,216.33872463170908,0.4281201583410029,0.9175192608507216,1.4263635276791444,0.6935762695009516,531,511,551,617,66,86,106,223.45791813281838,70,182.17306441119064,-0.12993224772675283,0.3943376944600405,0.9519317648907974,0.8058601687059327,38828,38425,Bradley+Calhoun+Cleveland+Union,Union,5,139,Arkansas,AR
05019,05CS006,202,193,211,243,32,41,50,228.18775186468497,18,100.44642857142856,0.7662686436893745,1.2979940989811345,1.7699837402036578,0.4296840531322767,247,236,258,291,33,44,55,207.38154896487944,35,164.11122051859147,-0.08383297799205662,0.42278737498962626,0.9585344557615529,0.7738524037600483,21504,21327,Clark+Dallas+Ouachita,Clark,5,19,Arkansas,AR
05039,05CS006,83,82,83,105,22,22,23,409.83316413973495,14,258.26287471176016,1.3941840903337093,1.5169073667008857,1.6356712053869247,0.6030227088891988,99,98,99,120,21,21,22,337.61616207454443,5,79.01390644753477,2.4623211043081765,2.586458385774033,2.7150254627470694,0.2235700941648274,6505,6328,Clark+Dallas+Ouachita,Dallas,5,39,Arkansas,AR
05103,05CS006,280,271,290,341,51,61,70,321.31692196924604,38,201.09366731345912,0.711188602864624,1.1987810503731855,1.684748037648601,0.6157018121145087,338,327,350,393,43,55,66,245.70841912449868,46,205.8349740468946,-0.15981659514360644,0.38830035668998164,0.9164204329412734,0.8227373481236558,22676,22348,Clark+Dallas+Ouachita,Ouachita,5,103,Arkansas,AR
05021,05CS007,198,192,204,216,12,18,24,146.8405970138394,27,223.6024844720497,-1.2467606413755496,-0.75111845369972,-0.21167360472020205,1.4414605193626586,239,232,246,280,34,41,48,285.45113102950705,41,285.2570792458081,-0.5050132629249082,-0.008867665859834022,0.5652864020125955,0.9755426447324376,14490,14373,Clay+Greene,Clay,5,21,Arkansas,AR
05055,05CS007,432,412,452,495,43,63,83,164.67571931776052,56,146.73450225997334,-0.3467865142942794,0.1764830366357355,0.6654129837501865,0.8770952162909746,532,509,556,612,56,80,103,171.9299745461334,73,157.858316754606,-0.33936978950841296,0.13087118771231937,0.6892661142166409,0.9067501000673381,45797,46244,Clay+Greene,Greene,5,55,Arkansas,AR
05027,05CS008,235,226,245,319,74,84,93,438.73698760103485,30,157.59061460339692,2.2789961556934646,2.8197448684422572,3.31444738087855,0.3549418043935525,285,274,297,306,9,21,32,91.58426059518334,24,105.81077506392734,-0.6830629459419849,-0.16256249382616278,0.3677921181103529,1.1022754553755916,22844,22682,Columbia+Lafayette+Miller,Columbia,5,27,Arkansas,AR
05073,05CS008,77,76,77,105,28,28,29,539.9848548936669,5,94.74182851729039,4.334941106727379,4.451130202352716,4.572543008234595,0.1695047369273826,92,91,92,105,13,13,14,216.38477698226436,13,210.28793270786153,-0.057947037985326404,0.06011422704758773,0.20218238590987067,0.9042278759004573,6333,6182,Columbia+Lafayette+Miller,Lafayette,5,73,Arkansas,AR
05091,05CS008,415,396,433,503,70,88,107,248.37181610566583,61,171.4486473825975,0.22757493546241706,0.762063506329107,1.2916431831745234,0.6825661888731155,505,483,527,656,129,151,173,353.98764260888373,102,239.2288388019795,0.6533804706781251,1.153062613400366,1.6620991322085632,0.6713630876302099,42695,42637,Columbia+Lafayette+Miller,Miller,5,91,Arkansas,AR
05029,05CS009,234,225,243,229,-14,-5,4,-30.27643919502612,11,63.55320173326914,-1.382434563002508,-0.9535285457056832,-0.42072595638752863,-2.594127309632951,287,276,298,301,3,14,25,66.43519889513644,27,129.48398235181278,-1.1753126286449296,-0.6208098947102253,-0.12775964719584718,1.8178063005775507,20770,20852,Conway+Pope,Conway,5,29,Arkansas,AR
05115,05CS009,515,488,543,642,99,127,154,239.56137742834446,56,105.81177470909635,0.8226557333798763,1.3243484971893738,1.8443012793162572,0.43823314124643353,636,603,668,753,85,117,150,184.3478494790222,93,145.94187433306132,-0.11895058944679371,0.36444317487000877,0.9031131692343692,0.7849835277741517,63509,63724,Conway+Pope,Pope,5,115,Arkansas,AR
05031,05CS010,834,786,882,1005,123,171,219,184.15690115659444,99,106.52224593368362,0.2708685992786986,0.7955403199314417,1.2735754663951633,0.57507200641783,1030,973,1088,1190,102,160,217,142.34307249905598,104,92.7544504298812,7.436204872573055e-4,0.5065796703783876,1.0166134601058188,0.6475685960122087,111526,112124,Craighead,Craighead,5,31,Arkansas,AR
05033,05CS011,521,495,547,663,116,142,168,280.4481540564711,56,110.86181866173948,1.1861949212214693,1.7094708417330375,2.187319162161955,0.3925314969891423,637,606,668,874,206,237,268,392.86934814691756,123,203.8516357850774,1.3700843871862671,1.8938318213823586,2.379191463914136,0.5166992421152086,60616,60338,Crawford,Crawford,5,33,Arkansas,AR
05035,05CS012,435,414,456,555,99,120,141,299.9947020207922,68,170.03542404667638,0.7957220092223467,1.3040040988277226,1.799028014912168,0.5621094521141192,531,506,555,687,132,156,181,328.4331055009015,87,182.75775144945803,0.9175110620068189,1.4683631554407188,1.9662302475258855,0.5529170342582632,47990,47604,Crittenden,Crittenden,5,35,Arkansas,AR
05037,05CS013,200,193,208,223,15,23,30,162.25493711162855,29,208.49559642921335,-0.9626909131391362,-0.451844826350389,0.03207579067470009,1.2304658440948433,245,236,254,266,12,21,30,125.65488645445676,29,173.7255136883724,-1.0070004483745674,-0.4608136343572588,0.023408013476210195,1.3196472146823512,16691,16693,Cross+Lee+St. Francis,Cross,5,37,Arkansas,AR
05077,05CS013,93,93,94,144,50,51,51,706.6353692435196,17,237.45780467931553,4.559679634689814,4.689086511582723,4.817070801560518,0.3295263106344774,115,114,116,155,39,40,41,465.21908862569035,27,313.73460376481523,1.3950430412132588,1.5167609368314638,1.6347455746832118,0.6579467639002669,8591,8606,Cross+Lee+St. Francis,Lee,5,77,Arkansas,AR
05123,05CS013,211,201,221,271,50,60,70,310.09089153151535,32,164.83516483516485,0.8863740766164775,1.4412043513141972,1.9677838595668424,0.522884545326457,255,244,267,337,70,82,93,358.45458639277786,46,201.89606741573036,1.1134412033682213,1.562063462347431,2.100756051043882,0.5564272043910784,23296,22784,Cross+Lee+St. Francis,St. Francis,5,123,Arkansas,AR
05045,05CS014,852,799,906,954,48,102,155,98.13721004897577,70,67.67044493317543,-0.2381363690205523,0.30573263343739304,0.8245763718490943,0.6828230168211072,1060,996,1125,1189,64,129,193,103.16911329096847,117,93.67794004611838,-0.3858321201192728,0.0837490556182399,0.6276350675147233,0.9010112414010251,124131,124896,Faulkner,Faulkner,5,45,Arkansas,AR
05047,05CS015,190,182,197,242,45,52,60,365.6183529145328,22,153.33681826102108,1.6362152068891869,2.108883172552123,2.627806531094609,0.4115450109512299,231,222,240,275,35,44,53,256.0891868633336,31,180.58953745776535,0.24586260151818343,0.7554046440295391,1.2831626828264937,0.6894976415000567,17217,17166,Franklin+Johnson+Logan,Franklin,5,47,Arkansas,AR
05071,05CS015,229,218,240,272,32,43,54,199.94019871214573,20,92.87925696594428,0.5767277070971194,1.0475879444045713,1.587636280989932,0.45399045682480044,281,267,294,354,60,73,87,283.49604814104066,46,178.13577043720716,0.5484682485743774,1.0462105057144766,1.5728368749200343,0.6198860703695818,25840,25823,Franklin+Johnson+Logan,Johnson,5,71,Arkansas,AR
05083,05CS015,240,231,249,285,36,45,54,256.4559657344467,12,68.03042471772098,1.397141364616655,1.8948408124355083,2.416585031549557,0.2595341198641344,293,282,304,375,71,82,93,386.35888179680495,37,174.54476837437494,1.5956304414579832,2.1223821471583784,2.643141470894497,0.4463189531496056,21167,21198,Franklin+Johnson+Logan,Logan,5,83,Arkansas,AR
05051,05CS016,1217,1174,1260,1365,105,148,191,177.13491283986895,137,164.27022652104836,-0.39819306325933856,0.12751750739521292,0.6627007096481358,0.9211381913660526,1487,1435,1539,1705,166,218,270,217.48144404810355,229,228.30139772296775,-0.6099965808542757,-0.11623132096910987,0.3662568958721738,1.044960987618593,100079,100306,Garland,Garland,5,51,Arkansas,AR
05053,05CS017,177,169,184,201,17,24,32,162.0840826488735,14,93.16770186335403,0.17611467619730228,0.6911437883382161,1.2003817660440486,0.5521411580306015,217,208,226,306,80,89,98,492.5728668268057,39,215.7915122005201,2.2545382492988635,2.7632121952131437,3.2597059802115504,0.4332240924048976,18032,18073,Grant+Hot Spring,Grant,5,53,Arkansas,AR
05059,05CS017,361,346,375,441,66,80,95,291.1641773359054,51,184.58754335695974,0.5753593660821487,1.0581848552980821,1.5831438000428855,0.6261799514786295,441,424,458,526,68,85,102,256.96535025949385,53,159.97102411638645,0.450058308778028,0.9793561613020401,1.491894855340247,0.6153118125163307,33155,33131,Grant+Hot Spring,Hot Spring,5,59,Arkansas,AR
05057,05CS018,192,183,200,226,26,34,43,203.02974132843252,20,118.85895404120443,0.3422858034912488,0.8460432313845208,1.3758025311454702,0.5687774540904761,231,221,242,280,38,49,59,246.02003378334766,29,146.92471375012667,0.49725740999195744,0.9928821162999545,1.4862108801124119,0.5851559935709966,20192,19738,Hempstead+Howard+Nevada+Pike,Hempstead,5,57,Arkansas,AR
05061,05CS018,154,149,160,171,11,17,22,158.65396858945965,18,168.5261761722712,-0.592499575698453,-0.12207399618921884,0.4126970458728951,1.0030332862366556,187,181,194,164,-30,-23,-17,-181.6306018813758,14,110.18416496143554,-3.462402517622475,-2.9051304919736367,-2.3810646587060584,-0.634115860650499,12817,12706,Hempstead+Howard+Nevada+Pike,Howard,5,61,Arkansas,AR
05099,05CS018,99,98,100,118,18,19,20,278.61354316399644,22,319.5352214960058,-0.5252947606675535,-0.4110764876041108,-0.2922695437889213,1.0900509714247277,120,119,121,115,-6,-5,-4,-64.83607789407164,18,219.48542860626753,-2.9681349165163087,-2.845120930308061,-2.718462922966344,-4.16936251847372,8262,8201,Hempstead+Howard+Nevada+Pike,Nevada,5,99,Arkansas,AR
05109,05CS018,127,122,131,129,-2,2,7,29.090451943787446,18,211.08179419525067,-2.359440343698662,-1.8093949959547961,-1.3261759884135014,5.171390972948116,153,148,158,177,19,24,29,240.52394756799524,27,267.85714285714283,-0.7948875601034614,-0.27306623164581284,0.24627038433615647,1.0695266002382111,10233,10080,Hempstead+Howard+Nevada+Pike,Pike,5,109,Arkansas,AR
05063,05CS019,351,335,368,452,84,101,117,319.1350915172259,72,228.18508345658145,0.4135077535523286,0.8945853812184478,1.4040483718125665,0.7079802009331939,427,407,446,545,99,118,138,313.8128307738025,76,201.33517007523577,0.609583729181549,1.1088560526387645,1.5960535281070223,0.6362065089388292,37864,37748,Independence+Jackson+Woodruff,Independence,5,63,Arkansas,AR
05067,05CS019,188,181,195,239,44,51,58,365.69071479164376,22,157.60253119216762,1.5494663263038226,2.0784205659674773,2.6036146774546656,0.42269181537341854,229,220,238,254,16,25,34,148.8082505755298,22,130.95238095238093,-0.3196420783710885,0.17761540714271115,0.6820723798153019,0.8461608075614757,16751,16800,Independence+Jackson+Woodruff,Jackson,5,67,Arkansas,AR
05147,05CS019,83,82,83,95,12,12,13,234.6923399191081,6,115.66265060240963,1.0626378695977574,1.190833536650045,1.3162614204385055,0.45541954495927406,100,99,101,105,4,5,6,84.31942127704815,16,261.0966057441253,-1.895025116782632,-1.7675588708131067,-1.6460734896826794,2.5944147515068314,6225,6128,Independence+Jackson+Woodruff,Woodruff,5,147,Arkansas,AR
05069,05CS020,684,655,713,901,188,217,246,390.01813777622135,132,237.2678250449371,1.0075936485328933,1.521758265560555,1.9946174038165405,0.6055598913033118,826,792,860,999,139,173,207,261.9845712724706,102,154.54545454545453,0.6138766548461393,1.0711008610567994,1.5419740283286696,0.5865108809621651,66760,66000,Jefferson,Jefferson,5,69,Arkansas,AR
05081,05CS021,148,142,153,192,39,44,50,444.0236835830301,28,279.39464493597205,1.1470234266464294,1.638303901249353,2.175512272093803,0.6154039094502677,179,173,185,200,15,21,27,173.06684425595515,35,292.9360562437228,-1.7433891834743758,-1.2077751183440384,-0.6972319210669237,1.6145381092013116,12026,11948,Little River+Polk+Sevier,Little River,5,81,Arkansas,AR
05113,05CS021,227,219,236,258,22,31,39,190.52188455087705,51,316.9178188597172,-1.7567632130286324,-1.2674537619404946,-0.7315509642661623,1.6108789657831037,279,269,289,374,85,95,105,493.25045848001906,72,372.5165562913907,0.6648344066824227,1.2108953689546889,1.7489824199492998,0.7473884331792653,19311,19328,Little River+Polk+Sevier,Polk,5,113,Arkansas,AR
05133,05CS021,135,129,142,175,33,40,46,297.57433893153666,29,218.14078856641385,0.2773827163685611,0.8035069754032642,1.315525645380341,0.7149896343521035,166,157,174,229,55,63,72,401.59178509456774,35,221.77163857559245,1.299583753565073,1.792736012148213,2.300204155715309,0.5436537198431123,15953,15782,Little River+Polk+Sevier,Sevier,5,133,Arkansas,AR
05085,05CS022,598,566,630,674,44,76,108,123.68953850992774,75,121.53129430828437,-0.5024019729015209,0.021917545794146703,0.5321327807092757,0.9698454808642503,738,699,776,836,60,98,137,131.682172712538,85,113.90590032563686,-0.31584396238163936,0.1730017375045659,0.6938077367767537,0.8562921395950983,74055,74623,Lonoke,Lonoke,5,85,Arkansas,AR
05093,05CS023,426,409,444,571,127,145,162,429.28917201697885,82,243.28734609108437,1.3534943619714628,1.8628750140777073,2.411055971723021,0.5628315048156686,514,493,535,594,59,80,101,200.9931695235432,61,153.3279710436356,-0.03499005435890063,0.47615036719797615,0.982657870907507,0.7534294388454235,40446,39784,Mississippi+Poinsett,Mississippi,5,93,Arkansas,AR
05111,05CS023,283,273,293,352,59,69,79,360.30205395491936,49,256.1198710689084,0.5130736304642461,1.030782591394172,1.545569980800522,0.7006827857878325,342,331,354,423,69,81,92,355.3962018336219,40,176.2580417731559,1.286110610134153,1.7880965985621788,2.2899477755923856,0.4898742139984851,22958,22694,Mississippi+Poinsett,Poinsett,5,111,Arkansas,AR
05097,05CS024,125,121,129,135,6,10,14,141.84979395614184,21,294.358135731807,-1.9906543399321905,-1.534136029571851,-0.9540703867252499,1.8885230530798527,153,148,157,173,16,20,25,236.53617009680823,34,395.855163581325,-2.1255540779473274,-1.6146563125604279,-1.083725482361639,1.5950391168736746,8561,8589,Montgomery+Perry+Scott+Yell,Montgomery,5,97,Arkansas,AR
05105,05CS024,105,104,107,111,4,6,7,65.65352544368743,3,35.803083043262056,0.17681663150244759,0.2995715619633016,0.4131398166889009,0.46145196985863446,128,127,130,152,22,24,25,237.92318189721112,20,200.62192797672785,0.23959794856646158,0.37365545029359265,0.5005879814281512,0.8091085556394122,10055,9969,Montgomery+Perry+Scott+Yell,Perry,5,105,Arkansas,AR
05127,05CS024,126,122,130,141,11,15,19,181.64817379218542,14,170.19552223685542,-0.40056425757128034,0.12169745198972487,0.6370510588716793,0.878179226743553,153,148,158,181,23,28,33,286.304440882299,19,193.4826883910387,0.41496511668465214,0.9198116107080312,1.4118756044749063,0.6525824245346281,9871,9820,Montgomery+Perry+Scott+Yell,Scott,5,127,Arkansas,AR
05149,05CS024,213,204,221,252,31,39,48,232.30847370302004,37,217.87133814220522,-0.34209198980194755,0.13950543805119786,0.6766370158395351,0.9146691199253302,257,247,268,298,30,41,51,201.26801487273903,40,198.37333862328904,-0.5032778633241626,0.029812412873841704,0.5645224838339811,0.9619157702491159,20379,20164,Montgomery+Perry+Scott+Yell,Yell,5,149,Arkansas,AR
05119,05CS025,3240,3069,3412,3803,391,563,734,169.6974271272221,342,103.12671972097488,0.13846677102449478,0.6635469421770327,1.1842348952018114,0.6066314483742823,3979,3773,4184,4725,541,746,952,187.48871934190421,479,120.35054924071115,0.18285690606721536,0.6744321389622772,1.1949436003291607,0.6410491450203497,397957,398004,Pulaski,Pulaski,5,119,Arkansas,AR
05125,05CS026,1024,970,1077,1101,24,77,131,75.06237718286327,98,95.08562557609275,-0.6986997477878228,-0.2009563356565921,0.3528050258735246,1.250589578915856,1269,1205,1334,1581,247,312,376,249.54431855512155,165,131.99260841392882,0.6312168870955437,1.1855314273499746,1.6757824677718345,0.5272443680565945,123678,125007,Saline,Saline,5,125,Arkansas,AR
05131,05CS027,1111,1056,1165,1345,180,234,289,220.17617170781276,111,104.22535211267606,0.6241749431800553,1.145878850081378,1.6745978250244575,0.4713623529243107,1367,1301,1433,1711,278,344,410,267.9138161290338,217,169.12956727771544,0.45705050031006633,0.9841204320157181,1.52546500092203,0.6294523188540524,127800,128304,Sebastian,Sebastian,5,131,Arkansas,AR
05049,05CS028,164,159,169,183,14,19,24,190.09540233106134,35,346.6776723070574,-2.096309457075754,-1.553820650974272,-1.0496088654473552,1.7333842128301844,200,194,206,255,49,55,61,453.36824479325236,43,354.522219473988,0.43356102412664244,0.9957405485348676,1.5144771953854193,0.7680075295524692,12115,12129,Sharp and Nearby Counties,Fulton,5,49,Arkansas,AR
05065,05CS028,175,169,181,191,10,16,22,142.98589944373748,10,88.12513769552764,0.06240529968173837,0.556247367547092,1.0495635603117013,0.5805405723952068,217,209,224,263,39,46,54,334.8029550828885,35,252.4888183523301,0.31014511783800053,0.818587510729584,1.3411232017610843,0.7382348726394388,13617,13862,Sharp and Nearby Counties,Izard,5,65,Arkansas,AR
05075,05CS028,201,194,208,230,22,29,36,215.47987134378187,32,236.424085703731,-0.734646182676391,-0.21531022844816167,0.316502253464141,1.0608250360664768,245,237,254,251,-3,6,14,33.98484744122083,18,110.57869517139699,-1.3142742172103912,-0.7376724416029238,-0.2627976652782635,2.7556418655119415,16242,16278,Sharp and Nearby Counties,Lawrence,5,75,Arkansas,AR
05121,05CS028,222,214,230,258,28,36,44,234.25596188443973,44,284.651463690765,-1.0350944248704257,-0.4972972592786479,-0.012524529987171299,1.1824741642281478,274,264,284,285,1,11,21,58.822914077392284,24,127.49681257968551,-1.1658772384409308,-0.6752693885513988,-0.20227489437872143,1.9879356581675585,18549,18824,Sharp and Nearby Counties,Randolph,5,121,Arkansas,AR
05135,05CS028,246,239,253,240,-13,-6,1,-41.728373747591824,26,180.169775365248,-2.741660448497877,-2.2234224339324524,-1.721060360576472,-5.177475838465273,303,294,313,347,34,44,53,247.73029805566617,42,239.01661734577738,-0.44547898931060664,0.09072126526714093,0.5874744721598804,0.9431596320177345,17317,17572,Sharp and Nearby Counties,Sharp,5,135,Arkansas,AR
05003,05CS029,211,203,219,248,29,37,45,231.5379860275158,21,132.3251417769376,0.48535392462781957,0.9970608261799516,1.5226385024748812,0.5563639261032566,255,246,265,323,58,68,77,361.60441618729504,37,197.6918144902757,1.13368249827145,1.6410892394881411,2.1469021604699194,0.5387469536774155,19044,18716,Southeast Arkansas,Ashley,5,3,Arkansas,AR
05017,05CS029,134,129,138,149,11,15,20,183.165481163962,25,295.9455460195324,-1.6143595692410748,-1.1347893956429824,-0.5775669447070682,1.517643760179456,162,156,167,171,4,9,15,92.84376458477564,13,129.5207731393843,-0.8619916919980329,-0.37463743665182075,0.1341735791066412,1.2598451261986678,10137,10037,Southeast Arkansas,Chicot,5,17,Arkansas,AR
05041,05CS029,143,138,147,151,4,8,13,88.93350908130715,13,137.870083959346,-0.9955875602098763,-0.4841834390131075,-0.006651740690074199,1.3850874757960434,172,166,177,192,15,20,26,182.76997766264648,24,215.73033707865167,-0.8182921114383679,-0.3364333046953725,0.17194070207614034,1.1250091399098523,11315,11125,Southeast Arkansas,Desha,5,41,Arkansas,AR
05043,05CS029,171,164,179,238,59,67,74,458.8253194252901,23,158.60245948741525,2.4992589454353755,3.024013850102148,3.5214755388211585,0.3405524611143999,208,199,217,223,6,15,24,85.98788464488783,24,140.03150708909504,-1.0100296592559384,-0.5542978573827733,-0.03978915682371662,1.525023389241581,17402,17139,Southeast Arkansas,Drew,5,43,Arkansas,AR
05079,05CS029,129,123,135,151,16,22,28,203.95640103493716,27,250.8710801393728,-0.9781503895730451,-0.4717307134547277,0.023698638055184504,1.1764291870838026,160,153,167,176,9,16,23,123.8048104519973,28,215.15291224834792,-1.4451459664361463,-0.9100814818014907,-0.4136971035494142,1.6362826479163974,12915,13014,Southeast Arkansas,Lincoln,5,79,Arkansas,AR
05023,05CS030,320,309,331,368,37,48,59,233.10073718830063,38,184.2200945339959,-0.00993190276767893,0.4876091489416492,1.0139119305647135,0.7742011001178688,394,381,407,457,50,63,76,251.30071460230766,61,244.35186668803075,-0.4367015703491401,0.06827418273605068,0.5924485045535344,0.9570922912108077,24753,24964,Van Buren and Nearby Counties,Cleburne,5,23,Arkansas,AR
05101,05CS030,78,77,78,124,46,46,47,763.9934822053995,17,280.4509210888094,4.7139767612348935,4.8349528745252925,4.961589225789548,0.3593264580121261,94,94,95,139,44,45,45,618.9057991203915,15,208.24656393169514,3.9829071505132365,4.100340889438828,4.2337458416044615,0.3290932613048928,7274,7203,Van Buren and Nearby Counties,Newton,5,101,Arkansas,AR
05129,05CS030,100,99,101,91,-10,-9,-8,-134.4020135705275,15,229.6504210257719,-3.7584278369966655,-3.6374136886908577,-3.5273241096694448,-1.9283448844812485,123,122,124,158,34,35,36,446.92586902367185,15,190.54878048780486,2.446394623710742,2.5609653452673107,2.6937240264334217,0.41457073052712257,7838,7872,Van Buren and Nearby Counties,Searcy,5,129,Arkansas,AR
05137,05CS030,151,146,156,197,41,46,51,444.80815350300867,19,183.6784016756626,2.110898650326532,2.6150928266446094,3.138645156988712,0.40415473840369626,186,179,192,243,51,57,64,460.86395462117804,25,200.57766367137356,2.102335407556445,2.610198283510167,3.0940418937692957,0.4277739359489245,12413,12464,Van Buren and Nearby Counties,Stone,5,137,Arkansas,AR
05141,05CS030,201,194,208,201,-7,0,7,0.6713571529974489,13,98.3048711323965,-1.4988218880172346,-0.9902670543796583,-0.48163725694158466,11.939954276623661,244,236,252,323,71,79,87,505.1854790505981,35,222.8731533367295,2.3300708071638074,2.825204035411307,3.3080212036344796,0.43567925484053566,15869,15704,Van Buren and Nearby Counties,Van Buren,5,141,Arkansas,AR
05143,05CS031,1481,1375,1587,1646,59,165,271,80.70363270574617,217,105.8730255534549,-0.7738061609954658,-0.26071975336033526,0.2399704874399919,1.3039910651216808,1854,1725,1983,2046,63,192,321,76.96564511378864,237,94.96638109968666,-0.6658464737627212,-0.19098130117522782,0.3234376652518759,1.227489530082647,245955,249562,Washington,Washington,5,143,Arkansas,AR
05145,05CS032,711,678,744,841,97,130,163,201.74481152826544,55,85.58646177786423,0.6507370205883811,1.1408618444580185,1.6564690799834962,0.4209841154808119,873,833,912,1095,183,222,262,288.27643290326284,111,143.8774319822681,0.9458956937933629,1.4488097357814445,1.9848205877238752,0.4968613020421563,77115,77149,White,White,5,145,Arkansas,AR
06001,06CS001,8592,7872,9312,9396,84,804,1524,57.601018177358604,635,45.4947645198153,-0.4273165996834598,0.12211051644318192,0.6191056554082949,0.7888445197072179,10539,9685,11392,11273,-119,734,1588,44.415987819887434,805,48.695828914917804,-0.5691560258208502,-0.03743777665417705,0.4588368966568813,1.0948669819736645,1674918,1653119,Alameda,Alameda,6,1,California,CA
06003,06CS002,18,18,19,19,0,1,1,50.80875014274108,4,403.7005887300252,-3.6406854096441252,-3.5318363555969015,-3.398193095355507,2.660582742857238,24,23,24,27,3,3,4,283.4236478220574,4,325.2032520325203,-0.5435977191983664,-0.41334605662394663,-0.28465833898655596,0.8916409151508271,1189,1230,Alpine and Nearby Counties,Alpine,6,3,California,CA
06005,06CS002,396,378,413,426,13,30,48,90.21855359878774,19,56.30741874938259,-0.19051302439366458,0.34008765953714,0.8685495792439206,0.6042728975696215,491,470,513,550,37,59,80,142.45775496766112,43,104.48559070807212,-0.1289157706262364,0.38330786080220647,0.903870456698512,0.7211490348457783,40492,41154,Alpine and Nearby Counties,Amador,6,5,California,CA
06009,06CS002,431,411,450,466,16,35,55,92.6006701946786,17,44.79971890372452,-0.03219240548822823,0.4706732967480702,0.9995167283591384,0.4704076554003277,535,511,558,619,61,84,108,183.20029358906294,59,128.0076370658046,0.023600100256224454,0.5348324770056462,1.0576671250727694,0.6905523874907993,45536,46091,Alpine and Nearby Counties,Calaveras,6,9,California,CA
06027,06CS002,191,183,199,204,5,13,21,84.87712203585592,28,178.088726347591,-1.4291853132116679,-0.927748218067716,-0.4151836782359458,1.9519260805875824,234,224,244,245,1,11,21,58.47322250507228,22,115.92370112762146,-1.1220393846790069,-0.5800908822398014,-0.03388588977472539,1.8186254775765627,18867,18978,Alpine and Nearby Counties,Inyo,6,27,California,CA
06051,06CS002,54,53,55,39,-16,-15,-14,-134.33736414685518,2,17.921146953405017,-1.6460444908886906,-1.5241422698579419,-1.3968550455329363,-0.14293831304513802,68,66,69,64,-5,-4,-2,-27.92744371196306,4,30.209198701004453,-0.7078555873961591,-0.5805044131708169,-0.44548414951321497,-1.4826495776703958,13392,13241,Alpine and Nearby Counties,Mono,6,51,California,CA
06007,06CS003,1877,1786,1968,1992,24,115,206,65.38171726167293,132,75.01456248608868,-0.6217858746677299,-0.09306034628651087,0.42498702202977556,1.1374458194411317,2273,2165,2381,2569,188,296,404,141.89993804204994,293,140.4817613440221,-0.5305081304466084,0.007261195334186678,0.5342723700124075,0.9866719717789245,211159,208568,Butte,Butte,6,7,California,CA
06011,06CS004,148,139,157,155,-2,7,16,38.20190865445638,15,82.55365987892131,-0.9450195409689208,-0.45096771895815435,0.04901515187351413,1.8888626456923872,183,171,194,183,-11,0,12,1.0473352323919487,23,104.98448055504838,-1.5406392783505451,-1.0263163976552727,-0.5327625047970801,18.70754907295726,21804,21908,Colusa+Lake,Colusa,6,11,California,CA
06033,06CS004,777,747,806,719,-87,-58,-28,-101.940290549653,39,69.13463527048188,-2.239634914427154,-1.7180922677783652,-1.2087790164937866,-0.6901895426183989,956,921,991,957,-34,1,36,1.4794883404607018,89,129.58648806057076,-1.806389334841272,-1.2809321176969695,-0.787923683712954,44.1443599643551,67694,68680,Colusa+Lake,Lake,6,33,California,CA
06013,06CS005,6794,6293,7294,7277,-17,483,984,49.85160533520926,422,43.532044278209646,-0.4354155306268929,0.07062467299715683,0.6040414006080865,0.8714293227775489,8388,7788,8988,9112,124,724,1324,62.280281030461495,650,55.937171369118204,-0.4302018472152702,0.05985390505329823,0.5676567749925775,0.8969128694765401,1163281,1162018,Contra Costa,Contra Costa,6,13,California,CA
06015,06CS006,260,248,272,283,11,23,35,98.4886737612619,6,25.919792641658866,0.22605759505060657,0.7024022687027949,1.2228283751733684,0.25211687308541886,322,307,336,380,44,58,73,206.90206117477567,45,160.46785294012764,-0.07377606415886123,0.4460675696856469,0.9954012769600988,0.7624334467757279,27778,28043,Del Norte+Humboldt+Trinity,Del Norte,6,15,California,CA
06023,06CS006,1148,1089,1207,1200,-7,52,111,45.79671719366838,23,20.25361042620641,-0.2706049771516011,0.26498009320611804,0.73388192547889,0.43390698566887964,1411,1340,1481,1602,121,191,262,140.43324182496985,93,68.22383285894539,0.2000655251909632,0.735866851624659,1.260274443715807,0.48328514687177093,136272,136316,Del Norte+Humboldt+Trinity,Humboldt,6,23,California,CA
06105,06CS006,165,163,166,147,-19,-18,-16,-137.60261503130272,4,30.89200669326812,-1.8085956968816916,-1.6818896467975775,-1.5691478391919558,-0.2378510829726666,209,207,211,198,-13,-11,-9,-68.18887041474781,19,118.27689243027889,-1.989322054938497,-1.8636676485733572,-1.7386772012697513,-1.9088072090856367,15538,16064,Del Norte+Humboldt+Trinity,Trinity,6,105,California,CA
06017,06CS007,1353,1270,1435,1514,79,161,244,101.112162958743,72,45.089945046629474,0.03596957213224559,0.565368395083541,1.0759926506560928,0.44319489633850484,1676,1576,1775,1903,128,227,327,117.8421257481409,159,82.4201457644339,-0.17164918965448525,0.3470212183365075,0.8654427389125847,0.696348458496317,191617,192914,El Dorado,El Dorado,6,17,California,CA
06019,06CS008,6034,5601,6468,7507,1039,1473,1906,175.32959683674684,937,111.56698831642397,0.1135240086896267,0.6404714198345465,1.1677403750809483,0.6358953385905118,7503,6980,8026,9355,1329,1852,2375,182.80947536536334,1402,138.41336034467096,-0.06986734337092551,0.44130030973293227,0.9592832839319525,0.7567367650921274,1007825,1012908,Fresno,Fresno,6,19,California,CA
06021,06CS009,233,220,245,223,-22,-10,3,-41.154242551114606,22,91.60941078492608,-1.8507739773658236,-1.3081143119559213,-0.8273980221652119,-2.4765874263580923,287,272,302,330,28,43,58,150.3444768872377,59,204.73315289055452,-1.0358216779895257,-0.5377490209374381,-0.014877080387471747,1.3310390927083093,28818,28818,Glenn+Tehama,Glenn,6,21,California,CA
06103,06CS009,612,584,640,679,39,67,95,122.35012834836937,44,80.56148916692096,-0.10035353616106332,0.4316961612533272,0.9107213157587428,0.648742101625862,751,717,785,941,156,190,224,289.9695152985942,129,196.90147294512704,0.42534195523225365,0.9184333164659996,1.4199717002206285,0.6754862906193491,65540,65515,Glenn+Tehama,Tehama,6,103,California,CA
06025,06CS010,969,951,987,1660,673,691,709,461.65355027440967,529,353.32424233991037,0.9692524516337653,1.0816282833060866,1.2048567089511568,0.7642393289368794,1196,1173,1218,1587,369,391,414,217.69036599040356,344,191.32582119934594,0.14116794307567493,0.26471075991892057,0.3884723670872511,0.8766499400157395,179665,179798,Imperial,Imperial,6,25,California,CA
06029,06CS011,5345,4954,5736,6535,799,1190,1581,157.0593047371078,678,89.48742710448337,0.1749026980036396,0.6818977573701873,1.189289532170171,0.5692899772825795,6672,6199,7145,8615,1470,1943,2416,211.97897649299625,1345,146.74530905980444,0.11285473090400933,0.6701866365649298,1.1453825866035816,0.6919073834699987,909178,916554,Kern,Kern,6,29,California,CA
06031,06CS012,749,683,814,920,106,171,237,134.60647075223443,113,88.78587283191577,-0.057480923183645075,0.4410447746987908,0.946373707318483,0.6557680702689436,938,859,1017,1302,285,364,443,237.40755095097208,225,146.74806292556937,0.4141413867114466,0.9153446561868023,1.4288304430517145,0.61643370602483,152727,153324,Kings,Kings,6,31,California,CA
06035,06CS013,223,209,237,247,10,24,38,89.55399178418857,16,59.13150600554358,-0.21797924797424711,0.3139954392855017,0.8012109057761406,0.6341199927462425,278,261,296,364,68,86,103,258.4699564894498,65,196.4042906783502,0.10483660837391387,0.5979926739548578,1.1683135957051318,0.7510922721797665,32470,33095,Lassen+Plumas+Sierra,Lassen,6,35,California,CA
06063,06CS013,203,194,211,232,21,29,38,179.12159310275203,7,42.68292682926829,0.8471500054033555,1.3656412112923142,1.8815831807340915,0.2304455337875594,249,239,260,278,18,29,39,143.36596056593152,30,150.79923595053785,-0.5745435370675039,-0.07128225130576996,0.4625967363176322,1.0162180200201485,19680,19894,Lassen+Plumas+Sierra,Plumas,6,63,California,CA
06091,06CS013,32,31,32,36,4,4,5,162.9151555201057,1,37.57044458359424,1.1278323263667336,1.2522773116702417,1.3648899719336414,0.1873972223649038,40,39,40,37,-3,-3,-2,-85.81412706393859,3,91.6030534351145,-1.8920815386902883,-1.7757523331643257,-1.6493989720388054,-1.6570807662010616,3194,3275,Lassen+Plumas+Sierra,Sierra,6,91,California,CA
06037,06CS014,53793,49505,58081,69724,11643,15931,20219,191.63488887682013,11176,134.43720359549752,0.051972199336305945,0.5751060538843886,1.086055616659916,0.7014837755590095,66022,60935,71108,82276,11168,16254,21341,164.97283607827458,13943,141.5127564468332,-0.299126213653763,0.2400486077475211,0.7245387491562201,0.8577415183557254,9975810,9852822,Los Angeles,Los Angeles,6,37,California,CA
06039,06CS015,949,882,1017,1137,120,188,255,143.4800068246657,170,129.99840688226857,-0.3882059197799086,0.1350531540941401,0.5931063910601287,0.9012352195677493,1188,1106,1270,1496,226,308,390,193.90056420848748,269,169.17919787676962,-0.27794323455133096,0.24725232834764127,0.780648256277353,0.8696840968722418,156925,159003,Madera,Madera,6,39,California,CA
06041,06CS016,1665,1552,1777,1754,-23,89,202,40.95900692892187,114,52.369650103361145,-0.6291558132097818,-0.11616743017752405,0.39522954571167224,1.2644057464614553,2048,1914,2183,2166,-17,118,252,45.1693936259961,76,29.181945591030395,-0.3852971964552966,0.14391859787450126,0.6563994742795036,0.6406100750121599,261220,260435,Marin,Marin,6,41,California,CA
06043,06CS017,173,166,180,175,-5,2,9,13.556733361806403,5,35.03649635036496,-0.7153441678325304,-0.2016992297484579,0.30315376399356686,1.7037755666682626,212,203,220,243,23,31,40,183.3311511528952,22,128.32477834811013,0.01799410415913727,0.5436212371186676,1.0956536707967097,0.6783780924456176,17125,17144,Mariposa+Tuolumne,Mariposa,6,43,California,CA
06109,06CS017,583,559,607,647,40,64,88,138.04357021949534,33,71.52145643693108,0.18250568621035002,0.6626676996203067,1.2066918089588503,0.5100991650919414,716,687,745,847,102,131,160,235.0047426818677,115,206.21514515753043,-0.22699799027666723,0.2814291167237479,0.8414470019245216,0.8708486418446073,55368,55767,Mariposa+Tuolumne,Tuolumne,6,109,California,CA
06045,06CS018,753,714,793,870,77,117,156,154.27819672649244,35,46.30446286823072,0.5634665364962993,1.0800284401467601,1.6140688235734095,0.29758426290599466,928,881,975,1057,82,129,176,141.24949258443343,65,71.18451025056947,0.20537753771515505,0.7067968947110027,1.216242003710895,0.5000856428642041,90704,91312,Mendocino,Mendocino,6,45,California,CA
06047,06CS019,1566,1445,1687,1948,261,382,503,162.78729642346656,260,110.81631130859145,0.0346304573740563,0.528088825998172,1.0613187123680696,0.6789652968557184,1964,1817,2112,2342,230,378,525,132.112406894534,384,134.37379710956364,-0.5293308859148445,-0.015516782326411151,0.4551678588536637,1.0144302031135122,281547,285770,Merced,Merced,6,47,California,CA
06049,06CS020,94,93,95,101,6,7,8,100.91833664595814,2,27.6211301645759,0.6145489686763989,0.7410877693373625,0.8548692528955391,0.24075128192197814,114,113,116,141,25,27,28,306.04851196163065,12,138.55213023900242,1.5502740218438662,1.6721572047805269,1.8035060279693182,0.43625478490937813,8689,8661,Modoc+Siskiyou,Modoc,6,49,California,CA
06093,06CS020,492,473,511,542,31,50,69,137.12911028097713,14,38.23830658927962,0.4714378460997873,0.9940371079196579,1.4997756789998722,0.27340334860235055,600,577,623,743,120,143,166,324.6765095230346,75,170.0873114865631,1.0420885428654993,1.5476669991600842,2.0712868459843703,0.5202332339143669,43935,44095,Modoc+Siskiyou,Siskiyou,6,93,California,CA
06053,06CS021,2246,2058,2434,2539,105,293,481,80.34142521564341,256,70.19612413197419,-0.4175528090965461,0.09468298567862835,0.6223013274125789,0.8707508104153188,2788,2562,3014,3157,143,369,595,84.4051069590536,367,83.88648124782856,-0.4772386648982334,0.023914538153448957,0.51147207468664,0.9911713726096234,437631,437496,Monterey,Monterey,6,53,California,CA
06055,06CS022,1032,973,1091,1043,-48,11,70,9.732887466058914,38,33.170391061452506,-0.7406832867245109,-0.22680485899212216,0.25692825592162116,3.127573076716649,1259,1189,1329,1345,16,86,156,63.08443101476019,73,53.51474587826495,-0.4207376669707779,0.09829255666316872,0.622428138994208,0.8385589802628673,137472,136411,Napa,Napa,6,55,California,CA
06057,06CS023,910,866,954,988,34,78,122,91.48426524998784,63,74.1459969988525,-0.33827463012263714,0.1674893392535031,0.676384946118092,0.8001839856557141,1129,1075,1182,1207,25,78,132,75.9785353453392,67,64.86026002187825,-0.39660856294671426,0.09574823825704087,0.5857608576900352,0.8429256253778695,101961,103299,Nevada,Nevada,6,57,California,CA
06059,06CS024,17174,15806,18542,19959,1417,2785,4153,105.0754039278633,2459,92.7786819063334,-0.3994662238559299,0.11983270667306681,0.6272852645973421,0.8826554610231877,21266,19630,22903,25162,2259,3896,5532,122.88351144629932,3517,110.9398978293065,-0.3928969294646743,0.11503817055966,0.6358926129531433,0.9025737125232817,3180472,3170185,Orange,Orange,6,59,California,CA
06061,06CS025,2880,2706,3055,2988,-67,108,282,31.83855072667508,157,46.46929548700266,-0.6470172956894863,-0.15184798911407799,0.36558348390268697,1.4460858903183373,3588,3376,3800,3895,95,307,519,74.61404390369916,306,74.39047218501348,-0.4820667585343043,-0.001243214017463494,0.5773522778070616,0.9937657546834135,405429,411343,Placer,Placer,6,61,California,CA
06065,06CS026,14474,13429,15520,18545,3025,4071,5116,200.80051491922282,2657,131.06327983761372,0.19552469234491615,0.6841126709512374,1.234081913959562,0.6525436028795237,18083,16817,19350,23082,3732,4999,6265,203.76098441167568,3945,160.81043568010585,-0.08086037619493588,0.4443897783737322,0.9480856653770262,0.7890532718305422,2432718,2453199,Riverside,Riverside,6,65,California,CA
06067,06CS027,10289,9608,10970,11312,342,1023,1704,77.64771592489221,948,71.93275653076206,-0.4313658136855869,0.04478939671181817,0.5906111352857946,0.925494466938014,12737,11917,13557,13886,329,1149,1969,72.3141119572049,1326,83.4733999357897,-0.6516552183359546,-0.1041750534722524,0.41659608760776945,1.1533128894703604,1581477,1588530,Sacramento,Sacramento,6,67,California,CA
06069,06CS028,321,293,349,352,3,31,59,57.17398993142861,32,59.54873226331704,-0.5535664510796895,-0.03833478548107194,0.49875434994445833,1.0087040810558159,411,376,445,475,30,64,99,96.99115212273716,60,90.41455071502841,-0.43229519744059114,0.04850050772663247,0.6077834630862051,0.9179322874024511,64485,66361,San Benito,San Benito,6,69,California,CA
06071,06CS029,12427,11488,13366,16663,3297,4236,5175,232.84249428503438,2747,150.99006499663335,0.31488024763058853,0.8259561657443718,1.3416302099367015,0.6483113434323671,15478,14346,16610,19934,3324,4456,5588,203.2047079778768,3626,165.34699156028097,-0.09098578966838161,0.3788477251673702,0.8805894638123503,0.8135140994033518,2183190,2192964,San Bernardino,San Bernardino,6,71,California,CA
06073,06CS030,18345,16927,19764,20772,1008,2427,3845,88.2118583852746,1748,63.545728022102864,-0.23599969464160034,0.26228931608744877,0.7886587739043773,0.7200794978483493,22684,20986,24381,26447,2066,3763,5461,114.46229206394365,2869,87.26465310095203,-0.18901808847182971,0.2731104683082867,0.7673048477494315,0.7621852454301481,3300930,3287700,San Diego,San Diego,6,73,California,CA
06075,06CS031,4876,4505,5248,5343,95,467,838,64.68122503668735,222,30.776731220013193,-0.20598616646066367,0.32750622334436646,0.8778426232531527,0.4748040448295668,5759,5334,6184,6569,385,810,1235,98.41425727065848,342,41.545441845492256,0.05559620786157479,0.556749809971693,1.0727349796383225,0.42162817147993825,865589,823195,San Francisco,San Francisco,6,75,California,CA
06077,06CS032,4956,4620,5291,5976,685,1020,1356,157.24629969157778,793,122.20681152719987,-0.17962080181591691,0.34634087845645234,0.8452469706279414,0.776407216058266,6177,5770,6584,7229,645,1052,1459,133.48990928378194,1092,138.5588107289183,-0.5521678835920443,-0.04132154812778572,0.45971745325428537,1.036986488866031,778680,788113,San Joaquin,San Joaquin,6,77,California,CA
06079,06CS033,2064,1943,2186,2068,-118,4,125,1.5703325559288532,116,49.29178470254958,-1.0393948420354486,-0.4886590627254193,0.0560224053134952,24.704420403969834,2546,2400,2692,2671,-21,125,271,44.06554600217388,248,87.6250777319238,-0.9235186065623135,-0.42779156134028506,0.052730843411926964,1.9726992594554922,282400,283024,San Luis Obispo,San Luis Obispo,6,79,California,CA
06081,06CS034,4001,3674,4327,4151,-176,150,477,23.7320405372625,248,39.145635971893014,-0.6720574044248401,-0.16517304713732514,0.3753912763934666,1.6385861459601194,4847,4464,5230,5116,-114,269,652,36.287228292365235,357,48.147598689090586,-0.6443288261493333,-0.11593083157316689,0.3761716589096608,1.3219337879252335,760238,741470,San Mateo,San Mateo,6,81,California,CA
06083,06CS035,2738,2546,2931,2900,-31,162,354,43.38921595154182,177,47.45912683250548,-0.5458403063884631,-0.059411553642054346,0.4749715299677083,1.0870822557017645,3380,3149,3611,3666,55,286,517,64.01168166531704,378,84.61846697305417,-0.7131439957168393,-0.19803531168241637,0.28220089970323603,1.3173154131759712,447543,446711,Santa Barbara,Santa Barbara,6,83,California,CA
06085,06CS036,8680,7852,9507,9579,72,899,1727,56.07053227480189,851,53.05742640308369,-0.5180519748118283,0.03612950692377498,0.5341133043186524,0.9452112014352413,10655,9678,11632,11365,-267,710,1687,37.520682365001264,1085,57.344177108415906,-0.7487533129592125,-0.20045298942583537,0.32508727117508585,1.526185343465778,1924707,1892084,Santa Clara,Santa Clara,6,85,California,CA
06087,06CS037,1478,1362,1594,1583,-11,105,221,46.65089659230265,122,54.13140175927056,-0.6069817130085726,-0.07853888453320429,0.4154077161653557,1.1494185248322761,1819,1681,1957,2004,47,185,323,68.97195319002044,147,54.816996998116835,-0.4424587722728796,0.12629469896761705,0.6784458974487052,0.7904983676260844,270453,268165,Santa Cruz,Santa Cruz,6,87,California,CA
06089,06CS038,1926,1848,2004,2068,64,142,220,93.69646430511054,102,67.40422157485779,-0.2616924535117262,0.26983383857298343,0.7316187500860006,0.7143509692783934,2356,2262,2450,2782,332,426,520,233.8178668861325,346,190.00236130102195,-0.07584496573118549,0.434041373799144,0.9602694186205957,0.8107043905618189,181591,182103,Shasta,Shasta,6,89,California,CA
06095,06CS039,2950,2756,3145,3118,-27,168,362,44.53528932658333,171,45.372131075045324,-0.5152316416024586,-4.924775533485813e-4,0.4980342794434524,1.0127566896372848,3642,3409,3875,4082,207,440,673,97.39003107677419,358,79.21352913973665,-0.3380283459204675,0.18424461304927092,0.6659168956596115,0.8115200886512604,452260,451943,Solano,Solano,6,95,California,CA
06097,06CS040,3429,3219,3639,3693,54,264,474,64.90145290228075,196,48.1308372964876,-0.3613257238850067,0.18419317297478197,0.7131894593745425,0.7388033785665068,4205,3954,4456,4558,102,353,604,72.52327068753956,232,47.71257287992678,-0.31308517126544405,0.24642598989398512,0.7587443942000772,0.6560329428191098,488668,486245,Sonoma,Sonoma,6,97,California,CA
06099,06CS041,3728,3491,3966,4541,575,813,1050,176.54090342002695,634,137.74872806938134,-0.12837369306356808,0.38424036562901087,0.9046577366753717,0.7793061331175907,4597,4312,4883,5581,698,984,1269,177.86483839426705,860,155.52746416086603,-0.32073480694922224,0.22419656407146535,0.7375873529489579,0.8735256054497234,552310,552957,Stanislaus,Stanislaus,6,99,California,CA
06101,06CS042,736,693,778,799,21,63,106,76.55435634172481,62,75.1044800226121,-0.49062949059605476,0.030166984020299548,0.5242417910661605,0.9657787655410642,904,853,955,1013,58,109,160,109.75514754937313,146,147.29026270126306,-0.8933083212024583,-0.3757130866795838,0.11832661844114929,1.3297667355289275,99062,99124,Sutter,Sutter,6,101,California,CA
06107,06CS043,2700,2496,2904,3323,419,623,827,158.0806052683682,451,114.43868585819499,-0.07968416128916815,0.430110534315156,0.9236955161663618,0.722766008510811,3364,3118,3610,4334,724,970,1216,203.55332090380074,783,164.29905365423755,-0.1596321375509371,0.4087025317844285,0.8970109665139377,0.8063236689135274,472917,476570,Tulare,Tulare,6,107,California,CA
06111,06CS044,4888,4525,5250,5547,297,659,1022,93.88630154425772,376,53.537039871568055,-0.09042299246136261,0.3955795138684556,0.9011069650801875,0.569369215027429,6039,5606,6473,7127,654,1088,1521,129.44422832046666,818,97.35302133554539,-0.18783844037885528,0.31315021347143507,0.8289795638842149,0.7513938366125946,842781,840241,Ventura,Ventura,6,111,California,CA
06113,06CS045,1125,1032,1218,1253,35,128,221,70.66607582489677,110,60.86315012910365,-0.41779493987970656,0.09767517508565304,0.6115152069962398,0.8545869471307324,1398,1286,1510,1542,32,144,256,66.51035313318098,131,60.40234416425749,-0.4591628289753982,0.06001287294626357,0.5578076133219768,0.9019119852866352,216880,216879,Yolo,Yolo,6,113,California,CA
06115,06CS046,587,552,622,561,-61,-26,9,-38.16250386137236,29,42.650194867269654,-1.3211786540659611,-0.7876265309395152,-0.32078644058483347,-1.162390129807599,733,690,776,810,34,77,120,92.01553656954675,85,102.15855006970818,-0.6326835595689505,-0.1125483838485227,0.3731938174760842,1.0959171573803566,81594,83204,Yuba,Yuba,6,115,California,CA
08005,08CS002,3365,3084,3647,4174,527,809,1090,148.11056557054638,492,90.10617694325784,0.036482061294073824,0.5684020398856956,1.1123932191934298,0.6076196895536361,4177,3839,4516,4870,354,693,1031,105.74234059099635,392,59.853633436194045,-0.07818904029412911,0.47136274033601155,1.00564583699923,0.5652166520260282,655227,654931,Arapahoe,Arapahoe,8,5,Colorado,CO
08015,08CS005,156,148,165,182,17,26,34,155.9392561471455,15,91.22237989053313,0.10483308917043685,0.6494485928250555,1.1823056828694776,0.5630290005314309,194,183,204,167,-37,-27,-16,-133.53937300473277,12,59.9970001499925,-2.4536033787663216,-1.934496394346161,-1.4397465147205593,-0.4667587997641602,19732,20001,Central Colorado,Chaffee,8,15,Colorado,CO
08051,08CS005,66,64,67,70,3,4,6,31.579072121406387,5,35.17411185367569,-0.15683823282189505,-0.034136911314132136,0.08349474361023705,0.9109185259941631,81,79,83,89,6,8,10,47.30741360632157,7,40.62209842154132,-0.07071687156476057,0.06631140153626756,0.19931965408206997,0.7648590105697685,17058,17232,Central Colorado,Gunnison,8,51,Colorado,CO
08065,08CS005,32,31,33,31,-2,-1,-0,-16.822927361337584,6,95.93604263824118,-1.2408229859536706,-1.124013530826681,-1.0127778721923502,-115.08822913219949,39,38,40,58,18,19,20,261.5452622931252,4,54.00297016335898,1.9472729586545858,2.075927009193836,2.2034795861124534,0.19634159091297684,7505,7407,Central Colorado,Lake,8,65,Colorado,CO
08097,08CS005,50,48,52,60,8,10,12,69.28043123687358,6,41.32231404958677,0.15723278590361234,0.28018417468077156,0.3920787917814791,0.5425190922451122,61,59,63,72,9,11,13,64.39261629295258,8,46.11748429123191,0.05418305814342024,0.17953808439391886,0.3045779611308991,0.6573440410151941,17424,17347,Central Colorado,Pitkin,8,97,Colorado,CO
08109,08CS005,40,39,41,53,12,13,14,242.61721311636552,3,55.7534458726963,1.7420434970355336,1.8710097983331926,1.9888739083960294,0.21344978583280538,49,48,50,68,18,19,20,298.45743416390775,2,30.96934035305048,2.5578818835721044,2.6746586783048767,2.7968564467258803,0.09864666103998558,6457,6458,Central Colorado,Saguache,8,109,Colorado,CO
08027,08CS006,38,37,38,46,8,8,9,203.32431602108696,6,149.812734082397,0.42348750682785297,0.535445525989357,0.649508155305095,0.6562297799556723,48,48,49,61,12,13,13,254.98713953385248,17,340.27221777421937,-0.9767619820138554,-0.8522495923437438,-0.722593321453457,1.237339335472235,4806,4996,Custer+Fremont,Custer,8,27,Colorado,CO
08043,08CS006,490,469,511,533,22,43,64,105.71832906742203,26,63.79063586178695,-0.11758847242683157,0.43218301246479124,0.9339208671842811,0.5897158684557707,606,581,632,754,122,148,173,297.7366154832723,137,276.42145191880877,-0.30412456895907064,0.2226479514204194,0.7129609656470266,0.9221601186375548,48910,49562,Custer+Fremont,Fremont,8,43,Colorado,CO
08029,08CS007,342,329,356,371,15,29,42,111.05291079655113,23,88.33130640722013,-0.2758184713054229,0.2135881118974118,0.7328235494913037,0.7688109550057239,422,406,439,506,67,84,100,264.78456425007954,93,294.32242546996645,-0.8265582372635456,-0.3045516901153658,0.21963661147710442,1.0984257165042683,31246,31598,Delta+Montrose,Delta,8,29,Colorado,CO
08085,08CS007,384,365,402,417,15,33,52,93.073517565964,27,75.6373144084415,-0.3386131261972578,0.17344980160163767,0.6746154275950657,0.7889167523400334,474,451,496,614,118,140,163,325.46790311149397,114,264.41527114162454,0.056052355849562883,0.6225462058924135,1.0810862013489224,0.8066671364466697,42836,43114,Delta+Montrose,Montrose,8,85,Colorado,CO
08031,08CS008,3944,3635,4253,4938,685,994,1303,166.0972934243221,647,108.11322646406808,0.06237885137221928,0.5843785376765569,1.067313057034204,0.650248827865789,4844,4476,5212,5239,27,395,763,55.480346497610405,408,57.274251012827754,-0.5613038781070565,-0.015320626321988873,0.5016443716325402,1.0297286031776196,718136,712362,Denver,Denver,8,31,Colorado,CO
08035,08CS009,1298,1143,1453,1611,158,313,468,104.34800433206321,166,55.36055227153351,-0.020789085225465204,0.4839014500342671,1.01404765276204,0.5288475175357508,1670,1480,1859,1995,136,325,515,88.5143770770767,165,44.87427045314854,-0.08399849145936222,0.43176559502769374,0.9823919813895682,0.5054186180455891,359823,367694,Douglas,Douglas,8,35,Colorado,CO
08037,08CS010,135,130,141,130,-11,-5,0,-11.72555288509218,13,28.05704933364508,-0.5190860779645192,-0.39918914315038573,-0.27929181365309336,-2.9325928533350254,170,163,177,188,11,18,25,31.956845880223455,16,28.716034315661005,-0.08715724155132426,0.029790621375525073,0.15759620359295975,0.8508051765262045,55601,55718,Eagle,Eagle,8,37,Colorado,CO
08039,08CS011,140,128,151,150,-1,10,22,46.49539801737153,13,59.14691943127962,-0.6661681228581181,-0.13921937077657548,0.38180435325139445,1.1587174614398819,178,164,192,210,18,32,46,118.4277880848439,25,92.61317329776988,-0.26477836202322774,0.2626943610363772,0.772092876147201,0.7583019554248583,26375,26994,East Central Colorado,Elbert,8,39,Colorado,CO
08063,08CS011,57,56,58,81,23,24,25,410.0288502838256,5,84.91367110104726,3.134916495699114,3.2469515615113758,3.3713451904253313,0.19885566149141531,69,68,70,103,33,34,35,493.38128540998605,15,215.3007033156308,2.6551521007681225,2.7798637456642425,2.904051218967113,0.4240417641132471,7066,6967,East Central Colorado,Kit Carson,8,63,Colorado,CO
08073,08CS011,49,48,50,50,0,1,2,19.79000109977844,4,84.58149779735683,-0.7610328452839925,-0.646355575868795,-0.5216859986919481,2.0662201497545554,60,59,61,67,6,7,8,120.43629740878191,6,105.54089709762533,0.031179495033364167,0.1528700481687724,0.27461353655916204,0.7646425699484473,5675,5685,East Central Colorado,Lincoln,8,73,Colorado,CO
08121,08CS011,45,44,45,65,20,20,21,502.99170212313726,14,347.970173985087,1.4234894238744686,1.5431625702773477,1.6696825626506904,0.6592258024781198,55,54,56,67,11,12,13,246.04034410714485,14,288.421920065925,-0.5546393252891089,-0.4237149851856518,-0.2959257106280532,1.0816826216628397,4828,4854,East Central Colorado,Washington,8,121,Colorado,CO
08125,08CS011,84,83,85,101,16,17,18,208.229627299384,12,144.27412082957616,0.5251171957037083,0.6433652647302656,0.7595842395997392,0.6550397385774489,102,101,103,103,-0,1,2,9.374205633665902,7,70.37297677691767,-0.734607535807798,-0.6130838672151354,-0.4897161370240633,3.6223405036674263,9981,9947,East Central Colorado,Yuma,8,125,Colorado,CO
08041,08CS012,4265,3950,4579,5200,621,935,1250,153.51525796574506,530,87.0007715162757,0.11914870296689647,0.6620534842547668,1.1653092317640552,0.5661185926581662,5324,4944,5705,6487,782,1163,1543,157.7788559060157,828,112.34903098960771,-0.05645963648523486,0.4531902479013828,0.9252975158611384,0.7114546181407085,731028,736989,El Paso,El Paso,8,41,Colorado,CO
08045,08CS013,314,288,341,338,-3,24,50,45.87686259964745,36,70.17315876677172,-0.7216810981842701,-0.2431618901777079,0.24507239801736738,1.4672560340271912,394,362,426,423,-3,29,61,46.95426337332767,40,64.40705257225666,-0.7059629591282724,-0.1499232216135439,0.33242069423422993,1.326218380908378,61562,62105,Garfield,Garfield,8,45,Colorado,CO
08059,08CS014,10102,9311,10892,11827,935,1725,2516,112.66200399241785,1405,91.7447667119949,-0.3149291221107951,0.19850226224872763,0.743876304446326,0.8138646491731543,12564,11611,13517,14167,650,1603,2556,86.85536484117819,1420,76.93866471321925,-0.41096390389561976,0.09136143319922482,0.601339006311102,0.8852728770261176,1837707,1845626,Jefferson,Jefferson,8,59,Colorado,CO
08067,08CS015,295,271,319,362,43,67,91,143.50966621981715,24,51.59256207230124,0.43914225985521455,0.9254674627191402,1.412827746709692,0.3542001240473578,369,340,398,440,42,71,100,125.71143036622702,36,64.10142269546483,0.07787164283080357,0.6234980617273478,1.101346420248024,0.5027877035734952,55822,56161,La Plata+Montezuma,La Plata,8,67,Colorado,CO
08083,08CS015,230,219,242,251,9,21,32,95.09445189810644,16,73.94284834013709,-0.3034440792977137,0.20142570079113226,0.7063121695355343,0.741535334190811,284,271,298,371,73,87,100,331.32786590319085,47,179.87676527995714,0.9992326656929457,1.5043696800483526,1.9929588831092893,0.5366971955570214,25966,26129,La Plata+Montezuma,Montezuma,8,83,Colorado,CO
08069,08CS016,2055,1901,2210,2213,3,158,312,52.574711068682745,114,38.03951883345475,-0.3663622631449129,0.17315698130516408,0.6724324552949198,0.7189694880615641,2557,2370,2744,2778,34,221,408,61.05461327400734,241,66.55289159887108,-0.537149697874284,-0.06119219095612214,0.4610330555790359,1.085146910080791,359626,362118,Larimer,Larimer,8,69,Colorado,CO
08075,08CS017,180,171,189,264,75,84,93,465.15652034115135,55,305.1740879456235,1.1115364805146823,1.6042050414404685,2.0716243548683204,0.6483338759940867,220,209,231,272,41,52,63,242.0101496795119,46,214.0729709605361,-0.24096978063395352,0.2659686565797302,0.8233482892278468,0.8678730951434638,21627,21488,Logan+Morgan+Phillips+Sedgwick,Logan,8,75,Colorado,CO
08087,08CS017,236,224,249,296,47,60,72,247.3499302245988,71,293.3783271925898,-0.9826459853373832,-0.4553158515919001,0.03252938599913958,1.1665976277849164,289,274,304,331,27,42,57,143.58841846372025,44,151.64047422111938,-0.5806982018036708,-0.09056501224074714,0.4202940117127571,1.031323751699432,29041,29016,Logan+Morgan+Phillips+Sedgwick,Morgan,8,87,Colorado,CO
08095,08CS017,45,45,46,67,21,22,22,576.8029900757268,2,53.262316910785614,5.113024976853697,5.234685615019847,5.354175737202939,0.08826533440382324,55,55,56,71,15,16,16,345.0747158990237,1,22.1483942414175,3.110919509343206,3.234611469463856,3.356401059025676,0.060313181904447795,4506,4515,Logan+Morgan+Phillips+Sedgwick,Phillips,8,95,Colorado,CO
08115,08CS017,31,30,31,41,10,10,11,530.555959820856,5,253.48542458808618,2.647874719577347,2.770539308807663,2.883460661856287,0.4361016718667486,37,37,37,34,-3,-3,-3,-121.72791683965629,3,127.98634812286689,-2.607490060553051,-2.495336882463719,-2.3702551876882696,-1.6187320792300148,2367,2344,Logan+Morgan+Phillips+Sedgwick,Sedgwick,8,115,Colorado,CO
08077,08CS018,1336,1269,1403,1536,133,200,267,154.14994277676337,108,83.13981088259068,0.2079130715288252,0.7233505918012542,1.1922569173264104,0.5366637097478603,1652,1571,1733,1998,265,346,427,220.19556551573305,319,203.01531842857233,-0.30622193493690464,0.16037667986143808,0.7010472446704233,0.9193202951319879,155882,157131,Mesa,Mesa,8,77,Colorado,CO
08049,08CS019,67,66,69,64,-5,-3,-2,-24.673335350484717,4,30.480060960121914,-0.6770320647588678,-0.5537282467400403,-0.42414663050869883,-1.787338815122379,84,82,86,100,14,16,18,103.88409104663523,13,82.06552616627738,0.09655793465841199,0.21905782425929932,0.34615093595458507,0.7447177088686319,15748,15841,Northwest Colorado,Grand,8,49,Colorado,CO
08057,08CS019,11,11,11,11,-0,-0,0,-3.758728475298511,8,696.6618287373004,-7.120658321317292,-7.000703765849016,-6.892075576444444,8.36087835149794,13,13,14,14,0,1,1,42.69670789107772,7,512.8205128205128,-4.833430600277207,-4.696450903193918,-4.574512401625019,4.422514213740079,1378,1365,Northwest Colorado,Jackson,8,57,Colorado,CO
08081,08CS019,87,86,88,139,51,52,53,471.7401948497416,21,190.188679245283,2.696952542822227,2.8199335941830252,2.9384099024135684,0.39556977040998076,106,105,108,157,49,51,52,383.76900390662587,32,242.4793513677351,1.2821565209104016,1.4154393288816045,1.531622553719698,0.619602734421738,13250,13197,Northwest Colorado,Moffat,8,81,Colorado,CO
08103,08CS019,46,45,46,56,10,10,11,191.8902695538572,3,55.478502080443825,1.235318939659577,1.3615011605054608,1.4807625874972083,0.2637022704590461,56,55,57,70,13,14,15,216.66525918203578,10,154.27337241592102,0.4970391789096999,0.6249098094599833,0.7501531993064161,0.6647061336430266,6489,6482,Northwest Colorado,Rio Blanco,8,103,Colorado,CO
08107,08CS019,105,103,108,115,7,10,12,47.32200389580816,21,100.90898170023624,-0.6566920823189075,-0.530156039334868,-0.41603850698206124,1.935822263270531,130,127,134,132,-2,2,5,6.649035709980692,3,11.974135866528298,-0.1722522192029399,-0.058750834961725784,0.08325512753706546,1.1253448872137262,24973,25054,Northwest Colorado,Routt,8,107,Colorado,CO
08019,08CS020,53,52,54,57,3,4,5,46.28619213238775,4,50.86362191374378,-0.17254770592643073,-0.04728156459149178,0.07798491638458456,0.8620646379259074,66,65,67,68,1,2,3,23.767823829307748,1,10.59322033898305,-0.001052873967727611,0.1285610389109063,0.2615302448700539,0.30829157248832184,9437,9440,Park and Nearby Counties,Clear Creek,8,19,Colorado,CO
08047,08CS020,27,26,27,27,-0,0,1,7.303766721046162,6,122.49064307587614,-1.2778357119138828,-1.1548935758035248,-1.027432408350424,4.419033887025633,33,32,34,40,6,7,8,122.04717132276774,1,17.053206002728512,0.9082468291712632,1.0484969541305404,1.172395124703958,0.1225964036231465,5878,5864,Park and Nearby Counties,Gilpin,8,47,Colorado,CO
08093,08CS020,86,84,87,113,26,27,29,185.45522207516103,8,54.344749504670254,1.1926865228889945,1.3100872450954557,1.4307783832705898,0.28267997713746523,106,104,108,118,10,12,14,68.67112490451606,10,56.573885494455766,-0.004347288040665034,0.12093056938253417,0.23811889198193503,0.7611330143108145,17665,17676,Park and Nearby Counties,Park,8,93,Colorado,CO
08117,08CS020,71,68,74,72,-2,1,4,4.386234298897637,6,23.263327948303715,-0.30936118909160926,-0.19023678614927234,-0.0714632352121178,2.8152057695841974,89,85,93,88,-5,-1,3,-2.9422154982557718,7,22.620778801098723,-0.3843712074604046,-0.2537920713454499,-0.1348067925345976,78.18484800136655,30950,30945,Park and Nearby Counties,Summit,8,117,Colorado,CO
08119,08CS020,150,139,161,183,22,33,44,158.60324421792424,3,14.489253803429122,0.9164936900678752,1.4345226872196388,1.9754354992239573,0.08865562159199297,186,173,199,288,89,102,115,409.10940826519374,42,168.69502349680684,1.8889945253598999,2.40765453863813,2.957548264922646,0.4083379919988172,24846,24897,Park and Nearby Counties,Teller,8,119,Colorado,CO
08101,08CS021,1560,1488,1633,1998,365,438,510,311.5892675687704,262,186.50009787695976,0.7189560466553484,1.2599003167858638,1.7793016914430508,0.5971804065849279,1924,1837,2012,2471,459,547,634,322.56926093258784,365,215.3976890483553,0.5249571955268334,1.0694053930225536,1.5770695034723943,0.6665369927521461,168579,169454,Pueblo,Pueblo,8,101,Colorado,CO
08009,08CS022,44,43,44,60,16,16,17,560.1156533214107,2,68.41505131128848,4.784751536038004,4.91604829410569,5.035536904860389,0.1151142235930357,53,53,54,78,24,25,25,707.1830713248728,3,85.47008547008546,6.086902431133017,6.217424124953928,6.3396120411818435,0.11617943552862016,3508,3510,Southeast Colorado,Baca,8,9,Colorado,CO
08011,08CS022,54,53,55,67,12,13,14,275.5587648715789,5,106.38297872340425,1.5739652726559104,1.6886638932302187,1.81449479457428,0.35839051824062534,67,66,68,85,17,18,19,312.2602653200882,22,383.2085002612785,-0.8318322494073395,-0.7093954246047849,-0.5797055244382098,1.162369134156919,5640,5741,Southeast Colorado,Bent,8,11,Colorado,CO
08017,08CS022,15,15,16,23,7,8,8,526.6930482420737,2,137.4570446735395,3.771816403377638,3.8897934603186366,4.011938221557306,0.23085667611925725,18,18,19,24,5,6,6,331.3918486938202,7,409.1174751607247,-0.9034188818787721,-0.7828222780657227,-0.6536245807520185,1.0494572420470565,1746,1711,Southeast Colorado,Cheyenne,8,17,Colorado,CO
08021,08CS022,68,67,69,79,10,11,12,169.8995135617011,4,63.30783434450014,0.9484799443211706,1.0645681290026012,1.188115592423892,0.34086597140611835,83,82,84,140,56,57,58,746.7407962781203,48,632.4110671936759,1.0116271855613457,1.1416274186847304,1.258516074734626,0.8322117771612094,7582,7590,Southeast Colorado,Conejos,8,21,Colorado,CO
08023,08CS022,33,32,33,35,2,2,3,77.97807812676224,8,268.75699888017914,-2.0281234833876804,-1.9086074331535379,-1.7838609606183207,2.408806022311859,40,40,41,58,17,18,18,492.17228292365917,10,277.1618625277162,2.0217575642151213,2.1493902118751484,2.2677202002325907,0.5331179261713108,3572,3608,Southeast Colorado,Costilla,8,23,Colorado,CO
08025,08CS022,41,40,42,63,21,22,23,444.88015860082197,0,0,4.329870296068679,4.448765548603553,4.563175727186115,0,51,50,51,69,18,18,19,304.7430325664888,13,216.84737281067555,0.7490360011482713,0.8833563107051297,1.002491459653379,0.6746467061198239,5919,5995,Southeast Colorado,Crowley,8,25,Colorado,CO
08055,08CS022,91,91,92,113,21,22,22,381.1142458101225,10,175.69546120058564,1.9339601871354979,2.050692450211861,2.1698887293175892,0.440688748218172,112,112,113,139,26,27,27,384.6121123584888,7,101.39049826187717,2.7073271365458007,2.835105097598223,2.9515697305321287,0.25405010084815277,6830,6904,Southeast Colorado,Huerfano,8,55,Colorado,CO
08061,08CS022,18,18,18,17,-1,-1,-1,-85.878762423653,3,248.790601243953,-3.467557242696188,-3.3454340677312717,-3.224662066337258,-84.37692695096487,22,22,22,20,-2,-2,-2,-141.37333848529903,3,206.61157024793388,-3.6033974555318764,-3.4785122745101007,-3.3437297216525335,-2.8497041121836353,1447,1452,Southeast Colorado,Kiowa,8,61,Colorado,CO
08071,08CS022,159,152,165,164,-1,5,12,44.072716954148284,5,41.23994776273283,-0.49525749288975573,0.027486926919975164,0.5340686940232712,0.7882146575649901,193,186,201,239,38,46,53,312.5806957155945,27,184.64063461669974,0.7529703752010148,1.2726335308778542,1.822960809689243,0.5780510777121618,14549,14623,Southeast Colorado,Las Animas,8,71,Colorado,CO
08089,08CS022,206,198,214,264,50,58,66,374.81234776586,36,232.2830411872244,0.9194519492446951,1.4330938178856336,1.9238074293293603,0.60924357520857,250,240,259,313,54,63,73,341.16831063809144,62,333.243751679656,-0.42951360353122964,0.08558931392031414,0.5875884441923263,0.9616225111307285,18598,18605,Southeast Colorado,Otero,8,89,Colorado,CO
08099,08CS022,110,108,111,148,37,38,40,384.16672092659826,18,179.92503123698458,1.9239243503546841,2.0416551996634813,2.1675885157895425,0.45647418431881964,133,132,135,181,46,48,49,396.2101008900761,22,183.40975406419344,1.9989136146498854,2.130155495439695,2.2538757611975,0.45337079702190386,12005,11995,Southeast Colorado,Prowers,8,99,Colorado,CO
08003,08CS023,135,128,142,140,-2,5,12,35.51417024635315,21,154.0530627216041,-1.7128614167149658,-1.1906997600381775,-0.6973361033922315,3.5951681100337294,167,159,176,187,11,20,28,118.57564951856247,26,157.38498789346247,-0.9230213080275513,-0.39713644584439034,0.1056015802422805,1.2628288045893445,16358,16520,Southwest Colorado,Alamosa,8,3,Colorado,CO
08007,08CS023,92,91,94,90,-4,-2,-1,-20.37015517470631,4,35.46099290780142,-0.6848943249768207,-0.564122682577144,-0.4406447181060117,-3.082249432249265,116,114,118,136,18,20,22,144.07933177524222,11,80.07570794205431,0.5196986449191123,0.6403035410470128,0.7683989970330721,0.5290451102646992,13536,13737,Southwest Colorado,Archuleta,8,7,Colorado,CO
08033,08CS023,23,22,24,21,-3,-2,-1,-97.10658812352762,8,417.2099087353325,-5.676748709512356,-5.152592938849719,-4.627723895855192,-9.280539759611141,29,28,30,47,17,18,19,762.9701757935959,7,293.13232830820766,4.211440695551972,4.677987671820981,5.2017424405777435,0.3642091123031534,2301,2388,Southwest Colorado,Dolores,8,33,Colorado,CO
08053,08CS023,9,9,9,2,-7,-7,-7,-1110.5257205291348,2,303.03030303030306,-14.251751208608042,-14.137066698607354,-14.019030493465369,-0.315982235046551,11,11,11,2,-9,-9,-9,-1193.888787420049,2,255.4278416347382,-14.62604941208301,-14.491178261568226,-14.366181009565452,-0.23957406016205196,792,783,Southwest Colorado,Hinsdale,8,53,Colorado,CO
08079,08CS023,11,10,11,7,-4,-4,-3,-493.05528511597396,7,980.1633605600932,-14.84991061768963,-14.729397026889673,-14.610330668081858,-2.7764154672394765,14,14,14,7,-7,-7,-7,-745.5611999914277,7,764.1921397379913,-15.222455451257957,-15.098654176720936,-14.974835640141745,-1.200821926531599,857,916,Southwest Colorado,Mineral,8,79,Colorado,CO
08091,08CS023,26,25,26,24,-2,-2,-1,-42.639634940280324,5,122.29922543823888,-1.7731408066941445,-1.6528327134154237,-1.5251336534098092,-6.727207873666879,33,32,33,32,-1,-1,-0,-16.177684954732907,8,159.64877270005988,-1.8755963420758208,-1.7548689659325138,-1.6307303930927604,42.25287983851195,4906,5011,Southwest Colorado,Ouray,8,91,Colorado,CO
08105,08CS023,114,113,115,142,27,28,29,293.68357263770343,6,62.68500783562598,2.1872913892691663,2.309372215779058,2.419540916153545,0.2061118156155336,140,138,141,174,33,34,36,300.1337977598054,28,245.03369213266825,0.41927812541528425,0.548762974920698,0.6771466351273147,0.7932845275734172,11486,11427,Southwest Colorado,Rio Grande,8,105,Colorado,CO
08111,08CS023,7,7,7,3,-4,-4,-4,-678.2394023255641,3,504.2016806722689,-12.330422441358118,-11.822460380921775,-11.330443199675548,-0.9882970984110406,9,8,9,5,-4,-4,-3,-519.4433694351814,5,684.931506849315,-12.520896377512573,-12.045967184648585,-11.547216671866796,-1.7908716142025605,714,730,Southwest Colorado,San Juan,8,111,Colorado,CO
08113,08CS023,24,23,25,24,-1,0,1,3.4106779896139345,2,29.725043349021547,-0.3806747131606897,-0.2630228528247652,-0.13729891060671223,1.6267016119448388,30,29,31,31,-0,1,2,9.392208991785044,1,12.390038409119068,-0.15540398949199294,-0.023673962107482422,0.09570319952613729,0.5688135930640837,8074,8071,Southwest Colorado,San Miguel,8,113,Colorado,CO
09001,09CS001,5892,5481,6303,7546,1243,1654,2065,207.90309006925884,1629,204.7725796652071,-0.5300879782125512,0.046127922632362345,0.5897089273616403,0.9843472876912238,7307,6812,7802,7409,-393,102,597,10.61651360898721,517,53.89891399422229,-0.9256651621467138,-0.4162777039771146,0.07575429420412172,5.027524137148533,954620,959203,Fairfield,Fairfield,9,1,Connecticut,CT
09003,09CS002,6958,6573,7344,8610,1266,1652,2037,220.9869845420579,1731,231.60805476886023,-0.6460419461252914,-0.11624319790932316,0.390196479016971,1.0474277897229831,8559,8096,9022,8844,-178,285,748,31.804849729182678,731,81.49286909525078,-0.9960313611469442,-0.5061503782915421,0.023815959987129216,2.5533282282737613,896860,897011,Hartford,Hartford,9,3,Connecticut,CT
09005,09CS003,1595,1516,1674,1890,216,295,374,192.05420305445665,249,162.1850472768327,-0.21134084714786702,0.30436157758050036,0.7701645346844775,0.8416210557160738,1966,1871,2062,2043,-19,77,172,41.45482719980233,143,77.30481884723919,-0.9023868332246263,-0.3731813279665106,0.16061101510502374,1.8407916440401784,184234,184982,Litchfield,Litchfield,9,5,Connecticut,CT
09007,09CS004,1350,1280,1421,1526,105,176,246,128.72183982221225,214,156.7689001758156,-0.7848140114140407,-0.24590722687863437,0.23866835882091647,1.2109970336406068,1668,1583,1753,1696,-57,28,113,17.081709164955672,134,81.39118181210786,-1.150945173128945,-0.6545258093424153,-0.1195537346848772,4.6012037922641404,163808,164637,Middlesex,Middlesex,9,7,Connecticut,CT
09009,09CS005,6757,6386,7128,8319,1191,1562,1933,217.45798659913854,1488,207.12046184522336,-0.4020715438072925,0.09590829446150491,0.6316726904204454,0.9518526913325108,8314,7868,8760,8576,-184,262,708,30.301864677365966,717,83.01772318394389,-1.0325924121486416,-0.5188927203774253,-0.03598600033830893,2.729261613838991,862107,863671,New Haven,New Haven,9,9,Connecticut,CT
09011,09CS006,2135,2020,2250,2348,98,213,328,95.41632386008376,274,122.71083460535107,-0.7595476355165091,-0.2752981780435619,0.29267167142054984,1.2800489481081392,2634,2495,2773,2954,181,320,459,119.12181215380846,243,90.42735297182239,-0.2346209273992552,0.29090052690558965,0.7970241405690187,0.7567526192548116,267947,268724,New London,New London,9,11,Connecticut,CT
09013,09CS007,925,861,990,1042,52,117,181,93.28767167543758,113,90.46392784234193,-0.4822109012773168,0.04916090172652489,0.5586145514132671,0.9614796741225365,1150,1073,1228,1280,52,130,207,86.28365467299777,87,57.923155280660986,-0.21388634666682196,0.28865443356929416,0.7840518097857216,0.6661705534658968,149894,150199,Tolland,Tolland,9,13,Connecticut,CT
09015,09CS008,927,877,977,1084,107,157,207,161.64737919051709,84,86.63366336633663,0.22290898707614537,0.7512513362814571,1.2414941900408112,0.5325444950776808,1142,1082,1203,1242,39,100,160,85.49899267074203,147,126.29734002336932,-0.9266449913445111,-0.4086455688766655,0.09917471911014762,1.462483019369375,116352,116392,Windham,Windham,9,15,Connecticut,CT
10001,10CS001,1441,1363,1520,1740,220,299,377,196.71920195481326,191,125.6978644525123,0.18170898919995862,0.7032375556641273,1.23126811978954,0.6368405113391317,1785,1690,1880,2234,354,449,544,244.10446737223023,250,135.96340952722804,0.5460517512583909,1.0674612018869412,1.6109727891879035,0.5557504297014246,182342,183873,Kent,Kent,10,1,Delaware,DE
10003,10CS002,4182,3937,4427,4893,466,711,956,149.82250304970128,499,105.19122563236824,-0.08106483155185425,0.4492834665915135,0.9429873581739006,0.7011191558677489,5169,4874,5465,5717,252,548,843,95.79140703568626,523,91.50331371464964,-0.4646804358634506,0.03509620151457489,0.5767213844775064,0.9534935825762355,569249,571564,New Castle,New Castle,10,3,Delaware,DE
10005,10CS003,2364,2261,2467,2784,317,420,523,210.53033648726932,318,159.4831008931221,0.04191478874360061,0.5069326294247816,0.992260826749123,0.7557299839160205,2970,2843,3097,3314,217,344,471,139.78373848293688,338,137.2471789207824,-0.46114290716834033,0.009506221806346667,0.505971548983086,0.9790097681518514,239273,246271,Sussex,Sussex,10,5,Delaware,DE
11001,11CS001,4163,3867,4459,5284,825,1121,1417,194.75622398864553,831,144.38488736762545,-0.01792247573828609,0.5120369070734083,1.0136896756108147,0.7407013176465145,5018,4671,5366,5828,462,810,1157,120.32169909550123,463,68.79919402412875,-0.002982063761545471,0.5009861712266803,1.0381310858907051,0.5710884571137013,690654,672973,District of Columbia,District of Columbia,11,1,District of Columbia,DC
12001,12CS001,1746,1626,1865,1931,66,185,305,80.13911389692458,133,57.53403917073118,-0.28360981653879924,0.23397238074239743,0.7138504646114338,0.7140725428550252,2165,2021,2309,2438,129,273,417,97.6961769153568,290,103.8841941989633,-0.6033623191393549,-0.06756256726191412,0.4673933241437021,1.0594547111285075,277401,279157,Alachua,Alachua,12,1,Florida,FL
12003,12CS002,223,210,235,257,22,34,47,144.8881695403891,36,151.6108654453569,-0.5397673112045784,-0.06681403830995021,0.450341043441176,1.016842991337317,275,261,290,368,78,93,107,323.19576924320404,80,279.17364600781684,-0.0854143626611684,0.43848154419178453,0.9316846148466985,0.8545640912649479,28494,28656,Baker+Bradford+Union,Baker,12,3,Florida,FL
12007,12CS002,281,268,293,294,1,13,26,56.49637715666684,20,84.56659619450316,-0.7869371375355454,-0.28420187175806866,0.24449465520673014,1.392622548863125,345,330,359,408,49,63,78,222.44091793584903,87,305.1132776881532,-1.3349679068934899,-0.8089784604516916,-0.3278669113107455,1.350369651906621,28380,28514,Baker+Bradford+Union,Bradford,12,7,Florida,FL
12125,12CS002,217,210,224,259,35,42,49,317.7187288327154,58,434.5925694661255,-1.6684979831689035,-1.1724455300089796,-0.6416945283557295,1.3363374192743347,267,259,276,249,-27,-18,-10,-111.66315493743967,27,165.5933762649494,-3.27694186267195,-2.7882092357224146,-2.2239251784445613,-1.5691582606359429,16015,16305,Baker+Bradford+Union,Union,12,125,Florida,FL
12005,12CS003,1584,1508,1659,1811,152,227,303,156.06981233563226,179,122.8348077703881,-0.16968038335739874,0.335340383624427,0.85943079463101,0.7836049413209272,1980,1887,2072,2549,477,569,662,319.03136561862226,420,235.3178471778667,0.3185212785450724,0.8079935724890653,1.3516339206971533,0.7363078790405777,174869,178482,Bay,Bay,12,5,Florida,FL
12009,12CS004,6515,6253,6777,7028,251,513,775,101.27943660789056,478,94.35964249934611,-0.44653422543942767,0.056888999381667936,0.6030477947240641,0.9298638083536965,8050,7732,8368,9279,911,1229,1547,199.73850117145034,1073,174.36635785566756,-0.2763033496066614,0.2601179015216775,0.7476102435947095,0.8722635389403992,607887,615371,Brevard,Brevard,12,9,Florida,FL
12011,12CS005,12919,12084,13753,15293,1540,2374,3209,146.68062073580154,1736,107.24578291171888,-0.12951854291733195,0.42022931257463997,0.9789280391715942,0.7308438745925308,15845,14847,16843,18771,1928,2926,3924,151.42060979069745,2673,138.3168807137213,-0.38983235294849533,0.1414358425796046,0.6491282593985013,0.9131493337662898,1942454,1932519,Broward,Broward,12,11,Florida,FL
12015,12CS006,2341,2260,2422,2695,273,354,435,224.86121729585088,245,155.61648476122926,0.15349411925316372,0.692214651333985,1.194656685135381,0.690106334264676,2923,2823,3023,3342,319,419,519,216.26901839576,388,200.16611724162837,-0.32795943020819013,0.16550648859250072,0.6678945332133591,0.9233397141233577,188926,193839,Charlotte,Charlotte,12,15,Florida,FL
12017,12CS007,2327,2261,2394,2726,332,399,465,310.43245355899444,204,158.7888458619549,0.9874609759674164,1.5103384993780737,2.0316339932645566,0.5102291772177548,2884,2802,2965,3563,598,679,761,431.1406127226112,478,303.4034504208295,0.7692878412877194,1.3006154708859339,1.7827945723975585,0.7026882193346564,154167,157546,Citrus,Citrus,12,17,Florida,FL
12019,12CS008,1600,1506,1694,1861,167,261,355,142.8183080445035,148,81.02189781021897,0.09952163454326259,0.6223956902047247,1.109584391704325,0.565141227561432,1993,1879,2108,2768,660,775,889,349.2270534519435,476,214.568091561073,0.819822024213149,1.356639956997936,1.8690369028227491,0.613616521107881,219200,221841,Clay,Clay,12,19,Florida,FL
12021,12CS009,2963,2800,3126,3412,286,449,612,142.12805238046676,318,100.6077064026681,-0.06550368751546805,0.424414054729004,0.9377849834549088,0.7062944282141179,3700,3501,3898,4462,564,762,961,198.17491069751142,498,129.45757794749952,0.1375325528814927,0.6884218171160027,1.1999565900206404,0.6523933055223778,379295,384682,Collier,Collier,12,21,Florida,FL
12023,12CS010,688,657,718,813,95,125,156,214.40669680084852,96,164.0698436209303,-0.015520351163922995,0.507566422822678,1.032183446897817,0.7591757555689945,845,808,881,1137,256,292,329,415.6103812462026,178,253.15375535107307,1.0987234642321773,1.6244154967195408,2.160494399363961,0.6070358993154907,70214,70313,Columbia,Columbia,12,23,Florida,FL
12027,12CS011,288,273,303,374,71,86,101,296.88087246933327,55,190.42123485285632,0.5575278373350757,1.071489317728432,1.5848694700138473,0.6340123998199876,354,336,371,470,99,116,134,338.6457703959968,78,227.0081490104773,0.6234846613640533,1.117049953936254,1.6243192368762556,0.6646291142813214,34660,34360,DeSoto+Hardee,DeSoto,12,27,Florida,FL
12049,12CS011,182,171,193,217,24,35,46,162.93878259705886,21,98.66102889358703,0.12134528921529815,0.649899706017932,1.1767767867789867,0.5885399521406626,225,212,238,352,114,127,140,500.9294117388552,74,291.23538903538116,1.5888681949470678,2.083265776434068,2.5735460444072396,0.576857921531153,25542,25409,DeSoto+Hardee,Hardee,12,49,Florida,FL
12029,12CS012,193,186,201,212,11,19,26,132.29879390895525,14,99.7150997150997,-0.19335711403996317,0.31104008944301126,0.8431794268765813,0.7152070664768622,239,230,247,313,66,74,83,436.4469660127287,50,293.100416202591,0.942974360822314,1.45437140146327,1.9331961300736842,0.6626598898249351,16848,17059,Dixie+Gilchrist+Levy,Dixie,12,29,Florida,FL
12041,12CS012,173,166,181,191,10,18,25,117.42333919791348,13,86.34527038246526,-0.1522119419509459,0.29576867701368953,0.8213237845897295,0.6959664157725757,215,205,224,301,77,86,96,471.22605970971784,42,229.5458271847844,1.9447230877037294,2.408230242472288,2.8963595216280376,0.48153964931135274,18067,18297,Dixie+Gilchrist+Levy,Gilchrist,12,41,Florida,FL
12075,12CS012,496,478,515,552,37,56,74,156.09210841808627,30,83.8027841147167,0.20740177859212727,0.7175360097042521,1.2139865840333532,0.5274412447256425,617,595,640,757,117,140,162,317.5066648251648,111,252.28992885878583,0.132916263155679,0.6581490347660329,1.1511432049264694,0.7889495471885793,42958,43997,Dixie+Gilchrist+Levy,Levy,12,75,Florida,FL
12031,12CS013,7557,7130,7985,8614,629,1057,1484,127.9091126723624,709,85.8164770056626,-0.05307823511887695,0.41563851816390196,0.9295372129308599,0.6702833359892095,9358,8842,9874,11537,1663,2179,2695,217.9958211405863,1831,183.20699288384418,-0.1696936136303194,0.3411747640333212,0.8624225329313696,0.8400295926777656,991418,999416,Duval,Duval,12,31,Florida,FL
12033,12CS014,3012,2874,3151,3586,435,574,712,213.7597959870015,327,121.87243769721965,0.4316531589074768,0.9069851695977128,1.4228539321653648,0.5691449956724821,3700,3533,3866,4583,717,883,1050,273.92957589430046,557,172.769428806278,0.4921146416329849,1.0134208034892236,1.5320285280703172,0.6299941056430515,321976,322395,Escambia,Escambia,12,33,Florida,FL
12035,12CS015,1225,1174,1275,1360,85,135,186,139.60939527998406,53,54.63260432594018,0.2963137639674275,0.857973415095238,1.3690058551360365,0.3884565342048794,1548,1486,1610,1844,234,296,358,246.13392065120206,221,183.84799680553706,0.11468502228309845,0.6279723256593264,1.1407723788128263,0.7444269119166996,116414,120208,Flagler,Flagler,12,35,Florida,FL
12039,12CS016,386,367,405,481,76,95,114,258.7225201119201,54,147.30620595589906,0.625427384750038,1.1210708741117503,1.6468095048956615,0.5634192899907191,473,450,495,664,169,191,214,437.59238488701897,96,219.61932650073206,1.6606510694370062,2.1961106662811845,2.711403488739533,0.4992708999300184,43990,43712,Gadsden+Leon,Gadsden,12,39,Florida,FL
12073,12CS016,1665,1539,1791,2057,266,392,518,160.65747181000555,158,64.78928106451248,0.44433634156654045,0.9663978077641067,1.466889191935361,0.4022491736410517,2073,1922,2224,2572,348,499,650,170.36221145328048,309,105.54972963556308,0.08784396787035396,0.6459184339833552,1.1876205794478516,0.6183209272396959,292641,292753,Gadsden+Leon,Leon,12,73,Florida,FL
12043,12CS017,100,99,101,129,28,29,30,281.3340521510221,16,154.36565364206464,1.1552093416818683,1.2720943421681523,1.385652728707574,0.5304991503677114,121,119,122,167,45,46,48,379.18926527365414,16,130.86864060199576,2.356274471151388,2.486566243581807,2.6083069318271734,0.3378401235919453,12438,12226,Glades+Hendry+Okeechobee,Glades,12,43,Florida,FL
12051,12CS017,261,244,279,315,36,54,71,160.23856853053172,51,152.56138601520627,-0.4421781503358104,0.07932950738095447,0.5539390279050905,0.9346407871356017,325,304,346,480,134,155,176,385.8801954608643,79,196.3952765692977,1.3712348748167704,1.8817627853009256,2.3910072002010647,0.5056960948020827,40115,40225,Glades+Hendry+Okeechobee,Hendry,12,51,Florida,FL
12093,12CS017,384,367,401,467,66,83,100,248.081373606551,55,164.70764393202066,0.29689762694425037,0.8437966164491413,1.3436152670862802,0.6560069694286788,473,452,494,657,163,184,205,458.0763388934902,103,256.37834474175486,1.5404890651490435,2.0160747652399524,2.5137379471849557,0.556659960659301,40071,40175,Glades+Hendry+Okeechobee,Okeechobee,12,93,Florida,FL
12047,12CS018,138,132,144,176,32,38,44,321.00406415553715,19,162.17369656447826,1.1142394344434317,1.5897038772288508,2.074106199603047,0.4921221456063207,169,162,177,226,49,57,64,405.1106938365734,33,235.84905660377356,1.1879984264489802,1.6950646683180028,2.22307893412139,0.5720914219934171,14059,13992,Hamilton+Lafayette+Suwannee,Hamilton,12,47,Florida,FL
12067,12CS018,67,66,68,97,29,30,31,430.81373217226167,16,231.7441158720579,1.8677468747589412,1.9908599971891368,2.110660780650769,0.520425089462365,84,83,85,118,33,34,35,410.82152938793325,22,263.06349396149704,1.3514402191941117,1.4794204556046069,1.6008587641029217,0.6222246570212698,8285,8363,Hamilton+Lafayette+Suwannee,Lafayette,12,67,Florida,FL
12121,12CS018,486,467,505,587,82,101,120,276.8360242079087,71,194.76956839795167,0.2999198194359264,0.8234522515841821,1.3438907379167133,0.6966524272718371,603,580,626,785,159,182,205,409.62237470361896,161,363.0787271948222,-0.05069953518355562,0.46260544404218135,1.0042871922377137,0.8815211021069134,43744,44343,Hamilton+Lafayette+Suwannee,Suwannee,12,121,Florida,FL
12053,12CS019,2450,2365,2534,2676,142,226,311,138.60123196284476,203,124.37137824521992,-0.41776126518070433,0.1511217922583542,0.6165987719897744,0.893383342266388,3043,2940,3146,3688,542,645,748,322.77227907846924,557,278.6532592926109,-0.09567933531453704,0.44357487006382174,0.9133110778798973,0.8619762353674066,195865,199890,Hernando,Hernando,12,53,Florida,FL
12055,12CS020,1332,1289,1376,1582,206,250,293,293.2393973726852,185,217.39343315151928,0.25752110507146675,0.7392951261551363,1.2660125701015161,0.7383924207480327,1644,1591,1697,2130,433,486,539,471.7461446042087,284,275.7442181097928,1.438420279010978,1.952024196808435,2.4851277711644855,0.5833176602286975,102119,102994,Highlands,Highlands,12,55,Florida,FL
12057,12CS021,9337,8707,9968,10901,933,1564,2194,127.91412219447466,945,77.30978316446532,-0.016181977687035862,0.5002242466308289,1.0125964956578344,0.6040018793192099,11589,10827,12351,14310,1959,2721,3483,184.36404239876663,1769,119.8481877788723,0.1337145387381343,0.6428376943776075,1.1663376153792393,0.6498239093919883,1466826,1476034,Hillsborough,Hillsborough,12,57,Florida,FL
12059,12CS022,239,230,247,286,39,47,56,289.0631821600829,28,171.03588699414607,0.6641836014088619,1.1744714351780692,1.6847609487401292,0.579445594069406,294,284,304,362,58,68,78,344.3714430538885,47,237.85425101214577,0.5782073425479713,1.054511416219584,1.5750366992357705,0.6806878994218118,19645,19760,Holmes+Walton,Holmes,12,59,Florida,FL
12131,12CS022,637,604,670,665,-5,28,61,44.32438935093928,49,77.32568843533836,-0.8134644046069539,-0.3447018403373109,0.183578979584521,1.6845650678418145,820,779,861,892,31,72,113,90.82971616782207,127,159.84091423968584,-1.1977743771410685,-0.6759652240947941,-0.16532023846635546,1.7357351992531023,76042,79454,Holmes+Walton,Walton,12,131,Florida,FL
12061,12CS023,1823,1754,1892,2023,131,200,269,149.16596108682893,141,105.35360705346136,-0.056879183969252733,0.42023632776943004,0.94998234510803925,0.7027642818625894,2259,2175,2344,2716,372,457,541,279.9028985474968,358,219.39232004314306,0.09332320902303622,0.6012687501147076,1.1070793612743766,0.7821034598325975,160602,163178,Indian River,Indian River,12,61,Florida,FL
12063,12CS024,539,519,559,666,107,127,147,323.8244191651971,102,259.7402597402597,0.15866958582403487,0.6474885960604299,1.1789004410838342,0.7958438263593118,668,643,692,761,69,93,118,195.85687660924395,99,207.8783806484126,-0.5998575164036144,-0.10426675431465451,0.3915395892034434,1.0501206804816416,47124,47624,Jackson+Washington,Jackson,12,63,Florida,FL
12133,12CS024,294,283,305,299,-6,5,16,24.280494988076164,22,103.90428211586901,-1.3352563717222774,-0.8262360250699343,-0.2880931558290432,3.5824841764471476,361,348,374,418,44,57,70,223.30437008208733,62,243.86406544996856,-0.7383800243205207,-0.20518654676831638,0.31523927811189956,1.0731674665317736,25408,25424,Jackson+Washington,Washington,12,133,Florida,FL
12065,12CS025,154,148,160,184,24,30,36,246.43918343939026,13,107.44541635098835,0.9023264764603217,1.4061726480381254,1.9013730012847383,0.42184388724876365,188,181,196,225,29,37,44,253.23255548095787,32,219.84061555372355,-0.17363274669542103,0.32130936295110885,0.8237619744480577,0.8452073794075561,14519,14556,Jefferson+Madison+Taylor,Jefferson,12,65,Florida,FL
12079,12CS025,193,185,201,273,72,80,88,528.8430209407626,38,251.9476214155478,2.234257807231928,2.7833791880585212,3.2961626131486685,0.47051395158050996,238,228,247,303,56,65,75,358.061406787962,51,279.5746080473632,0.23544963320963172,0.7885084533787372,1.285547651122743,0.7690270660675183,18099,18242,Jefferson+Madison+Taylor,Madison,12,79,Florida,FL
12123,12CS025,221,211,230,284,54,63,73,350.4478447037073,31,171.16826945198545,1.2628776065150544,1.7931744688323112,2.3296303142945356,0.480851074824753,270,258,281,330,49,60,72,276.79262115175584,49,224.69849131012978,0.02386085576673635,0.5425755948530104,1.024251182756966,0.7985636689058854,21733,21807,Jefferson+Madison+Taylor,Taylor,12,123,Florida,FL
12069,12CS026,4023,3857,4189,4366,177,343,509,107.23209818353492,292,91.21484427876756,-0.36242341110555193,0.14857000143895302,0.7019359120242377,0.8481592561101182,5027,4823,5230,5756,526,729,933,184.945914760233,778,197.28367262067778,-0.6443720352968064,-0.14706153932505056,0.39447475936647913,1.0652495300927751,384148,394356,Lake,Lake,12,69,Florida,FL
12071,12CS027,6371,6041,6702,7250,548,879,1209,137.2368425773493,599,93.56792135504261,-0.05744796347983171,0.43541577527487524,0.9715182194279733,0.6810236887843554,7978,7573,8383,9408,1025,1430,1835,182.21247590961062,1019,129.87857182004615,0.004920207975101811,0.5243139544389392,1.042545679904553,0.712288141304434,768212,784579,Lee,Lee,12,71,Florida,FL
12013,12CS028,149,143,155,180,25,31,37,274.4785527460802,20,175.25923762231633,0.5151431807154533,0.9984059200651397,1.517093202740745,0.618762535050674,182,175,189,239,50,57,64,414.754633751321,42,307.9856273373909,0.5730625644542733,1.0774317795489425,1.587652554924924,0.7296722509363258,13694,13637,Liberty and Nearby Counties,Calhoun,12,13,Florida,FL
12037,12CS028,138,133,143,143,-0,5,10,46.92990999702231,5,48.31695925269769,-0.5394500856203845,2.5709506819924057e-4,0.4972006159320494,0.8537575592044959,171,165,178,205,27,34,40,268.45036648041594,38,302.668259657507,-0.8408702231044708,-0.3351827322151312,0.14740508558780568,1.0949764250071614,12418,12555,Liberty and Nearby Counties,Franklin,12,37,Florida,FL
12045,12CS028,154,148,160,197,37,43,49,362.6339915806509,22,187.23404255319147,1.2373313530370111,1.7441832221506877,2.3033107936666837,0.5044773047490241,192,185,200,242,42,50,57,346.40071346785675,32,223.2142857142857,0.7240127768628333,1.2415776915042605,1.7256913943992114,0.6316619824600169,14100,14336,Liberty and Nearby Counties,Gulf,12,45,Florida,FL
12077,12CS028,60,59,61,78,17,18,19,273.8066013913714,15,224.43890274314214,0.3815764296948304,0.49204318031232364,0.6195692936059579,0.7772259184881986,73,72,74,117,43,44,45,558.2596748497201,17,214.89065857666537,3.322167999186148,3.433502384144671,3.552995295774214,0.37640662982624423,8020,7911,Liberty and Nearby Counties,Liberty,12,77,Florida,FL
12129,12CS028,263,248,277,321,44,58,73,206.57330272612268,30,106.04141506377212,0.4839796018161723,1.0022469610317006,1.5112680463197699,0.5046995197952947,332,314,349,414,65,82,100,238.38941426489205,60,173.53077279037484,0.1666282724096727,0.6703673280426554,1.1663589250062605,0.7192043539219075,33949,34576,Liberty and Nearby Counties,Wakulla,12,129,Florida,FL
12081,12CS029,3636,3462,3809,4106,297,470,644,140.14267848370218,379,112.89842120941317,-0.2503976532982615,0.27173579276786497,0.7523962308917279,0.8038875549608866,4541,4329,4753,5302,549,761,973,185.12314338919546,694,168.83138998834724,-0.2865235682283763,0.17027235979577998,0.6797256790612873,0.9107981551975199,402840,411061,Manatee,Manatee,12,81,Florida,FL
12083,12CS030,4620,4458,4782,5251,469,631,793,201.0818851859423,441,140.51969984227378,0.10117478847946973,0.6067544018516933,1.117295469177748,0.6977126825619303,5742,5544,5941,7072,1131,1330,1528,345.6252408055069,1110,288.5597747673974,0.06970867113724398,0.588301666740429,1.0855684473178195,0.8342645795705607,376602,384669,Marion,Marion,12,83,Florida,FL
12085,12CS031,1646,1578,1715,1995,280,349,417,262.9700295909514,167,125.98464797852478,0.8362140634172321,1.3605233405204005,1.9115269073502663,0.477713227435164,2020,1938,2103,2462,359,442,524,276.4729690263081,225,140.85741473431162,0.8608162079205628,1.3597075525361602,1.8773051894942117,0.5083288417766698,159067,159736,Martin,Martin,12,85,Florida,FL
12086,12CS032,17029,15872,18186,22009,3823,4980,6137,221.96194271634505,3655,162.9175086176156,0.09505467941349015,0.6053410148614095,1.0674450215096694,0.7338411102517697,20833,19456,22210,26100,3890,5267,6644,197.4835252827433,4101,153.76216768287424,-0.10120414943360959,0.45671153027480516,0.9533647090599306,0.7784597729350561,2692160,2667106,Miami-Dade,Miami-Dade,12,86,Florida,FL
12087,12CS033,657,622,693,662,-31,5,40,6.9403236734302265,40,58.9369252114976,-1.027917869964889,-0.501036322572904,0.006545779865499798,7.004837034727021,806,764,849,855,6,49,91,59.38403872869845,56,68.07434691173432,-0.6193678324205857,-0.07654700732248881,0.3966323541357274,1.1233455076133967,81443,82263,Monroe,Monroe,12,87,Florida,FL
12089,12CS034,832,793,871,901,30,69,108,90.88356456062665,67,88.37689889418955,-0.5243922500634358,0.013904535804316893,0.522677026867613,0.958507429131022,1047,999,1095,1209,114,162,210,172.7316939517786,169,180.3185984230125,-0.5926093680612106,-0.07183325623753216,0.43824294589861207,1.0375142720861306,90974,93723,Nassau,Nassau,12,89,Florida,FL
12091,12CS035,1619,1528,1710,1896,186,277,368,156.9053034346453,200,113.25990316278279,-0.07788929175891915,0.46077751822535973,0.9465784462938771,0.7192401743596559,1998,1888,2108,2362,254,364,474,170.72277200316395,305,143.16291470306604,-0.209053932545815,0.2531995750033049,0.8315427793333112,0.836270281691223,211902,213044,Okaloosa,Okaloosa,12,91,Florida,FL
12095,12CS036,7361,6748,7974,8379,405,1018,1631,85.7847278630874,745,62.775652877322756,-0.31022859652165624,0.22366664710302062,0.7575633383079121,0.7310631291132728,9130,8395,9865,10777,912,1647,2382,115.67666850121924,1451,101.9111680171711,-0.4032000562066336,0.12468335306624985,0.6662319894055342,0.8804656092164307,1424119,1423789,Orange,Orange,12,95,Florida,FL
12097,12CS037,2216,2048,2384,2531,147,315,483,97.05544822193849,276,84.98496340925186,-0.41718073941995754,0.10778873847881316,0.6520547212185126,0.8728638705349232,2820,2613,3028,3533,505,713,920,177.48892648966344,605,150.69619149625126,-0.30917093323305095,0.2620514055308466,0.7666741485342142,0.8478557319307621,389716,401470,Osceola,Osceola,12,97,Florida,FL
12099,12CS038,12653,12011,13296,14606,1310,1953,2595,156.86328641949387,1572,126.28035926708657,-0.19807848667805106,0.3014995624022395,0.8150793957935454,0.8046224582398646,15533,14760,16306,17803,1497,2270,3043,151.5972094372811,1994,133.18354081200548,-0.32624136139871207,0.18396635053543778,0.66122855128384606,0.8781486669275894,1493819,1497182,Palm Beach,Palm Beach,12,99,Florida,FL
12101,12CS039,5677,5433,5921,6147,226,470,714,99.6548311721983,352,74.6362279020046,-0.2640421049694537,0.24393526929387496,0.7504165195394084,0.7473572663114414,7113,6812,7413,8130,717,1017,1318,175.00190830309523,1049,180.42810825686496,-0.5785875138239767,-0.04677688587914927,0.4378153523853431,1.0299941920481854,565945,581395,Pasco,Pasco,12,101,Florida,FL
12103,12CS040,10071,9658,10484,11173,689,1102,1515,137.59400955163824,747,93.28249485926456,-0.08345413359321921,0.4539880105781022,0.9880192144008708,0.6773398896906239,12269,11775,12763,13923,1160,1654,2148,172.87171131638164,1235,129.05895643032332,-0.062297192430892864,0.4243780959645787,0.9334481117519784,0.7461081183838987,960952,956927,Pinellas,Pinellas,12,103,Florida,FL
12105,12CS041,6284,5969,6599,7210,611,926,1241,151.98074143111538,718,117.84320671388966,-0.15118889500130028,0.34950892284368884,0.9053252889608121,0.7745460488199034,7888,7501,8276,9804,1528,1916,2303,255.4129800757761,1555,207.33941528951516,0.005860755908748604,0.4611644843661218,0.9671912337656987,0.8113574770463576,731141,749978,Polk,Polk,12,105,Florida,FL
12107,12CS042,854,823,886,994,108,140,171,227.91842437523056,71,115.80335177306893,0.558684744310249,1.1170776067160384,1.625251520270026,0.5044810518608037,1050,1012,1089,1489,400,439,477,592.4529393495957,265,357.8808054343863,1.8153265193709458,2.346919837659711,2.844571055176931,0.6026923819780313,73573,74047,Putnam,Putnam,12,107,Florida,FL
12109,12CS043,1920,1801,2040,1984,-56,64,183,27.63182458060963,101,43.784861709199156,-0.66480777432271,-0.17474957567072844,0.3628721022419206,1.560104553563597,2465,2315,2615,2677,62,212,362,72.95094511506288,300,103.37769385040559,-0.8025820256903177,-0.30391345441076784,0.22429590849737613,1.410422755302129,276808,290198,St. Johns,St. Johns,12,109,Florida,FL
12111,12CS044,2952,2809,3095,3405,310,453,596,163.52581790608426,362,130.808701308087,-0.18661733423638513,0.31623175024223255,0.8368446808855255,0.798163169066189,3718,3541,3894,4440,546,722,899,211.38474687865082,522,152.72759190719313,0.0728100934265945,0.5639055396742048,1.090026498393705,0.721511335245088,332088,341785,St. Lucie,St. Lucie,12,111,Florida,FL
12113,12CS045,1426,1344,1507,1572,65,146,228,92.87416870435534,130,82.5497282738111,-0.3975625057393317,0.097493059247029,0.6243585578720791,0.8827982460204716,1796,1696,1896,2097,201,301,401,155.72339389433483,332,171.76352508420032,-0.6966291471096944,-0.16720188315480522,0.30882835058428054,1.0993516146467661,188977,193289,Santa Rosa,Santa Rosa,12,113,Florida,FL
12115,12CS046,5035,4847,5223,5783,560,748,936,205.5113171814933,387,106.32963560806401,0.47932065041633853,0.9883320439241234,1.5196194793433409,0.5166998680445322,6258,6028,6488,7121,633,863,1093,193.6613735684331,682,153.12216544378484,-0.11738175694796833,0.4024838914950125,0.8844585057923703,0.7897540309670558,436755,445396,Sarasota,Sarasota,12,115,Florida,FL
12117,12CS047,3033,2830,3235,3358,123,325,528,82.87053787787117,248,63.17612893364808,-0.3091183959660968,0.19679074730171953,0.683615529568313,0.7600110180726649,3736,3493,3978,4398,420,662,905,140.87361917028645,530,112.7098423338168,-0.24751935646576362,0.29955747950579353,0.7847862625143629,0.7988717466563122,471064,470234,Seminole,Seminole,12,117,Florida,FL
12119,12CS048,1704,1647,1760,2017,257,313,370,285.1033570166248,117,106.51695622486913,1.2744855859154913,1.7709966300891544,2.2779881630271,0.37241899424230596,2130,2060,2199,2742,543,612,682,453.72242913729696,320,237.13013257056474,1.6572779633673937,2.1776890403478193,2.652023460431406,0.5217804136603547,131810,134947,Sumter,Sumter,12,119,Florida,FL
12127,12CS049,6297,6058,6536,6918,382,621,860,134.1052926166772,402,86.79849578062868,-0.04159057918627313,0.4784314350400396,0.992699913935228,0.6462009704239194,7779,7488,8069,9312,1243,1533,1824,272.3238111298838,1137,201.9448514719595,0.2006108296876752,0.709234070166845,1.2581666035033439,0.7410781534554972,555770,563025,Volusia,Volusia,12,127,Florida,FL
13001,13CS001,177,169,185,232,47,55,63,360.1077622101906,48,312.5508709099788,-0.014386460245598726,0.45933072119624613,1.0402821301986134,0.8525217389816452,216,207,226,269,43,53,62,286.3353909198877,58,313.8697981492505,-0.7736963464899785,-0.29290431284097135,0.2509811398666803,1.0758289325975976,18429,18479,Appling+Jeff Davis+Long+Wayne,Appling,13,1,Georgia,GA
13161,13CS001,146,140,152,186,34,40,46,324.391987298509,26,210.32762572468653,0.6280697427759212,1.1422887844678622,1.639969375468645,0.6325994635349422,178,171,186,216,30,38,45,253.12795880592682,35,235.56333288464126,-0.3188163641210667,0.17323623695875384,0.7110898685477715,0.9065067263777568,14834,14858,Appling+Jeff Davis+Long+Wayne,Jeff Davis,13,161,Georgia,GA
13183,13CS001,80,78,82,105,23,25,27,177.74616344203125,4,28.457935613920668,1.3769999615716428,1.4955295001927724,1.6059292427663783,0.15394263745453482,99,97,102,149,47,50,52,291.22223588358963,29,170.32773405380007,1.0851475865648261,1.2049158828388908,1.3293744406921126,0.5733095023976843,16867,17026,Appling+Jeff Davis+Long+Wayne,Long,13,183,Georgia,GA
13305,13CS001,299,286,312,336,24,37,50,146.27616302904948,40,159.16174812653358,-0.6654536472252349,-0.13051287419020902,0.3823655098576406,1.0592760915779387,367,351,383,512,129,145,161,478.0292366994643,103,339.40751968893136,0.8464977181582232,1.3858658992593131,1.9282113444904587,0.7051532826254152,30158,30347,Appling+Jeff Davis+Long+Wayne,Wayne,13,305,Georgia,GA
13005,13CS002,127,122,132,146,14,19,24,205.76070518120514,25,269.9055330634278,-1.1802144160215844,-0.6661821101832441,-0.14063106578102863,1.2463491120833008,155,149,160,185,25,30,36,274.6067252183233,40,360.8479927830401,-1.3525415909888507,-0.861323965244037,-0.3395976690624777,1.2722583389305637,11115,11085,Bacon+Ben Hill+Coffee+Irwin,Bacon,13,5,Georgia,GA
13017,13CS002,195,188,202,267,65,72,79,504.9811111814387,50,351.1030487448066,1.0109217162034139,1.545808166088815,2.033511082982821,0.6857438934725993,239,230,248,287,39,48,57,281.2383379765015,39,227.312467214548,0.04058234449068969,0.541682212465473,1.0441043084518007,0.7918450252867701,17089,17157,Bacon+Ben Hill+Coffee+Irwin,Ben Hill,13,17,Georgia,GA
13069,13CS002,362,343,380,479,99,117,136,326.8008043571367,94,261.61981630949066,0.15733808680078912,0.645398853450759,1.1477233676655074,0.7937879907934687,446,424,469,551,82,105,127,241.22201719265183,113,260.74716754736136,-0.7365123046059714,-0.18715384490075554,0.32198615698646643,1.0707004789532462,43116,43337,Bacon+Ben Hill+Coffee+Irwin,Coffee,13,69,Georgia,GA
13155,13CS002,99,99,100,121,21,22,22,268.61591995275893,18,224.74248257205284,0.32120806839515653,0.44276238596094125,0.5661996517939457,0.7995061993083525,122,121,123,155,32,33,34,341.25239600791593,27,280.60694242361257,0.4774293341576369,0.606533837440001,0.7306728324576075,0.7979830406728016,9611,9622,Bacon+Ben Hill+Coffee+Irwin,Irwin,13,155,Georgia,GA
13011,13CS003,153,145,161,168,7,15,23,100.20953044143414,18,118.14899901542502,-0.7043666661192017,-0.1940050200266944,0.34771001088102516,1.1065400105327767,190,180,199,268,69,78,88,422.659954598535,41,221.7414818820984,1.5312995957570035,2.0230148422900904,2.5286236851072132,0.5180049316150429,18282,18490,Banks+Habersham,Banks,13,11,Georgia,GA
13137,13CS003,409,389,429,508,79,99,119,256.85235723600175,74,192.6539821664895,0.11927011844926713,0.6393703489070756,1.1087214181297709,0.7425310593054503,507,483,531,608,77,101,125,216.7437039800568,94,201.38829376981747,-0.3829237507452199,0.14443890044612775,0.6673166554485006,0.9200596280059056,46093,46676,Banks+Habersham,Habersham,13,137,Georgia,GA
13013,13CS004,567,530,603,619,16,52,89,74.51768445428843,55,78.39597092222168,-0.5518288941473667,-0.03284168400268454,0.493841074769096,1.0322992646453586,716,672,761,889,128,173,217,200.44101340469948,114,132.150930272996,0.16479819443193894,0.6712309099497081,1.1854374379187953,0.6555098121769267,84188,86265,Barrow,Barrow,13,13,Georgia,GA
13015,13CS005,816,769,863,1038,175,222,269,243.68204932197023,119,130.71656109260005,0.6288343373826294,1.1301696356477096,1.6659014965038308,0.5340154012160924,1018,961,1075,1338,263,320,377,288.9869499846984,182,164.5272102693907,0.7337899682737411,1.2702723566992924,1.7564465879527966,0.5675486342045873,109244,110620,Bartow,Bartow,13,15,Georgia,GA
13021,13CS006,1498,1430,1565,1827,262,329,397,252.50884132143796,199,152.58980945443392,0.4907057879888579,0.9940206928029743,1.548305442984005,0.6024654361669743,1835,1754,1916,2317,401,482,563,307.08678773094294,332,211.71849093181643,0.4658477354486043,0.9701657988490742,1.4705525792797702,0.6880131255067137,156498,156812,Bibb,Bibb,13,21,Georgia,GA
13023,13CS007,134,129,139,175,36,41,46,390.11331198987614,30,285.01306309872535,0.5448078499882862,1.0553238212234612,1.5666939259668629,0.7132213667177376,163,157,170,197,27,34,40,266.007339883345,43,341.1886058874871,-1.2471711907907301,-0.7503152988820193,-0.23076993633071152,1.2454777194414666,12631,12603,Bleckley+Dodge+Pulaski+Twiggs,Bleckley,13,23,Georgia,GA
13091,13CS007,187,178,196,289,93,102,111,613.4091031143269,67,402.8056112224449,1.5930083276870464,2.1129196056103776,2.604610630069422,0.650293626676415,227,217,238,320,82,93,103,468.7877011879304,64,323.69006676107625,0.9341642038048582,1.4501903498826063,1.9591561701570384,0.6831133005052029,19960,19772,Bleckley+Dodge+Pulaski+Twiggs,Dodge,13,91,Georgia,GA
13235,13CS007,90,89,91,111,20,21,22,250.63490840673495,22,262.4776297474647,-0.2421523587710966,-0.11363736910829068,-0.007172776659988741,0.9996645410723713,108,107,110,174,64,66,67,661.7515118297674,34,343.1224139671006,3.072878863220396,3.1824057809513366,3.3090300430547845,0.5107178856889519,10058,9909,Bleckley+Dodge+Pulaski+Twiggs,Pulaski,13,235,Georgia,GA
13289,13CS007,93,92,94,131,37,38,39,574.6163459512811,19,285.0712678169542,2.7670949481804006,2.897285544366357,3.019834864866429,0.48348295677345826,111,110,112,161,49,50,51,628.814882599986,26,330.1587301587301,2.8617231832686074,2.9843820673727524,3.1088971887218526,0.5146560992241906,7998,7875,Bleckley+Dodge+Pulaski+Twiggs,Twiggs,13,289,Georgia,GA
13025,13CS008,170,162,178,207,29,37,45,242.42965660211993,29,191.1667765326302,0.011806970188519672,0.5089299186355678,1.038949886135857,0.7676714207431367,209,200,219,294,75,85,94,467.5424379638609,67,370.3294273712138,0.46901096333519077,0.9654537381073621,1.4914192572002951,0.7828220531293593,18204,18092,Brantley+Pierce+Ware,Brantley,13,25,Georgia,GA
13229,13CS008,192,184,201,252,51,60,68,362.5449956117955,37,225.2892226507002,0.863105224102317,1.3904090422061668,1.8837728984189268,0.6111462527188882,240,229,250,346,96,106,117,533.4041822151544,78,391.1931390741762,0.8905673112418142,1.433404226511122,1.9612123795318768,0.7265582959502549,19708,19939,Brantley+Pierce+Ware,Pierce,13,229,Georgia,GA
13299,13CS008,411,395,426,505,79,94,110,313.68876376237785,72,239.0702822357499,0.23980602722141753,0.7410051430889325,1.2854453128928893,0.7541430786199711,503,484,521,650,129,147,166,408.7057210701623,144,399.33444259567386,-0.41783790823792516,0.08713374543110046,0.6368243218819709,0.970485886379622,36140,36060,Brantley+Pierce+Ware,Ware,13,299,Georgia,GA
13027,13CS009,183,176,190,200,10,17,24,123.55283275688487,28,208.28167617158442,-1.3997221999132892,-0.8572350721186326,-0.3807106384108154,1.5900400662298595,226,218,235,231,-4,5,13,28.66466054554257,35,215.1992129857354,-2.4372382857589003,-1.8558826259443582,-1.2959332778709103,6.181539023569842,16132,16264,Brooks+Thomas,Brooks,13,27,Georgia,GA
13275,13CS009,473,453,492,539,47,66,86,174.2969612251737,76,200.0921476995985,-0.8074922250814414,-0.2599747489883924,0.23816251699602717,1.1309129454566966,584,560,607,693,86,109,133,238.39092062335416,85,185.46398725753312,0.040211107741049266,0.5324601772013795,1.0305941993219858,0.7709265087312624,45579,45831,Brooks+Thomas,Thomas,13,275,Georgia,GA
13029,13CS010,283,264,302,295,-7,12,31,31.92777559425682,19,51.3201431561888,-0.7242313815546886,-0.19830877768258953,0.31321749354292716,1.4820060227065937,363,339,387,369,-18,6,30,13.200120879379321,54,115.74322151966564,-1.5259666623822614,-1.044137364158028,-0.5217657286604973,7.543462501266849,44427,46655,Bryan+Liberty,Bryan,13,29,Georgia,GA
13179,13CS010,333,305,361,384,23,51,79,93.73445778317259,35,64.69500924214417,-0.2324856309633196,0.29932862092577434,0.7745761070729569,0.6768472006945286,416,382,450,602,152,186,220,283.28491446285955,102,155.39542040555156,0.7736574173100847,1.286739483075072,1.7881172222378094,0.5456138967948674,64920,65639,Bryan+Liberty,Liberty,13,179,Georgia,GA
13031,13CS011,486,451,521,559,38,73,108,107.50865579904037,53,78.27981340849507,-0.20021447008254614,0.2795205676563948,0.818268745402977,0.7182580947493763,606,564,649,748,99,142,184,172.06762295018902,146,177.42778324644232,-0.592123535251398,-0.05055102525519847,0.4730565372001086,1.0239198555869131,81247,82287,Bulloch,Bulloch,13,31,Georgia,GA
13033,13CS012,224,213,234,248,14,24,35,120.90022331198907,25,123.56357345854441,-0.5839383062961394,-0.010878850952031168,0.4963664588314639,0.9818885672995095,275,262,287,286,-1,11,24,46.649464880401794,52,213.5085198111271,-2.1655621689989117,-1.6792812182775414,-1.1330961639492354,4.206616998765809,24279,24355,Burke+Emanuel+Jenkins+Screven,Burke,13,33,Georgia,GA
13107,13CS012,255,245,265,304,39,49,59,258.08450883986785,47,248.34874504623514,-0.4028228126672417,0.11402364770925191,0.6141904234666173,0.9429704834195726,313,301,324,407,83,94,106,415.5207854792935,82,360.9472664847258,0.018993910800329066,0.5467084635679068,1.103748375129954,0.859556695596132,22710,22718,Burke+Emanuel+Jenkins+Screven,Emanuel,13,107,Georgia,GA
13165,13CS012,86,85,87,110,23,24,25,332.12997839907183,26,359.8615916955017,-0.3979534179134349,-0.276211329705292,-0.16027192231897522,1.0401501586010098,105,104,106,133,27,28,29,321.3609767358743,20,231.42791020597085,0.764789784196795,0.9034752255688405,1.0226604807337538,0.6951198786847054,8670,8642,Burke+Emanuel+Jenkins+Screven,Jenkins,13,165,Georgia,GA
13251,13CS012,154,148,160,181,21,27,33,233.76613722910065,17,145.21640091116174,0.3839215483461948,0.8691024590003292,1.3572785361859103,0.5993043317982714,189,182,196,252,56,63,70,447.6734676375486,43,305.00780252518086,0.8911795619371423,1.4231138903368576,1.9478239246226445,0.6706907543395317,14048,14098,Burke+Emanuel+Jenkins+Screven,Screven,13,251,Georgia,GA
13035,13CS013,242,231,253,290,37,48,59,226.44869479364561,41,193.12293923692886,-0.16871107044617156,0.32327899141980826,0.8542958787633959,0.8354549490216885,298,285,311,361,50,63,76,244.3640062417114,55,213.62541754058884,-0.25522829862197954,0.29262427747884356,0.8576253793907445,0.860531917301924,25476,25746,Butts+Lamar+Monroe,Butts,13,35,Georgia,GA
13171,13CS013,180,172,188,236,48,56,64,356.9379183474045,28,179.95822398371806,1.2661005980679512,1.7642826032345307,2.290643590689706,0.4952547028069969,224,215,234,307,73,83,92,434.7155225042634,55,289.4279850549913,0.9550102661483437,1.4483044903861173,1.999670546646629,0.6578239913223837,18671,19003,Butts+Lamar+Monroe,Lamar,13,171,Georgia,GA
13207,13CS013,247,235,259,303,44,56,68,240.4082295855481,43,183.87855462903568,0.07671319078814824,0.5643966301718333,1.0395657292433396,0.7514925276621861,307,293,322,372,50,65,79,226.05350100376901,65,227.15359077406953,-0.530824057568617,-0.009600534923987524,0.4993190144431201,0.9895682860814006,28062,28615,Butts+Lamar+Monroe,Monroe,13,207,Georgia,GA
13007,13CS014,28,28,28,38,10,10,10,425.9601586120449,5,208.9864158829676,2.044082249055446,2.172261524421187,2.2860546872709966,0.44678373279072386,34,34,34,46,12,12,12,422.3799675754113,3,106.26992561105206,3.033675215253676,3.1591351417753586,3.2792415924993494,0.2321301116791353,2871,2823,Calhoun and Nearby Counties,Baker,13,7,Georgia,GA
13037,13CS014,52,51,52,70,18,18,19,388.1031657898093,2,42.507970244420825,3.33934307759709,3.4530234805868334,3.5806323189279023,0.10384079073668549,63,62,64,68,4,5,6,88.89439599553657,2,36.25815808556926,0.39868815518232414,0.5272673188590127,0.6629422863937183,0.3387869630712938,5646,5516,Calhoun and Nearby Counties,Calhoun,13,37,Georgia,GA
13061,13CS014,36,35,37,37,-0,1,2,39.77730935985494,5,210.5263157894737,-2.2180208443978153,-1.706399876389475,-1.1755385873434312,2.5710759849885996,45,43,46,57,11,12,14,431.2328966273958,2,69.56521739130436,3.0963866585205566,3.6299748207420057,4.133062075631214,0.14927661547029605,2850,2875,Calhoun and Nearby Counties,Clay,13,61,Georgia,GA
13099,13CS014,141,137,146,172,26,31,35,343.35846447765624,35,392.52336448598135,-0.9978778016193947,-0.5127131107913828,0.04576176607380311,1.1070298698031429,172,166,177,194,17,22,28,209.9645105330696,23,216.02329294636985,-0.5975115055449072,-0.06939920812537913,0.46908930438767044,0.9848031414953976,10700,10647,Calhoun and Nearby Counties,Early,13,99,Georgia,GA
13177,13CS014,224,210,238,267,29,43,57,157.2765071472442,32,117.26623099004459,-0.08874291843533524,0.3945330172143614,0.9264499704531529,0.7286283481743552,283,266,300,310,10,27,44,81.01604253815323,43,128.83123108727565,-0.9812322697026342,-0.4716525696033384,0.028028255307944682,1.533483914527941,32746,33377,Calhoun and Nearby Counties,Lee,13,177,Georgia,GA
13201,13CS014,81,81,82,95,13,14,14,277.7212634162101,3,60.67756615540199,2.0506451074996694,2.1718974213405438,2.2861564158239776,0.20365213263182677,101,100,101,128,27,27,28,463.78405442393984,20,337.32501264968795,1.142840465510701,1.2653052795172943,1.3941854483944243,0.7018096297891435,5933,5929,Calhoun and Nearby Counties,Miller,13,201,Georgia,GA
13239,13CS014,28,27,29,33,4,5,6,253.08979133855206,5,268.21636119803304,-0.7015446901182509,-0.16147394466973927,0.3603077446040844,0.8744292449897201,35,34,36,51,15,16,17,725.2782013522692,5,223.2142857142857,4.522567807721621,5.008675035360887,5.5077428069749175,0.28991840559677157,2237,2240,Calhoun and Nearby Counties,Quitman,13,239,Georgia,GA
13243,13CS014,74,74,75,104,29,30,30,556.6457485842376,25,466.56298600311044,0.7868304134295169,0.9071106314177757,1.0266004032753775,0.8109791079577415,90,89,91,115,24,25,26,393.2274205881386,6,95.23809523809524,2.8489401115401076,2.978731927430335,3.1024187624989605,0.23279881112309306,6430,6300,Calhoun and Nearby Counties,Randolph,13,243,Georgia,GA
13273,13CS014,104,103,105,136,31,32,33,429.3915486011065,31,411.09514863520826,0.05974350735358013,0.18308529039916327,0.2978997632146929,0.9287081383541148,128,127,129,135,6,7,8,79.45157245159966,15,166.8149466192171,-0.992942825714014,-0.8749142971925916,-0.7464864259560827,1.8417822157225916,9049,8992,Calhoun and Nearby Counties,Terrell,13,273,Georgia,GA
13039,13CS015,331,307,354,357,3,26,50,57.081860891182394,22,48.025322442742535,-0.4444243634626952,0.08836644117489914,0.6297421332423633,0.8103511368762619,416,387,445,529,84,113,142,203.29893714103923,82,147.60413291572164,0.07110370598733341,0.5573328420394726,1.0680322734127088,0.7196726550645268,54971,55554,Camden+Charlton,Camden,13,39,Georgia,GA
13049,13CS015,96,94,97,141,44,45,47,428.6984713685925,17,161.0865445356917,2.5434589623876622,2.6794879085348295,2.7900005457384545,0.3676313273317827,119,117,120,178,58,59,61,465.6087040144545,45,353.440150801131,0.9987969799894073,1.121269332042152,1.2432730428460939,0.7465001560076282,12664,12732,Camden+Charlton,Charlton,13,49,Georgia,GA
13043,13CS016,133,129,138,174,36,41,45,444.7934687512135,35,382.47882706493033,0.12209728539364559,0.6105018628519927,1.11878862725542,0.8392820646334622,162,156,168,234,66,72,78,654.3654627322046,42,380.71065989847716,2.210175053705308,2.7210957124895763,3.2101074388438318,0.5738520395599325,10981,11032,Candler+Evans+Tattnall+Toombs,Candler,13,43,Georgia,GA
13109,13CS016,98,97,99,126,27,28,29,309.077812357494,11,122.97372833985466,1.737297252416583,1.8619650750442929,1.9836129472346877,0.38398422309692654,119,118,121,179,58,60,61,558.2542680532704,33,308.87308124298016,2.365516494091948,2.4948032963758053,2.617542747367644,0.5441603791789792,10734,10684,Candler+Evans+Tattnall+Toombs,Evans,13,109,Georgia,GA
13267,13CS016,189,179,199,242,43,53,63,275.90950680644397,34,175.61983471074382,0.48142147550439096,1.0008233736194356,1.496950332447834,0.6248153059999159,228,216,240,346,106,118,130,511.26815820761726,74,321.41771272206057,1.3817520324015828,1.8940295735148729,2.4078916031064725,0.6233717148354171,23232,23023,Candler+Evans+Tattnall+Toombs,Tattnall,13,267,Georgia,GA
13279,13CS016,262,250,274,364,90,102,114,453.314437201936,47,208.83474654719146,1.9574075127933532,2.455059288156922,2.9385476094441096,0.4562123870467912,316,303,330,455,125,139,152,514.2753600797637,96,356.45328976682015,1.0612754036212193,1.5919047044609023,2.087708661091236,0.68814915415033,27007,26932,Candler+Evans+Tattnall+Toombs,Toombs,13,279,Georgia,GA
13045,13CS017,957,905,1008,1159,151,202,254,202.4898950107605,126,126.1903370917801,0.27228301826376666,0.7602828708658278,1.2698004660275943,0.6201261262395311,1192,1129,1255,1501,246,309,372,254.12928600563296,207,170.22606350172282,0.3557916463451041,0.8512118249438975,1.3539423654943674,0.6676798290661468,119819,121603,Carroll+Heard,Carroll,13,45,Georgia,GA
13149,13CS017,111,110,112,135,23,24,25,249.2681939598839,4,41.637751561415676,1.9547738369284013,2.0778469704444897,2.195429001891454,0.16034400523734424,136,135,138,178,40,42,43,360.9816110763215,28,242.42424242424244,1.0610779495916005,1.1857598877987914,1.316332309753858,0.6558394432893292,11528,11550,Carroll+Heard,Heard,13,149,Georgia,GA
13047,13CS018,569,540,598,645,47,76,105,134.31408674908988,60,105.93999676294455,-0.2569491117450583,0.2781480241499025,0.7943164954112134,0.7785140268536039,700,664,735,901,166,201,237,294.79971526709403,151,220.96698665417938,0.21946721983494033,0.7343208157420094,1.2407254648424244,0.745847211297145,67963,68336,Catoosa,Catoosa,13,47,Georgia,GA
13051,13CS019,2133,2006,2260,2425,165,292,419,119.03708743701411,193,78.67809922408989,-0.12026572475111716,0.40428793787838074,0.9147285676846285,0.6586987027106557,2639,2486,2792,3199,407,560,713,189.0684049128613,396,133.72911748913452,0.03966383671134891,0.5608870273864448,1.0554670063033122,0.7060443891065193,294364,296121,Chatham,Chatham,13,51,Georgia,GA
13055,13CS020,276,266,287,336,49,60,70,287.2207958414903,36,173.4173658223275,0.6046944967069111,1.1220177428240832,1.6798859969449103,0.5938179228264128,337,324,350,380,30,43,56,173.49626036205353,48,192.53910950661853,-0.7288666899329697,-0.19623615047891077,0.33452582231304245,1.0846815959328115,24911,24930,Chattooga+Dade+Walker,Chattooga,13,55,Georgia,GA
13083,13CS020,163,156,170,207,37,44,51,327.0169732168151,2,14.799284701239438,2.638237452833611,3.113169812144403,3.655542623943775,0.04425403527312229,200,191,208,247,39,47,56,290.67556747104504,31,190.05579057078046,0.5057079327895317,1.0161118380823462,1.5285256970701802,0.6403358921472423,16217,16311,Chattooga+Dade+Walker,Dade,13,83,Georgia,GA
13295,13CS020,705,675,734,830,96,125,155,221.1051612398802,63,111.02299762093575,0.6071672433296157,1.0862087499819597,1.58778416453915,0.4981571201371373,864,829,899,1000,101,136,171,199.0093390258022,156,228.09351834252044,-0.7741537114451025,-0.2908882473724331,0.20817875073305256,1.1377853936976772,68094,68393,Chattooga+Dade+Walker,Walker,13,295,Georgia,GA
13057,13CS021,1449,1333,1564,1630,66,181,297,81.2962961248312,116,52.04166323959353,-0.19412985294298615,0.29995809561010206,0.8119690455434786,0.6366347430440918,1832,1691,1974,2243,269,411,552,150.01165775924386,260,95.00944613147114,0.028724978035494723,0.5363000925007391,1.1056621972274683,0.631808031842963,267478,273657,Cherokee+Pickens,Cherokee,13,57,Georgia,GA
13227,13CS021,303,289,317,334,17,31,45,111.96577549557459,23,82.8704398738928,-0.1976271454695446,0.29346528107227526,0.7572102195715331,0.7170656142017783,377,359,394,470,76,93,111,274.6126442589367,86,253.51531409368275,-0.31090853305092975,0.2023063327467107,0.7297964931988589,0.913369579113732,33305,33923,Cherokee+Pickens,Pickens,13,227,Georgia,GA
13059,13CS022,680,625,735,698,-37,18,73,16.60977237282046,50,46.701329431177804,-0.8007209638334566,-0.2922456347101825,0.1879243701841735,2.6619849859094527,851,785,918,967,49,116,182,90.06006202790242,86,66.83297196900816,-0.28675147836719383,0.22214870448738736,0.7202519244125862,0.7357446025876665,128476,128679,Clarke+Madison+Oconee,Clarke,13,59,Georgia,GA
13195,13CS022,261,248,274,282,8,21,34,83.6831889298685,26,103.04511526520906,-0.7196336257482152,-0.20839467871107023,0.35397052959828906,1.1756905209356745,326,310,342,400,58,74,90,240.1328396818927,50,162.3692927193609,0.25988629573482547,0.780540194805557,1.3067617984918363,0.6671425024838636,30278,30794,Clarke+Madison+Oconee,Madison,13,195,Georgia,GA
13219,13CS022,249,231,268,292,24,43,61,121.86477154306618,27,77.37498208912452,-0.04355094855117969,0.4632989371860977,0.9601044224437578,0.6203372461469491,317,295,339,350,11,33,55,77.476402496302,29,67.63532896424657,-0.40777997205905137,0.10006485698591584,0.6025214889746988,0.8474685957115237,41874,42877,Clarke+Madison+Oconee,Oconee,13,219,Georgia,GA
13063,13CS023,1537,1409,1665,1920,255,383,511,154.86333554582396,204,82.52065544592504,0.20962914439007557,0.7318197922151223,1.237460928484576,0.5314729109072013,1912,1758,2065,2628,563,716,870,241.01599813520733,432,145.3830776789861,0.44199479530256575,0.9659179560604504,1.4843631599988247,0.6023681452580929,296653,297146,Clayton,Clayton,13,63,Georgia,GA
13067,13CS024,3842,3513,4172,4574,402,732,1061,114.70214631223587,451,70.69704253318005,-0.0475875664000177,0.4346046153199764,0.9815885986551746,0.6155120847568007,4786,4391,5182,5655,473,869,1264,113.2754461387514,629,82.03819928108975,-0.17690008655126177,0.32355063322198957,0.8155396175629794,0.7234034486205653,765520,766716,Cobb,Cobb,13,67,Georgia,GA
13071,13CS025,423,404,443,525,82,102,121,266.27236470046637,55,144.05133465744157,0.6663324543166508,1.215084282356471,1.7239250648841549,0.5357229419237868,520,497,544,640,96,120,143,261.3012315474595,108,235.7049323439546,-0.2516117609764792,0.25313641321585817,0.7729973982674311,0.8945712622763371,45817,45820,Colquitt+Mitchell,Colquitt,13,71,Georgia,GA
13205,13CS025,220,211,230,288,58,68,77,375.1644895977368,50,276.68895549919296,0.4783366587524443,0.9817586802277174,1.4788562762168853,0.7267933117700086,269,257,280,288,8,19,31,90.34010199355926,35,162.45822502784998,-1.243225466191294,-0.7171868387185748,-0.19261672445190278,1.710414878688824,21685,21544,Colquitt+Mitchell,Mitchell,13,205,Georgia,GA
13073,13CS026,846,778,913,1012,99,166,234,126.86193167065713,101,77.13702004162344,-0.02285404381527046,0.4976606216878984,1.005326501098953,0.6044005358814271,1065,983,1147,1356,209,291,373,182.6499983301425,175,109.9101249207077,0.20658910656102217,0.7211379223367124,1.2897132034705225,0.5996905860277466,157123,159221,Columbia,Columbia,13,73,Georgia,GA
13077,13CS027,924,860,987,1100,113,176,240,143.81321700681548,95,77.41041781254455,0.1544916212651652,0.6786803592963324,1.140181202064712,0.535237878001013,1158,1081,1235,1579,344,421,498,281.4629974190753,247,165.2461297616977,0.6598352393538537,1.159140834300041,1.6491128065601557,0.5857050028065997,147267,149474,Coweta,Coweta,13,77,Georgia,GA
13079,13CS028,130,125,135,140,5,10,15,99.9293445476479,5,49.419322955275504,-0.05673341325792975,0.5122984164025648,1.0281322816603757,0.45003076900206873,160,153,166,213,47,53,60,440.0163871025818,30,247.0152326060107,1.3961235387592463,1.932700335323768,2.427553364299937,0.5510654921554485,12141,12145,Crawford+Peach+Pike+Upson,Crawford,13,79,Georgia,GA
13225,13CS028,276,263,288,319,31,43,56,186.08134431468292,36,154.1425818882466,-0.19404883826621927,0.3123906416177029,0.819702981441742,0.8097293850341079,342,328,357,408,51,66,80,231.52901263754092,68,239.76587567434154,-0.6188585463613359,-0.08079071463146174,0.4325965295074958,1.020041669608006,28026,28361,Crawford+Peach+Pike+Upson,Peach,13,225,Georgia,GA
13231,13CS028,174,166,182,190,8,16,24,102.77122956861648,32,202.16910603348424,-1.5838253163298703,-0.9859919023389438,-0.49761353556108895,1.8532489970855688,218,208,228,264,36,46,56,235.65365642813754,55,283.5343849881431,-0.9524575380834145,-0.4792500541336019,0.07250851096530996,1.177425215033549,18994,19398,Crawford+Peach+Pike+Upson,Pike,13,231,Georgia,GA
13293,13CS028,340,328,352,421,69,81,93,352.2386877152581,55,239.80815347721824,0.6457856356649034,1.1173311714066934,1.6616974090118781,0.6724872021284921,418,404,432,548,116,130,144,469.34010542836296,97,349.94047404307514,0.7397914814848031,1.193231533665608,1.6798994404827312,0.7399136205805319,27522,27719,Crawford+Peach+Pike+Upson,Upson,13,293,Georgia,GA
13081,13CS029,198,190,207,318,111,120,128,704.1183020837119,45,265.14779534518317,3.892848288136238,4.386717156697981,4.907192816542435,0.37344208932701994,240,230,251,346,95,106,116,531.2817138938713,66,331.6083002562428,1.474871107600405,1.994255728077366,2.5260414501110398,0.6183191116729532,20366,19903,Crisp+Dooly+Turner+Wilcox,Crisp,13,81,Georgia,GA
13093,13CS029,109,104,114,170,56,61,66,641.5393293549413,20,209.69855832241151,3.7803152476600084,4.311817633458314,4.790942141623959,0.3216115903418527,129,124,135,174,39,45,50,408.448466912129,25,228.89580662882256,1.2621967625648218,1.763895160680355,2.333676174227567,0.5481164994703549,11445,10922,Crisp+Dooly+Turner+Wilcox,Dooly,13,93,Georgia,GA
13287,13CS029,114,113,115,117,2,3,4,39.79652398239287,25,340.17462297312613,-3.122539569864365,-3.0041757852625017,-2.8813615217375212,6.369892727493252,142,141,143,135,-8,-7,-6,-80.77940998462499,15,167.28002676480426,-2.6069116306141487,-2.48221743972853,-2.358551064575333,-2.4025025645586537,8819,8967,Crisp+Dooly+Turner+Wilcox,Turner,13,287,Georgia,GA
13315,13CS029,84,83,85,117,32,33,34,449.7529686511544,25,344.27358274041774,0.9393069140609402,1.056938178127387,1.179814921206379,0.7427310088148251,104,103,105,171,66,67,68,766.7850160670191,17,194.55252918287937,5.59436659382241,5.720327046938547,5.849886981806895,0.24999384315186565,8714,8738,Crisp+Dooly+Turner+Wilcox,Wilcox,13,315,Georgia,GA
13085,13CS030,224,213,236,230,-6,6,17,24.56130601363771,18,79.82556635500202,-1.106825241607727,-0.5727962567270459,-0.04312579750799813,2.7529797903860875,287,272,301,317,16,30,45,107.39954417278051,56,197.97779820405853,-1.4098743483548295,-0.9059274305254905,-0.38622887645293447,1.7846310405820867,27059,28286,Dawson+Lumpkin+White,Dawson,13,85,Georgia,GA
13187,13CS030,256,242,271,287,16,31,45,108.71305446886416,20,71.25679166295537,-0.1069438912474448,0.37435829443583696,0.8877901595650247,0.6346579759137397,320,302,337,425,88,105,123,308.49595638098,67,196.02680008192164,0.5960295636651634,1.1262578641717658,1.6399949183354037,0.629457682308312,33681,34179,Dawson+Lumpkin+White,Lumpkin,13,187,Georgia,GA
13311,13CS030,242,230,254,336,82,94,106,394.5892899548888,33,138.9815042291089,2.046474905476753,2.572947151335931,3.0570965027665227,0.3484985149579222,297,283,312,448,136,151,165,530.8446284285226,67,235.99027860941845,2.421863106265999,2.959344923211385,3.4855294763571547,0.4416259525862881,28493,28391,Dawson+Lumpkin+White,White,13,311,Georgia,GA
13087,13CS031,298,285,310,367,57,69,82,287.7256817221347,39,161.9825557247681,0.708078157055868,1.2628029609066174,1.7921317291337548,0.554964594924291,365,350,380,397,17,32,47,108.72673536969725,51,175.36620590055705,-1.159106164002386,-0.6607440064873131,-0.13547183836787727,1.5634623541788566,28892,29082,Decatur+Grady+Seminole,Decatur,13,87,Georgia,GA
13131,13CS031,234,223,246,273,27,39,50,178.07447694208187,38,175.71577203190628,-0.499913917057956,0.029571702662354506,0.5610506176782959,0.9617796464582367,287,274,301,349,48,62,75,236.90421991045704,49,188.73738540944456,-0.02603806994649705,0.5007421770509908,0.9907676636086273,0.7839363622643019,25951,25962,Decatur+Grady+Seminole,Grady,13,131,Georgia,GA
13253,13CS031,119,118,120,125,5,6,7,82.70408490349678,14,186.8535201868535,-1.1621431080756124,-1.0376119052284618,-0.9199639745700423,1.945362125420064,149,148,150,163,13,14,15,154.27411655631826,28,304.74531998258595,-1.634461040217687,-1.4994284484713012,-1.376108163327327,1.8451758020989755,8991,9188,Decatur+Grady+Seminole,Seminole,13,253,Georgia,GA
13089,13CS032,3969,3641,4297,4797,500,828,1156,130.2250171677327,479,75.371151783443,0.0219644127111335,0.5662011861752002,1.076065164489515,0.5780777939160027,4910,4518,5301,5888,587,978,1370,128.97311440752293,564,74.34660015897518,0.016047384121525697,0.5645316573584991,1.1222057653420316,0.5758618009255337,762626,758609,DeKalb,DeKalb,13,89,Georgia,GA
13095,13CS033,781,745,818,1089,271,308,344,430.71608579062297,173,242.31388752713778,1.3241898696446437,1.886943262639973,2.410471456652798,0.5607602362917133,953,909,996,1205,209,252,296,297.32876372393685,149,175.4592557701366,0.7340276676517288,1.2354341904792328,1.7232439378104947,0.587790712348395,85674,84920,Dougherty,Dougherty,13,95,Georgia,GA
13097,13CS034,847,785,909,1034,125,187,249,154.80503300937218,108,89.40829096327775,0.11677013352499717,0.6516306053901252,1.1678419829116706,0.5744819900709773,1053,978,1128,1309,181,256,331,175.66221022838397,164,112.62034582686681,0.10506221446669442,0.6449146351652814,1.131602604313134,0.6386222611838479,144953,145622,Douglas,Douglas,13,97,Georgia,GA
13103,13CS035,422,394,450,470,20,48,76,88.18615075079776,31,57.05696493757476,-0.1681180356853137,0.3301999122580928,0.8512580480136029,0.6337782702330624,531,497,565,658,93,127,161,190.9355099390193,143,215.00849509088994,-0.8093536013079765,-0.23445577563943445,0.26433004571276253,1.117280912493534,65198,66509,Effingham,Effingham,13,103,Georgia,GA
13105,13CS036,224,216,233,296,63,72,80,440.79051759381,27,165.64417177914112,2.2663156914188853,2.758127890991027,3.25540491412416,0.3706303995349805,273,263,284,331,47,58,68,293.5880246973038,39,199.12182170938425,0.388436059578272,0.943825926513143,1.499477618552412,0.6666421602488694,19560,19586,Elbert+Franklin+Hart+Stephens,Elbert,13,105,Georgia,GA
13119,13CS036,264,254,274,323,49,59,69,301.753488699406,33,168.86993603411514,0.8436526316145703,1.3196518924366394,1.8525464349606735,0.5502966014607964,326,314,338,369,31,43,55,181.6597044859007,43,181.18231997640416,-0.517655811618099,-0.011321214755126709,0.5360996414776122,0.974762764867928,23450,23733,Elbert+Franklin+Hart+Stephens,Franklin,13,119,Georgia,GA
13147,13CS036,257,246,268,324,56,67,78,308.74835299335314,36,166.28815581816082,0.907966874933022,1.4159685497446868,1.9510234515975735,0.5306490704023057,319,305,332,408,76,89,103,338.3952438953405,52,197.4933535890619,0.8929906356084436,1.402773390654028,1.9199537616001205,0.577139924543832,25979,26330,Elbert+Franklin+Hart+Stephens,Hart,13,147,Georgia,GA
13257,13CS036,326,314,337,330,-7,4,16,18.052765058081665,42,188.81354662271008,-2.193156423666776,-1.7159801373618893,-1.1647067921911243,8.37372801875355,399,385,413,488,75,89,103,331.3552120150216,69,256.9258266309205,0.2482467691794169,0.7541165021095011,1.2197106731413074,0.7667624630827596,26693,26856,Elbert+Franklin+Hart+Stephens,Stephens,13,257,Georgia,GA
13111,13CS037,284,273,295,352,57,68,79,318.4512797130273,26,122.17088260631216,1.4479013615727203,1.9813406966562397,2.5238871846757434,0.3780622688749642,347,334,361,470,109,123,136,476.6877676771232,79,306.7246466842677,1.213819777485258,1.6922980019642886,2.233109720336302,0.6382512809788558,25538,25756,Fannin+Rabun+Towns+Union,Fannin,13,111,Georgia,GA
13241,13CS037,181,174,188,234,46,53,60,376.27175149931526,24,169.91150442477874,1.6067524532567727,2.0563540168143875,2.546847462170151,0.4432265162597654,221,212,230,286,56,65,74,381.8887408828977,46,269.22626711927893,0.6040984346691557,1.1100968391584407,1.6371159496668544,0.6943447553715497,16950,17086,Fannin+Rabun+Towns+Union,Rabun,13,241,Georgia,GA
13281,13CS037,169,164,175,181,6,12,17,112.61843938988474,26,249.65991838041128,-1.8834086093605489,-1.3601459669354674,-0.820843723420086,2.0426967659179933,209,203,216,249,33,40,46,310.2211366884747,41,319.6631841571807,-0.6028641480499428,-0.10012398234463386,0.4419863446180465,1.005173875304929,12497,12826,Fannin+Rabun+Towns+Union,Towns,13,281,Georgia,GA
13291,13CS037,279,268,290,361,71,82,93,396.88230638262655,31,149.87309133395107,1.9513959321092968,2.4639038703619596,2.9773336608574827,0.3730813491779059,345,332,358,436,78,91,104,357.9984575104564,64,251.8594309550982,0.532412167770048,1.0765304524146218,1.5930698475677114,0.6958716152268513,24821,25411,Fannin+Rabun+Towns+Union,Union,13,291,Georgia,GA
13113,13CS038,793,742,844,868,24,75,126,75.58977574809477,70,70.67137809187278,-0.4960356613779288,0.053291653956157696,0.5534725229916858,0.9226104729772913,987,925,1050,1189,139,202,264,167.48450678030107,145,120.42289197651337,-0.04379054700100121,0.4801654974935642,0.9948690417961458,0.71546139792278,118860,120409,Fayette,Fayette,13,113,Georgia,GA
13115,13CS039,965,923,1007,1143,136,178,220,216.6336984865019,107,130.26011443411923,0.3810212615831258,0.8708866542378546,1.3800344753195113,0.5979319120182585,1185,1134,1236,1454,218,269,320,272.87649044297257,207,209.6308673856904,0.08695801148204317,0.6385767606696734,1.1560007360748386,0.7653856648092131,98572,98745,Floyd,Floyd,13,115,Georgia,GA
13117,13CS040,1091,982,1200,1196,-4,105,214,49.88010104606377,71,33.760089392912754,-0.3332811387806194,0.1724960730772591,0.6435826447308202,0.670433726712572,1392,1258,1525,1702,177,310,444,119.76072827189367,201,77.56904030502771,-0.08228336151087728,0.4055070798712331,0.9123999451590754,0.6456197009766078,252369,259124,Forsyth,Forsyth,13,117,Georgia,GA
13121,13CS041,5852,5393,6312,7006,694,1154,1613,129.63541714871087,687,77.18703624813328,0.026867420732775652,0.5269500372519932,1.0649431818919377,0.5949006730892701,7237,6687,7787,8396,609,1159,1709,108.75490251729086,877,82.280048636234,-0.25128018297319066,0.24972930064580343,0.7891326054285434,0.7559119373395745,1068055,1065872,Fulton,Fulton,13,121,Georgia,GA
13123,13CS042,308,294,321,363,42,55,69,211.32167878898437,33,125.66641279512565,0.3325688354344983,0.8609593177926635,1.335457342294135,0.5841424149050766,382,365,398,506,108,124,141,388.52419051993303,93,291.1800619931745,0.501748346698914,0.9715358776851186,1.51201258211744,0.7434603001012947,31512,31939,Gilmer+Murray,Gilmer,13,123,Georgia,GA
13213,13CS042,326,309,343,406,63,80,97,239.42144677673883,41,123.16010814058276,0.593976820931848,1.1576131531255225,1.6927145504524865,0.5080331211196578,402,381,422,545,123,143,164,358.928031019981,92,230.2936243710731,0.7585559589955431,1.3048198786310188,1.813649128698329,0.6371713620126362,39948,39949,Gilmer+Murray,Murray,13,213,Georgia,GA
13127,13CS043,751,715,787,945,158,194,230,275.13017801800174,107,151.73179868357303,0.725023163288251,1.2325419047453707,1.757628879522872,0.5486630576891092,922,878,966,1142,176,220,264,259.5910150412471,189,223.1404958677686,-0.11435289557149461,0.33808479421936977,0.8864727894846426,0.855693069608434,84623,84700,Glynn+McIntosh,Glynn,13,127,Georgia,GA
13191,13CS043,105,100,110,148,38,43,48,449.1092986833863,12,125.4355400696864,2.7454261579317736,3.2535764410402885,3.769598272558006,0.27294569395788915,127,121,132,226,94,99,105,895.369551709343,25,225.18465141415962,6.176325608899437,6.702172000659627,7.207793733032313,0.24899424345166887,11480,11102,Glynn+McIntosh,McIntosh,13,191,Georgia,GA
13129,13CS044,483,459,508,593,85,110,134,227.35565985469287,61,126.63702575990865,0.47179628221608105,0.9805307320902361,1.5156590288934289,0.5519596404371768,599,569,629,774,145,175,205,300.5347586284126,122,209.7733759757901,0.3555645727788211,0.9150785870059865,1.3939524740024785,0.6940296190415242,57803,58158,Gordon,Gordon,13,129,Georgia,GA
13135,13CS045,3863,3451,4274,4746,472,883,1295,110.89653871449099,531,66.68564395810485,-0.060616937248500216,0.4336961016425489,0.9558704259272389,0.6006518495310286,4873,4376,5371,6005,634,1132,1629,117.4352642800227,761,78.97779281457758,-0.1375075526583526,0.38434388068238606,0.9191831035001689,0.6719281429204301,955528,963562,Gwinnett,Gwinnett,13,135,Georgia,GA
13139,13CS046,1338,1251,1426,1728,302,390,477,229.1109438954485,183,107.60064285994277,0.6901268668098055,1.2105664227370048,1.7816898597496504,0.46844208174723706,1672,1565,1779,2032,253,360,467,174.05179494810605,332,160.52761365064936,-0.3733880673035918,0.13222008191719878,0.6294380190825979,0.919742898688923,204088,206818,Hall,Hall,13,139,Georgia,GA
13141,13CS047,94,93,94,159,65,65,66,904.2486096820323,40,553.2503457814661,3.4002573382954964,3.5102876985195257,3.6350789640080987,0.6026167927959294,114,113,115,168,53,54,55,623.8735107091683,30,347.1017007983339,2.648494464461747,2.7661324335971145,2.8896478792542664,0.5462352891810828,8676,8643,Hancock+Jasper+Morgan+Putnam,Hancock,13,141,Georgia,GA
13159,13CS047,141,134,147,144,-3,3,10,28.63388181481878,16,131.12962710012292,-1.5442727355646269,-1.02227154044493,-0.5214898821898717,3.5604525127154405,177,169,185,225,40,48,56,315.85807176063116,53,349.0286466908133,-0.824162869451175,-0.3441617513004182,0.18812577468078484,1.082448947763994,14642,15185,Hancock+Jasper+Morgan+Putnam,Jasper,13,159,Georgia,GA
13211,13CS047,176,167,185,209,24,33,42,198.08230290903455,12,71.69172558000596,0.7579488654556017,1.2653835289343638,1.7537253500699062,0.35133252676596805,219,208,230,294,64,75,86,364.6696203931304,38,184.75301439128745,1.3139226430039372,1.792447351146503,2.317840277480306,0.49996547920946177,20086,20568,Hancock+Jasper+Morgan+Putnam,Morgan,13,211,Georgia,GA
13237,13CS047,210,200,219,258,39,48,58,261.0838390886475,30,162.32302281540265,0.4505180488372451,0.9877452334810127,1.482017208983933,0.6091043452534638,259,248,271,367,96,108,119,477.76918962456574,51,226.46536412078152,2.0187967018620805,2.5035023307689617,2.9996855116980887,0.4696408434852567,22178,22520,Hancock+Jasper+Morgan+Putnam,Putnam,13,237,Georgia,GA
13143,13CS048,311,298,324,392,68,81,94,324.8976467575389,50,199.79354666844262,0.724135988658646,1.2714393844332736,1.724837335361804,0.6074718287886945,383,367,398,448,50,65,81,214.3078089286573,68,223.05320474972117,-0.5493512631539234,-0.1032773323623211,0.41242952308691644,1.02511720111081,30031,30486,Haralson+Polk,Haralson,13,143,Georgia,GA
13233,13CS048,422,403,440,504,64,82,101,230.35377902749286,46,128.5544609795291,0.471343483606462,1.025807181804627,1.5477277463213401,0.5513846041832883,517,495,540,668,128,151,173,346.86023360837527,88,202.70425909289844,0.9331286751272938,1.4326834362846455,1.939798123984033,0.5805422048765266,42939,43413,Haralson+Polk,Polk,13,233,Georgia,GA
13145,13CS049,253,238,268,284,16,31,46,106.90661927686396,29,99.32073748501627,-0.4301488371944575,0.0628527967930684,0.5586827935676948,0.9002031371495418,317,299,335,347,12,30,48,84.49971692869907,58,163.26990203805877,-1.2834279766549894,-0.7758866213362775,-0.28573040947011413,1.8699013286574122,35038,35524,Harris+Meriwether+Talbot,Harris,13,145,Georgia,GA
13199,13CS049,233,224,242,284,42,51,60,294.9273329989803,19,110.09705924960163,1.3572678163259546,1.8353082301369292,2.3513602775774163,0.3661091983465737,286,276,297,401,104,115,125,551.799288619825,68,327.4268104776579,1.7371495021499608,2.2284663728918748,2.7107972247854466,0.5882471187978142,20709,20768,Harris+Meriwether+Talbot,Meriwether,13,199,Georgia,GA
13263,13CS049,67,66,68,80,12,13,14,270.7755762284134,2,41.386445938954985,2.170545647000671,2.294180026009688,2.4117826761015606,0.1419927143243072,81,81,82,98,16,17,17,290.9364617315112,20,348.4320557491289,-0.7125940348500058,-0.5729851249925415,-0.4501818875329613,1.129959277350751,5799,5740,Harris+Meriwether+Talbot,Talbot,13,263,Georgia,GA
13151,13CS050,1426,1322,1530,1751,221,325,429,161.532530364195,151,75.14556342584144,0.3690805020785927,0.8550193043749467,1.355908943503738,0.4637750941655314,1788,1661,1914,2218,304,430,557,175.87764349656874,326,133.2042151370655,-0.0727481320518169,0.41518252203088296,0.9277324774561776,0.7556132065056675,241132,244737,Henry,Henry,13,151,Georgia,GA
13153,13CS051,1097,1027,1168,1304,136,207,277,151.68615583688663,106,77.7896011448281,0.2012260189993719,0.7255604010424697,1.250229378421558,0.5103634099085352,1375,1290,1461,1705,244,330,415,197.99115849852,247,148.39112777257108,0.02718898785207283,0.491416430217254,1.0203329564228454,0.7472162945270866,163518,166452,Houston,Houston,13,153,Georgia,GA
13157,13CS052,580,547,613,680,67,100,133,156.59453638482557,77,120.71330589849107,-0.1287131309680464,0.3642913290160837,0.8547241565505004,0.7632245511596965,736,695,777,865,88,129,170,161.54989211536886,139,174.26189431454898,-0.6413452679004881,-0.1257988191649254,0.3714226265045272,1.0703812524986829,76545,79765,Jackson,Jackson,13,157,Georgia,GA
13003,13CS053,72,71,73,80,7,8,9,115.63615444116462,11,158.92126173850227,-0.5504454499987982,-0.43259579095849476,-0.3163389768862347,1.2216861522340345,89,88,90,139,49,50,51,595.0356645240315,28,334.20864168059205,2.4800262126566146,2.6066767101642854,2.737940998076377,0.5506165256068402,8306,8378,Lanier and Nearby Counties,Atkinson,13,3,Georgia,GA
13019,13CS053,184,176,192,227,35,43,51,282.19042929958744,30,196.34578674665937,0.3714239347804312,0.8692682136640059,1.3761947620697041,0.6800200540895844,223,214,233,286,53,63,72,344.8142882267659,37,203.86798170698108,0.8915434934606713,1.3817711511262578,1.918600044460738,0.5819408482434248,18335,18149,Lanier and Nearby Counties,Berrien,13,19,Georgia,GA
13065,13CS053,71,70,72,92,20,21,22,378.28240148725934,13,232.45417970496197,1.3335282557079873,1.45583423847036,1.5835977257580995,0.5867632537118785,87,86,88,116,28,29,30,431.14339196281503,19,282.52788104089217,1.358269981698521,1.486475735111933,1.6055822023547064,0.6334517231483054,6711,6725,Lanier and Nearby Counties,Clinch,13,65,Georgia,GA
13075,13CS053,167,159,174,213,39,46,54,321.5518325608735,32,222.82829455115183,0.4727234849712695,0.9689271734008267,1.4833727196981752,0.6782891116734627,204,195,213,230,17,26,35,150.7700378912894,29,168.35016835016833,-0.6513276033514165,-0.16682925199950735,0.34923312694131886,1.0752031677325975,17233,17226,Lanier and Nearby Counties,Cook,13,75,Georgia,GA
13101,13CS053,21,21,21,36,15,15,15,484.12701806579594,4,128.5140562248996,3.4455384081184186,3.559674222220331,3.6787087988848466,0.24893497159566386,26,25,26,42,16,16,17,444.17522453609723,4,108.13733441470669,3.228777141614724,3.361404244023813,3.4874503121061875,0.2294888389819761,3735,3699,Lanier and Nearby Counties,Echols,13,101,Georgia,GA
13173,13CS053,78,77,79,84,5,6,7,75.07105739283736,10,119.85617259288851,-0.5671054897853341,-0.4493976744970052,-0.3306554370455563,1.3767602894531332,95,93,96,114,18,19,21,196.41781433644354,3,30.278562777553493,1.5386134062642016,1.6606862990328686,1.7807335916329217,0.14661984769824385,10012,9908,Lanier and Nearby Counties,Lanier,13,173,Georgia,GA
13185,13CS054,802,751,853,989,136,187,238,189.7285698185605,107,108.52660761376698,0.3332086901867868,0.8066917803404535,1.3070300156673769,0.5689681941328846,998,937,1060,1238,178,240,301,201.33697490224847,156,130.94278807413377,0.1745990976599887,0.6858233524095504,1.2339279191702046,0.647666193110346,118312,119136,Lowndes,Lowndes,13,185,Georgia,GA
13053,13CS055,35,34,36,35,-1,-0,1,-2.0782080881829725,4,49.70487729108419,-0.636384788895175,-0.5206176376692903,-0.3891548370157987,4.803326568195671,42,41,43,39,-4,-3,-2,-31.211914121213717,9,98.78169245966416,-1.4279644901176547,-1.2986785871202204,-1.1783409268591876,-4.881441989652706,9657,9111,Marion and Nearby Counties,Chattahoochee,13,53,Georgia,GA
13193,13CS055,135,130,140,147,7,12,17,120.37416835737395,11,108.62409479920998,-0.40661851431697443,0.11304178228234578,0.6246877555221191,0.8339720306662272,164,158,170,174,4,10,16,85.65933125707025,23,191.57088122605364,-1.5795074368330475,-1.0353047153788573,-0.5681341404291749,2.0382374568565824,12152,12006,Marion and Nearby Counties,Macon,13,193,Georgia,GA
13197,13CS055,67,66,68,87,19,20,21,317.56593353877247,3,47.108086888249154,2.5749022705710276,2.7094991376690998,2.822733230472059,0.14135169879573445,80,79,81,127,46,47,48,625.1384269583755,30,402.5764895330112,2.0976392140614513,2.2270664802096585,2.359705722402505,0.6304465912702546,7642,7452,Marion and Nearby Counties,Marion,13,197,Georgia,GA
13249,13CS055,31,30,31,40,9,9,10,239.35286131564428,6,155.30629853321827,0.7238059753192716,0.8408868101567657,0.9665461773486055,0.5855372946657531,37,36,38,58,20,21,22,469.5434245589595,2,44.57321149988857,4.127877985905638,4.248381386089533,4.377384717018475,0.09062726704974372,4636,4487,Marion and Nearby Counties,Schley,13,249,Georgia,GA
13259,13CS055,49,49,50,59,9,10,10,215.49822295007863,12,261.9610696743678,-0.5836572826834965,-0.4617693510458662,-0.3417150931400674,1.1037919048421743,59,58,60,78,18,19,20,358.93683524490683,12,224.97187851518564,1.2208513033262043,1.335873871775224,1.4689976033766625,0.595660884698336,5497,5334,Marion and Nearby Counties,Stewart,13,259,Georgia,GA
13261,13CS055,311,298,323,342,19,31,44,126.9281075627908,69,280.64942548215436,-2.081879226013313,-1.5412166215977061,-1.0142609651349193,2.1424357764037527,378,363,393,431,38,53,68,179.6046605578662,58,197.80369688288656,-0.71836174879749,-0.1730010371139763,0.38095658865183746,1.0808055196153739,29503,29322,Marion and Nearby Counties,Sumter,13,261,Georgia,GA
13269,13CS055,82,82,83,98,15,16,16,239.61520544692468,17,259.97196380782464,-0.3176924871792047,-0.2018629485993016,-0.07780803776940244,1.0198671535619581,101,100,102,138,36,37,38,476.49604178562214,15,192.28304063581592,2.7106827293453213,2.8442011340109707,2.9628928726347885,0.3929637872253885,7847,7801,Marion and Nearby Counties,Taylor,13,269,Georgia,GA
13307,13CS055,21,21,21,27,6,6,6,304.64178030609366,8,402.68456375838923,-1.1071490488032705,-0.9813785001530252,-0.863787222429221,1.1343950899352333,26,25,26,25,-1,-1,-0,-27.632429246344913,3,126.84989429175475,-1.6595743342473444,-1.5419207239536747,-1.4233009963377192,8.658182363287255,2384,2365,Marion and Nearby Counties,Webster,13,307,Georgia,GA
13215,13CS056,1781,1692,1869,1981,112,200,289,117.12059765112107,190,111.09324523833885,-0.45158078151164704,0.04964763233539855,0.5603653892344481,0.9438253522742683,2186,2080,2292,2572,280,386,492,187.53872748029974,369,179.28896619747053,-0.4150887598946012,0.08575229875064944,0.5808232998545011,0.9535399145251291,205233,205813,Muscogee,Muscogee,13,215,Georgia,GA
13217,13CS057,786,738,835,999,164,213,261,225.8300893045997,104,110.52170139657629,0.667463474590778,1.1798490574586498,1.6888673933414695,0.4871097821724447,988,928,1047,1256,209,268,328,233.23219375811325,199,173.0750832760765,0.06824160284860953,0.5968414019257232,1.100577602219398,0.7393151021850035,112919,114979,Newton,Newton,13,217,Georgia,GA
13223,13CS058,849,776,922,1046,124,197,270,138.81406528357067,106,74.80724783429488,0.11529834430353521,0.6405847259196958,1.1295551096229048,0.5361765930833021,1076,987,1166,1297,131,221,310,127.39404920834332,188,108.55819701003009,-0.2975805863327375,0.18314289225288094,0.7062223017954199,0.8482998833681251,170037,173179,Paulding,Paulding,13,223,Georgia,GA
13245,13CS059,1775,1686,1863,2116,253,341,430,199.01498170764063,236,137.66150436025316,0.06995127374813809,0.6134209995334265,1.163605859795449,0.6896927933407544,2175,2068,2281,2658,377,483,590,234.969113189353,391,190.01890469409872,-0.05657600982620501,0.45650192810878537,0.9574310529929528,0.8070282134245831,205722,205769,Richmond,Richmond,13,245,Georgia,GA
13247,13CS060,655,615,695,777,82,122,162,156.84240023316423,71,91.38787287217497,0.08874704967979166,0.6689125753584332,1.1402506550345684,0.5779303800160878,816,768,865,1011,146,195,243,207.37163077865364,151,160.61437658221118,-0.0329310888076454,0.4658774316137848,0.962777257999328,0.7705718509676037,93229,94014,Rockdale,Rockdale,13,247,Georgia,GA
13255,13CS061,662,633,691,839,148,177,206,315.0147930297857,94,167.40872662511129,0.9716327639825444,1.469304430300619,1.9705252623028306,0.5284437481621618,814,779,849,1108,259,294,329,432.90407722306537,205,302.1949673482023,0.8020290650264872,1.3229067054435848,1.8177780094364893,0.6956955207085829,67380,67837,Spalding,Spalding,13,255,Georgia,GA
13133,13CS062,196,188,204,212,8,16,24,99.75350251178777,23,145.408566461198,-0.9846324072716923,-0.45260642232925685,0.06653177752137165,1.3708010808983093,246,236,256,275,19,29,39,147.34614404557752,33,169.56990904886698,-0.7447456241679997,-0.21819986470845204,0.2816805275395606,1.1120459376372858,18981,19461,Taliaferro and Nearby Counties,Greene,13,133,Georgia,GA
13181,13CS062,79,78,80,96,16,17,18,265.09176172707106,17,263.3277397702336,-0.10605555500789625,0.020304944181493235,0.14420464111042522,0.9385067045278916,97,96,98,122,24,25,26,325.17156974545384,17,219.58150348747094,0.9210793725854735,1.0566699108431687,1.1833539217624631,0.649480075753177,7747,7742,Taliaferro and Nearby Counties,Lincoln,13,181,Georgia,GA
13189,13CS062,220,211,229,238,9,18,27,99.08631364102968,23,128.06236080178172,-0.7926519295231244,-0.28957535527442063,0.24713926813778425,1.2236709941211619,271,260,282,311,29,40,51,184.2825002898169,37,171.09035420327382,-0.4057683086067111,0.15424260689527944,0.630393464058986,0.9056877148986052,21552,21626,Taliaferro and Nearby Counties,McDuffie,13,189,Georgia,GA
13221,13CS062,141,135,148,151,3,10,16,77.26604828766177,2,16.057808109193093,0.11005684061038987,0.6214216971707642,1.126649285352913,0.18826211479383703,176,168,184,195,11,19,27,126.50903643214798,20,132.4503311258278,-0.5947702612552851,-0.05456022117237261,0.4547461975113234,0.9948830923449776,14946,15100,Taliaferro and Nearby Counties,Ogelthorpe,13,221,Georgia,GA
13265,13CS062,21,21,21,23,2,2,2,156.46309087813202,5,385.60411311053986,-2.411124567356845,-2.291385042546399,-2.1664652625416556,1.6508162198855516,26,26,26,37,11,11,11,723.5387056187024,2,128.36970474967907,5.818357466294794,5.946127890256774,6.074567811318598,0.1629628864682647,1556,1558,Taliaferro and Nearby Counties,Taliaferro,13,265,Georgia,GA
13301,13CS062,66,66,67,89,22,23,23,523.9725816386695,6,138.1692573402418,3.7219870998048465,3.8563554308795727,3.9805190181471932,0.25259425500701116,82,81,82,86,4,4,5,84.40702893723585,13,248.32855778414518,-1.76417488441276,-1.644968864334321,-1.5162549108916357,2.3990958885944624,5211,5235,Taliaferro and Nearby Counties,Warren,13,301,Georgia,GA
13317,13CS062,134,130,138,135,-3,1,5,12.178589621166822,11,137.7439215277053,-1.768238466818696,-1.2765915078520065,-0.7270222536696319,5.576504428124683,163,158,168,179,11,16,21,170.79825379514847,21,220.6114087614245,-1.0267695008322035,-0.5112597708561919,0.02304705428292212,1.2168068294386893,9583,9519,Taliaferro and Nearby Counties,Wilkes,13,317,Georgia,GA
13277,13CS063,391,373,408,450,42,59,77,172.51975075053284,69,200.8149010477299,-0.735051399971864,-0.2904874183085123,0.19169967008913316,1.1447002978896923,484,462,505,546,41,62,84,151.09059498479536,79,191.5987582460225,-0.8979353195437966,-0.40734514935501853,0.09071968402651316,1.2480711352059461,41232,41232,Tift+Worth,Tift,13,277,Georgia,GA
13321,13CS063,214,205,222,240,18,26,35,154.04376108037326,40,232.73855702094644,-1.2875418863212968,-0.7937139224547998,-0.2765321349380207,1.4558696215591977,263,252,274,315,41,52,63,252.98475627230374,41,199.24190883467782,0.03508178866682841,0.5435070282590683,1.044041288483219,0.7727217441883383,20624,20578,Tift+Worth,Worth,13,321,Georgia,GA
13285,13CS064,600,570,630,789,159,189,219,326.2479482696276,100,172.61219792865361,1.0015056474429997,1.533345764386909,2.043085265423918,0.5262983070510742,737,701,773,942,169,205,241,293.5892933690775,161,231.08278792054196,0.1179400118199982,0.6238460526383967,1.1686748950303338,0.7832661940922546,69520,69672,Troup,Troup,13,285,Georgia,GA
13297,13CS065,783,741,825,904,79,121,163,149.36166249545002,91,112.48454882571075,-0.14275138949780608,0.3653631576998257,0.91365270983709,0.7469204819899117,983,931,1034,1244,210,261,313,262.64487552472946,213,214.16290457182504,-0.02270024078983544,0.4992390902452911,1.0147999892882302,0.8122990036528552,97080,99457,Walton,Walton,13,297,Georgia,GA
13009,13CS066,390,371,409,498,89,108,127,294.97657332701846,45,122.85571279064477,1.2240334414944387,1.726395407164476,2.217063055690622,0.4126736572470616,480,457,502,620,118,140,163,320.6996803567456,88,201.00502512562815,0.6705839104731574,1.1982378265440428,1.7467050227699426,0.6223377378995317,43954,43780,Washington and Nearby Counties,Baldwin,13,9,Georgia,GA
13125,13CS066,32,32,33,38,5,6,6,228.29288848473212,10,414.0786749482402,-1.974661722945339,-1.8585651795068427,-1.7382750635601643,1.5353263413901153,40,40,40,51,11,11,11,373.49305707214717,4,137.26835964310226,2.2338843637750463,2.361354581379288,2.4918523435933517,0.33659868607646604,2898,2914,Washington and Nearby Counties,Glascock,13,125,Georgia,GA
13163,13CS066,192,186,199,257,58,65,71,497.48054000449656,33,253.87870239774333,1.894681006924571,2.426437753257502,2.9518698172624562,0.5025571106468398,234,226,242,278,36,44,52,281.27154445033466,47,302.367472979928,-0.7251233877196657,-0.20614742411612197,0.2919610748176931,1.0509639505568846,15598,15544,Washington and Nearby Counties,Jefferson,13,163,Georgia,GA
13167,13CS066,87,86,88,124,36,37,38,478.3449373396762,24,311.4186851211073,1.5496703152871463,1.6717316938051001,1.7975419380201396,0.6338399238047158,106,105,107,142,35,36,37,390.81362546573826,25,272.89597205545243,1.0484859215103992,1.1840445198819878,1.3067544320247755,0.6793028549658103,9248,9161,Washington and Nearby Counties,Johnson,13,167,Georgia,GA
13169,13CS066,219,207,232,263,31,44,56,183.88284308637967,18,76.03224330317857,0.551479095980281,1.0885461156887983,1.605284782559396,0.40419708604006227,272,257,286,387,101,115,130,406.300231774508,60,211.31224906670425,1.4751610334631844,1.951808971156224,2.447080392665696,0.5156194547099118,28409,28394,Washington and Nearby Counties,Jones,13,169,Georgia,GA
13303,13CS066,198,189,207,271,64,73,82,438.28637956246786,53,318.4139381195554,0.6536919974656014,1.1935996001798341,1.7338684581294037,0.7166736488796519,242,232,252,312,60,70,80,354.65949611472234,58,292.84055336766636,0.09163449099365018,0.6243316118930258,1.1416548784476883,0.8141052458756266,19974,19806,Washington and Nearby Counties,Washington,13,303,Georgia,GA
13319,13CS066,102,101,103,130,27,28,29,375.85299215051157,13,176.15176151761517,1.878901535072262,1.9979309859288241,2.1095828903407425,0.4523634994403487,125,124,126,193,67,68,69,767.287653888359,26,294.3507302162346,4.609383604055388,4.730881082976,4.851021183262476,0.3780469944273488,8856,8833,Washington and Nearby Counties,Wilkinson,13,319,Georgia,GA
13175,13CS067,502,481,523,642,119,140,161,341.93585316296725,103,251.1123301030048,0.35278241466080196,0.9058787973373781,1.4299761599830416,0.7291852723968418,617,592,643,811,168,194,219,390.68598672238454,116,234.15421881308032,1.0429633251081438,1.5720881377947578,2.107161677480204,0.5962605075415379,49221,49540,Wheeler and Nearby Counties,Laurens,13,175,Georgia,GA
13209,13CS067,76,75,77,101,24,25,26,341.49430394316244,14,193.81633594831564,1.3599454616785218,1.4814526090846267,1.6010571796199287,0.5454416839078808,94,93,95,151,56,57,58,662.696505529759,30,347.14186530895626,3.0274763381257497,3.157243692805893,3.291535686139554,0.5148426386210737,8668,8642,Wheeler and Nearby Counties,Montgomery,13,209,Georgia,GA
13271,13CS067,116,110,121,192,71,76,82,704.8992091320475,33,305.90961761297797,3.4529016831155053,3.98317286273191,4.518290938514991,0.4283433374958601,139,132,145,185,40,46,53,371.2230412399664,32,257.62821028902664,0.6152957671016779,1.1344017711884353,1.6486660506116961,0.6792668696525954,12945,12421,Wheeler and Nearby Counties,Telfair,13,271,Georgia,GA
13283,13CS067,63,62,63,93,30,30,31,562.1216066143146,13,241.86046511627907,3.090814682109373,3.2044622107038547,3.3262852566844083,0.4164792996308944,76,75,76,132,56,56,57,891.6917486438497,33,522.3171889838557,3.5672866087223616,3.6919377219685816,3.8281468052376733,0.5755437372612555,6450,6318,Wheeler and Nearby Counties,Treutlen,13,283,Georgia,GA
13309,13CS067,53,53,54,68,14,15,15,233.00231577849164,12,192.0512136569752,0.29025827383065456,0.3988443011081896,0.521120488687993,0.7712696222458514,66,65,67,78,11,12,13,164.5109063592334,12,160.75016744809108,-0.09666162314530105,0.037923572619388654,0.1503207582837898,0.9035641657957172,7498,7465,Wheeler and Nearby Counties,Wheeler,13,309,Georgia,GA
13313,13CS068,733,689,778,916,138,183,227,212.77503192057878,138,160.83291247426283,0.029678494300927956,0.5220598341465434,1.0068497624082702,0.7517647272943795,905,852,958,1139,181,234,287,227.86257785450604,199,193.52329086842363,-0.20232004343379242,0.35768294385999666,0.8670352883170128,0.8456890026230387,102964,102830,Whitfield,Whitfield,13,313,Georgia,GA
15001,15CS001,1505,1418,1591,1531,-60,26,113,15.578712813907504,47,28.034874588672714,-0.6277133627147428,-0.09175862593389687,0.4248381287196995,1.7332011624369092,1865,1760,1969,2053,84,188,293,92.98185967325749,107,52.81577167791264,-0.12939402760541477,0.40962662768950625,0.9101137751526213,0.5650228289193181,201178,202591,Hawaii (county),Hawaii (county),15,1,Hawaii,HI
15003,15CS002,6754,6321,7188,6909,-279,155,588,18.45678210876444,275,32.7983883070764,-0.6773834353561953,-0.15431397137759373,0.3745590768806871,1.7656277904211224,8295,7778,8813,8768,-45,473,990,47.13673976652947,470,46.873955932497516,-0.51424584823128106,0.008317211862466228,0.5550220191156489,0.9923255136766055,1006147,1002689,Honolulu,Honolulu,15,3,Hawaii,HI
15005,15CS003,1,1,1,1,0,0,0,447.26383620692224,1,1445.7831325301206,-10.476041895171297,-9.971050045906068,-9.473419776110141,0.7637333655248306,1,1,1,3,2,2,2,2629.703316503797,3,3658.5365853658536,-10.757018914780783,-10.278885170519745,-9.752624461329145,0.9504629123300607,83,82,Kalawao+Maui,Kalawao,15,5,Hawaii,HI
15009,15CS003,990,919,1061,1026,-35,36,107,26.20883693316319,16,11.632768053510732,-0.359094103003571,0.1440823736220788,0.6661782884134116,0.43186879068317646,1222,1137,1307,1389,82,167,252,101.51076435444051,84,51.13096832314772,-0.01066925461118863,0.4971874826050931,1.0008581134709502,0.5006975667474998,165051,164284,Kalawao+Maui,Maui,15,9,Hawaii,HI
15007,15CS004,505,474,537,487,-50,-18,13,-30.31541848318514,3,4.926108374384236,-0.8443951576603894,-0.3432803673692604,0.18018041347300834,-0.17180074233351686,626,588,664,591,-73,-35,3,-47.70622496475362,18,24.51748232698149,-1.2433834153325736,-0.730373768862283,-0.20270421274975461,-0.529030875197794,73080,73417,Kauai,Kauai,15,7,Hawaii,HI
16001,16CS001,2881,2667,3095,3261,166,380,594,91.72837363749008,315,76.04287369640788,-0.3350897133510032,0.15818150772299436,0.7221560151741878,0.8268245725817144,3647,3383,3910,4154,244,507,771,99.50442039826243,451,88.449235826059,-0.4272570654973317,0.10084102252409514,0.6159669500560048,0.8871490286007859,497088,509897,Ada,Ada,16,1,Idaho,ID
16005,16CS002,638,601,676,704,28,66,103,90.3753802313983,59,81.02169733589673,-0.42536146095309213,0.0984472661920647,0.563828945955086,0.8830834631514777,794,749,840,937,97,143,188,162.11480006492317,126,143.0111798422337,-0.3484131680457647,0.1817923782742806,0.7108936395616601,0.8760266265710418,87384,88105,Bannock+Bear Lake+Caribou+Franklin,Bannock,16,5,Idaho,ID
16007,16CS002,53,52,54,69,15,16,17,302.091414202977,6,113.3322839603337,1.7630015510941397,1.8879042991748622,2.0059532927443873,0.3530819325082967,67,66,68,79,11,12,13,185.3702201009114,11,168.7375364319681,0.030696048413085823,0.16172198973997132,0.28823133474575324,0.8407032020174884,6353,6519,Bannock+Bear Lake+Caribou+Franklin,Bear Lake,16,7,Idaho,ID
16029,16CS002,58,57,59,74,15,16,17,270.5162991623964,7,119.23349893541518,1.3969529181280007,1.5116758496233882,1.6339238487550247,0.4146535959406701,72,71,73,78,5,6,7,83.96524350801243,15,211.35691137100184,-1.3988596376489972,-1.2712630304296997,-1.1472432410146602,2.1554779801231545,7045,7097,Bannock+Bear Lake+Caribou+Franklin,Caribou,16,29,Idaho,ID
16041,16CS002,97,95,98,91,-7,-6,-4,-48.85529291933999,5,42.08754208754208,-1.0303230009537585,-0.901696398412749,-0.7806573068316603,-1.0407974276047638,122,120,124,134,10,12,14,79.77400178188489,16,109.52902519167579,-0.42162726574247855,-0.29813041297659437,-0.17060652253205288,1.264483654574076,14256,14608,Bannock+Bear Lake+Caribou+Franklin,Franklin,16,41,Idaho,ID
16009,16CS003,112,111,113,102,-11,-10,-9,-121.05029849670046,4,50.14102162331558,-1.8315775803083314,-1.7089186628734025,-1.5936699035216322,-0.46206516806455106,141,139,142,158,16,17,19,174.7188833973574,23,232.81708674967103,-0.7093141925095132,-0.5805727150325812,-0.45864312342732605,1.2595507840364895,9573,9879,Benewah+Latah+Nez Perce,Benewah,16,9,Idaho,ID
16057,16CS003,182,165,199,213,14,31,48,94.66764721491113,2,6.03090840557859,0.3708267247415419,0.8865391704460222,1.3915923640145238,0.06173952626452721,227,206,247,303,56,76,97,189.87175011130074,29,72.11956927208972,0.6604024888798045,1.182683735780856,1.7045015141919666,0.37492244872690794,39795,40211,Benewah+Latah+Nez Perce,Latah,16,57,Idaho,ID
16069,16CS003,443,425,461,463,2,20,38,56.65684619223199,37,105.9438306807607,-0.9867260339860828,-0.489244894730575,-0.009408919174029983,1.7799645027832733,543,522,565,609,44,66,87,154.48213103533905,58,136.7892266691823,-0.35838518646596457,0.17912820246736727,0.7171337067886526,0.8721546356090505,41909,42401,Benewah+Latah+Nez Perce,Nez Perce,16,69,Idaho,ID
16011,16CS004,350,329,371,406,35,56,77,139.89141146928486,43,107.58292850739112,-0.201411256718275,0.3336682028129679,0.8255159916245574,0.7555334292864815,438,413,463,504,41,66,91,135.40404584704908,75,153.82091144017392,-0.7107562663973696,-0.1737167759520476,0.32017639486573846,1.1190638473623513,47963,48758,Bingham+Oneida+Power,Bingham,16,11,Idaho,ID
16071,16CS004,38,38,38,39,1,1,1,25.543243218190142,4,105.44815465729349,-0.9171640272009057,-0.7971482016136636,-0.6845843775947899,2.031549600211653,47,47,48,63,15,16,16,342.0901208620898,6,130.3497718878992,1.9894227080938087,2.121883372174615,2.241198001780081,0.358285783176297,4552,4603,Bingham+Oneida+Power,Oneida,16,71,Idaho,ID
16077,16CS004,55,55,56,63,7,8,8,116.47586468031557,3,45.854031333588075,0.5906505668701868,0.7070939292617641,0.8244792339197132,0.3480103429306187,69,68,70,88,18,19,20,239.92136825994118,12,151.13350125944584,0.7615719118960362,0.8849907478561824,1.0128976505764675,0.5985110051737846,7851,7940,Bingham+Oneida+Power,Power,16,77,Idaho,ID
16015,16CS005,51,50,52,57,5,6,7,90.64681366673206,3,46.565774155995335,0.32025973784450823,0.44076659790591777,0.554184226716868,0.43860155884079116,66,65,67,93,26,27,28,341.3902405301113,3,37.36455349358575,2.9010063871553564,3.0378997081086556,3.1694100214677547,0.10559579423481305,7731,8029,Boise+Gem+Payette+Washington,Boise,16,15,Idaho,ID
16045,16CS005,200,192,209,227,18,27,35,166.6672053752874,17,106.49404886197534,0.058410257374295574,0.586723412866241,1.046031176306369,0.6158161536779316,251,241,261,304,43,53,63,269.63282144084167,37,187.68387947651416,0.30889995399426645,0.8106123736417844,1.3317203848456438,0.6832188507290421,19156,19714,Boise+Gem+Payette+Washington,Gem,16,45,Idaho,ID
16075,16CS005,219,208,230,220,-10,1,12,4.002106892359881,25,117.90598962427292,-1.610458899307999,-1.148838736877176,-0.6220329269043265,13.523893542295983,276,262,289,338,49,62,76,236.93779532668282,47,179.12267998018217,0.039990139108188244,0.5852604512796801,1.0515098745189493,0.74402278865608,25444,26239,Boise+Gem+Payette+Washington,Payette,16,75,Idaho,ID
16087,16CS005,107,106,108,138,30,31,32,350.098526635639,13,148.2889733840304,1.8937229704735214,2.020005136839365,2.143272411492901,0.4101985347537739,136,134,137,163,26,27,29,250.09476125121083,28,258.1596902083717,-0.20746963442783903,-0.07576023231050308,0.04578056911007581,0.9955457220307815,10520,10846,Boise+Gem+Payette+Washington,Washington,16,87,Idaho,ID
16017,16CS006,417,396,437,414,-23,-3,18,-6.803005640998126,18,45.59559242606548,-1.0254359616719064,-0.5348805399597241,-0.016458536332710463,-10.678331822365497,528,502,553,618,65,90,116,183.66553789800156,120,243.97682220189083,-1.1165070877735186,-0.6089606947052646,-0.11785105242950714,1.3138317661734784,47373,49185,Bonner+Boundary+Shoshone,Bonner,16,17,Idaho,ID
16021,16CS006,99,98,100,113,13,14,15,137.09068295170093,1,9.841712457967686,1.1631870877766708,1.27349590157014,1.3968518968597186,0.06698122922809213,125,123,126,179,53,54,56,434.76607358775175,41,328.10499359795136,0.9380799994908238,1.0634818839731612,1.1937054030325396,0.7410303442953311,12193,12496,Bonner+Boundary+Shoshone,Boundary,16,21,Idaho,ID
16079,16CS006,167,161,172,158,-14,-9,-3,-77.79352272680019,24,218.41346883057787,-3.4788193748812444,-2.9681391190470356,-2.4866644891810568,-3.1795611075730963,208,201,215,246,31,38,45,282.49322307136515,42,309.96309963099634,-0.7907501008675588,-0.27782843656198697,0.23651677856813735,1.069305461992096,13186,13550,Bonner+Boundary+Shoshone,Shoshone,16,79,Idaho,ID
16019,16CS007,835,781,888,942,54,107,161,103.78452786550514,111,107.25414885136604,-0.5424719445296087,-0.020393446017926888,0.4788789281775477,1.0238983171079339,1054,988,1120,1104,-16,50,116,39.19944314319258,115,90.23287929194652,-1.0329182843215732,-0.4954838960647295,0.028448614212321505,2.25672033323178,124191,127448,Bonneville,Bonneville,16,19,Idaho,ID
16027,16CS008,1425,1324,1526,1649,123,224,325,115.14414698838033,209,107.43614018103077,-0.4287607401339523,0.06607149466016271,0.6474648514570487,0.9289107417853832,1818,1693,1943,2131,188,313,438,129.48962393610307,334,138.24617753458224,-0.5760248557764651,-0.09554476517446224,0.42225780023924175,1.064221831299278,233441,241598,Canyon,Canyon,16,27,Idaho,ID
16003,16CS009,38,38,39,41,2,3,3,70.56681008253697,3,81.41112618724559,-0.23148920862669164,-0.10502801930597591,0.014316343456953883,0.8332437708440102,49,48,50,55,5,6,7,131.88372005482552,4,87.03220191470844,0.31472851340817865,0.4461464961256508,0.568659737230282,0.5664618522196115,4422,4596,Central Idaho,Adams,16,3,Idaho,ID
16035,16CS009,92,91,92,104,12,12,13,170.82260375821622,4,54.75076993270218,1.0411625417374146,1.1582372378704624,1.287220700357068,0.296735580875512,113,112,115,132,17,19,20,209.13787171427234,16,180.30200585981518,0.16366878247466726,0.28853693581881296,0.41366784299019665,0.818042134590163,8767,8874,Central Idaho,Clearwater,16,35,Idaho,ID
16037,16CS009,45,43,47,40,-7,-5,-3,-131.6754721845039,2,56.022408963585434,-2.4551531667870052,-1.8759070360447923,-1.3879997753438376,-0.5404215956480465,56,53,58,69,11,13,16,300.69418520799314,4,90.82652134423252,1.5741894025477772,2.0968963755123293,2.6161354758704225,0.28084815182496287,4284,4404,Central Idaho,Custer,16,37,Idaho,ID
16049,16CS009,168,161,176,181,5,13,20,90.62405888239248,16,115.52346570397111,-0.7932797246364933,-0.2550643493782755,0.2618908049739765,1.180687016452871,209,200,218,257,39,48,57,283.8986895209183,30,176.78255745433117,0.5533538553785735,1.0650259006543117,1.5586834686433528,0.610033742122557,16620,16970,Central Idaho,Idaho (county),16,49,Idaho,ID
16059,16CS009,90,89,91,109,18,19,20,283.9002030870212,11,165.24787180771156,1.067648083953176,1.1851572132320154,1.3052210662635317,0.552811316824588,112,111,113,148,35,36,37,439.6059756758029,13,159.8819333415324,2.6722916501712026,2.793681243182428,2.921796965512413,0.35379577529954964,7988,8131,Central Idaho,Lemhi,16,59,Idaho,ID
16061,16CS009,37,36,39,47,8,10,11,322.38988148895265,8,266.96329254727476,0.0022575275823959657,0.5485062539441323,1.036470181967266,0.750402160547552,47,45,49,67,18,20,22,550.7762386035084,12,325.3796095444685,1.743140243929684,2.2507316219897113,2.7601121376725026,0.5630464802531746,3596,3688,Central Idaho,Lewis,16,61,Idaho,ID
16085,16CS009,77,76,79,83,4,6,7,55.97895941754773,4,40.602266959905265,0.028769754262255608,0.15310756763841105,0.2762799666614111,0.6139809147155917,98,97,100,101,1,3,4,23.290090087226936,1,8.208832703989492,0.022116463282795602,0.15033021577360967,0.27370460033608257,0.26060677561578555,11822,12182,Central Idaho,Valley,16,85,Idaho,ID
16039,16CS010,194,181,206,209,3,15,28,64.21417075094143,11,46.322290847838296,-0.324285445573317,0.17396744201483327,0.6580004284369994,0.6769761901423985,241,226,256,239,-17,-2,13,-7.652995896242891,43,149.28482155256214,-2.0862156757542936,-1.569419945597503,-1.0689941931372868,-35.7033452498834,28496,28804,Elmore+Gooding+Owyhee,Elmore,16,39,Idaho,ID
16047,16CS010,120,119,122,169,47,49,50,375.8394225252577,20,153.79685998077537,2.104254139924962,2.2169401481458904,2.3390229991710827,0.40100423567554955,149,147,151,170,19,21,23,134.07487327304437,26,165.04792737891194,-0.43127566028445796,-0.3077400204105697,-0.17793077511013267,1.175363577277867,15605,15753,Elmore+Gooding+Owyhee,Gooding,16,47,Idaho,ID
16073,16CS010,89,88,90,118,28,29,30,290.5699122304883,17,170.09922454765277,1.077816312310877,1.202191543126166,1.3312382025822191,0.5659113389265167,112,110,113,140,27,28,30,228.6975396001577,19,154.67274503419083,0.6097616370026337,0.7377529738244221,0.8618017983730817,0.6530734410573265,11993,12284,Elmore+Gooding+Owyhee,Owyhee,16,73,Idaho,ID
16023,16CS011,25,25,25,31,6,6,6,280.0874635967455,1,46.31416441528367,2.2241790932968244,2.3338377301926423,2.454797176803206,0.14189317834400264,31,31,32,45,13,14,14,521.0869400703622,4,151.3431706394249,3.5707391675298283,3.702476445302396,3.820727075803415,0.27077655242281123,2591,2643,Jefferson and Nearby Counties,Butte,16,23,Idaho,ID
16033,16CS011,5,5,5,6,1,1,1,115.97415253020677,6,901.1264080100124,-7.974941291298917,-7.857435177918242,-7.727864284521938,3.3856327722001067,6,6,6,10,4,4,4,456.11652126256627,4,505.0505050505051,-0.6253970647197358,-0.48384339165656387,-0.3619776501094356,0.8672194174477335,799,792,Jefferson and Nearby Counties,Clark,16,33,Idaho,ID
16043,16CS011,95,94,96,111,15,16,17,142.64185139940588,13,116.59192825112106,0.13048555980141882,0.26392344361770576,0.3768619481319537,0.7690229769001545,119,117,120,164,44,45,47,334.1573990178432,5,36.85956505713233,2.8422792325022717,2.9785205127635663,3.097558950139039,0.1079250411571508,13380,13565,Jefferson and Nearby Counties,Fremont,16,43,Idaho,ID
16051,16CS011,163,150,176,176,-0,13,26,49.87434784814303,16,61.91750782031023,-0.5934785176253622,-0.12618566474805135,0.3973881400556944,1.1520781207424298,207,190,223,251,28,44,61,138.0394758284818,37,115.49867332604964,-0.2667793079949475,0.20248639505249788,0.7705434343602587,0.8182049073716896,31009,32035,Jefferson and Nearby Counties,Jefferson,16,51,Idaho,ID
16065,16CS011,174,152,196,164,-32,-10,12,-23.48003776287927,15,35.2023155300882,-1.0872467487305848,-0.5866533609158378,-0.07600266940052751,-1.6657339005194507,225,197,253,234,-19,9,37,16.683871132604025,20,37.2203818811181,-0.7228575557755308,-0.20925187487774707,0.3020658827263004,2.007042448146201,51133,53734,Jefferson and Nearby Counties,Madison,16,65,Idaho,ID
16081,16CS011,45,44,46,37,-9,-8,-7,-78.08594254572562,7,70.94594594594595,-1.610406462694854,-1.4907230462890513,-1.3690013570323767,-1.0440780418878237,57,56,59,70,11,13,14,104.66108771690158,7,57.4288292722947,0.33482387670026337,0.4709131996784082,0.5985383925576839,0.5088266899409298,11840,12189,Jefferson and Nearby Counties,Teton,16,81,Idaho,ID
16055,16CS012,1381,1307,1455,1387,-68,6,80,4.1967451970650105,115,80.05987085994742,-1.2815695876860347,-0.7634153031440523,-0.27352700735663305,16.36239787181791,1757,1665,1849,2018,169,261,353,145.94215063168946,310,173.4294841312022,-0.7720352479119789,-0.26716771572755355,0.2595815769391744,1.1838060706777471,172371,178747,Kootenai,Kootenai,16,55,Idaho,ID
16013,16CS013,112,110,115,121,6,9,11,44.06999369767942,15,74.43860882511062,-0.42165111060732685,-0.30396212043561344,-0.18665481714838347,1.5181462533838272,142,139,145,156,11,14,17,55.532686419408975,11,44.530807222087276,-0.008887853787574052,0.11650070946109199,0.22640907118749162,0.7474001922467146,24181,24702,Lincoln and Nearby Counties,Blaine,16,13,Idaho,ID
16025,16CS013,10,10,11,12,1,2,2,166.72075607845392,0,0,1.1654976791547447,1.6747630066468528,2.200785726165518,0,13,13,14,7,-7,-6,-6,-554.7703316268659,7,618.3745583038869,-12.243658742746453,-11.751727418975445,-11.200712523747608,-1.3257575370855996,1094,1132,Lincoln and Nearby Counties,Camas,16,25,Idaho,ID
16031,16CS013,185,175,196,192,-4,7,17,32.21046218593152,18,87.61611162941631,-1.053438142011226,-0.5444062268377418,-0.061372403053710535,2.36301998628141,232,219,245,234,-11,2,15,6.196676009129715,25,99.6174689193497,-1.460427692021235,-0.9269011610572508,-0.42430254016905816,9.784284657997029,24653,25096,Lincoln and Nearby Counties,Cassia,16,31,Idaho,ID
16053,16CS013,154,143,164,158,-6,4,15,22.181971487839064,17,83.92989385336955,-1.1364659777723354,-0.6243960334775842,-0.06413658510758556,3.0948714689962085,193,180,205,242,37,49,62,200.12490685380547,39,158.54947556711926,-0.10868939327360075,0.414192909287602,0.9357597165452278,0.7764790620926956,24306,24598,Lincoln and Nearby Counties,Jerome,16,53,Idaho,ID
16063,16CS013,33,33,34,39,5,6,6,129.4840385572883,4,92.71779022599961,0.24600051102276824,0.37331379813972165,0.4941648222010615,0.6073344228291244,42,41,43,38,-5,-4,-3,-74.75462674806954,2,38.02281368821293,-1.2502879388578816,-1.123225650215386,-1.0042354052853635,-0.6821065190299438,5177,5260,Lincoln and Nearby Counties,Lincoln,16,63,Idaho,ID
16067,16CS013,175,166,185,178,-7,3,12,14.865453201076615,23,127.8251204149685,-1.647977870285186,-1.1164157584183911,-0.622721953996552,6.258860120655911,219,207,230,228,-2,9,21,42.6839599490308,29,132.33549329195947,-1.376492061976754,-0.882262888337818,-0.4421896988331091,2.8009140297078097,21592,21914,Lincoln and Nearby Counties,Minidoka,16,67,Idaho,ID
16083,16CS014,693,655,732,838,106,145,183,192.7504492681996,98,130.63183151159691,0.08881416017411602,0.6107397301395059,1.1559545219046594,0.6730705111511187,868,820,915,986,71,118,166,128.4987063888981,130,141.37042313255108,-0.6495797717014385,-0.12741129207239288,0.35769675696809,1.0909375733754376,90024,91957,Twin Falls,Twin Falls,16,83,Idaho,ID
17001,17CS001,681,653,710,745,35,64,92,116.62282429576513,71,130.17371774304442,-0.6449547148677152,-0.1470905561144178,0.3974197699090774,1.0989180403441485,828,794,861,936,75,108,142,166.59666742930062,103,158.36895353485656,-0.44566014358960937,0.06939073020201719,0.5903092860077946,0.9419197593185712,65451,65038,Adams,Adams,17,1,Illinois,IL
17005,17CS002,151,143,158,165,7,14,22,104.08049834175621,11,79.39372067845542,-0.22409765924526587,0.2619628811594005,0.7688853674592224,0.7133429414826626,183,174,192,219,27,36,45,216.38342335663606,28,168.61375406479587,-0.058331806476396394,0.4818730274099322,0.9952725817516839,0.7581371548035172,16626,16606,Bond+Effingham+Fayette,Bond,17,5,Illinois,IL
17049,17CS002,308,294,323,379,56,71,85,245.5011887087352,44,152.95037803076386,0.41756000296680407,0.918920898429982,1.4246877784976522,0.6143144670236765,375,357,392,430,38,55,73,160.4677251863712,53,153.81489973009838,-0.4334938554603638,0.06365216355325162,0.5525488567984687,0.9415131319849716,34521,34457,Bond+Effingham+Fayette,Effingham,17,49,Illinois,IL
17051,17CS002,192,182,201,226,25,34,44,191.99773805179393,34,190.3606587971819,-0.4747364905170141,0.008506309479724713,0.5134018919980896,0.963380327102095,233,222,244,244,-0,11,22,51.108657066800504,30,140.21967749474175,-1.3951768139728822,-0.9061857831730311,-0.351241622983365,2.513679195118272,21433,21395,Bond+Effingham+Fayette,Fayette,17,51,Illinois,IL
17007,17CS003,359,336,382,401,19,42,65,94.41045192929445,57,128.32539116731078,-0.8437115790305378,-0.35100986555039543,0.20849208690320442,1.327571231990051,442,415,470,500,30,58,85,108.4105605020117,37,69.57110354812627,-0.13301187064614053,0.3935157564170732,0.8836009183301872,0.6307966332928091,53302,53183,Boone,Boone,17,7,Illinois,IL
17009,17CS004,47,46,48,60,12,13,14,245.57494670155782,2,38.11338732729871,1.9479784135496243,2.07779501895216,2.195020375209639,0.14402430213824774,59,58,60,67,7,8,9,127.94810082988727,8,125.17602879048661,-0.09731154533603327,0.023759246126274225,0.1542209535271669,0.8717290835819724,6297,6391,Brown and Nearby Counties,Brown,17,9,Illinois,IL
17013,17CS004,41,41,42,59,17,18,18,479.60196757095457,5,134.6801346801347,3.328073917125635,3.4498247810571665,3.564304751930223,0.26588357860740575,50,49,50,68,18,18,19,419.1284602263267,2,45.714285714285715,3.6094025393959956,3.732184505173067,3.8618495187765234,0.10342935470152069,4455,4375,Brown and Nearby Counties,Calhoun,17,13,Illinois,IL
17017,17CS004,125,124,127,140,13,15,16,137.98627006105428,27,252.76954283039473,-1.2721862231341057,-1.1482083212284877,-1.0297328330622388,1.7154583892579114,153,152,155,149,-6,-4,-3,-34.8299436604893,16,125,-1.7170658884926537,-1.597235428845024,-1.4755716681975446,-4.626640535307261,12818,12800,Brown and Nearby Counties,Cass,17,17,Illinois,IL
17149,17CS004,171,164,177,217,40,46,53,376.54259605523646,39,316.8799512492383,0.09209970343716549,0.6087453671809039,1.1176186487901403,0.8237757739832935,208,200,215,236,21,28,36,193.5478646375374,32,218.87824897400822,-0.7371122081861077,-0.26868044076180975,0.2734686845884814,1.0922732728283309,14769,14620,Brown and Nearby Counties,Pike,17,149,Illinois,IL
17169,17CS004,78,78,79,80,1,2,2,31.15410603650224,4,69.91988346686088,-0.5097623689459478,-0.38524989011562216,-0.2661109414042508,1.437672675601564,96,95,96,108,12,12,13,181.01338697684315,3,43.80841121495327,1.2489575810058273,1.3742011479612903,1.4902234689599405,0.22395084504402413,6865,6848,Brown and Nearby Counties,Schuyler,17,169,Illinois,IL
17171,17CS004,50,50,51,59,8,9,9,211.08791503953253,4,97.48172217709178,1.017705328296156,1.1325138760110032,1.252613729343579,0.4140083543668475,61,60,61,69,8,8,9,169.2363436964141,6,123.73685295937307,0.32732148550892837,0.45251147186767376,0.5893339267602988,0.651729723403241,4924,4849,Brown and Nearby Counties,Scott,17,171,Illinois,IL
17011,17CS005,345,330,359,417,58,72,87,262.7747977119603,57,207.14091032979013,0.01665848627642721,0.5522901784349378,1.0530879863974258,0.7775301431835263,420,403,437,447,10,27,44,80.94793909297726,51,154.9351398973175,-1.2073149081145589,-0.7280485190094784,-0.24484661479909695,1.844775983056555,33021,32917,Bureau+Marshall+Putnam+Stark,Bureau,17,11,Illinois,IL
17123,17CS005,148,143,153,148,-5,0,5,1.4751743495773033,6,61.77606177606177,-1.1048150915554915,-0.6039153535984308,-0.15415942910223232,5.2480751628697275,180,174,186,184,-2,4,10,31.1756645587993,17,145.71012256792662,-1.6093021156860217,-1.13237456010954,-0.640282420485083,3.6659541327853225,11655,11667,Bureau+Marshall+Putnam+Stark,Marshall,17,123,Illinois,IL
17155,17CS005,49,48,50,42,-8,-7,-6,-150.25873232205913,6,127.56909992912826,-2.9042705983197536,-2.779055347161427,-2.6588655770872447,-0.9889290964096425,59,59,60,71,11,12,12,207.78890817707156,8,143.47202295552367,0.5186812069195529,0.6464397541239809,0.7676704956713567,0.6356112558107144,5644,5576,Bureau+Marshall+Putnam+Stark,Putnam,17,155,Illinois,IL
17175,17CS005,63,63,64,77,13,14,14,305.53036935277214,12,268.20636990128514,0.2559751276092566,0.37572446085639355,0.5001553936915534,0.817999370368265,77,76,77,97,20,20,21,384.72385231339155,4,75.35795026375283,2.968988985679627,3.0911430118152774,3.220760684049204,0.18673140698628807,5369,5308,Bureau+Marshall+Putnam+Stark,Stark,17,175,Illinois,IL
17015,17CS006,171,164,178,216,38,45,52,349.2579051202436,26,201.6285381930981,0.9531714357567755,1.4722344447243134,1.9887192998380459,0.5647654946204044,210,202,218,214,-4,4,12,24.886498470629423,13,82.83948257184731,-1.0883669679489458,-0.5858354117943229,-0.07396042383837652,2.6501200212369067,15474,15693,Carroll+Jo Daviess+Stephenson,Carroll,17,15,Illinois,IL
17085,17CS006,207,198,216,247,31,40,49,219.32051660101263,23,125.9871274022002,0.41989860674334245,0.9159992565242484,1.463673845720877,0.5604454013889985,253,241,264,259,-5,6,18,28.569565892953978,18,81.99334942832415,-1.0560318975897218,-0.5261855267949079,-0.024602101618529222,2.475289460186042,21907,21953,Carroll+Jo Daviess+Stephenson,Jo Daviess,17,85,Illinois,IL
17177,17CS006,462,443,481,573,92,111,130,299.61066953166835,64,172.97686884839746,0.7672973907936123,1.2823662615276152,1.7743264091329056,0.5721772501817065,560,537,582,653,71,93,116,212.04305136126104,93,210.95610751956445,-0.5303774493271671,-0.008504942571964576,0.5513891622985182,0.9843438606764738,44399,44085,Carroll+Jo Daviess+Stephenson,Stephenson,17,177,Illinois,IL
17019,17CS007,1126,1037,1214,1277,63,151,240,88.0575217129367,66,38.42365965952368,-0.04648418458852185,0.5063397209016992,1.0002828221065685,0.43348138998859065,1399,1293,1505,1642,137,243,349,118.07228760999465,128,62.173951057442906,0.01285523282277298,0.5531544892684627,1.1579018819955111,0.5244179197408537,206123,205874,Champaign,Champaign,17,19,Illinois,IL
17021,17CS008,371,357,386,418,32,47,61,166.10036561252102,61,217.46880570409982,-1.0414689382154745,-0.5023145667255442,0.02634006548977797,1.281750844978704,453,436,471,501,30,48,65,141.70351765574455,40,118.70492922218595,-0.31906214288666884,0.2331185812668232,0.7490282441898899,0.8205156086760885,33660,33697,Christian+Shelby,Christian,17,21,Illinois,IL
17173,17CS008,201,192,210,234,24,33,42,189.47819393988343,30,171.4775650185767,-0.33412434774029026,0.17635745772545858,0.689414946531041,0.8784976277294863,244,234,255,321,66,77,87,368.0108140251704,48,230.71377072819035,0.8989436529935364,1.3668039632985436,1.8556363621184844,0.6188386086692101,20994,20805,Christian+Shelby,Shelby,17,173,Illinois,IL
17023,17CS009,163,157,170,191,21,28,34,217.17702572762684,18,140.22331861854062,0.249786825910735,0.7839528490611931,1.2840531534901494,0.6233055855523342,197,189,205,234,29,37,45,243.7687724759806,30,195.87359623922697,-0.0097325825880573,0.4879627792257478,1.009724822447635,0.7825619081316271,15404,15316,Clark+Crawford+Cumberland+Jasper,Clark,17,23,Illinois,IL
17033,17CS009,186,178,194,195,1,9,17,59.23169604215578,29,186.61518661518662,-1.7832842535264164,-1.273727752144721,-0.742126460479707,2.841854083964217,225,216,235,240,5,15,24,77.88232416464854,27,144.72555746140654,-1.2115083951158783,-0.6910873676783595,-0.16793941520011088,1.738601138953854,18648,18656,Clark+Crawford+Cumberland+Jasper,Crawford,17,33,Illinois,IL
17035,17CS009,94,93,95,103,8,9,10,99.64351538371649,20,229.35779816513758,-1.4222301611648642,-1.297664917513602,-1.1739548259640795,2.064214718214047,114,113,115,157,42,43,44,413.7599360419426,19,183.4508062180168,2.1748077538946164,2.3031127223547396,2.4233274171175694,0.43326453131628223,10464,10357,Clark+Crawford+Cumberland+Jasper,Cumberland,17,35,Illinois,IL
17079,17CS009,82,81,83,87,4,5,6,63.691385876193856,13,167.83216783216784,-1.163836050045655,-1.0440268624342814,-0.9193690858409364,2.190976058113598,99,98,101,124,23,25,26,268.01115908384367,13,141.28899032713835,1.140897207426244,1.267222738987136,1.4001555861550137,0.5066308874073803,9295,9201,Clark+Crawford+Cumberland+Jasper,Jasper,17,79,Illinois,IL
17025,17CS010,157,151,163,176,13,19,25,172.4913887210638,29,262.8200286987387,-1.3825878901185253,-0.9097954417424204,-0.3696156760721387,1.447612357603917,190,184,197,182,-15,-8,-2,-64.47276441616741,19,144.36592964060483,-2.602556057222881,-2.097418485939494,-1.603557445390046,-2.538321804166961,13241,13161,Clay+Hamilton+Wayne+White,Clay,17,25,Illinois,IL
17065,17CS010,86,85,87,107,20,21,22,313.5762115797784,11,165.14450143875894,1.3703409721660982,1.4828930376116702,1.593876464240651,0.50258629017232,105,104,106,103,-3,-2,-1,-22.057541061775307,18,227.24403484408535,-2.6163058973101223,-2.4986820984534,-2.3657854732855554,-24.090650628845616,7993,7921,Clay+Hamilton+Wayne+White,Hamilton,17,65,Illinois,IL
17191,17CS010,172,165,179,215,36,43,50,317.620359854747,32,238.28730995966487,0.28631153216610666,0.8029230104661141,1.311880855147429,0.7330409684741815,209,201,218,242,24,33,41,204.7680124221549,29,181.40873264106094,-0.26897412050203096,0.23344029192589763,0.7361327493723341,0.8596613396584508,16115,15986,Clay+Hamilton+Wayne+White,Wayne,17,191,Illinois,IL
17193,17CS010,192,186,198,215,17,23,29,196.82274465835047,31,270.1328879529446,-1.2361031674888474,-0.7377237335532844,-0.2289922518478793,1.3142804978665794,234,227,242,253,11,19,26,135.0168637584637,22,159.55903684363213,-0.7664985066429393,-0.24538061814799136,0.3028610436581088,1.121526285324643,13771,13788,Clay+Hamilton+Wayne+White,White,17,193,Illinois,IL
17027,17CS011,292,276,308,347,39,55,71,178.23833600846373,41,133.09887731638037,-0.05893044423762547,0.45297694369020736,0.9431060575433194,0.7333891723121005,355,336,374,364,-10,9,28,24.03608857015418,35,95.08802434253424,-1.2448180031316822,-0.7292899341358131,-0.20152394920685415,3.5543085981597655,36965,36808,Clinton+Marion,Clinton,17,27,Illinois,IL
17121,17CS011,439,423,456,567,111,128,144,407.97369106175796,51,163.0043947263284,1.952357074494446,2.4466813070996083,2.9588612350647225,0.3964405281194525,531,512,551,593,42,62,81,165.11712747430778,67,179.03428372925742,-0.6619896882896226,-0.14280625950185227,0.38870829275050073,1.0670186003654551,37545,37423,Clinton+Marion,Marion,17,121,Illinois,IL
17029,17CS012,401,381,421,524,103,123,143,312.1803188446879,50,126.77216928310338,1.3609886291586322,1.8650504052447905,2.3852923379011304,0.40281480782749934,488,464,512,597,85,109,133,233.75469624489605,64,136.86619191206347,0.4883842626718188,0.9613798185166103,1.4512821609527236,0.5802039830720026,47329,46761,Coles,Coles,17,29,Illinois,IL
17031,17CS013,34998,32744,37252,44691,7439,9693,11947,222.13744176880058,7636,174.99429461918132,-0.03806365446766945,0.4819508099872435,1.0179364555926023,0.7876936082587671,42715,40037,45392,47087,1695,4372,7050,84.30640464763923,4196,80.90683527784827,-0.4982528095267756,0.053820974896496676,0.553567404829447,0.9594565854623152,5236285,5186212,Cook,Cook,17,31,Illinois,IL
17037,17CS014,602,559,646,753,107,151,194,178.88838868762716,56,66.55705881187727,0.6214227057318614,1.1232805349698975,1.6582383056007068,0.3696035194116799,744,692,796,892,96,148,200,147.386876782613,69,68.7333147388134,0.27777514180827706,0.7766048163464817,1.2971875283313898,0.46321552524667614,100966,100388,DeKalb,DeKalb,17,37,Illinois,IL
17039,17CS015,171,164,177,205,28,34,41,266.951534163065,21,163.03293006404866,0.5528368141426647,1.0415701266545363,1.5800165805794952,0.5934620457419933,208,200,216,230,14,22,30,144.23959929112422,21,136.75436311539463,-0.4278112923044272,0.08221973114000383,0.5742596440158665,0.9071496533206378,15457,15356,De Witt+Logan+Mason+Menard,De Witt,17,39,Illinois,IL
17107,17CS015,291,278,303,351,48,60,73,259.22058295917213,47,201.42137780793544,0.07612665537363984,0.5818956201403849,1.0563165949687165,0.7643896821751821,357,342,371,332,-39,-25,-10,-88.01809921576236,30,107.23477266228196,-2.4411917378129724,-1.946371453625048,-1.4570793374901625,-1.2698980625529097,28001,27976,De Witt+Logan+Mason+Menard,Logan,17,107,Illinois,IL
17125,17CS015,156,150,161,193,32,37,43,343.81545492124764,33,303.12308634415183,-0.10441777670784994,0.42746105602714446,0.9315537328724786,0.8587031871713374,188,182,195,222,27,34,40,260.90412775312416,20,155.0147263990079,0.5505699272642796,1.050391711970687,1.5611573435084414,0.5770032377185758,13064,12902,De Witt+Logan+Mason+Menard,Mason,17,125,Illinois,IL
17129,17CS015,106,105,108,111,3,5,6,44.77641308583611,12,117.5990200081666,-0.8548532314976033,-0.7229286777779459,-0.611101359772365,2.1547622742080197,130,129,132,162,30,32,33,260.6846989930604,14,114.95196649971263,1.3377985832180976,1.4553185927248848,1.581757423972446,0.42749671721817395,12245,12179,De Witt+Logan+Mason+Menard,Menard,17,129,Illinois,IL
17041,17CS016,169,161,178,200,22,31,39,187.46395116294264,29,176.67665126669036,-0.38893247562195077,0.11090452238219914,0.6337567098993495,0.9127922851319721,208,198,218,247,29,39,49,199.2363745016003,17,86.1850443599493,0.6077430233006932,1.1227849854566248,1.6644411023772545,0.4218427718706226,19697,19725,Douglas+Edgar+Moultrie+Piatt,Douglas,17,41,Illinois,IL
17045,17CS016,193,186,201,242,41,49,56,346.9208798930947,36,257.2806860818295,0.4214563789872325,0.904264665288577,1.4218049654543017,0.7266429096182876,233,225,242,278,36,45,53,271.2344230599834,42,253.71511417180136,-0.33981997568165523,0.16783039311879458,0.7225514024606227,0.9150297613448413,16791,16554,Douglas+Edgar+Moultrie+Piatt,Edgar,17,45,Illinois,IL
17139,17CS016,165,159,172,183,11,18,24,145.11186671723482,20,165.68864342423194,-0.7133485054921286,-0.2511689992192288,0.26928054131072554,1.0801345575144863,202,195,210,216,6,14,21,95.37160100214041,19,130.98028402040535,-0.9029410697018322,-0.3547990699698433,0.10297503931667516,1.2807891221563772,14485,14506,Douglas+Edgar+Moultrie+Piatt,Moultrie,17,139,Illinois,IL
17147,17CS016,152,144,159,162,3,10,18,75.74662307504096,2,14.43522194153735,0.09163414857947949,0.6063556625786356,1.1270602736758135,0.1739933129927624,187,178,195,209,14,22,31,133.43807131019187,10,59.74072525240456,0.2242592442325349,0.7362388151770424,1.2451213838422048,0.42851880481032495,16626,16739,Douglas+Edgar+Moultrie+Piatt,Piatt,17,147,Illinois,IL
17043,17CS017,5387,4987,5787,6490,703,1103,1503,142.46034268284893,821,106.01801832824694,-0.15384735480029457,0.36800302645373,0.8827458141647164,0.7435192392616844,6647,6169,7125,6994,-131,347,825,37.50172686299031,393,42.44981902119142,-0.5754907210411284,-0.05069577062434434,0.4501921586824869,1.1286921190271277,929276,925799,DuPage,DuPage,17,43,Illinois,IL
17047,17CS018,61,60,61,81,20,20,21,393.6486095725356,10,192.89503295290143,1.8837875330518346,2.005261928041303,2.126664988381097,0.4671281892903012,73,72,73,90,17,17,18,285.523464748511,18,295.3724975385625,-0.21881012397940977,-0.09647626220944598,0.017659403861352733,0.9782715060468364,6221,6094,Edwards+Lawrence+Richland+Wabash,Edwards,17,47,Illinois,IL
17101,17CS018,163,156,170,180,10,17,24,133.73233218289542,30,235.47880690737833,-1.528679732147203,-1.0339133391693858,-0.4992167462788145,1.663201744335399,196,188,204,197,-7,1,9,5.250094720810407,20,131.89132155104195,-1.7848962912151014,-1.2569475674953108,-0.73923143483723,11.135086415414749,15288,15164,Edwards+Lawrence+Richland+Wabash,Lawrence,17,101,Illinois,IL
17159,17CS018,174,167,181,222,41,48,55,364.7799157042136,29,220.7981727047776,0.93046853250012,1.4259140486266886,2.0033444235783846,0.59291605857543,211,203,219,265,46,54,62,341.1025208211864,41,259.5429511932645,0.30865246935698765,0.8154598322730956,1.3374500726412613,0.7470305733203444,15761,15797,Edwards+Lawrence+Richland+Wabash,Richland,17,159,Illinois,IL
17185,17CS018,123,118,128,139,11,16,21,167.4316234808034,15,159.1230551626591,-0.43468245286023693,0.08477614079575653,0.6389913614071892,0.8937497733086767,148,142,154,161,7,13,19,114.87108319101235,15,133.70175594972815,-0.7100386432514291,-0.18221248794923117,0.3200309084907053,1.080116813261199,11312,11219,Edwards+Lawrence+Richland+Wabash,Wabash,17,185,Illinois,IL
17053,17CS019,173,167,178,203,25,30,36,271.0582761677849,24,214.1423154137854,0.09476812344554894,0.5635225648738033,1.0811087207340135,0.7648462317872716,211,204,218,237,19,26,33,194.65198086120216,20,147.9946721918011,-0.08755879363609986,0.4830802217599676,0.9466004510322806,0.7324593734798257,13449,13514,Ford+Iroquois+Livingston,Ford,17,53,Illinois,IL
17075,17CS019,319,307,331,381,50,62,74,276.089628431499,44,195.67150904239546,0.2856011131380784,0.7985057579192558,1.3637589324143458,0.6974898590281087,387,373,401,418,17,31,45,115.29350424926241,43,160.14897579143388,-0.9815754855941202,-0.4479729670259248,0.06628925873894453,1.3455873199726935,26984,26850,Ford+Iroquois+Livingston,Iroquois,17,75,Illinois,IL
17105,17CS019,375,359,390,420,30,45,61,151.90468795677037,54,181.44145153161224,-0.8257440131741995,-0.29403521410215283,0.2084972727087093,1.1685942406303336,457,439,476,482,6,25,43,69.39105893438413,64,179.38728032065475,-1.6523009249302862,-1.118714853002036,-0.6035220310291578,2.48479537249604,35714,35677,Ford+Iroquois+Livingston,Livingston,17,105,Illinois,IL
17055,17CS020,428,412,444,518,74,90,106,286.50800560778066,60,190.74868860276584,0.46517952423425546,0.9526970727625907,1.472192556989696,0.6584644445832056,519,500,539,644,105,125,144,332.7284395107117,88,234.8545503069122,0.4698819184411425,0.989546442961575,1.4946436105275103,0.700228032447473,37746,37470,Franklin+Gallatin+Saline,Franklin,17,55,Illinois,IL
17059,17CS020,63,63,64,68,4,5,5,119.42348145825744,1,24.3605359317905,0.8198690588339413,0.9504931777935784,1.0704039659813058,0.1694245047118611,77,76,78,91,13,14,15,283.26563531383897,1,20.370747606437156,2.5027642830182186,2.6281694611443673,2.760455682325938,0.06708928426336107,4926,4909,Franklin+Gallatin+Saline,Gallatin,17,59,Illinois,IL
17165,17CS020,309,299,320,330,10,21,31,104.39881101490425,41,208.58063422079022,-1.5510722612977015,-1.0290744170658195,-0.5386118792406497,1.9050870497821386,373,361,385,423,38,50,62,212.18063231511022,53,226.82530172044852,-0.669083920724684,-0.14477973011839873,0.3517828159266631,1.0478838110188373,23588,23366,Franklin+Gallatin+Saline,Saline,17,165,Illinois,IL
17057,17CS021,390,376,404,450,46,60,74,214.4713273410579,31,110.94211326831885,0.5412060134720552,1.0353678749341069,1.5868339359115264,0.5087918355849944,474,457,491,515,24,41,58,123.41106729941473,55,165.50312951372172,-0.9198080963097746,-0.4199795302988335,0.1455502751417284,1.3091508298047496,33531,33232,Fulton+McDonough,Fulton,17,57,Illinois,IL
17109,17CS021,248,236,260,318,58,70,82,306.4530759116568,31,135.52900029146022,1.169391992110612,1.716945006227702,2.231919932788465,0.4360299505639879,301,287,314,323,9,22,36,83.71990504891097,32,119.1140889633352,-0.8933701298010323,-0.35699242068624926,0.12053631625033377,1.3622033900231443,27448,26865,Fulton+McDonough,McDonough,17,109,Illinois,IL
17061,17CS022,136,131,141,163,22,27,32,268.0355734686356,26,258.83524141363864,-0.4385905313537045,0.08940172219477913,0.6289310046659434,0.9310929161458912,165,159,171,181,10,16,22,134.41575987968682,19,160.28344862493674,-0.7866333452862976,-0.2543084585470205,0.24576879343952696,1.1220266472100386,12054,11854,Greene+Jersey+Morgan,Greene,17,61,Illinois,IL
17083,17CS022,233,224,242,271,29,38,47,211.97412426153028,36,201.25786163522008,-0.39514231170719744,0.11524660018314947,0.5939445333773589,0.9250486648449109,285,274,296,317,21,32,43,149.983153684673,29,135.83774415663498,-0.37981096573828893,0.15970063323374137,0.6456685018526915,0.8782581698774943,21465,21349,Greene+Jersey+Morgan,Jersey,17,83,Illinois,IL
17137,17CS022,339,325,353,414,61,75,89,273.55931812704625,54,196.92457302619584,0.2753658164141652,0.7700673589645084,1.2687706778514063,0.7103905531218602,414,397,431,437,6,23,40,69.91302810629423,31,94.99295213580929,-0.7652293402997505,-0.2625613510645251,0.25838591844685577,1.3016777841486429,32906,32634,Greene+Jersey+Morgan,Morgan,17,137,Illinois,IL
17063,17CS023,369,347,392,466,74,97,119,222.05923290425602,44,100.86537910481975,0.6978691824167481,1.2117517717034407,1.6954034470887862,0.4495861253880081,460,433,487,527,40,67,94,126.80018385860569,55,103.93046107331821,-0.33844010551093645,0.2190970118557857,0.7547102945464714,0.8076043165152104,52347,52920,Grundy,Grundy,17,63,Illinois,IL
17067,17CS024,176,169,184,235,51,59,66,400.23779872401894,32,218.70372479781295,1.280505378008609,1.8154675222987011,2.3715980410881805,0.5372601626389731,216,207,225,239,14,23,32,132.67499416789076,24,137.7568591436115,-0.5796622254411952,-0.04526794013146929,0.47032836256634053,0.9952461452507292,17558,17422,Hancock+Henderson+Mercer+Warren,Hancock,17,67,Illinois,IL
17071,17CS024,70,69,70,95,25,25,26,474.7491087328333,15,281.6901408450704,1.806704958920816,1.9332950334088874,2.047594782539931,0.57076778454033394,85,84,86,109,23,24,25,383.6504035646861,10,158.32805573147562,2.123570583952635,2.251452837307928,2.3829787047780897,0.396332191466019,6390,6316,Hancock+Henderson+Mercer+Warren,Henderson,17,71,Illinois,IL
17131,17CS024,173,166,180,192,12,19,26,144.73129154456805,16,123.02172102261805,-0.3124932129590003,0.22522696239637036,0.7501094731243938,0.8071224292994232,213,204,221,206,-15,-7,2,-41.859493346873364,16,102.63647443710309,-1.9614558121032506,-1.4250482103349502,-0.9300538609647399,-2.8956779090268605,15607,15589,Hancock+Henderson+Mercer+Warren,Mercer,17,131,Illinois,IL
17187,17CS024,163,156,170,218,48,55,62,392.30815161401154,31,221.99677746613355,1.177607423107815,1.7104571534781998,2.2458435819087743,0.5557292046156697,199,191,208,215,7,16,24,95.94186339486559,28,169.01068388966019,-1.2457560063872706,-0.7374249180221685,-0.17829393155620724,1.6573256136508003,16757,16567,Hancock+Henderson+Mercer+Warren,Warren,17,187,Illinois,IL
17073,17CS025,454,433,475,583,108,129,150,315.2831719273009,64,156.46646565072123,1.1228951712195332,1.5924501716498745,2.1175435203076827,0.4924541907724881,553,528,578,601,23,48,73,97.64697981530081,41,83.77434053247788,-0.38474949891143784,0.12598304999719784,0.6563529889466917,0.840346324166981,49084,48941,Henry,Henry,17,73,Illinois,IL
17077,17CS026,382,359,405,535,130,153,176,344.35016862355064,68,152.70318318767895,1.3478303871898583,1.9001790770091378,2.386662975860129,0.44058001155975235,466,439,493,611,118,145,172,274.9663464008874,64,121.6429399578051,1.033904813996011,1.5318531273244895,2.047061837330572,0.4393551139730831,53437,52613,Jackson,Jackson,17,77,Illinois,IL
17081,17CS027,373,357,388,486,98,113,129,366.94757760914274,65,210.23125437981776,1.049692514218997,1.5688168078309257,2.0666526481348253,0.5679133738511868,454,435,473,549,76,95,114,257.023229001226,67,181.57673649692404,0.24922036251506244,0.7644088836922577,1.2836777331939422,0.6990890880825387,37102,36899,Jefferson+Washington,Jefferson,17,81,Illinois,IL
17189,17CS027,138,132,144,149,5,11,17,99.5122907271092,17,148.50404018344616,-1.022527272169137,-0.49601392717454384,0.044424659612357566,1.3718893992520818,168,161,175,167,-8,-1,6,-5.672295023360095,21,153.69977310985874,-2.1164021418921704,-1.5874503281251238,-1.1099642853272966,93.33568499506391,13737,13663,Jefferson+Washington,Washington,17,189,Illinois,IL
17089,17CS028,2735,2512,2957,3584,627,849,1072,196.56711831524743,513,118.73877662026544,0.2556016140948219,0.7927904448256564,1.299748026288421,0.6033518020097696,3387,3121,3653,3905,252,518,784,100.45501893135052,326,63.218602558608104,-0.17254428885654075,0.3627165908600767,0.861708767231997,0.6281099623576736,518449,515671,Kane,Kane,17,89,Illinois,IL
17091,17CS029,955,909,1001,1149,148,194,240,216.7167296586277,124,138.40572969956284,0.27501833583169144,0.7725657477925589,1.3207233776277139,0.635375678271756,1163,1108,1218,1378,160,215,270,201.13035173074286,132,123.718297186346,0.26629199241590273,0.7748466211533159,1.2844713760316366,0.6122618871599252,107510,106694,Kankakee,Kankakee,17,91,Illinois,IL
17093,17CS030,532,476,589,630,41,98,154,88.63510124052854,74,67.23961685533638,-0.35546698834245566,0.2150818556450537,0.7063196677173859,0.750913612915564,679,609,748,780,32,101,171,75.44751207892952,61,45.35619483831632,-0.181789449328419,0.2963101171576229,0.808284551443049,0.5952955250490217,132065,134491,Kendall,Kendall,17,93,Illinois,IL
17095,17CS031,570,549,591,694,103,124,145,299.4368204638304,106,256.05410954767797,-0.10384091307932598,0.4376230465222622,0.9532037431293808,0.8482758066889597,691,666,717,730,13,39,64,78.76045366415934,73,147.96497486622343,-1.1958984419105414,-0.6852436197292628,-0.1723304725424592,1.8315359541980878,49677,49336,Knox,Knox,17,95,Illinois,IL
17097,17CS032,4052,3746,4358,4865,507,813,1119,137.30427926549652,699,118.030129484174,-0.3138922114067186,0.1869193253173368,0.698618825694391,0.8585686906733653,5026,4659,5394,5214,-180,188,555,26.380998225230048,373,52.42246604837202,-0.7693053408420225,-0.2749104872268998,0.24687850815487078,1.9765995493914654,710666,711527,Lake,Lake,17,97,Illinois,IL
17099,17CS033,1121,1074,1168,1295,127,174,221,191.06631964187014,180,197.8112550940977,-0.5746700791012909,-0.05975525072681481,0.4706672348150584,1.02938087617977,1368,1311,1424,1435,11,67,124,61.74984714751823,129,118.32474179523399,-1.0674531163418801,-0.570055238448812,-0.058385697785712024,1.8881479216309016,109195,109022,La Salle,La Salle,17,99,Illinois,IL
17103,17CS034,323,308,337,387,50,64,79,227.4381239559396,64,225.68322068762853,-0.5143830205728339,0.014743104445018137,0.5389097471945138,0.977134125274759,397,379,414,420,6,23,41,68.96126362129536,39,114.55426641210163,-0.9800588497232751,-0.45789448324361126,0.04456103422903726,1.593276393238586,34030,34045,Lee+Whiteside,Lee,17,103,Illinois,IL
17195,17CS034,573,549,597,706,109,133,157,287.6220375998446,148,320.31743168906127,-0.8219741088243923,-0.3590789842000404,0.18938392306489632,1.105357231941252,701,673,730,757,27,56,84,100.52433349932554,79,142.76678413300803,-0.92622823269326,-0.42869429747713167,0.06780815271217426,1.395140039938531,55445,55335,Lee+Whiteside,Whiteside,17,195,Illinois,IL
17111,17CS035,1837,1704,1970,2165,195,328,461,127.10836465134774,234,90.70617079765222,-0.13067686845287985,0.3491795574323658,0.8690510257691909,0.7114432791634472,2284,2123,2444,2536,92,252,413,81.1548560883561,183,58.85663745276192,-0.2720286809528883,0.23108888252516258,0.7597566522404581,0.7223758264711522,309571,310925,McHenry,McHenry,17,111,Illinois,IL
17113,17CS036,1025,952,1099,1220,121,195,268,136.8473932287119,110,77.22414307527598,0.05625664598541974,0.5855286365701243,1.134679636177483,0.5614282994404427,1270,1181,1358,1412,54,142,231,83.2717188711109,145,84.85188956380277,-0.5472421404782585,-0.025963147828024544,0.47925890786631853,1.0118652752034625,170931,170886,McLean,McLean,17,113,Illinois,IL
17115,17CS037,1044,1000,1089,1242,153,198,242,229.02556486002186,142,164.5200532952285,0.16205442448337923,0.6284866483364699,1.1429867850854447,0.7147323064860455,1268,1215,1321,1433,112,165,218,160.87948520710853,136,132.54197974836515,-0.23267181361439898,0.30389803725891323,0.785536372636898,0.8188980919290355,103574,102609,Macon,Macon,17,115,Illinois,IL
17117,17CS038,470,451,489,568,79,98,117,262.11383543838076,66,176.7580958332403,0.3283939280126757,0.8283983825090735,1.3797401128014195,0.6675356641173016,570,547,593,647,54,77,100,172.41464660624285,70,157.42718992465984,-0.4042412199978749,0.17225976232634332,0.6685783543718891,0.9013164969694529,44807,44465,Macoupin+Montgomery,Macoupin,17,117,Illinois,IL
17135,17CS038,300,288,312,360,48,60,72,254.64047310305722,29,123.46993081426291,0.7587003721565335,1.3262700958247395,1.8066469870448043,0.4769055908766202,366,351,380,460,80,94,109,335.6501999201652,69,245.59530165509878,0.36824268585974573,0.9231209323329346,1.4079361019139278,0.7240223635259448,28185,28095,Macoupin+Montgomery,Montgomery,17,135,Illinois,IL
17119,17CS039,2468,2354,2582,2909,327,441,555,199.45465394139947,294,133.0728204044991,0.17140560040785774,0.6738129745311457,1.1647608507906468,0.6656726992912834,3022,2885,3159,3378,219,356,493,134.52967831580634,319,120.5424789428538,-0.41028440394311355,0.11879305556553396,0.6786844209640831,0.8935191172675168,265118,264637,Madison,Madison,17,119,Illinois,IL
17133,17CS040,264,249,279,302,23,38,53,131.07214839908863,45,154.8253913641837,-0.7767773110503582,-0.24669306962885235,0.27331853819562524,1.1510093604696339,326,308,344,358,14,32,50,91.22309870772345,35,100.20900735820426,-0.5899586261975253,-0.09334956909073765,0.38892199471760414,1.0650764224220381,34878,34927,Monroe+St. Clair,Monroe,17,133,Illinois,IL
17163,17CS040,2176,2065,2286,2685,399,509,620,237.8421217513354,324,151.2646236086417,0.3551553247281886,0.8640564627840333,1.3816244604986985,0.6347415804933172,2660,2528,2792,3073,281,413,545,161.94699689428836,295,115.64681853642091,-0.0969929570529793,0.45726174376044326,0.9770443508568003,0.7123784443859673,257033,255087,Monroe+St. Clair,St. Clair,17,163,Illinois,IL
17141,17CS041,449,427,471,518,47,69,91,161.1713011063441,52,121.15093387178192,-0.0949850304345362,0.4191196531244901,0.9261681723528588,0.7409791985794877,550,524,577,592,15,42,68,80.95129482124857,49,95.17889747873043,-0.691482846543853,-0.13178241294403067,0.33994803713264043,1.1482039409692164,51506,51482,Ogle,Ogle,17,141,Illinois,IL
17143,17CS042,1539,1461,1617,1770,153,231,309,153.49432447291883,146,96.92088113915227,0.06346028100912125,0.5645594049449532,1.0640333729239415,0.628710652025025,1872,1779,1964,2148,184,276,369,153.8040128377713,211,117.42249280717668,-0.12045437318363841,0.3902140226523667,0.8378363999857393,0.7607028965451113,180766,179693,Peoria+Woodford,Peoria,17,143,Illinois,IL
17203,17CS042,326,310,343,383,40,57,73,177.10014826084824,46,143.85864324620155,-0.15474231338443264,0.34665035679453177,0.8148786895313349,0.7982057966061313,398,378,418,421,3,23,43,59.523791082845975,58,151.63398692810458,-1.4296873521164357,-0.9164542770310534,-0.42946243427550995,2.440271197535985,38371,38250,Peoria+Woodford,Woodford,17,203,Illinois,IL
17145,17CS043,197,188,206,232,26,35,44,198.63925886111974,29,166.51514426527584,-0.21125587138526147,0.3301464238110201,0.8768706146432494,0.8147284414549835,242,231,253,302,49,60,71,287.28350097786176,40,190.74868860276584,0.47465909263146044,0.9530938726953309,1.4847104362470167,0.653132134325227,20899,20970,Perry+Randolph,Perry,17,145,Illinois,IL
17157,17CS043,295,282,308,362,54,67,80,264.3362947325091,51,201.92688399102545,0.12678100845179546,0.6164549291421385,1.142602517028114,0.7526282571255563,359,344,375,444,69,85,100,281.4846465738056,50,165.95306847223605,0.6459056105352056,1.1463123077472406,1.7267254900310158,0.5826927945239523,30308,30129,Perry+Randolph,Randolph,17,157,Illinois,IL
17161,17CS044,1363,1301,1425,1652,227,289,351,241.07882471653218,192,160.2648822359177,0.2898456576989313,0.8322146653728878,1.3470537012727155,0.6624882749274007,1661,1587,1735,1776,41,115,189,80.16747204186436,160,111.80445400993662,-0.8153019477823871,-0.29784517588241305,0.1867384774336183,1.3825848753545489,143762,143107,Rock Island,Rock Island,17,161,Illinois,IL
17167,17CS045,1682,1598,1766,1899,133,217,301,133.24160792076322,190,116.49652043287654,-0.3497541843329053,0.16188786760811452,0.703377285751108,0.8703204227488873,2055,1954,2155,2118,-37,63,164,32.443628920665795,141,72.3373691770983,-0.9233856360398388,-0.4181612596285857,0.10039906901378766,2.194924163419706,195714,194920,Sangamon,Sangamon,17,167,Illinois,IL
17003,17CS046,69,69,70,99,29,30,30,680.6913928801068,11,251.71624713958812,4.177379395085698,4.2883487427730085,4.408303610468314,0.3577676278099609,82,81,82,103,21,21,22,419.0877919342687,12,237.6237623762376,1.6925265635423838,1.8167902136631302,1.9467406209642755,0.5414201411479098,5244,5050,Southern Illinois,Alexander,17,3,Illinois,IL
17069,17CS046,51,51,52,62,10,11,11,348.30164544899,10,327.242977911099,0.1062769127930092,0.20967942622905084,0.3321143762376202,0.8588469728028202,63,62,63,84,21,21,22,584.953919356626,11,301.53508771929825,2.707771035684923,2.8323487547986455,2.9607821838295525,0.4924097503920875,3667,3648,Southern Illinois,Hardin,17,69,Illinois,IL
17087,17CS046,122,120,123,140,17,18,20,166.9387908680261,16,145.58689717925387,0.09303389324082749,0.21425069654690265,0.332404507721673,0.8270198501687166,153,151,154,175,21,22,24,165.75210762242355,32,238.09523809523813,-0.8425136455885334,-0.7248539425730189,-0.6009016737798215,1.374742687322298,13188,13440,Southern Illinois,Johnson,17,87,Illinois,IL
17127,17CS046,181,175,187,200,13,19,25,160.34898076289767,23,196.35742743312466,-0.8520263591190833,-0.3557719226634754,0.18345145784171996,1.1626607586750686,221,213,228,239,11,18,26,131.4701742198926,29,207.3798627002288,-1.240014198676822,-0.7447441010424221,-0.29279584233300066,1.4960183345964704,14056,13984,Southern Illinois,Massac,17,127,Illinois,IL
17151,17CS046,40,40,41,42,1,2,2,53.94370262343166,6,188.92679086853843,-1.463383279274347,-1.3514669493837521,-1.2293187426366783,2.2114417800528843,49,49,50,71,21,22,22,581.098717504563,12,317.9650238473768,2.502672398256921,2.6329951531993663,2.7608442350120534,0.5233166891030421,3811,3774,Southern Illinois,Pope,17,151,Illinois,IL
17153,17CS046,66,66,67,68,1,2,2,38.800840796914684,7,162.3815967523681,-1.3602192128707766,-1.234677179389302,-1.1205467379306115,2.6191335546407384,80,79,81,107,26,27,28,532.7274408319407,16,315.0226422524119,2.0532268841113557,2.1748641011056407,2.3017669466184008,0.5702630612696244,5173,5079,Southern Illinois,Pulaski,17,153,Illinois,IL
17181,17CS046,200,193,207,231,24,31,38,216.93837070413213,22,154.5576956852643,0.08403224739075588,0.6373586364440668,1.1370164643645322,0.6901014831093509,244,235,252,278,26,34,43,202.66722087808418,32,188.67924528301887,-0.36932456364930477,0.1237463219339592,0.6550624951076477,0.9046611366074692,17081,16960,Southern Illinois,Union,17,181,Illinois,IL
17179,17CS047,1182,1126,1239,1421,182,239,295,218.52896711557278,112,102.53593335164331,0.644551763238243,1.1625103364966798,1.6495367153273166,0.4672523075083578,1441,1374,1509,1718,209,277,344,212.08354095630736,165,126.4358127523927,0.34846757809681955,0.848506276608902,1.376576699935939,0.5940141907494083,131076,130501,Tazewell,Tazewell,17,179,Illinois,IL
17183,17CS048,798,766,829,928,99,130,162,211.15886429734155,84,136.0856475543735,0.22243286576800694,0.7491365082036182,1.2524638770116945,0.639563544077212,965,927,1003,1186,183,221,259,301.8026855538804,157,214.45157765332604,0.3898030984931299,0.8778445337530355,1.3733525751985554,0.7073673332048347,74071,73210,Vermilion,Vermilion,17,183,Illinois,IL
17197,17CS049,4024,3725,4323,4966,643,942,1241,162.56079027124667,644,111.16097628335692,-0.01544804898129552,0.5020985971971095,1.0470009248558136,0.6830864220468397,5005,4645,5364,5525,161,520,880,74.6677998672987,461,66.13538386497478,-0.38973031124642304,0.0784636355695119,0.5861087596217494,0.8840298019473516,695208,697055,Will,Will,17,197,Illinois,IL
17199,17CS050,638,609,667,744,77,106,135,190.37599837452498,76,136.11127693869022,0.022781215404667644,0.55289889344059,1.0601385167122341,0.7082970650919019,778,743,813,889,76,111,146,165.82740075392525,97,144.97085637423405,-0.29277746410038313,0.21732785518611913,0.6898759032501243,0.8664186625255031,67004,66910,Williamson,Williamson,17,199,Illinois,IL
17201,17CS051,2538,2416,2661,2933,272,395,517,166.5483399016843,323,136.32143158605555,-0.20161290147570798,0.2871638859179202,0.7984674573570618,0.8164407682239068,3101,2954,3247,3540,293,439,586,155.03126717729066,303,106.926206801636,-0.038892703428982586,0.4709369430615618,1.0281392069070223,0.6881409760488578,284328,283373,Winnebago,Winnebago,17,201,Illinois,IL
18001,18CS001,271,256,287,336,49,65,80,216.8806289727006,43,144.0536013400335,0.2379280469546789,0.7083504787569943,1.2297830472139215,0.6541031428257071,334,316,353,382,29,48,66,132.35686848322922,55,153.02857460838595,-0.6961256313720053,-0.22742507747247262,0.31706995242560615,1.1323773382099134,35820,35941,Adams+Wells,Adams,18,1,Indiana,IN
18179,18CS001,261,249,273,315,42,54,66,231.11545682401817,46,195.9253212181444,-0.14717006275492914,0.3497740748395161,0.8741474321656415,0.8323975294414107,319,305,334,363,29,44,58,155.02101249622646,54,191.5301127899553,-0.8624407684239493,-0.35767632059168525,0.144827100391102,1.2078746917258656,28174,28194,Adams+Wells,Wells,18,179,Indiana,IN
18003,18CS002,2958,2792,3124,3470,346,512,678,159.49276612107585,428,133.34337216457106,-0.2754128850931997,0.25818270612158817,0.7703625789999414,0.8344165880839571,3664,3464,3864,3912,48,248,448,63.89071797819686,387,99.68779944978516,-0.8649667435067785,-0.3446495413707024,0.14908212382959068,1.5540206859168473,385171,388212,Allen,Allen,18,3,Indiana,IN
18005,18CS003,631,596,667,726,59,95,130,137.86545582882965,101,146.9660959402435,-0.5893682084853554,-0.08044771317130125,0.44836902637721243,1.0548772552908803,773,731,816,892,76,119,161,143.95296682507038,87,105.54537844690583,-0.12365160741177657,0.3738292613486081,0.9017063541431267,0.7270661339805039,82468,82429,Bartholomew+Brown,Bartholomew,18,5,Indiana,IN
18013,18CS003,147,140,154,172,18,25,32,194.98162019022743,18,140.07782101167314,0.03343087963045261,0.5370419677797681,1.0152918537061564,0.6908426225057661,180,172,188,204,16,24,32,152.66982562029486,23,148.00514800514802,-0.4794783338449941,0.042543912405720065,0.5754689969047083,0.9302366627916412,15420,15540,Bartholomew+Brown,Brown,18,13,Indiana,IN
18007,18CS004,74,73,75,95,20,21,22,292.0647966414154,11,151.37614678899084,1.2837494150593387,1.4064956887435445,1.5248425452845304,0.49497431824887106,91,90,92,107,15,16,17,187.50685539294793,11,126.23364700481983,0.4942980575492349,0.6130003900328027,0.7423786108407283,0.6343952721865083,8720,8714,Benton+Jasper+Newton,Benton,18,7,Indiana,IN
18073,18CS004,277,262,291,350,59,73,88,266.70166802875127,34,123.58393408856847,0.8932470967461899,1.4449581094408899,1.9226543181999904,0.4571485494336027,341,324,358,425,67,84,101,254.18364868269398,75,226.83280909750786,-0.2662296291399462,0.2632502570718443,0.7489038068866876,0.8819038798663518,33014,33064,Benton+Jasper+Newton,Jasper,18,73,Indiana,IN
18111,18CS004,147,141,153,163,10,16,22,142.55557096950554,23,199.66722129783693,-1.0875581946423052,-0.5590459589236261,-0.03359494658923177,1.3202294769708232,179,172,186,223,37,44,51,317.0060648263096,31,224.5400550485296,0.41345189209224187,0.9090494987919033,1.4632491506017715,0.6924920433307611,13823,13806,Benton+Jasper+Newton,Newton,18,111,Indiana,IN
18009,18CS005,147,142,152,173,21,26,31,261.08587295971944,22,219.0507799535347,-0.08415282840624756,0.4150354032558929,0.9032393377194539,0.8081780415442706,180,174,186,204,18,24,30,198.45528550198696,35,289.4475686404234,-1.4109630086226752,-0.912472440700429,-0.3802260708007755,1.400156082516897,12052,12092,Blackford+Jay+Randolph,Blackford,18,9,Indiana,IN
18075,18CS005,199,190,208,226,18,27,36,159.45510134213518,34,199.67699309939803,-0.9119391005144759,-0.41051160167079465,0.06318861316506146,1.2077630441271348,243,232,253,297,44,54,65,267.07817576116094,38,187.39520662787257,0.24513216188708414,0.8040027351980862,1.3774063687221498,0.688928578061735,20433,20278,Blackford+Jay+Randolph,Jay,18,75,Indiana,IN
18135,18CS005,261,251,272,327,55,66,76,323.06009716352804,56,275.4211238165499,-0.013838562811864786,0.4804868597998668,0.9764978009377823,0.839754024426892,321,308,333,415,82,94,107,386.75829182576547,54,221.44761123641584,1.118432169544935,1.6524182877954379,2.1766162080572755,0.5665662372581646,24399,24385,Blackford+Jay+Randolph,Randolph,18,135,Indiana,IN
18011,18CS006,490,460,521,511,-10,21,51,35.33247281907033,76,128.64820640137674,-1.4306903780953326,-0.9435896966394401,-0.43532931961875027,3.474610897339544,616,579,654,640,-14,24,61,32.63312004266896,54,74.1992662517004,-0.9300467140670015,-0.42173826266245124,0.1300732316441365,2.1818705666833305,70891,72777,Boone,Boone,18,11,Indiana,IN
18015,18CS007,162,154,171,165,-6,3,11,16.24093067046289,18,106.36726252031319,-1.4338767132030972,-0.903486341083478,-0.3767371487036148,4.802085394953943,199,188,209,236,27,37,48,183.20957383781726,34,166.4708186447317,-0.35506895726402493,0.1674748052776861,0.657069554943953,0.8849851589508239,20307,20424,Carroll+Clinton,Carroll,18,15,Indiana,IN
18023,18CS007,318,303,332,387,55,69,84,252.2420707541275,35,127.20334363074686,0.7285604436989912,1.2392241038093053,1.7705539435780224,0.4971279796797745,386,369,403,435,32,49,66,148.54654183300914,49,148.13471189310116,-0.5103617276247969,0.004122581503641118,0.5455164168636382,0.9773372425808684,33018,33078,Carroll+Clinton,Clinton,18,23,Indiana,IN
18017,18CS008,358,342,374,450,76,92,108,293.1725396704599,75,238.56226475109997,0.0297110636475703,0.5571361509314945,1.0204533971825556,0.8049925832058206,437,417,456,495,39,58,78,154.94000271541435,63,167.58439071103663,-0.6599083854816725,-0.13112854815181874,0.39762762259818973,1.0633522443813985,37726,37593,Cass+White,Cass,18,17,Indiana,IN
18181,18CS008,257,246,267,279,12,22,33,109.8634046851814,31,151.37950679580044,-0.900782893578509,-0.42122857694394383,0.051642188280357826,1.3192503094534367,314,302,327,516,189,202,214,818.5122202551361,52,210.9619051482819,5.573360161063667,6.05242496617528,6.593693794888908,0.25646706719074674,24574,24649,Cass+White,White,18,181,Indiana,IN
18019,18CS009,1117,1065,1169,1253,84,136,188,134.61413347506434,129,127.95186100526519,-0.4269118722289523,0.06659974975529273,0.5831869518256896,0.9435559865413804,1384,1320,1447,1539,92,155,219,126.83606679010461,181,147.72374842890488,-0.7056469542079984,-0.2098113535078185,0.2946615924183739,1.1572360301874487,120983,122526,Clark+Scott,Clark,18,19,Indiana,IN
18143,18CS009,280,270,291,333,42,53,63,260.24936260835403,38,187.90176363936044,0.2514909301790577,0.7294602094665273,1.220073323917745,0.7085441612166069,343,330,355,437,82,94,107,386.7110373377156,55,225.85413929040737,1.0783944709108393,1.614452046977378,2.1549857475646634,0.5779018417160888,24268,24352,Clark+Scott,Scott,18,143,Indiana,IN
18021,18CS010,257,246,269,317,48,60,71,270.6948919073943,32,145.39396463594713,0.7671246218961147,1.2466192825118831,1.7633966209839753,0.5282472811903033,312,299,326,350,24,38,51,143.0450777284505,36,136.2965206527089,-0.49105744164682785,0.07116657683346914,0.6262376561666457,0.9282538093184548,26411,26413,Clay+Sullivan+Vermillion+Vigo,Clay,18,21,Indiana,IN
18153,18CS010,196,187,205,225,20,29,38,169.47081334536574,28,161.77957532861478,-0.38908114300619445,0.0553161030872611,0.5736387115620912,0.9231430337193056,237,227,248,274,26,37,47,176.851894207827,30,144.47387430772935,-0.2328018790281248,0.3215048466748459,0.8535805817807746,0.7952645530603009,20769,20765,Clay+Sullivan+Vermillion+Vigo,Sullivan,18,153,Indiana,IN
18165,18CS010,174,167,181,195,14,21,28,162.86780591071428,26,202.62371736589168,-0.9237951776579768,-0.38703229819667667,0.0943527505524468,1.187287586049001,210,202,218,233,15,23,31,147.93315826201416,27,175.91868647380767,-0.787114066696395,-0.2939021514641704,0.1967628801213264,1.1390107274927863,15398,15348,Clay+Sullivan+Vermillion+Vigo,Vermillion,18,165,Indiana,IN
18167,18CS010,953,908,999,1144,145,191,236,215.5758805210499,138,156.0144709074465,0.07734318407295698,0.6124653619576289,1.118098358878956,0.7199346968513273,1157,1102,1211,1348,137,191,246,180.65976134271096,128,120.75927393486548,0.11179062084574586,0.5975565577277392,1.1253323075007948,0.6649622830233186,106144,105996,Clay+Sullivan+Vermillion+Vigo,Vigo,18,167,Indiana,IN
18025,18CS011,105,104,106,124,18,19,20,214.12778545564916,11,125.1778093883357,0.7677642542519469,0.8893835405846903,1.0173099817042666,0.5550935622038776,129,128,130,166,36,37,38,352.39329711549476,26,247.19528427457695,0.9291701377431518,1.0526893435365143,1.1761881398558476,0.6830470636612042,10545,10518,Crawford+Harrison+Perry,Crawford,18,25,Indiana,IN
18061,18CS011,352,335,369,403,34,51,68,153.82921729962706,41,123.6336223143611,-0.28033959745744824,0.3253573112821565,0.8015421257973537,0.7882551643614898,433,413,454,542,88,109,129,274.0493292757583,72,181.1548622468235,0.3908867667170291,0.9254761744087716,1.4388384239810774,0.6550164356539736,39795,39745,Crawford+Harrison+Perry,Harrison,18,61,Indiana,IN
18123,18CS011,191,182,199,210,11,19,28,121.7855015700035,25,156.4781973711663,-0.8284413732673284,-0.3313572561200201,0.17246915663238022,1.222059824181236,235,225,245,245,-0,10,20,50.652842391619544,32,165.87186398507154,-1.6719823481873126,-1.1396332200224912,-0.6009508933743852,2.9706794805517354,19172,19292,Crawford+Harrison+Perry,Perry,18,123,Indiana,IN
18027,18CS012,292,278,306,336,30,44,58,158.36635896058664,70,251.504536063954,-1.4587496665132367,-0.9393710126353223,-0.39973897056893787,1.5528874582523995,359,342,376,343,-33,-16,1,-48.05483731913248,38,113.78608216552881,-2.1016902536299926,-1.6250700531063924,-1.1014208410971034,-2.5251864973483213,33399,33396,Daviess+Knox+Martin,Daviess,18,27,Indiana,IN
18083,18CS012,373,358,389,477,88,104,119,342.6230528414832,68,225.0041361054431,0.6376724369720093,1.1987177770955113,1.6742941114211463,0.6504289194263533,455,436,473,503,30,48,67,134.40900576766353,43,119.45108061558976,-0.33723351783248823,0.14139815235311856,0.6563541094732652,0.870717595026627,36266,35998,Daviess+Knox+Martin,Knox,18,83,Indiana,IN
18101,18CS012,90,89,91,95,4,5,6,59.20507911727087,10,121.914050594331,-0.7548864703536595,-0.6288801090576258,-0.5121905456199077,1.7075637827291004,110,109,111,128,17,18,19,182.7996015769706,5,51.11951743175544,1.1935727296252296,1.3163903689751328,1.438399216899572,0.2648357121843042,9843,9781,Daviess+Knox+Martin,Martin,18,101,Indiana,IN
18029,18CS013,436,414,457,474,17,38,60,91.339183917267,58,137.63917179188007,-0.9611042612441374,-0.4671522856145303,0.06298863898909858,1.4687422176328215,536,510,562,616,54,80,106,157.6347510263925,84,165.3445662657717,-0.6218569315938625,-0.06600789446835559,0.46361446810609513,1.0359731493489635,50567,50803,Dearborn+Ohio+Ripley+Switzerland,Dearborn,18,29,Indiana,IN
18115,18CS013,57,56,58,66,8,9,10,183.851275697002,16,323.66824005394466,-1.5268761563860098,-1.4006004298991026,-1.2824726627481,1.585982862173749,70,70,71,89,18,19,19,313.54398626563164,2,33.49522693016245,2.6666086047506288,2.8021979115253495,2.9233817920846303,0.10141107723439273,5932,5971,Dearborn+Ohio+Ripley+Switzerland,Ohio,18,115,Indiana,IN
18137,18CS013,265,252,277,332,55,67,80,278.85014785678686,43,178.45408957288603,0.4977061647531959,1.0122588629791045,1.527967020639007,0.6305792804429978,326,311,341,421,80,95,110,327.8774215918551,74,254.59299525218466,0.2267247532811789,0.7366162475567961,1.255135883858847,0.7684251899648584,28915,29066,Dearborn+Ohio+Ripley+Switzerland,Ripley,18,137,Indiana,IN
18155,18CS013,85,84,86,90,4,5,6,58.81770048003624,6,72.80080889787664,-0.26489073324219115,-0.13670905199003403,-0.010326874523381923,1.0260692008872776,103,102,105,116,11,13,14,128.79067950648573,12,122.69938650306749,-0.07360104979882491,0.059838632155174785,0.18904647958471527,0.8826301613091376,9890,9780,Dearborn+Ohio+Ripley+Switzerland,Switzerland,18,155,Indiana,IN
18031,18CS014,247,235,258,332,74,85,97,387.36516563231146,61,276.6439909297052,0.580573220292206,1.0975349157245415,1.6141930304603709,0.7059039805164401,302,288,315,332,17,30,44,115.20167186750132,38,144.25084462665603,-0.7805172880523376,-0.28228905686541156,0.182550442182904,1.2122149250328638,26460,26343,Decatur+Shelby,Decatur,18,31,Indiana,IN
18145,18CS014,408,389,427,492,65,84,103,224.30632830659678,62,165.37008224049785,0.05770907947036936,0.58246248100493,1.121620887720541,0.7285873388089661,502,479,525,541,16,39,62,87.02022865031945,69,153.20736283500233,-1.1930557729858537,-0.6562784165916619,-0.14454342229461745,1.7167894383200055,44990,45037,Decatur+Shelby,Shelby,18,145,Indiana,IN
18033,18CS015,364,346,383,458,75,94,112,259.94345950464736,63,174.50717880060938,0.3730345133187096,0.8450210777422912,1.3453886389133514,0.664249212337095,446,424,469,489,20,43,65,98.28682907409667,55,126.95042009048102,-0.7694726235120865,-0.3017810797162777,0.2432671364369829,1.26199509623092,43322,43324,DeKalb+Steuben,DeKalb,18,33,Indiana,IN
18151,18CS015,277,262,292,306,14,29,44,101.25905202096261,32,111.28176891645174,-0.5974086225460996,-0.08982821094270058,0.3878459970200468,1.0624916329218819,341,323,359,395,36,54,72,156.87692255821676,60,173.39035949601202,-0.6534461911664822,-0.14034452052190996,0.3697529254273629,1.0852717890272179,34507,34604,DeKalb+Steuben,Steuben,18,151,Indiana,IN
18035,18CS016,1100,1052,1148,1343,195,243,291,260.11654580490875,120,128.5760205721633,0.8163450770663104,1.3103917594565775,1.800186796742692,0.49227381942639176,1351,1293,1409,1554,145,203,261,181.35857428649146,183,163.62368341052556,-0.322751145909703,0.17155035747928354,0.6646099129206823,0.8977847236115248,111996,111842,Delaware,Delaware,18,35,Indiana,IN
18037,18CS017,358,339,377,412,35,54,73,149.55229480264646,55,151.9022302009252,-0.5604711138812278,-0.03224515687828879,0.5295927354438643,0.9972955675944037,438,416,461,534,73,96,118,219.5285156197542,62,142.34221824276236,0.2824137416227721,0.7688285088055689,1.300227331522987,0.6416888551948466,43449,43557,Dubois+Pike+Spencer,Dubois,18,37,Indiana,IN
18125,18CS017,139,134,144,154,10,15,20,147.4604388189153,25,244.97795198432144,-1.4314695142638825,-0.9889003172911751,-0.47285061203396545,1.5577937316888628,168,162,174,189,15,21,27,172.2514353466197,16,131.61141729044994,-0.13002175857755294,0.4114485294491484,0.8878483075770527,0.729241447311901,12246,12157,Dubois+Pike+Spencer,Pike,18,125,Indiana,IN
18147,18CS017,170,161,178,195,17,25,34,153.2860958628968,12,72.4200362100181,0.2903385133853599,0.7961319271482058,1.2966896523933344,0.45455395875962123,207,197,217,281,64,74,84,374.64301271084634,43,217.16074945709812,1.032090520341372,1.568032036805359,2.104856210748132,0.5719373262350903,19884,19801,Dubois+Pike+Spencer,Spencer,18,147,Indiana,IN
18039,18CS018,1489,1400,1578,1781,203,292,381,169.57018280457598,331,192.1002867962489,-0.7819346246949794,-0.22588115912199785,0.2845667571007086,1.1290018814310463,1833,1726,1939,2092,153,259,366,125.36402996112784,219,105.84363174149021,-0.3186648043769099,0.19202992183661186,0.7307467158128931,0.841047864868666,206767,206909,Elkhart,Elkhart,18,39,Indiana,IN
18041,18CS019,282,272,292,344,52,62,72,320.042159038187,44,226.6775426093676,0.4362389937091737,0.9384036968312287,1.4763841160663822,0.6970534432324332,345,333,357,390,33,45,57,193.4238493031828,61,261.17485870868296,-1.1844564141019747,-0.677139454333126,-0.179440328476104,1.3210304470375183,23293,23356,Fayette+Franklin+Union,Fayette,18,41,Indiana,IN
18047,18CS019,187,177,197,249,52,62,72,326.9250113150494,30,158.0749978045139,1.1965546231304443,1.6923077207399935,2.2098602234229605,0.47585119883720084,231,219,242,263,21,32,44,141.59375957659455,36,157.68034689676318,-0.6853303412032824,-0.16128053466421868,0.3423234619033996,1.0801964472609895,22774,22831,Fayette+Franklin+Union,Franklin,18,47,Indiana,IN
18161,18CS019,64,63,65,94,29,30,31,505.49295850626214,1,16.920473773265652,4.770789628993919,4.886709710633958,5.00326612999753,0.03238904807526467,78,78,79,89,10,11,11,150.3652981155073,19,269.38891251949525,-1.3128400283083705,-1.1886187936311419,-1.0594179118260147,1.6371880226556248,7092,7053,Fayette+Franklin+Union,Union,18,161,Indiana,IN
18043,18CS020,722,687,756,830,74,108,143,161.82901535737375,87,130.22165122051615,-0.1864800050419797,0.330826315205054,0.8262936692727563,0.7973121117820041,889,848,931,955,24,66,107,81.43246096052519,95,118.08283199920449,-0.8900370690277314,-0.3761706664958066,0.14693008165181454,1.4282698060820918,80171,80452,Floyd,Floyd,18,43,Indiana,IN
18045,18CS021,189,182,196,227,31,38,45,278.20542978977545,26,189.56194179476276,0.3424954597421834,0.8898071969834127,1.3955666613877198,0.6639734359218376,231,222,239,258,19,27,36,165.26904945543822,34,206.90074849388424,-0.9586571851624627,-0.398189957412989,0.07737064018749466,1.2074436959010453,16459,16433,Fountain+Montgomery+Warren,Fountain,18,45,Indiana,IN
18107,18CS021,354,337,370,405,35,51,68,162.62007444674563,63,198.9683124539425,-0.8880869949988777,-0.353760904024533,0.1628814642844125,1.2002072074532069,436,416,455,488,33,52,72,137.72962645613003,63,165.5977289454316,-0.788636178281352,-0.298864860841894,0.242901481022769,1.1798225823067374,37996,38044,Fountain+Montgomery+Warren,Montgomery,18,107,Indiana,IN
18171,18CS021,73,72,74,105,31,32,33,458.50249365679224,8,114.3265451947124,3.3210586256038233,3.4390410596476326,3.5651440686900777,0.2418108343325972,90,89,91,98,7,8,9,90.06260886080608,11,129.9314906685566,-0.5306684728439082,-0.39758718073688504,-0.2664507545845497,1.275406611877718,8397,8466,Fountain+Montgomery+Warren,Warren,18,171,Indiana,IN
18049,18CS022,212,204,221,237,16,25,33,145.2977424490202,31,182.6035735322992,-0.8721960612655111,-0.37277124822822083,0.15791968021864203,1.20779000821389,260,249,271,293,22,33,44,161.73851293192868,41,201.049379689109,-0.8964268938477468,-0.4025594483119607,0.10536066161723519,1.2064737045297134,20372,20393,Fulton+Miami+Wabash,Fulton,18,49,Indiana,IN
18103,18CS022,334,318,349,387,38,53,69,177.4810255061526,37,123.75616690358726,0.009568906059878325,0.548771884570831,1.0356249449213155,0.6843944611638026,412,393,430,521,91,109,128,303.24609935937497,77,213.54484441732765,0.3689682223266211,0.8898011643402477,1.425473649834056,0.6978147075579582,35877,36058,Fulton+Miami+Wabash,Miami,18,103,Indiana,IN
18169,18CS022,379,366,392,434,42,55,68,214.32410651245922,54,209.70195139315877,-0.4760864974938574,0.04574619546784322,0.5685288649983328,0.9610209295018913,462,446,477,530,53,68,84,222.0840607077639,62,201.1289171478622,-0.3345126406045387,0.21765525711602646,0.7311959522337043,0.8926047795026834,30901,30826,Fulton+Miami+Wabash,Wabash,18,169,Indiana,IN
18051,18CS023,306,292,321,382,61,76,90,273.67508891716653,71,257.3162997191265,-0.3607239694824944,0.1705670673509936,0.6684661306515594,0.9279371957992428,374,357,391,401,10,27,44,83.00100997279009,48,145.72833808974437,-1.142926232515104,-0.6183610957681248,-0.12918352197908448,1.6937865019435867,33111,32938,Gibson+Posey,Gibson,18,51,Indiana,IN
18129,18CS023,209,199,220,233,13,24,34,112.63637521167522,23,109.5585900285805,-0.5052192505334548,0.03721857547035647,0.5549673948729809,0.9332094035605947,256,243,269,255,-14,-1,12,-5.034941922099918,20,79.60832703100743,-1.4061565044602897,-0.8459992065887156,-0.36066377561530216,-75.49207838508937,25192,25123,Gibson+Posey,Posey,18,129,Indiana,IN
18053,18CS024,725,696,753,892,139,167,196,302.60285835062564,120,217.07015586843136,0.3751052335899689,0.8423845161909136,1.3891278001114604,0.7130806780712655,886,851,920,1121,201,235,270,355.0087807111018,144,217.22733443958367,0.8542710975965255,1.3627946876299764,1.9283340908079694,0.6093037619309001,66338,66290,Grant,Grant,18,53,Indiana,IN
18055,18CS025,323,309,336,367,31,44,58,171.87342025714122,55,213.02004324952392,-0.9425469269177529,-0.4295812673069267,0.10885683442371555,1.2120868908453355,394,378,410,448,38,54,70,175.5973453679812,40,129.92496833078897,-0.024246951956730604,0.4595398606528829,0.9985075032348746,0.7264649679895601,30983,30787,Greene+Owen+Parke+Putnam,Greene,18,55,Indiana,IN
18119,18CS025,207,205,209,259,50,52,54,293.5648956871564,23,129.8640191972898,1.5271753453283496,1.6397416097763178,1.7539818532842089,0.4340213123383622,256,254,259,77,-182,-179,-177,-836.8884661314739,21,98.02091112770725,-9.47249014685849,-9.347346337564153,-9.21946423782133,-0.11778233696188199,21253,21424,Greene+Owen+Parke+Putnam,Owen,18,119,Indiana,IN
18121,18CS025,142,135,149,150,1,8,15,58.82920754894317,13,95.77603143418467,-0.8531813592372823,-0.34422167591901837,0.13435030240533594,1.4468422739639393,176,168,185,194,9,18,26,109.65686999047685,31,189.37080024434943,-1.3091611034410036,-0.7865268114329846,-0.28266028177917213,1.6358122903215646,16288,16370,Greene+Owen+Parke+Putnam,Parke,18,121,Indiana,IN
18133,18CS025,310,295,326,363,37,53,68,171.4968077679188,38,123.8121096931849,-0.02574264386361212,0.49418418278286463,0.9824331184884018,0.7084895693212787,384,365,403,441,38,57,76,154.80000076804563,51,138.08788887986353,-0.37247235710145626,0.17991870589212558,0.6949278595434997,0.8767061604683,36830,36933,Greene+Owen+Parke+Putnam,Putnam,18,133,Indiana,IN
18057,18CS026,1638,1488,1788,1971,183,333,483,114.65913548019861,274,94.45914383473097,-0.3171115292875519,0.19692257206110958,0.6920375173142925,0.8213561698657075,2086,1902,2270,2313,43,227,411,63.83963014755357,168,47.255390067929625,-0.35980961900525776,0.17359691753438625,0.6842490391666834,0.7369731406420762,348087,355515,Hamilton,Hamilton,18,57,Indiana,IN
18059,18CS027,603,569,638,659,21,56,90,83.69617341907653,81,121.44686699568938,-0.8773606286416356,-0.3639509438563291,0.1804859875504003,1.4255077100544133,752,710,794,918,124,166,208,203.13687033773053,104,127.52755944133119,0.263961749190444,0.7472226551970758,1.276340337193259,0.6240244026148347,80035,81551,Hancock,Hancock,18,59,Indiana,IN
18063,18CS028,1104,1029,1180,1288,108,184,259,125.87090961724988,189,129.51932796144118,-0.5550749585957302,-0.0406965580615643,0.48247752396115123,1.0234135582716368,1391,1299,1483,1460,-23,69,161,38.524119744040306,157,87.80907957068631,-1.0091256879172672,-0.495658536076379,0.05881236406477519,2.2467095957404504,175109,178797,Hendricks,Hendricks,18,63,Indiana,IN
18065,18CS029,514,493,535,622,87,108,129,266.231202763522,63,155.02922177791447,0.595060920283934,1.12150002243431,1.6207272303864202,0.5769774722508351,628,603,653,734,81,106,131,216.47958905239244,109,222.77632439502943,-0.5659009339091211,-0.08461901136488673,0.4161688039361104,1.019462060751958,48765,48928,Henry+Rush,Henry,18,65,Indiana,IN
18139,18CS029,170,162,177,183,6,13,21,96.5682707611306,17,122.03876525484566,-0.7788055213275457,-0.2606567951378025,0.2478713704264545,1.1763110237186944,206,198,215,220,5,14,22,81.3878982075745,21,125.88418654837548,-0.9422768080160796,-0.4521096449866285,0.058804274560835326,1.4406128766609798,16716,16682,Henry+Rush,Rush,18,139,Indiana,IN
18067,18CS030,922,886,958,1064,106,142,178,204.49742754711542,137,196.91924394509257,-0.4552847380020597,0.06945199997404282,0.573440412155581,0.9562213351212643,1129,1085,1172,1334,162,205,249,245.52330912040242,184,219.89316060566222,-0.23724202327077223,0.23683169261887718,0.8228682430269796,0.8912719029299957,83486,83677,Howard+Tipton,Howard,18,67,Indiana,IN
18159,18CS030,163,157,170,186,16,23,29,178.8053481303705,36,281.76363162014087,-1.5194047492279568,-1.045198724682796,-0.5154153966938291,1.5097274689327158,200,192,208,230,22,30,38,195.73440190121977,36,234.20727343699176,-0.901651195246911,-0.38735884766267253,0.16858487468937916,1.1580651143662832,15332,15371,Howard+Tipton,Tipton,18,159,Indiana,IN
18069,18CS031,357,341,372,426,54,69,85,227.1323206653796,44,144.25047127284648,0.2957706908581968,0.8346595707755402,1.3195548626208822,0.6260579302008898,438,419,457,520,63,82,101,223.5429760708448,71,193.46049046321525,-0.2417854902378609,0.28971555533066917,0.8017158774452102,0.8550068310663587,36603,36700,Huntington+Whitley,Huntington,18,69,Indiana,IN
18183,18CS031,277,262,291,305,14,28,43,99.58248508797345,27,94.56264775413713,-0.48904832021726224,0.05784161412244282,0.5789025086810118,0.9173286733189112,341,324,359,385,26,44,61,126.8666134526403,40,116.2351436956964,-0.41103546469091307,0.10665206643319347,0.6210418834110296,0.8956839917612225,34263,34413,Huntington+Whitley,Whitley,18,183,Indiana,IN
18071,18CS032,430,410,450,474,24,44,64,113.88848589972885,50,130.37526346667823,-0.666817252873543,-0.1668609298749084,0.33925908332265414,1.1191394841859736,525,502,549,567,18,42,65,90.37196596889694,48,104.09437890353921,-0.6568736374694559,-0.1254347356295474,0.37095157887580454,1.1248509322698244,46021,46112,Jackson+Washington,Jackson,18,71,Indiana,IN
18175,18CS032,272,260,284,293,9,21,33,88.57229399205427,19,80.89409260244811,-0.40034508479873904,0.08656957433970651,0.6010406288540684,0.8714230214241883,331,317,346,397,51,66,80,232.99572820941364,44,156.477826380739,0.24756675175225853,0.7642608395146467,1.252706321389809,0.661494294292118,28185,28119,Jackson+Washington,Washington,18,175,Indiana,IN
18077,18CS033,331,316,345,382,37,51,66,186.79223176897688,45,163.81507098653077,-0.34396515906151054,0.20972381469692844,0.7237385909076722,0.860226135910802,406,389,423,427,4,21,38,62.69533543306295,75,226.3740907307356,-2.1753456209915534,-1.6301048091815389,-1.1206583057591342,3.444856096826527,32964,33131,Jennings+Jefferson,Jefferson,18,77,Indiana,IN
18079,18CS033,262,250,274,300,26,38,50,164.90987847524403,30,130.61461432406938,-0.16377926210565136,0.35399364647062737,0.8274703194481412,0.7716634761748826,320,306,334,346,12,26,40,95.50862746662314,32,116.65208515602218,-0.7224468759364374,-0.21921135656538596,0.26017602708461823,1.176473759236745,27562,27432,Jennings+Jefferson,Jennings,18,79,Indiana,IN
18081,18CS034,1213,1143,1282,1462,180,249,319,184.9132896114665,223,165.3495140231959,-0.33540548519145225,0.20155214771087093,0.6965136440762171,0.8906289694033099,1508,1423,1592,1742,150,234,319,142.95943848499016,199,121.34960271725542,-0.3189199048942496,0.21129302970224725,0.7256200870900809,0.8452340246051055,161839,163989,Johnson,Johnson,18,81,Indiana,IN
18085,18CS035,626,592,661,679,18,53,87,79.21498298280319,67,100.54147335776007,-0.7675865032341018,-0.20277397609092102,0.30643355672585393,1.245626259128063,772,730,813,924,111,152,194,190.3159370853582,97,121.10165047816426,0.21567893754610554,0.6724242837385862,1.2002111507552484,0.6321719776996604,79967,80098,Kosciusko,Kosciusko,18,85,Indiana,IN
18087,18CS036,252,234,269,308,39,56,74,166.87333669758172,72,213.82433736728782,-0.9843740471847271,-0.4621493058696899,0.03871055122928453,1.2589520165640393,314,293,335,313,-22,-1,20,-2.694764752522308,32,78.96749993830664,-1.3526033517895464,-0.823603854630522,-0.2991049678124229,-347.8278991980435,40407,40523,LaGrange+Noble,LaGrange,18,87,Indiana,IN
18113,18CS036,395,375,415,437,22,42,62,105.98077619852302,47,118.88701517706578,-0.6938702806285365,-0.11895292111208541,0.4072514157541008,1.0956289794169753,486,461,510,552,42,66,91,139.98355731064507,59,124.87036762682808,-0.3651046740034244,0.13636882073979717,0.6851965932129965,0.878749922018842,47440,47249,LaGrange+Noble,Noble,18,113,Indiana,IN
18089,18CS037,4383,4170,4597,5247,650,864,1077,208.5870378429712,627,151.45201905831627,0.04913849907389891,0.5638765317792324,1.1028601657850878,0.7252456209523018,5395,5138,5652,6032,380,637,894,127.76184341193522,617,123.7554255822723,-0.4663773939930968,0.031898839845232986,0.5901561851014717,0.96712320772274,496791,498564,Lake,Lake,18,89,Indiana,IN
18091,18CS038,1061,1013,1109,1271,162,210,258,225.27948983893967,130,139.38278443916298,0.27826310015284467,0.875139600639012,1.3717085172527355,0.6157798060606727,1301,1243,1359,1366,7,65,123,57.49686914628781,107,95.22453411174199,-0.9138816985814587,-0.38326692846078875,0.13700983054427027,1.6309252202891913,111922,112366,LaPorte,LaPorte,18,91,Indiana,IN
18093,18CS039,463,443,482,545,63,82,102,218.85926301338222,82,218.25440833980258,-0.4995753723103555,-0.010505628606226874,0.5196578265388966,0.9852542411658377,565,542,588,733,145,168,191,372.48530226240433,108,239.6644697423607,0.8221177203311002,1.3404364521578216,1.8724708226721194,0.6396094051913318,45085,45063,Lawrence+Orange,Lawrence,18,93,Indiana,IN
18117,18CS039,203,195,212,264,52,61,69,367.81030524666994,35,211.99273167777102,1.0762952780380093,1.566549645186833,2.071269138674887,0.5670267644464319,248,238,259,310,51,62,72,310.8400485350066,39,196.66179214361352,0.633332424328198,1.139937661091146,1.6607202021370278,0.6225786278406907,19812,19831,Lawrence+Orange,Orange,18,117,Indiana,IN
18095,18CS040,1303,1247,1359,1558,199,255,311,235.51716053308374,227,209.46595409281403,-0.21789857797122134,0.2545401742869892,0.7652337054498153,0.8859162015835598,1602,1534,1669,1950,281,348,416,266.59241787073137,261,199.72910305562573,0.17131069778293842,0.6773889408960223,1.2066271674803035,0.7470483563427925,130045,130677,Madison,Madison,18,95,Indiana,IN
18097,18CS041,7153,6733,7572,8757,1185,1604,2024,197.59423461307358,1268,156.17494549888536,-0.030073794264925242,0.4103288178024944,0.931792658480503,0.7898897351959403,8768,8266,9270,10250,980,1482,1984,152.47044401070556,1003,103.19683845219146,-0.022168062754373864,0.4852434262107412,1.008359420957587,0.6763753335825966,974292,971929,Marion,Marion,18,97,Indiana,IN
18099,18CS042,392,372,412,515,103,123,143,319.73111266158935,74,192.81294104874604,0.7565069998703836,1.272295419408805,1.7750505314570506,0.5981724863108535,483,459,507,541,34,58,82,125.26792981396677,71,153.99297271504793,-0.772227543653983,-0.2930442922503468,0.21176618794736343,1.2083865761785102,46055,46106,Marshall+Pulaski+Starke,Marshall,18,99,Indiana,IN
18131,18CS042,145,140,151,163,12,18,23,168.76637241420363,28,269.72786385164966,-1.5404026672776183,-1.0071922825634902,-0.4706680793691238,1.511931637219254,176,170,183,211,28,35,41,280.0187649285147,33,266.9686918534099,-0.40334781689456173,0.1323614336062518,0.6610520823212834,0.9266248066135856,12457,12361,Marshall+Pulaski+Starke,Pulaski,18,131,Indiana,IN
18149,18CS042,236,226,246,296,50,60,70,307.71457231867527,49,252.28472132835628,0.07051967523942287,0.5473282074149228,1.0677286460629392,0.8063738048835778,290,278,302,374,72,84,96,359.4032755937135,42,179.7175866495507,1.2728385552611128,1.8036103890945654,2.324307573846467,0.4941609849408625,23307,23370,Marshall+Pulaski+Starke,Starke,18,149,Indiana,IN
18105,18CS043,801,741,861,1017,156,216,276,183.9883822922588,113,96.29519163169219,0.3493971802674228,0.8817249848682612,1.3656649502727154,0.5209635576294934,988,916,1060,1162,102,174,246,124.423417551601,116,82.96203056721713,-0.0896713546986906,0.40571957988746876,0.9225557982232034,0.6629611136348766,140817,139823,Monroe,Monroe,18,105,Indiana,IN
18109,18CS044,626,595,656,720,64,94,125,158.110325267226,93,155.7788944723618,-0.5500359459091269,0.02054232071339766,0.538512176230578,0.9749259100345613,774,737,811,903,92,129,166,178.85120099089409,112,155.23861006001636,-0.3224751842966946,0.23185479279754317,0.741062379929282,0.8613014315242996,71640,72147,Morgan,Morgan,18,109,Indiana,IN
18127,18CS045,1337,1262,1411,1602,191,265,340,183.91897714887634,180,124.87642437171547,0.06543611498817488,0.5958430973520509,1.088058718930869,0.6764236732083606,1656,1566,1746,1902,156,246,336,141.50333367650856,192,110.28208088501371,-0.2595571270814962,0.314852736623149,0.8112779610147635,0.776209537018902,172971,174099,Porter,Porter,18,127,Indiana,IN
18141,18CS046,2343,2226,2461,2802,341,459,576,202.03927871563417,372,163.88326988241081,-0.151988186425184,0.3873765576875985,0.8928500105112449,0.8093807359279258,2874,2734,3015,3115,100,241,381,88.39470650059309,250,91.8236545079905,-0.5381186543092956,-0.03454189168929678,0.481199561618286,1.034492838723563,272389,272261,St. Joseph,St. Joseph,18,141,Indiana,IN
18157,18CS047,1032,951,1112,1164,52,132,213,84.66994841422469,83,53.09394856923536,-0.18359608057357235,0.2966359463229124,0.7865827943848094,0.6223675538472354,1277,1181,1374,1497,123,220,316,117.48687232140979,167,89.32630846995266,-0.23528947276768225,0.28139520844089927,0.7974570057754161,0.7568630409356226,187592,186955,Tippecanoe,Tippecanoe,18,157,Indiana,IN
18163,18CS048,1697,1619,1774,2038,264,341,419,227.1727899833456,247,164.35165931963735,0.11804398673549107,0.6340848486188476,1.147015027128754,0.7213525773857902,2076,1983,2169,2334,165,258,351,143.3598714515157,219,121.65855609626024,-0.2769980688543923,0.21858553780011325,0.7200546442883972,0.8453477846914401,180345,180012,Vanderburgh,Vanderburgh,18,163,Indiana,IN
18173,18CS049,529,502,557,661,104,132,159,247.26039483955464,85,159.72439711869714,0.3466586439606367,0.88388085685092,1.3709740873234169,0.6411042554899962,657,624,691,722,31,65,98,100.29847932373558,73,113.29422354657478,-0.635115836999687,-0.13036841190227932,0.39175089117363443,1.112358541344571,63860,64434,Warrick,Warrick,18,173,Indiana,IN
18177,18CS050,764,736,793,935,142,171,199,308.5605005898053,131,236.81831877071406,0.22045789424987158,0.7346898248408319,1.2074111010869832,0.7630236032400006,934,900,969,1028,59,94,128,140.88983539624581,113,170.03731792464188,-0.8435406330484478,-0.2772086242388411,0.2096581990571014,1.1941276520446993,66380,66456,Wayne,Wayne,18,177,Indiana,IN
19005,19CS001,158,152,164,169,5,11,17,92.2386087943618,27,231.51125401929258,-1.909019441484408,-1.387010867264695,-0.8391734420060344,2.2964401922473123,192,185,199,169,-30,-23,-16,-165.5317139885511,20,143.40001434000143,-3.6084440779399434,-3.1008728621488517,-2.5750081448693547,-0.905521993779557,13995,13947,Allamakee+Clayton+Winneshiek,Allamakee,19,5,Iowa,IA
19043,19CS001,165,158,172,197,25,32,39,224.52922222891704,43,302.3024195910715,-1.298223230031545,-0.7682083592516945,-0.23153921820446693,1.3055063824053355,201,193,210,223,13,22,30,127.09319132448687,16,94.12872102600306,-0.18693200330861523,0.33845801898670885,0.8573713872776094,0.7078612207892518,17069,16998,Allamakee+Clayton+Winneshiek,Clayton,19,43,Iowa,IA
19191,19CS001,166,157,175,161,-14,-5,4,-29.57502847874185,22,131.9274399080506,-2.1375412382436254,-1.6080867345857224,-1.083456967116248,-5.595284253370821,203,192,213,202,-11,-1,10,-3.0599189750773954,16,80.35355564483729,-1.3376561333283843,-0.841902183127664,-0.2989437196309107,40.951200806169325,20011,19912,Allamakee+Clayton+Winneshiek,Winneshiek,19,191,Iowa,IA
19001,19CS002,90,89,91,98,7,8,9,126.08238588105931,16,258.44662807914926,-1.4500255783177247,-1.324578616717917,-1.2020071673317747,1.817035769826627,112,111,113,130,17,18,19,241.61418819009768,19,252.25703664365375,-0.23090522764784874,-0.10515531006652204,0.028619337852224307,0.9896668027346419,7429,7532,Audubon and Nearby Counties,Adair,19,1,Iowa,IA
19009,19CS002,73,72,73,68,-5,-5,-4,-104.75795438358026,4,85.09129586952666,-2.0221889915896667,-1.8971246230948207,-1.7796357595680539,-1.019238940459467,89,88,90,82,-8,-7,-6,-126.27678632440092,4,70.92198581560284,-2.0873776287827783,-1.9719563590674603,-1.8482931092115225,-0.653380100786636,5641,5640,Audubon and Nearby Counties,Audubon,19,9,Iowa,IA
19029,19CS002,172,166,177,205,28,33,39,306.5203201317911,41,376.80937428199434,-1.2246536317656054,-0.7109141232217071,-0.19216248793898838,1.1935270602851613,209,202,215,203,-12,-6,1,-43.832322486772036,25,191.45351508653698,-2.898800187772759,-2.331965045981132,-1.8496975440535912,-5.29254581911821,13057,13058,Audubon and Nearby Counties,Cass,19,29,Iowa,IA
19077,19CS002,104,103,105,133,28,29,30,324.4204370845765,20,225.8610954263128,0.8592302836865833,0.9880426237867879,1.1074853552410362,0.6727793219679882,127,126,128,127,-1,-0,1,-0.14657568460303153,14,132.40022697181766,-1.4679291194234028,-1.3257206329490696,-1.1921395984286425,14.220400752523174,10626,10574,Audubon and Nearby Counties,Guthrie,19,77,Iowa,IA
19165,19CS002,128,127,129,162,33,34,35,347.43251642397615,28,287.8190851464794,0.46422341963086494,0.5949296041393594,0.7240543272281963,0.8046117285349865,158,156,159,150,-9,-8,-6,-67.8414188442169,13,110.54421768707483,-1.9039842587765217,-1.7857370728431772,-1.6572343548138764,-1.862957718759174,11674,11760,Audubon and Nearby Counties,Shelby,19,165,Iowa,IA
19011,19CS003,212,201,223,267,44,55,66,257.6410017322549,41,192.54099322975776,0.10118197518611693,0.6538418079030027,1.1345316932351008,0.7339448974948161,263,250,276,235,-41,-28,-15,-108.52670989380135,14,54.54262116253701,-2.138603208329662,-1.631482381786757,-1.1157702177689444,-0.5212864356672628,25553,25668,Benton+Iowa (county)+Keokuk+Washington,Benton,19,11,Iowa,IA
19095,19CS003,171,164,179,195,16,24,31,170.42993837417987,22,159.13200723327307,-0.38876367191060635,0.0953268303892596,0.6264114119461626,0.8956947583701579,210,201,219,214,-5,4,13,24.484056894696856,14,84.4187168355041,-1.1135459420181426,-0.6009264368803203,-0.08931917739947716,2.7665600380442426,16590,16584,Benton+Iowa (county)+Keokuk+Washington,Iowa (county),19,95,Iowa,IA
19107,19CS003,100,99,101,128,27,28,29,337.7441510710408,26,311.53270094857714,0.13881013597351793,0.26101872405102317,0.3870621921697182,0.8907903397535132,122,120,123,156,33,34,36,347.2272396979421,18,181.34193028410238,1.5341730502158344,1.6578591571318224,1.7936222541036733,0.5075315452058322,10015,9926,Benton+Iowa (county)+Keokuk+Washington,Keokuk,19,107,Iowa,IA
19183,19CS003,217,207,226,263,37,46,56,247.42686162943318,32,171.130620794153,0.28088041376570017,0.7646040057371555,1.300137177636579,0.6770085185538964,267,255,278,265,-13,-2,10,-7.495893607541393,34,151.1514181559527,-2.09556181921195,-1.5967318418909784,-1.093489538080893,-49.55355828743099,22439,22494,Benton+Iowa (county)+Keokuk+Washington,Washington,19,183,Iowa,IA
19013,19CS004,1050,994,1106,1302,196,252,308,230.84814305317892,239,219.04500045825313,-0.4185479360541795,0.11735343399165923,0.6151169758175574,0.945118252892768,1289,1222,1357,1450,93,161,228,123.06157814592649,141,108.08159010248589,-0.3600432324664588,0.15352789692944718,0.6586787436113618,0.8728356299427857,130932,130457,Black Hawk,Black Hawk,19,13,Iowa,IA
19015,19CS005,252,241,264,284,20,32,43,143.68609718937307,15,67.55995946402432,0.2429488135030781,0.7709183414549614,1.2958357911438059,0.4559006436827839,308,294,322,334,12,26,40,96.518171422538,27,101.05546822366944,-0.5757564410900755,-0.04010208420612099,0.4630668822233251,1.007924336949255,26643,26718,Boone+Carroll+Greene,Boone,19,15,Iowa,IA
19027,19CS005,204,195,213,239,26,35,44,202.13705345946624,36,209.54598370197903,-0.552577525312869,-0.0815548912774005,0.41083246354359026,1.007637168032139,250,239,260,281,21,31,42,151.8588501595714,10,48.32552070748562,0.5250333309139474,1.0366847539388602,1.5296470705205776,0.3084120763464237,20616,20693,Boone+Carroll+Greene,Carroll,19,27,Iowa,IA
19073,19CS005,99,98,100,85,-15,-14,-13,-189.8127982408395,4,54.77576172543648,-2.570183356263804,-2.445826448874786,-2.328495432488687,-0.31101588101764277,120,119,121,130,9,10,11,111.76360584489399,10,114.66574934067195,-0.15451765621458963,-0.03013691846321807,0.09232960857336718,0.9305005366043297,8763,8721,Boone+Carroll+Greene,Greene,19,73,Iowa,IA
19017,19CS006,203,192,213,272,59,69,80,333.0589131746653,44,211.08179419525067,0.6946934981462359,1.2082517719774386,1.742672333831322,0.6247681040839214,251,238,264,254,-10,3,16,11.873401916809843,23,91.76142030720128,-1.3302498840139843,-0.8043080002605374,-0.2609649640686855,5.784609040471777,25014,25065,Bremer+Butler+Grundy,Bremer,19,17,Iowa,IA
19023,19CS006,164,158,170,153,-17,-11,-5,-94.6098193602735,22,184.2674670203113,-3.31547737566118,-2.7894927719553246,-2.303115789483901,-2.136830168315954,201,194,209,199,-10,-2,5,-17.143376441986245,21,146.55593551538837,-2.1866388277498885,-1.6335049475932866,-1.1411913204958806,-14.418378963921066,14327,14329,Bremer+Butler+Grundy,Butler,19,23,Iowa,IA
19075,19CS006,124,123,126,142,16,18,19,171.48904978009503,26,253.5966837356742,-0.9414222416659626,-0.8154465067137683,-0.7057292668768601,1.3992099436295304,154,152,155,147,-8,-7,-5,-53.669863566040426,3,24.307243558580456,-0.9055732570046489,-0.7776703039763657,-0.6623421620899975,-0.5334343718422443,12303,12342,Bremer+Butler+Grundy,Grundy,19,75,Iowa,IA
19019,19CS007,173,164,182,191,9,18,27,103.2921331609951,22,127.69044740024182,-0.7285654581608471,-0.2462371761267394,0.25796511675706923,1.1704385251292853,212,202,223,223,-0,11,21,51.22632477698912,20,96.86637283866905,-0.9826434332654707,-0.45755930229442154,0.05412696122425578,1.727608148226216,20675,20647,Buchanan+Delaware+Fayette,Buchanan,19,19,Iowa,IA
19055,19CS007,151,143,158,187,29,36,44,249.15434404811168,32,220.62625682275205,-0.2350862480149199,0.27965917073423635,0.7837881959337303,0.8616566767719777,186,177,195,189,-6,3,12,19.220879058971686,23,131.4135527368301,-1.6252208751227577,-1.118329949591493,-0.5968932112486054,5.270347936274284,17405,17502,Buchanan+Delaware+Fayette,Delaware,19,55,Iowa,IA
19065,19CS007,210,201,218,250,32,40,49,248.8876599099108,26,160.74188562596598,0.3637289668531279,0.8809634705773599,1.4250216646425622,0.6301872440462905,254,244,264,273,9,19,29,96.36013449769476,30,155.60973079516572,-1.092660100129596,-0.5896075662710102,-0.08663815339397059,1.5323893216266515,19410,19279,Buchanan+Delaware+Fayette,Fayette,19,65,Iowa,IA
19031,19CS008,155,147,163,181,18,26,34,168.56986799026222,18,116.80095171145838,0.016376031665585614,0.517447587395938,1.0724092614661427,0.6672097901095054,189,179,198,213,15,24,34,130.87623796404804,5,27.14146129627619,0.5212333032620673,1.0244933827449332,1.5421688751165359,0.19912369201384003,18493,18422,Cedar+Clinton+Jackson+Jones,Cedar,19,31,Iowa,IA
19045,19CS008,471,451,491,531,40,60,80,155.70367558898388,71,183.4506814805245,-0.8067216373777575,-0.28818756503917803,0.22588026621317467,1.1589714625811354,574,550,598,611,13,37,61,79.62503839736358,47,101.17100051661788,-0.7386928435963382,-0.21974719025454467,0.270452712777045,1.2371478814070933,46443,46456,Cedar+Clinton+Jackson+Jones,Clinton,19,45,Iowa,IA
19097,19CS008,191,182,199,223,24,32,41,200.35382223595556,32,197.72411307347716,-0.4935411359697929,0.04707379051527007,0.5339445383486513,0.9573501548994158,232,222,242,269,27,37,47,191.62406924983847,27,139.33326452678295,-0.02071406568076775,0.5221399270415349,1.0426980004952215,0.7080497786640478,19421,19378,Cedar+Clinton+Jackson+Jones,Jackson,19,97,Iowa,IA
19105,19CS008,173,164,182,210,28,37,46,216.60319662529923,48,278.77262607685606,-1.1354343918749885,-0.6231496506713303,-0.079230583345847,1.2534122711051567,212,202,223,242,19,30,40,142.58931605924727,14,67.3659897988644,0.1847345724119439,0.7309588096207468,1.2847933765100454,0.4570247893448579,20662,20782,Cedar+Clinton+Jackson+Jones,Jones,19,105,Iowa,IA
19033,19CS009,449,430,467,533,66,84,103,236.360845428885,67,187.55686192175799,-0.05619036608630086,0.48041533288001104,0.9773448855353943,0.7842310747567881,548,526,570,601,31,53,75,124.91332367471212,63,147.38910724312183,-0.7266303240877763,-0.2264295714626341,0.2704772074151276,1.158238315056008,42867,42744,Cerro Gordo+Hancock+Winnebago,Cerro Gordo,19,33,Iowa,IA
19081,19CS009,101,100,102,120,18,19,20,216.43884474768896,20,223.5885969815539,-0.19191244906246216,-0.06969154758501227,0.04470809573279725,0.9822963352905145,123,122,124,154,30,31,32,290.4222008320204,16,149.85482813524396,1.2732381167150877,1.4062802241289114,1.5288502738208092,0.49986912203525885,10734,10677,Cerro Gordo+Hancock+Winnebago,Hancock,19,81,Iowa,IA
19189,19CS009,111,110,112,137,25,26,27,297.7253732224942,24,271.49321266968326,0.14311736861085708,0.26361909623089497,0.3825698236150035,0.8785119386392031,136,135,138,126,-12,-10,-9,-98.0909330709326,11,103.23791647114031,-2.1361960227312964,-2.0124551049909036,-1.8809406207055333,-1.1638254789337383,10608,10655,Cerro Gordo+Hancock+Winnebago,Winnebago,19,189,Iowa,IA
19049,19CS010,481,438,524,557,33,76,119,91.07316982507403,63,75.7279802866845,-0.34448255123056315,0.1567759311044473,0.6563990836839045,0.8206753196320797,617,564,670,585,-85,-32,21,-31.118400377516284,46,44.524890381655744,-1.2814780362720273,-0.7598415621940782,-0.22616759688375984,-1.4767561954351685,99831,103313,Dallas,Dallas,19,49,Iowa,IA
19051,19CS011,81,80,82,91,9,10,11,135.75299460408462,20,263.8232384302517,-1.4042050559061683,-1.2793176810398512,-1.1680971405845446,1.7712896201128354,100,99,101,82,-19,-18,-17,-195.15254401692886,2,21.89621195533173,-2.2960133656658614,-2.172008710948435,-2.0421348165102,-0.11886907931428108,9097,9134,Davis+Jefferson+Van Buren+Wapello,Davis,19,51,Iowa,IA
19101,19CS011,137,130,143,178,35,41,48,310.3299520044168,25,187.20748829953197,0.70558350907144185,1.2466187230403472,1.743096360486375,0.5890394506751355,166,158,174,183,9,17,25,109.9501528032312,15,95.85277014505719,-0.3503454615116287,0.13823548397272037,0.6457715498974157,0.8238997085760631,16025,15649,Davis+Jefferson+Van Buren+Wapello,Jefferson,19,101,Iowa,IA
19177,19CS011,81,81,82,80,-2,-1,-1,-24.153017236002192,13,217.11899791231733,-2.537146634676187,-2.4151434961198617,-2.300879887874771,-29.137404596569272,101,100,102,91,-11,-10,-9,-135.25795698498598,4,55.27152134862512,-2.037571191674318,-1.905869814745345,-1.774081584615593,-0.45513411119551445,7185,7237,Davis+Jefferson+Van Buren+Wapello,Van Buren,19,177,Iowa,IA
19179,19CS011,358,343,373,456,83,98,113,332.9294231395907,95,322.90958531611153,-0.44349974970009265,0.10797938545446609,0.5755402271085042,0.9601018431955379,439,420,457,469,12,30,49,85.9992872660045,60,170.12589316093909,-1.3356334599300372,-0.8428952203077279,-0.3180251401514545,1.915083375320509,35304,35268,Davis+Jefferson+Van Buren+Wapello,Wapello,19,179,Iowa,IA
19057,19CS012,391,374,407,434,27,43,60,133.53255713648943,42,129.80323477902542,-0.5036672383908599,0.022796723086232085,0.5425215383808859,0.9500825625383491,475,456,495,549,54,74,93,190.78161349635857,63,163.46228691523314,-0.24094625087001004,0.25582963029736927,0.7984703791659503,0.845306930937249,38828,38541,Des Moines+Henry+Lee,Des Moines,19,57,Iowa,IA
19087,19CS012,190,181,199,246,47,56,65,329.25298623491386,35,206.6420664206642,0.7069826980937632,1.2339546240878339,1.705641767341704,0.6165529543047537,234,223,244,250,6,16,27,79.60922726466328,23,112.79486047766171,-0.847622303410906,-0.33664273412684415,0.17042301311281377,1.3346395368051556,20325,20391,Des Moines+Henry+Lee,Henry,19,87,Iowa,IA
19111,19CS012,365,350,379,439,60,74,89,266.4458977346572,33,118.2089552238806,0.9594063609212906,1.4895180180391985,2.0380796849550573,0.43776556797532024,443,426,460,509,49,66,83,198.52654529771374,75,225.50965181309758,-0.7596284363862561,-0.26892578188948124,0.2515587458864364,1.1189694522996767,33500,33258,Des Moines+Henry+Lee,Lee,19,111,Iowa,IA
19061,19CS013,794,751,837,867,30,73,116,88.5050025593035,151,183.1894372889581,-1.49407895474555,-0.9431009722359528,-0.4151247750653345,2.0418319019208586,974,923,1025,1052,27,78,129,79.08252711853788,100,101.22174648001378,-0.7042741248640167,-0.2120026557328135,0.2997587379673983,1.2637751328951834,98914,98793,Dubuque,Dubuque,19,61,Iowa,IA
19069,19CS014,103,102,104,135,31,32,33,378.9650846677989,18,216.12967780668401,1.5145457035620975,1.6286863994545757,1.7479773622661097,0.5528005024724273,127,125,128,168,40,41,43,415.46675845639925,16,160.69097117605705,2.4170829964340785,2.5506522927920163,2.677821340139209,0.3776432804530628,9994,9957,Franklin+Hamilton+Hardin+Wright,Franklin,19,69,Iowa,IA
19079,19CS014,161,155,168,176,8,15,21,117.42929612845565,33,264.4583945505543,-2.005752647673918,-1.4493584870515868,-0.9421929066240845,2.1081925702312927,197,189,205,193,-12,-4,4,-27.992715905815686,22,147.59157386287401,-2.2830063952636666,-1.749344569376417,-1.2192681339994456,-6.934388196168863,14974,14906,Franklin+Hamilton+Hardin+Wright,Hamilton,19,79,Iowa,IA
19083,19CS014,188,181,195,215,20,27,34,194.43201128966862,28,199.9167013744273,-0.5663692310218282,-0.058945000795130625,0.4917287857246359,0.9917885768764874,229,221,238,280,42,51,59,302.86748407293527,15,89.6914613728773,1.6258591727432574,2.144402852303296,2.65753887994773,0.2904075030890927,16807,16724,Franklin+Hamilton+Hardin+Wright,Hardin,19,83,Iowa,IA
19197,19CS014,159,153,164,161,-3,2,8,22.664076431352463,23,214.81942714819425,-2.4191071053739557,-1.9247948970585056,-1.4000930121950015,6.712257258492758,193,187,200,189,-11,-4,2,-33.38492468681064,25,195.25148391127775,-2.8100273288242303,-2.2728896690831677,-1.73043838956184,-7.634506824929306,12848,12804,Franklin+Hamilton+Hardin+Wright,Wright,19,197,Iowa,IA
19071,19CS015,77,76,77,70,-7,-7,-6,-120.32526399392208,5,90.73037955542114,-2.229067891362185,-2.105490520775131,-2.0046566603737688,-0.8879536161695175,93,92,94,97,3,4,5,57.873224079527105,12,182.75967103259214,-1.3707312787068393,-1.2482741402796291,-1.125378848742067,2.500022972574766,6613,6566,Fremont+Harrison+Mills+Pottawattamie,Fremont,19,71,Iowa,IA
19085,19CS015,169,162,175,235,60,66,73,549.5711784978033,61,505.38525269262635,-0.09734211530771054,0.4337778330251377,0.9657231401343752,0.9059418330736484,208,200,215,193,-22,-15,-7,-98.9942559691834,20,136.50945327963962,-2.861077720975815,-2.3603240918642476,-1.8448110845205101,-1.4810812119284629,14484,14651,Fremont+Harrison+Mills+Pottawattamie,Harrison,19,85,Iowa,IA
19129,19CS015,112,110,113,136,23,24,26,198.82146853090688,16,132.26784238082118,0.5412733307411507,0.6636293889337145,0.7904603914332055,0.6387029142030606,137,135,139,156,17,19,21,131.15441914767888,15,103.76314333148866,0.14511474108496092,0.27581045459837455,0.399076526818287,0.7515149477205216,14516,14456,Fremont+Harrison+Mills+Pottawattamie,Mills,19,129,Iowa,IA
19155,19CS015,807,767,847,994,147,187,227,239.9338174594185,111,142.4431350322422,0.4855016897006802,0.9737729147169333,1.4874597634023736,0.5905184232781068,987,939,1036,1141,105,154,202,164.53680818142976,117,125.34684650903677,-0.16088510499994144,0.39280739448126145,0.9172315488625502,0.7568881571060087,93511,93341,Fremont+Harrison+Mills+Pottawattamie,Pottawattamie,19,155,Iowa,IA
19099,19CS016,337,321,354,388,34,51,67,161.2002027830003,58,184.5860075319578,-0.7480538060554952,-0.2454387653284204,0.29177060434894253,1.1229039607007356,413,393,432,448,16,35,55,93.01043547489093,29,76.78051363516018,-0.37520925544063505,0.16678581450734836,0.7008601035366818,0.8026561502001899,37706,37770,Jasper+Poweshiek,Jasper,19,99,Iowa,IA
19157,19CS016,185,177,193,194,1,9,17,55.00613535825341,25,161.2036539494895,-1.575308340349015,-1.0461580681438354,-0.5444205691956087,2.6231476468715687,226,216,236,245,9,19,29,101.73026791094699,25,134.45197375497472,-0.8346435641279953,-0.34728245212555636,0.1758604341513031,1.255289412031321,18610,18594,Jasper+Poweshiek,Poweshiek,19,157,Iowa,IA
19103,19CS017,651,585,717,727,10,76,142,59.51116529601434,53,41.5431042366128,-0.3345273468390151,0.18649639917900698,0.6586182361929045,0.6889975286935344,821,741,901,906,5,85,165,55.0385374264965,59,38.189926921309336,-0.35731220850300754,0.1573408988973884,0.6932845883621925,0.6858105700199689,153094,154491,Johnson,Johnson,19,103,Iowa,IA
19113,19CS018,1565,1466,1664,1921,257,356,455,185.90834442901718,266,138.97354626356213,-0.08397698452240092,0.47645968004524264,0.9421452129156498,0.7454430557741062,1922,1804,2040,2075,35,153,271,66.75722733465521,177,77.24804915943648,-0.6202520598853706,-0.09900838051922449,0.41569311537683734,1.1496330549455205,229684,229132,Linn,Linn,19,113,Iowa,IA
19115,19CS019,93,92,94,111,17,18,19,202.55896966917499,30,332.19525698994187,-1.4252704873446818,-1.2952013593783565,-1.1718074090442185,1.5549872288276723,113,112,114,122,8,9,10,82.89509824690865,20,185.9254438969973,-1.154116360267462,-1.0310592845831421,-0.9031501112208595,2.016733703014588,10837,10757,Louisa+Muscatine,Louisa,19,115,Iowa,IA
19139,19CS019,357,338,375,431,56,74,93,207.35627909148153,79,220.51639916259595,-0.6403138571787109,-0.14281666049017905,0.38432271756492564,1.0493404253369962,436,414,458,486,28,50,72,117.90900833735637,45,105.26315789473684,-0.3620626709748262,0.12419965320503495,0.6074295603807592,0.8753824753949548,42990,42750,Louisa+Muscatine,Muscatine,19,139,Iowa,IA
19007,19CS020,147,142,153,180,27,33,38,319.4664089762904,40,389.768574908648,-1.1822434985391603,-0.7005429855118418,-0.20437829121992898,1.1839489593124157,178,172,184,188,4,10,16,81.94428233330167,16,130.4950656553299,-1.0087644028402567,-0.4774473543287516,0.016846631579931493,1.4483323121030502,12315,12261,Lucas and Nearby Counties,Appanoose,19,7,Iowa,IA
19039,19CS020,97,96,98,100,2,3,4,33.311093352128054,4,49.57653377401363,-0.2903583742684279,-0.1528029219778205,-0.04169328212935013,1.0847016249518358,120,119,121,159,38,39,40,396.4449654489666,22,225.04091653027825,1.5852901514039406,1.7110744239187403,1.8432544445359824,0.5533691907765103,9682,9776,Lucas and Nearby Counties,Clarke,19,39,Iowa,IA
19053,19CS020,70,70,71,76,5,6,6,87.28445781109467,2,31.372549019607845,0.4298215300982978,0.5598808071376331,0.6823405735496763,0.30467442847583376,86,85,87,99,12,13,14,166.5309227662677,15,196.02718243596442,-0.4367075141950855,-0.2934578601136122,-0.1660102656505136,1.0914690176844075,7650,7652,Lucas and Nearby Counties,Decatur,19,53,Iowa,IA
19117,19CS020,95,94,96,98,2,3,4,39.76737752239149,11,153.18556342114425,-1.2531370867537206,-1.1357447153429132,-1.0111713869672165,2.8529715156922477,117,116,119,125,6,8,9,86.99700942890938,12,137.9944802207912,-0.6402517552529768,-0.507757686374671,-0.3851859183870088,1.401008268767955,8617,8696,Lucas and Nearby Counties,Lucas,19,117,Iowa,IA
19135,19CS020,84,84,85,101,16,17,17,263.5270753476985,16,252.66482431898936,-0.01126155453125485,0.10947544105265675,0.23116868738383992,0.9045756351892824,103,102,104,109,5,6,7,76.20028472845208,17,223.50775703392057,-1.6107355477666303,-1.4739590187354445,-1.3507652458117303,2.501547407030945,7599,7606,Lucas and Nearby Counties,Monroe,19,135,Iowa,IA
19185,19CS020,74,73,75,94,19,20,21,370.4159543331822,17,314.08775981524246,0.4291828145500882,0.5660789879095127,0.6828419595548069,0.8076483911825456,91,90,91,86,-5,-5,-4,-70.9189897804604,7,107.55992624462202,-1.9127064632314876,-1.7822614106497063,-1.660757610607278,-1.9361577672319572,6495,6508,Lucas and Nearby Counties,Wayne,19,185,Iowa,IA
19119,19CS021,95,93,96,112,16,17,19,175.2738788789215,35,352.6152296196793,-1.8917174911696941,-1.7728280200523816,-1.661196771327697,1.9024434505708405,117,115,118,94,-24,-23,-21,-188.47491097615298,3,25.006251562890725,-2.2647482181944176,-2.13474859361126,-2.00271534903677,-0.13881604215146268,11911,11997,Lyon+O'Brien+Osceola+Sioux,Lyon,19,119,Iowa,IA
19141,19CS021,172,166,178,220,42,48,54,412.4416256545151,50,425.92461134379215,-0.6070807437137001,-0.14296986214716328,0.3797986282522379,1.0117932631893645,207,200,214,183,-31,-24,-17,-172.75857803013446,11,78.37548984681155,-2.982635023602951,-2.5024486194713993,-2.0337717373889492,-0.473186124761814,14087,14035,Lyon+O'Brien+Osceola+Sioux,O'Brien,19,141,Iowa,IA
19143,19CS021,61,61,62,71,9,10,10,188.73217238390433,10,195.02681618722573,-0.1937813638799845,-0.06361662486328525,0.05222194257470839,0.9365714357538121,75,74,76,91,15,16,17,258.29043742109576,4,64.9034561090378,1.811540412362786,1.9314508189969226,2.0716285716254332,0.23642842252574975,6153,6163,Lyon+O'Brien+Osceola+Sioux,Osceola,19,143,Iowa,IA
19167,19CS021,213,198,229,279,50,66,81,221.18775712289784,63,211.5454570892912,-0.4116650456711217,0.09794417613810506,0.5947091267130595,0.9421045739222957,263,244,281,257,-24,-6,13,-15.341749573439433,13,36.22178879910838,-1.0527112975061763,-0.5175472330083342,-0.02266348286727163,-2.8849436182812913,35737,35890,Lyon+O'Brien+Osceola+Sioux,Sioux,19,167,Iowa,IA
19121,19CS022,143,136,150,122,-28,-21,-14,-154.009488456382,10,72.33273056057865,-2.784949322406571,-2.2687413409277606,-1.7761544855008191,-0.4928096174390045,177,168,186,180,-6,3,12,18.748502398174228,15,89.54154727793697,-1.2044047115346022,-0.6918166865919239,-0.21636494844424206,3.6225329183162436,16590,16752,Madison+Warren,Madison,19,121,Iowa,IA
19181,19CS022,381,359,404,423,19,42,64,95.6543531158712,48,109.7330971023604,-0.6199022132723158,-0.14073998978738833,0.36756887160782525,1.1204061925018358,475,447,502,534,32,59,87,111.47208578943648,62,116.37291889558345,-0.6089801517414171,-0.04239958858611428,0.47543154103526375,1.0266773303677927,52491,53277,Madison+Warren,Warren,19,181,Iowa,IA
19123,19CS023,205,195,214,250,36,45,55,245.87497826954768,38,205.664802453545,-0.090704552193121707,0.4124727855391744,0.9242962805958739,0.8184451668857279,250,239,261,274,13,24,35,109.4099526335682,34,154.4892766266812,-0.9507985486445837,-0.4538118642768132,0.0842683321184756,1.3557190526936014,22172,22008,Mahaska+Marion,Mahaska,19,123,Iowa,IA
19125,19CS023,297,283,311,329,18,32,46,114.81166054044604,51,183.43674130024277,-1.2173210760919628,-0.6797701264527788,-0.18597374756360247,1.549186115975723,366,348,383,371,-12,5,23,15.798974791007867,45,134.81126423007788,-1.708298346412554,-1.1963564557637536,-0.6675651958846861,7.172803271761332,33363,33380,Mahaska+Marion,Marion,19,125,Iowa,IA
19127,19CS024,409,392,426,467,41,58,75,173.81145218322922,60,180.21625951141368,-0.5719710175500773,-0.07194096838859136,0.4432933538107724,1.019235935390108,499,479,520,531,11,32,52,79.20901725550142,26,65.19068274703507,-0.33975501667022157,0.1356347022977381,0.6359015447084123,0.7977679103861287,39952,39883,Marshall+Tama,Marshall,19,127,Iowa,IA
19171,19CS024,178,171,185,222,37,44,51,309.6101827298993,56,394.6904733936333,-1.3442432787677834,-0.8547658516164652,-0.33374626116268113,1.2464241881870128,216,207,225,216,-9,-0,9,-0.6035986896889483,20,118.36420666390484,-1.6664487761145712,-1.1809250878535305,-0.6977146107720092,22.271468661031747,17026,16897,Marshall+Tama,Tama,19,171,Iowa,IA
19037,19CS025,115,114,116,133,17,18,19,179.6256064913538,11,110.39558417663292,0.5811114281599791,0.6891757361061325,0.8113077776389684,0.5820661768200489,141,139,142,146,4,5,7,44.811147569149895,13,109.25287839314228,-0.773557140429451,-0.6447926669159909,-0.5216057109935667,2.0530383671309886,11957,11899,Mitchell and Nearby Counties,Chickasaw,19,37,Iowa,IA
19067,19CS025,154,147,161,202,41,48,55,369.09720904421835,30,231.46659808397095,0.8551979819814273,1.3853230061317545,1.92825219507016,0.6142748368254118,188,180,196,199,3,11,19,72.06106023485762,17,110.15356703168536,-0.9264702598344356,-0.37647608722713133,0.1585144573579569,1.4025033202179742,15553,15433,Mitchell and Nearby Counties,Floyd,19,67,Iowa,IA
19089,19CS025,102,101,103,99,-4,-3,-2,-36.48030805169808,15,190.7587961000424,-2.4014443342129117,-2.2732187778908863,-2.146577626340695,-8.027536706612127,126,124,127,134,7,8,10,89.20100621038063,7,73.84745226289694,0.014232528949643988,0.15470256554489842,0.2775202854084208,0.7403205693587799,9436,9479,Mitchell and Nearby Counties,Howard,19,89,Iowa,IA
19131,19CS025,117,116,118,129,11,12,13,138.2753098147751,37,419.77876524534366,-2.930904667970452,-2.8164195760892468,-2.7024130488307647,2.8056199187127278,143,142,144,150,6,7,8,65.91258678128352,2,18.941187612463303,0.3380518963578344,0.4671067627985514,0.5959443403765411,0.25126543434279436,10577,10559,Mitchell and Nearby Counties,Mitchell,19,131,Iowa,IA
19195,19CS025,72,71,73,59,-14,-13,-12,-210.6006649806636,5,80.88433540037745,-3.030523070103786,-2.916760946775194,-2.7939982739542972,-0.4160207560688371,88,87,89,99,10,11,12,147.30097513778415,6,81.17981328642944,0.5404907287605992,0.6672470475128406,0.7913504252538421,0.5047524515985677,7418,7391,Mitchell and Nearby Counties,Worth,19,195,Iowa,IA
19041,19CS026,165,158,172,187,15,22,29,161.11261071084485,16,117.7264087313753,-0.06356838819672839,0.42811602758983186,0.9725716439805097,0.6987953431927046,203,194,211,198,-13,-5,4,-27.550432862943847,20,121.77301509985388,-2.0279340398968144,-1.4891354338948743,-0.9410914541587564,-5.6739470416456905,16309,16424,Palo Alto and Nearby Counties,Clay,19,41,Iowa,IA
19059,19CS026,179,172,187,197,10,18,25,119.5481368940939,28,189.9270815668984,-1.2055820572391653,-0.7164407286838735,-0.20917297374812518,1.5034054214788735,220,211,229,217,-12,-3,6,-17.539607959599067,27,151.37923301188607,-2.2057253592400654,-1.6843924239160224,-1.1640512751557022,-12.685797150156171,17691,17836,Palo Alto and Nearby Counties,Dickinson,19,59,Iowa,IA
19063,19CS026,104,103,105,132,27,28,29,356.5137196979271,32,412.2383252818035,-0.6753125038202781,-0.5581060874924817,-0.4383915796647776,1.1159788912393387,128,127,129,131,2,3,4,32.10243800780156,14,150.16625549715755,-1.3026993718793416,-1.1748858403842775,-1.062608566549262,3.5062145062193055,9315,9323,Palo Alto and Nearby Counties,Emmet,19,63,Iowa,IA
19109,19CS026,152,146,159,175,16,23,29,183.38310566677652,44,357.796300060988,-2.227526265009695,-1.7347655750585707,-1.2361447242120973,1.8682432155706612,184,176,191,219,28,35,43,243.6583320144289,30,205.95908279555127,-0.14205680459846107,0.36950933441442324,0.8911648513430405,0.8221143804700042,14757,14566,Palo Alto and Nearby Counties,Kossuth,19,109,Iowa,IA
19147,19CS026,109,108,110,119,9,10,11,137.05332592364473,11,147.6179825542384,-0.2241540760024161,-0.10430985287532367,0.01546106473586655,0.9810254513367629,133,132,134,139,5,6,7,68.8031350688804,22,246.80278214045322,-1.898932418497409,-1.782315636442792,-1.6612761797701152,3.0842080799164515,8942,8914,Palo Alto and Nearby Counties,Palo Alto,19,147,Iowa,IA
19021,19CS027,166,157,175,175,-0,9,18,51.5075704525116,31,180.43362273851676,-1.803558729671789,-1.2780845878720526,-0.7577377594981314,3.14739030827727,205,195,216,184,-32,-21,-11,-102.6954487738566,14,67.39842095128057,-2.261822319565815,-1.6890793625786724,-1.1686311013296484,-0.6885731756849681,20617,20772,Pocahontas and Nearby Counties,Buena Vista,19,21,Iowa,IA
19025,19CS027,116,115,117,111,-6,-5,-4,-66.6802751394701,4,48.73096446700507,-1.2718352622533755,-1.15526109757907,-1.0313119183534094,-0.8941865965291237,143,142,145,145,0,2,3,16.208593596417526,10,100.8979921299566,-0.9747574117655621,-0.8465115631098735,-0.7162488677881088,3.836660014213546,9850,9911,Pocahontas and Nearby Counties,Calhoun,19,25,Iowa,IA
19091,19CS027,98,97,99,106,7,8,9,101.7835225681716,20,250.39123630672924,-1.604317844630665,-1.48311573401503,-1.3658723732172344,2.190590373455017,120,119,122,129,7,9,10,89.32447457538268,10,103.8637307852098,-0.2743562586132832,-0.14820348894284446,-0.011049303161305592,1.041649261128747,9585,9628,Pocahontas and Nearby Counties,Humboldt,19,91,Iowa,IA
19151,19CS027,84,84,85,95,10,11,11,180.6495455860052,15,256.77603423680455,-0.8832524385697899,-0.7607135837218103,-0.6387025149430083,1.2983703224123746,104,103,105,112,7,8,9,109.5027933595578,10,141.3627367825841,-0.44192727783461433,-0.31983367039944693,-0.20184811677904688,1.143350076714401,7010,7074,Pocahontas and Nearby Counties,Pocahontas,19,151,Iowa,IA
19161,19CS027,115,114,116,128,12,13,14,155.25977949780548,15,184.23746161719546,-0.40619849346888875,-0.28931718932108474,-0.16331382665414418,1.0996475933314847,141,140,142,151,9,10,11,102.7962751540176,12,122.97601967616313,-0.33102449583314575,-0.20315023904779098,-0.08193960075155855,1.0878571048810406,9770,9758,Pocahontas and Nearby Counties,Sac,19,161,Iowa,IA
19187,19CS027,374,358,390,469,79,95,111,309.5977124549122,68,221.54648132059077,0.3774364214279328,0.8758662729481156,1.3556948571475713,0.7081425930887868,461,441,480,510,30,49,69,133.18372995175437,47,126.61979040383632,-0.43190691800654624,0.0738525197477241,0.5701815896624745,0.9318653980353887,36832,37119,Pocahontas and Nearby Counties,Webster,19,187,Iowa,IA
19153,19CS028,3158,2946,3370,3754,384,596,808,145.14997136815262,437,106.38211547044266,-0.15352650434373757,0.38657218945589944,0.9132240161035281,0.7316845819848339,3925,3669,4181,4348,167,423,679,85.21502072615324,380,76.57430730478589,-0.4315151982580411,0.07987112475260222,0.5872811705576534,0.8964811080125785,492940,496250,Polk,Polk,19,153,Iowa,IA
19163,19CS029,1322,1247,1397,1594,197,272,347,186.97164151278437,178,122.55014458163126,0.12073652826287361,0.6417230157756414,1.1634983008345858,0.6530430706788527,1625,1535,1715,1826,111,201,291,115.18610459463633,133,76.34201221472195,-0.10683058143198532,0.39579049990801485,0.9031634460551192,0.659484650791272,174296,174216,Scott,Scott,19,163,Iowa,IA
19169,19CS030,481,438,523,477,-46,-4,39,-4.568850290411265,35,42.62531334679752,-0.9847132514847761,-0.4730856049586123,0.00998534747671855,-12.72023706142491,604,553,655,628,-27,24,75,24.266150245482255,26,26.17089595055714,-0.5749258888714762,-0.016357023723171465,0.5258870748244301,1.035539216647796,98533,99347,Story,Story,19,169,Iowa,IA
19003,19CS031,37,37,38,40,2,3,3,86.38692321453124,5,163.17650258362798,-0.8901361976676558,-0.770323883907741,-0.6470245095575797,1.3709750790076662,45,45,46,62,16,17,17,455.5264778095385,6,164.4286105782406,2.7856587451987926,2.9088843132284845,3.037668253721871,0.34048037243128043,3677,3649,Taylor and Nearby Counties,Adams,19,3,Iowa,IA
19137,19CS031,141,136,145,169,24,28,33,330.38736902544287,30,350.4331743405042,-0.726494743271985,-0.20673956813786212,0.2835507171174225,1.0244532896745373,172,167,178,159,-19,-13,-8,-127.85986915122376,15,145.29252227818674,-3.2209652910640387,-2.745402040008781,-2.206493634774578,-1.2294827110390028,10273,10324,Taylor and Nearby Counties,Montgomery,19,137,Iowa,IA
19145,19CS031,177,170,183,189,6,12,19,96.33581485901468,15,118.62396204033215,-0.7428638139417799,-0.21619205028648625,0.3217574154545746,1.1379443627295125,217,209,225,219,-6,2,10,15.112357581998442,18,118.46001974333662,-1.5404894645768472,-1.0161203922725581,-0.5189340276771496,5.46063035974783,15174,15195,Taylor and Nearby Counties,Page,19,145,Iowa,IA
19159,19CS031,64,64,65,93,28,29,29,736.2722450741668,8,205.4794520547945,5.190078423631832,5.311830613268106,5.421577710005531,0.2696732288510004,78,77,79,87,8,9,10,192.52774837069305,16,344.90191851692174,-1.6459874445792966,-1.521991052656888,-1.3844286934289618,1.6110579397068894,4672,4639,Taylor and Nearby Counties,Ringgold,19,159,Iowa,IA
19173,19CS031,62,62,63,79,16,17,17,342.6142014604882,5,101.5400236926722,2.289138338476704,2.4100649270228653,2.530908940942638,0.27978454323896823,75,75,76,105,29,30,30,502.8746268127222,11,187.48934719618205,3.0336675383335345,3.1549316523507462,3.2738968416884346,0.36061253094287066,5909,5867,Taylor and Nearby Counties,Taylor,19,173,Iowa,IA
19175,19CS031,129,124,135,151,16,22,27,213.93130639489252,23,227.96729164945899,-0.6705908552868086,-0.13742810212428147,0.3828562571661336,1.0184252588168576,158,152,164,172,8,14,20,117.83630188523314,13,108.06317539484621,-0.4273679292487949,0.09750898310903053,0.6339135034179764,0.8566322412491808,12107,12030,Taylor and Nearby Counties,Union,19,175,Iowa,IA
19035,19CS032,151,146,156,152,-4,1,6,11.153467451168472,25,259.51557093425606,-2.9993528459584247,-2.47348995802333,-1.9943806310715713,12.051383060856784,182,176,188,172,-16,-10,-4,-90.6568059164016,17,147.5438291963201,-2.877547187409267,-2.383112737304811,-1.8594482708009406,-1.7998031947139297,11560,11522,West Central Iowa,Cherokee,19,35,Iowa,IA
19047,19CS032,149,142,156,169,13,20,27,145.63026036732677,23,167.35386854232357,-0.7540137500327595,-0.22121231119826232,0.29937618102287133,1.0944848750998208,180,171,188,158,-30,-22,-13,-132.56224163424923,20,123.22099685786458,-3.064803760414322,-2.5526469744125335,-2.007806905771727,-0.9748404671789739,16492,16231,West Central Iowa,Crawford,19,47,Iowa,IA
19093,19CS032,88,87,88,117,29,29,30,507.0268054880246,31,533.3333333333334,-0.386938654826505,-0.26535754024003044,-0.15054950203713122,1.0173630039425006,107,106,108,96,-12,-11,-10,-159.80025874947134,6,86.16975441619991,-2.5811145243277527,-2.4590832837792056,-2.336907547538336,-0.5924818779631827,6975,6963,West Central Iowa,Ida,19,93,Iowa,IA
19133,19CS032,118,117,119,154,35,36,37,490.86590375691344,17,234.26734037666512,2.4490687799620363,2.5653471797084135,2.692652521604538,0.464220829274888,143,142,144,157,13,14,15,160.32376761563597,22,255.87345894394045,-1.0889041158000503,-0.9564540694980956,-0.8265937465627654,1.488031068809452,8708,8598,West Central Iowa,Monona,19,133,Iowa,IA
19149,19CS032,210,199,221,262,41,52,63,242.23897840561176,64,299.90627928772255,-1.1150703978698986,-0.566237633140456,-0.05732610742889679,1.2145641885599323,258,244,271,250,-21,-8,6,-29.585364410036284,19,74.05963749756383,-1.6166631402915275,-1.0374788300731548,-0.49343225975167093,-2.883101505631603,25608,25655,West Central Iowa,Plymouth,19,149,Iowa,IA
19193,19CS032,851,806,896,1064,168,213,258,242.52751016760863,175,199.21641543263163,-0.1291486417413109,0.42797597353307715,0.978359736503411,0.8175802353406435,1043,988,1097,1084,-13,41,96,39.21367539141678,91,86.14242845918648,-0.9585475262654624,-0.4769473250137691,0.046421872957556155,2.1449650063631087,105413,105639,West Central Iowa,Woodbury,19,193,Iowa,IA
20001,20CS001,143,137,148,129,-19,-14,-8,-132.41919376134823,4,38.36930455635492,-2.2253467205300392,-1.7112827411814704,-1.1848468186154504,-0.31238527285703876,173,166,179,199,20,26,33,210.9984781937402,27,216.43286573146295,-0.5960772709151153,-0.049223147640632535,0.4713581739682036,0.9882124498355571,12510,12475,Allen+Anderson+Franklin+Osage,Allen,20,1,Kansas,KS
20003,20CS001,88,87,89,90,1,2,3,33.594562741453004,5,76.43312101910827,-0.5381684829674624,-0.4302612467517306,-0.300369736260757,1.563651085328178,106,106,107,103,-4,-3,-3,-44.93501887799791,21,269.6456086286595,-3.268996145173899,-3.1502582224848297,-3.0156302470056295,-8.40154833741198,7850,7788,Allen+Anderson+Franklin+Osage,Anderson,20,3,Kansas,KS
20059,20CS001,232,220,243,269,26,37,49,172.81612318814015,21,97.05746418117393,0.23232875572240763,0.7529187460402376,1.289844741829687,0.5469939637731599,282,268,295,338,43,56,70,215.84573738319193,40,153.8935056940597,0.11172714432696379,0.615474223885473,1.1684083028749706,0.7004932025106696,25964,25992,Allen+Anderson+Franklin+Osage,Franklin,20,59,Kansas,KS
20139,20CS001,164,157,170,230,60,66,73,505.6132213395076,23,175.1824817518248,2.782974342836744,3.3132611028561754,3.8174277068069005,0.34133338389615075,199,191,207,232,25,33,41,209.8838364780383,23,145.92056845577972,0.12378039407817892,0.625346612639605,1.153861246633234,0.6748451976613137,15755,15762,Allen+Anderson+Franklin+Osage,Osage,20,139,Kansas,KS
20011,20CS002,163,157,169,181,12,18,24,150.96951560696456,17,142.10086375034828,-0.43821272619379087,0.10496632811893516,0.6271077539194194,0.8918740960051428,197,190,204,213,9,16,23,112.32468697553377,34,237.36386484222285,-1.7272594545190632,-1.251144451170811,-0.73801526888222,1.989538752174609,14356,14324,Bourbon+Linn+Miami,Bourbon,20,11,Kansas,KS
20107,20CS002,93,92,94,122,28,29,30,356.1521594327897,5,62.383031815346214,2.8184139746751105,2.941872732307683,3.058712191194863,0.16922996142382715,115,114,117,166,49,51,52,519.5765332664832,24,246.8373958654736,2.604648046852376,2.728102432053927,2.858198332544548,0.4658527387172397,9618,9723,Bourbon+Linn+Miami,Linn,20,107,Kansas,KS
20121,20CS002,254,240,269,292,23,38,52,131.507263450047,23,80.6192493062655,0.03690582615305192,0.5269164869165193,1.006096787753573,0.5971245642872263,312,294,330,419,89,107,125,309.85643465410544,61,176.64263168563403,0.8036696486506657,1.3310280459964414,1.849974941165078,0.5648005767199342,34235,34533,Bourbon+Linn+Miami,Miami,20,121,Kansas,KS
20005,20CS003,155,148,162,146,-16,-9,-2,-68.24681686864993,3,22.12117488017697,-1.4329919888978697,-0.9034280285808248,-0.403783264087963,-0.3633982468542072,189,181,198,218,20,29,37,175.70915818427915,26,160.0098467598006,-0.3540882167600615,0.15245032571327416,0.6511932760154735,0.879835424084864,16274,16249,Brown and Nearby Counties,Atchison,20,5,Kansas,KS
20013,20CS003,111,110,111,147,36,36,37,461.8201950359964,31,392.3636747178567,0.5789252256201618,0.6943940447888655,0.8213594380242153,0.8269391395965993,136,134,137,157,20,21,23,225.65322805168947,11,116.30365827870585,0.9613877533670623,1.0943449890517958,1.2173179175219704,0.49234003258053594,9481,9458,Brown and Nearby Counties,Brown,20,13,Kansas,KS
20043,20CS003,76,75,77,92,15,16,17,260.4501428564955,10,160.29922522041144,0.8824053042032425,0.99882396660371775,1.1217223022955178,0.5797858337487777,93,92,94,111,17,18,19,238.35894697091868,17,227.54651318431266,-0.016758378815588552,0.10833289563648356,0.22813221718442853,0.9038804526070239,7486,7471,Brown and Nearby Counties,Doniphan,20,43,Kansas,KS
20085,20CS003,123,121,124,125,1,2,4,22.300405785307106,12,108.89292196007258,-0.9846962667445529,-0.8662774095264215,-0.743061571522558,3.470711099574442,152,150,153,157,4,5,7,40.55642441528107,14,105.61255280627641,-0.7760716988173018,-0.6515448764364639,-0.5255646310552726,2.195679034604354,13224,13256,Brown and Nearby Counties,Jackson,20,85,Kansas,KS
20087,20CS003,158,151,166,180,14,22,29,139.94230573907515,23,149.6908558411975,-0.6458608144892487,-0.10189919508306837,0.44101839497821826,1.0221252213208498,194,185,204,204,0,10,19,53.01228264756081,27,146.77901603696657,-1.4711314866495144,-0.9322666911023831,-0.40829610949148404,2.5112519449908146,18438,18395,Brown and Nearby Counties,Jefferson,20,87,Kansas,KS
20117,20CS003,118,117,119,123,4,5,6,65.23949507347238,24,289.0695573622403,-2.3540457505214967,-2.2431204995851677,-2.1168634603624077,3.7403516002978785,145,144,146,132,-14,-13,-12,-129.98098520167343,14,140.22435897435898,-2.836029222043246,-2.6996862177686767,-2.575628297059724,-1.16887764133717,9963,9984,Brown and Nearby Counties,Marshall,20,117,Kansas,KS
20131,20CS003,114,112,115,158,43,44,46,522.8311707644052,42,493.5853491332876,0.16563268922292945,0.2929117764422914,0.41009101736714376,0.9233087505706131,140,139,141,123,-18,-17,-16,-164.81929731595434,7,68.51996867658575,-2.4640932433164573,-2.3337661804886034,-2.2035919852787322,-0.441976687567175,10211,10216,Brown and Nearby Counties,Nemaha,20,131,Kansas,KS
20015,20CS004,562,533,591,638,47,76,105,134.76978078994958,38,67.6728551711856,0.1669863077975243,0.6544780816354782,1.2324168775841664,0.49558795546583007,695,660,730,790,60,95,130,139.82954535582658,101,148.92801321183165,-0.6628944755881638,-0.08966694170914714,0.4162598870753667,1.0539540901024969,67383,67818,Butler+Harvey,Butler,20,15,Kansas,KS
20079,20CS004,344,330,359,380,21,36,50,126.2519059021649,40,141.16816657843654,-0.6995731964473383,-0.15023684256908465,0.35030582651904346,1.0877404770691588,420,402,437,512,75,92,110,272.8799791996562,61,180.28668538495643,0.44136263915992907,0.9379698476740933,1.4595991721433001,0.6536021878219295,34002,33835,Butler+Harvey,Harvey,20,79,Kansas,KS
20009,20CS005,241,230,252,306,54,65,76,307.18938605428855,36,169.58467457014996,0.871107440213624,1.3688393754429857,1.882935180365743,0.5437147666458105,291,278,304,368,64,77,90,304.2293683822774,50,198.05117642398795,0.539633223428809,1.0473487753873008,1.593033763195851,0.6426260572112116,25474,25246,Central Kansas,Barton,20,9,Kansas,KS
20051,20CS005,207,194,219,259,40,52,65,217.43966974064705,57,236.8749134229118,-0.7468886449512074,-0.1751893244497842,0.32964604542246867,1.0689524489993651,252,238,267,235,-32,-17,-3,-60.342406829844414,18,62.47613758633855,-1.7376648932650063,-1.2278703031039142,-0.6712581986138242,-1.098548944098246,28876,28811,Central Kansas,Ellis,20,51,Kansas,KS
20053,20CS005,72,71,73,92,19,20,21,378.0261523603253,17,323.09154260373776,0.42648774104721116,0.5495418948817198,0.6693277082803518,0.8137679562347273,89,88,89,83,-6,-6,-5,-87.09482131686472,8,126.20287111531788,-2.2579749417539716,-2.131357830853081,-2.0103345975857474,-1.769543218917252,6314,6339,Central Kansas,Ellsworth,20,53,Kansas,KS
20113,20CS005,324,311,337,356,19,32,45,128.64538197170936,48,192.455477964516,-1.1522691314029303,-0.630389501207195,-0.1419064117559398,1.4507984243208283,396,380,411,422,11,26,42,87.65464060543175,46,152.58060236168237,-1.1886445590616177,-0.6467894704837822,-0.14758507253922512,1.6772331718582671,29929,30148,Central Kansas,McPherson,20,113,Kansas,KS
20159,20CS005,100,99,101,107,6,7,8,88.12936918472509,10,127.71392081736909,-0.5146990338319377,-0.3991671663481283,-0.27668207089393515,1.26573793115493,122,121,124,145,21,23,24,241.30835838985968,15,159.77844056242012,0.6862474165430349,0.8141303011482982,0.9433305859814315,0.6341414479262153,9396,9388,Central Kansas,Rice,20,159,Kansas,KS
20167,20CS005,75,74,76,120,44,45,46,807.6547737156156,19,340.09546539379477,4.553609260209923,4.673123727528895,4.783833729024388,0.41196002317680774,92,91,92,85,-7,-7,-6,-97.08335852398253,13,194.08778739922366,-3.04625479890504,-2.9086331392664913,-2.783300631435968,-2.3625009225248754,6704,6698,Central Kansas,Russell,20,167,Kansas,KS
20017,20CS006,28,28,28,21,-7,-7,-7,-336.3341088239271,1,46.67444574095683,-3.950728184592178,-3.8327281006634477,-3.700816035147052,-0.16113546927515193,35,35,35,32,-3,-3,-3,-109.46425385984939,5,192.82684149633627,-3.147020363839444,-3.024742362151331,-2.89662497526529,-2.719744322801356,2571,2593,Chase+Coffey+Lyon+Marion,Chase,20,17,Kansas,KS
20031,20CS006,86,85,87,89,2,3,4,40.97889078441963,8,115.20460818432737,-0.8725346149317929,-0.7419332507688113,-0.6301600583909379,2.080276586715121,106,105,107,111,4,5,6,64.09763808123489,15,179.79144192736425,-1.2829273148372673,-1.1527960711370124,-1.0284501925856036,2.3630733138277193,8333,8343,Chase+Coffey+Lyon+Marion,Coffey,20,31,Kansas,KS
20111,20CS006,240,226,253,323,70,83,97,310.27921718371243,68,252.9997209561901,0.04440036537470942,0.5625038877420266,1.0477404038735325,0.8057321052316374,294,277,310,320,10,26,43,82.75973778375696,30,93.71192952862899,-0.648216907720177,-0.11186372989505669,0.4248431571419823,1.0911521259315646,32253,32013,Chase+Coffey+Lyon+Marion,Lyon,20,111,Kansas,KS
20115,20CS006,148,143,153,133,-20,-15,-10,-150.25246964522034,10,102.03214012413909,-3.003003558256515,-2.5250632057416316,-1.971897293842681,-0.7285446799635694,179,173,186,222,36,43,49,363.03669895779194,29,247.4825055470217,0.6686447705952437,1.1671324911742231,1.6614420571195447,0.6660444068879747,11761,11718,Chase+Coffey+Lyon+Marion,Marion,20,115,Kansas,KS
20021,20CS007,228,220,236,271,35,43,51,266.4316157163205,26,161.17367496642214,0.5289070103609858,1.058829403953434,1.5556953437533116,0.5911796880678921,278,268,288,312,24,34,44,179.1260334590154,43,224.53135606495746,-0.9748189902061819,-0.4475243911625409,0.01596022203752145,1.2179775755796873,19358,19151,Cherokee+Crawford,Cherokee,20,21,Kansas,KS
20037,20CS007,379,362,396,484,88,105,122,323.65044592190594,53,163.4121274409044,1.0998957927850719,1.5954229561824478,2.1320912837898027,0.5001385857567033,470,449,490,518,28,48,69,123.99267441638719,63,161.19128031931226,-0.9221684180854249,-0.3625581607264598,0.1480080925851509,1.2737231732314687,38920,39084,Cherokee+Crawford,Crawford,20,37,Kansas,KS
20027,20CS008,84,83,85,90,5,6,7,91.86981689652897,17,252.06968985543062,-1.7224715358943699,-1.6033875364188757,-1.4774921462682022,2.3624716428252217,102,101,103,113,10,11,12,136.55837056918344,10,123.73174956693887,0.0011377820784056333,0.13246306687397097,0.25480483738123094,0.8307961159608063,8093,8082,Cloud and Nearby Counties,Clay,20,27,Kansas,KS
20029,20CS008,117,116,118,128,10,11,12,145.25267694585128,21,281.5327896324433,-1.4794166611240167,-1.3633922677704253,-1.2453482032411045,1.7744520586169164,142,141,144,157,13,15,16,162.58510357723472,17,190.22043191227482,-0.39923512093664043,-0.27293346805544627,-0.15682830260642294,1.0946392440048358,8951,8937,Cloud and Nearby Counties,Cloud,20,29,Kansas,KS
20089,20CS008,32,32,32,31,-1,-1,-1,-36.27361365179045,1,41.138155639355496,-0.907019451717628,-0.7770112953345931,-0.6588918199578236,8.456737704086962,39,39,39,59,20,20,20,678.6229413237218,11,374.78705281090294,2.9174954275225162,3.0365101056377592,3.172766242881948,0.5258733682372274,2917,2935,Cloud and Nearby Counties,Jewell,20,89,Kansas,KS
20105,20CS008,30,29,30,39,9,9,10,381.59001291170404,5,203.73514431239386,1.661018802770954,1.780947757029323,1.8968245850936953,0.4823994207482468,36,35,36,40,4,4,5,148.72775916749262,4,137.50429700928154,-0.01586159110167181,0.1132893082520327,0.23804202025009602,0.7509635076509692,2945,2909,Cloud and Nearby Counties,Lincoln,20,105,Kansas,KS
20123,20CS008,68,67,68,76,8,8,9,170.62817906277746,4,82.87292817679557,0.748594628685074,0.8764833282677847,1.0036578417940092,0.4331041679713745,82,81,83,97,14,15,16,261.67729819406395,12,208.69565217391303,0.40749319876688966,0.5312041473867843,0.6514010808724426,0.7478292085638206,5792,5750,Cloud and Nearby Counties,Mitchell,20,123,Kansas,KS
20141,20CS008,49,49,50,48,-2,-1,-1,-49.48105041396663,4,137.69363166953528,-1.9885989074719002,-1.8736873288864557,-1.7461426457275158,-9.144434907442092,60,60,61,59,-2,-1,-1,-40.00138105703598,7,200.17157563625966,-2.5340170083961095,-2.3972116891082047,-2.2672437717350826,-17.55053256550058,3486,3497,Cloud and Nearby Counties,Osborne,20,141,Kansas,KS
20143,20CS008,61,60,61,64,3,3,4,66.81669743970522,11,229.9251001567671,-1.74942580054655,-1.6338694018920912,-1.5020822675371932,2.6211556730892807,75,74,76,75,-1,-0,1,-2.2738832825421107,10,171.7327837884252,-1.8598197214680285,-1.7371724619906013,-1.613247258651381,11.526158121081524,5741,5823,Cloud and Nearby Counties,Ottawa,20,143,Kansas,KS
20157,20CS008,69,69,70,65,-5,-4,-4,-114.53802791898474,10,257.4554816562969,-3.846079774309359,-3.722627762559385,-3.5977831516301806,-2.8995189949807534,85,84,85,86,1,1,2,29.239523464260248,7,150.05359056806003,-1.3295248662259576,-1.2061325301714139,-1.0872060940442636,2.961053137448572,4661,4665,Cloud and Nearby Counties,Republic,20,157,Kansas,KS
20183,20CS008,47,47,47,43,-4,-4,-4,-132.08460056608504,5,168.39741790625877,-3.121829255778905,-3.0041662716528976,-2.8847957493403285,-1.7112668839386986,57,57,58,55,-3,-2,-2,-65.03320727699256,2,55.959709009513155,-1.3305696155128879,-1.21214478871362,-1.0916825266887689,-1.5102468419927622,3563,3574,Cloud and Nearby Counties,Smith,20,183,Kansas,KS
20201,20CS008,60,60,61,66,5,6,6,129.35850463319727,10,217.6673317612915,-1.007351334177941,-0.8834284300874597,-0.7615227583447772,1.440310929640493,73,72,74,83,9,10,11,178.38310596945848,10,181.3894431344096,-0.14718558258020792,-0.02903385263706333,0.08716149792910041,0.9229979174005868,5513,5513,Cloud and Nearby Counties,Washington,20,201,Kansas,KS
20041,20CS009,198,190,206,203,-3,5,13,33.52230136015707,23,150.26132404181183,-1.6985836794053562,-1.1749218731021958,-0.6542009615297812,3.7513372733300736,242,233,252,285,33,43,52,232.20002459182626,47,254.82541747993926,-0.7459486890518713,-0.22439429099689095,0.29212551156335226,1.0723989653106367,18368,18444,Dickinson+Geary+Morris,Dickinson,20,41,Kansas,KS
20061,20CS009,195,179,211,214,3,19,35,63.65664855948605,26,86.74136061608607,-0.791391471114356,-0.22755298397692153,0.2684175346438075,1.2947852566751867,240,222,259,273,14,33,51,91.00017922427494,40,110.94777133664327,-0.7141757046532148,-0.19400423065264857,0.3057145177891522,1.1831416063616451,35969,36053,Dickinson+Geary+Morris,Geary,20,61,Kansas,KS
20127,20CS009,64,63,64,77,13,13,14,292.7697340018679,14,311.2263801407929,-0.31343791059337106,-0.1873907131049556,-0.06490748980961691,0.9880196593256104,77,77,78,75,-3,-2,-2,-44.83345369989366,2,37.334328915437744,-0.9463966593839389,-0.8214850741817281,-0.6907907658284286,-1.4268102201997497,5398,5357,Dickinson+Geary+Morris,Morris,20,127,Kansas,KS
20045,20CS010,622,571,673,729,56,107,158,107.57089152750744,53,53.27748691099477,0.013165788611343399,0.5351897474084797,1.0284656411202127,0.49069245993090355,773,711,834,849,15,76,138,63.99791160704544,40,33.53369717394767,-0.2120491913602109,0.32085197741325294,0.8428230897461683,0.5172059625024668,119375,119283,Douglas,Douglas,20,45,Kansas,KS
20019,20CS011,45,43,46,41,-5,-4,-2,-132.1392126241359,5,178.57142857142856,-3.657665840558108,-3.1021456313651345,-2.5751348473725284,-1.8519218452545885,55,53,57,65,8,10,12,299.84985122184446,10,294.6375957572186,-0.4520689806252329,0.049044667692631834,0.5699170528070389,0.8947021504626981,3360,3394,Elk and Nearby Counties,Chautauqua,20,19,Kansas,KS
20035,20CS011,370,355,384,429,45,59,74,206.60566983012984,63,218.87666473653735,-0.6172968624610754,-0.12643362317461165,0.3643377844573214,1.041873411134453,452,434,469,504,35,52,70,151.9807729630267,64,185.5287569573284,-0.8531789463915133,-0.3457850989944474,0.11541786459338918,1.1978897500698562,34540,34496,Elk and Nearby Counties,Cowley,20,35,Kansas,KS
20049,20CS011,33,32,34,36,2,3,4,155.49624544784444,2,96.93053311793214,0.10091062093372664,0.5784911629462771,1.0979087095083333,0.475239333951866,40,38,41,50,9,10,12,428.62920387803274,5,204.4153720359771,1.7638506186892933,2.241856281510474,2.7051303338637407,0.43537811786850655,2476,2446,Elk and Nearby Counties,Elk,20,49,Kansas,KS
20073,20CS011,82,81,82,87,5,5,6,107.80952949956159,5,100.45203415369161,-0.0483654688669408,0.07482927188594905,0.1903862421671859,0.7853954977293777,99,98,100,124,24,25,26,420.84545666023905,13,218.70794078061908,1.8949848363195483,2.0223538604418283,2.146207896213021,0.49971066860139746,5973,5944,Elk and Nearby Counties,Greenwood,20,73,Kansas,KS
20205,20CS011,92,92,93,112,19,20,20,273.11049499138346,6,84.03361344537815,1.7698589252376369,1.8868901759840282,2.0147776386741247,0.29268165127430695,112,111,113,155,42,43,44,500.422116000518,26,304.6994023204031,1.8386998277980153,1.96085112675009,2.0906820960959456,0.594951799769354,8568,8533,Elk and Nearby Counties,Wilson,20,205,Kansas,KS
20207,20CS011,41,40,42,51,9,10,11,381.8569733554546,2,77.36943907156673,2.538560810772673,3.0382232864381353,3.5684503949805317,0.1839756684756969,50,49,52,55,3,5,6,157.51089029233427,1,32.23726627981947,0.722141857651901,1.2617657599156076,1.7609779609509253,0.16989501696455697,3102,3102,Elk and Nearby Counties,Woodson,20,207,Kansas,KS
20091,20CS012,3547,3285,3810,3992,182,445,707,87.53207378481143,479,94.27448176097123,-0.57806378718349,-0.06379106717364971,0.45455475131303025,1.0746116000071213,4416,4100,4733,4825,92,409,725,66.71078789061143,420,68.5347275255047,-0.5788967866266382,-0.02184090687050562,0.47989587532880024,1.0248342040436225,609709,612828,Johnson,Johnson,20,91,Kansas,KS
20099,20CS013,227,219,236,241,5,14,22,82.00558996575225,28,167.68977391825123,-1.428182249465169,-0.8449248082023796,-0.34744653393923713,1.9056844914101823,276,266,287,303,16,27,37,133.60872661079637,39,195.56714471968712,-1.14054263505403,-0.6092896197314948,-0.11445092046217467,1.4107815119097444,20037,19942,Labette+Montgomery+Neosho,Labette,20,99,Kansas,KS
20125,20CS013,365,351,378,412,34,47,61,180.78405550297,41,156.67791860391057,-0.26195410769407,0.243550796579602,0.7181945406403407,0.8487176472748699,443,427,459,544,85,101,117,323.5539153083206,79,253.3187968960431,0.1731781507870236,0.7026078840797626,1.240319632748175,0.7752430620382884,31402,31186,Labette+Montgomery+Neosho,Montgomery,20,125,Kansas,KS
20133,20CS013,174,167,181,192,11,18,25,138.3531530509217,17,128.34224598930481,-0.40928340763200977,0.09735641595666142,0.6309377810954229,0.8796427255114597,211,203,219,241,22,30,38,187.8885072566421,39,246.80420199974688,-1.1022798129256923,-0.6056557569313594,-0.06326127630509794,1.270766362236503,15895,15802,Labette+Montgomery+Neosho,Neosho,20,133,Kansas,KS
20103,20CS014,549,514,584,669,85,120,155,175.81986939774737,62,90.83250924806798,0.29298683427275274,0.8470210132080089,1.3400771671585143,0.5123533035887544,679,636,721,793,72,114,157,139.19125907008444,88,107.13676982638974,-0.17763709802993455,0.3106936277369999,0.8815623754872962,0.7630350025476055,81909,82138,Leavenworth,Leavenworth,20,103,Kansas,KS
20023,20CS015,31,31,31,48,17,17,17,784.068609446881,12,549.1990846681922,2.2196257851486796,2.3494743118069064,2.47228553101383,0.6618170508756417,38,38,38,41,3,3,3,117.47806106356416,6,228.05017103762827,-1.2265792000094877,-1.1067245068016358,-0.9839895540162736,1.4666886457324277,2622,2631,Northwest Kansas,Cheyenne,20,23,Kansas,KS
20039,20CS015,39,38,39,35,-4,-4,-3,-160.3187076869539,5,217.47009786154405,-3.9058350362795533,-3.7805943372788997,-3.653224400359014,-1.8615080542576004,47,47,48,58,10,11,11,394.16693884968475,10,363.50418029807344,0.1795708700461123,0.3071633800214614,0.4472196495404073,0.8443426832610221,2759,2751,Northwest Kansas,Decatur,20,39,Kansas,KS
20063,20CS015,29,29,29,47,18,18,18,804.9113136354467,20,890.2077151335311,-0.979208847392889,-0.8509966451968456,-0.7279358606131373,1.048016215939145,36,36,36,44,8,8,8,288.927744430485,4,145.66642388929353,1.3021150733796059,1.4313893908482187,1.551005017427706,0.4477299934944133,2696,2746,Northwest Kansas,Gove,20,63,Kansas,KS
20065,20CS015,30,30,30,28,-2,-2,-2,-90.68490244126762,5,248.96265560165975,-3.518450341041153,-3.3973393829822687,-3.274838580084983,-6.0882420744868435,36,36,37,40,3,4,4,152.07114414797235,2,83.29862557267805,0.5606511799828905,0.6867703667143101,0.8205287145582919,0.42999395567667775,2410,2401,Northwest Kansas,Graham,20,65,Kansas,KS
20109,20CS015,28,28,28,39,11,11,11,481.60221874080094,4,174.79970866715223,2.9525327631754723,3.068681313147507,3.18606786995885,0.33276031714118093,34,34,34,50,16,16,16,586.5085014069258,3,110.09174311926607,4.641798823427031,4.764804919265704,4.8902864701781255,0.1766539273360309,2746,2725,Northwest Kansas,Logan,20,109,Kansas,KS
20137,20CS015,57,57,58,76,18,19,19,418.22349704209444,22,487.4446085672082,-0.8201366194136758,-0.6972548468536628,-0.5673029238442946,1.1068725439628835,69,68,70,56,-14,-13,-12,-246.030227738116,2,37.34129947722181,-2.9614957415034895,-2.829376992726493,-2.7076114621626677,-0.16423895490034335,5416,5356,Northwest Kansas,Norton,20,137,Kansas,KS
20147,20CS015,58,58,59,65,6,7,7,160.60802259158618,15,361.30068245684464,-2.138624379680998,-2.0098801064301735,-1.8964777018895755,1.9562045606518215,69,69,70,77,7,8,8,159.44658703387515,16,330.9203722854188,-1.8385463118146894,-1.7134136330093555,-1.5926730636661461,1.8371287779700443,4982,4835,Northwest Kansas,Phillips,20,147,Kansas,KS
20153,20CS015,35,35,36,32,-4,-3,-3,-163.34605629647936,4,188.6051080550098,-3.6466545136483823,-3.520650657926007,-3.404813075007492,-1.6231805698954256,43,43,44,37,-7,-6,-6,-252.4760829817954,3,117.6470588235294,-3.83048539816227,-3.69659061298969,-3.5750006373618666,-0.5516591952373042,2545,2550,Northwest Kansas,Rawlins,20,153,Kansas,KS
20163,20CS015,55,55,56,59,3,4,4,89.86260825616942,10,245.1982018798529,-1.665560007419883,-1.5513660516148895,-1.4290342589676233,2.1436701879394593,67,66,68,73,5,6,7,124.0368604936014,3,61.98347107438017,0.5006922844384658,0.6217989255708374,0.7404968242578517,0.4283643420788436,4894,4840,Northwest Kansas,Rooks,20,163,Kansas,KS
20179,20CS015,25,24,25,44,19,19,20,950.0113226111366,10,488.40048840048837,4.494237630808654,4.61519594764162,4.735958879840163,0.48896212425569746,30,30,31,40,9,10,10,393.34893416933716,2,80.87343307723413,3.008146441214258,3.1254968467215587,3.2446655914508082,0.18643639536080941,2457,2473,Northwest Kansas,Sheridan,20,179,Kansas,KS
20181,20CS015,59,58,59,51,-8,-8,-7,-158.71845502065332,11,224.07061619419449,-3.9603121349787527,-3.8224927765250403,-3.7134247881047346,-1.6196111975920797,72,71,73,62,-11,-10,-9,-170.70978668300526,4,67.87714237230612,-2.5086446920970658,-2.3880849758119846,-2.263763963746358,-0.4415046255937606,5891,5893,Northwest Kansas,Sherman,20,181,Kansas,KS
20193,20CS015,70,70,71,69,-2,-1,-1,-21.942870858083378,10,152.26494099733537,-1.8640733808195054,-1.7416544673992742,-1.6283944936414134,-22.670696787228117,86,85,87,72,-15,-14,-13,-182.5858430457912,14,177.59736141063047,-3.7290039564083264,-3.601264491756801,-3.476946775094417,-1.0453032949281122,7881,7883,Northwest Kansas,Thomas,20,193,Kansas,KS
20195,20CS015,37,37,37,45,8,8,8,348.07166704651615,2,85.65310492505353,2.5044911891331343,2.626447373924575,2.7600028370521943,0.2191186878073566,45,45,45,45,-0,0,0,0.5965589125402828,4,143.11270125223612,-1.5493573403566467,-1.4221567756309357,-1.3055944936287778,3.9343985406089432,2802,2795,Northwest Kansas,Trego,20,195,Kansas,KS
20199,20CS015,14,14,14,15,1,1,1,75.46012435678648,5,396.3011889035667,-3.328165502717672,-3.208377939879214,-3.089471150613953,2.561402929960662,17,17,17,19,2,2,2,121.75670764747424,3,198.80715705765405,-0.9002744213551209,-0.7678741182226589,-0.646437368193129,1.0573399998895205,1514,1509,Northwest Kansas,Wallace,20,199,Kansas,KS
20025,20CS016,27,27,27,33,6,6,6,365.30713723325374,7,424.6713852376137,-0.7212283352112413,-0.5967422738682662,-0.46851986901672915,0.996940913572932,33,33,34,31,-3,-2,-2,-117.8342096894805,3,151.82186234817814,-2.8316403786334226,-2.692002101927808,-2.570699330844023,-2.2583491447961292,1978,1976,Pawnee and Nearby Counties,Clark,20,25,Kansas,KS
20033,20CS016,25,25,25,29,4,4,4,283.91390111806,2,142.602495543672,1.2862132599543679,1.4119954521355993,1.5411661722251184,0.4014538681397107,31,30,31,32,1,1,2,78.92905028264619,4,239.23444976076553,-1.740512364937418,-1.6059625725401478,-1.4720731748775486,1.7243655764815276,1683,1672,Pawnee and Nearby Counties,Comanche,20,33,Kansas,KS
20047,20CS016,38,37,38,69,31,31,32,1307.6831356040423,11,459.2901878914405,8.358960896467092,8.483847141241064,8.60615965767226,0.34035694863129956,46,46,46,59,13,13,13,454.17508291063103,2,70.37297677691767,3.7232723913908345,3.834710267728555,3.9642966647370486,0.14380568664208992,2874,2842,Pawnee and Nearby Counties,Edwards,20,47,Kansas,KS
20057,20CS016,220,205,235,253,18,33,48,116.55012270053817,41,144.38314356145088,-0.8000846121406925,-0.26959844666452737,0.2258931617840428,1.2024747572380472,274,257,292,276,-16,2,19,4.997525186416315,56,163.90563718316454,-2.1067225265275193,-1.5797053541354777,-1.1172787832148268,20.68363509961591,34076,34166,Pawnee and Nearby Counties,Ford,20,57,Kansas,KS
20083,20CS016,22,22,22,20,-2,-2,-2,-128.59086492979478,2,139.21113689095128,-2.797383706140193,-2.677941944796626,-2.554330592823209,-2.360098960051165,27,27,27,41,14,14,14,826.9586204740966,5,292.22676797194623,5.217783913284711,5.3501595308062075,5.471023645497432,0.33004908101908126,1724,1711,Pawnee and Nearby Counties,Hodgman,20,83,Kansas,KS
20097,20CS016,25,25,25,29,4,4,4,204.8713887284917,3,147.05882352941177,0.45773540505865756,0.5801187004096484,0.708830977660742,0.5792203170462675,30,30,31,37,6,7,7,280.5789385919187,4,166.5972511453561,1.013323957517642,1.1373544163466291,1.2622491535414746,0.5170162778489299,2448,2401,Pawnee and Nearby Counties,Kiowa,20,97,Kansas,KS
20135,20CS016,38,38,39,55,16,17,17,747.3278372066765,14,623.839584106944,1.1217192834357923,1.2347073716845494,1.3478033816735318,0.7877878383762345,47,47,47,53,6,6,6,228.41885112349783,3,112.23344556677891,1.032619151944367,1.1609732116816331,1.2843469005999444,0.42220007416898064,2693,2673,Pawnee and Nearby Counties,Ness,20,135,Kansas,KS
20145,20CS016,72,72,73,82,9,10,10,185.33876492265136,3,57.4896199297349,1.1559763049475509,1.280045639884476,1.4078918280533639,0.2811201255886676,89,88,90,86,-4,-3,-2,-51.404692539156315,13,208.73474630700068,-2.727253731393746,-2.5995624495415472,-2.4828322075436953,-5.9051069713967275,6262,6228,Pawnee and Nearby Counties,Pawnee,20,145,Kansas,KS
20165,20CS016,50,50,50,58,8,8,8,321.92835481323993,13,528.4552845528455,-2.1832630347254147,-2.0633848155638406,-1.9546197765051134,1.4574910086649462,62,61,62,60,-2,-2,-1,-58.10327956514163,1,33.87533875338753,-1.043793930048013,-0.9213196176916914,-0.7862319911414778,-1.398193062158755,2952,2952,Pawnee and Nearby Counties,Rush,20,165,Kansas,KS
20149,20CS017,167,156,178,180,2,13,24,63.57404567564466,16,75.89232775999051,-0.6715070731926162,-0.11845912216437196,0.36600390405698136,1.1108798182518507,208,195,221,225,4,17,30,66.65567532934176,34,132.1311985076947,-1.1727796377751887,-0.6692448794505036,-0.16315836453789404,1.8730885156750554,25299,25732,Pottawatomie+Riley+Wabaunsee,Pottawatomie,20,149,Kansas,KS
20161,20CS017,308,277,339,348,9,40,71,66.69477961904798,22,36.600582281990846,-0.22395016202494517,0.301662846425235,0.8396640616178587,0.5354215363923258,384,347,421,431,10,47,84,64.98703279212027,32,44.33545312218574,-0.3259329735723327,0.2264361153454674,0.7714263621450254,0.6679790972684768,72130,72177,Pottawatomie+Riley+Wabaunsee,Riley,20,161,Kansas,KS
20197,20CS017,54,54,55,57,2,3,3,44.497350346578386,6,104.43864229765012,-0.7246876353817636,-0.5997917977799444,-0.47621092050513286,1.687112227972922,67,66,68,92,24,25,26,354.7585610860051,10,143.80212827149842,1.9859178196083098,2.1102360416584376,2.2367100400345916,0.3895611581170009,6894,6954,Pottawatomie+Riley+Wabaunsee,Wabaunsee,20,197,Kansas,KS
20155,20CS018,612,585,638,746,108,134,161,261.04527762782993,94,182.55381129632624,0.2648628220329681,0.7745847499070849,1.2991418077515315,0.694154371377801,744,712,776,825,49,81,113,131.545205977591,75,122.00875209448358,-0.41500392850784545,0.08683521025081949,0.6113109567742642,0.9161742848493254,61790,61471,Reno,Reno,20,155,Kansas,KS
20169,20CS019,479,455,502,545,43,66,90,147.19355439791667,77,170.53319306793642,-0.7439236915897635,-0.23851151116541594,0.23555721892043513,1.1413905783698086,586,558,614,736,122,150,178,278.3685500290504,130,241.01746449627348,-0.1659354517230827,0.3649095578443403,0.8790599690963885,0.8600930983121651,54183,53938,Saline,Saline,20,169,Kansas,KS
20055,20CS020,204,187,220,275,55,71,88,225.7684654646533,59,186.35011712683917,-0.12868932442366496,0.3878352865916174,0.9154143218873771,0.8140156657732879,253,234,273,325,52,72,91,187.6210506818828,45,118.00183558410909,0.14658256469126582,0.6999891392172267,1.1637928614644386,0.6202679783709814,37993,38135,Scott and Nearby Counties,Finney,20,55,Kansas,KS
20071,20CS020,21,21,21,24,3,3,3,317.7923405427328,3,283.46456692913387,0.22825912032059895,0.3416372595419388,0.4675241796758282,0.6875526410615862,26,26,26,27,1,1,1,94.21683043370658,3,230.7692307692308,-1.4909951367304175,-1.3670580470378253,-1.2275721934633026,1.348424422645825,1270,1300,Scott and Nearby Counties,Greeley,20,71,Kansas,KS
20075,20CS020,20,20,21,20,-1,-0,-0,-16.13487724921169,3,144.23076923076923,-1.7208549904305435,-1.6039550245043668,-1.4788911566278997,4.515389214852404,25,24,25,27,2,2,3,88.91613689304974,7,281.69014084507046,-2.058134571647482,-1.9297772606244628,-1.806000702776865,2.1809802310004094,2496,2485,Scott and Nearby Counties,Hamilton,20,75,Kansas,KS
20093,20CS020,29,28,29,29,-0,0,1,9.548423102014103,7,213.25209444021326,-2.1554825010910856,-2.037948949648841,-1.9139077675637983,5.329569182170088,35,34,35,48,13,13,14,337.5759009120858,2,51.24263387138099,2.7347505977875435,2.8607547510996514,2.9908330674839383,0.14108762774955472,3939,3903,Scott and Nearby Counties,Kearny,20,93,Kansas,KS
20101,20CS020,24,24,25,26,1,2,2,115.36506582829074,6,460.9475032010243,-3.5713981391875973,-3.455544096921781,-3.3412046825351225,2.3983992058481234,30,30,30,33,3,3,3,193.60501081713562,5,319.4888178913738,-1.3831099247765926,-1.257538529556447,-1.1352861552321745,1.2407199054126705,1562,1565,Scott and Nearby Counties,Lane,20,101,Kansas,KS
20171,20CS020,45,44,45,55,10,10,11,237.42985413975487,16,376.8400392541708,-1.5223211562420338,-1.3919058698956566,-1.2759641835460993,1.443929176567468,55,55,56,72,16,17,17,324.0834721015247,12,233.82696804364772,0.7734157735757035,0.9028345748012039,1.029391188331335,0.6805821599972133,5095,5132,Scott and Nearby Counties,Scott,20,171,Kansas,KS
20203,20CS020,19,19,20,31,11,12,12,654.9424010645629,5,281.1621368322399,3.6045965269125633,3.7351690615394255,3.8548581345528734,0.3953488306842045,23,23,23,30,7,7,7,325.0478471008149,7,334.7680535628886,-0.22087223109930415,-0.0963627559663954,0.02691553834541611,0.8978099293253345,2134,2091,Scott and Nearby Counties,Wichita,20,203,Kansas,KS
20173,20CS021,3917,3692,4142,4833,691,916,1141,210.11945672587711,497,114.0161044879981,0.4629703049037058,0.9583137220261714,1.500631669386249,0.5420333705072733,4821,4550,5091,5624,533,803,1074,153.34522212359374,611,116.62775893366724,-0.17612009856129957,0.3632766569919622,0.892126882583633,0.759611304588491,523084,523889,Sedgwick,Sedgwick,20,173,Kansas,KS
20177,20CS022,1646,1570,1723,1914,191,268,344,180.09702195556125,239,160.85339794390322,-0.30904916156392903,0.19327702794893087,0.7166530726521408,0.8898232814465065,2018,1926,2110,2155,45,137,229,76.8061854378799,238,133.47241383177987,-1.092069884054172,-0.5685199829290104,-0.07796046322512945,1.7251854712799888,178299,178314,Shawnee,Shawnee,20,177,Kansas,KS
20007,20CS023,49,49,49,66,17,17,17,483.8719029628516,3,85.16678495386799,3.870682732087037,3.9859344855631536,4.110966009759374,0.16625667970929023,59,58,59,66,7,7,8,170.69367169792253,5,121.2709192335678,0.3688156669358029,0.4963312172226288,0.6230101518765893,0.6220684956742245,4227,4123,South Central Kansas,Barber,20,7,Kansas,KS
20077,20CS023,77,77,78,94,16,17,17,367.31116058201155,14,308.5399449035812,0.4701170481339548,0.5854391836636897,0.6998935115542458,0.7924493653275364,94,93,94,78,-16,-16,-15,-290.993428181618,7,130.84112149532712,-4.348494266695948,-4.222455287813967,-4.096860297810312,-0.48050032194154396,5445,5350,South Central Kansas,Harper,20,77,Kansas,KS
20095,20CS023,158,155,161,212,51,54,57,880.0277662797633,31,503.791982665222,3.2936714112411365,3.75435022984863,4.308884565993555,0.5620927355206614,193,189,196,265,69,72,76,978.4481218392942,35,472.972972972973,4.553079460186073,5.036621609233643,5.584873583925877,0.4768057111450205,7384,7400,South Central Kansas,Kingman,20,95,Kansas,KS
20151,20CS023,101,101,102,124,22,23,23,295.68767739046086,25,327.90468903705323,-0.44632097395972764,-0.32262153005056626,-0.198807036549424,1.06185422610589,126,125,127,129,2,3,4,35.528602845167804,6,65.38084341288003,-0.42443120484300445,-0.2988780439125562,-0.1704566776779392,1.408298673060805,9149,9177,South Central Kansas,Pratt,20,151,Kansas,KS
20185,20CS023,51,50,51,59,8,8,9,247.61808906523058,8,236.27861186315528,-0.003872951723546513,0.11445360270328025,0.22646119198191478,0.8525207515709058,62,62,63,81,18,19,19,469.3065545237168,16,396.235760277365,0.5971558814234292,0.7259768749599308,0.8524392780347726,0.8019809462019792,4063,4038,South Central Kansas,Stafford,20,185,Kansas,KS
20191,20CS023,230,221,240,270,30,40,49,213.36225656313098,42,224.92970946579194,-0.6238668593279634,-0.10510437212764263,0.41598372618378804,1.028401829828462,286,275,298,322,24,36,47,159.73790617567047,30,134.0662287169862,-0.2856709905512203,0.26610800377485566,0.7897487101424601,0.8164475811311103,22407,22377,South Central Kansas,Sumner,20,191,Kansas,KS
20067,20CS024,51,50,52,60,8,9,10,147.97897738467574,16,263.0497328401151,-1.2739342816703472,-1.1548123438483273,-1.0300551146469692,1.599868602883973,63,63,64,59,-5,-4,-4,-61.43666389279331,16,218.45985800109227,-2.92357910912457,-2.800737989040604,-2.6749598570433544,-4.571923301197702,7299,7324,Southwest Kansas,Grant,20,67,Kansas,KS
20069,20CS024,45,45,46,55,9,10,10,208.4432863920875,10,211.0075611042729,-0.14510640462059116,-0.0276401823572783,0.09160856103317568,0.9192465149774522,55,55,56,66,10,11,11,187.6204663908948,11,194.96632399858206,-0.19616584456116895,-0.07399045670875704,0.059340827989868734,0.9494588621287835,5687,5642,Southwest Kansas,Gray,20,69,Kansas,KS
20081,20CS024,25,25,26,25,-1,-0,-0,-13.401894928838056,5,158.68817773075907,-1.834848790963513,-1.7251044970643945,-1.6074356462100632,8.654582383267122,31,30,31,35,4,4,5,115.87129463642215,3,81.49959250203749,0.22058229288088738,0.34136327588773663,0.462164527892374,0.5697765065568837,3781,3681,Southwest Kansas,Haskell,20,81,Kansas,KS
20119,20CS024,42,42,43,56,13,14,14,403.19310753273857,5,148.55162168853676,2.4244606667228377,2.5475559411845476,2.6710720827951944,0.3431518688745196,52,52,53,58,5,6,6,146.1995729739088,7,173.91304347826087,-0.4050349442588293,-0.27740103860534543,-0.14669658384391415,1.0167719714539751,4039,4025,Southwest Kansas,Meade,20,119,Kansas,KS
20129,20CS024,32,32,32,36,4,4,4,184.13077130438367,1,44.91017964071856,1.2707535435081356,1.390672491223363,1.513931551314294,0.19607925768472237,40,39,40,44,4,4,5,164.765540421545,5,185.73551263001485,-0.33398196961517185,-0.2066068967385542,-0.07620185616901023,0.9198805479370822,2672,2692,Southwest Kansas,Morton,20,129,Kansas,KS
20175,20CS024,117,115,119,141,22,24,26,133.98891333509894,38,209.5299361301291,-0.8759933092031278,-0.7567450008935233,-0.6243209282092717,1.5019759279340885,146,143,148,163,15,17,20,79.8053889830367,14,64.34119215037455,0.026851561167931814,0.1525134750935842,0.2851181315505881,0.7623256657051668,21763,21759,Southwest Kansas,Seward,20,175,Kansas,KS
20187,20CS024,18,18,18,16,-2,-2,-2,-114.38738117939499,2,116.67476908118618,-2.432087963635619,-2.3128768566793925,-2.1838543755284032,-2.0816195553598904,22,22,22,19,-3,-3,-3,-151.58239628446506,4,195.3125,-3.5939516283296036,-3.466651122426757,-3.348176376686794,-1.9007725670040188,2057,2048,Southwest Kansas,Stanton,20,187,Kansas,KS
20189,20CS024,40,39,41,46,5,6,7,137.27827114716615,5,113.9168407062844,0.11230477767247515,0.23304736201196613,0.34693892539942617,0.7117060728149358,50,49,50,54,4,4,5,81.52351083760108,10,189.2147587511826,-1.199259319266754,-1.0776250673169927,-0.9498291275248265,1.883765083192772,5267,5285,Southwest Kansas,Stevens,20,189,Kansas,KS
20209,20CS025,1213,1141,1286,1474,188,261,333,185.89995655069598,213,151.90324785308889,-0.20025823596562561,0.34189906923493146,0.8410351242867211,0.8140009127941167,1486,1399,1572,1653,81,167,254,99.95975094274412,174,103.99732236779191,-0.5726623850871869,-0.041896901164243765,0.48824601939024564,1.034208167760449,168265,167312,Wyandotte,Wyandotte,20,209,Kansas,KS
21001,21CS001,175,167,183,268,85,93,101,589.1101335536042,44,278.42227378190256,2.62045475697243,3.1220906037564133,3.6356073663276014,0.4675924524379518,214,205,224,270,46,56,65,293.3639766872029,40,211.38297310151665,0.3008012715695006,0.8298378721321568,1.3356334366338098,0.7077984218683958,18964,18923,Adair and Nearby Counties,Adair,21,1,Kentucky,KY
21045,21CS001,169,162,175,210,35,41,48,311.59308002694917,25,188.32391713747646,0.6956067661552093,1.2321584300738375,1.759413677763014,0.5901239493885848,206,198,214,242,28,36,44,228.36974409438346,39,245.76217783099122,-0.682897345471798,-0.18792790990714622,0.3537931092165018,1.0472611589850451,15930,15869,Adair and Nearby Counties,Casey,21,45,Kentucky,KY
21087,21CS001,129,128,130,141,11,12,13,130.97343911086003,16,172.8639596650761,-0.5327489259083801,-0.41738730671989677,-0.30090498503858654,1.2192628377466188,160,159,162,164,2,4,5,33.28046401194978,28,248.55747891699954,-2.282767190178957,-2.156723143410272,-2.021043892080558,5.895923137903621,11107,11265,Adair and Nearby Counties,Green,21,87,Kentucky,KY
21207,21CS001,218,210,226,272,46,54,62,360.7807386605158,33,220.13452665517815,0.9048408480470502,1.403859656792862,1.9065043316708141,0.5990846070926588,268,259,277,310,33,42,51,232.08807860788983,35,193.05019305019306,-0.1346005877523035,0.40607498927704067,0.9077996948625666,0.8124878236063482,17989,18130,Adair and Nearby Counties,Russell,21,207,Kentucky,KY
21217,21CS001,269,258,280,311,31,42,53,193.99419962805538,28,129.22579900773047,0.12436576505836393,0.6485180097651713,1.1587486766743293,0.6506529631793567,331,318,345,447,102,116,129,440.90208176221154,66,251.86994352007326,1.3812175243225777,1.896915780864608,2.3898307585716547,0.566358405914289,26001,26204,Adair and Nearby Counties,Taylor,21,217,Kentucky,KY
21005,21CS002,213,202,223,246,23,33,44,169.08804688851092,13,65.77837746668915,0.5132609220655188,1.0446504865696236,1.53684968071226,0.3777155459663226,262,250,275,291,16,29,41,120.0759515690777,47,195.74361750864188,-1.2776488606025214,-0.7663399864809547,-0.2605632937067513,1.5755191552930827,23716,24011,Anderson+Franklin,Anderson,21,5,Kentucky,KY
21073,21CS002,487,465,509,528,19,41,63,95.48515777758395,40,93.2382820846526,-0.48382143333735644,0.008319248721430262,0.5300791729026068,0.9531996056782895,596,569,623,759,136,163,190,315.1504628988458,79,152.90519877675843,1.0968500750217343,1.6176920334708818,2.143899505193077,0.48222000467478354,51481,51666,Anderson+Franklin,Franklin,21,73,Kentucky,KY
21003,21CS003,204,195,213,231,18,27,36,157.62443946172087,30,173.72840459415113,-0.6791806470954602,-0.17152853734394802,0.2987255422712087,1.0631092245797367,250,239,261,290,29,40,51,193.3733739238202,47,226.30970724191062,-0.8772684031804915,-0.31682739405291377,0.19356811599624213,1.1418913652514093,20722,20768,Barren and Nearby Counties,Allen,21,3,Kentucky,KY
21009,21CS003,447,428,466,507,41,60,79,162.08258315153037,45,121.57507260733502,-0.10866948254590858,0.39382204973042845,0.9555563614373992,0.7377833230485046,547,524,570,653,83,106,129,238.53168203874188,111,249.27015495171796,-0.6128317265143007,-0.11484330918798133,0.4069265418609151,1.0352724021590654,44417,44530,Barren and Nearby Counties,Barren,21,9,Kentucky,KY
21099,21CS003,195,187,203,227,24,32,40,198.5125238286773,31,193.2166415623539,-0.5020487642152573,0.05433879949634267,0.5305146388067576,0.9436925970877882,240,230,250,269,19,29,39,148.52974630718708,45,231.57678056813504,-1.3436205149522573,-0.8136002461422989,-0.3071435790021883,1.5069167326123374,19253,19432,Barren and Nearby Counties,Hart,21,99,Kentucky,KY
21169,21CS003,118,117,119,148,29,30,31,353.33789514257654,14,163.87046429964883,1.773379250182182,1.894585067584581,2.0144337598945268,0.44890737935870206,145,144,147,160,13,15,16,141.30658921629347,34,328.8837299284194,-2.0061626438667455,-1.8736426429939528,-1.7589541779650437,2.178331659276184,10252,10338,Barren and Nearby Counties,Metcalfe,21,169,Kentucky,KY
21171,21CS003,150,145,155,152,-3,2,7,22.779287041368992,37,396.42857142857144,-4.245808924835069,-3.7461189517202755,-3.20694431889723,11.835959523357882,182,176,188,185,-3,3,9,24.25311520664007,37,329.0936582762608,-3.523516526801582,-3.0433570021727845,-2.54363343674124,9.92814773369536,11200,11243,Barren and Nearby Counties,Monroe,21,171,Kentucky,KY
21011,21CS004,147,142,153,150,-3,3,8,25.100750902501673,10,94.56264775413713,-1.1858535519285323,-0.713440611079515,-0.20787438803379166,2.736424019814014,180,174,187,220,33,40,46,312.01135941914214,19,148.8095238095238,1.107704926117653,1.6465895179953691,2.137334694573666,0.4652573896356528,12690,12768,Bath+Clark+Montgomery+Rowan,Bath,21,11,Kentucky,KY
21049,21CS004,366,351,382,396,14,30,45,96.12868646434323,17,55.313033811447625,-0.12598371105991954,0.40164123949133435,0.9208345395091397,0.5565677319532149,446,427,465,523,58,77,96,207.6071844473167,31,84.03361344537815,0.7190453233909677,1.2413829766725966,1.7471225588540475,0.3995551258232139,36881,36890,Bath+Clark+Montgomery+Rowan,Clark,21,49,Kentucky,KY
21173,21CS004,269,257,281,306,25,37,49,159.26261118052943,20,85.34850640113798,0.22651059803894766,0.733231459633337,1.2689358435043108,0.5219133330336655,329,314,343,433,90,104,119,369.6836676469957,67,237.5886524822695,0.8031944800107633,1.3380426814068545,1.8363037437246201,0.6365747684907455,28120,28200,Bath+Clark+Montgomery+Rowan,Montgomery,21,173,Kentucky,KY
21205,21CS004,198,188,209,230,21,32,42,153.58667111210556,11,53.41102209274095,0.5051329748091771,0.9992390342136129,1.5019461449753366,0.33710094804959284,244,231,257,328,71,84,97,338.7392310994067,45,181.14483535947187,1.0754648908369093,1.5898723458435213,2.062751055736055,0.5284816383298567,24714,24842,Bath+Clark+Montgomery+Rowan,Rowan,21,205,Kentucky,KY
21013,21CS005,318,307,328,362,34,44,55,219.5748637814126,40,198.04431241490283,-0.34720931620547063,0.2030581642742137,0.703006074616544,0.8820552518306028,385,372,397,545,148,160,173,671.508808993492,80,335.14872224549646,2.8714231878336554,3.35607230576409,3.9109317380104343,0.49600359762230734,24237,23870,Bell+Harlan,Bell,21,13,Kentucky,KY
21095,21CS005,365,353,376,471,95,106,118,480.2804441646437,31,140.2291917973462,2.899642593417448,3.4107364982881756,3.9045617042669143,0.2892492666990843,441,427,454,586,132,145,159,554.266483241241,87,331.5422430547616,1.7056344282606042,2.2315370875948344,2.7395303213024786,0.5940794133047492,26528,26241,Bell+Harlan,Harlan,21,95,Kentucky,KY
21015,21CS006,828,769,886,911,25,83,142,73.39695416110936,91,80.22922636103152,-0.617936917810615,-0.0728795341185878,0.46913401235648533,1.0801123450034773,1032,961,1103,1168,65,136,207,99.17040617623805,160,116.56285287582413,-0.6720819653126765,-0.16827315612860935,0.32122494086721043,1.1668078914242617,136110,137265,Boone,Boone,21,15,Kentucky,KY
21017,21CS007,205,196,213,202,-11,-3,6,-15.81575084172474,1,5.939123979213066,-0.7155763483505081,-0.22581926006523181,0.3177805531054063,-0.6013312097226197,251,240,261,334,73,83,94,410.56278141589144,37,182.8334239264713,1.7385879230474006,2.295691438603922,2.8249514414679164,0.44002783315118527,20205,20237,Bourbon+Fleming+Lewis+Nicholas,Bourbon,21,17,Kentucky,KY
21069,21CS007,164,157,170,179,9,15,22,121.57130993619214,17,135.73757402355446,-0.6465052924274584,-0.15354497050115318,0.4086552099631007,1.047714555588417,202,194,210,208,-2,6,14,37.33357628727887,29,190.72673462676752,-2.0216645878397572,-1.5221439829529417,-1.0174185386463606,4.343547481383378,15029,15205,Bourbon+Fleming+Lewis+Nicholas,Fleming,21,69,Kentucky,KY
21135,21CS007,157,151,162,174,12,17,23,159.151637247919,29,265.8721063488425,-1.6033861906443871,-1.0786499469081325,-0.5479944212421496,1.5795667392310762,190,184,197,231,34,41,47,313.21421981220914,39,300.04616094783813,-0.36271040071135235,0.13985963327351036,0.6242403084209578,0.9349920570683381,13089,12998,Bourbon+Fleming+Lewis+Nicholas,Lewis,21,135,Kentucky,KY
21181,21CS007,87,86,88,77,-11,-10,-9,-163.63208452792142,4,63.89776357827476,-2.3892710983111893,-2.2773769220280675,-2.158542956800025,-0.4327426742427143,109,108,110,116,6,7,8,87.17806950065398,21,273.224043715847,-1.990290865379568,-1.867313725028384,-1.7273675077421866,2.727093368884688,7512,7686,Bourbon+Fleming+Lewis+Nicholas,Nicholas,21,181,Kentucky,KY
21019,21CS008,569,549,590,641,51,72,92,179.03964999323392,50,125.12773456236573,0.009422052513556588,0.5376691567811641,1.0573173894020766,0.6892487329865618,698,673,723,795,72,97,122,201.97686924655764,78,162.70677319093014,-0.08428675561718514,0.39689374276728684,0.8701067606578392,0.797336557760081,47951,47939,Boyd+Carter+Greenup,Boyd,21,19,Kentucky,KY
21043,21CS008,292,280,303,304,1,12,24,54.65540921971956,22,99.30038366057323,-0.9449371827488318,-0.43586479083334395,0.08724371250805962,1.6782483714987702,357,344,371,436,65,79,92,297.49823819646,56,211.83234982599487,0.36659250378132857,0.8500630881710023,1.4017980185473282,0.7031056682758678,26586,26436,Boyd+Carter+Greenup,Carter,21,43,Kentucky,KY
21089,21CS008,425,410,441,498,57,73,88,244.1791728842733,37,124.26184545632644,0.6753855150453844,1.1950088269790111,1.7192904250112857,0.5019917979496094,521,503,539,577,38,56,74,156.85082811125042,66,184.9827629698142,-0.8107568391871175,-0.27354309899282014,0.19763025116815808,1.158650767407676,35731,35679,Boyd+Carter+Greenup,Greenup,21,89,Kentucky,KY
21021,21CS009,302,289,315,339,24,37,50,144.09639019936907,45,176.44752319958175,-0.8727806938363663,-0.335548712624683,0.18649307828618172,1.1920724728432406,373,357,389,442,53,69,85,224.65443338032316,55,178.91997397527652,-0.05064163445397292,0.4581296827539639,0.990454329061564,0.7850551442063859,30604,30740,Boyle+Lincoln+Mercer,Boyle,21,21,Kentucky,KY
21137,21CS009,262,251,272,309,37,47,58,233.8355873164672,37,182.86655683690282,0.0020138174815583377,0.519369893149161,1.0225577004242787,0.7658436412926025,321,308,333,435,102,114,127,470.38146596361224,64,264.0046200808514,1.5210746355134221,2.0759840258154423,2.5799181414018415,0.5563772021115401,24280,24242,Boyle+Lincoln+Mercer,Lincoln,21,137,Kentucky,KY
21167,21CS009,256,247,266,260,-6,4,13,18.98121625833969,25,133.1026221216558,-1.689366791955282,-1.1613922658737783,-0.6223523758000837,5.476274982643544,318,306,329,351,22,33,45,146.32749534888626,51,223.52734922861148,-1.2837361476082556,-0.7709960252599192,-0.2394835063299629,1.4831582435201962,22539,22816,Boyle+Lincoln+Mercer,Mercer,21,167,Kentucky,KY
21023,21CS010,83,82,83,90,7,7,8,105.79752069574235,8,114.47650846649177,-0.2056267159223502,-0.08871708248461212,0.042305506010475856,0.9531203690229286,102,101,103,140,37,38,39,452.9223564173026,22,260.91081593927896,1.7977942959532673,1.9194531823037841,2.0392948231645365,0.56136177865064385,8386,8432,Bracken and Nearby Counties,Bracken,21,23,Kentucky,KY
21097,21CS010,198,190,206,209,3,11,19,70.16592634213521,11,70.39999999999999,-0.5171939784464271,0.006514846627679561,0.5171177686698231,0.9194690557966643,245,236,255,298,43,53,62,278.228479889149,43,227.34482393993866,-9.414548425029174e-5,0.4977019984400641,1.0605419233375601,0.8018777412745633,18750,18914,Bracken and Nearby Counties,Harrison,21,97,Kentucky,KY
21161,21CS010,203,195,210,197,-13,-6,2,-39.247006754927845,21,147.67932489451476,-2.388216577555341,-1.8639251962401637,-1.3721385891245892,-4.584227624634973,247,238,255,272,17,25,34,149.79868227293085,44,259.54108417389256,-1.612200842820394,-1.0934378520727597,-0.5889911040852359,1.666958977664378,17064,16953,Bracken and Nearby Counties,Mason,21,161,Kentucky,KY
21191,21CS010,147,141,154,153,-1,6,12,46.391686598010466,8,65.63653767263777,-0.7071370050667645,-0.20895907996650226,0.335431502915941,1.2022168756222211,181,173,188,209,21,28,36,191.9289003431207,23,157.4048727073638,-0.13745358520923756,0.35999871234541125,0.8887259100822273,0.791884194608714,14626,14612,Bracken and Nearby Counties,Pendleton,21,191,Kentucky,KY
21201,21CS010,27,27,27,39,12,12,12,659.6760096636551,1,54.89478499542543,5.92890263280952,6.047404210137958,6.153021500673958,0.076822038356067393,34,34,34,39,5,5,5,225.80824005351232,7,311.6651825467498,-0.9791875239238328,-0.8608196132356819,-0.7298228576472079,1.1528985463184884,2186,2246,Bracken and Nearby Counties,Robertson,21,201,Kentucky,KY
21027,21CS011,204,195,213,249,36,45,54,264.8423423566243,15,87.97653958944281,1.2330002577603305,1.7641291099459828,2.2815766986569277,0.32498751406991633,250,239,261,355,94,105,116,509.9338023361064,44,213.395411998642,2.4448860725942776,2.9824455493650857,3.4718594331074564,0.4145341291914454,20460,20619,Breckinridge+Grayson+Hancock+Meade,Breckinridge,21,27,Kentucky,KY
21085,21CS011,280,269,291,314,23,34,45,154.65215000976912,40,181.6392946340725,-0.7801813369502718,-0.25236789534499937,0.2182295440979788,1.1409995640106458,341,328,355,447,92,106,119,398.7070686234861,65,245.21824423737127,1.0425660968135628,1.5125154246761088,2.036091240247879,0.6092686673095224,26426,26507,Breckinridge+Grayson+Hancock+Meade,Grayson,21,85,Kentucky,KY
21091,21CS011,77,76,78,102,24,25,26,333.92752322519397,4,53.132610139473094,2.682024222128695,2.80909938437603,2.926619453636394,0.1530270059328189,95,94,96,114,18,19,20,212.93358360258196,8,88.2223202470225,1.1182074769446344,1.2432727045934202,1.3788237239208339,0.3939175707656139,9034,9068,Breckinridge+Grayson+Hancock+Meade,Hancock,21,91,Kentucky,KY
21163,21CS011,235,222,248,243,-5,8,21,31.632341404881448,13,52.35426385206564,-0.6911405920681836,-0.2115794114944546,0.2760869107046001,1.4681677558566257,289,274,305,357,52,68,83,224.98005554164536,63,209.23976219734962,-0.35160407886694833,0.15016911480351286,0.6871373268869142,0.9165070124139403,29797,30109,Breckinridge+Grayson+Hancock+Meade,Meade,21,163,Kentucky,KY
21029,21CS012,569,534,605,699,94,130,165,189.1481336080156,63,91.87356447555506,0.49057331056347664,0.97861819978481,1.5236215454225963,0.48200660204712253,704,661,747,856,109,152,195,183.31999955788265,103,124.35558453161408,0.07125138734626138,0.6021145801409807,1.0816278381661673,0.673914161873087,82287,82827,Bullitt+Spencer,Bullitt,21,29,Kentucky,KY
21215,21CS012,148,139,156,157,1,9,18,56.39904785889543,12,73.61210510172783,-0.7221344282886493,-0.16881074598593032,0.35452484963867964,1.1771647940365124,184,174,194,213,19,29,39,146.3701767354941,26,130.88346337780015,-0.3373273800311456,0.1507807591490899,0.6506187530818333,0.8644641385845253,19562,19865,Bullitt+Spencer,Spencer,21,215,Kentucky,KY
21031,21CS013,145,140,150,170,20,25,30,241.86939926789935,20,193.62646228317868,-0.060590616780529336,0.4709436349402971,1.0115145887329413,0.7697312909684133,176,170,183,189,6,13,19,102.54133652993086,30,243.9421044072207,-1.9315040045768135,-1.4118254116894327,-0.8413824830040135,2.2041751598885218,12395,12298,Butler+McLean+Muhlenberg+Ohio,Butler,21,31,Kentucky,KY
21149,21CS013,101,100,102,128,26,27,28,359.7048194434181,16,210.5263157894737,1.374929795921094,1.4873476422034366,1.6167550082384619,0.5646215290051632,123,122,124,145,21,22,23,238.21561746066072,21,230.71852340145026,-0.04852050206149801,0.0743028976019043,0.20132269742720518,0.925828546509132,9120,9102,Butler+McLean+Muhlenberg+Ohio,McLean,21,149,Kentucky,KY
21177,21CS013,333,319,346,364,18,31,45,122.01236179621789,42,163.4877384196185,-0.9340691077394894,-0.4184314608287877,0.10312353933822163,1.2985015147494827,406,390,422,482,60,76,92,247.85543324804073,61,198.56770833333331,-0.024719710999627637,0.4889880868523017,1.033811662836607,0.7907578391853463,30828,30720,Butler+McLean+Muhlenberg+Ohio,Muhlenberg,21,177,Kentucky,KY
21183,21CS013,247,236,257,260,3,13,24,67.84565033793137,29,146.415348367553,-1.2768756089034705,-0.7829061673390415,-0.2836715929148966,2.008593760054084,301,289,314,372,58,71,83,297.61618224172304,46,194.14197687178188,0.5363931273456456,1.037337617360155,1.5483634417265764,0.6432021109427435,23768,23694,Butler+McLean+Muhlenberg+Ohio,Ohio,21,183,Kentucky,KY
21035,21CS014,329,313,345,404,59,75,91,240.88239359313792,40,128.0990632755998,0.5850195049481011,1.1064317294522348,1.6578440328661712,0.5248136157875855,406,386,425,511,86,105,125,280.7562479887154,40,106.66666666666667,1.2204430172593796,1.7585657252881641,2.254519536977424,0.3763515973871208,37471,37500,Calloway+Marshall,Calloway,21,35,Kentucky,KY
21157,21CS014,380,366,393,385,-8,5,19,19.763219994677783,35,132.9408413256101,-1.6929592998692906,-1.1443615324989342,-0.6611376626169909,5.642283958385622,466,449,482,510,28,44,61,140.00366346488912,48,151.24779430299975,-0.6166611186865577,-0.10704831898491833,0.38467726515513584,1.0565342069189305,31593,31736,Calloway+Marshall,Marshall,21,157,Kentucky,KY
21037,21CS015,745,705,785,817,32,72,112,92.84701529065175,58,74.68452227659026,-0.3591436534066087,0.1767804334803453,0.6694649667979463,0.793379471824832,914,866,962,957,-5,43,91,45.75294202723651,84,90.26919563698887,-0.9716014379961676,-0.42626098800187284,0.06896316832510548,1.92769313896879,93192,93055,Campbell,Campbell,21,37,Kentucky,KY
21047,21CS016,534,503,566,668,102,134,165,221.01773545404174,72,119.17570139865926,0.5404468616446954,1.026896967697123,1.5480131081036017,0.5352051046609302,660,622,697,835,138,175,213,242.10224528430817,102,140.87230340027068,0.524238420898222,1.0174513229106608,1.500854499869485,0.5785705903180567,72498,72406,Christian,Christian,21,47,Kentucky,KY
21051,21CS017,240,232,249,236,-13,-4,4,-25.759999409483243,21,124.57363191457807,-2.02264510596281,-1.5072241585070354,-0.9926357733423761,-6.2827377374197715,296,286,306,390,84,94,104,464.9051577364191,43,212.6712498145309,2.047385095461126,2.525360622743865,3.010742359188241,0.45263551524340134,20229,20219,Clay+Jackson+Leslie+Owsley,Clay,21,51,Kentucky,KY
21109,21CS017,154,149,160,173,13,19,24,173.01933501804845,23,212.17712177121768,-0.9542222762753648,-0.3686426185940762,0.09477555458368014,1.164244772533262,190,183,197,224,27,34,41,260.8167441737754,42,323.59966099083135,-1.1278547035861592,-0.6368529562742591,-0.13053263608153298,1.205116399963356,13008,12979,Clay+Jackson+Leslie+Owsley,Jackson,21,109,Kentucky,KY
21131,21CS017,140,139,141,132,-9,-8,-7,-92.09559474172153,3,34.77252970153579,-1.3839423164559754,-1.2717432827496213,-1.1489009068744676,-0.4319313959764695,171,170,173,206,33,35,36,337.04999647188345,29,281.444099378882,0.4413213200470798,0.5556188091574584,0.6747877418452078,0.8116512449684722,10353,10304,Clay+Jackson+Leslie+Owsley,Leslie,21,131,Kentucky,KY
21189,21CS017,58,57,58,91,33,33,34,980.2354181150115,12,353.8953059719833,6.142567353887655,6.2593069972600475,6.383186372160042,0.35048623376073157,69,69,70,83,13,14,14,349.9715677807126,7,176.67844522968198,1.6050330504651589,1.7387635342829686,1.8600324140577846,0.47087713969277806,4069,3962,Clay+Jackson+Leslie+Owsley,Owsley,21,189,Kentucky,KY
21053,21CS018,104,103,105,145,40,41,42,526.8680861499773,21,269.0870261612386,2.458467993628085,2.5779224757649946,2.6923730158301695,0.4986031566487185,126,125,127,157,30,31,32,335.85315458285606,21,226.83084899546338,0.9722895255192271,1.0902426329032588,1.215773226503579,0.6543424883568255,9365,9258,Clinton+Cumberland+McCreary+Wayne,Clinton,21,53,Kentucky,KY
21057,21CS018,78,78,79,97,18,19,19,378.9430479433036,4,80.38854463238988,2.865087833532822,2.9824058617283975,3.1092549358225408,0.20145476028540063,94,93,95,111,16,17,18,286.49033091427674,11,187.20217835262082,0.8661331902808449,0.9946417055021594,1.1221678055458681,0.6167934286995356,5971,5876,Clinton+Cumberland+McCreary+Wayne,Cumberland,21,57,Kentucky,KY
21147,21CS018,189,181,196,198,2,9,17,66.80025236514227,11,78.03724504877327,-0.6515990084221157,-0.1171231168584769,0.43175136677502357,1.056062291828892,230,221,239,290,51,60,69,354.18952875233623,57,337.55774013976077,-0.3936417885494575,0.15446930787023969,0.699890175820304,0.937369819295618,16915,16886,Clinton+Cumberland+McCreary+Wayne,McCreary,21,147,Kentucky,KY
21231,21CS018,197,188,205,258,53,61,70,374.5657500665242,26,158.86755944803707,1.6264544249124369,2.1566323667291796,2.67588409326866,0.41733007180622933,240,230,250,334,84,94,104,481.342587364142,46,235.43863240863956,1.991635646769077,2.4455537474564695,2.973395924085487,0.48398272471961656,19639,19538,Clinton+Cumberland+McCreary+Wayne,Wayne,21,231,Kentucky,KY
21059,21CS019,947,902,991,1034,43,87,132,101.77367485397109,92,107.16989923699691,-0.5836974037897306,-0.04352943656145687,0.45682302208550474,1.0411054318790587,1160,1107,1214,1310,96,150,203,145.11024337233513,191,185.26421975634358,-0.9351021940926575,-0.392633135643576,0.07902854489713987,1.2682362368800186,103014,103096,Daviess,Daviess,21,59,Kentucky,KY
21061,21CS020,135,130,140,140,-0,5,10,47.076628339045165,19,187.63887745864537,-1.913804882524821,-1.4052900992156243,-0.8790235810711828,3.2946638495328213,166,160,173,187,14,21,27,169.34260008078599,29,236.3873492011738,-1.1979461397423503,-0.6588781763170876,-0.16668804812210125,1.3318055730579117,12151,12268,Edmonson+Warren,Edmonson,21,61,Kentucky,KY
21227,21CS020,922,864,980,1081,101,159,217,141.44345988242924,95,84.53649529487664,0.05607664202046207,0.5775621934137835,1.1260160708884384,0.5939332873322128,1149,1078,1219,1336,117,187,258,136.961957650437,158,115.42957334891877,-0.29989953773207756,0.20529390594337169,0.7140076765454842,0.8383140167491754,134853,136880,Edmonson+Warren,Warren,21,227,Kentucky,KY
21063,21CS021,67,66,68,65,-3,-2,-1,-30.810110441212316,3,48.90639858714848,-0.9177587692708576,-0.7968279339263991,-0.6758927299827922,-3.3710004252084236,83,82,84,115,31,32,33,436.04701655501856,15,203.41741253051262,2.2002522536004587,2.3254697293973647,2.459318238495256,0.45243263525852023,7361,7374,Elliott+Johnson+Lawrence+Magoffin,Elliott,21,63,Kentucky,KY
21115,21CS021,273,264,283,302,19,29,38,151.69244718500994,17,90.42152386862284,0.09072594399751739,0.6193309547884455,1.1640274804122093,0.5758916021420347,335,324,347,435,88,100,111,442.251474329383,68,301.3249435015731,0.8966523380417951,1.416726618890455,1.8921576411163297,0.6745838324382137,22561,22567,Elliott+Johnson+Lawrence+Magoffin,Johnson,21,115,Kentucky,KY
21127,21CS021,191,184,198,182,-16,-9,-2,-68.41872342515644,14,103.97326401782398,-2.2277858992013537,-1.7158726136933962,-1.251415693308967,-1.7047015808856147,236,227,244,276,32,40,49,246.7100883186295,37,227.13321055862494,-0.3093211646129431,0.1895230198484571,0.7397418828963478,0.8982964887863626,16158,16290,Elliott+Johnson+Lawrence+Magoffin,Lawrence,21,127,Kentucky,KY
21153,21CS021,142,137,147,152,5,10,15,103.59990490033853,10,102.82776349614396,-0.4857539348558668,0.013647548238145785,0.5003330225580875,0.9029271384158463,172,166,178,217,39,45,51,388.6024999845812,24,208.49622100599427,1.2760164128617313,1.80111929205014,2.3006424498450895,0.5247962537378197,11670,11511,Elliott+Johnson+Lawrence+Magoffin,Magoffin,21,153,Kentucky,KY
21065,21CS022,172,166,178,195,17,23,29,193.60134058558688,11,93.41164814945863,0.45183879379506264,1.0002100155342861,1.4857909587848968,0.4622203911497563,210,203,217,273,56,63,70,447.22577187784754,27,191.51652716697404,2.054648289871287,2.5553357420186478,3.0495279349592397,0.4215463958943601,14131,14098,Estill+Madison+Rockcastle,Estill,21,65,Kentucky,KY
21151,21CS022,710,669,750,833,83,123,164,159.07856872010407,63,81.17859290438966,0.24572733591570253,0.7773869400321103,1.303448989415633,0.5062047258256056,888,839,937,1071,134,183,232,193.84587789526688,142,150.4062026670621,-0.06917055377139888,0.43713239737522835,0.9522150422616809,0.7716895083681515,93128,94411,Estill+Madison+Rockcastle,Madison,21,151,Kentucky,KY
21203,21CS022,168,161,175,192,17,24,31,178.9790636542126,13,96.54062751407882,0.334423909762885,0.8197149633985883,1.3260420741150831,0.5179071906307905,206,197,214,317,103,111,120,691.6053042075308,39,242.14578417980874,3.9928863566732926,4.489810000311034,5.019521727128805,0.34700611484747945,16159,16106,Estill+Madison+Rockcastle,Rockcastle,21,203,Kentucky,KY
21067,21CS023,2089,1950,2228,2478,250,389,528,144.7543797601163,142,52.82721717752611,0.4077807026336905,0.9319997804555097,1.427406658333448,0.3640083148067771,2571,2405,2737,2837,100,266,432,82.60387570226133,229,71.1440838568171,-0.38526615359393135,0.11075256590324661,0.636230316872545,0.8580410204784858,322561,321882,Fayette,Fayette,21,67,Kentucky,KY
21071,21CS024,457,442,472,541,69,84,99,282.1808019938323,46,154.747554035491,0.7743605817403212,1.2560936254157034,1.781232743090698,0.5419377662768041,552,534,571,680,109,128,146,360.89188526901745,110,311.22679945676776,-0.04328667388988971,0.501187884174037,1.0083586273535288,0.8556740231426282,35671,35344,Floyd+Martin,Floyd,21,71,Kentucky,KY
21159,21CS024,131,126,136,140,4,9,14,97.11465486145818,6,64.15396952686447,-0.15968304211295697,0.3226282558770353,0.8581519844082106,0.5950817625410528,159,153,165,185,20,26,32,233.1355168840513,29,260.01972563435845,-0.7798132980765309,-0.2750893583810541,0.2929556854596621,1.0740102620296905,11223,11153,Floyd+Martin,Martin,21,159,Kentucky,KY
21079,21CS025,155,148,162,203,41,48,55,336.94295627611405,22,154.48534144771492,1.3268988837981575,1.823308330482954,2.3543853497185574,0.4491309688478537,193,184,202,241,39,48,57,278.8978526992066,33,190.7514450867052,0.35050692863488175,0.8731686584516225,1.3771778911145371,0.670059897134109,17089,17300,Garrard+Jessamine,Garrard,21,79,Kentucky,KY
21113,21CS025,414,391,437,454,17,40,63,90.06135364172711,49,110.54293878778763,-0.7084613093958335,-0.20869478764946403,0.31874294705059114,1.1974234568059794,513,485,541,597,56,84,112,156.80844418353877,51,95.27189852608768,0.09164591958816985,0.6048654958991739,1.1346792890733843,0.6004158532761598,53192,53531,Garrard+Jessamine,Jessamine,21,113,Kentucky,KY
21093,21CS026,828,781,876,1003,127,175,222,189.02583262018229,84,90.93533487297921,0.48892298651770744,0.9820980781749956,1.4688256024576751,0.4783341331780044,1030,972,1088,1396,308,366,424,328.2914542078065,223,200.0394696711459,0.7765404545624378,1.287810995665235,1.7855679685991863,0.6076745524769537,110848,111478,Hardin+Larue,Hardin,21,93,Kentucky,KY
21123,21CS026,161,154,167,162,-5,1,8,9.933299861427594,6,48.59283255719781,-0.9335537780366359,-0.37722770090979785,0.11735683246312759,2.6947952988351225,199,191,207,225,18,26,34,173.0531302307422,34,226.59113628790405,-1.0613794724010452,-0.5342823010120163,-0.018842253811497473,1.260817901442341,14817,15005,Hardin+Larue,Larue,21,123,Kentucky,KY
21101,21CS027,429,410,448,543,95,114,133,305.60819883789094,60,161.05941302791697,0.8790822162980745,1.4342896108609562,1.94321944495925,0.5224240010110603,521,498,544,638,94,117,140,264.383890833244,71,160,0.5401791507893025,1.0472570810849022,1.5493208980215363,0.600065830311914,44704,44375,Henderson+Union,Henderson,21,101,Kentucky,KY
21225,21CS027,145,139,151,142,-9,-3,3,-24.49656964269451,13,113.38033287302856,-1.900669484242092,-1.3748570731520255,-0.8722393025569914,-7.187340272566491,175,168,182,245,63,70,77,518.8278320542945,40,295.00700641640236,1.7242095638327177,2.2378920017413177,2.721361127866668,0.5606334482539965,13759,13559,Henderson+Union,Union,21,225,Kentucky,KY
21103,21CS028,161,155,168,164,-4,3,9,20.926497175278516,3,22.896393817973667,-0.5160175725391599,-0.006606976875705534,0.5413000255282038,0.8017329634619803,197,189,205,230,25,33,41,212.86060289286237,29,185.20883893217524,-0.22614547805047558,0.2575017666662906,0.7792383294056591,0.8447492651696645,15723,15658,Henry+Shelby,Henry,21,103,Kentucky,KY
21211,21CS028,332,311,352,416,64,84,105,209.24300464440427,39,96.83226086776602,0.6292935650162201,1.1193591064711736,1.6510095131338072,0.457347299428371,410,385,435,508,73,98,123,201.46328030604292,77,159.0251961999174,-0.08640395860311924,0.4329488840852693,0.9488943093552419,0.7813410058994311,48331,48420,Henry+Shelby,Shelby,21,211,Kentucky,KY
21107,21CS029,504,484,523,613,90,109,129,289.7756174398693,95,251.98938992042437,-0.12308106236652155,0.3681796382693739,0.8557435656285486,0.8617138973627955,608,585,632,756,124,148,171,327.0884249880379,103,228.0224037546213,0.46059678286089917,0.9739220600127477,1.4854390813691258,0.6924411063877077,45240,45171,Hopkins+Webster,Hopkins,21,107,Kentucky,KY
21233,21CS029,147,141,153,174,21,27,33,249.53456114308372,23,212.89725393397097,-0.14067575493644457,0.3720183837024735,0.861155471666509,0.8226610816100264,176,170,183,205,22,29,35,224.04702816635185,28,218.0855206791806,-0.4172148476304546,0.057369743074153344,0.5972929429927946,0.9406895903268556,12964,12839,Hopkins+Webster,Webster,21,233,Kentucky,KY
21111,21CS030,6914,6579,7250,8138,888,1224,1559,188.3821556962555,753,115.90722803938996,0.19580732494296227,0.7228260390874865,1.2503349194454756,0.6147747753158466,8450,8048,8852,9578,726,1128,1530,144.91005067951687,907,116.5069994116846,-0.22877671068457486,0.28258205270377956,0.8056225762853014,0.803283240948181,779589,778494,Jefferson,Jefferson,21,111,Kentucky,KY
21117,21CS031,1334,1262,1407,1390,-17,56,128,39.54005407924269,109,77.42118783516625,-0.8782128816158215,-0.3743021541209895,0.1026983473449988,1.9234915143225737,1641,1553,1728,1753,25,112,200,66.34158484520702,197,116.25848332841547,-1.0430339151094414,-0.5184353419211257,-0.003441672071578035,1.7369711542999702,168946,169450,Kenton,Kenton,21,117,Kentucky,KY
21119,21CS032,169,163,175,197,22,28,34,237.3355491822674,11,92.62507894182863,0.9866860330811312,1.4740417648569757,1.95404675934157,0.37689852875222646,206,199,213,269,56,63,70,447.1282384158832,34,241.666074347857,1.541940943941635,2.0489811327911998,2.556680300322946,0.5320274928184284,14251,14069,Knott+Letcher+Perry,Knott,21,119,Kentucky,KY
21133,21CS032,286,277,295,324,29,38,47,212.1144339439863,24,134.39731205375892,0.2530012462244595,0.7597106619078084,1.290390936815225,0.6173103857033071,349,338,360,427,67,78,89,364.6439773966637,61,286.6676065604587,0.2722933963204837,0.7725443831698793,1.2847558854151315,0.7761545775029854,21429,21279,Knott+Letcher+Perry,Letcher,21,133,Kentucky,KY
21193,21CS032,404,392,416,436,20,32,44,136.47358738394595,33,141.65623323197997,-0.5630073769324289,-0.06037341576903237,0.4498878925391797,1.006322772913908,494,480,509,594,85,100,114,356.91284738880904,87,310.78088161748946,-0.03839890406345784,0.45915360326764193,1.0021378832734966,0.8621186620790813,27955,27994,Knott+Letcher+Perry,Perry,21,193,Kentucky,KY
21121,21CS033,337,324,350,411,61,74,87,292.4421570794429,30,118.96893588896233,1.2508079768172395,1.7168792854886648,2.2166052699480825,0.4013691292695999,407,392,423,526,103,119,134,396.4176845214216,84,280.5423819384143,0.6572429415571736,1.149166558252767,1.641172727668585,0.701781454095352,30260,29942,Knox+Whitley,Knox,21,121,Kentucky,KY
21235,21CS033,430,414,446,474,28,44,60,144.8815571143842,25,81.81966944853542,0.11127929451760386,0.6354781555921573,1.161469271333685,0.5522596725749712,526,507,545,635,90,109,128,295.5108098061596,108,292.6670641157661,-0.49242041370073364,0.027352846486209254,0.5596305373119421,0.9813774627335912,36666,36902,Knox+Whitley,Whitley,21,235,Kentucky,KY
21125,21CS034,585,559,612,687,75,102,128,195.40451419313507,27,51.93472894559677,0.9167827059222639,1.4281587933595012,1.9537782812837428,0.2631898310346154,719,687,752,940,188,221,253,352.6750456790795,142,226.92406034262336,0.751431253674252,1.2701038702202645,1.8011145466067797,0.6405342623484622,62386,62576,Laurel,Laurel,21,125,Kentucky,KY
21141,21CS035,282,270,293,317,24,35,47,154.90060407358897,40,174.74243692890167,-0.7121700913815726,-0.2041052121974255,0.3600958355416998,1.097151711270665,347,333,362,389,27,42,56,150.04788396363872,41,147.84897767841045,-0.4984558968680196,0.013320465579895838,0.5533721535191115,0.9622204397442051,27469,27731,Logan+Simpson+Todd,Logan,21,141,Kentucky,KY
21213,21CS035,195,187,204,222,18,27,35,164.60152084695608,24,147.9122798007293,-0.35200528139494763,0.157257668384662,0.7084342409079228,0.8661768203893357,241,231,251,265,14,24,34,121.40661731480672,55,279.13114088509946,-2.0863157226769173,-1.5678873333255057,-1.085401649728437,2.206889035785921,19471,19704,Logan+Simpson+Todd,Simpson,21,213,Kentucky,KY
21219,21CS035,119,118,120,121,1,2,3,21.796809797335936,13,126.97379130717891,-1.169586391062642,-1.0562902714300413,-0.9306789471645838,4.022737697906235,146,144,148,184,36,38,40,309.1553936121952,20,162.813415825464,1.335623094710796,1.463786523917706,1.593666357595875,0.5131277506752595,12286,12284,Logan+Simpson+Todd,Todd,21,219,Kentucky,KY
21033,21CS036,146,141,152,145,-7,-1,4,-10.631969621367979,14,132.8483314882176,-1.9156763681763584,-1.4074023736430443,-0.914592484330238,-116.24778849314455,178,172,185,210,25,32,38,251.40843456523194,30,237.6237623762376,-0.37581448399815964,0.13950928576054292,0.61815591188396,0.916301511599531,12646,12625,Lyon and Nearby Counties,Caldwell,21,33,Kentucky,KY
21055,21CS036,110,109,110,112,2,2,3,32.55794100137715,12,160.80402010050253,-1.406849668060761,-1.28076495974176,-1.161650503126432,3.4989132330895054,134,133,135,157,22,23,24,253.73809697615508,23,256.8971294538144,-0.15668498738821465,-0.030884134122124495,0.08837501731966775,0.9697614948506805,8955,8953,Lyon and Nearby Counties,Crittenden,21,55,Kentucky,KY
21139,21CS036,125,122,129,154,25,29,32,385.72526118188375,19,256.1509942703067,0.7885357140798446,1.3083901180868678,1.7779169078547028,0.6416497287717601,154,149,158,174,16,20,25,227.76248143256194,27,301.94587340639674,-1.2220020922145547,-0.7490345554208944,-0.21469821976239029,1.2636591556786512,8901,8942,Lyon and Nearby Counties,Livingston,21,139,Kentucky,KY
21143,21CS036,105,104,106,112,6,7,8,92.6134499957514,12,167.07274625826662,-0.862946399991752,-0.7453151695055181,-0.6360771669548202,1.5682254428568214,132,130,133,139,6,7,9,84.25912849561097,13,148.01320733234658,-0.7639538432790386,-0.6345032456055418,-0.515676669331381,1.5475307543996975,8619,8783,Lyon and Nearby Counties,Lyon,21,143,Kentucky,KY
21221,21CS036,152,146,158,196,38,44,50,369.463392137311,6,50.81874647092039,2.664618374280544,3.1730522710496905,3.7147840808724064,0.13446489678018866,187,180,194,258,64,71,78,501.988921903764,25,176.37928601665018,2.7430440113776475,3.2695647223782154,3.754772882774776,0.3464911749743224,14168,14174,Lyon and Nearby Counties,Trigg,21,221,Kentucky,KY
21145,21CS037,703,674,732,795,63,92,121,163.91194931921368,76,135.1651771819839,-0.2497065561110058,0.29974526067373986,0.810510720233443,0.8157693250837222,856,821,891,1006,115,150,185,221.7042838184849,109,161.45756184268998,0.09695781098879848,0.6178708441396304,1.1142923858118647,0.7234230210790559,67473,67510,McCracken,McCracken,21,145,Kentucky,KY
21155,21CS038,189,180,197,232,35,43,52,266.4761419551775,27,165.77129700690713,0.4976934177137569,1.0145215104423897,1.5046327063421172,0.6080765864457142,233,223,243,256,13,23,33,117.46369517679487,30,152.2533495736906,-0.8783909862955697,-0.34459910809343886,0.17768608397130678,1.242490877080633,19545,19704,Marion+Nelson+Washington,Marion,21,155,Kentucky,KY
21179,21CS038,388,368,408,441,33,53,73,136.4812713235047,36,92.47762983259835,-0.08956308053824423,0.43467339328808713,0.9472293247747802,0.6650670051585186,480,456,505,618,113,138,162,292.75213722586517,87,184.9175310321374,0.5676725210858078,1.075893260941578,1.596026459444264,0.627099225821773,46714,47048,Marion+Nelson+Washington,Nelson,21,179,Kentucky,KY
21229,21CS038,130,125,136,150,14,20,25,195.32367733986558,27,269.10299003322257,-1.2694405292846553,-0.7377237021363788,-0.25544082901617315,1.3108402451682148,160,154,166,151,-15,-9,-3,-73.82644505229686,18,149.1918773311231,-2.765369575009603,-2.2200101784866835,-1.7235404335898676,-2.2764176574468675,12040,12065,Marion+Nelson+Washington,Washington,21,229,Kentucky,KY
21185,21CS039,376,347,405,424,19,48,77,84.76845955736363,50,88.71802454532013,-0.5204205250729714,-0.05763075012437076,0.4624562990024275,1.0251344305147074,473,437,508,486,-22,13,49,19.57606625110423,37,53.98858943866458,-0.864451311592762,-0.36446872903335575,0.13460440147066455,2.5665810162558467,67630,68533,Oldham,Oldham,21,185,Kentucky,KY
21041,21CS040,120,119,121,122,1,2,3,26.651234595077206,13,144.2974747941911,-1.294183174840949,-1.1765880843490562,-1.0559688698849619,3.8223443238171413,147,145,148,154,6,7,9,66.99928316597244,23,211.80587531080212,-1.566342538688958,-1.4510812970509341,-1.331399806680804,2.779304327801093,10811,10859,Owen and Nearby Counties,Carroll,21,41,Kentucky,KY
21077,21CS040,86,85,87,100,13,14,15,196.2639945915999,11,151.65441176470588,0.33025412845359997,0.44603699585865714,0.5613327526890035,0.7219893528207953,105,104,107,120,13,15,16,165.86331527703172,23,262.58705331658865,-1.0856829508209191,-0.9647960808717913,-0.8391208163486489,1.4811983331165415,8704,8759,Owen and Nearby Counties,Gallatin,21,77,Kentucky,KY
21081,21CS040,208,197,219,227,8,19,30,90.52361397708036,13,62.27793524691604,-0.26478798112326657,0.27475218813702673,0.7913114920013902,0.6533960240622132,254,241,267,321,54,67,80,264.13010237481546,36,142.80047600158667,0.7040864543357858,1.2156101714909506,1.7293955066331077,0.5326452439891738,25049,25210,Owen and Nearby Counties,Grant,21,81,Kentucky,KY
21187,21CS040,105,104,106,133,27,28,29,295.600757198782,11,117.50044507744349,1.6681916517408197,1.777709967169021,1.8994812873034943,0.38363406540182593,129,128,131,160,29,31,32,270.71818400502474,18,159.37666017354348,0.993675401699715,1.1125975827533436,1.2320624482499016,0.5700728530977718,11234,11294,Owen and Nearby Counties,Owen,21,187,Kentucky,KY
21223,21CS040,87,86,87,98,11,11,12,162.72406421081035,11,155.6970983722576,-0.050200811070333126,0.07011673777644331,0.19658027189170635,0.8802496291829505,106,105,107,147,40,41,42,478.73221994009344,25,293.42723004694835,1.7244152837555387,1.8539203113875127,1.9789666084372641,0.5982580858326709,8478,8520,Owen and Nearby Counties,Trimble,21,223,Kentucky,KY
21195,21CS041,682,657,707,781,74,99,124,204.3020096194396,47,96.85562672803147,0.5719596983647468,1.0955438690402872,1.5850193736000782,0.46934642250667974,824,794,854,1076,222,252,282,438.08774405498457,160,278.0722640296147,1.076811324716576,1.6029180103875231,2.0952630337173384,0.6322328748523508,58231,57539,Pike,Pike,21,195,Kentucky,KY
21199,21CS042,710,682,738,814,76,104,132,190.94500901527505,66,121.67393842561297,0.16815829268267699,0.6888953107073653,1.2171589835175223,0.6311263619825853,870,836,903,1042,139,172,206,263.6191273302004,165,252.4325316688085,-0.3840966655442479,0.11909252465859091,0.6495277494915922,0.9520402160165499,65092,65364,Pulaski,Pulaski,21,199,Kentucky,KY
21209,21CS043,377,352,402,389,-13,12,37,25.298755712204063,23,48,-0.7172316043209028,-0.22443101424941309,0.2978460379992268,1.7527387854644307,470,440,500,559,59,89,119,152.81182195658994,51,87.7208070314247,0.1540118033979274,0.65246412567614,1.1425130523575162,0.5676552372067905,57500,58139,Scott+Woodford,Scott,21,209,Kentucky,KY
21239,21CS043,220,209,232,237,5,17,28,74.75264155053901,6,26.789700848340527,-0.03106494805793205,0.4631899592354344,0.9514528354381813,0.3381786832465639,272,258,286,301,15,29,43,107.30878002594557,31,114.61106181603076,-0.6268864498230811,-0.08480664839156983,0.4569656057292625,1.0324771062152183,26876,27048,Scott+Woodford,Woodford,21,239,Kentucky,KY
21007,21CS044,91,90,91,96,5,5,6,84.68290640607468,6,93.08338720103426,-0.2047379842696066,-0.0807682334112792,0.039673876358410166,0.9290055493935305,111,110,112,134,22,23,24,297.0141304067338,24,311.72879594752567,-0.2758966436986557,-0.1471866614215215,-0.014409372809982411,1.005567580490541,7735,7699,Southwest Kentucky,Ballard,21,7,Kentucky,KY
21039,21CS044,63,62,63,69,6,6,7,161.01043061646178,4,100.0834028356964,0.49816278457902835,0.6045735649560323,0.7265251718183557,0.5379923318414461,77,76,78,107,29,30,31,625.6074283440879,10,208.59407592824365,4.047633092382521,4.1678997078779725,4.288760296366478,0.3226678683770872,4796,4794,Southwest Kentucky,Carlisle,21,39,Kentucky,KY
21075,21CS044,86,86,87,111,24,25,25,460.76163833888234,19,354.7533841605726,0.9394601212251641,1.061219425022955,1.1922622559035487,0.7399438107742407,108,107,108,125,17,17,18,266.8892761715331,14,215.05376344086022,0.38907669677476,0.5218459969438993,0.6482100924990031,0.7619258313302324,6427,6510,Southwest Kentucky,Fulton,21,75,Kentucky,KY
21083,21CS044,394,379,410,471,61,77,92,250.7384770572348,66,216.28116551516968,-0.17799659172882057,0.33773224162083,0.859441877681778,0.8514488124355851,485,466,504,578,74,93,112,254.9794588944371,52,142.07650273224044,0.627243502015482,1.1162378832307334,1.6394140486292823,0.5513001664291218,36619,36600,Southwest Kentucky,Graves,21,83,Kentucky,KY
21105,21CS044,57,56,57,76,19,19,20,514.6252784084751,7,187.1657754010695,3.1578682753898275,3.2775715508671985,3.40092665767818,0.3457304807305453,69,69,70,72,2,3,3,64.66347043666683,11,247.85939612438037,-1.9471469799068628,-1.8354468300304327,-1.709438341169115,2.8425500043033662,4488,4438,Southwest Kentucky,Hickman,21,105,Kentucky,KY
21025,21CS045,176,171,182,183,1,7,12,58.368108492256155,7,62.1761658031088,-0.5280783635310042,-0.03306025036698158,0.4862627268651092,0.9245469061963665,216,209,223,277,54,61,68,447.6515367289412,47,346.32672610714025,0.4652260263684598,1.0179025990487387,1.5526092581660087,0.7611238651738073,13510,13571,Wolfe and Nearby Counties,Breathitt,21,25,Kentucky,KY
21129,21CS045,94,94,95,124,29,30,30,480.284046138159,16,260.3742880390561,2.079903820449766,2.2043950006009694,2.3203263577217195,0.5243588505887458,117,116,118,150,32,33,34,443.0169017324665,22,295.778435063189,1.353749182438437,1.4782912856752917,1.6010449502630335,0.6479812982654389,7374,7438,Wolfe and Nearby Counties,Lee,21,129,Kentucky,KY
21165,21CS045,73,72,74,80,6,7,8,135.4607537416232,5,97.13453132588634,0.25906734127392944,0.38083666891111945,0.5143478779750705,0.6271289224824081,90,89,91,127,36,37,38,601.0762865643128,22,355.8718861209964,2.32202472573789,2.449511583351059,2.579249625977687,0.5765420345158697,6177,6182,Wolfe and Nearby Counties,Menifee,21,165,Kentucky,KY
21175,21CS045,132,130,133,138,5,6,8,54.07236311138958,7,61.457418788410884,-0.19361771706204114,-0.07609349648674954,0.05049027161393447,0.9778117529520923,164,162,166,183,17,19,21,137.1708857291074,19,137.63129300977906,-0.13120057619559053,-0.006507974407781923,0.12683254725534904,0.9530286882459932,13668,13805,Wolfe and Nearby Counties,Morgan,21,175,Kentucky,KY
21197,21CS045,169,163,174,163,-11,-6,-0,-52.421265227880156,5,46.23921085080148,-1.5326425391717724,-0.9930531736616148,-0.47061384079290597,-1.071010996486956,208,202,215,218,3,10,16,73.38201876586159,19,144.7508761237239,-1.2199212504005923,-0.7300045652289296,-0.20679117621733648,1.7870371326949492,12976,13126,Wolfe and Nearby Counties,Powell,21,197,Kentucky,KY
21237,21CS045,86,85,87,102,15,16,17,290.3164978234855,4,72.3436322532027,2.0564312105142717,2.1805151950552277,2.313503233004046,0.23457544711813919,104,103,104,164,60,60,61,926.9428901636137,11,168.86705557261283,7.468193364147204,7.5758530985652,7.699564698346892,0.17920837509399368,6635,6514,Wolfe and Nearby Counties,Wolfe,21,237,Kentucky,KY
22001,22CS001,529,504,554,770,216,241,266,497.90404670848693,134,276.6166073179543,1.7097391583217247,2.2047149322087782,2.7594425900589714,0.5532682367939532,646,617,676,882,206,236,265,411.05811817763987,83,144.821328866555,2.1641805908857865,2.6596708048308253,3.147759772689168,0.35082435251706023,58131,57312,Acadia +Jefferson Davis,Acadia,22,1,Louisiana,LA
22053,22CS001,342,329,356,365,9,23,36,84.51690035068334,56,209.4828392406247,-1.7644421506936292,-1.23581029585842,-0.7794860664678064,2.3735370569848024,423,407,440,515,75,92,108,283.84042475168326,66,204.2142393019586,0.2947595949301305,0.7918001464123621,1.2975942946011163,0.7117101026247188,32079,32319,Acadia +Jefferson Davis,Jefferson Davis,22,53,Louisiana,LA
22003,22CS002,206,196,215,320,105,114,124,593.8451372639074,53,275.1103036594861,2.628132216075955,3.181936667501417,3.6781987727410783,0.45925512095524934,250,238,261,339,78,89,101,393.3467235176272,39,171.89703808180536,1.7002254177463285,2.2234160533686165,2.743583659827857,0.4321688561191509,23118,22688,Allen+Evangeline,Allen,22,3,Louisiana,LA
22039,22CS002,315,301,329,416,87,101,115,373.15323261047473,57,210.7468572837072,1.0917206024970307,1.6268379829914918,2.129950753855215,0.5592319278257892,384,368,401,490,89,106,122,327.5273862546884,78,242.0255678292168,0.363052031250144,0.8572608707249605,1.3818182909959433,0.7320127157847978,32456,32228,Allen+Evangeline,Evangeline,22,39,Louisiana,LA
22005,22CS003,655,601,710,841,131,186,240,175.26282000134623,116,109.51920126513559,0.15131626772952964,0.6556994445008537,1.1052426972027252,0.621537349205298,821,755,887,1009,122,188,254,146.65627660349386,115,89.72668471603455,0.07813017152350916,0.5601329870350444,1.093561385402828,0.6085784690709304,127101,128167,Ascension,Ascension,22,5,Louisiana,LA
22007,22CS004,180,171,189,226,37,46,55,260.1954302149822,24,136.63535439795046,0.7091933487058656,1.232962949781441,1.7341475097618932,0.5138820160920218,219,208,230,325,95,106,117,512.1867232899878,31,149.54172696575012,3.1060072576723625,3.632235671804824,4.152807953512997,0.2892430300526632,21078,20730,Assumption+St.James+St.John the Baptist,Assumption,22,7,Louisiana,LA
22093,22CS004,167,158,176,210,34,43,52,255.3013450564505,38,225.5081351070669,-0.17816991526023201,0.3194148157269091,0.8327990350785416,0.8632360545290397,202,192,212,254,42,52,62,262.78809677061025,21,106.07132033538741,1.0296565723041877,1.5649892792585105,2.0930451921954853,0.39602625446882067,20221,19798,Assumption+St.James+St.John the Baptist,St. James,22,93,Louisiana,LA
22095,22CS004,349,331,367,440,73,91,109,257.12281651904107,91,257.3954036535062,-0.5382308647315857,0.002165666868158771,0.5019284584202374,0.9901676451831652,427,406,449,476,27,49,70,115.46421082016145,43,102.04565949973896,-0.39079582857209655,0.11854695294885702,0.6705943486975144,0.8659872774672164,42425,42138,Assumption+St.James+St.John the Baptist,St. John the Baptist,22,95,Louisiana,LA
22009,22CS005,410,393,427,526,99,116,133,350.86734912301046,71,214.8639447204499,0.8081421872730188,1.382381404953636,1.8801531796011117,0.6071427784729463,500,480,520,627,107,127,147,323.64005193375016,75,190.88340841414063,0.8319546304821626,1.3250181830544636,1.8391725590987982,0.5851995414091161,39653,39291,Avoyelles+East Feliciana+Pointe Coupee+West Feliciana,Avoyelles,22,9,Louisiana,LA
22037,22CS005,219,210,227,278,51,59,68,366.37797060541664,67,414.6894986589642,-0.9795567589223355,-0.4898783250672364,-0.031782868923133756,1.1130591038909954,268,258,278,293,15,25,35,131.03566456434285,38,196.34184147979744,-1.1937357967146476,-0.6474152603811496,-0.16134269635598358,1.44154301138457,19388,19354,Avoyelles+East Feliciana+Pointe Coupee+West Feliciana,East Feliciana,22,37,Louisiana,LA
22077,22CS005,211,202,220,281,61,70,79,403.79683903516263,45,259.52804344691685,0.9562075837734445,1.4493329962186854,1.9373776958073181,0.6336688814779305,255,245,266,327,61,72,82,351.6302811289066,27,132.32050967900025,1.6863159632397493,2.19633676211191,2.7460792045419384,0.37113321017405565,20807,20405,Avoyelles+East Feliciana+Pointe Coupee+West Feliciana,Pointe Coupee,22,77,Louisiana,LA
22125,22CS005,120,118,121,149,28,29,31,230.52997036863985,26,203.56234096692108,0.15025903128435023,0.26698985819287885,0.39149117669433287,0.8540147101604586,149,147,151,168,17,19,21,124.20462104533729,14,90.56213209133837,0.21190462865265067,0.33632943121656683,0.45955870704363583,0.6930421215849969,15327,15459,Avoyelles+East Feliciana+Pointe Coupee+West Feliciana,West Feliciana,22,125,Louisiana,LA
22011,22CS006,323,307,339,423,84,100,116,327.0730946809682,54,176.4177397838338,1.010100858366369,1.4877015373223226,2.037481202421076,0.5340488339076624,396,377,415,468,53,72,91,197.8249014797593,75,205.01886173527967,-0.5748855537194795,-0.07466035396846074,0.44265560466867787,1.0222397741158007,36731,36582,Beauregard +Vernon,Beauregard,22,11,Louisiana,LA
22115,22CS006,348,327,369,463,94,115,136,283.70054503653165,63,155.88593108852092,0.8067318444253464,1.26917844334416,1.8101880214029615,0.5447225369087576,427,402,451,490,39,63,88,131.73053866054246,75,155.89922673983537,-0.7642026640701728,-0.25231620448129477,0.2759490805504391,1.1650860519708168,48497,48108,Beauregard +Vernon,Vernon,22,115,Louisiana,LA
22013,22CS007,163,157,168,223,55,60,66,558.1846120690074,44,408.1948202551218,0.9700934125051496,1.4929415596331308,1.9843889486769386,0.7193344890164407,197,190,204,264,60,67,74,524.2374665530499,30,234.4849148038143,2.3810332297514174,2.896238393081451,3.4164823509868802,0.44071668985025214,12935,12794,Bienville+Natchitoches+Red River,Bienville,22,13,Louisiana,LA
22069,22CS007,340,324,356,424,68,84,100,268.0774935646511,51,163.47900416711184,0.5421057616768501,1.0354209145469695,1.538525653919851,0.6026143389739057,415,396,434,533,99,118,137,319.08761679138775,72,194.2114207104901,0.7223549647561023,1.2467436650391819,1.7490796948545515,0.6035440500275644,37436,37073,Bienville+Natchitoches+Red River,Natchitoches,22,69,Louisiana,LA
22081,22CS007,83,82,84,139,55,56,57,871.4476252550635,27,419.47177628171926,4.392584607982914,4.517719985973718,4.647676846443668,0.47291941841614044,100,99,101,135,34,35,36,467.2468590533694,19,250.9244585314316,2.0344442943687207,2.162595594761802,2.2794334401832526,0.5222659545517956,7724,7572,Bienville+Natchitoches+Red River,Red River,22,81,Louisiana,LA
22015,22CS008,934,879,989,1132,143,198,253,185.02116980460454,169,157.8332944197992,-0.2839269766892934,0.26600043885738456,0.7966440967020724,0.8487710150626879,1155,1089,1222,1379,157,224,290,173.3296960829706,142,110.02037701348911,0.12760251349646065,0.6245230251475551,1.1366679082174422,0.6319215467217673,128490,129067,Bossier,Bossier,22,15,Louisiana,LA
22017,22CS009,2263,2161,2365,3042,677,779,881,394.29680623906955,463,234.29691947624772,1.103296583201349,1.5918111729400037,2.115515182680834,0.5934529631590857,2735,2615,2856,3398,542,663,783,283.6711045822131,409,175.033166431292,0.5941437767009251,1.071637362977467,1.5759443983647445,0.6160990723949126,237135,233670,Caddo,Caddo,22,17,Louisiana,LA
22019,22CS010,1840,1748,1932,2226,294,386,478,217.05196008182585,269,151.229087706312,0.14722242840372682,0.6486540025321882,1.1690888060090154,0.6949414259460696,2181,2074,2288,2454,166,273,380,132.01682487760556,327,158.0427827129228,-0.8055344367380564,-0.25976722483675935,0.2432035749709515,1.192774493048542,213451,206906,Calcasieu,Calcasieu,22,19,Louisiana,LA
22023,22CS011,37,36,38,61,23,24,25,501.3021272174442,3,62.489151189029684,4.264267552320255,4.3883196006539675,4.512695865895687,0.11968078919826369,41,40,41,52,11,11,12,218.28571760121278,3,58.15080441946114,1.4801638138342252,1.6039990767378387,1.7224683562378067,0.24467106080808773,5761,5159,Cameron +Vermilion,Cameron,22,23,Louisiana,LA
22113,22CS011,479,454,504,639,135,160,185,333.22277401132436,65,135.3861107736101,1.4890306241306812,1.9653668781595357,2.4868889913848435,0.40376926520640216,587,557,616,778,162,191,221,334.18124537816357,84,146.81208053691276,1.40638902595823,1.8718989609290462,2.357249273851876,0.43703305441036117,57613,57216,Cameron +Vermilion,Vermilion,22,113,Louisiana,LA
22021,22CS012,104,103,105,125,20,21,22,260.56511269210995,23,285.7142857142857,-0.37800060838456473,-0.25125176067998223,-0.12899178245378248,1.0466205010678264,126,125,128,158,30,32,33,330.6011884773859,16,167.04948841094173,1.5153472882667984,1.636125287471414,1.761884565883003,0.4898211816590517,9660,9578,Catahoula and Nearby Parishes,Caldwell,22,21,Louisiana,LA
22025,22CS012,97,97,98,140,42,43,43,571.4290998085468,22,295.26898557208364,2.634342835458199,2.7593335018671046,2.8897792934538318,0.5048624004027712,118,117,119,147,28,29,30,333.37887762448975,25,283.67184840576425,0.36391747037030475,0.4972982042232422,0.6228053461710518,0.8228913770481634,8941,8813,Catahoula and Nearby Parishes,Catahoula,22,25,Louisiana,LA
22029,22CS012,198,190,206,258,52,60,68,383.40107921405485,43,276.3348149734911,0.5593487639775212,1.057337561801222,1.5957835183585993,0.7088643978558562,239,229,248,295,47,56,66,305.8630393851474,30,162.9814744390721,0.9125786783067821,1.4359847371684678,1.9553894887596521,0.5235582937341179,18673,18407,Catahoula and Nearby Parishes,Concordia,22,29,Louisiana,LA
22059,22CS012,143,137,149,175,26,32,38,259.5424931612653,25,202.30629172567265,0.025327141217232067,0.5749846519640927,1.0595933529021098,0.7559044392907786,174,167,182,199,17,25,32,166.0309522363648,19,128.11003978153866,-0.1277980531391767,0.35741829598513813,0.8994362163433153,0.7414908888269354,14829,14831,Catahoula and Nearby Parishes,La Salle,22,59,Louisiana,LA
22107,22CS012,45,45,46,71,25,26,26,743.5904519859195,6,173.99710004833253,5.584549179587207,5.69393036730072,5.81157718295972,0.22521273522354052,54,54,55,85,30,31,31,754.2736742100853,6,148.00197335964478,5.933221760739077,6.06586886049649,6.186539274714498,0.19000416733066564,4138,4054,Catahoula and Nearby Parishes,Tensas,22,107,Louisiana,LA
22027,22CS013,150,144,156,202,46,52,58,436.0503724500445,40,334.8214285714286,0.46047865144507505,1.03756858970889,1.4874706808644993,0.7533881111813582,180,173,188,202,14,22,29,153.96776626358005,23,163.7243735763098,-0.6029465918789796,-0.10173160814836614,0.40691297253037334,1.0163772936758813,14336,14048,Claiborne+Webster,Claiborne,22,27,Louisiana,LA
22119,22CS013,416,401,432,564,132,148,163,478.6127722727605,77,249.68923958277037,1.8042975236082595,2.3250621816859582,2.8093569018365874,0.5181828264606929,499,480,517,698,181,199,218,549.1719697150896,74,203.95226414574316,2.928786803272438,3.4435709640908967,3.96462671501882,0.36952688406629036,37006,36283,Claiborne+Webster,Webster,22,119,Louisiana,LA
22031,22CS014,256,245,268,310,42,54,65,238.97091016700125,53,236.02761077710977,-0.496977778025528,0.026155746996513757,0.5159454360328615,0.9696141604920137,314,300,328,376,48,62,76,230.76049308186916,57,211.81716833890746,-0.3242960898788244,0.20061269273507554,0.7087078145812897,0.9033617129150066,26946,26910,De Soto+Sabine,De Soto,22,31,Louisiana,LA
22085,22CS014,222,212,231,339,108,117,127,628.4103393350007,48,257.38415478797083,3.1995459007892544,3.7116897074355615,4.223852015161358,0.40611441967108075,270,258,281,374,93,104,116,471.1901871707974,51,230.42515700537658,1.8943337214561877,2.4042851293612246,2.949386643555348,0.48438327370530354,22379,22133,De Soto+Sabine,Sabine,22,85,Louisiana,LA
22033,22CS015,3381,3185,3576,4176,600,795,991,210.45622258263785,522,138.12172969683337,0.17968565079504512,0.7217330875639164,1.267052086252254,0.6554726169860553,4155,3921,4389,5069,680,914,1148,201.4098998977919,538,118.58631011422197,0.30464415697954494,0.819546835164175,1.3133804379048564,0.5881372890326828,453513,453678,East Baton Rouge,East Baton Rouge,22,33,Louisiana,LA
22043,22CS016,186,177,196,235,39,49,58,263.58463723640955,38,205.65552699228792,0.042184535845227,0.5843220833437018,1.0833935691606793,0.7645282804337307,229,218,241,282,41,53,64,237.34317750165778,33,148.5148514851485,0.35030522814114534,0.8842411816597257,1.369105194088093,0.61409454113689,22173,22220,Grant+Jackson+Winn,Grant,22,43,Louisiana,LA
22049,22CS016,156,150,163,200,37,44,50,348.6543077697559,17,135.18886679920476,1.6291922998231505,2.139183753176035,2.6643898628209857,0.3790980566654024,189,181,197,224,27,35,43,235.12088482348335,16,107.44023636852002,0.7164470519968329,1.282380204003456,1.822823885017921,0.4442691781814676,15090,14892,Grant+Jackson+Winn,Jackson,22,49,Louisiana,LA
22127,22CS016,148,142,154,210,56,62,68,538.8637111699917,29,253.4226623944072,2.371475731918135,2.880851003633413,3.376587824392527,0.4627858669756646,179,172,186,211,25,32,39,239.08258656995253,21,155.30247004880934,0.3176380725047461,0.8559168574696877,1.3621101998116598,0.6300866868981327,13732,13522,Grant+Jackson+Winn,Winn,22,127,Louisiana,LA
22045,22CS017,621,591,651,802,151,181,211,311.7071889410811,81,139.5869833701927,1.2016402629742589,1.7288196193775525,2.2163274455946027,0.44535228714561625,757,721,792,928,136,171,207,247.94624539821058,100,144.75131723698684,0.5372694853493732,1.014707165329662,1.5479959572740356,0.5804127499687249,69634,69084,Iberia,Iberia,22,45,Louisiana,LA
22047,22CS018,260,247,273,393,120,133,146,523.1849484327468,56,220.87099424815116,2.5467989150092034,3.013690779306465,3.5081722556916923,0.419007422324179,313,298,329,435,106,122,137,408.07113126914015,54,180.81971604607554,1.795297820482142,2.270659546712262,2.80548230374482,0.43950190140524253,30425,29864,Iberville+West Baton Rouge,Iberville,22,47,Louisiana,LA
22121,22CS018,185,174,197,249,52,64,75,280.3938982365403,40,176.50952415974112,0.4900347591121881,1.0368621757126006,1.5646886998284208,0.6197521463253215,231,217,245,285,40,54,68,195.4691648391455,26,93.82555663815813,0.5365360437927119,1.0243535191836943,1.4929204999645105,0.4713008569594657,27194,27711,Iberville+West Baton Rouge,West Baton Rouge,22,121,Louisiana,LA
22051,22CS019,3648,3459,3836,4495,659,847,1036,231.9043849069491,592,162.0567335439645,0.19067377154641435,0.6918234072522221,1.1993014474914956,0.697984491348228,4445,4220,4669,5112,443,667,892,153.55468553978656,415,95.49318201690805,0.08428072208905497,0.5691956714385105,1.0659793854932775,0.6209533613157441,438365,434586,Jefferson,Jefferson,22,51,Louisiana,LA
22055,22CS020,1537,1433,1642,1930,288,393,497,194.23966049650255,134,66.27074566952822,0.786637972267554,1.278126994144055,1.7967432422294176,0.34031381976963015,1911,1785,2037,2416,379,505,631,207.03495127258606,184,75.44570369519936,0.811496324857877,1.3109979478683456,1.8156129902628677,0.36369018362982114,242641,243884,Lafayette,Lafayette,22,55,Louisiana,LA
22057,22CS021,767,725,809,953,144,186,228,228.53932474181184,132,162.43821400004103,0.17503049652501992,0.6591125309173479,1.1707334259934776,0.7069603189510069,944,894,995,1215,220,271,321,277.70780682038367,150,153.8414202639919,0.7083597081895776,1.2421022706220215,1.7550493472419784,0.551930307863011,97514,97503,Lafourche,Lafourche,22,57,Louisiana,LA
22061,22CS022,344,323,364,437,73,93,114,232.79016176639084,68,169.84784463917742,0.07093388495676252,0.6278970776836271,1.1178161156888453,0.7218723409867243,426,401,451,490,39,64,89,133.10177566837174,33,68.51021425012456,0.12247306079531194,0.6565757032790804,1.1975486225465244,0.5068154132943469,48043,48168,Lincoln+Union,Lincoln,22,61,Louisiana,LA
22111,22CS022,225,216,234,351,117,126,135,712.231778237117,52,293.53655094552636,3.678751340959547,4.187356419679131,4.721265250483364,0.4088954914902936,274,263,285,350,65,76,87,359.6015323897989,34,161.16799393249906,1.461740748180962,1.9965737094809963,2.49074709493773,0.44235387843663443,21258,21096,Lincoln+Union,Union,22,111,Louisiana,LA
22063,22CS023,957,895,1018,1142,124,185,247,155.45434766583057,119,99.94470845960566,0.042986942212261965,0.5524556768901107,1.081932456714304,0.6394651637996916,1199,1124,1274,1590,316,391,466,269.04025480456045,250,171.96667973613432,0.4283860877219932,0.9623130910356658,1.4831510249297355,0.6375556199509906,142879,145377,Livingston,Livingston,22,63,Louisiana,LA
22035,22CS024,76,75,77,82,5,6,7,101.72491041300934,19,312.97185998627316,-2.2321243824348764,-2.1129436259170866,-1.9874928961088305,2.6478807352638154,93,92,93,116,23,23,24,323.306504401638,19,262.2860298177802,0.47717269989518407,0.610046172434389,0.731110199950377,0.7780404813172961,7285,7244,Northeast Louisiana,East Carroll,22,35,Louisiana,LA
22041,22CS024,228,220,236,286,50,58,66,352.31662938438643,55,334.07572383073494,-0.3334484449268161,0.19564297731457295,0.703242872854165,0.932155027031636,278,268,288,314,26,36,46,181.83966511571256,46,233.7873551534865,-1.0156474138612486,-0.5248824516054135,-0.016080876622069997,1.2507214586833915,19756,19676,Northeast Louisiana,Franklin,22,41,Louisiana,LA
22065,22CS024,101,100,102,118,16,17,18,201.64328724150639,18,214.51981328831062,-0.24918563540449037,-0.12911948339491608,-0.010606219127712889,1.0044893889641326,121,120,122,147,25,26,27,264.17129971285584,32,325.9319617029945,-0.7368773782675992,-0.6207923450392628,-0.4906061793109082,1.187986271760575,10069,9818,Northeast Louisiana,Madison,22,65,Louisiana,LA
22067,22CS024,314,304,325,405,80,91,101,429.3428461036093,44,208.67915579796065,1.6708010529597423,2.205248394309977,2.730972049303613,0.4807327813232335,381,368,394,505,111,124,137,495.3815882896169,62,247.16951044490514,1.956156928589985,2.4802241231283753,2.9893198103447443,0.4949644646230066,25302,25084,Northeast Louisiana,Morehouse,22,67,Louisiana,LA
22083,22CS024,197,189,206,250,44,53,61,317.0849939274545,45,270.01350067503375,-0.048844757838435615,0.4552287496465187,0.9808769570849454,0.8357344197880014,240,230,251,303,52,63,73,316.0457279228924,42,211.76826501285734,0.5598473392498365,1.0568010691626648,1.565136158840881,0.6595337648327283,19999,19833,Northeast Louisiana,Richland,22,83,Louisiana,LA
22123,22CS024,121,116,125,156,31,35,40,430.5688634612144,35,425.96348884381337,-0.4959067312569091,0.02895372346092986,0.5613234965116345,0.9621091645787962,145,140,150,159,9,14,19,147.46169444762856,17,176.91747320220625,-0.7821367312624886,-0.28168040198266187,0.23038718186975138,1.12066280442609,9860,9609,Northeast Louisiana,West Carroll,22,123,Louisiana,LA
22071,22CS025,2785,2621,2950,3765,815,980,1144,306.30481439981446,548,171.35040062536643,0.8501144903825577,1.3486625069340001,1.906932446052786,0.558840907513511,3386,3191,3582,4069,487,683,878,180.61393151608686,261,69.06753534749438,0.6291207931319812,1.1297435509644949,1.6063386264578308,0.38184479176231434,383775,377891,Orleans,Orleans,22,71,Louisiana,LA
22073,22CS026,1396,1328,1465,1726,261,330,398,249.02018931506444,274,206.90696737817154,-0.08947017075965029,0.41903998519672925,0.9382427391910582,0.828372330268992,1712,1630,1794,2054,260,342,424,215.246105455993,282,177.41651357676724,-0.14409138685332373,0.3650112187760038,0.874079757075499,0.8218474333104225,158912,158948,Ouachita,Ouachita,22,73,Louisiana,LA
22075,22CS027,162,151,172,209,37,47,58,243.26217402386416,20,102.47651579846284,0.8824393662908945,1.4114941086956574,1.9367781617257962,0.41256961292217975,198,186,210,223,13,25,37,105.93971179952771,20,85.73755733699147,-0.33740701108763915,0.19369477536141586,0.7044830538764671,0.77783008252812,23420,23327,Plaquemines+St. Bernard,Plaquemines,22,75,Louisiana,LA
22087,22CS027,305,286,324,379,55,74,93,201.1274114199332,42,113.58770368033173,0.3387700295102077,0.8848761400273191,1.3866163602424233,0.5572617167194437,376,353,398,489,91,113,136,256.41015902178367,47,106.34205941579746,1.003727362573328,1.4904778832873298,2.0015709497951764,0.4111065310766823,44371,44197,Plaquemines+St. Bernard,St. Bernard,22,87,Louisiana,LA
22079,22CS028,1261,1205,1317,1626,309,365,421,337.9829658305689,211,195.46689723320156,0.8892924684615244,1.4122068630786568,1.9780347906037887,0.5767527442881969,1537,1471,1604,1973,369,436,502,338.1860403743353,241,187.12197091456832,1.0329773393392507,1.5130114700045183,2.0212002292505344,0.5520433142516796,129536,128793,Rapides,Rapides,22,79,Louisiana,LA
22089,22CS029,364,341,386,463,77,99,122,226.5556377477987,57,130.16670472710663,0.4151924425265853,0.9835717261110035,1.484721523142978,0.5688128093427369,449,422,476,502,26,53,80,102.03334303199104,43,82.20068436848847,-0.29081831136963016,0.20263403684638448,0.6732229416206966,0.7908095123773516,52548,52311,St. Charles,St. Charles,22,89,Louisiana,LA
22091,22CS030,111,110,112,136,24,25,26,282.33899659746527,3,33.385885189650374,2.3730522446338824,2.48774859645958,2.611404675803924,0.11376343537155488,137,136,139,172,33,35,36,317.6405329069112,19,174.16811806765057,1.3125314889821893,1.4336902703574081,1.5537143364946626,0.5329383122036555,10783,10909,St. Helena +Tangipahoa +Washington,St. Helena,22,91,Louisiana,LA
22105,22CS030,1102,1044,1159,1323,164,221,279,198.32302210572476,155,138.8971862118406,0.054712151043640564,0.59670060079681575,1.0865326391041639,0.6972080649635183,1369,1300,1439,1774,335,405,474,299.71377708617695,286,211.89266080874836,0.33019837293943866,0.9081679637103895,1.3931937463259698,0.7052400533416322,133912,134974,St. Helena +Tangipahoa +Washington,Tangipahoa,22,105,Louisiana,LA
22117,22CS030,510,490,529,630,101,120,140,316.9176601145248,79,208.53497580290363,0.5674508392636225,1.094926212432086,1.6255273898872602,0.6525745070200045,621,598,644,758,114,137,160,303.32423365857335,110,243.53524619199433,0.09963162325084074,0.5918145384429907,1.1114310836533583,0.7970697405767193,45460,45168,St. Helena +Tangipahoa +Washington,Washington,22,117,Louisiana,LA
22097,22CS031,857,822,892,1109,217,252,287,367.83678058258727,168,245.13320606510135,0.7110587506435951,1.231308719848512,1.7059576853959941,0.6637853318850205,1048,1006,1090,1249,159,201,243,244.78283275702995,122,148.59926918392205,0.4651161966448484,0.9692412378168334,1.4561871588236048,0.6040599591951128,82241,82100,St. Landry,St. Landry,22,97,Louisiana,LA
22099,22CS032,412,389,434,580,146,168,191,389.7412570247994,82,189.69406049389855,1.5002005813880972,1.9812772558510081,2.5146466099689455,0.48384602774313124,504,478,531,631,100,127,153,245.6283844306439,62,120.27391413994451,0.7330764728536977,1.2550383227961261,1.7839904480348026,0.4858211685804953,51873,51549,St. Martin,St. Martin,22,99,Louisiana,LA
22101,22CS033,465,444,486,589,103,124,145,303.112727632465,87,212.7659574468085,0.38316720107704766,0.9204709780861922,1.39009745176568,0.6963186670130843,562,537,587,717,130,155,180,319.66194837488064,112,231.57720618641966,0.39482455785160636,0.8877496492375808,1.3533520400127965,0.719788309020155,49068,48364,St. Mary,St. Mary,22,101,Louisiana,LA
22103,22CS034,2000,1886,2114,2355,241,355,469,160.7003491750888,259,117.34146820302944,-0.09643640677086898,0.4408148040885908,0.9483655364545068,0.728135208661451,2499,2360,2637,2956,319,457,596,170.1747689268432,307,114.23765898384299,0.04986808273551049,0.5622473713771935,1.0479827030009545,0.6698314266722383,264868,268738,St. Tammany,St. Tammany,22,103,Louisiana,LA
22109,22CS035,872,825,919,1054,135,182,229,199.19022034829732,116,127.188333759731,0.23372257854849943,0.725277579416906,1.229230246260965,0.6350314417144974,1068,1012,1125,1393,268,325,381,298.28078930615357,171,157.17345147384577,0.9253199985651537,1.4034129414501733,1.9110906404978096,0.5253124566809991,109444,108797,Terrebonne,Terrebonne,22,109,Louisiana,LA
23001,23CS001,1042,994,1089,1032,-57,-10,38,-10.48621912591232,23,24.943966452172653,-0.8587686473657494,-0.3573801726925104,0.10823321287566559,-2.6531339561489973,1282,1225,1339,1480,141,198,255,178.39680274212995,150,135.09253838879633,-0.08181353178364197,0.44541397377135705,0.9293718737625227,0.7534550058858251,110648,111035,Androscoggin,Androscoggin,23,1,Maine,ME
23003,23CS002,733,704,762,796,34,63,92,112.8038967664795,21,37.61530883362689,0.2545773760043115,0.7193706770538105,1.2767470195333215,0.32824534551534773,892,857,926,1107,181,215,250,321.5916993216806,94,140.5523407945693,1.2983544340927355,1.805945912284239,2.3626481025800476,0.43502947567034145,66994,66879,Aroostook,Aroostook,23,3,Maine,ME
23005,23CS003,2397,2267,2527,2469,-58,72,202,28.62555151364309,106,42.05612111633874,-0.665682327033136,-0.14781794370322462,0.35802885631614656,1.4490963993830939,2965,2807,3122,3102,-20,137,295,45.08446709102435,171,56.07458247390564,-0.6333912783118613,-0.09054959507548556,0.387501280917698,1.234786017000023,302453,304951,Cumberland,Cumberland,23,5,Maine,ME
23007,23CS004,295,283,308,285,-23,-10,2,-41.90605604751363,4,16.250253910217346,-1.090192577431835,-0.5676505897059329,-0.07864605373971462,-0.4294068228553786,364,349,379,410,31,46,61,155.59164168057785,40,134.91635186184567,-0.3061170682518971,0.21066869018281623,0.770837160859212,0.8487197394444302,29538,29648,Franklin+Oxford,Franklin,23,7,Maine,ME
23017,23CS004,583,558,608,608,0,25,50,52.26976809725018,32,66.27888913820185,-0.6127894360650563,-0.12216536560870529,0.3747524774802593,1.2196851255208836,721,691,752,849,97,128,158,217.95629570110958,91,155.51567974023754,0.11074528178301477,0.6342465917067535,1.1151378198745878,0.7079666593442061,57937,58515,Franklin+Oxford,Oxford,23,17,Maine,ME
23009,23CS005,534,510,558,575,17,41,65,88.40240300500382,27,58.39626552277274,-0.21210449616294733,0.3109655716004025,0.8443530344967793,0.6447978659742982,660,631,689,753,64,93,122,166.02750152490452,44,78.45234911295356,0.38000459360851907,0.8883587407680067,1.3749511164547488,0.4675055773666296,55483,56085,Hancock+Washington,Hancock,23,9,Maine,ME
23029,23CS005,362,349,376,429,53,67,80,257.2484253981378,2,7.716793672229189,1.9477360803362402,2.489595932004524,2.969591842964375,0.029554163335135133,442,426,458,530,72,88,104,282.6981977939356,38,122.13936744664437,1.0617371131784874,1.5981548311107514,2.085753461092021,0.42719158386762635,31101,31112,Hancock+Washington,Washington,23,29,Maine,ME
23011,23CS006,1153,1100,1206,1193,-13,40,93,39.00118857827015,34,33.0070382655125,-0.44153344493459523,0.059406112878403694,0.5732280394966793,0.8257543186501357,1418,1354,1483,1629,146,211,275,169.29927678315528,124,99.69528618175094,0.2143165449613398,0.6837587222600036,1.1712039260705458,0.5860868258446749,123610,124379,Kennebec,Kennebec,23,11,Maine,ME
23013,23CS007,436,419,454,390,-64,-46,-29,-137.53216152518343,5,14.80056242137201,-2.017100508799491,-1.5235780116107722,-1.032131814937199,-0.10998244083266308,538,517,560,539,-21,1,22,1.2301430490475815,19,46.32451542118737,-0.9333219844138037,-0.44100135260629214,0.07082036681325289,12.628417953745366,40539,41015,Knox+Waldo,Knox,23,13,Maine,ME
23027,23CS007,357,340,374,388,14,31,48,92.78428795361391,20,60.48234671505254,-0.18919780667161784,0.31511805762969247,0.8318921646374835,0.6312843485118032,440,419,461,529,68,89,110,223.2497076787028,32,80.25682182985554,0.905860859884466,1.420373975594779,1.9082089837518939,0.3554997679816386,39681,39872,Knox+Waldo,Waldo,23,27,Maine,ME
23015,23CS008,355,340,371,384,13,29,44,97.37285155005068,3,10.231923601637106,0.390681772475329,0.8573760456175403,1.376284481320995,0.10152380436901022,439,420,457,453,-4,14,33,39.74777794804896,18,50.37078494473206,-0.5939013759261187,-0.10956018270757521,0.37699123259318057,1.1839092175461032,35184,35735,Lincoln+Sagadahoc,Lincoln,23,15,Maine,ME
23023,23CS008,317,302,333,302,-31,-15,0,-50.20089490207949,3,9.826400262037339,-1.1136434717335082,-0.6009246045563837,-0.062015355055573894,-0.20940459469078088,391,372,410,437,27,46,65,125.31853964737718,21,56.73375658516817,0.16194993999002985,0.6893928114896977,1.1986763442784862,0.44316271984254,36636,37015,Lincoln+Sagadahoc,Sagadahoc,23,23,Maine,ME
23019,23CS009,1433,1368,1499,1529,30,96,161,75.65716750157588,34,26.831690330726886,0.013361432386809367,0.470178520950551,0.9957592970484173,0.350987269414229,1765,1687,1844,1999,155,234,312,152.98631348078976,211,138.22107511103542,-0.3272970204697021,0.14946624813254106,0.6355139791624366,0.8996343720359353,152059,152654,Penobscot+Piscataquis,Penobscot,23,19,Maine,ME
23021,23CS009,209,202,217,203,-14,-6,1,-45.81683172814307,4,28.527279210745277,-1.2394515313756853,-0.7476420638118773,-0.22327596036140274,-0.7374245939413253,260,251,269,302,33,42,51,246.3146698352109,36,210.44017069036065,-0.14809432685317897,0.35397741178426967,0.8635052701532775,0.8345494076526745,16826,17107,Penobscot+Piscataquis,Piscataquis,23,21,Maine,ME
23025,23CS010,523,501,545,559,14,36,58,85.87969650337557,19,45.17445661865229,-0.13687366866508302,0.40347232436265934,0.8993122294359788,0.5118495227377516,640,614,666,774,108,134,160,265.41619103799366,65,128.54741421932167,0.8198924951637394,1.4018615585463348,1.8894061522120071,0.48074186191328816,50471,50565,Somerset,Somerset,23,25,Maine,ME
23031,23CS011,1860,1769,1951,1901,-50,41,132,23.268408681940787,82,46.46989374262102,-0.7257255741013209,-0.22555472370658997,0.2752030237326579,1.949640029900811,2306,2195,2417,2367,-50,61,172,28.492410549798933,176,82.15622753540653,-1.0375519115885747,-0.5493440629652502,-0.05127064413644914,2.8369639642541524,211750,214226,York,York,23,31,Maine,ME
24001,24CS001,741,712,770,995,225,254,283,446.0974779717129,161,282.8655510168226,1.1196997491561624,1.6460614018949422,2.157445086372684,0.6316015800760817,900,865,935,1055,120,155,190,228.27159768713258,140,206.60852112572127,-0.3077103582264337,0.2164678390118542,0.7572103560042545,0.8992856744062883,68301,67761,Allegany+Garrett,Allegany,24,1,Maryland,MD
24023,24CS001,284,271,296,376,80,92,105,383.95285266735453,49,204.18793624335865,1.3250768669417177,1.7776726863486458,2.29636813468851,0.5260949210442427,347,332,361,396,35,49,64,172.10077362236413,56,195.0471944550869,-0.7283721482938307,-0.23856187976067764,0.25366746467337703,1.1108498604994084,28797,28711,Allegany+Garrett,Garrett,24,23,Maryland,MD
24003,24CS002,3871,3618,4124,4228,104,357,610,72.81237298218954,356,72.69781736375116,-0.5126913353098025,0.005988540989846515,0.5642151174490915,0.995634375519585,4800,4496,5105,4995,-110,195,499,32.9797322492276,412,69.8178465939228,-0.8948616129008813,-0.3541647372157084,0.16044723692579854,2.1061703223245387,587638,590107,Anne Arundel,Anne Arundel,24,3,Maryland,MD
24510,24CS003,5384,5133,5634,6749,1115,1365,1616,280.5048619211424,684,140.52051483100902,0.8366644650298235,1.4131560557927736,1.9198120321757128,0.5005890920108931,6540,6242,6839,7538,699,998,1296,172.73885200274677,604,104.59508368472548,0.17705670100638896,0.6866015972133406,1.168773082237542,0.6049034767448118,584114,577465,Baltimore (city),Baltimore (city),24,510,Maryland,MD
24005,24CS004,7313,6948,7679,8384,705,1071,1436,151.3197363427192,889,125.63905975628283,-0.24081029586782382,0.26949595212055705,0.7953702982976318,0.8295139198395466,8968,8530,9407,9467,60,499,937,58.677339084584915,863,101.54565907015711,-0.8977909361855066,-0.4428865151413768,0.07028932871842587,1.727113708418882,849099,849864,Baltimore (county),Baltimore (county),24,5,Maryland,MD
24009,24CS005,614,574,654,711,57,97,137,125.464113633141,52,67.1400903808909,0.09064248735185568,0.5811410654993938,1.0851110017788865,0.5296828352416949,765,717,814,860,46,95,143,100.80556457542777,61,65.05140127116836,-0.1592526695998624,0.35183616345403124,0.8641322776792104,0.6385602855582013,92940,93772,Calvert,Calvert,24,9,Maryland,MD
24011,24CS006,292,278,307,347,40,55,69,196.58456002129242,15,54.00216008640345,0.9187084676168833,1.4483621234092714,1.9415976043919358,0.2697616700979596,360,343,378,436,58,76,93,226.3249046215467,58,173.79839386311878,0.042080916928103694,0.5493218637101535,1.049278773286627,0.7578811752720946,33332,33372,Caroline+Dorchester+Talbot,Caroline,24,11,Maryland,MD
24019,24CS006,354,340,368,379,11,25,39,92.60935310733335,27,99.96297667530544,-0.6027625232934114,-0.08387214943535427,0.48505339634614664,1.0379111950605948,434,417,451,493,42,59,76,181.12945078463747,57,175.4277976117198,-0.4724671487787366,0.04670363314517808,0.5750420226607762,0.9523398808508241,32412,32492,Caroline+Dorchester+Talbot,Dorchester,24,19,Maryland,MD
24041,24CS006,391,375,407,458,51,67,83,214.88300857679909,1,3.2056419297964416,1.6067673121572856,2.10722252152356,2.6462561424835465,0.014698802172190502,481,462,501,556,55,75,94,198.93095103923534,52,138.294194303343,0.09078497566500793,0.5986136523965797,1.1416622350712406,0.6860155876781049,37434,37601,Caroline+Dorchester+Talbot,Talbot,24,41,Maryland,MD
24013,24CS007,1411,1337,1485,1557,72,146,220,101.50178640579392,178,123.90366142280385,-0.7400885713559535,-0.18615364728530942,0.2822411969220399,1.2123898090911085,1746,1656,1836,1887,51,141,231,81.12073162827325,132,75.97996891728545,-0.4885588905028026,0.059398006588279394,0.5582711325253338,0.9300290721186969,172392,173730,Carroll,Carroll,24,13,Maryland,MD
24015,24CS008,868,823,913,1040,127,172,217,199.1465218772572,93,107.65654090659154,0.3899046852402825,0.9182488598396856,1.484506104089213,0.5374654370313644,1071,1018,1125,1248,123,177,230,170.04105477407043,144,138.62015190458314,-0.14426446407188814,0.2942301165337338,0.7981034202863382,0.8106266483499063,103663,103881,Cecil,Cecil,24,15,Maryland,MD
24017,24CS009,992,920,1063,1223,160,231,303,166.7492286912634,153,110.29544280376302,0.05710003387482287,0.563844505360253,1.0712510844016114,0.658597765356317,1244,1157,1331,1476,145,232,319,137.55546481087958,160,95.00961972399706,-0.08677648841694227,0.4474306156958515,0.9645700885587357,0.6877315843263095,166462,168404,Charles,Charles,24,17,Maryland,MD
24021,24CS010,1720,1603,1838,1873,35,153,270,67.3598741976208,189,83.4719625480295,-0.6925850298195372,-0.1757647885504893,0.36058369840921933,1.2311222026751263,2172,2028,2316,2209,-107,37,181,13.356120837370014,205,73.52941176470588,-1.0945798308349,-0.5985653347161054,-0.1078141097587045,5.361318208622737,271708,278800,Frederick,Frederick,24,21,Maryland,MD
24025,24CS011,1913,1801,2025,2163,138,250,362,115.04230461401237,158,72.7805949122679,-0.1179101065836054,0.4222711850178966,0.9682939626661532,0.6301189744519992,2372,2236,2508,2606,98,234,370,89.02600307081381,231,87.93099510479395,-0.5319093595448793,0.00917755836107127,0.5418981679675213,0.9834949468141898,260509,262706,Harford,Harford,24,25,Maryland,MD
24027,24CS012,1522,1379,1665,1734,69,212,355,76.51826315619446,178,64.35227447329652,-0.37052208487884714,0.12746694698772185,0.6044903742765456,0.8370505712820431,1913,1741,2086,1994,-92,81,253,24.110500942707073,93,27.822236848009812,-0.5500272957013781,-0.03320767930022876,0.46287101431615046,1.1398041349201102,331923,334265,Howard,Howard,24,27,Maryland,MD
24029,24CS013,221,213,229,285,56,64,72,400.7237872117726,34,212.53320831379904,1.4021205016962055,1.8790305315816243,2.3804454998076605,0.5222269957553977,272,262,282,315,33,43,53,225.16582843412456,23,119.47431302270012,0.5215654701550697,1.05887427908067,1.5544224558691924,0.5186409287635851,19197,19251,Kent+Queen Anne's,Kent,24,29,Maryland,MD
24035,24CS013,380,359,402,392,-10,12,33,27.810359892444637,27,64.59845282717919,-0.8849489343977524,-0.36658818641023383,0.15691681177133082,2.1388165749404826,476,450,502,523,21,47,73,92.44011659637667,48,94.71378677558752,-0.5467538647764361,-0.019478666379598344,0.48928577332950873,1.0031824565273335,50156,50679,Kent+Queen Anne's,Queen Anne's,24,35,Maryland,MD
24031,24CS014,5402,4946,5857,6588,731,1186,1642,134.40016973034656,1118,126.67359078462846,-0.48419583504936,0.06413643852838448,0.5731595058740251,0.9417167478362778,6689,6143,7234,7012,-222,323,869,30.640030435001748,565,53.5157985267527,-0.7560694139340121,-0.24352253445450434,0.2832215673478308,1.7412147766179171,1059100,1055763,Montgomery,Montgomery,24,31,Maryland,MD
24033,24CS015,5499,5087,5912,7260,1348,1761,2173,220.85139838770678,1249,156.67204656258102,0.11100682884330984,0.6579812381547333,1.1390504268150867,0.7089975996237945,6813,6319,7307,7624,317,811,1305,84.78944645044831,734,76.71348558277688,-0.4988153288529631,0.08039899539648282,0.5690419089200515,0.9036389033767964,956648,956807,Prince George's,Prince George's,24,33,Maryland,MD
24037,24CS016,719,670,768,855,87,136,185,142.88577825641755,88,92.64864580317426,0.015440121841575595,0.5030108739451593,1.0171121012242985,0.6436678095528235,894,835,953,1051,98,157,216,136.98017387962236,89,77.80196340685183,0.070821869121233,0.5938544695310739,1.0902945962099373,0.5643779944278431,113979,114393,St. Mary's,St. Mary's,24,37,Maryland,MD
24039,24CS017,220,210,231,300,69,80,90,387.7050934644167,17,82.52093361919017,2.5176538306643375,3.044817600972292,3.5901019107895165,0.2102126755373313,269,256,282,312,30,43,56,174.7212536886662,31,126.10853470018714,-0.029175463428984003,0.4940139330132773,1.0067564953627168,0.7053473289489622,24721,24582,Somerset+Worcester,Somerset,24,39,Maryland,MD
24047,24CS017,550,528,573,614,41,64,86,145.58877265139455,53,121.16593636883216,-0.24695811394684875,0.2592472628680112,0.7884302258854587,0.8193812338635069,679,652,707,744,37,65,92,122.28834074574692,70,131.99577613516368,-0.6415846484522943,-0.0918595760441689,0.4236945521519499,1.0629904954263738,52490,53032,Somerset+Worcester,Worcester,24,47,Maryland,MD
24043,24CS018,1406,1340,1473,1660,187,254,320,197.4147626884973,143,111.34975893685638,0.35165371726716343,0.8491995493887599,1.3798658160004293,0.5618236569547929,1735,1655,1815,2025,210,290,370,187.11463937422943,272,175.61303151995662,-0.3921071060510838,0.11462731346445967,0.616492811876429,0.9353045048216085,154109,154886,Washington,Washington,24,43,Maryland,MD
24045,24CS019,862,817,906,1033,127,171,216,198.40065010222324,83,96.13621227184541,0.5263099195385865,1.0371884694116402,1.5219383536450968,0.4817435039748744,1064,1010,1118,1255,137,191,245,183.93980701216145,151,145.32365792158296,-0.158109408367245,0.39315260517059936,0.9048006173564928,0.7859487116051309,103603,103906,Wicomico,Wicomico,24,45,Maryland,MD
25001,25CS001,2675,2577,2773,2625,-148,-50,48,-26.379887731543917,197,104.14647470350856,-1.8585670178968672,-1.3044502561548792,-0.772607566332981,-4.028686184029793,3313,3193,3432,3312,-120,-1,119,-0.2526234363937721,199,85.8095201134928,-1.419923685159705,-0.8696715494165185,-0.3742770201658422,480.50975771319776,226988,231909,Barnstable+Dukes+Nantucket,Barnstable,25,1,Massachusetts,MA
25007,25CS001,151,149,153,143,-10,-8,-6,-46.82885386641614,7,41.62537165510406,-1.006418060437709,-0.8860400448159864,-0.7672914742952219,-1.0181740787947067,193,190,195,171,-24,-22,-19,-103.83802303960339,6,28.54152792312815,-1.4507118711012965,-1.325292024331345,-1.198452835069985,-0.28806227855691413,20180,21022,Barnstable+Dukes+Nantucket,Dukes,25,7,Massachusetts,MA
25019,25CS001,77,76,78,64,-14,-13,-12,-113.10087994376426,8,69.33911159263272,-1.942940090100914,-1.8205458779434605,-1.7106328832442113,-0.6639547422211666,99,97,101,91,-10,-8,-6,-55.25973985256192,3,20.75406433759945,-0.8810401492950011,-0.7628170723418952,-0.6261871172301059,-0.42931995430938097,13845,14455,Barnstable+Dukes+Nantucket,Nantucket,25,19,Massachusetts,MA
25003,25CS002,1339,1284,1394,1386,-8,47,102,44.164924872631495,121,113.23314955042072,-1.2328334945453412,-0.6993725324065154,-0.14535724963064503,2.5106718765142104,1642,1575,1708,1760,52,118,185,91.97560262661287,128,99.4777418552599,-0.5994988710302771,-0.0775807017477882,0.3982614800968684,1.0725042410080057,128231,128672,Berkshire,Berkshire,25,3,Massachusetts,MA
25005,25CS003,4766,4517,5014,5477,463,711,960,147.8978516929904,777,161.5320248846633,-0.62127512542764,-0.12718593840140197,0.3937615737386174,1.0906533463177694,5869,5570,6169,6249,80,380,679,65.49838129002661,669,115.34104917252711,-0.9859803008423311,-0.4980946928451091,5.596573241301044e-5,1.7563524081921302,577223,580019,Bristol,Bristol,25,5,Massachusetts,MA
25009,25CS004,6102,5755,6449,7072,623,970,1317,144.36383573210753,1242,184.8782859808076,-0.8945462337183017,-0.4110433593792326,0.09016034030680824,1.2793221457363166,7509,7092,7925,7483,-442,-26,391,-3.1764889041898448,631,78.15335149067299,-1.3241161642807602,-0.8113913517861092,-0.2905718146804103,-25.601951720641097,806152,807387,Essex,Essex,25,9,Massachusetts,MA
25011,25CS005,607,577,638,705,67,98,128,165.3476778737076,70,118.49845528799356,-0.02203608708281504,0.45538016816765886,0.9659930970748042,0.7093994935467861,745,708,782,717,-65,-28,9,-39.57809680319284,26,36.61404571122784,-1.2818120178818284,-0.7572741904444708,-0.2590118202074807,-0.9592396097254414,70887,71011,Franklin,Franklin,25,11,Massachusetts,MA
25013,25CS006,3896,3696,4096,4817,721,921,1121,237.74095645376633,751,193.8885936622612,-0.08847325677609831,0.4393313422706163,0.9685153879079619,0.8146609333393082,4769,4530,5008,5148,140,379,618,81.83378806584145,448,96.75252733582846,-0.6427751067194903,-0.13839416892271156,0.3441311222846188,1.1791933939454295,464803,463037,Hampden,Hampden,25,13,Massachusetts,MA
25015,25CS007,1109,1039,1179,1246,67,137,207,101.44700059273319,149,110.4085362841476,-0.6021586871443128,-0.08084091530250205,0.42638249666749145,1.0804452480357716,1368,1285,1452,1404,-48,36,119,22.235442020346564,93,57.53383979609512,-0.8976498352823932,-0.3474524371738917,0.15920041507775873,2.5174422270921486,161944,161644,Hampshire,Hampshire,25,15,Massachusetts,MA
25017,25CS008,10013,9313,10712,11522,810,1509,2209,111.4489156022606,2117,156.30874114364295,-0.9872775429634132,-0.4475764565987989,0.07301086441089472,1.4015861361827329,12299,11465,13134,12202,-932,-97,737,-6.0286519309795,823,50.90040528597308,-1.058717574432926,-0.5668131426865644,-0.054620965375509284,-8.530597067620423,1625245,1616883,Middlesex,Middlesex,25,17,Massachusetts,MA
25021,25CS009,5146,4835,5458,5757,299,611,922,101.34046949790914,926,153.66829111788428,-1.0657477954922292,-0.5329445870370161,0.023112423328170723,1.513877587066012,6333,5959,6707,6186,-521,-147,227,-20.239719102138984,374,51.6056390889259,-1.2607510291281039,-0.7175253543776604,-0.20636680920298042,-2.5672229904287898,723116,724727,Norfolk,Norfolk,25,21,Massachusetts,MA
25023,25CS010,4129,3901,4357,4799,442,670,898,151.6824914199078,740,167.59238813491189,-0.6896693592401534,-0.15391344311940902,0.36348530950534447,1.1032422296098048,5097,4822,5372,5438,66,341,616,64.05260575687032,412,77.34068194958589,-0.6345342215967726,-0.13085253491335344,0.3758545304318357,1.2039272982474156,529857,532708,Plymouth,Plymouth,25,23,Massachusetts,MA
25025,25CS011,4048,3706,4389,5128,739,1080,1422,163.19502861493999,1089,164.49302087883177,-0.49600926699627385,-0.014453233595087335,0.48647756283343946,1.0070215500147572,4904,4504,5304,5141,-163,237,637,30.602506266570934,393,50.724600269498644,-0.7086039549504513,-0.17444052736558327,0.3250856130060693,1.6505694159772326,794441,774772,Suffolk,Suffolk,25,25,Massachusetts,MA
25027,25CS012,6446,6077,6816,6985,169,539,908,75.44315132800376,1135,158.95727760569727,-1.3103018156830017,-0.843686618878058,-0.3418106273137638,2.1030767926627387,7953,7508,8398,7793,-605,-160,285,-18.552890593683298,665,77.15100481932744,-1.484479698367914,-0.9442013003233425,-0.4527045529062405,-4.184603346026759,856834,861946,Worcester,Worcester,25,27,Massachusetts,MA
26001,26CS001,157,153,162,176,14,19,23,220.96328261665403,20,235.08668821627973,-0.6342200274483342,-0.13273654937724916,0.38591010749601906,1.0101800251268993,191,186,196,227,31,36,41,353.31457731030883,35,342.3317683881064,-0.40855845319289075,0.09829482322698413,0.632767721570862,0.9428147210597752,10209,10224,Alcona+Alpena+Presque Isle,Alcona,26,1,Michigan,MI
26007,26CS001,326,314,339,343,4,17,29,69.43228690816079,20,83.31019161344071,-0.6557320812693728,-0.1318516780861296,0.3414740861790319,1.131965841206694,397,382,412,477,65,80,95,276.83003540450323,72,249.21255754387178,-0.23709714535282472,0.2820711173563955,0.7474861684762084,0.8891197798083614,28808,28891,Alcona+Alpena+Presque Isle,Alpena,26,7,Michigan,MI
26141,26CS001,171,165,176,170,-6,-1,5,-5.382947128510315,11,102.0408163265306,-1.566810065591812,-1.0604833944588228,-0.579620677104871,26.20805433521256,209,202,215,211,-4,2,9,18.10227175516797,33,252.370755582747,-2.8308889550743217,-2.3457797331231025,-1.846396243601853,9.80085536635055,12936,13076,Alcona+Alpena+Presque Isle,Presque Isle,26,141,Michigan,MI
26003,26CS002,94,93,94,78,-16,-16,-15,-210.54618764984696,6,81.19079837618405,-3.03335253603363,-2.914073101160555,-2.7933806580355935,-0.41210593415620733,114,113,115,114,-1,-0,1,-3.8545350095425297,3,34.002040122407344,-0.5020661610922315,-0.3794072705725418,-0.26144886506308057,4.546044318193096,8868,8823,Alger+Delta+Schoolcraft,Alger,26,3,Michigan,MI
26041,26CS002,403,388,419,502,83,99,114,322.36872269092004,63,206.1068702290076,0.6865205387080895,1.1676195722118223,1.7186630901985405,0.6329280968837196,497,478,516,555,39,58,77,158.51057746632463,51,138.48159009449333,-0.30118827486992944,0.2096602100233093,0.7115799758322647,0.8589289172637783,36680,36828,Alger+Delta+Schoolcraft,Delta,26,41,Michigan,MI
26153,26CS002,93,93,94,110,16,17,17,248.58513180913562,2,29.828486204325127,2.0758475633749955,2.1877985092209173,2.303324759135551,0.11320135470669065,114,113,115,131,16,17,18,207.3426553422391,5,62.25099601593625,1.3312714504820558,1.4540555346458715,1.5796927825869425,0.2832257497391497,8046,8032,Alger+Delta+Schoolcraft,Schoolcraft,26,153,Michigan,MI
26005,26CS003,903,852,955,1042,87,139,190,138.2457649541982,73,72.84156958615013,0.11960526797390027,0.6566753336947433,1.1481147516783667,0.5231233060048274,1115,1053,1178,1279,101,164,226,135.5385506434647,168,138.96011513838113,-0.5948626115040859,-0.03585679697446712,0.4581619917949243,1.0190254665435734,120261,120898,Allegan,Allegan,26,5,Michigan,MI
26009,26CS004,233,223,243,259,16,26,36,134.43178325001531,5,25.583081055728474,0.5599451728543547,1.08441473509784,1.6330131131927508,0.18332765660167055,288,276,301,333,32,45,57,187.71887681698092,36,151.5406634113487,-0.17121569821209698,0.3612736182062756,0.8374275150445585,0.78956898005003,23453,23756,Antrim+Charlevoix+Kalkaska+Otsego,Antrim,26,9,Michigan,MI
26029,26CS004,246,235,257,242,-15,-4,7,-17.447555749932224,12,55.28467769800745,-1.256177951264834,-0.7239852467577303,-0.2097392881698668,-4.305492840548784,302,288,315,376,61,74,88,285.2251020691811,36,138.06327900287633,0.9473369745339436,1.4892224135208887,2.0015441949588983,0.47762812823553663,26047,26075,Antrim+Charlevoix+Kalkaska+Otsego,Charlevoix,26,29,Michigan,MI
26079,26CS004,180,172,188,209,21,29,37,193.01140610990092,13,86.9613690841184,0.5788122109212732,1.0667899723120917,1.5798606119371106,0.4354584170746177,221,212,230,251,21,30,39,167.48846551743625,26,144.677536030271,-0.2929045062579343,0.2100060101825923,0.681613495456757,0.8360302775605117,17939,17971,Antrim+Charlevoix+Kalkaska+Otsego,Kalkaska,26,79,Michigan,MI
26137,26CS004,237,226,248,276,28,39,50,185.54088682852435,18,86.2000159629659,0.48859356470274284,1.0029387947683803,1.4896579314069813,0.4528982143566679,293,280,306,366,60,73,86,290.0464080389252,59,233.55237115034438,0.07184483161102262,0.5623696737911007,1.0801038486624635,0.7943825189141345,25058,25262,Antrim+Charlevoix+Kalkaska+Otsego,Otsego,26,137,Michigan,MI
26011,26CS005,172,166,179,204,25,32,38,255.38190422050417,15,120.14417300760911,0.8274360979948948,1.362069230388627,1.909607692869839,0.45614291205819635,210,202,218,254,36,44,52,294.9160298484443,20,133.53809174066902,1.1141863413944515,1.5995997048320298,2.157457519516552,0.44277592905359636,14982,14977,Arenac+Iosco+Ogemaw,Arenac,26,11,Michigan,MI
26069,26CS005,351,340,362,405,43,54,65,255.4917440835976,43,204.6238648530753,0.010515012270043277,0.5104286885977841,1.0151565092052224,0.786257521570343,429,416,442,499,57,70,83,274.7013089905603,56,220.968314722014,-0.00808842366998885,0.535604957171211,1.0241782971616251,0.793003974637598,25217,25343,Arenac+Iosco+Ogemaw,Iosco,26,69,Michigan,MI
26129,26CS005,276,267,285,294,9,18,27,103.49574279642536,28,161.79515577599076,-1.0809542471378197,-0.5795306387521565,-0.07038777443611494,1.4806353449595924,336,325,346,385,39,49,60,238.45988711293109,52,250.86839058278656,-0.6197808694867029,-0.1165421011413022,0.3771061616138069,1.0311738652697595,20767,20728,Arenac+Iosco+Ogemaw,Ogemaw,26,129,Michigan,MI
26015,26CS006,497,470,524,534,10,37,64,71.56490914877949,39,74.95315427857588,-0.5364314911471372,-0.014170898099991478,0.458233625103776,1.0199541915062529,614,581,646,769,123,155,188,246.8784197611932,78,123.95315206509129,0.7303779564867424,1.250049320900843,1.7199858916570707,0.49887055960137633,62439,62927,Barry,Barry,26,15,Michigan,MI
26017,26CS007,1086,1042,1131,1312,181,226,270,261.6474449315429,148,171.6953953537834,0.4161700846637456,0.8800298333466051,1.3935223959909921,0.6533122660936301,1326,1273,1379,1559,180,233,286,226.12559299318977,219,212.46871179928982,-0.3761873089968876,0.13413272216975033,0.6547490539941511,0.935590795127519,103439,103074,Bay,Bay,26,17,Michigan,MI
26019,26CS008,181,173,189,226,37,45,53,301.00300973554045,24,160.2671118530885,0.8762453603433363,1.4083100614439732,1.9327053531303253,0.52088758445465555,224,215,234,241,7,17,26,91.5076480632464,24,131.9623907186452,-0.9038587218122347,-0.4055841891195279,0.08366789759780456,1.3603517361477235,17970,18187,Benzie+Manistee+Mason,Benzie,26,19,Michigan,MI
26101,26CS008,282,271,292,343,51,61,72,294.82403135391974,21,100.68723030206169,1.4314509580464314,1.9393474740172714,2.4739638874153655,0.33605126543934716,348,335,361,373,12,25,38,99.23104397066666,43,169.90674885411727,-1.2485790388198093,-0.7074028974103672,-0.2143250691383788,1.6466646308786426,25028,25308,Benzie+Manistee+Mason,Manistee,26,101,Michigan,MI
26105,26CS008,295,282,307,349,42,54,67,223.8518211227991,21,86.56818962555822,0.8653395112765998,1.3577287507031792,1.8816858398713903,0.37972815157712986,364,349,379,441,62,77,92,261.8302771579947,46,156.80392691573493,0.5110494168133413,1.0584593785345033,1.5409741401322887,0.5911796248747155,29110,29336,Benzie+Manistee+Mason,Mason,26,105,Michigan,MI
26021,26CS009,1485,1419,1551,1652,101,167,233,130.10482578026924,170,132.56824990414796,-0.5372100444255449,-0.026142010180257743,0.4783160738616307,1.0128633191932896,1807,1728,1886,2006,120,199,278,129.97989419860073,204,133.11929838299204,-0.5171620272903661,-0.044368917694543715,0.4858555256236262,1.019037067732115,153883,153246,Berrien,Berrien,26,21,Michigan,MI
26023,26CS010,419,400,438,468,30,49,68,131.16961534827985,71,190.907257612763,-1.090545842778401,-0.5962270328532076,-0.12086105077041473,1.4261875710213445,518,495,542,565,23,47,70,103.73188993458875,75,166.81865699859873,-1.1719483620925586,-0.6283910413812314,-0.10882786279274781,1.57441238472715,44629,44959,Branch+Hillsdale,Branch,26,23,Michigan,MI
26059,26CS010,427,408,447,545,98,118,137,309.4857786086756,63,165.6260269470917,0.9459921618498932,1.4381818315913548,1.956959046591133,0.530657458392594,525,501,548,651,103,126,150,277.5399544202119,108,237.0240316032042,-0.1207753223624224,0.4012866066715052,0.928652750688373,0.8473174698016608,45645,45565,Branch+Hillsdale,Hillsdale,26,59,Michigan,MI
26025,26CS011,1327,1269,1384,1625,241,298,356,267.07751618495695,158,141.45242393947984,0.763239865443854,1.2782905241514877,1.7758936778775616,0.5278611561343446,1622,1552,1691,1847,156,225,295,168.41495929611926,229,171.07170070669795,-0.5740094670304291,-0.044406090478087266,0.4857536039115195,1.011289198796507,134038,133862,Calhoun,Calhoun,26,25,Michigan,MI
26027,26CS012,452,429,474,560,86,108,131,252.07392633781683,66,153.50027133886346,0.5040048819537222,0.9720637621372508,1.4888771794410276,0.6033823096666616,552,526,579,634,55,82,108,158.91156203113252,65,126.22584716962812,-0.2160027614510708,0.3222252813130153,0.8086907656351315,0.7847255336569732,51596,51495,Cass,Cass,26,27,Michigan,MI
26031,26CS013,283,272,294,343,49,60,71,279.89107185616825,39,182.98404754457306,0.4606894494451502,0.9531599422074524,1.5121268076838978,0.6429901522775728,349,335,362,443,81,94,108,366.6266584527639,52,202.09871745044697,1.0891701584603575,1.663122074318905,2.176263292977828,0.5454562282448195,25576,25730,Cheboygan+Emmet,Cheboygan,26,31,Michigan,MI
26047,26CS013,325,311,340,374,34,49,63,171.94398674035403,32,112.96111078425605,0.08478018240898755,0.5941114510597537,1.0562819577319178,0.6437483443378136,401,384,419,387,-32,-14,3,-41.95395767185766,28,81.85937728402281,-1.7818483252725739,-1.2227160216755255,-0.7228755977710906,-2.0973230992286003,33994,34205,Cheboygan+Emmet,Emmet,26,47,Michigan,MI
26033,26CS014,309,293,325,308,-17,-1,15,-2.482191915250126,22,71.67874888001955,-1.2980469512397728,-0.7282255627311277,-0.23488686913259554,92.37749361582864,382,363,401,452,51,70,89,189.71485786314753,50,135.84741618214423,0.05457417007205953,0.5292752049131706,1.0886612550862855,0.7059509489313807,36831,36806,Chippewa+Luce+Mackinac,Chippewa,26,33,Michigan,MI
26095,26CS014,55,55,56,65,9,10,10,218.46724955954878,4,87.89598974546786,1.1791095837280037,1.3140407368516231,1.427362785321595,0.3655611956918561,66,65,67,83,16,17,18,321.40380693629766,6,112.9730747505178,1.9435024714756706,2.0786399156965607,2.19130830608229,0.3320465388747318,5461,5311,Chippewa+Luce+Mackinac,Luce,26,95,Michigan,MI
26097,26CS014,146,141,150,140,-10,-6,-1,-63.22560667537083,8,88.60175357637286,-2.00386888493222,-1.516556825083226,-1.013981599592948,-1.698966352133036,179,174,185,195,10,16,21,144.9806062400408,14,128.49931161083066,-0.3375658207618703,0.19725604500641655,0.6938009038216404,0.8335498057290417,10835,10895,Chippewa+Luce+Mackinac,Mackinac,26,97,Michigan,MI
26035,26CS015,392,378,405,434,29,42,56,165.21988359063843,42,163.3393829401089,-0.47695379146439987,0.011218233074560414,0.537524760171569,0.9658827358339307,481,465,497,557,60,76,92,244.38352863870543,65,209.47470190138574,-0.14857599380603187,0.34487750585103083,0.8337095558786733,0.8459993653656968,30856,31030,Clare+Gladwin,Clare,26,35,Michigan,MI
26051,26CS015,314,303,325,390,65,76,87,358.6858956377952,36,170.14572666404095,1.370059720267051,1.889518893170169,2.36479242070754,0.4681894076902032,385,372,398,481,83,96,109,375.83680523718664,59,231.66326370347102,0.9507060406644497,1.4339792250332872,1.9922841292119835,0.6100201439997708,25390,25468,Clare+Gladwin,Gladwin,26,51,Michigan,MI
26037,26CS016,526,492,560,638,78,112,146,169.64813732934152,48,72.69973494888299,0.43883531972658874,0.9566942074556173,1.472295205170151,0.4247404867881973,650,609,691,771,80,121,162,152.12964269319522,90,113.37440006046636,-0.16055708682777523,0.3750392403727145,0.8974134296595562,0.7391281986857983,79230,79383,Clinton,Clinton,26,37,Michigan,MI
26039,26CS017,156,150,161,155,-6,-1,5,-7.7469717836944305,2,18.260671079662178,-0.7931638585996851,-0.2785112378230091,0.2525793922470907,13.200194814022778,192,185,198,219,21,27,34,208.24036184455449,12,91.12309211025895,0.6893805446272744,1.1737701703110803,1.692392426799125,0.4221907207157875,13143,13169,Crawford+Montmorency+Oscoda+Roscommon,Crawford,26,39,Michigan,MI
26119,26CS017,143,139,147,159,12,16,20,211.40926724783736,16,208.87728459530024,-0.49142136129206726,0.04136246264577148,0.5436499642103627,0.9305598841377741,175,171,180,200,20,25,29,265.0043373900934,26,280.2932298404485,-0.6451831240485637,-0.1580254866898184,0.3556952788704884,1.0163474667733416,9192,9276,Crawford+Montmorency+Oscoda+Roscommon,Montmorency,26,119,Michigan,MI
26135,26CS017,106,105,107,148,41,42,43,611.1235805231333,13,188.99927307971893,4.102482709720532,4.222431871128705,4.338454981699592,0.3020788816727363,131,130,132,172,40,41,42,496.9404934623582,33,397.5903614457831,0.8594739497374239,0.9911421293773541,1.1189539994742463,0.7811379156342039,8254,8300,Crawford+Montmorency+Oscoda+Roscommon,Oscoda,26,135,Michigan,MI
26143,26CS017,345,335,355,389,34,44,54,226.34437439655278,29,147.87116512280105,0.2697771206284691,0.8091642048156127,1.3537425553103672,0.6389085964135877,421,409,433,468,35,47,59,197.88530330229352,61,258.4307744450093,-1.0906381687533826,-0.5922037252948291,-0.10273949724453188,1.2785888539897445,23534,23604,Crawford+Montmorency+Oscoda+Roscommon,Roscommon,26,143,Michigan,MI
26043,26CS018,271,260,282,339,57,68,79,315.1130453775689,68,316.3403760418685,-0.5046051116272106,0.001788728221813192,0.525327592160427,0.989289845624068,332,319,346,360,14,28,41,107.80949021695592,30,116.27456300143406,-0.6148642736535601,-0.06831119540111834,0.423944184285922,1.0410909372013706,25795,25801,Dickinson+Iron+Menominee,Dickinson,26,43,Michigan,MI
26071,26CS018,174,169,179,204,25,30,35,311.88551448265684,28,290.85872576177286,-0.2886980248844387,0.203473083550362,0.7081369235932085,0.9025218725553863,213,207,219,197,-22,-16,-10,-135.64116406905381,25,214.86892995272885,-4.0318344112286875,-3.5157760804678437,-3.02144267787038,-1.6912633363255634,11552,11635,Dickinson+Iron+Menominee,Iron,26,71,Michigan,MI
26109,26CS018,251,240,261,248,-13,-3,8,-12.872859905571284,22,113.23182500536134,-1.7247999494010364,-1.2776140448813658,-0.7283835613195278,-14.65602242924547,306,294,319,326,7,20,32,83.7666025273908,33,141.5276407771154,-1.085714857801101,-0.5829367245804423,-0.02299533295872182,1.607258284015911,23315,23317,Dickinson+Iron+Menominee,Menominee,26,109,Michigan,MI
26045,26CS019,888,841,935,1071,136,183,230,200.7544824210044,80,87.88231093860138,0.6364882739323199,1.1316894770442192,1.665782391178044,0.4353777551756193,1092,1035,1148,1330,182,238,295,218.78244955493312,183,167.93921151163644,0.006231337285530499,0.4974339750177892,1.0120795447082844,0.7644018967945888,109237,108968,Eaton,Eaton,26,45,Michigan,MI
26049,26CS020,3916,3742,4090,4701,611,785,959,232.3161123928873,497,147.07550566452775,0.37383817766652827,0.8427807997980508,1.3720323575590643,0.6322781328077213,4789,4580,4998,5638,640,849,1058,209.99341184810729,670,165.67017293987902,-0.09894814666782945,0.4559436018772836,0.9415013803759218,0.7880024567019005,405506,404418,Genesee,Genesee,26,49,Michigan,MI
26055,26CS021,789,748,830,899,69,110,151,138.41918684133765,37,46.717663275076546,0.3613383417778243,0.9223701625390979,1.4475917856422342,0.33445770636523553,978,929,1027,1122,95,144,193,150.2990197087446,113,117.97746943548303,-0.17316598769065092,0.34382191923531974,0.8266098212955812,0.7795366573980654,95039,95781,Grand Traverse+Leelanau,Grand Traverse,26,55,Michigan,MI
26089,26CS021,214,204,223,243,20,29,39,156.95905192106667,10,53.942281758518384,0.5104909226788211,1.0392385814174923,1.54446650781486,0.33225249114965194,266,254,277,316,39,50,62,222.23839180316946,28,124.02551381998582,0.4405490958682014,0.9829200422308694,1.518043984243105,0.5471684689620017,22246,22576,Grand Traverse+Leelanau,Leelanau,26,89,Michigan,MI
26057,26CS022,408,390,426,484,58,76,94,220.3440733564799,54,156.11824511528175,0.1734199537623703,0.6507424788078644,1.149688496755519,0.6993443628289051,500,478,521,528,7,28,50,68.17608380094383,48,115.4928899689613,-0.9691541045139144,-0.4797595304168264,0.07029211053687372,1.6362895093709493,41507,41561,Gratiot+Isabella,Gratiot,26,57,Michigan,MI
26073,26CS022,395,367,423,512,89,117,145,214.8236009076274,33,60.669199656820695,1.0441493400529027,1.531179710794662,2.052486555453355,0.2800176423868274,489,455,522,685,163,196,230,303.021004878538,101,155.94602106043294,0.9651185994042362,1.4710957386891446,2.010890220283638,0.5120286583045739,65272,64766,Gratiot+Isabella,Isabella,26,73,Michigan,MI
26063,26CS023,382,369,396,424,28,42,55,160.76524579158138,46,176.4931576927996,-0.6571480450927062,-0.1633393732442229,0.337633582113905,1.0722415296016379,464,448,480,529,49,65,81,207.23422844366573,71,227.08373312863816,-0.6946286839185929,-0.18276596311999477,0.3211395613322226,1.0791281529954184,31276,31266,Huron+Sanilac,Huron,26,63,Michigan,MI
26151,26CS023,419,401,436,492,56,73,91,216.33767513219033,64,189.11598128539768,-0.23198496798516496,0.2713351875872637,0.7959376422925954,0.8623910275298241,510,489,531,644,113,134,155,331.3154736375292,99,244.40823581691603,0.3488811928068586,0.8736917079297094,1.362178844172764,0.7322341914955873,40610,40506,Huron+Sanilac,Sanilac,26,151,Michigan,MI
26065,26CS024,1849,1727,1972,2244,272,395,517,165.91879506143368,157,65.99503986324594,0.4918963804441263,1.0158293507106861,1.523624773766921,0.3967499028071923,2277,2130,2424,2850,426,573,720,201.65476009241152,345,121.433976874747,0.27703098353349637,0.8098111878609283,1.3152403000568909,0.6011382357405617,285476,284105,Ingham,Ingham,26,65,Michigan,MI
26067,26CS025,473,444,502,520,18,47,76,84.58838282901364,31,55.87766996124613,-0.2534026494687543,0.2749455573332832,0.8416710222945041,0.6468005023826215,587,552,621,628,7,41,76,61.470957475878556,82,122.11830583189372,-1.1368594950531588,-0.6199221373089417,-0.06226031904989693,1.9396109911405877,66574,67148,Ionia,Ionia,26,67,Michigan,MI
26075,26CS026,1489,1420,1558,1706,148,217,286,163.0085611479462,175,131.31894244478352,-0.16669944038605267,0.33231807776918476,0.8272066659908984,0.8019038858715556,1824,1742,1907,2162,255,338,420,210.86807669212416,229,143.06062271977612,0.15178840270203034,0.6983520814665919,1.1930348353950673,0.67643260535252,159916,160072,Jackson,Jackson,26,75,Michigan,MI
26077,26CS027,1841,1728,1954,2161,207,320,433,146.4366397766671,185,84.686279296875,0.0800567449798773,0.6136635634431848,1.1473942447745005,0.5765112714218622,2261,2127,2396,2662,266,401,535,153.34557159213136,249,95.33508943886302,0.015625201362388298,0.5862138880471497,1.0914055483722525,0.6201525710352153,262144,261184,Kalamazoo,Kalamazoo,26,77,Michigan,MI
26081,26CS028,4184,3901,4467,4822,355,638,921,116.378072929849,442,80.62505700300974,-0.16627682312147404,0.3404402325916364,0.9019877460486121,0.6917014688984522,5166,4827,5506,5811,305,645,984,97.95186154670972,542,82.36518779110851,-0.36102758053492007,0.1597284964087427,0.6630127150003639,0.8395716094465486,657860,658045,Kent,Kent,26,81,Michigan,MI
26085,26CS029,154,149,159,175,16,21,26,207.69090263859943,3,29.826014913007455,1.249542901633713,1.7740625332949609,2.2851144229364992,0.13704735759221892,190,184,197,194,-3,4,10,28.942621894380483,20,162.89297931259162,-1.8223758346922159,-1.3374395958490168,-0.8333133812802923,4.3921533058457944,12070,12278,Lake+Missaukee+Wexford,Lake,26,85,Michigan,MI
26113,26CS029,149,143,156,167,11,18,24,140.20990207080496,7,55.721393034825866,0.34799143586854725,0.8399899769287708,1.3618439087913907,0.37606367701894006,183,175,191,204,13,21,29,137.66659947603304,30,198.3995767475696,-1.1380489330283035,-0.6017713700715193,-0.05101494514436213,1.3751018058084095,15075,15121,Lake+Missaukee+Wexford,Missaukee,26,113,Michigan,MI
26165,26CS029,308,293,322,329,7,21,36,75.51723421605247,12,42.73504273504274,-0.16768780970411087,0.3194188595391206,0.825304022797752,0.5404129989863925,379,361,396,507,111,128,146,378.67993913199274,66,194.87421755049016,1.3322724664208914,1.8442139554125432,2.3524913638649276,0.5106330758432945,33696,33868,Lake+Missaukee+Wexford,Wexford,26,165,Michigan,MI
26087,26CS030,768,730,806,874,68,106,144,143.8770397550054,96,130.28579183678085,-0.3660497792860169,0.12571259829195514,0.6579745491354919,0.8970738759210363,946,900,991,1207,216,261,307,295.3928488434309,210,237.24792408066432,0.049599095406636505,0.5833917754389057,1.086433207393731,0.8001006445724115,88421,88515,Lapeer,Lapeer,26,87,Michigan,MI
26091,26CS031,908,865,950,1037,87,129,172,156.80514316385822,75,90.83018791756656,0.13311568393846834,0.6450080576779432,1.1468881035333285,0.5748156254016226,1110,1059,1161,1308,147,198,249,200.0583560283877,188,189.91049962623998,-0.4081431849630287,0.09959637106675759,0.6052727488996984,0.9445063865256653,99086,98994,Lenawee,Lenawee,26,91,Michigan,MI
26093,26CS032,1277,1193,1360,1499,139,222,306,137.73477894740108,80,49.535092517105085,0.36257635234606417,0.8881743288295737,1.4050935449469393,0.35803160093633146,1584,1483,1685,1913,228,329,430,168.80224545839303,226,115.97951370713633,-0.010837221082128444,0.5334720815107815,1.1036942330600612,0.6849908144295241,193802,194862,Livingston,Livingston,26,93,Michigan,MI
26099,26CS033,7541,7163,7919,9309,1390,1768,2146,241.3922108183515,1407,192.1216907254972,-0.0088369532378859,0.5096769268189882,1.028756794999538,0.7954402300826288,9230,8777,9683,10658,975,1428,1881,162.79778025521964,1448,165.04979420068824,-0.5415459820572989,-0.007092069273740807,0.5151646033306406,1.0131238482501181,878818,877311,Macomb,Macomb,26,99,Michigan,MI
26103,26CS034,585,557,613,600,-13,15,43,27.23499396493467,44,79.92854872159737,-1.0515244052528758,-0.5180846527548251,5.300976881015558e-4,2.7512660605211696,717,683,752,794,42,77,111,115.83638575629408,41,62.04788280516965,0.029934001764695232,0.5430268275812095,1.036278810842423,0.5287432096385658,66059,66078,Marquette,Marquette,26,103,Michigan,MI
26107,26CS035,323,306,341,412,71,89,106,263.4563264764466,13,38.650215549279025,1.7487400008660363,2.24470112133149,2.7482787429480324,0.1450673711339609,397,376,418,474,56,77,98,192.42648493556501,59,147.51843980497563,-0.06329062214502201,0.44769410323980746,0.95773877685126,0.7567889162298147,40362,39995,Mecosta+Osceola,Mecosta,26,107,Michigan,MI
26133,26CS035,211,202,221,223,2,12,21,60.5020443544337,17,88.75739644970413,-0.7575435026024223,-0.2750118135138501,0.24618793098928654,1.3504755573583778,261,249,273,285,12,24,36,104.25989320981071,47,203.70129588696744,-1.489170485462278,-1.0033005287328591,-0.4833707160843642,1.8758068094305538,22984,23073,Mecosta+Osceola,Osceola,26,133,Michigan,MI
26111,26CS036,648,612,684,767,83,119,155,170.7902375950093,37,53.19595039837057,0.6804762598678352,1.188898277410631,1.685444516393817,0.30886941092519654,797,754,840,938,98,141,184,169.11255876902675,103,123.4124131320393,-0.028215403089043706,0.4532579763998827,0.964406983722314,0.7246308419339169,83465,83460,Midland,Midland,26,111,Michigan,MI
26115,26CS037,1330,1264,1397,1530,133,200,266,155.27484632934033,123,95.71611999533091,0.054635672420788636,0.5909242094178297,1.1129237086424588,0.6133563849834219,1642,1562,1722,1933,211,291,371,187.62290669732496,207,133.37285121517488,0.02659118527699421,0.5250188817482018,1.0389951835546676,0.7084231191363023,154206,155204,Monroe,Monroe,26,115,Michigan,MI
26117,26CS038,570,541,598,620,22,50,79,91.05420045249743,70,126.92848184469393,-0.8628853504437485,-0.33977821353320375,0.14677615137404706,1.3667701875676908,710,675,745,820,75,110,145,163.8135084031792,90,134.09419372141187,-0.2561292829639065,0.30046019448636363,0.7918895890370573,0.8112002422132067,66179,67117,Montcalm,Montcalm,26,117,Michigan,MI
26121,26CS039,1517,1442,1593,1878,285,361,436,246.57879453115314,247,168.81866801843105,0.24541966007432867,0.7827904152005345,1.2933575386430927,0.6827514258053754,1869,1778,1960,2152,192,283,374,160.45246280170798,230,130.3780964797914,-0.24474053594403733,0.3119051549963295,0.8357471829584413,0.8097046563573341,175573,176410,Muskegon,Muskegon,26,121,Michigan,MI
26123,26CS040,441,420,463,488,25,47,68,112.52096967202932,30,72.11538461538461,-0.11599459893045574,0.4102469309092821,0.9466968463623913,0.627500545440489,541,515,567,641,74,100,126,199.36127363323797,82,163.15485783640742,-0.17489459545036762,0.38914121045746264,0.8511537289101826,0.810300840616259,49920,50259,Newaygo+Oceana,Newaygo,26,123,Michigan,MI
26127,26CS040,231,219,242,284,42,53,65,240.449853465409,41,184.3870629239591,0.058831462050289204,0.5560873682970767,1.0978210807931688,0.7527627955181219,282,268,296,330,34,48,62,178.23168201361415,37,138.0803104941036,-0.12759486773731724,0.4171863607245435,0.9264880499516998,0.7588348654762611,26683,26796,Newaygo+Oceana,Oceana,26,127,Michigan,MI
26013,26CS041,89,88,90,105,15,16,17,231.8154628072079,27,397.35099337748346,-1.780413872550948,-1.6544510384298727,-1.5381248034360888,1.6117612536992276,110,109,111,114,3,4,5,43.886370806323654,18,219.45866861741038,-1.876870316971488,-1.7567721971958172,-1.6280656259812434,3.9134176915668184,8154,8202,Northwest Upper Peninsula,Baraga,26,13,Michigan,MI
26053,26CS041,169,163,175,207,32,38,44,321.06114028404767,38,319.5515066573231,-0.48335033408815664,0.017354317693275213,0.524996026717122,0.9698944606582351,208,201,215,211,-4,3,10,20.519303509551598,20,139.33398355858995,-1.7299620286676105,-1.1787486272222583,-0.6771575820672366,5.06927053536423,14270,14354,Northwest Upper Peninsula,Gogebic,26,53,Michigan,MI
26061,26CS041,322,306,338,333,-5,11,27,35.2498541605237,27,87.65285142300617,-1.0247129452413755,-0.529370251898348,0.01289412635140629,2.276918858676165,401,382,420,381,-39,-20,-1,-53.431125083647515,46,123.3541605213054,-2.2737965406930263,-1.764059089755559,-1.2584277745348873,-2.4306471821366036,36964,37291,Northwest Upper Peninsula,Houghton,26,61,Michigan,MI
26083,26CS041,24,23,25,26,1,2,3,99.03851045793124,4,232.44552058111378,-1.8426432720101547,-1.3162900923655798,-0.7978907777660076,1.479132563750994,30,29,31,35,4,5,6,222.95685640321508,2,95.28346831824678,0.7577257667770385,1.2855517339491396,1.7690042641973522,0.35212108134131653,2065,2099,Northwest Upper Peninsula,Keweenaw,26,83,Michigan,MI
26131,26CS041,82,81,83,115,32,33,34,681.9135786451552,20,414.0072451267897,2.560398688579889,2.678694834142481,2.798603003283636,0.5892385861225501,102,101,102,101,-1,-1,0,-12.356684217000186,13,221.88086704215738,-2.4704847228429276,-2.3441224449822626,-2.2240772416979167,47.09771699869749,5797,5859,Northwest Upper Peninsula,Ontonagon,26,131,Michigan,MI
26125,26CS042,9157,8610,9703,10946,1243,1789,2336,169.05834105686492,1401,132.37607655954483,-0.19513642225515995,0.3994195211410012,0.8911560174780011,0.7825826987213773,11265,10609,11920,12423,503,1158,1814,91.1939923029582,1189,93.59507417547384,-0.5185825784535539,-0.020585947997321878,0.5119169555934365,1.02544423635794,1270018,1270366,Oakland,Oakland,26,125,Michigan,MI
26139,26CS043,1761,1633,1888,2147,259,386,514,156.54491402581218,221,89.51687217517222,0.13405309196177476,0.6712497219513333,1.174595371547172,0.5703529185810768,2198,2044,2352,2544,192,346,500,115.7280314646467,290,97.05131337199768,-0.3314866514734579,0.1918528624625747,0.6935740069703509,0.8361973378098558,296257,298811,Ottawa,Ottawa,26,139,Michigan,MI
26145,26CS044,1813,1732,1895,2310,415,497,578,313.9067425336157,328,207.26589117487532,0.5114652118172978,1.070006991926087,1.5496727436288698,0.6589520578418386,2218,2120,2316,2583,267,365,463,192.27578767030536,337,177.71824538829063,-0.3589460545610494,0.1447604047614153,0.683232379561908,0.9217601123745857,189901,189626,Saginaw,Saginaw,26,145,Michigan,MI
26147,26CS045,1531,1462,1600,1776,176,245,314,183.38188493869305,154,115.4220900891898,0.17049000467323663,0.6913217528929736,1.230634859581343,0.6268463892309782,1874,1791,1957,2357,400,483,566,301.73415037406824,411,256.74021138902077,-0.07776877406336183,0.459272628884121,0.9801204555509074,0.8491242601525042,160108,160084,St. Clair,St. Clair,26,147,Michigan,MI
26149,26CS046,569,542,595,639,44,70,97,138.69026230153736,59,116.30199093238714,-0.25645340047568455,0.22451102107587775,0.7031603412820404,0.8268218767228951,696,664,727,792,65,96,128,158.23174905435133,89,146.43215584330113,-0.36747859651324644,0.12116540337746469,0.6257150479215121,0.9159047656828314,60876,60779,St. Joseph,St. Joseph,26,149,Michigan,MI
26155,26CS047,633,604,663,728,65,95,124,167.00509936004826,49,86.49093904448107,0.2864933237438048,0.7987676883499425,1.3041078719144454,0.5124774901336975,777,742,812,880,68,103,138,152.21499482585364,118,173.80545572379663,-0.7328052255789015,-0.2219995628867066,0.294586749364414,1.1308985962638858,67984,67892,Shiawassee,Shiawassee,26,155,Michigan,MI
26157,26CS048,534,511,557,647,90,113,136,255.07441856965215,90,203.37834020676797,0.011979335289149795,0.5333789929227216,1.0016086321800493,0.7903277437232824,654,626,681,794,113,140,168,264.69530219891783,118,222.77180992656085,-0.07316189369131976,0.4083240619593237,0.964775528144718,0.8356558509743139,53103,52969,Tuscola,Tuscola,26,157,Michigan,MI
26159,26CS049,660,627,692,767,75,107,140,170.53520297543997,90,142.9100725136294,-0.1896405711987525,0.2591154578968226,0.7682684476285173,0.830278321733339,809,770,848,980,132,171,210,226.28811831693062,117,154.67392884999273,0.21152606066294574,0.71485897690065,1.2068011872094297,0.6795564731787195,75572,75643,Van Buren,Van Buren,26,159,Michigan,MI
26161,26CS050,2004,1845,2164,2311,147,307,466,99.1889344580832,179,57.909749219512456,-0.0935699803052953,0.4058262775709288,0.9439430782939561,0.5819346996338353,2485,2294,2676,2640,-36,155,346,41.865212573377264,172,46.521692091312346,-0.5887091529224031,-0.04003627546995859,0.48400681858582933,1.1040923934387936,370922,369720,Washtenaw,Washtenaw,26,161,Michigan,MI
26163,26CS051,15695,14927,16463,19800,3337,4105,4873,276.31224495185455,3079,207.25086340503273,0.1821953831188862,0.6765944617289087,1.2263441795424317,0.7498776912769727,19152,18234,20069,21711,1642,2559,3477,144.00689050483953,2477,139.38729240325188,-0.4771039802750246,0.03809002779865179,0.5495290463964936,0.9675429122538277,1782767,1777063,Wayne,Wayne,26,163,Michigan,MI
27001,27CS001,192,185,198,225,27,33,40,254.59205246996208,29,221.16301239275498,-0.17039065453324406,0.33884729441657063,0.8420797705625007,0.8434306799045134,236,228,244,248,4,12,20,76.91559027352557,20,126.1113563276373,-1.0366517781425908,-0.4932558161538669,0.07606816483590789,1.5153761281643512,15735,15859,Aitkin+Itasca,Aitkin,27,1,Minnesota,MN
27061,27CS001,445,426,465,469,4,24,43,63.52714755941218,36,95.94030381096206,-0.8617287285614366,-0.3325896312117773,0.2007058777154461,1.4494210433783603,546,523,569,684,115,138,161,306.1895273003612,64,142.04230197305634,1.1257124144664035,1.6265802705618444,2.1258605591561723,0.46056480324609494,45028,45057,Aitkin+Itasca,Itasca,27,61,Minnesota,MN
27003,27CS002,1948,1792,2105,2359,254,411,567,135.49849021951783,331,109.24212587597223,-0.2716271846464603,0.2719205998295729,0.7987391428615058,0.8042649685344031,2440,2251,2629,2764,135,324,513,88.42815232952096,307,83.73770187741565,-0.4422710908379718,0.05013547844699843,0.5440541167234613,0.944045540276229,363596,366621,Anoka,Anoka,27,3,Minnesota,MN
27005,27CS003,328,312,343,386,43,58,74,199.94720170846733,40,136.93159125920008,0.1413786006424332,0.6294645926847183,1.1638572541063688,0.6733110111304847,406,388,424,412,-12,6,24,17.269860063239296,43,122.1313337877755,-1.5819897075167304,-1.0380312821224398,-0.551485839499958,6.073126947199731,35054,35208,Becker+Hubbard+Mahnomen+Norman,Becker,27,5,Minnesota,MN
27057,27CS003,191,182,200,229,29,38,47,211.36331805851955,37,207.01230883998505,-0.4611559616572855,0.045885253587064335,0.5159363160398721,0.954157370375089,239,228,250,239,-11,0,11,0.15730696342803904,15,69.23289947382996,-1.198917580912615,-0.6882313739015352,-0.16623874325040966,14.505617699748795,21448,21666,Becker+Hubbard+Mahnomen+Norman,Hubbard,27,57,Minnesota,MN
27087,27CS003,55,55,56,68,12,13,13,281.2190003228549,3,66.64198445020362,2.025024076393722,2.146682322475098,2.2663767552456173,0.21962669029960322,68,67,69,89,20,21,22,387.5268178240575,10,184.91124260355028,1.890451172309421,2.0244051438864714,2.1513246877902925,0.45542628400669694,5402,5408,Becker+Hubbard+Mahnomen+Norman,Mahnomen,27,87,Minnesota,MN
27107,27CS003,83,83,84,66,-18,-17,-17,-322.23093260862356,5,93.51620947630923,-4.281314774050707,-4.153499867067182,-4.03501103405994,-0.30809778592695797,102,101,103,85,-18,-17,-16,-265.2553638182151,3,46.75081813931744,-3.2495204488597857,-3.119466391671528,-2.9979009958637537,-0.18724912483714795,6416,6417,Becker+Hubbard+Mahnomen+Norman,Norman,27,107,Minnesota,MN
27007,27CS004,345,325,364,461,97,116,136,301.2087099390549,40,103.4750366474088,1.4574632599614885,1.965000348983983,2.5142737079751467,0.3406074395587666,424,400,448,511,63,87,111,188.1371151732523,56,120.7989990940075,0.17102889018764372,0.6724972469481011,1.2248023898182638,0.6348011321535367,46388,46358,Beltrami+Clearwater,Beltrami,27,7,Minnesota,MN
27029,27CS004,82,81,83,92,9,10,11,142.25949964834402,10,139.24344395451382,-0.08885823376617752,0.03208604622287301,0.15168099322174186,0.8915355157699195,100,99,101,125,24,25,26,293.94172710383657,15,174.88632388947184,1.0658642705044932,1.1858782709639335,1.3064701631438422,0.5722704753966726,8618,8577,Beltrami+Clearwater,Clearwater,27,29,Minnesota,MN
27009,27CS005,327,309,345,397,52,70,88,203.9281700755803,72,209.24149956408021,-0.5765899884465508,-0.060203824586593124,0.4719522378236747,1.0116382898130083,403,382,425,407,-18,4,25,9.257750350790985,51,123.06652831736687,-1.65916795367616,-1.1516674586481588,-0.6117002182131472,10.544806040765158,41292,41441,Benton+Stearns,Benton,27,9,Minnesota,MN
27145,27CS005,919,851,987,1187,200,268,336,202.36395294530067,185,139.79056602585493,0.09118748604994438,0.6221894162832967,1.1552673546536125,0.688218081483458,1142,1060,1224,1279,55,137,219,86.24187481402652,121,76.16769482563264,-0.38911188241527556,0.09501796204620269,0.6033907008392666,0.876787181845588,158809,158860,Benton+Stearns,Stearns,27,145,Minnesota,MN
27013,27CS006,434,404,463,456,-7,22,52,38.785673626021335,27,46.959924632219725,-0.5759396184284921,-0.06769516373878098,0.44657005730698296,1.158791008977212,535,499,571,594,23,59,95,85.00024335969132,41,59.1938091938092,-0.24492411283858265,0.25463702939891186,0.7350541890776937,0.6847648506805438,68995,69264,Blue Earth+Faribault+Martin+Watonwan,Blue Earth,27,13,Minnesota,MN
27043,27CS006,162,156,168,159,-9,-3,3,-22.24121188385458,11,95.24496716934844,-1.6810700389719533,-1.1776844238606599,-0.6338115518567253,-7.012289097797511,197,190,204,184,-20,-13,-6,-93.59128637899029,17,122.24938875305624,-2.6884526079140465,-2.1671115139685457,-1.6364946584077305,-1.4149210922090047,13859,13906,Blue Earth+Faribault+Martin+Watonwan,Faribault,27,43,Minnesota,MN
27091,27CS006,214,206,223,215,-8,1,9,3.2182093544401136,23,138.5820445872665,-1.8295964453151405,-1.3526497318455444,-0.8604710834213872,14.992352474088298,261,251,271,302,31,41,51,205.67881827897472,25,125.48310997339757,0.31465528640690793,0.8147416536608234,1.3264486500725403,0.5955586906393414,19916,19923,Blue Earth+Faribault+Martin+Watonwan,Martin,27,91,Minnesota,MN
27165,27CS006,103,102,104,134,30,31,32,335.63811363568703,10,107.55579456843238,2.1638108245889636,2.283284982712233,2.401838462478883,0.3105015960544685,126,124,127,128,1,2,4,21.02437158443315,15,134.55328310010765,-1.264268757774001,-1.1341253761530272,-1.0102858966933796,4.485918328824377,11157,11148,Blue Earth+Faribault+Martin+Watonwan,Watonwan,27,165,Minnesota,MN
27015,27CS007,257,246,268,268,0,11,22,52.475695168733395,30,139.83840894965817,-1.392015053240855,-0.8709547435495838,-0.36880204054417265,2.4474240683301085,316,303,330,342,12,26,39,99.98447122373105,30,116.14851523481359,-0.6965371923826791,-0.15206203444043223,0.3590526779949447,1.1183601946325457,25744,25829,Brown+Le Sueur+Nicollet,Brown,27,15,Minnesota,MN
27079,27CS007,210,198,223,216,-7,6,18,23.50208763079381,19,79.48959313879301,-1.0766069278948178,-0.5507017320125549,-0.04073317544300715,2.8711373869652776,262,247,277,284,7,22,37,75.50640431148473,32,111.07254425546687,-0.843059205213005,-0.3609841030570141,0.12204566055509639,1.4063835258202748,28683,28810,Brown+Le Sueur+Nicollet,Le Sueur,27,79,Minnesota,MN
27103,27CS007,224,209,239,238,-1,14,29,49.48076025065944,30,104.50837518506691,-1.0367538436736594,-0.5453217701737323,-0.05565307418715101,1.9731825328110462,278,260,296,298,2,20,38,58.053045489991334,20,58.21568912822005,-0.5282198312121066,-0.003995176663473126,0.49868914537389886,0.9549217819714023,34447,34355,Brown+Le Sueur+Nicollet,Nicollet,27,103,Minnesota,MN
27019,27CS008,476,430,522,510,-12,34,80,37.75346164652009,36,40.331992045634905,-0.512095691515863,-0.03548896162500293,0.49717984251154557,1.0375110610060074,602,546,658,674,16,72,128,66.59212771422766,53,48.87901061504551,-0.34213946202844875,0.16948767672061044,0.7110573371571957,0.723979329142812,107111,108431,Carver,Carver,27,19,Minnesota,MN
27021,27CS009,291,278,303,310,7,19,32,77.65428030447677,24,95.66517189835575,-0.6864599562949594,-0.18090903778568995,0.36339485309218345,1.1717881703028687,361,345,377,429,52,68,84,222.8109042193741,40,130.87292239235703,0.39011417704111406,0.899680421307596,1.4337702781517352,0.578871831419239,30105,30564,Cass+Crow Wing,Cass,27,21,Minnesota,MN
27035,27CS009,609,581,638,619,-19,10,38,17.463213738521162,68,123.27959994561193,-1.559591654515385,-1.0630562255559246,-0.5467775099726341,6.3954475420369175,757,722,792,815,23,58,93,86.55105886428959,67,99.8227029604136,-0.6876727474996838,-0.14322058532474513,0.3648685744420186,1.1338212844525033,66191,67119,Cass+Crow Wing,Crow Wing,27,35,Minnesota,MN
27025,27CS010,389,364,413,412,-1,23,48,49.27736388858315,27,57.10760553450251,-0.6153583073358532,-0.08352016767132263,0.4572311466796527,1.1112059064945838,486,456,515,544,29,58,88,101.54518598842418,64,111.59157483609987,-0.6139357202693447,-0.09515792192090702,0.40826657865650523,1.0803840313913402,56735,57352,Chisago+Isanti,Chisago,27,25,Minnesota,MN
27059,27CS010,294,276,312,314,2,20,38,57.84019830866946,31,90.070458342413,-0.8231907718141134,-0.33427161042360226,0.19007844251830683,1.4827463152574003,367,346,389,435,46,68,89,161.63010057280044,57,136.26583791537175,-0.27548909953141404,0.24323971989180806,0.7469611505815197,0.8307842459312508,41301,41830,Chisago+Isanti,Isanti,27,59,Minnesota,MN
27027,27CS011,423,395,451,489,38,66,94,120.81514670077766,83,152.662395389473,-0.8002260869812772,-0.32752929335977876,0.19546279136320163,1.2446543282130036,523,490,557,543,-14,20,53,29.838377598048538,32,48.82439999389695,-0.7159419883783714,-0.1783062626428799,0.36280055205881157,1.5566949975852096,65242,65541,Clay,Clay,27,27,Minnesota,MN
27037,27CS012,2337,2148,2526,2746,220,409,598,111.7264107572732,285,77.91994750656168,-0.1707707263516007,0.32374936864671183,0.8025396655040731,0.6957149718981863,2922,2694,3150,3241,91,319,547,72.1674947033331,333,75.37569009500054,-0.5698126081613573,-0.03718196736184599,0.5048400716106718,1.0411891624095735,438912,441787,Dakota,Dakota,27,37,Minnesota,MN
27039,27CS013,139,137,141,133,-8,-6,-4,-33.51132729588809,7,40.22025377064879,-0.8489018659162656,-0.7393162954988457,-0.6165159391869339,-1.448565398886749,171,169,174,163,-11,-8,-6,-40.33921131675717,11,52.57121009367234,-1.056755164193781,-0.9264891551050215,-0.7992071931937109,-1.478380053986938,20885,20924,Dodge+Steele+Waseca,Dodge,27,39,Minnesota,MN
27147,27CS013,278,262,294,299,5,21,37,69.12214190819526,4,12.88417662058784,0.02458120673589027,0.549143703410727,1.0742544797614333,0.17809799819027486,344,325,363,383,20,39,58,103.90084774538948,33,88.3557792711987,-0.34664135973261107,0.1541955068075383,0.6655739047761047,0.8290222579752343,37255,37349,Dodge+Steele+Waseca,Steele,27,147,Minnesota,MN
27161,27CS013,162,154,170,162,-8,0,8,0.39580779797521426,18,114.27966774244749,-1.6475414663812444,-1.145695677704534,-0.6530440715846603,16.943679724577603,200,191,210,188,-22,-12,-3,-65.45280813802793,14,73.71136734586426,-1.8910837017068303,-1.3840472687069891,-0.8964168347936176,-1.224691332660578,18901,18993,Dodge+Steele+Waseca,Waseca,27,161,Minnesota,MN
27041,27CS014,386,369,403,433,30,47,64,145.25061352995365,52,160.21361815754338,-0.666081601473667,-0.15540306638239704,0.36045001306087604,1.0801041041332926,473,453,494,448,-46,-25,-5,-64.83788190776829,46,117.30205278592375,-2.3452009280901485,-1.8148329402351049,-1.2739094515352876,-1.8832256489317163,38948,39215,Douglas+Morrison+Todd,Douglas,27,41,Minnesota,MN
27097,27CS014,281,266,295,323,28,42,57,150.25597007143926,43,152.27527592516086,-0.5207860846037456,-0.03457429398341025,0.485855842087971,0.9901039870484853,344,327,362,415,53,71,88,208.08672931130977,34,100.02942041776994,0.5424149596621257,1.0942931545539651,1.5917738971857072,0.4740084487148606,33886,33990,Douglas+Morrison+Todd,Morrison,27,97,Minnesota,MN
27153,27CS014,188,178,199,214,15,26,36,122.01784490155785,31,147.7832512315271,-0.8165052090271063,-0.24293175153372423,0.23168790294085495,1.1656205147849572,232,219,245,252,7,20,33,80.96409842681462,28,110.93941915289828,-0.8214446868387125,-0.2915272022247309,0.17262718607153008,1.3063035002412036,25172,25239,Douglas+Morrison+Todd,Todd,27,153,Minnesota,MN
27045,27CS015,199,189,208,206,-2,7,17,41.98995568057553,5,28.268551236749115,-0.3647848017215894,0.12804961872293869,0.6282858751693106,0.5933328321022436,242,231,253,248,-5,6,17,27.241812275940923,14,65.8296891898246,-0.8815601460703876,-0.39654908235838493,0.1425853230793087,2.0607884861648875,21225,21267,Fillmore+Houston+Winona,Fillmore,27,45,Minnesota,MN
27055,27CS015,165,157,173,179,6,14,22,88.80627971656678,12,76.62835249042146,-0.4034122860266816,0.11960523092066487,0.6497045715933231,0.804987520016215,201,191,211,202,-9,1,11,4.8610275388139454,6,31.942078364565585,-0.809095459006102,-0.25951733221720125,0.23535317886912346,3.1362784937807207,18792,18784,Fillmore+Houston+Winona,Houston,27,55,Minnesota,MN
27169,27CS015,356,335,377,389,12,33,54,79.27305310507579,41,98.87062417105422,-0.7164734932105856,-0.19167338908219184,0.2999941711672163,1.2103959227145826,435,409,461,431,-30,-4,22,-8.111376427952466,20,40.301454882521256,-0.9815223555142182,-0.4834763506659132,0.011054712281059373,-6.61080172062978,49762,49626,Fillmore+Houston+Winona,Winona,27,169,Minnesota,MN
27047,27CS016,311,297,324,326,2,15,29,59.60945828162586,17,66.2423691388492,-0.5805188204661784,-0.08542420232680992,0.465805306859541,1.0430872353477687,379,363,394,391,-3,12,28,40.30017833319507,24,78.00058500438753,-0.896879230046599,-0.37705024393496767,0.11438557800532825,1.7910498724127022,30796,30769,Freeborn+Mower,Freeborn,27,47,Minnesota,MN
27099,27CS016,354,336,371,354,-17,0,18,1.3777370281963808,30,89.86744551786116,-1.4237959224295553,-0.8494475002964219,-0.3670804692224844,20.549028062725096,433,413,454,447,-7,14,34,33.74238978710629,21,52.31428429076778,-0.7591401459905699,-0.2087991929005985,0.2500375840229181,1.4438080122804495,40059,40142,Freeborn+Mower,Mower,27,99,Minnesota,MN
27049,27CS017,427,407,448,482,34,55,75,138.39300914677824,42,106.2977179735943,-0.18501525000726718,0.3078769327085746,0.8576130850052448,0.7542915896267075,529,504,554,567,13,38,63,79.64473446630055,43,89.76098528337334,-0.6346666666421549,-0.08373823504459016,0.3992644999003673,1.0982328399047763,47414,47905,Goodhue+Wabasha,Goodhue,27,49,Minnesota,MN
27157,27CS017,168,159,177,194,17,26,35,146.32089180250978,6,33.572694208710246,0.6515009892972037,1.1118766325991538,1.6583477569918617,0.22099462127426578,207,196,218,219,1,12,23,55.070792849532324,10,46.52028284331969,-0.4343402879728393,0.07876772581832837,0.5782523184819879,0.7789364594657695,21446,21496,Goodhue+Wabasha,Wabasha,27,157,Minnesota,MN
27053,27CS018,7636,7086,8185,9067,882,1431,1981,134.46757517605892,1286,120.8007984500675,-0.336513837536689,0.1537423794014038,0.6538257959399989,0.8977366411899065,9379,8723,10034,9922,-112,543,1199,42.796173762240144,683,53.80342136192766,-0.5934408498728526,-0.10606218653150368,0.385592099203557,1.2548917896845204,1277475,1269436,Hennepin,Hennepin,27,53,Minnesota,MN
27065,27CS019,142,135,149,181,32,39,46,290.4317083915038,19,141.6237033356109,0.9952749589270755,1.4779302344986198,1.9767636763415617,0.47542986056265685,174,166,182,213,31,39,47,240.85758880179387,29,179.6555569322265,0.12155825855844585,0.6264664550843267,1.0843198247763755,0.7271955490856681,16099,16142,Kanabec+Mille Lacs+Pine,Kanabec,27,65,Minnesota,MN
27095,27CS019,261,249,272,306,34,45,57,206.03775209556034,42,190.75013246536975,-0.3252550846637209,0.14661979339615377,0.6535626736272738,0.9058346287098792,322,308,336,377,41,55,69,205.30154913689717,47,175.3731343283582,-0.22533675341544346,0.2920180962134912,0.8279410883430735,0.8389738681680159,26422,26800,Kanabec+Mille Lacs+Pine,Mille Lacs,27,95,Minnesota,MN
27115,27CS019,250,237,262,302,40,52,65,216.23516668499587,18,74.52130412282214,0.9010953592336408,1.4212087426950983,1.9366713091120342,0.33815642998233425,308,293,323,394,71,86,101,293.8438995391475,38,129.97229537914288,1.1390211288661447,1.6257528907155963,2.112729769661911,0.43722818044824735,28985,29237,Kanabec+Mille Lacs+Pine,Pine,27,115,Minnesota,MN
27067,27CS020,337,318,356,406,50,69,88,190.4831451776446,69,189.84729673957904,-0.49947486625939985,0.011421899407124916,0.5055965250347854,0.9824707411626535,415,392,437,439,2,24,47,55.31652060171061,48,109.70174837161468,-1.0897207117711023,-0.5534608209184133,-0.032906958206303245,1.9044789846385726,43614,43755,Kandiyohi+Renville,Kandiyohi,27,67,Minnesota,MN
27129,27CS020,159,152,165,174,9,15,22,125.02603892213585,34,278.3652862113666,-2.052522554755614,-1.538242028515858,-1.0070948820772192,2.0896215615010028,193,186,201,203,2,10,17,67.39597224923531,10,68.40413160954921,-0.5017104473805934,-0.006359661356996428,0.4774381092477751,0.9214367217852117,14657,14619,Kandiyohi+Renville,Renville,27,129,Minnesota,MN
27085,27CS021,294,279,310,376,66,82,97,267.81002910602086,39,127.94925773026765,0.9111546961315763,1.3916584360426334,1.9378597688061723,0.4719793792273399,361,342,380,417,37,56,75,152.7475844243275,43,117.07051456575007,-0.12250734632196941,0.3404176108364902,0.8979735021726293,0.7530095722827461,36577,36730,McLeod+Meeker+Sibley,McLeod,27,85,Minnesota,MN
27093,27CS021,194,184,204,226,22,32,42,165.06344818063036,29,148.8197057817311,-0.34819849346200055,0.1353094201746831,0.6978292481048519,0.8744062045099026,237,225,249,244,-5,7,19,31.15889169520167,27,115.46356483065343,-1.3469053793354484,-0.8443121524191614,-0.32972248812467636,3.258431552420333,23384,23384,McLeod+Meeker+Sibley,Meeker,27,93,Minnesota,MN
27143,27CS021,122,121,123,93,-30,-29,-28,-234.74206942800583,3,24.284943335132215,-2.718797571168722,-2.5909891554645132,-2.48251884729483,-0.10714871086824465,150,148,152,170,18,20,22,131.82278833938906,12,80.53691275167785,0.3871331214714917,0.5155125904520379,0.6373564685603545,0.5813504107160972,14824,14900,McLeod+Meeker+Sibley,Sibley,27,143,Minnesota,MN
27069,27CS022,50,49,50,74,24,24,25,689.4272240672154,19,543.8931297709923,1.3294690404779954,1.4546096146634477,1.5711873557121026,0.7574552223063137,61,60,61,62,1,1,2,31.751662304826553,5,120.45290291496025,-1.012051342999705,-0.8851240768597898,-0.7609623165215985,2.1570212206006465,4192,4151,Northwest Minnesota,Kittson,27,69,Minnesota,MN
27077,27CS022,39,38,39,45,6,6,7,200.29239530427677,7,223.22614934892374,-0.341335574714169,-0.22807338521509846,-0.1125921356534589,0.9614280959211379,48,48,49,50,1,2,2,45.99388817567374,3,78.65757734661773,-0.4659823903559313,-0.3274506291062204,-0.1959017077430992,1.089242789067232,3763,3814,Northwest Minnesota,Lake of the Woods,27,77,Minnesota,MN
27089,27CS022,72,71,73,87,14,15,16,199.77354995718642,15,198.3471074380165,-0.1074576870325939,0.013362310417809272,0.13978988757594396,0.931221546288455,88,87,89,99,10,11,12,123.56916932115344,12,133.40744858254587,-0.2197575006671316,-0.1000886288528105,0.017118926620606528,0.9905038104662115,9075,8995,Northwest Minnesota,Marshall,27,89,Minnesota,MN
27113,27CS022,116,114,117,121,4,5,7,46.636662738413065,13,111.90015063481816,-0.772323697162344,-0.6518208527733043,-0.5312075533773457,2.025548620683556,141,139,143,156,13,15,17,108.2547349870511,13,94.18242411070058,0.018209489324981447,0.1425929979489679,0.2636873432299925,0.8154355133022517,13941,13803,Northwest Minnesota,Pennington,27,113,Minnesota,MN
27119,27CS022,301,288,315,349,34,48,61,184.04354441751,60,231.8019381217604,-0.9816560034684894,-0.4635104337414862,0.03143223100187281,1.233599860997856,368,352,384,380,-4,12,28,38.54499849645678,35,113.63636363636363,-1.264123568298075,-0.757163537723791,-0.21951314938657393,2.719109845756258,31061,30800,Northwest Minnesota,Polk,27,119,Minnesota,MN
27125,27CS022,28,28,29,27,-2,-1,-1,-40.43940356124059,0,0,-0.5241572839497178,-0.40186730582949404,-0.2900477822052495,-0,35,34,35,43,8,8,9,207.2246747019416,8,203.40706839562674,-0.09811702531563742,0.038351842995723376,0.16151592560274006,0.8743029456900394,3950,3933,Northwest Minnesota,Red Lake,27,125,Minnesota,MN
27135,27CS022,120,118,121,174,53,54,56,427.37446580014864,17,133.5690434099391,2.817375607735232,2.9367487920796322,3.056564363112173,0.3068919715644257,147,146,149,171,22,24,25,154.29578863395034,15,98.27687872633166,0.4396945161116741,0.5589724347452997,0.6911828783242219,0.6109938265211833,15273,15263,Northwest Minnesota,Roseau,27,135,Minnesota,MN
27109,27CS023,970,900,1040,1055,15,85,155,62.73363160655023,57,42.134571909053385,-0.3362562815832575,0.2125261904455031,0.6862226006772799,0.6638205487378438,1206,1122,1290,1266,-24,60,144,36.723601288832974,51,31.217290706428923,-0.48579548263397526,0.03783112353007437,0.573183635075695,0.8361243127154385,162337,163371,Olmsted,Olmsted,27,109,Minnesota,MN
27111,27CS024,582,556,608,675,67,93,119,186.66163706804534,53,106.29941000484699,0.27365968417174646,0.8141719273934799,1.3360197428643483,0.5634225841795338,712,681,743,783,40,71,102,118.25896205807126,82,136.5687923654714,-0.7053542757736794,-0.16566129181393704,0.3193168792474569,1.1387903742130512,59831,60043,Otter Tail+Wadena+Wilkin,Otter Tail,27,111,Minnesota,MN
27159,27CS024,182,176,189,170,-19,-12,-6,-106.70871268671583,11,93.9568652573137,-2.4900919592286948,-1.9975203350950896,-1.4791960440929417,-0.957110775246578,223,216,231,222,-9,-1,6,-8.715385044221064,29,204.70106585727396,-2.673198350893703,-2.1331389557695672,-1.6346275408815318,-123.5574669910585,14049,14167,Otter Tail+Wadena+Wilkin,Wadena,27,159,Minnesota,MN
27167,27CS024,71,70,72,76,4,5,6,94.14025742662095,12,223.811004041032,-1.419858936349211,-1.2996905026603272,-1.177846247747487,1.9842953597389197,87,86,87,89,2,2,3,38.82602825990988,11,171.66042446941324,-1.4501076702172095,-1.327290994072779,-1.1975645931781693,3.1536951397785957,6434,6408,Otter Tail+Wadena+Wilkin,Wilkin,27,167,Minnesota,MN
27123,27CS025,3669,3432,3905,4354,449,685,922,149.41774122870103,630,137.36613161710463,-0.34757227060280144,0.13540456160525446,0.6272501728833271,0.9180032284501014,4478,4197,4760,4976,216,498,779,91.39083344093798,357,65.57003688084988,-0.2959974230114709,0.2387314171694024,0.7677412780634982,0.716029404737627,550354,544456,Ramsey,Ramsey,27,123,Minnesota,MN
27131,27CS026,446,417,474,508,34,62,91,111.84770195527287,52,93.06210105589692,-0.2838974821190621,0.17259418202667673,0.6825503985323976,0.8189393250842963,553,518,587,615,28,62,97,92.77890225373292,73,108.58570833581246,-0.6715765279234235,-0.1579037547445109,0.3287751901897528,1.1519028414289714,67052,67228,Rice,Rice,27,131,Minnesota,MN
27017,27CS027,326,310,341,367,26,41,57,137.72676920697276,41,136.11088057100173,-0.48502205166305934,0.02117002225175994,0.4845511507258172,0.9650068270121751,401,382,419,472,53,71,90,196.16570168673508,34,93.47849994501264,0.5008938813286002,1.0124661751929958,1.5042835699273387,0.46994177092188516,36147,36372,St. Louis and Nearby Counties,Carlton,27,17,Minnesota,MN
27031,27CS027,45,45,46,48,2,3,3,61.16804076255441,1,21.547854192853297,0.2708951075900919,0.39577678624721085,0.5272720356463271,0.26050439524918134,56,55,57,49,-8,-7,-6,-123.54322390055752,4,71.26313914127917,-2.0679445711614806,-1.9493801719116652,-1.8194776452760857,-0.6740269104939338,5569,5613,St. Louis and Nearby Counties,Cook,27,31,Minnesota,MN
27071,27CS027,124,123,125,147,22,23,24,230.67771684988034,3,29.882958412882875,1.8916714998276922,2.00777025559264,2.125904400221213,0.1241818462362397,151,149,152,186,34,35,37,295.46217052177,22,184.03881545926052,0.9869161743223933,1.1067117771522004,1.2329402423534628,0.6057344128367307,12047,11954,St. Louis and Nearby Counties,Koochiching,27,71,Minnesota,MN
27075,27CS027,121,120,122,135,13,14,15,154.77425165749972,12,132.62110885982685,0.10709485265433505,0.2202259159080435,0.34250574687872054,0.7997605941111399,150,148,151,169,18,19,21,174.86236651186297,6,54.68963631391851,1.0794986160488214,1.2022958792473755,1.3329429809623659,0.2972629479876349,10858,10971,St. Louis and Nearby Counties,Lake,27,75,Minnesota,MN
27137,27CS027,1766,1680,1852,2079,227,313,399,188.23548229888928,220,132.15131325367545,0.059362103951674364,0.560578555902215,1.0842407997080012,0.6998199189975459,2156,2054,2259,2371,112,215,317,107.65565040225032,185,92.82675016056518,-0.3774009634939911,0.1419502936699685,0.6913891928990246,0.8582559852300622,199771,199296,St. Louis and Nearby Counties,St. Louis,27,137,Minnesota,MN
27139,27CS028,629,564,694,740,46,111,176,88.01314095724297,64,50.81247022706823,-0.1455063312944994,0.36277904352865875,0.8946144137745967,0.5721668464485303,795,716,874,911,37,116,195,75.85306608786506,109,71.25300700763518,-0.45277307733423433,0.0433729747065371,0.5513983866078529,0.93132951704194,151144,152976,Scott,Scott,27,139,Minnesota,MN
27141,27CS029,486,444,528,595,67,109,151,133.78406676099473,57,70.05540932228561,0.13065760919403238,0.6469418633908938,1.200730396479543,0.5188785727971015,612,561,663,727,64,115,166,116.4485147866671,87,88.02015357999211,-0.19078105119983027,0.2745331155748714,0.7708991920197937,0.749361256736907,97637,98841,Sherburne,Sherburne,27,141,Minnesota,MN
27033,27CS030,136,131,141,150,9,14,19,150.99579261661037,16,167.5392670157068,-0.7516080303058935,-0.15967334264974653,0.33674200608095567,1.0376068814727792,167,161,173,166,-7,-1,5,-8.429352497610227,16,138.4442329324219,-1.9617168831278249,-1.470939674126412,-0.9573379513196479,619.6811063808541,11460,11557,Southwest Minnesota,Cottonwood,27,33,Minnesota,MN
27063,27CS030,91,90,92,96,4,5,6,55.985753180290075,11,132.71667001809772,-0.8913374902652325,-0.7661566545085527,-0.642675386597595,1.9502557683526658,113,112,114,106,-8,-7,-6,-69.97208979680258,8,80.10413537598879,-1.6244886136845025,-1.5021583110170886,-1.3727255706560098,-1.335980220095267,9946,9987,Southwest Minnesota,Jackson,27,63,Minnesota,MN
27101,27CS030,82,81,83,58,-25,-24,-23,-350.1634089228103,5,73.43941248470011,-4.359671404570706,-4.234751331490112,-4.108434623429121,-0.21891138607670674,100,99,101,109,8,9,10,105.23427636500075,1,12.272950417280313,0.8079457080806088,0.9269242055617686,1.0624145093139228,0.10444421805664597,8170,8148,Southwest Minnesota,Murray,27,101,Minnesota,MN
27105,27CS030,161,152,171,201,30,40,49,215.8444578339084,43,233.6427439438533,-0.7069034441500102,-0.17138224428875906,0.3583514290072353,1.0558787288631257,199,187,210,184,-26,-15,-3,-66.88748053225338,18,81.74758163404333,-1.9912839140717449,-1.478527727219485,-0.9354107339010396,-1.3111931724346058,22085,22019,Southwest Minnesota,Nobles,27,105,Minnesota,MN
27117,27CS030,103,102,104,106,2,3,4,39.45516057772802,17,217.97200555614916,-1.8989106438925227,-1.7876997012299873,-1.6647835659043126,4.169554970476859,126,125,127,128,1,2,3,20.6220649934482,11,117.9498177139181,-1.1033101427977525,-0.9705568215369886,-0.8531763363063258,3.762981712254242,9359,9326,Southwest Minnesota,Pipestone,27,117,Minnesota,MN
27133,27CS030,102,101,103,119,16,17,18,212.46522524417452,13,161.6915422885572,0.3883690835945617,0.5059352944680585,0.6341723326557182,0.7189389037520844,126,125,127,122,-5,-4,-3,-39.121837107196846,16,165.22098306484924,-2.1760669268101074,-2.048788275719377,-1.9147465925292733,-5.737731096952191,9648,9684,Southwest Minnesota,Rock,27,133,Minnesota,MN
27011,27CS031,68,67,68,67,-1,-1,-0,-15.212144746913653,3,70.298769771529,-0.9705700157413418,-0.8569109837481682,-0.7360125882428971,8.551351880332165,84,83,84,76,-8,-8,-7,-145.87496165815938,1,19.436345966958214,-1.7764550850429188,-1.6519822744087207,-1.5214422925483722,-0.1537215973198193,5121,5145,Stevens and Nearby Counties,Big Stone,27,11,Minnesota,MN
27023,27CS031,151,145,156,155,-1,4,10,40.60369009753021,28,269.96625421822273,-2.793874155171529,-2.288729878315365,-1.7486776787564264,5.372960821644015,183,177,190,172,-18,-11,-5,-91.89904897171719,4,32.28149463320152,-1.713302749683559,-1.250268065495878,-0.730042994784566,-0.385088927058768,12446,12391,Stevens and Nearby Counties,Chippewa,27,23,Minnesota,MN
27051,27CS031,60,59,61,73,12,13,14,258.81067697827353,6,118.55754981063724,1.2859272107672457,1.400788416648555,1.5268092108294538,0.4255929765971548,75,74,75,78,3,3,4,54.03153987588102,1,16.281341582546403,0.25297769305890605,0.379144790358456,0.49855264026531276,0.23155560183055168,6073,6142,Stevens and Nearby Counties,Grant,27,51,Minnesota,MN
27121,27CS031,113,112,114,109,-5,-4,-3,-42.263045260404624,8,84.91817779743478,-1.3969995019163999,-1.2708914196459362,-1.147786362735625,-2.683185199444444,140,139,142,148,6,8,9,67.88558810638034,8,70.24321713934498,-0.14613625221334173,-0.023768713504817504,0.10288447944849022,0.9162239594295967,11305,11389,Stevens and Nearby Counties,Pope,27,121,Minnesota,MN
27149,27CS031,74,73,75,80,5,6,7,73.44896779943541,7,86.80376149633149,-0.25423886691012476,-0.13495135407337003,-0.0049031552179162755,1.0111154553371353,92,91,93,74,-19,-18,-17,-183.57788844093676,4,41.27115146512588,-2.370065564072621,-2.251752151215224,-2.124492068714688,-0.23820343707663222,9677,9692,Stevens and Nearby Counties,Stevens,27,149,Minnesota,MN
27151,27CS031,106,105,107,123,16,17,18,215.7326015014733,17,210.00617665225448,-0.059003184719450916,0.055596481720936,0.16805710479100033,0.920732807763456,130,129,132,94,-38,-36,-35,-373.8672949919314,15,153.76729882111738,-5.41271584786505,-5.275738703527077,-5.150656858832757,-0.42288358840861173,9714,9755,Stevens and Nearby Counties,Swift,27,151,Minnesota,MN
27155,27CS031,48,48,48,56,8,8,8,285.1785570769428,9,324.61677186654646,-0.5084999325907293,-0.3901951851860601,-0.283319766731184,1.0104893856336417,58,58,59,62,3,4,4,107.6082920042251,6,182.09408194233689,-0.8812265609263557,-0.7477283344837087,-0.6097592478518308,1.3199306921042815,3327,3295,Stevens and Nearby Counties,Traverse,27,155,Minnesota,MN
27163,27CS032,1492,1376,1607,1715,108,223,339,100.00635244334592,172,77.07532021360021,-0.2765107024979291,0.22773954633663485,0.7388612218499963,0.7672662473484044,1875,1735,2015,2018,3,143,283,52.64680134227394,182,66.99476925455436,-0.665263076867229,-0.15059486090133453,0.3383441773593045,1.2636968777790945,267790,271663,Washington,Washington,27,163,Minnesota,MN
27171,27CS033,751,690,812,824,12,73,134,62.14728139712379,92,77.9600454766932,-0.6466001467616384,-0.16145462198785915,0.329325170874277,1.2375656785201228,951,877,1026,1097,71,146,220,100.87929299233312,146,101.11153433290626,-0.5209968567982732,-0.0010251230081878174,0.5262667198974221,0.9954681984166367,141611,144395,Wright,Wright,27,171,Minnesota,MN
27073,27CS034,71,70,72,94,22,23,24,409.64606847659024,16,287.0384212886829,1.1086790573126757,1.2256595548332825,1.3415412699522888,0.6712999058836158,87,86,88,102,14,15,16,223.91051954576855,2,29.91325157044571,1.8156691134190959,1.9414543884431734,2.06758177756566,0.12522966073461364,6689,6686,Yellow Medicine and Nearby Counties,Lac Qui Parle,27,73,Minnesota,MN
27081,27CS034,68,67,69,65,-4,-3,-2,-63.94089540897531,5,106.76156583629891,-1.826218296763782,-1.7106551757357924,-1.580749710974242,-2.5068119250921197,82,82,83,101,18,19,19,332.4389792342545,6,107.60401721664275,2.116754945065581,2.2531376027840753,2.3748093914145265,0.30711277042702084,5620,5576,Yellow Medicine and Nearby Counties,Lincoln,27,81,Minnesota,MN
27083,27CS034,188,177,199,226,27,38,49,180.25594601358168,25,118.8636633781053,0.08007765148123451,0.623630091571564,1.1637886310203724,0.6424698499022332,231,218,244,247,3,16,29,64.06137512954909,37,146.69151171549777,-1.3415336740635884,-0.8287024412286836,-0.32035580449613565,2.156403270777441,25239,25223,Yellow Medicine and Nearby Counties,Lyon,27,83,Minnesota,MN
27127,27CS034,157,150,163,178,15,21,28,165.2293624897296,21,164.126611957796,-0.4814715829914592,0.013834106514353989,0.5228143107575922,0.9484624933380842,191,183,199,187,-12,-4,4,-28.296547457280752,18,117.11125569290827,-1.9654951715842544,-1.4452847516214125,-0.9403523596806379,-5.374450917732289,15354,15370,Yellow Medicine and Nearby Counties,Redwood,27,127,Minnesota,MN
27173,27CS034,89,89,90,91,1,2,2,19.301460621138183,14,176.4891270091396,-1.6944267452054018,-1.5716084072990457,-1.4454974437259651,5.5312174005404655,108,107,110,109,-1,1,2,6.144261458537506,16,169.79730446779158,-1.7643392527175041,-1.6358303551155788,-1.5071517613417147,10.133163978600829,9519,9423,Yellow Medicine and Nearby Counties,Yellow Medicine,27,173,Minnesota,MN
28001,28CS001,329,317,342,414,72,85,97,343.74499473664304,61,247.88350829664745,0.4347883744978166,0.9499000862868993,1.4781494646224693,0.7127007968888487,394,379,409,467,58,73,88,253.29278178982915,60,208.05159679600538,-0.05497694645351175,0.4455249188933685,0.9811114870769513,0.8102950105098753,29530,28839,Adams+Amite+Wilkinson,Adams,28,1,Mississippi,MS
28005,28CS001,151,146,157,167,10,16,21,151.40471946915886,23,218.49271690943633,-1.1992142780569324,-0.665057617818929,-0.17053766182238003,1.3579039049869879,184,178,191,224,33,40,46,315.95935018922194,31,245.13680215087777,0.17348485658317433,0.705740462013294,1.2201048420454672,0.7569057992967753,12632,12646,Adams+Amite+Wilkinson,Amite,28,5,Mississippi,MS
28157,28CS001,104,103,105,119,14,15,16,211.2184422935522,19,267.6684667762385,-0.6791856229025311,-0.5628382187054594,-0.44501535994118563,1.1880205686741176,125,124,126,123,-3,-2,-1,-23.924321864771233,15,179.72681524083393,-2.1709089381772797,-2.038853692466458,-1.904303737435328,-15.049302978842164,8518,8346,Adams+Amite+Wilkinson,Wilkinson,28,157,Mississippi,MS
28003,28CS002,378,363,393,463,70,85,100,290.5254382648327,41,140.6116033152329,0.9403040034580963,1.5084538744625533,2.0282501286074375,0.4783439924704624,456,438,474,541,67,85,103,246.89223826013952,67,194.78442887461117,0.008166069061325342,0.5272289000607873,1.0347748408148751,0.7797631836913935,34990,34397,Alcorn+Prentiss+Tishomingo,Alcorn,28,3,Mississippi,MS
28117,28CS002,267,256,278,342,64,75,86,361.2361636977827,45,216.32881980610526,0.9530559925675985,1.449834158643212,1.9871067586629436,0.5909921554688623,326,313,339,367,28,41,54,162.6633477913658,40,160.08324328650897,-0.5364497658943541,-0.0018623398934372979,0.5329826503497123,0.9605065931698749,24962,24987,Alcorn+Prentiss+Tishomingo,Prentiss,28,117,Mississippi,MS
28141,28CS002,240,232,249,308,59,68,76,429.3235043390523,44,279.45379485550967,0.9710571980830351,1.4891314764239125,1.9721151734539415,0.6414276008439728,291,282,301,394,93,103,112,547.6087614375147,39,207.88912579957358,2.872017083405798,3.410442422286608,3.9166527590088087,0.37597100424105795,18894,18760,Alcorn+Prentiss+Tishomingo,Tishomingo,28,141,Mississippi,MS
28007,28CS003,221,213,229,272,43,51,59,342.56249667337534,33,221.61284906821868,0.6758010592539382,1.2016544140607925,1.6870002788990874,0.6344883595316528,268,258,277,305,28,37,47,211.02089764975835,33,185.86313714446635,-0.26580399380512487,0.260118574916897,0.7585934343070493,0.857883525307691,17869,17755,Attala+Choctaw+Leake+Webster,Attala,28,7,Mississippi,MS
28019,28CS003,92,92,93,108,15,16,16,227.46191548009034,10,146.50225857648638,0.6908571056493394,0.8143430058291177,0.9260855756526302,0.6051008337170511,112,111,113,115,2,3,4,33.704321482105435,13,160.0985221674877,-1.3847074003090716,-1.2616567285166969,-1.141304067514545,3.478920906405886,8191,8120,Attala+Choctaw+Leake+Webster,Choctaw,28,19,Mississippi,MS
28079,28CS003,188,179,198,270,72,82,91,456.3446994592234,62,346.4816280910912,0.6001676431604658,1.096962874858401,1.6173077264177007,0.7500688270196714,229,218,240,317,77,88,99,416.85658381714256,38,179.2199217091921,1.8721208895583414,2.372252333732036,2.864147715664629,0.42512201982693976,21473,21203,Attala+Choctaw+Leake+Webster,Leake,28,79,Mississippi,MS
28155,28CS003,135,131,139,152,13,17,21,205.89787744113204,20,242.5222312045271,-0.8808482478714401,-0.36235600975345167,0.1477667015006446,1.1123648930348486,165,160,170,203,33,38,43,379.5634851135292,23,230.59955885301784,0.9369738073319586,1.4825097998843384,1.9993976423477522,0.5919038566167014,9896,9974,Attala+Choctaw+Leake+Webster,Webster,28,155,Mississippi,MS
28009,28CS004,88,87,89,119,30,31,32,482.9140760278705,18,278.74564459930315,1.921510662042272,2.04028437822818,2.1683169627233343,0.5592810498864568,106,105,107,132,25,26,27,337.75787409770686,24,313.8075313807531,0.11012223228468065,0.23989049466431386,0.3710682039324595,0.8944636431189459,7749,7648,Benton+Marshall+Tippah,Benton,28,9,Mississippi,MS
28093,28CS004,339,324,353,437,84,98,113,347.19833711696214,46,162.46284251111047,1.3316120696528115,1.8393280766675524,2.3870722446363932,0.4632132368734866,413,395,430,580,150,167,185,495.9120410836921,72,213.46615671973672,2.3245639998932757,2.827046553855736,3.340487692685836,0.42789349160298945,33977,33729,Benton+Marshall+Tippah,Marshall,28,93,Mississippi,MS
28139,28CS004,231,221,240,285,45,54,64,300.1209299566196,43,237.08877044660906,0.12424380149547926,0.638508935628245,1.1470365936997347,0.7757261551986132,281,270,292,334,42,53,64,246.2041902759369,45,207.8617950020786,-0.12442613455541485,0.36438000163893,0.8555398383843719,0.8287179093646093,21764,21649,Benton+Marshall+Tippah,Tippah,28,139,Mississippi,MS
28011,28CS005,337,324,350,473,123,136,149,529.3228305348324,87,339.25844084099697,1.4480581721101866,1.9075751394266751,2.4094099388776193,0.6362419711625715,409,393,425,492,67,83,99,273.40722121558804,50,164.54404844176787,0.5769732933975041,1.0758304830526497,1.6188716375012298,0.5946699566883795,30773,30387,Bolivar+Sunflower,Bolivar,28,11,Mississippi,MS
28133,28CS005,267,256,278,367,89,100,111,467.73989819983706,55,257.0093457943925,1.600245345649392,2.1117927209351484,2.618070335622735,0.5440355305763909,325,312,338,397,59,72,85,283.0821181028844,43,168.86584982720703,0.6312471855372709,1.140024256061618,1.6414837697062616,0.5883638282428059,25680,25464,Bolivar+Sunflower,Sunflower,28,133,Mississippi,MS
28013,28CS006,143,137,149,209,60,66,72,593.5717180096599,19,170.39085270159183,3.7167171943798785,4.222875055238837,4.7703421105143375,0.2827877809289135,171,164,178,231,53,60,67,459.7067712967297,32,245.21072796934865,1.624454499589025,2.119482045501147,2.6366627197497836,0.5246612628100666,13381,13050,Calhoun+Chickasaw+Grenada,Calhoun,28,13,Mississippi,MS
28017,28CS006,171,164,179,210,31,39,46,272.54077751238884,34,239.2260334212841,-0.16893606361746405,0.3383331946369272,0.8043381305838094,0.8556718636473191,209,200,218,248,30,39,48,229.7652305269906,33,193.90093424995592,-0.15679470311040236,0.3622326452039998,0.8628578374991793,0.8228658032514252,17055,17019,Calhoun+Chickasaw+Grenada,Chickasaw,28,17,Mississippi,MS
28043,28CS006,262,252,271,329,58,67,77,377.1445110379624,48,268.71938418474457,0.5717700099438892,1.0920941473501793,1.5879996069267261,0.7020886141805882,318,306,329,350,21,32,44,151.72606304379826,39,182.27706113292203,-0.8278229672706467,-0.3167865521959495,0.22886674979834634,1.1654555932391382,21435,21396,Calhoun+Chickasaw+Grenada,Grenada,28,43,Mississippi,MS
28015,28CS007,96,95,97,141,44,45,46,547.887768965511,20,241.61884627000904,2.942849175191858,3.059326678649456,3.1876497399665142,0.43148633379556706,117,116,119,156,37,39,40,391.61952076440406,24,242.71844660194174,1.3620532162965846,1.4872701352427238,1.6213594307222006,0.6041788298656717,9933,9888,Carroll+Leflore+Montgomery,Carroll,28,15,Mississippi,MS
28083,28CS007,306,294,318,477,159,171,183,729.8920776623512,91,388.1976537504444,2.8958725880892215,3.408663444490346,3.9102736740728434,0.5287658258604785,369,354,383,442,59,73,88,265.5389929145859,39,141.0488245931284,0.7383011280026078,1.2378964784183644,1.7502487645915554,0.5240418893902445,28130,27650,Carroll+Leflore+Montgomery,Leflore,28,83,Mississippi,MS
28097,28CS007,133,129,137,184,47,51,55,624.334285485648,35,429.3600490697199,1.4501393842131145,1.937484371844636,2.4814467172292294,0.6744563180451033,162,157,167,169,2,7,12,75.3714597431769,26,266.99527623742046,-2.4454777673665236,-1.9080369122185448,-1.4331288257546642,3.117628326681396,9782,9738,Carroll+Leflore+Montgomery,Montgomery,28,97,Mississippi,MS
28021,28CS008,91,90,92,113,21,22,23,293.34657325262407,20,264.9006622516556,0.1582834248279523,0.2877582632103939,0.40673964857966366,0.8640179859852729,110,109,111,130,19,20,21,227.7530554651082,20,223.83883603805262,-0.07936225981145437,0.03742318570540601,0.16403794520670298,0.9367797551665092,9060,8935,Claiborne+Jefferson+Warren,Claiborne,28,21,Mississippi,MS
28063,28CS008,73,73,74,97,23,24,24,391.2340811070884,17,282.74428274428277,0.9667318392607387,1.0811069907653874,1.208201023147626,0.6932282048240805,90,89,91,104,13,14,15,195.8570423170834,20,277.31558513588465,-0.9434221973781307,-0.81787601706852,-0.6886579137354722,1.3222956998897544,7215,7212,Claiborne+Jefferson+Warren,Jefferson,28,63,Mississippi,MS
28149,28CS008,427,408,446,581,135,154,173,414.6238852048515,87,234.16997510261757,1.2750592488090173,1.8025632846802764,2.306704506865576,0.5611341500744881,511,489,534,653,119,142,164,323.66832079127903,98,224.15370539798718,0.47900831863657817,0.9984833298225246,1.5054905427509202,0.6876817057031659,44583,43720,Claiborne+Jefferson+Warren,Warren,28,149,Mississippi,MS
28023,28CS009,183,176,189,237,48,54,61,421.4696101353596,45,348.00541341754206,0.25865729810870536,0.719031584107552,1.2618899635004437,0.8108176357440348,220,212,228,254,26,34,42,217.5556348724102,35,226.72799118999805,-0.6035450216114501,-0.08263907229001617,0.42787894321704584,1.0120268298283364,15517,15437,Clarke+Jasper+Wayne,Clarke,28,23,Mississippi,MS
28061,28CS009,166,159,173,209,36,43,50,313.3983376194545,22,161.5172835729581,1.0326665808126827,1.5292101422768332,2.053476634903866,0.5035769386221461,202,193,210,317,107,115,124,707.2934721012687,37,227.00779188907296,4.270723378116922,4.810770611412249,5.312746018589007,0.3181926300372716,16345,16299,Clarke+Jasper+Wayne,Jasper,28,61,Mississippi,MS
28153,28CS009,185,176,193,224,31,39,48,237.2119827289638,29,175.49167927382751,0.11211930614241689,0.6428947337899177,1.1295743047687172,0.7214059529101684,224,214,234,301,67,77,87,390.28611587774816,39,197.7787920279933,1.4463887442460097,1.9457236468348782,2.4078851714932323,0.5002532102818008,19830,19719,Clarke+Jasper+Wayne,Wayne,28,153,Mississippi,MS
28025,28CS010,185,177,193,241,48,56,64,355.9048603765896,29,185.7386848847139,1.1736558227757186,1.7148500657071732,2.201086739606963,0.5126517846575803,224,215,234,287,53,63,72,338.4625845096512,41,221.01234434801358,0.681375254780979,1.145695988574389,1.6919776955362418,0.6427521676868477,18736,18551,Clay+Oktibbeha,Clay,28,25,Mississippi,MS
28105,28CS010,284,262,306,397,91,113,135,263.398780070095,73,170.40149393090567,0.39909815022528733,0.9192923278400923,1.4663225029606193,0.6412506678561941,352,325,379,428,49,76,103,146.21101102408417,61,117.70835343380352,-0.20031480669780838,0.2818693157734267,0.8150004363805207,0.7945715678807996,51408,51823,Clay+Oktibbeha,Oktibbeha,28,105,Mississippi,MS
28027,28CS011,234,225,243,333,90,99,108,559.3991874717972,58,326.54593225110256,1.8550331131280728,2.3200437814155848,2.841129500429823,0.5779274423002657,282,271,293,390,97,108,119,516.5046396800598,53,253.92870831736298,2.1058979769841066,2.6364091996310237,3.1547678237020076,0.4871106460997735,21314,20872,Coahoma+Quitman+Tallahatchie+Tunica,Coahoma,28,27,Mississippi,MS
28119,28CS011,72,72,73,123,50,51,51,979.1636491924717,13,250.56215868936715,7.162915789788206,7.28277227537829,7.41117480542018,0.25095423417641854,85,84,86,130,44,45,46,751.8629117508835,19,318.417965476789,4.2022962823149275,4.336983099920076,4.462622122454347,0.4142713430006808,6226,5967,Coahoma+Quitman+Tallahatchie+Tunica,Quitman,28,119,Mississippi,MS
28135,28CS011,131,125,136,181,45,50,56,471.6088413590165,31,290.1263453439401,1.3516350882146222,1.8191742282101457,2.287715693504968,0.603213712126378,157,150,163,192,29,35,42,283.9539416939919,24,193.39242546333602,0.3942527172301532,0.9126870113907474,1.417600303924113,0.6622757021540344,12822,12410,Coahoma+Quitman+Tallahatchie+Tunica,Tallahatchie,28,135,Mississippi,MS
28143,28CS011,94,93,95,117,22,23,24,288.1265963409449,15,185.56701030927834,0.8886206197834411,1.0235341583225768,1.142763705286454,0.6175321526921393,116,114,117,163,46,47,49,489.11819333095957,21,216.49484536082477,2.5910443047045737,2.7294648302320237,2.843911636070327,0.4334860568080662,9700,9700,Coahoma+Quitman+Tallahatchie+Tunica,Tunica,28,143,Mississippi,MS
28029,28CS012,273,261,285,364,79,91,103,385.696110632827,42,178.50818162499115,1.5616738986708025,2.057410057398051,2.575535966572643,0.45777631211707676,331,316,345,399,54,68,83,243.46597517098763,46,164.0630572794065,0.2835901021044942,0.7993902216260629,1.294022384883613,0.6641353473382944,28234,28038,Copiah+Franklin+Lincoln,Copiah,28,29,Mississippi,MS
28037,28CS012,84,83,84,103,19,19,20,305.36665907088405,14,219.2925205586738,0.7463596189412715,0.8581944090877819,0.9874190629472679,0.6830895558780308,103,102,104,143,39,40,41,527.0761153677603,16,208.52339371823277,3.0523397937694696,3.1855180747156555,3.3070212446862084,0.38607662587745206,7661,7673,Copiah+Franklin+Lincoln,Franklin,28,37,Mississippi,MS
28085,28CS012,362,347,377,474,97,112,127,387.4562399132436,74,255.7161780798249,0.7999297188183494,1.3306062945471047,1.866867376982023,0.6541530244223834,443,425,461,536,75,93,111,267.5687399684992,54,154.62146374985682,0.6195030275753837,1.1107629874115807,1.6315069531781903,0.5717570640334558,34726,34924,Copiah+Franklin+Lincoln,Lincoln,28,85,Mississippi,MS
28031,28CS013,218,210,226,298,72,80,88,522.6819537403447,50,327.0467676877793,1.4385111274800955,1.9578299462101856,2.4782324313392663,0.6179754776812527,264,255,273,302,29,38,47,207.89771672521294,30,164.07788230146576,-0.07609980083437187,0.42055604623535836,0.9336612253689965,0.768993790464264,18346,18284,Covington+Simpson+Smith,Covington,28,31,Mississippi,MS
28127,28CS013,252,241,263,350,87,98,109,452.33083554514945,58,267.57910114951363,1.3157916148342899,1.8551746337044615,2.323842751748867,0.585583668947621,304,291,318,400,82,96,109,371.0722871541774,58,225.05917504171356,0.9414164802178143,1.464852687108751,1.958996205033276,0.6002336412190702,26011,25771,Covington+Simpson+Smith,Simpson,28,127,Mississippi,MS
28129,28CS013,140,134,146,164,18,24,30,201.21727678249056,16,132.95478152482514,0.1934480364444897,0.7029187909705227,1.2114514729062895,0.6345473989215291,168,161,176,221,45,53,60,371.47603047567515,32,225.4632565349116,0.9491954908654214,1.4601632726885359,1.9499807240831877,0.5956414716487047,14441,14193,Covington+Simpson+Smith,Smith,28,129,Mississippi,MS
28033,28CS014,1250,1170,1330,1497,167,247,327,159.53743086580403,152,98.00602866031561,0.11108496901907516,0.6265265306172967,1.1034763331302668,0.6118409170991369,1558,1461,1655,2083,428,525,622,278.966484909052,275,146.09397827184105,0.8124741145684352,1.3235398408366328,1.8515106950119657,0.5227018311454141,186111,188235,De Soto,De Soto,28,33,Mississippi,MS
28035,28CS015,682,649,716,780,64,98,131,151.29565313813995,92,142.16361693086264,-0.41127114844642565,0.08469023597758277,0.63116740970114,0.9301411322141968,839,798,879,1029,150,190,231,244.274427342818,141,180.9710831311848,0.14826901755892066,0.629174992065289,1.1383610215577538,0.7369792444575921,77657,77913,Forrest,Forrest,28,35,Mississippi,MS
28039,28CS016,245,235,256,269,13,24,34,116.71241522646352,37,182.0119701565959,-1.1409960304821711,-0.6591241025185006,-0.17530350751940807,1.496419383354104,303,290,316,382,66,79,92,320.74614977091875,42,170.04048582995952,1.0025347675564946,1.5157414582796431,2.01360661057609,0.5235321533123829,24394,24700,George+Greene+Perry+Stone,George,28,39,Mississippi,MS
28041,28CS016,118,117,119,141,22,23,24,203.1752864783461,22,195.20851818988464,-0.03891491814959818,0.07917914932215776,0.19759764214132167,0.9205847218047072,146,144,147,143,-4,-3,-1,-20.205491534581586,17,124.8989787671736,-1.5766698949677347,-1.451896665028925,-1.3332408692816924,-9.713345169563771,13524,13611,George+Greene+Perry+Stone,Greene,28,41,Mississippi,MS
28111,28CS016,126,121,131,177,46,51,56,524.8705148751923,25,259.56047759127875,2.163057116745533,2.6631855472359818,3.163380374252199,0.48493050876305566,154,148,160,195,35,41,47,351.6328461322721,26,224.9913464866736,0.7644925904564083,1.2664194530616384,1.7776741938653948,0.6244792248718909,11558,11556,George+Greene+Perry+Stone,Perry,28,111,Mississippi,MS
28131,28CS016,168,160,176,217,41,49,57,321.14494317684574,14,91.5082520834468,1.7809569128802125,2.2969860176937966,2.8412237765721264,0.27925996055607327,208,198,217,282,65,74,84,400.1326080156988,47,252.70175815904082,0.9430158693188827,1.485390480463079,1.998598114127682,0.6231713916831215,18359,18599,George+Greene+Perry+Stone,Stone,28,131,Mississippi,MS
28045,28CS017,428,408,448,522,74,94,114,243.77462012635846,54,139.938668855008,0.5054816597723466,1.0494224309000428,1.5643033930431045,0.5680111100662151,522,498,546,658,112,136,160,295.22639519460927,78,169.3516870033436,0.7304185472201984,1.2637303810528588,1.7443967891261412,0.5694454282944487,46306,46058,Hancock+Harrison,Hancock,28,45,Mississippi,MS
28047,28CS017,1808,1719,1898,2084,186,276,365,158.59698714601407,145,83.41922957067861,0.23603398126472985,0.7496530216367977,1.2702875232178388,0.5240813487666266,2223,2115,2331,2856,525,633,741,302.5581226014519,348,166.2828145755488,0.8463325172924732,1.3569120135028356,1.8801566049875464,0.5487230684733676,208585,209282,Hancock+Harrison,Harrison,28,47,Mississippi,MS
28049,28CS018,1812,1715,1910,2460,550,648,745,342.3364621836827,268,141.67775359701136,1.5436799528881988,2.010964347945501,2.547990166528536,0.4132171785661274,2200,2084,2315,2878,563,678,794,303.8951549110728,329,147.36446052961622,1.0112508864330711,1.5677553247390479,2.0690280009066475,0.4842050779943926,226994,223256,Hinds,Hinds,28,49,Mississippi,MS
28057,28CS019,259,248,269,301,32,42,53,213.70078494091652,43,217.20828422293317,-0.5424824780007469,-0.04510457983289328,0.47466576980396524,0.992942440872623,318,305,330,358,28,40,53,169.6952822244306,56,234.93874811209935,-1.1720082324060086,-0.6655737200261614,-0.10771437328600127,1.351072025327786,23756,23836,Itawamba+Monroe,Itawamba,28,57,Mississippi,MS
28095,28CS019,368,353,382,495,113,127,142,445.8298027824901,76,266.3084739823629,1.2778215548758995,1.7806535461203887,2.290383663275195,0.5926739485069039,447,430,465,554,89,107,124,314.8010517619627,84,247.68532169605473,0.17145383465040695,0.6886733045757419,1.1822877146046094,0.7794982408636023,34246,33914,Itawamba+Monroe,Monroe,28,95,Mississippi,MS
28059,28CS020,1217,1155,1279,1424,145,207,269,173.32190039295875,142,118.84668498653909,-0.0023003313966017073,0.5416917495902179,1.0033748738304056,0.6824039418706795,1502,1428,1576,1824,248,322,396,223.8512680325857,207,143.86389224802969,0.2878402723038582,0.8106818334927773,1.3069063774743233,0.6406870928523427,143378,143886,Jackson,Jackson,28,59,Mississippi,MS
28065,28CS021,143,138,148,145,-3,2,7,20.29238294531486,21,224.5989304812834,-2.5791817995457067,-2.0461803646366294,-1.5496499334648075,7.248032991167023,173,168,179,197,18,24,29,211.87454923075026,17,152.4390243902439,0.0851039293827349,0.6020459260520429,1.1077247313329244,0.6902642366479198,11220,11152,Jefferson Davis+Lawrence+Marion,Jefferson Davis,28,65,Mississippi,MS
28077,28CS021,142,136,147,176,29,34,40,341.76395530579606,17,169.1963174919134,1.250702895058711,1.7310375455675604,2.2207830280965783,0.4810585541671443,170,164,177,202,25,32,38,266.46240883953413,27,228.09833572695783,-0.18389852167855575,0.38032646608933424,0.9161110968296802,0.8297185432599276,12057,11837,Jefferson Davis+Lawrence+Marion,Lawrence,28,77,Mississippi,MS
28091,28CS021,275,264,285,397,112,122,133,601.073445690591,66,324.43060789775524,2.2485474136304453,2.762590225102448,3.3004911403597843,0.535373703582783,335,323,348,408,60,73,85,297.5128630384305,39,159.96062507690417,0.8811913824568997,1.3685749047872473,1.8459340572909921,0.5303480728412996,24412,24381,Jefferson Davis+Lawrence+Marion,Marion,28,91,Mississippi,MS
28067,28CS022,658,629,687,763,76,105,134,187.92902508942606,86,153.41846670730075,-0.163668704217538,0.3485658535596999,0.8612699344582413,0.8086873247971301,800,765,834,1048,214,248,283,371.9752583544434,138,206.58064129816475,1.1549937462423612,1.6615615340348076,2.154733782364147,0.5531352280013236,67267,66802,Jones,Jones,28,67,Mississippi,MS
28069,28CS023,83,82,84,106,22,23,24,301.748707373238,20,264.22987999559615,0.253477036216054,0.37408389783060825,0.4990807184384413,0.8389310104696686,100,98,101,133,32,33,35,378.48664351285095,19,214.6650096034346,1.5176455258123966,1.643062655692246,1.7676359253016536,0.5507269871731183,9083,8851,Kemper+Neshoba+Noxubee+Winston,Kemper,28,69,Mississippi,MS
28099,28CS023,336,324,349,497,148,161,173,665.5750009303664,121,500.43081164914696,1.1418685675969085,1.6621927209274476,2.1379667773951825,0.747234204760466,410,395,425,470,45,60,75,207.53575731828587,65,224.19204635601696,-0.721578278674902,-0.1658470758874248,0.3357041175411752,1.0625977630525676,29015,28993,Kemper+Neshoba+Noxubee+Winston,Neshoba,28,99,Mississippi,MS
28103,28CS023,103,102,104,143,39,40,41,466.56947793561733,18,210.77283372365338,2.4323146316331177,2.561565830948649,2.682045728749054,0.44069005445054693,125,124,126,151,25,26,27,254.48124001142023,19,187.39520662787257,0.5364068740402285,0.6755060895665124,0.7965220205586925,0.7089062108257812,10248,10139,Kemper+Neshoba+Noxubee+Winston,Noxubee,28,103,Mississippi,MS
28159,28CS023,191,184,199,258,59,67,74,450.72821551075117,49,331.97831978319783,0.6370229514546267,1.1692179233885411,1.7070845775457497,0.7256304641501277,233,224,242,299,57,66,75,376.14854856682433,39,221.50281138183678,1.0491781704370984,1.555254511185921,2.041218622321171,0.5801113297785314,17712,17607,Kemper+Neshoba+Noxubee+Winston,Winston,28,159,Mississippi,MS
28071,28CS024,342,318,366,409,43,67,91,144.76423538721642,56,120.50785452980415,-0.24519998638128118,0.24143443557347447,0.7627479747416327,0.8202491367421767,428,398,457,523,66,95,125,168.19989189138494,46,81.07012565869476,0.37521958941902234,0.8853194252240427,1.4170785985228793,0.4769889109005242,55764,56741,Lafayette+Yalobusha,Lafayette,28,71,Mississippi,MS
28161,28CS024,165,160,171,212,41,47,52,452.2914074258543,25,242.07213749697408,1.6148057121536605,2.1032002451915686,2.6157556196614205,0.5239948222311354,201,195,207,196,-11,-5,1,-39.631227665112924,16,128.8244766505636,-2.2284057580751933,-1.6880013958618247,-1.1424413039721861,-4.079344810793135,12393,12420,Lafayette+Yalobusha,Yalobusha,28,161,Mississippi,MS
28073,28CS025,387,359,415,484,69,97,125,181.08854317144687,53,98.8560059686645,0.29759542262343835,0.8096151007040729,1.328775201749962,0.5403333111210983,482,448,516,577,61,95,129,145.88274321302254,86,131.88363569445934,-0.3559570041744495,0.14427985282158157,0.6726602738697176,0.8946341692175874,64336,65209,Lamar,Lamar,28,73,Mississippi,MS
28075,28CS026,702,671,733,1032,299,330,361,542.8308466023104,151,248.4880898506603,2.440708765886464,2.955271323371531,3.478894605198353,0.4563798560544073,852,815,889,1071,182,219,256,303.6504158732996,140,193.96492005874364,0.5894511858849256,1.0982074421315193,1.5997002127795361,0.6358757544218121,72921,72178,Lauderdale+Newton,Lauderdale,28,75,Mississippi,MS
28101,28CS026,224,215,233,276,43,52,61,296.64321895623794,39,220.90059473237042,0.23873258519433938,0.7665151015891468,1.2693241417196168,0.7307152948805753,272,261,283,324,41,52,63,248.13161222723951,45,213.442109756676,-0.14316475165748252,0.3547349586927899,0.8359727268300029,0.8440624961099744,21186,21083,Lauderdale+Newton,Newton,28,101,Mississippi,MS
28081,28CS027,762,726,797,969,172,207,243,297.9605564792381,116,166.60881638320026,0.8140203906875557,1.316107089999221,1.8547559236709465,0.5564815471289657,927,884,970,1168,198,241,284,290.8644510884729,141,170.0167605175262,0.7091701547905372,1.1931479250277977,1.6988836331614097,0.5821091472868277,83549,82933,Lee,Lee,28,81,Mississippi,MS
28087,28CS028,550,524,575,694,119,144,170,295.2556399975692,88,180.04808102163645,0.6188216778825165,1.1502666268359467,1.7098562067967074,0.6056074243839541,671,641,701,753,52,82,112,141.03486323454567,87,149.39725933303566,-0.5718290359479803,-0.0889854657782688,0.44003167707110175,1.0465505409220088,58651,58234,Lowndes,Lowndes,28,87,Mississippi,MS
28089,28CS029,900,853,947,1018,71,118,165,130.07193297392755,121,133.37987543862872,-0.5288386666123346,-0.03383549052742078,0.4698458487765862,1.0168145006501257,1112,1056,1169,1176,7,64,120,58.181408219442766,131,119.38720643050479,-1.1305776467153597,-0.6426915654568998,-0.1286066593705959,2.0203355627797874,108862,109727,Madison,Madison,28,89,Mississippi,MS
28107,28CS030,327,313,342,403,61,76,90,273.28854171876213,67,241.94276428635914,-0.1726107670559085,0.30791262107916884,0.8272953351516297,0.873756191908917,397,380,414,499,85,102,119,311.27635154120645,61,185.4723463772082,0.7602490345822137,1.2603556509146079,1.7924316782660639,0.5900807659752404,33231,32889,Panola+Tate,Panola,28,107,Mississippi,MS
28137,28CS030,254,242,266,377,111,123,135,525.6163091118461,55,234.35835523045236,2.380548227833929,2.9160480742463744,3.4395487803264824,0.44228791121827105,311,297,326,413,87,102,116,360.9547381273971,62,219.71791055354737,0.8931565724329859,1.409669959895713,1.9026176770711596,0.602794977499737,28162,28218,Panola+Tate,Tate,28,137,Mississippi,MS
28109,28CS031,592,568,616,712,96,120,144,255.99087635046268,84,179.61190998022127,0.241244136698654,0.7682825972996945,1.3141647122793614,0.6958219769652961,729,700,758,932,174,203,232,359.7050969316011,154,272.80779450841453,0.360759360845747,0.8668439023180587,1.3763524830426912,0.7547039352843847,56121,56450,Pearl River,Pearl River,28,109,Mississippi,MS
28113,28CS032,448,431,465,543,78,95,112,285.17279476067046,59,176.77902621722845,0.6080983818078171,1.0756576715283608,1.5894861714554882,0.6134559785630745,545,524,565,640,75,95,116,238.05810931525713,78,194.9658809708301,-0.11846341220857332,0.4229564962112332,1.0268084654519323,0.8104745919661145,40050,40007,Pike+Walthall,Pike,28,113,Mississippi,MS
28147,28CS032,153,147,159,200,41,47,53,401.07405286011846,33,284.3601895734597,0.6563256040476033,1.1647513409481627,1.6544060679898505,0.6940844927754379,186,179,193,229,36,43,50,308.1418767526484,30,216.7630057803468,0.41956065550533284,0.9241048140749842,1.4472037987366033,0.6873350493708877,13926,13840,Pike+Walthall,Walthall,28,147,Mississippi,MS
28115,28CS033,257,243,270,386,116,129,143,494.13847725904793,38,145.27845036319613,2.9618110542760587,3.493495375713162,4.017961071620832,0.2917462953059012,316,300,332,458,126,142,158,452.3847806436033,63,200.57306590257878,2.014210265099012,2.5124313430852405,3.039578893800704,0.44026984890944704,31388,31410,Pontotoc+Union,Pontotoc,28,115,Mississippi,MS
28145,28CS033,260,248,272,294,22,34,46,146.20198382019268,40,171.8336077897902,-0.7815256454634603,-0.25089231993937133,0.28567360749500686,1.1417680548838707,319,304,333,379,46,60,75,215.88757038777214,46,164.7092523632197,0.01624073021453835,0.5008308733220714,1.0526723158931246,0.7504925434690702,27934,27928,Pontotoc+Union,Union,28,145,Mississippi,MS
28121,28CS034,1054,986,1122,1391,269,337,405,257.74307799081976,140,107.06706349459247,1.0016692475389803,1.51785900300376,2.012980534814502,0.4141733665171296,1312,1230,1393,1608,215,296,378,187.51293104322775,209,132.32538114774857,0.035083623396663835,0.5565253068112914,1.0408691461447868,0.7033119712332297,156911,157944,Rankin+Scott,Rankin,28,121,Mississippi,MS
28123,28CS034,257,245,269,302,33,45,57,194.87095760380478,43,184.57576191157534,-0.38076491761022585,0.09218718270982737,0.6149185162792626,0.9267553475538426,312,298,326,398,72,86,100,311.7344819563195,51,184.44846292947557,0.743294761700087,1.28394042314969,1.7619793111873896,0.5848987116835933,27956,27650,Rankin+Scott,Scott,28,123,Mississippi,MS
28151,28CS035,492,473,511,687,176,195,214,526.0521101989881,97,262.0264277513901,2.132010262135714,2.632586209536463,3.1785966355399515,0.49555505652126053,596,573,618,713,95,117,140,267.4310988660086,45,102.68814750581899,1.1072180851872346,1.6255989868880276,2.1715243875905075,0.3807310939325735,44423,43822,Washington,Washington,28,151,Mississippi,MS
28051,28CS036,179,172,187,260,73,81,88,573.4333481355312,62,440.5755906910641,0.837620798193647,1.320915889162787,1.834993829376571,0.7589072956973263,215,207,224,299,75,84,92,505.6296321076927,27,163.07302047472368,2.9232768149589794,3.4301711140348483,3.961772933495155,0.31870780016638917,16887,16557,Yazoo and Nearby Counties,Holmes,28,51,Mississippi,MS
28053,28CS036,82,81,83,117,34,35,36,542.9654486158544,25,387.19669592152815,1.440331248308529,1.5584043781567058,1.6799341211024728,0.6933376246755841,99,98,100,144,44,45,46,593.884308239142,14,184.8184818481848,3.9555204835921156,4.091912669106088,4.206718324602044,0.3044356071219528,7748,7575,Yazoo and Nearby Counties,Humphreys,28,53,Mississippi,MS
28055,28CS036,13,13,13,13,-0,-0,-0,-14.811599067120277,1,90.84027252081756,-1.1773808427191592,-1.0554438299549336,-0.9460152334343026,1.1948159607985371,16,16,16,13,-3,-3,-3,-222.37938458362973,1,77.7000777000777,-3.1260304687859,-2.9959394303426294,-2.871668407700308,-0.5370503866362598,1321,1287,Yazoo and Nearby Counties,Issaquena,28,55,Mississippi,MS
28125,28CS036,46,46,47,75,28,29,29,897.4134850253112,14,437.956204379562,4.4821820082788655,4.600955570735949,4.7082832157976755,0.4715818425755356,55,54,55,76,21,21,22,576.9667703533327,7,190.32082653616095,3.736916660334353,3.8701569818579107,3.9942358387944052,0.315019625214902,3836,3678,Yazoo and Nearby Counties,Sharkey,28,125,Mississippi,MS
28163,28CS036,244,232,256,307,51,63,75,279.46574340004463,38,168.6265808741957,0.5984978965594696,1.1024624839333208,1.6518887006119483,0.5939578362857247,295,281,308,361,53,66,80,251.63809254410964,33,124.95740088606156,0.7716823285254246,1.253523169922819,1.7718000393616886,0.48921427900404335,27042,26409,Yazoo and Nearby Counties,Yazoo,28,163,Mississippi,MS
29003,29CS001,159,151,167,175,8,16,24,107.69496587202201,18,119.87346689605415,-0.6172051876320123,-0.1288914310740728,0.3503077762356285,1.04826096924166,194,185,204,191,-13,-3,6,-18.89282165835561,16,88.81980681692018,-1.632504930374715,-1.074653267558031,-0.565246275697119,-6.657366066811085,18019,18014,Andrew+Atchison+Holt+Nodaway,Andrew,29,3,Missouri,MO
29005,29CS001,64,64,65,87,22,23,23,512.4895074918327,11,250.47438330170775,2.4956459100717763,2.621397414245303,2.7398931759804124,0.4679490851197159,79,78,79,95,16,16,17,313.785715201569,3,57.20823798627002,2.442312902437415,2.5647988005299385,2.6896813156695263,0.1718712833221038,5270,5244,Andrew+Atchison+Holt+Nodaway,Atchison,29,5,Missouri,MO
29087,29CS001,47,46,47,64,17,17,18,495.64784372142975,18,511.9696610571226,-0.2857277665762659,-0.16509585007758745,-0.04417584178040817,0.9768724309304602,57,57,58,83,25,26,26,615.1258105676883,5,118.48341232227489,4.843225205230888,4.963405319377143,5.08778793032554,0.18547157248627627,4219,4220,Andrew+Atchison+Holt+Nodaway,Holt,29,87,Missouri,MO
29147,29CS001,162,153,171,156,-15,-6,3,-33.80132754878438,20,112.4701251230142,-1.9756856301502066,-1.4818647086984766,-0.9427755889231686,-3.9914414941802647,198,187,209,168,-41,-30,-19,-142.3930994402853,15,70.86167800453515,-2.6521279948460785,-2.1270644301816097,-1.5968692723852453,-0.5147250608405717,21339,21168,Andrew+Atchison+Holt+Nodaway,Nodaway,29,147,Missouri,MO
29007,29CS002,258,247,269,325,56,67,78,322.08991328532124,42,202.11742059672758,0.700071103085448,1.1979504909078826,1.6911533632336821,0.6182809424429782,317,304,330,330,0,13,26,52.61977462982026,38,152.15824457435733,-1.5015929253559057,-0.9893506559390322,-0.47571517652889955,2.6871716692103953,24936,24974,Audrain+Callaway,Audrain,29,7,Missouri,MO
29027,29CS002,353,333,372,452,80,99,119,268.83824582128244,38,102.71658332207053,1.1542222530622495,1.6457739011424362,2.198331193902788,0.37827239576671906,437,414,460,503,43,66,89,147.95104052727484,57,127.83995334963106,-0.33484543764943364,0.22061127698661118,0.7161538416142877,0.8511663835504373,44394,44587,Audrain+Callaway,Callaway,29,27,Missouri,MO
29009,29CS003,362,348,377,437,60,75,89,257.6681259346678,52,179.62520510089524,0.24826204266846064,0.7987543949319267,1.2975462974595986,0.6878964272196004,444,426,462,501,39,57,75,164.06394091477674,51,147.02914636607375,-0.3434922954392246,0.17755371839155057,0.6770230718182588,0.8806942619431667,34739,34687,Barry+Lawrence+McDonald,Barry,29,9,Missouri,MO
29109,29CS003,412,395,428,453,25,41,58,130.36857335860302,56,176.61900756938604,-0.9657000762107373,-0.4690384327845033,0.05687129461248194,1.3227660391202443,507,487,527,581,54,74,94,193.64687370518322,59,154.171783950456,-0.16965721179915585,0.39057734282779694,0.8997302382745589,0.7855488610304465,38048,38269,Barry+Lawrence+McDonald,Lawrence,29,109,Missouri,MO
29119,29CS003,210,200,220,260,40,50,60,257.40115514187005,29,149.73538143797597,0.5545350151664676,1.0778006400439863,1.6150944455365235,0.5702804959701914,259,247,271,304,33,45,57,191.14005159326823,39,166.88775728529248,-0.27800809854551267,0.24537416062084233,0.7694475467636065,0.8539986657270783,23241,23369,Barry+Lawrence+McDonald,McDonald,29,119,Missouri,MO
29015,29CS004,262,254,271,308,37,46,54,282.3853280559649,24,147.9122798007293,0.8541913512517045,1.346540534090108,1.8718933203115382,0.5126083204885767,323,313,333,365,32,42,52,210.8564784462836,42,211.74691202419964,-0.575184421366431,-0.0030476987330845073,0.5027823098694035,0.9807725954430665,19471,19835,Benton+Henry+St. Clair,Benton,29,15,Missouri,MO
29083,29CS004,254,244,263,301,38,47,57,257.089657849539,33,180.17198234678554,0.2488417257762528,0.7992716219735945,1.3019721157825095,0.6862402737482061,310,299,322,340,18,30,41,133.53866955603206,34,153.3673147187514,-0.7434648521235704,-0.19914022753460128,0.3295834335666376,1.1109590747687461,21979,22169,Benton+Henry+St. Clair,Henry,29,83,Missouri,MO
29185,29CS004,130,126,134,140,6,10,14,133.17505576778007,16,205.1282051282051,-1.207290266298133,-0.7124628695585044,-0.2113603406185932,1.4050303520284655,157,152,162,153,-9,-4,1,-44.24480718322603,12,128.05463664496853,-2.2703655048360227,-1.7325341866277628,-1.1845424783867868,-3.814148154015686,9360,9371,Benton+Henry+St. Clair,St. Clair,29,185,Missouri,MO
29017,29CS005,113,109,118,166,48,53,57,587.0026178537314,15,167.22408026755855,3.7034600342613233,4.190157395285055,4.678245685045269,0.27956838834338915,136,131,142,163,21,27,32,253.62459701698893,15,142.1666192777936,0.6029265793878744,1.1216997876004322,1.6067379935001582,0.5403471599060519,10764,10551,Bollinger+Madison+Stoddard+Wayne,Bollinger,29,17,Missouri,MO
29123,29CS005,153,148,159,174,15,21,26,196.56733120415996,22,210.6102911846829,-0.6295596027535791,-0.12976812191881257,0.37568176219944915,1.0216830965158168,187,181,194,215,21,28,34,218.7425020855892,26,205.6311293894337,-0.3631070176311884,0.14837506938857753,0.6494915977467252,0.9072572988302353,12535,12644,Bollinger+Madison+Stoddard+Wayne,Madison,29,123,Missouri,MO
29207,29CS005,325,313,338,380,42,55,67,228.07078114621106,49,204.8851876371999,-0.2788777838418526,0.2294026868093495,0.7571534815006581,0.8821671687224729,393,378,408,450,42,57,72,200.29372378900234,65,228.03817008139208,-0.7475465382944686,-0.29308292448317663,0.25509875681204824,1.1189201595510572,28699,28504,Bollinger+Madison+Stoddard+Wayne,Stoddard,29,207,Missouri,MO
29223,29CS005,138,134,143,188,45,50,54,530.7891281026428,21,224.93974828171025,2.583904853655966,3.05546225426652,3.571509192582754,0.4154007793501458,165,160,171,242,71,77,82,702.1553769041138,17,155.76323987538942,4.911951678234278,5.464394431016406,5.990261064867861,0.21897837155861585,11203,10914,Bollinger+Madison+Stoddard+Wayne,Wayne,29,223,Missouri,MO
29019,29CS006,1002,923,1081,1164,83,162,241,105.98358968041575,83,54.22267226314328,0.011638231763213708,0.5378346243203275,1.013990501635803,0.5084795697537727,1258,1162,1354,1381,27,123,219,66.31189415983766,94,50.658561296859176,-0.33531015260691965,0.16584062454269263,0.6560031625824884,0.7577852458215131,183687,185556,Boone,Boone,29,19,Missouri,MO
29021,29CS007,766,729,802,954,152,188,225,266.30282240199443,105,148.38542525378617,0.635257359074642,1.1790135210420265,1.7207822317949755,0.5542642795764092,929,886,973,1119,146,190,233,225.73204033920365,89,105.99780858463151,0.6800773482904738,1.2081442698602465,1.719648838560417,0.4671090898448689,84914,83964,Buchanan,Buchanan,29,21,Missouri,MO
29023,29CS008,484,466,502,575,73,91,109,259.0750591231339,53,151.07247203021447,0.5475995802393884,1.087450814073809,1.5530189859083796,0.5767765328846027,592,570,614,707,93,115,137,273.7239951597719,76,180.57832584883695,0.4194350759591136,0.9544039132401758,1.4367006198696597,0.6540322672907406,42099,42087,Butler+Carter+Ripley,Butler,29,23,Missouri,MO
29035,29CS008,63,62,63,79,16,16,17,365.616528316178,2,45.011252813203306,3.0736789564226354,3.2020830697013714,3.326780411745168,0.11597187191066961,77,76,77,102,25,25,26,478.51849445488426,13,245.09803921568627,2.2099999396150474,2.333698576097164,2.465175148202358,0.49278597447217404,5332,5304,Butler+Carter+Ripley,Carter,29,35,Missouri,MO
29181,29CS008,133,128,137,185,48,52,57,567.9741080308937,18,195.26306273729887,3.223007714830182,3.7155651484428045,4.210385095639651,0.3373455809544027,158,152,163,236,73,78,84,735.1975644513944,38,357.61340109166196,3.2637051754367694,3.773311730816318,4.303268147364983,0.4802704082236021,11062,10626,Butler+Carter+Ripley,Ripley,29,181,Missouri,MO
29029,29CS009,401,383,420,549,129,148,166,408.7856015958879,73,202.06680199298762,1.5281892478973993,2.077683154648574,2.567187011136357,0.4909853354792944,492,470,515,664,149,172,194,396.39019349730034,74,170.73902309591378,1.7344279376750231,2.25967211048991,2.79251392666133,0.42824204488729295,43352,43341,Camden+Miller+Moniteau+Morgan,Camden,29,29,Missouri,MO
29131,29CS009,240,229,251,298,47,58,69,279.07921955011324,38,183.28710961051488,0.4577743333586335,0.9433687338215918,1.4759958386725907,0.645598640179874,294,281,307,365,58,71,84,286.40035434507206,36,144.6770887754692,0.9108804653431304,1.4052393907168994,1.9108184923038958,0.4981664694454113,24879,24883,Camden+Miller+Moniteau+Morgan,Miller,29,131,Missouri,MO
29135,29CS009,137,130,144,165,21,28,35,216.37487106008314,21,162.40252626151963,-0.0032350994255840523,0.5380580540477913,1.0565245010841458,0.7246608374990825,167,159,175,172,-3,5,13,30.07485925373307,14,90.43343453265294,-1.1081651567596729,-0.6165069932448635,-0.12329504260275129,2.4752961199136414,15517,15481,Camden+Miller+Moniteau+Morgan,Moniteau,29,135,Missouri,MO
29141,29CS009,257,248,266,305,39,48,57,272.1602727767734,31,177.17660506763193,0.4333413333240237,0.9555262877478746,1.484823094135504,0.637611128917402,318,307,329,325,-4,7,18,35.12815252879945,36,168.83177789241665,-1.8737062445103656,-1.3255555960119676,-0.7879060915212366,4.240094920866638,20996,21323,Camden+Miller+Moniteau+Morgan,Morgan,29,141,Missouri,MO
29031,29CS010,711,676,746,943,197,232,267,341.46235271393965,113,166.56225817150016,1.23207314927355,1.7638220601078975,2.248703685430762,0.4856943737334561,876,834,919,926,7,50,92,60.46619004787159,70,85.29719981478321,-0.7838462774751352,-0.24402050974781983,0.22520316813809452,1.3827929797983516,81411,82066,Cape Girardeau+Perry,Cape Girardeau,29,31,Missouri,MO
29157,29CS010,174,166,182,213,31,39,47,245.64236198512023,22,139.04982618771726,0.576413518767183,1.0629975282061848,1.5903224119654458,0.5518664716581199,213,203,222,225,3,12,22,65.6533857255345,11,58.1149619611158,-0.46227629468201914,0.07336827101144351,0.6053354163641083,0.8192525633319135,18986,18928,Cape Girardeau+Perry,Perry,29,157,Missouri,MO
29033,29CS011,92,91,93,123,30,31,32,441.6306688267496,30,424.17815482502647,0.042605484056021124,0.17581260679071795,0.29118860720695555,0.9306847972819916,111,110,112,110,-2,-1,-0,-13.918342418582213,10,119.21793037672865,-1.4596197313363606,-1.3321616238094127,-1.1996479557247492,-59.71198684924575,8487,8388,Carroll+Lafayette+Ray,Carroll,29,33,Missouri,MO
29107,29CS011,339,325,353,383,30,44,58,160.55005870662288,42,152.96367112810705,-0.4227202834130197,0.0790114649338699,0.6051262321513424,0.9316143522886546,412,395,429,470,41,58,75,175.70552715005851,40,121.78784557301181,0.03004342273503485,0.5277888126217389,1.0202697999863652,0.6813297535066348,32949,32844,Carroll+Lafayette+Ray,Lafayette,29,107,Missouri,MO
29177,29CS011,225,215,235,284,49,59,69,306.0995417156332,23,119.5892369686728,1.3306985997717478,1.8672789613804799,2.3710248303175,0.3841618785597038,274,262,286,353,67,79,91,341.6243823844808,53,230.2245775596195,0.6139097729852985,1.1184979442627379,1.6478894938570927,0.6654500309147084,23079,23021,Carroll+Lafayette+Ray,Ray,29,177,Missouri,MO
29037,29CS012,868,821,914,956,42,88,135,98.35725984163658,69,76.72065527593492,-0.3215379658312349,0.2304307819698787,0.7376645203116104,0.771300977803861,1081,1025,1138,1255,117,174,230,159.0010303902607,151,138.0054105432478,-0.27267877455546824,0.20295516497397276,0.7186211077431873,0.8629924235186716,107924,109416,Cass,Cass,29,37,Missouri,MO
29043,29CS013,603,565,642,708,66,105,143,140.73057813617265,82,110.04741880647758,-0.1964471111584688,0.29068546289099606,0.8319887296077129,0.7745856938443342,758,711,805,952,147,194,241,212.8482941352537,135,148.07989733127118,0.12297416529993041,0.6342824813893686,1.1605453327206858,0.6921394338704953,89416,91167,Christian,Christian,29,43,Missouri,MO
29047,29CS014,1610,1501,1719,1878,159,268,377,126.79990934266556,209,98.898628905372,-0.2592815521608193,0.2663747674562652,0.7981580774948663,0.7770583279711324,1998,1866,2130,2220,90,222,354,86.96818578814445,265,103.80555065906732,-0.6913986570776036,-0.16668998723229633,0.3420896847884098,1.1882516451979916,253593,255285,Clay,Clay,29,47,Missouri,MO
29051,29CS015,580,547,613,751,138,171,204,266.12617241332373,125,194.45920893993804,0.21022530264373032,0.726302092056811,1.2210327701570478,0.7264564698134335,715,675,755,775,20,60,100,77.36902289070929,88,113.98373141288016,-0.8662380883796085,-0.37006793367744706,0.15304510568621582,1.4489894677112365,77137,77204,Cole,Cole,29,51,Missouri,MO
29055,29CS016,253,243,263,306,43,53,63,274.2712273051792,27,140.1141670991178,0.8112396574175305,1.3452299821821152,1.8661260712581176,0.5013735266875443,306,295,318,382,64,76,87,331.470476273932,55,240.81614781733003,0.41572212118934554,0.8885134366680458,1.4278114552008718,0.7170370686179104,23124,22839,Crawford+Iron+Reynolds+Washington,Crawford,29,55,Missouri,MO
29093,29CS016,129,125,134,155,21,26,30,320.18069889275426,12,150.04688965301656,1.1791484474852645,1.7139607154769245,2.2238106339537285,0.4510184324216026,155,151,160,190,30,35,39,366.94584450317,19,201.61290322580643,1.13890228606272,1.6637377010126102,2.19170581875946,0.5339932157535524,9597,9424,Crawford+Iron+Reynolds+Washington,Iron,29,93,Missouri,MO
29179,29CS016,72,71,73,79,6,7,8,135.3734960712752,6,117.83960720130932,0.05289976293425225,0.1735360912462235,0.2949012670161718,0.7601896606089309,88,87,89,112,23,24,25,391.7923223084272,13,213.60499507065396,1.6653838372835645,1.7793116391382744,1.9086086754160319,0.5232550496144831,6110,6086,Crawford+Iron+Reynolds+Washington,Reynolds,29,179,Missouri,MO
29221,29CS016,240,229,250,322,72,82,93,417.93703913871326,44,222.96355728220936,1.4842493072493825,1.9702934489464137,2.445308360842706,0.527095134525761,292,280,304,401,97,109,121,464.40863808526893,55,234.02263637137267,1.80975380201345,2.2952569112094325,2.8166643542053613,0.4993403345449605,23681,23502,Crawford+Iron+Reynolds+Washington,Washington,29,221,Missouri,MO
29059,29CS017,185,177,192,265,73,80,88,562.9668916640733,27,189.3961536213246,3.227395521327185,3.7315595962816683,4.261505419690398,0.3322847010794542,228,219,237,302,65,74,83,428.72894664986825,31,179.12862591008897,1.9736576521140734,2.4944872648268785,2.992648962866516,0.41225689481232686,17107,17306,Dallas+Hickory+Polk,Dallas,29,59,Missouri,MO
29085,29CS017,130,126,133,149,16,19,23,273.48205144434144,27,380.77329886003054,-1.592626505766011,-1.086602581730156,-0.5444979823166003,1.3240384873960953,160,155,164,197,33,37,42,437.14299168511917,12,140.13780217213593,2.431825258238828,2.9803707615667117,3.49206687317675,0.31223529620165424,8509,8563,Dallas+Hickory+Polk,Hickory,29,85,Missouri,MO
29167,29CS017,309,295,323,364,41,55,69,208.0446481479741,41,155.10718789407315,0.035425416339274006,0.530219593238769,1.0530098105836614,0.7322326167391074,381,364,397,429,32,48,65,150.2196548244358,44,137.60750586395622,-0.3614748582180706,0.14060466837074645,0.6296499046143452,0.8973596992279012,31720,31975,Dallas+Hickory+Polk,Polk,29,167,Missouri,MO
29025,29CS018,85,84,86,92,6,7,8,92.18856105414417,5,67.80427166911515,0.1152405274358843,0.24424445306305415,0.3627872412647886,0.6411786904008769,105,104,106,136,30,31,32,352.0712748166239,17,191.35524538496173,1.4815338150681945,1.6103377137939154,1.7432755279205654,0.5266743184551218,8849,8884,DeKalb and Nearby Counties,Caldwell,29,25,Missouri,MO
29049,29CS018,220,211,230,270,40,50,59,281.7246879986248,43,244.54976303317534,-0.1178233089394494,0.3684910861520209,0.9123286853337319,0.8508686314614211,271,260,282,246,-36,-25,-14,-118.26537345915195,26,122.20916568742655,-2.896595555150079,-2.4197920210544157,-1.8586616637005644,-1.0761162608320725,21100,21275,DeKalb and Nearby Counties,Clinton,29,49,Missouri,MO
29061,29CS018,78,77,79,99,20,21,22,302.9543186654468,14,199.95239228755057,0.9082065491923054,1.0262178114241862,1.1557303596479946,0.6302941459650271,95,94,96,107,11,12,13,139.44539918167888,11,130.9056289420445,-0.046080915492032276,0.08616615930932595,0.2174071661970351,0.8649432823153929,8402,8403,DeKalb and Nearby Counties,Daviess,29,61,Missouri,MO
29063,29CS018,95,94,96,139,43,44,45,479.88457500443985,22,240.17467248908298,2.280464471998515,2.3984803667524393,2.519033056449827,0.48935184759453326,117,116,119,130,11,13,14,113.2209043788846,12,108.24463287028685,-0.07707078282700204,0.05002853926261915,0.16658416780336835,0.8854997560199563,10992,11086,DeKalb and Nearby Counties,DeKalb,29,63,Missouri,MO
29075,29CS018,71,70,72,92,20,21,22,406.27896247185225,13,252.14158719896557,1.4293048246630728,1.5404567808339091,1.6746732258110346,0.5923342964049421,87,86,87,105,18,18,19,298.5652310047606,2,32.441200324412,2.540406796627811,2.659279703122794,2.7930186044061576,0.10305800678558735,6187,6165,DeKalb and Nearby Counties,Gentry,29,75,Missouri,MO
29081,29CS018,92,92,93,105,12,13,13,184.22844823329638,15,219.94134897360703,-0.47914147940557933,-0.3601598062645651,-0.2334903524622995,1.105837481149053,113,112,114,111,-3,-2,-1,-21.72585622551909,2,24.50079627587897,-0.5857389328552239,-0.4629578498554798,-0.3361127621504711,-2.5857110072593223,8184,8163,DeKalb and Nearby Counties,Harrison,29,81,Missouri,MO
29227,29CS018,25,25,26,25,-1,-0,-0,-26.410914371789737,6,365.85365853658533,-4.0382964777113495,-3.922515003829064,-3.8032289284834175,10.5846053167499,31,31,32,32,0,1,1,36.67480464996235,5,252.52525252525254,-2.2882615675719102,-2.1585061863286836,-2.032000463461881,2.896600964480179,1968,1980,DeKalb and Nearby Counties,Worth,29,227,Missouri,MO
29065,29CS019,159,153,165,232,67,73,79,598.7809100199679,28,230.38946791003838,3.149436775642088,3.677861531809353,4.204631038595676,0.3795486194481985,193,186,200,269,69,76,83,527.0050770848476,45,311.85031185031187,1.6429708179351838,2.150812102568493,2.6404097429700752,0.5840603496316341,14584,14430,Dent+Phelps,Dent,29,65,Missouri,MO
29161,29CS019,397,378,416,509,93,112,131,301.6830815814569,73,196.53594184689936,0.5285693503535456,1.0605215105877455,1.5590880528674393,0.6457025471182442,489,466,512,602,90,113,136,252.10722516965768,80,178.26900793297085,0.21192178938105838,0.7170059006151992,1.2790661018159266,0.7009204236687858,44572,44876,Dent+Phelps,Phelps,29,161,Missouri,MO
29067,29CS020,149,144,154,177,23,28,33,285.36073527242604,24,243.07900067521945,-0.08222929053386559,0.4267186011232269,0.9466329814983296,0.8226329186233359,182,176,188,229,41,47,53,399.2670042294728,40,341.53005464480873,0.061872878210760186,0.5452009110668313,1.1133093577898607,0.8374832103279531,11848,11712,Douglas+Ozark+Texas+Wright,Douglas,29,67,Missouri,MO
29153,29CS020,122,118,125,140,15,18,22,253.74508302712437,11,152.86624203821654,0.5061028828876395,1.00671745893034,1.5087073119977648,0.5711593620305678,152,147,156,188,32,36,41,415.9946128758436,39,446.07114262838843,-0.8123939806868745,-0.30423504905550175,0.17900965358106768,1.0436064533332274,8635,8743,Douglas+Ozark+Texas+Wright,Ozark,29,153,Missouri,MO
29215,29CS020,265,255,276,346,70,81,91,392.9490670439915,19,92.63021044933777,2.4694943753357648,3.0121461930168456,3.5459534804816357,0.23284198787768184,332,319,345,441,96,109,122,438.4741619534415,47,188.73228125125488,2.0118844049875033,2.498680056675674,3.017398591842859,0.42652351718982606,24614,24903,Douglas+Ozark+Texas+Wright,Texas,29,215,Missouri,MO
29229,29CS020,220,212,228,204,-24,-16,-8,-106.90806786866887,27,177.56343508521948,-3.32734835870691,-2.825596642265771,-2.3223839496366216,-1.7697650251910702,275,266,285,290,5,15,24,79.00148768894279,43,231.84342481263818,-1.9939892121819807,-1.5285413073590841,-1.0004218717588798,2.747181501373758,18247,18547,Douglas+Ozark+Texas+Wright,Wright,29,229,Missouri,MO
29069,29CS021,354,342,366,455,89,101,113,428.02039750106496,55,233.42175066312998,1.4560495894944796,1.958301043955278,2.4375426449977597,0.5399975913452429,426,412,441,519,78,93,107,333.66651757711134,47,169.16210768787792,1.1377289532378911,1.6276700903152788,2.1237597800314214,0.5015692434516842,28275,27784,Dunklin+Pemiscot,Dunklin,29,69,Missouri,MO
29155,29CS021,188,182,195,261,66,73,79,558.1315275008417,32,246.3275386490474,2.648717115396915,3.128710978462899,3.617599016327695,0.4353389877833916,226,218,234,292,58,66,74,429.3161643221896,27,176.62065807548896,2.033326617596797,2.5182224469739576,3.0237582654280284,0.40522553613391726,15589,15287,Dunklin+Pemiscot,Pemiscot,29,155,Missouri,MO
29071,29CS022,918,873,963,1087,124,169,214,193.8572885434661,134,153.60366814729903,-0.09121049326640761,0.40232041027434995,0.9108767478629896,0.7876966389234846,1132,1078,1186,1329,143,197,251,187.38623720832385,144,136.92898710585374,0.001966966739848571,0.5071667085149556,1.026364803224718,0.7270419006573096,104685,105164,Franklin,Franklin,29,71,Missouri,MO
29073,29CS023,182,176,189,240,51,58,64,468.6225820978382,37,301.2416039079992,1.1223292085252827,1.6655520369775034,2.197923002716713,0.6318460450009972,223,215,231,247,16,24,32,162.613560913294,42,284.0909090909091,-1.722917717177773,-1.2062782014391216,-0.674997327254907,1.6772634544090865,14739,14784,Gasconade+Montgomery+Warren,Gasconade,29,73,Missouri,MO
29139,29CS023,150,145,155,162,7,12,17,124.14039550598221,15,159.16526660182157,-0.8566659075593158,-0.349784888500522,0.1630170223592391,1.181176974164694,184,179,190,185,-5,1,6,4.42210450167877,17,149.21442991310454,-1.9555061453011384,-1.452253690692786,-0.8989091971989503,11.304616849142539,11309,11393,Gasconade+Montgomery+Warren,Montgomery,29,139,Missouri,MO
29219,29CS023,271,256,287,315,28,44,59,145.9139948888575,18,60.34699522252954,0.3630178351788421,0.845683026036093,1.3507811868892197,0.404289994574184,340,321,358,463,105,123,142,339.1592834261037,65,178.57142857142856,1.1229291305330302,1.5805142248461004,2.111114292841682,0.5222814122538088,35793,36400,Gasconade+Montgomery+Warren,Warren,29,219,Missouri,MO
29077,29CS024,2556,2428,2685,2927,242,371,499,149.14728591469304,359,144.3520743071402,-0.49113770551295116,0.0595013747874171,0.5885597192200741,0.9652468870600452,3153,2998,3309,3571,262,418,573,138.93075574945036,388,129.07432418945982,-0.4549688640706337,0.09112937918908386,0.6237870088425963,0.9268357962788017,298437,300602,Greene,Greene,29,77,Missouri,MO
29079,29CS025,108,107,109,137,28,29,30,361.9279135479603,31,382.0870994248151,-0.32625122050179134,-0.20267727638051042,-0.07767610596936557,1.020931800714114,132,130,133,152,19,20,22,209.82400102834532,26,267.4621952474025,-0.7041507240818257,-0.576604207986838,-0.453434337611254,1.2151241186167068,9736,9721,Grundy and Nearby Counties,Grundy,29,79,Missouri,MO
29115,29CS025,145,140,150,162,12,17,22,175.04821017318508,14,141.68845407775996,-0.17428356986842142,0.3476679391439384,0.8613928146696038,0.7651852976187633,175,169,181,186,5,11,17,90.95386465656009,38,320.8375548801081,-2.8210810884341875,-2.3072105306835464,-1.793003550878831,3.2278407777334057,11857,11844,Grundy and Nearby Counties,Linn,29,115,Missouri,MO
29117,29CS025,156,149,162,169,7,13,20,110.62714792217938,30,245.8512599877074,-1.8416584812718142,-1.358548923835166,-0.8748128023466301,2.0690685817991694,190,182,198,220,22,30,38,203.31369623627413,40,271.6099680858287,-1.224824383484145,-0.6725667016972225,-0.13432267265489709,1.2927409217331234,14643,14727,Grundy and Nearby Counties,Livingston,29,117,Missouri,MO
29129,29CS025,37,37,37,59,22,22,22,744.933796411727,10,340.2324922030054,3.9291136921771983,4.047745731381986,4.164249830138278,0.4367795298994293,45,45,45,52,7,7,7,200.66703555366772,5,143.184421534937,0.4423895118194769,0.5800202191825037,0.6979877785722177,0.6244307625528086,3527,3492,Grundy and Nearby Counties,Mercer,29,129,Missouri,MO
29171,29CS025,59,59,60,59,-1,-0,0,-5.655505861918268,5,128.15036309269544,-1.4698818244848202,-1.3379400517940683,-1.2152476271026835,6.415676728018063,73,72,73,88,15,15,16,322.00565519143254,6,127.46972594008922,1.8242389826729788,1.9487713918382252,2.083484562753423,0.371360523205714,4682,4707,Grundy and Nearby Counties,Putnam,29,171,Missouri,MO
29211,29CS025,57,57,58,72,14,15,15,292.33784796605795,12,240.64171122994654,0.39641259376036125,0.5106890612725649,0.6289043816544149,0.7703213656008102,70,69,71,86,15,16,17,271.622565765048,11,185.1851851851852,0.7395125943719603,0.8621252239190182,0.9998577249943628,0.6419841125893965,5984,5940,Grundy and Nearby Counties,Sullivan,29,211,Missouri,MO
29091,29CS026,437,419,454,539,85,102,120,308.5380086364735,80,241.072773843604,0.1515788619003515,0.6668039392804085,1.1968564580846326,0.7737816606699066,535,514,555,638,83,103,124,258.1828405112257,83,207.80131190225828,0.015862576796424964,0.513744921760723,1.0376530775104216,0.7971311717266925,39822,39942,Howell+Oregon+Shannon,Howell,29,91,Missouri,MO
29149,29CS026,115,111,119,140,21,25,29,336.4077750747587,10,134.89208633093523,1.5264245357248591,2.011118717232333,2.5296382997931515,0.38551943175241515,138,133,142,179,37,41,46,478.8317926218902,14,162.24359717232588,2.6595135720932985,3.1669419123407776,3.6554272759168938,0.3308253980926918,8896,8629,Howell+Oregon+Shannon,Oregon,29,149,Missouri,MO
29203,29CS026,74,73,74,121,47,47,48,788.6893974673071,13,216.27616802994592,5.600450525927068,5.721978434965799,5.849340471252801,0.26855728128393164,89,88,90,120,30,31,32,435.72881261458593,15,211.35691137100184,2.1192265162180743,2.2397325356377524,2.365400420914062,0.4698707322749669,7213,7097,Howell+Oregon+Shannon,Shannon,29,203,Missouri,MO
29095,29CS027,5534,5226,5842,6353,511,819,1127,137.42504156987107,518,86.89780700466783,-0.05638430999688215,0.5103350566898762,0.9686443584194571,0.631557816228782,6804,6434,7174,7829,655,1025,1395,142.97995031216595,862,120.23690296519267,-0.2665235013503242,0.21612877237229333,0.7643795410426624,0.840115822781993,715323,716918,Jackson,Jackson,29,95,Missouri,MO
29097,29CS028,1064,1011,1116,1291,175,227,280,222.5227904028466,175,171.31389600430734,0.019427984680852474,0.48540463547223367,1.0202790722491615,0.7664992049100653,1311,1248,1375,1536,161,225,288,182.6541334159742,214,173.84522900453297,-0.38803350524755026,0.10021864236939929,0.6191336175828633,0.9475584611163339,122582,123098,Jasper,Jasper,29,97,Missouri,MO
29099,29CS029,1817,1720,1915,2088,173,271,368,143.1726812745991,200,105.82290536786687,-0.11230564370881309,0.3829808880002664,0.8872518468895456,0.7364062834266096,2243,2126,2361,2501,140,258,375,113.2722743970223,265,116.40778746134382,-0.542248873887813,-0.029839200618728454,0.4728153043192616,1.0237112097828764,226794,227648,Jefferson,Jefferson,29,99,Missouri,MO
29101,29CS030,355,332,378,420,42,65,88,143.7973246035387,46,102.13899785360077,-0.09360392670986523,0.42852513509143714,0.8901299011024395,0.6994971948760811,437,409,465,565,100,128,156,236.52589596811126,57,105.30594147206622,0.8220129954492653,1.3064019888897531,1.8526074513899158,0.4417689026222624,54044,54128,Johnson,Johnson,29,101,Missouri,MO
29105,29CS031,380,364,395,408,13,28,44,94.38939827874943,52,173.27076333546216,-1.262792218779287,-0.7999172380404882,-0.2969135056921987,1.773107382515306,466,448,485,567,82,101,119,278.91741602278483,74,204.88966414707755,0.22176783074962766,0.7466717684960736,1.2271181734251875,0.7273684958261141,36013,36117,Laclede+Webster,Laclede,29,105,Missouri,MO
29225,29CS031,314,297,331,362,31,48,65,147.68246799690988,50,152.6872964169381,-0.556825371513978,-0.04645059283948971,0.4501906543547968,1.012943687789963,390,370,411,508,97,118,138,296.81301771888525,63,158.88227579945527,0.8657413234730517,1.3837152206311902,1.8856138337809505,0.5307842309502252,39296,39652,Laclede+Webster,Webster,29,225,Missouri,MO
29113,29CS032,447,421,473,480,7,33,59,66.1822018717145,51,102.17540110523063,-0.86533162903045,-0.3687975020016831,0.138053969109904,1.4984885298913235,559,528,591,606,15,47,78,75.853656869158,54,88.04826349258111,-0.6327782502476245,-0.13099954730472668,0.3727284645493007,1.1363385814883367,59897,61330,Lincoln+Pike,Lincoln,29,113,Missouri,MO
29163,29CS032,167,160,175,204,29,37,44,249.51636109400698,23,156.48032656763806,0.4165593405422744,0.932400329046537,1.4123576487725222,0.6104885142461097,205,196,214,212,-2,7,16,38.40282371963983,27,152.20700152207002,-1.6588157978630236,-1.1447928612553495,-0.5860326381339066,3.45609869528427,17638,17739,Lincoln+Pike,Pike,29,163,Missouri,MO
29125,29CS033,84,84,85,125,40,41,41,574.2728747093266,13,184.13597733711046,3.783489227048526,3.90093455868983,4.018462739059846,0.31292376380959097,103,102,104,133,29,30,31,357.2367899784799,11,130.812224997027,2.139974160206,2.26241314434028,2.4010125057732785,0.35438096756432214,8472,8409,Maries+Osage+Pulaski,Maries,29,125,Missouri,MO
29151,29CS033,111,110,113,119,6,8,9,70.36986676556025,10,90.11038522189682,-0.32032702916280376,-0.19395231454559567,-0.08286275906121644,1.1351644944745,137,136,139,165,26,28,29,207.5738844215623,21,157.18562874251495,0.3739686197181744,0.5009327051171873,0.6231056846312187,0.7308956673991348,13317,13360,Maries+Osage+Pulaski,Osage,29,151,Missouri,MO
29169,29CS033,293,270,316,342,26,49,72,109.90236758644053,39,87.06166868198308,-0.2891082921038325,0.21234601290244065,0.7849494040787172,0.7764024397078816,365,337,393,459,66,94,122,174.81917083592054,50,92.87120621122628,0.31115418136213485,0.8195246724890886,1.3227903523578683,0.5256565321070189,53755,53838,Maries+Osage+Pulaski,Pulaski,29,169,Missouri,MO
29127,29CS034,295,283,308,310,2,15,27,61.397830115018394,39,164.2912307800323,-1.5824252540286208,-1.0138101258272911,-0.5325726434270779,2.504041527497859,363,348,377,396,19,33,48,117.30691682199533,50,175.37090947353653,-1.0774610346425564,-0.5769207912100442,-0.07923554006589564,1.4515736850009786,28486,28511,Marion+Monroe+Ralls+Shelby,Marion,29,127,Missouri,MO
29137,29CS034,88,87,89,114,25,26,27,356.92513632185916,16,221.5810732833237,1.233825909127256,1.3516448648893788,1.4740602540700123,0.5976176892961017,108,107,110,122,12,14,15,155.66620277417573,17,195.29006318207925,-0.5219634443507333,-0.3974722601596142,-0.2665494471871269,1.1683252227513827,8665,8705,Marion+Monroe+Ralls+Shelby,Monroe,29,137,Missouri,MO
29173,29CS034,84,83,85,128,43,44,45,507.6290929648484,14,162.4286957362467,3.3272854478058496,3.4494432766303866,3.5706877379417055,0.3128254112494851,103,102,105,136,31,33,34,314.75819221626136,12,115.83011583011583,1.8564526337494627,1.988475456362512,2.1191589174605885,0.3570477643396945,10343,10360,Marion+Monroe+Ralls+Shelby,Ralls,29,173,Missouri,MO
29205,29CS034,69,68,70,84,14,15,16,296.9949776034622,7,138.56812933025404,1.4576082421727827,1.584543443135657,1.7074249840369757,0.43741261903060336,83,83,84,88,4,5,5,76.34499805910573,6,100.1001001001001,-0.3574908946876017,-0.23727323642416212,-0.12123368637997733,1.0760171729433456,6062,5994,Marion+Monroe+Ralls+Shelby,Shelby,29,205,Missouri,MO
29133,29CS035,149,144,155,185,30,36,41,339.93923409450355,24,227.93826671943017,0.607583777348394,1.1286804549004334,1.6548671060460851,0.6523020953116455,183,176,189,221,32,38,45,306.1195795130708,26,207.36959642686233,0.4957684420036838,1.0004413893863295,1.485148427662288,0.6602122810924724,12635,12538,Mississippi+New Madrid+Scott,Mississippi,29,133,Missouri,MO
29143,29CS035,200,193,207,289,82,89,96,653.4696799374498,37,270.6656912948061,3.2996157216614974,3.8288265913022173,4.33192992539204,0.4096123611118415,241,233,249,296,47,55,63,340.8655587902787,24,149.27229754944645,1.4157506387293706,1.910647315982774,2.403248672089836,0.4300738875327115,16404,16078,Mississippi+New Madrid+Scott,New Madrid,29,143,Missouri,MO
29201,29CS035,383,367,399,469,70,86,102,271.55453119817616,60,189.21973141310346,0.32424390455120666,0.8263966917857972,1.3432500963715006,0.6888026493828535,471,451,490,585,95,114,134,301.66116682685384,49,129.40710418592369,1.172166241142589,1.7276494308256998,2.1952173597963913,0.4252586236523485,38051,37865,Mississippi+New Madrid+Scott,Scott,29,201,Missouri,MO
29145,29CS036,565,540,590,642,52,77,102,158.0725643007254,80,163.6772829571029,-0.5707607659633556,-0.05146958731011801,0.4145522019512277,1.022225738719362,698,668,729,818,89,120,150,201.73865623299912,115,194.0175121893611,-0.4329569563441592,0.09698984934307403,0.6032278829298636,0.9537509280415768,58652,59273,Newton,Newton,29,145,Missouri,MO
29159,29CS037,396,378,415,492,77,96,114,268.0087112165479,51,142.66399365937806,0.7746488536225588,1.2806385193066683,1.7378671998311523,0.5268124423219674,488,466,511,514,3,26,48,59.224555894109464,47,108.91479155562766,-1.024473200724412,-0.481843884995056,0.023474808821116952,1.7697667104508563,42898,43153,Pettis+Saline,Pettis,29,159,Missouri,MO
29195,29CS037,219,209,229,255,26,36,46,183.72100582962196,42,216.83014971605576,-0.8190471852826045,-0.3470804159156502,0.20650914098457174,1.1479562919490487,269,257,281,325,44,56,68,239.3126218165536,36,154.55286996093247,0.34619952702471046,0.8457898380804209,1.3680650571423951,0.6344384952354535,23244,23293,Pettis+Saline,Saline,29,195,Missouri,MO
29165,29CS038,648,602,694,740,46,92,138,103.25297701591984,67,75.20555248954699,-0.21404856773338868,0.281490355536681,0.807739310955162,0.720529147109217,811,755,867,902,35,91,147,84.34503623860499,96,88.59766508236814,-0.5709094130670113,-0.04651797405075029,0.4518946287355254,1.0390502801519994,106907,108355,Platte,Platte,29,165,Missouri,MO
29041,29CS039,80,79,81,115,34,35,36,571.5380522079248,17,276.0487144790257,2.8403790736410532,2.956561916452089,3.0748743307236865,0.46964934765665334,98,97,98,117,19,19,20,264.31235685801573,12,163.04347826086956,0.8895448834439016,1.0124969027087842,1.1348793731923439,0.5866998240404697,7390,7360,Randolph and Nearby Counties,Chariton,29,41,Missouri,MO
29053,29CS039,166,159,173,173,-0,7,14,48.621750338147095,18,125.86679097954664,-1.2929015756490527,-0.7804272433214785,-0.26672902550513233,2.2632070922059677,203,194,212,227,15,24,33,138.5255840880599,36,210.39097656478287,-1.2203913955521541,-0.7309476862114447,-0.22438895216015814,1.4573062288523826,17161,17111,Randolph and Nearby Counties,Cooper,29,53,Missouri,MO
29089,29CS039,92,91,93,92,-1,0,1,0.4777375467394611,1,11.854193420922652,-0.22903358994990075,-0.11381771923885381,0.010882786899278685,0.9612601183065145,114,112,115,145,30,31,33,309.69462770738335,14,137.7410468319559,1.5867311331831009,1.7218618164324446,1.8414690190277554,0.4310694944117031,10123,10164,Randolph and Nearby Counties,Howard,29,89,Missouri,MO
29121,29CS039,175,168,181,235,54,60,67,474.7843693149845,15,118.63959926179804,3.0650633343389915,3.5707347848768123,4.1032485940207355,0.24578652088742914,214,206,222,226,4,12,20,79.90220953040763,17,111.96733188434432,-0.78429139544459,-0.33940486057671154,0.19235167239841133,1.294591788362546,15172,15183,Randolph and Nearby Counties,Macon,29,121,Missouri,MO
29175,29CS039,246,235,256,280,24,34,45,167.24149809554123,41,199.3597795696746,-0.8232721153130107,-0.322005907783481,0.2353827911691848,1.1583685366741132,302,289,315,355,40,53,66,215.0351375475168,38,153.5849971708027,0.08901008236424486,0.617068435988531,1.1560652697571294,0.7010553537416118,24679,24742,Randolph and Nearby Counties,Randolph,29,175,Missouri,MO
29183,29CS040,2589,2415,2764,3221,457,632,806,186.724032779929,396,117.05298421065595,0.16495774729184556,0.7003486916631004,1.2053035295140786,0.625886115623727,3215,3004,3427,3655,228,440,651,107.34389632931129,298,72.78269237344848,-0.19230769450345572,0.348141739253795,0.8624897299236002,0.676493679837313,405970,409438,St. Charles,St. Charles,29,183,Missouri,MO
29186,29CS040,172,164,180,176,-4,4,12,24.381677082274013,10,65.1748859439496,-0.9076784350410165,-0.41334978178287685,0.1013916523604615,2.1092765618963356,212,202,222,246,24,34,44,183.27811307912216,26,139.9956924402326,-0.07579528827411117,0.43526110315483973,0.9145847369730824,0.7420427792941472,18412,18572,St. Charles,Ste. Genevieve,29,186,Missouri,MO
29187,29CS040,661,632,690,827,137,166,195,297.00759132009597,103,184.55198363519628,0.658487514762449,1.1192637492831339,1.6372559353051128,0.6176451809565786,813,778,848,1027,179,214,249,317.4299809415694,123,182.36270904993475,0.8763866514929559,1.3510760594227065,1.8817833502440973,0.5718265958255919,66973,67448,St. Charles,St. Francois,29,187,Missouri,MO
29510,29CS042,2506,2377,2635,3132,497,626,755,250.53501607788948,330,132.0757234147578,0.6458056606674037,1.1976418889180889,1.7185688889778208,0.5263338879680807,3025,2873,3177,3392,215,367,519,124.60034701406279,265,90.0249012273961,-0.15498664226199507,0.33759493036461824,0.8474448654788643,0.7205447045346859,299828,294363,St. Louis (city),St. Louis (city),29,510,Missouri,MO
29189,29CS043,8783,8352,9213,10649,1436,1866,2297,223.70590545472763,1364,163.4880650116763,0.07548773349266216,0.6001678283257775,1.1163852324594639,0.7304255843898954,10743,10228,11258,11421,163,678,1193,67.93432146091,933,93.48594354170444,-0.7551034510783672,-0.25441609741810217,0.2433626754238686,1.3740957164258274,1001174,998011,St. Louis (county),St. Louis (county),29,189,Missouri,MO
29001,29CS044,193,182,204,196,-8,3,14,13.478457901231824,11,52.21932114882506,-0.8639986581086708,-0.38236375473032463,0.09800666769131008,2.8651525161049904,238,225,251,291,40,53,66,209.79780748133302,35,138.92196554735253,0.2355571726926856,0.7031180753963844,1.221303990991664,0.6498756184309508,25278,25194,Scotland and Nearby Counties,Adair,29,1,Missouri,MO
29045,29CS044,66,65,67,82,15,16,17,290.30819342141746,17,305.9388122375525,-0.2698106133759323,-0.155213307565187,-0.03804159855878963,0.9923264785907248,81,80,82,102,20,21,22,317.33457899079315,12,178.54485939592323,1.2619815174225817,1.3890425474963346,1.5223530786240311,0.5374404038378123,6668,6721,Scotland and Nearby Counties,Clark,29,45,Missouri,MO
29103,29CS044,36,36,37,45,8,9,9,280.12621349680006,3,95.41478929234032,1.7368882320344647,1.843688188230514,1.9747872746946342,0.30588413934844266,44,44,45,67,22,23,23,598.9489124022267,6,158.01948907031868,4.28408627493811,4.406739679172902,4.5369713220498875,0.2527157444213247,3773,3797,Scotland and Nearby Counties,Knox,29,103,Missouri,MO
29111,29CS044,101,100,102,109,7,8,9,97.61544145191611,7,84.06725380304242,0.017653901375595086,0.13590776786161518,0.26148717538907745,0.7668617206015172,123,121,124,155,31,32,34,322.60644206955135,14,139.93003498250874,1.7018726964600333,1.8318406260849898,1.9560663294968865,0.42071385217262086,9992,10005,Scotland and Nearby Counties,Lewis,29,111,Missouri,MO
29197,29CS044,39,39,40,51,11,12,12,348.05484585703505,5,146.34146341463415,1.8869718995237625,2.014869951282234,2.1420456414178966,0.3878412121262881,47,46,47,64,17,17,18,432.1576133620799,23,571.8547986076579,-1.520965636738727,-1.3939173947968868,-1.2543296745943364,1.2512662808354176,4100,4022,Scotland and Nearby Counties,Schuyler,29,197,Missouri,MO
29199,29CS044,45,45,45,51,6,6,6,151.79298891779837,6,152.1555367709214,-0.1325120158467818,-0.003852980461426099,0.11212098598645195,0.8588970279838515,54,54,55,69,14,15,15,314.2269886137555,11,234.34171282488282,0.673331214633153,0.7967828964031455,0.9246365941812172,0.698420908936727,4732,4694,Scotland and Nearby Counties,Scotland,29,199,Missouri,MO
29209,29CS045,342,329,356,386,30,44,57,167.45314820436826,47,179.99617029424905,-0.5807223342758158,-0.11493213247525155,0.4177857096088573,1.0508709198715989,421,405,437,499,62,78,94,247.2134724293459,66,209.56372642408076,-0.13833671699982103,0.36510980262867376,0.8812971996924396,0.8369536757201747,31334,31494,Stone+Taney,Stone,29,209,Missouri,MO
29213,29CS045,527,502,551,622,71,95,120,204.22195189578338,72,154.10958904109586,-0.047321034950334406,0.49160671639371145,1.0067374359795038,0.7467911634139117,649,620,678,795,117,146,175,259.520339089916,103,182.84131858768396,0.2876652949456186,0.7529785501308259,1.3049790609255985,0.6997492123710451,56064,56333,Stone+Taney,Taney,29,213,Missouri,MO
29011,29CS046,129,124,134,132,-2,3,8,26.145468169895764,16,165.11867905056758,-1.9529678301850695,-1.406622676298923,-0.8760494198159154,4.52809359577341,157,151,163,168,5,11,17,91.58711289456792,26,223.15681057419965,-1.8216099030055333,-1.3177579304290334,-0.7822247015532583,2.227779384891262,11628,11651,Vernon and Nearby Counties,Barton,29,11,Missouri,MO
29013,29CS046,174,167,181,191,10,17,24,128.4370277540592,16,119.44012441679627,-0.4334525036918273,0.08025867927605654,0.6209543898617592,0.878869282206847,211,203,219,244,25,33,41,203.98769715143277,42,260.93439363817095,-1.1047352564047455,-0.5804837915687309,-0.06004799868539037,1.2413599964895852,16075,16096,Vernon and Nearby Counties,Bates,29,13,Missouri,MO
29039,29CS046,180,174,186,157,-29,-23,-17,-196.1930614749134,13,109.5121095121095,-3.5477422597184356,-3.0536345603803423,-2.5273561434881953,-0.5832276817331571,221,214,229,236,7,15,22,100.47907309905847,34,235.24527779699716,-1.883576931485657,-1.3397034469005342,-0.8195063143778756,2.190405447097743,14245,14453,Vernon and Nearby Counties,Cedar,29,39,Missouri,MO
29057,29CS046,91,90,92,111,19,20,21,316.4725058703996,28,443.1548404115009,-1.3832699600012084,-1.2681001805078524,-1.1461973309648046,1.3336008264000068,112,111,113,119,6,7,8,97.70630560988359,10,131.63090693694878,-0.4624608059483345,-0.3430855191396764,-0.20716168385120118,1.1872609694430185,7582,7597,Vernon and Nearby Counties,Dade,29,57,Missouri,MO
29217,29CS046,197,189,206,251,45,54,62,326.4170022520388,37,224.41243366186504,0.5308084179148652,1.0247285799687293,1.520076438456221,0.6749607393351025,238,228,248,340,92,102,112,520.921314033388,44,224.46689113355782,2.4460497535029257,2.9710130477400383,3.4723110271842934,0.426724614413476,19785,19602,Vernon and Nearby Counties,Vernon,29,217,Missouri,MO
30001,30CS001,75,74,76,94,18,19,20,238.85948497811074,4,51.047538019780916,1.7459926981408744,1.8820164686659735,1.9993649275571528,0.20287441454060773,93,92,95,122,27,29,30,301.54993340426057,18,189.43380340980846,0.995067376137518,1.118546584548602,1.2486483566555922,0.6070155893086648,9403,9502,Beaverhead+Gallatin+Madison,Beaverhead,30,1,Montana,MT
30031,30CS001,675,616,734,705,-29,30,89,26.370633981236658,40,35.23194362889019,-0.6286292575886366,-0.09627161707010551,0.44511384169089485,1.2928473956684037,853,781,925,876,-49,23,95,16.232818001875422,80,57.27499874710941,-0.9365782590166503,-0.4148391397955974,0.1197282541238397,3.3793040907160123,136240,139677,Beaverhead+Gallatin+Madison,Gallatin,30,31,Montana,MT
30057,30CS001,76,75,77,91,14,15,16,206.13550548172046,5,68.98137502874224,1.2458115197214277,1.3674088778246765,1.4885063393585296,0.3136489636734087,95,94,96,105,9,10,11,110.34452299321666,14,157.67541389796148,-0.5927413349427205,-0.4744076006073628,-0.34978749615779764,1.296597611586654,8698,8879,Beaverhead+Gallatin+Madison,Madison,30,57,Montana,MT
30013,30CS002,781,745,817,908,91,127,163,181.28530359792234,137,195.90319236406532,-0.70889112702869606,-0.1406871108224079,0.3514570438178202,1.0721775449772684,961,918,1005,1029,24,68,111,79.9484270556456,114,134.93679276549406,-1.07221290302822,-0.5531371766661659,-0.013472577461255951,1.6631742654143833,83919,84484,Cascade,Cascade,30,13,Montana,MT
30023,30CS003,106,105,107,133,26,27,28,347.70150417021983,3,38.334575657544455,2.978337944077063,3.0912413577166182,3.209774390339578,0.1063432311915343,131,129,132,125,-7,-6,-4,-58.59188851940873,14,147.67932489451476,-2.180968142912292,-2.0654562564700303,-1.9380821919436466,-3.073875527524852,9391,9480,Deer Lodge and Nearby Counties,Deer Lodge,30,23,Montana,MT
30039,30CS003,28,27,28,25,-3,-3,-2,-94.70451119280597,5,180.94089264173704,-2.883333368178888,-2.756536254940984,-2.6278545668850937,-3.092143413690658,34,34,34,39,5,5,5,147.95358842339692,4,119.79634621144056,0.1533951704979619,0.2811959937306654,0.41588397762321044,0.6733813655552319,3316,3339,Deer Lodge and Nearby Counties,Granite,30,39,Montana,MT
30077,30CS003,67,67,68,81,13,14,14,235.27846679185066,2,34.637032760860144,1.8860756551029094,2.007273574047709,2.118700371428327,0.1371236992851826,83,82,84,82,-2,-1,-0,-17.236911995477865,14,200.28612303290413,-2.3063883602379827,-2.1746386441464285,-2.0580859532628546,-68.33930417218305,6929,6990,Deer Lodge and Nearby Counties,Powell,30,77,Montana,MT
30081,30CS003,415,395,434,478,44,63,83,170.8970333975118,35,94.40535862797545,0.2380338414919361,0.7657664872374719,1.2653368610501834,0.5438274336318674,522,498,545,665,120,143,167,313.671316769764,106,231.82573703088093,0.30598601962021094,0.7990963663319015,1.3390620371484734,0.7339547475784308,44489,45724,Deer Lodge and Nearby Counties,Ravalli,30,81,Montana,MT
30093,30CS003,363,348,378,402,24,39,54,132.34581466514064,54,184.33179723502303,-1.0255427181946961,-0.524245026463452,0.03299374600362086,1.3577832751707328,447,428,465,536,71,89,108,252.33055627221276,51,144.16553595658073,0.587215825084677,1.086057027506325,1.6361186068728217,0.5650064417760964,35154,35376,Deer Lodge and Nearby Counties,Silver Bow,30,93,Montana,MT
30003,30CS004,134,128,139,197,58,63,69,580.3198544895884,61,560.061208875287,-0.30492617470343136,0.19320146210047534,0.743529856756498,0.9500595119783275,163,156,169,165,-4,2,9,18.1273443077105,24,185.02813969624546,-2.165396041055889,-1.6911295457865883,-1.177350053817311,7.1614046904638675,13070,12971,Eastern Montana,Big Horn,30,3,Montana,MT
30011,30CS004,16,15,16,17,1,1,2,127.41143968908445,3,258.99280575539564,-1.4379312985314505,-1.3118348582087216,-1.1911084687903304,1.2117054740644106,20,19,20,12,-8,-8,-7,-527.7466307964335,6,420.7573632538569,-9.601221558997251,-9.489085705396697,-9.360544801454974,-0.9194462483652012,1390,1426,Eastern Montana,Carter,30,11,Montana,MT
30017,30CS004,120,119,121,119,-2,-1,0,-8.000968251994209,12,122.11668928086837,-1.4199089149396318,-1.2959537782888402,-1.1802976044275666,56.13469938779287,148,147,150,158,8,10,11,80.27392085964321,28,235.13604299630504,-1.6698752953333689,-1.547625752294726,-1.4145569804781315,2.651761620712794,11792,11908,Eastern Montana,Custer,30,17,Montana,MT
30019,30CS004,17,17,18,25,7,8,8,544.8640346210242,6,433.9963833634719,0.9931271464385727,1.1081559787287816,1.231309218386605,0.7031734575533196,22,22,22,20,-2,-2,-2,-102.44490246383384,4,237.81212841854932,-3.537674846357363,-3.4040813221154576,-3.2782887321324936,-5.531560419019507,1659,1682,Eastern Montana,Daniels,30,19,Montana,MT
30021,30CS004,79,78,80,115,35,36,37,489.0660361456249,20,270.3007095393626,2.061578482963769,2.1897614179057134,2.3061771846514483,0.5378250889288196,97,96,98,141,43,44,45,492.32520542241576,22,246.99674413382732,2.326836079883745,2.4516333842958615,2.5772983409019674,0.490508591346246,8879,8907,Eastern Montana,Dawson,30,21,Montana,MT
30025,30CS004,26,26,27,29,2,3,3,103.19524753266802,4,159.52143569292122,-0.6876027182767255,-0.5612947638126322,-0.43910198777439474,1.1149450255316036,33,32,33,34,1,1,2,47.26443557520068,4,132.49420337860218,-0.973031887216468,-0.8496692914264437,-0.7214307470771606,1.6481841289892505,3009,3019,Eastern Montana,Fallon,30,25,Montana,MT
30033,30CS004,12,12,12,12,-0,-0,-0,-24.820862809347574,3,302.52100840336135,-3.404482470483388,-3.279134663094127,-3.1508854144325755,3.979519919976224,15,15,15,19,4,4,4,316.1875890770651,5,415.2823920265781,-1.1191684817788454,-0.9929293768125694,-0.8592328466947619,1.0401717291513797,1190,1204,Eastern Montana,Garfield,30,33,Montana,MT
30055,30CS004,17,17,17,13,-4,-4,-4,-262.65969751813344,4,279.2321116928447,-5.533653152343574,-5.42155547444624,-5.294440747302288,-1.4479113003240327,21,20,21,25,4,4,5,256.34816506313985,3,174.41860465116278,0.7050165395664258,0.8206721057110462,0.9519851590586174,0.5546118486689128,1719,1720,Eastern Montana,McCone,30,55,Montana,MT
30071,30CS004,46,46,47,46,-1,-0,0,-8.57792904384279,12,346.4870067372473,-3.678577246296167,-3.5519386441223886,-3.427868754015518,17.071699273353744,57,57,58,67,9,10,10,232.33769087826565,13,310.1145038167939,-0.8976859610829757,-0.7779019613910851,-0.6617218883794003,1.2104738388709213,4156,4192,Eastern Montana,Phillips,30,71,Montana,MT
30075,30CS004,17,17,17,15,-2,-2,-2,-119.91238451876404,2,141.76018901358535,-2.73139893357334,-2.6134101497149556,-2.4921999394349017,-2.8911598658552196,21,20,21,22,1,1,2,83.46175670935412,1,58.78894767783657,0.12420357804565144,0.24587846899794588,0.37341057653274423,0.41327702334478117,1693,1701,Eastern Montana,Powder River,30,75,Montana,MT
30079,30CS004,15,14,15,18,3,3,4,351.3738073243737,3,334.5724907063197,-0.35085974946117143,0.15182051606442806,0.7034916099818804,0.7227780455826426,18,18,19,12,-7,-6,-6,-576.5821239144104,5,459.1368227731864,-10.892567663255877,-10.354060326315505,-9.819649676986364,-0.9471527899583266,1076,1089,Eastern Montana,Prairie,30,79,Montana,MT
30083,30CS004,80,79,81,95,14,15,16,160.92555984002965,15,157.9362990260595,-0.08754289459965243,0.03048946609629854,0.1550955265247518,0.9211549660726234,98,96,99,128,29,30,32,269.43857428461826,16,141.40521431727794,1.1520292778303343,1.2761142688409481,1.4045094399013145,0.5081466276913601,11397,11315,Eastern Montana,Richland,30,83,Montana,MT
30085,30CS004,123,119,128,167,39,44,48,482.9659872413992,45,499.07578558225504,-0.637467969414432,-0.16499574433397915,0.40551641384402015,1.0101592119844192,151,145,156,193,37,42,48,389.48664522736425,22,203.4211742949607,1.3684984549932668,1.8526691483458446,2.397389206699185,0.5101688160790804,10820,10815,Eastern Montana,Roosevelt,30,85,Montana,MT
30087,30CS004,73,72,74,123,49,50,51,721.0646599614109,35,501.432664756447,2.0730895553540596,2.196975336149017,2.321566721569425,0.6818582972423833,87,86,88,126,38,39,40,479.780887261489,21,257.70033132899744,2.0972023126659862,2.214878621441042,2.3477009897665644,0.5237254551473081,8376,8149,Eastern Montana,Rosebud,30,87,Montana,MT
30091,30CS004,40,39,40,29,-11,-11,-10,-371.09465891440095,6,206.30372492836673,-5.904143543457219,-5.771909978830104,-5.654239501414597,-0.6127031959842671,49,49,50,61,11,12,12,332.14007442076024,2,56.72149744753262,2.612447599078197,2.7493412104349995,2.8892779955778964,0.15734082644463945,3490,3526,Eastern Montana,Sheridan,30,91,Montana,MT
30103,30CS004,10,10,11,5,-6,-5,-5,-866.6545273262655,5,797.8723404255318,-17.175747407935322,-16.64103440480923,-16.16349773896484,-1.1284045278858685,13,12,13,4,-9,-9,-8,-1157.2721176099503,4,521.5123859191656,-17.34198226590851,-16.783861456007262,-16.24764594511987,-0.5078541457912178,752,767,Eastern Montana,Treasure,30,103,Montana,MT
30105,30CS004,77,76,78,91,13,14,15,227.05938736726083,17,271.0603242094073,-0.5605095167107179,-0.4398580508777228,-0.31539133386689994,1.11545570822118,94,93,95,102,7,8,9,101.35130987343089,13,172.43666268735907,-0.8448410157148399,-0.7089101602707096,-0.5878415912998541,1.5044772227161813,7526,7539,Eastern Montana,Valley,30,105,Montana,MT
30109,30CS004,13,12,13,19,6,6,7,793.4901200259723,6,772.5321888412016,-0.3091312833838268,0.20882027487754892,0.7064857115395373,0.8376643762926379,16,15,16,20,4,4,5,464.5499708211702,3,321.54340836012864,0.9171310601347827,1.4554860555442493,1.9354149520991037,0.5624032074805239,932,933,Eastern Montana,Wibaux,30,109,Montana,MT
30029,30CS005,815,770,860,941,81,126,171,143.76078658329135,62,70.83960162245539,0.2078687601383335,0.7295214936233557,1.2389804079427313,0.48887480062494626,1026,970,1081,1249,168,223,279,206.86134493536403,150,138.99570966576164,0.18511928972231725,0.6883203037635137,1.1975364440549539,0.6689304533356668,105026,107917,Flathead,Flathead,30,29,Montana,MT
30043,30CS006,89,88,90,136,46,47,48,461.84530520234836,7,68.97117989982758,3.8057210778085535,3.9282160291038304,4.050521633995647,0.14621883390575252,112,110,113,177,64,65,67,525.645498482747,18,144.9158682875775,3.679309791214497,3.8046056713656116,3.9369257491393825,0.271532417500825,12179,12421,Jefferson+Lewis and Clark,Jefferson,30,43,Montana,MT
30049,30CS006,552,521,583,604,21,52,83,87.97122361136776,49,82.82856740385971,-0.46310371012783647,0.04747869930947191,0.5498823721231587,0.9237908431178972,686,648,723,782,59,96,134,133.831167955858,99,137.38932526575815,-0.5457101174267684,-0.054100581740798466,0.48799856132443853,1.0160509050358228,70990,72058,Jefferson+Lewis and Clark,Lewis and Clark,30,49,Montana,MT
30047,30CS007,274,260,287,319,32,45,59,174.6308546733383,23,88.34544348772447,0.3374267764707419,0.8503392618398666,1.367757563098263,0.49501021357252606,339,323,356,397,41,58,74,180.1525336756101,62,194.23558897243106,-0.6750800913493025,-0.15252566806960305,0.3823599909864079,1.05974412180408,31241,31920,Lake+Lincoln+Mineral+Sanders,Lake,30,47,Montana,MT
30053,30CS007,210,202,219,239,20,29,37,173.7089254915439,12,72.48200533548093,0.5301281222200949,1.0262849786516413,1.4934858151546409,0.4032398956006644,262,252,273,331,58,69,79,336.9043577942768,50,244.9899554118281,0.3684318154126422,0.9295574481561623,1.4424938262800908,0.7167553420998979,19867,20409,Lake+Lincoln+Mineral+Sanders,Lincoln,30,53,Montana,MT
30061,30CS007,50,49,50,54,4,4,5,117.14396617331215,5,131.14754098360655,-0.26338286222749396,-0.14032097630633572,-0.026780953220871682,0.9147266714422159,64,63,64,84,20,20,21,423.48462341517563,13,269.87751712684246,1.409944328658814,1.5315617018901666,1.6630334007937961,0.6074978039762955,4575,4817,Lake+Lincoln+Mineral+Sanders,Mineral,30,61,Montana,MT
30089,30CS007,146,141,152,163,11,17,22,162.54012855671843,14,135.15687851971038,-0.25259356769021246,0.2559281974234258,0.8387654421317349,0.784909627281556,183,176,190,233,43,50,57,387.27400701722735,39,302.67753201396977,0.3538750567891789,0.842668569265613,1.3147430411553316,0.7662044008196345,12430,12885,Lake+Lincoln+Mineral+Sanders,Sanders,30,89,Montana,MT
30063,30CS008,771,720,822,835,13,64,115,64.92538858392267,56,56.64241944048753,-0.43924431204898684,0.09303745806526766,0.5959948321541494,0.8590402868977597,955,893,1017,1090,73,135,197,113.16156317687056,94,78.76390937122939,-0.1881916100791822,0.34098331703874596,0.8641933737679889,0.6909146547904726,118639,119344,Missoula,Missoula,30,63,Montana,MT
30005,30CS009,60,59,60,89,29,29,30,506.4672124657029,24,414.03105232892466,0.7989234094330881,0.9252003747385126,1.0513960021112025,0.7905602863720146,73,72,74,76,2,3,4,38.34257519134272,7,100.2434483746241,-0.7392826972881957,-0.6159184730292414,-0.498165860885694,1.9034866849063088,6956,6983,North Central Montana,Blaine,30,5,Montana,MT
30015,30CS009,51,50,51,64,13,13,14,274.9227058915239,1,20.446413358323394,2.4168627081665166,2.54292271511492,2.6568334630380437,0.06922326006947309,62,62,63,72,9,10,10,162.69642980430908,4,67.63611768684477,0.8258197158084012,0.9507888044054023,1.0661455228046899,0.3765816360945337,5869,5914,North Central Montana,Chouteau,30,15,Montana,MT
30027,30CS009,132,130,133,150,17,18,20,194.31118475843522,15,157.72870662460568,0.2386931821441848,0.36644370244969005,0.4833593801321362,0.7700603149071219,163,162,165,172,7,9,10,74.61295904049135,23,198.3784716232534,-1.3636033258354354,-1.2376728766742,-1.113694892615547,2.3832649692479873,11412,11594,North Central Montana,Fergus,30,27,Montana,MT
30035,30CS009,135,129,141,160,19,25,31,216.70352688589662,42,366.7054714784634,-1.9621895035607386,-1.495494556717394,-0.9842370892659861,1.6266600422467954,165,158,173,183,10,18,25,127.7862770045213,21,152.405834966253,-0.7580978095301641,-0.24615287051524987,0.24918589196560334,1.1285668086889302,13744,13779,North Central Montana,Glacier,30,35,Montana,MT
30041,30CS009,141,134,148,158,10,17,24,122.6392217495688,34,250.6450423884998,-1.7904738887657086,-1.2570286472912073,-0.7780273883298425,1.9278736613542427,172,164,181,205,24,33,41,202.71338742222116,29,179.13397986286984,-0.27578275088519516,0.21776582990584503,0.7672556995622465,0.857549995948705,16278,16189,North Central Montana,Hill,30,41,Montana,MT
30045,30CS009,16,16,17,16,-1,-0,-0,-20.275414603831063,8,475.48291233283794,-5.080071915087815,-4.958531769453327,-4.837983999507789,12.14207166146612,20,20,20,24,4,4,4,184.75854043300336,2,98.0392156862745,0.7414515376028075,0.8633887337343498,0.9879877017924144,0.4193686039914638,2019,2040,North Central Montana,Judith Basin,30,45,Montana,MT
30051,30CS009,13,13,13,18,5,5,5,285.9005916075111,5,296.8827313211281,-0.21905663452718932,-0.11166007166444476,0.008209548694686502,0.8598389489413976,16,15,16,15,-1,-1,-0,-30.781446393750148,5,256.6735112936345,-3.004214119680319,-2.873532343425493,-2.7514559579204403,12.488216610537721,2021,1948,North Central Montana,Liberty,30,51,Montana,MT
30069,30CS009,7,7,7,3,-4,-4,-4,-892.5637742839426,3,720,-16.63924128287224,-16.152361188586937,-15.648699432264829,-1.103340437170382,8,8,9,8,-1,-0,-0,-80.22497287190703,8,1550.3875968992247,-16.814585035146106,-16.315282364057985,-15.754408611194103,13.650965360880024,500,516,North Central Montana,Petroleum,30,69,Montana,MT
30073,30CS009,62,61,62,67,5,5,6,104.4034720043856,1,20.37351443123939,0.7176122492097508,0.8432583308444397,0.9536795316253843,0.1632794236599912,77,76,78,69,-9,-8,-7,-130.55699753882806,6,100.36801605888257,-2.440148068061568,-2.311011984446958,-2.196732026503149,-0.8817438490101464,5890,5978,North Central Montana,Pondera,30,73,Montana,MT
30099,30CS009,56,56,57,65,8,9,9,169.21439371465868,2,38.51709195955704,1.1926932340941547,1.3023329099423389,1.4288557446487744,0.2043640430398289,69,68,70,92,22,23,24,364.0898375614444,14,223.46368715083798,1.2826103784837515,1.4084653965622784,1.5245403710313097,0.587982601844452,6231,6265,North Central Montana,Teton,30,99,Montana,MT
30101,30CS009,45,44,45,48,3,3,4,80.67227406139827,2,48.661800486618006,0.203957241910034,0.32304091855352807,0.4319043172360932,0.46343170869679606,56,55,56,75,19,19,20,389.576270773194,9,179.85611510791367,1.9704162198923378,2.0945958273519114,2.221816398998218,0.4391444247065626,4932,5004,North Central Montana,Toole,30,101,Montana,MT
30007,30CS010,58,57,59,43,-16,-15,-14,-266.8726540917823,9,158.8702559576346,-4.3753209667498405,-4.25801042512455,-4.135147035081142,-0.6374688980967416,75,74,76,92,16,17,18,231.55981074504595,20,276.85492801771875,-0.5896671661082701,-0.45214351094318295,-0.3289123270508633,1.1281664349287253,6798,7224,South Central Montana,Broadwater,30,7,Montana,MT
30009,30CS010,89,88,90,104,14,15,16,171.90838413180424,7,79.43262411347517,0.8068792118242276,0.9288155179069945,1.0354262776878176,0.43345192873057486,111,109,112,109,-3,-2,-0,-14.745659742240736,18,166.69753658084832,-1.9250599451681536,-1.820163907314631,-1.683489548850575,-30.39327176611883,10575,10798,South Central Montana,Carbon,30,9,Montana,MT
30037,30CS010,11,11,12,12,0,1,1,106.72758600947557,4,583.9416058394161,-5.257877882005171,-4.776188881514016,-4.258023472440218,2.310690921297766,14,13,14,17,3,3,4,383.54794212783656,4,482.50904704463204,-1.508854106555283,-0.976846786948726,-0.48055703177950654,0.9570265322902853,822,829,South Central Montana,Golden Valley,30,37,Montana,MT
30059,30CS010,20,20,20,18,-2,-2,-2,-136.21350745656588,5,312.98904538341156,-4.620119519307858,-4.49154705700347,-4.369123083178191,-4.251661700854554,25,25,25,19,-6,-6,-6,-312.3114233340068,3,153.21756894790602,-4.782469868395664,-4.657137325431672,-4.531446086246624,-0.5865036514157171,1917,1958,South Central Montana,Meagher,30,59,Montana,MT
30065,30CS010,51,50,51,60,9,9,10,230.5331037437991,5,126.44889357218123,0.9157648949916711,1.0400957098150434,1.1631853109051038,0.4942829677983352,64,63,64,92,28,28,29,580.8959063045812,17,348.7894952810833,2.205184106703224,2.318005167955278,2.4492629608785186,0.5799501053741435,4745,4874,South Central Montana,Musselshell,30,65,Montana,MT
30095,30CS010,71,70,72,95,23,24,25,318.2250456576525,7,92.20636663007683,2.1334253857886663,2.2618899062521396,2.3810384931439406,0.27823504696188456,86,85,87,133,46,47,48,523.3446941354134,20,221.26341409447946,2.902643194465198,3.0212351151397705,3.1448477246921116,0.41403472638013694,9110,9039,South Central Montana,Stillwater,30,95,Montana,MT
30097,30CS010,31,31,32,46,14,15,15,481.1809850749686,4,130.328536519142,3.3879679134447818,3.5068211230315924,3.626028364146449,0.25367437180168845,38,38,39,42,3,4,4,96.82594338381031,8,215.34320323014802,-1.307863876204325,-1.1844036502227413,-1.0515120199251737,1.7402336685113042,3683,3715,South Central Montana,Sweet Grass,30,97,Montana,MT
30107,30CS010,23,23,23,32,9,9,9,531.2720173326786,2,114.77761836441894,4.044668495376428,4.166258536728971,4.273799229332353,0.194980901046107,27,27,28,31,3,4,4,176.69053146868183,2,96.89922480620154,0.6694658354383121,0.7995671485920555,0.9198035642361898,0.43039514472987855,2091,2064,South Central Montana,Wheatland,30,107,Montana,MT
30111,30CS011,1375,1304,1445,1579,134,204,275,148.9459949666954,173,126.0282288662923,-0.2733434174065529,0.22732575075918326,0.728348102857463,0.8420154679544051,1706,1620,1793,1942,149,236,322,141.1763855239488,238,142.6516422920163,-0.5208703893077253,-0.02221577329338756,0.5422548636028396,1.0061779256648797,164725,166840,Yellowstone,Yellowstone,30,111,Montana,MT
31007,31CS001,9,9,10,3,-7,-6,-6,-1121.3705851212983,3,517.9856115107913,-16.913188881270475,-16.378965665712958,-15.909357328906957,-0.5459901480082037,12,11,12,4,-8,-8,-7,-1096.375162850835,4,578.8712011577423,-17.28132570596437,-16.764472087255697,-16.267122412567776,-0.6082769113451739,695,691,Banner and Nearby Counties,Banner,31,7,Nebraska,NE
31033,31CS001,84,83,85,107,22,23,24,295.1500273729147,13,165.6402633255468,1.1830876112866169,1.2956780668921548,1.414928010321715,0.5379824289092009,105,103,106,136,30,31,33,330.518697151218,15,157.52993068683048,1.6105782282975145,1.7272246311136557,1.853746782190422,0.46193657492738605,9418,9522,Banner and Nearby Counties,Cheyenne,31,33,Nebraska,NE
31105,31CS001,47,46,48,56,8,9,10,314.12805386702325,3,104.92567764500146,1.5515649306715162,2.0992014503036898,2.5983768581156945,0.3005576966235736,57,55,59,50,-9,-7,-5,-209.9876581168972,6,175.95307917888562,-4.398257450407258,-3.8516125185276087,-3.3917581328091018,-0.9739344080985809,3431,3410,Banner and Nearby Counties,Kimball,31,105,Nebraska,NE
31123,31CS001,49,48,49,69,20,20,21,535.6227105699467,12,316.1361141602635,2.078314198201924,2.194921929255708,2.3229860382849705,0.5625524213933063,60,59,61,73,12,13,14,283.13232302840925,14,306.4127817903261,-0.3615633093679195,-0.23393465560280455,-0.10752076820755514,1.0045696553929266,4555,4569,Banner and Nearby Counties,Morrill,31,123,Nebraska,NE
31157,31CS001,364,349,380,460,80,96,111,320.49032044524336,96,320.76627499025443,-0.5338410493919196,-0.013663604054055678,0.5026245025140197,0.9905340909272007,444,426,463,465,2,21,39,57.78529378285289,48,134.14565982896428,-1.3046011134048991,-0.7668836080550265,-0.23462120598456024,2.2143557417610644,35914,35782,Banner and Nearby Counties,Scotts Bluff,31,157,Nebraska,NE
31019,31CS002,316,294,337,385,48,69,91,165.8086708933119,58,138.9055202969704,-0.2702819342791024,0.27020227463184754,0.7934261866752258,0.8258177918611082,391,365,417,424,7,33,59,65.84800064411502,35,69.571439930031,-0.5256986571757812,-0.036103096440258754,0.4364768006567559,1.0255865631914685,50106,50308,Buffalo+Kearney+Sherman,Buffalo,31,19,Nebraska,NE
31099,31CS002,64,63,65,61,-4,-3,-2,-54.153323860905985,3,53.89221556886227,-1.203458416625029,-1.0800902871855413,-0.9610355702171363,-1.4891773823339707,78,77,79,63,-16,-15,-14,-226.25903947174172,5,74.8839299086416,-3.1322783107899403,-3.0165244771693702,-2.885592192048943,-0.35442602808181956,6680,6677,Buffalo+Kearney+Sherman,Kearney,31,99,Nebraska,NE
31163,31CS002,34,33,34,43,9,9,10,375.0901115531404,1,40.52684903748734,3.2220877574373366,3.3454995145407036,3.467360548783785,0.0975100943423848,41,41,42,39,-3,-2,-2,-74.07174771867365,5,168.74789065136687,-2.5463007319126243,-2.4306481244090055,-2.30790921359944,-4.184990350814644,2961,2963,Buffalo+Kearney+Sherman,Sherman,31,163,Nebraska,NE
31021,31CS003,81,80,81,94,13,13,14,240.08653156701598,11,197.39793629430235,0.3175983952443027,0.4284023100527164,0.5467132706052814,0.7650139922274469,99,98,100,72,-28,-27,-26,-404.5414123368101,5,74.5045447772314,-4.9105527767469725,-4.788383678103026,-4.66743468992921,-0.1912135523146819,6687,6711,Burt+Dakota+Thurston+Washington,Burt,31,21,Nebraska,NE
31043,31CS003,155,146,165,210,45,55,64,308.0403342588421,68,383.638928067701,-1.2408541136670452,-0.7503471089513939,-0.24314352786425858,1.2230182997791972,190,179,201,157,-44,-33,-22,-154.32903227207385,11,51.69415856008271,-2.581808421759981,-2.067410921126868,-1.5267129630621263,-0.3454809157751116,21270,21279,Burt+Dakota+Thurston+Washington,Dakota,31,43,Nebraska,NE
31173,31CS003,67,66,68,84,16,17,18,297.6470383551547,10,175.92728338953233,1.100786638016219,1.2200933026752452,1.3352246284018565,0.5580745260487485,80,79,81,104,23,24,25,358.76264609153793,18,271.00271002710025,0.7510266217491386,0.8720453510880823,0.9963129977208923,0.7249582810185218,6821,6642,Burt+Dakota+Thurston+Washington,Thurston,31,173,Nebraska,NE
31177,31CS003,163,154,172,177,5,14,23,78.1857904276764,19,109.2006322141865,-0.80171852031293,-0.3031974361146099,0.2087989354385778,1.3010422867505178,201,190,211,201,-10,0,11,2.0112615832738023,17,81.10687022900763,-1.2948310962598237,-0.7806942472314142,-0.276530240810452,11.958689667284203,20879,20960,Burt+Dakota+Thurston+Washington,Washington,31,177,Nebraska,NE
31027,31CS004,86,85,87,95,8,9,10,132.71844505404584,20,286.56716417910445,-1.6602766886338154,-1.534545317967628,-1.4141945583494344,1.9488160083736317,104,103,105,87,-18,-17,-16,-208.6465094382655,12,143.95393474088291,-3.648674284411838,-3.527725311099018,-3.395024333108298,-0.7320299000297735,8375,8336,Cuming and Nearby Counties,Cedar,31,27,Nebraska,NE
31037,31CS004,66,65,67,65,-2,-1,0,-10.694126859759447,21,238.6363636363636,-2.607960401580661,-2.493649876398399,-2.3757524476589285,356.43461706592075,81,79,82,65,-17,-16,-14,-147.90471650743524,4,38.07710613993336,-1.9918081684929707,-1.858678256219284,-1.7313458897094907,-0.2751525460157752,10560,10505,Cuming and Nearby Counties,Colfax,31,37,Nebraska,NE
31039,31CS004,81,80,82,104,22,23,24,303.81440275275276,12,160.37420648179085,1.316000398124406,1.434706994781639,1.561256388529269,0.5056269392122087,100,98,101,121,20,21,23,238.21614527653745,5,55.62972852692479,1.7033300339779096,1.8241205329658028,1.952546478303038,0.22310604803164988,8979,8988,Cuming and Nearby Counties,Cuming,31,39,Nebraska,NE
31051,31CS004,51,51,52,64,12,13,13,270.7622972919442,14,300.8057296329454,-0.4245335847313819,-0.298221050939419,-0.17695988243009098,1.0292809410955177,63,62,63,64,1,1,2,26.522695515823287,4,72.07207207207207,-0.5837302510319029,-0.4543936143420761,-0.3306741652541707,1.6181166926594674,5585,5550,Cuming and Nearby Counties,Dixon,31,51,Nebraska,NE
31167,31CS004,37,36,37,55,18,18,19,373.6861806320607,6,123.30878575098474,2.378746532806452,2.5057564151551106,2.6264001951027174,0.31277780632742413,45,44,46,43,-3,-2,-1,-34.899003484259545,4,68.7639676809352,-1.162334967741775,-1.0360001398950207,-0.912910293887123,-3.8832122642516715,5839,5817,Cuming and Nearby Counties,Stanton,31,167,Nebraska,NE
31179,31CS004,61,60,62,67,5,6,7,70.25226702413715,3,37.27865796831314,0.21829061974522623,0.3291652239765128,0.4444883237435062,0.4508870398509321,76,75,77,72,-5,-4,-3,-42.842437234879526,2,20.470829068577277,-0.7584629018867715,-0.6313245866793251,-0.5015849443020823,-0.6278043002131046,9657,9770,Cuming and Nearby Counties,Wayne,31,179,Nebraska,NE
31053,31CS005,380,364,396,451,55,71,87,231.30119830391132,57,184.83489163919364,-0.034091272980470606,0.45917242790610374,0.9848857642885334,0.7880609099864812,462,443,481,488,7,26,45,69.63253093169838,41,110.50319381182113,-0.9200638656886363,-0.407765937668807,0.10889364830511633,1.5278122598200643,37006,37103,Dodge+Saunders,Dodge,31,53,Nebraska,NE
31155,31CS005,196,186,205,234,29,38,48,206.21637374457578,18,96.90878908878818,0.5332670547444,1.0992599539281347,1.6539109984123348,0.45798062201044476,242,231,254,252,-2,10,21,42.37945926965096,23,101.2101210121012,-1.0792881759937185,-0.5801466545644254,-0.05577715825238152,2.1635386671847177,22289,22725,Dodge+Saunders,Saunders,31,155,Nebraska,NE
31055,31CS006,3658,3407,3910,4168,258,510,761,104.88232056651283,488,100.45527373032836,-0.46944426880897483,0.036599068420401754,0.5148040765066182,0.955914183878438,4520,4218,4822,4695,-127,175,477,29.956728089625805,384,65.6401279982496,-0.9066970683049459,-0.37084561713432623,0.16962701234126734,2.1787326029872665,582946,585008,Douglas,Douglas,31,55,Nebraska,NE
31029,31CS007,44,44,45,46,1,2,2,53.24736485041036,7,216.60649819494586,-1.7576085035410411,-1.6305472297602652,-1.510974978700366,2.5727941405424724,54,53,54,60,6,6,7,157.59932127427837,5,130.41210224308816,0.15049759020111841,0.27109133791315765,0.3970390094497913,0.7099894688489456,3878,3834,Frontier and Nearby Counties,Chase,31,29,Nebraska,NE
31047,31CS007,191,181,201,228,27,37,47,186.05758484284826,36,180.33060611120388,-0.48835372499932395,0.0540945922713716,0.5769056076544354,0.9438093692185396,235,223,248,241,-7,6,18,24.061653184915087,29,121.24252686149086,-1.5052414383807307,-0.9857489029009535,-0.4852453241551795,4.292921217344234,23956,23919,Frontier and Nearby Counties,Dawson,31,47,Nebraska,NE
31057,31CS007,20,20,21,20,-1,-0,-0,-34.41246115329425,3,218.04966686856451,-2.633389297135621,-2.5264249856891428,-2.4080477149520103,5.6975523975706315,25,25,25,25,-0,0,0,0.8972289376160668,3,183.26206475259622,-1.954069845216983,-1.8192760229906713,-1.695555723052422,2.9565748990242735,1651,1637,Frontier and Nearby Counties,Dundy,31,57,Nebraska,NE
31063,31CS007,17,17,17,19,2,2,2,89.06998634678975,1,47.393364928909946,0.2923427902212934,0.4171664690481777,0.531883803471561,0.34729738413913175,21,21,22,32,10,11,11,414.8085372334658,7,274.72527472527474,1.2774328774560153,1.398187421957489,1.5303698436454258,0.6050484449437973,2532,2548,Frontier and Nearby Counties,Frontier,31,63,Nebraska,NE
31073,31CS007,20,20,20,29,9,9,9,582.5677561646357,4,253.03110173958882,3.172887541701694,3.296891085838888,3.4112009449993987,0.3917948259383615,24,23,24,22,-2,-2,-1,-88.0082386981785,9,490.73064340239915,-5.904953116577188,-5.786660901250947,-5.660565618224131,-14.656283341373658,1897,1834,Frontier and Nearby Counties,Gosper,31,73,Nebraska,NE
31085,31CS007,8,8,8,5,-3,-3,-3,-430.5557949371269,5,696.0556844547564,-11.394628457660753,-11.268462148643701,-11.147750913417724,-2.3891142851997564,10,10,10,2,-8,-8,-8,-923.6179101579985,2,236.68639053254438,-11.72554671113547,-11.604544455039585,-11.471218907228554,-0.2939200575351086,862,845,Frontier and Nearby Counties,Hayes,31,85,Nebraska,NE
31087,31CS007,31,31,32,44,12,13,13,572.7059644851404,4,182.5789273488018,3.7812070191431832,3.8999544196644784,4.025747606985516,0.2952676020819503,38,38,38,45,7,7,7,264.071322776722,6,231.66023166023166,0.19505931978466703,0.323545914115877,0.4577389027444856,0.7653600822953234,2629,2590,Frontier and Nearby Counties,Hitchcock,31,87,Nebraska,NE
31145,31CS007,114,113,115,119,4,5,6,56.529643491070686,4,44.973297104843994,-0.0019424932934456493,0.11444791510304639,0.231706223544691,0.6635875421491496,140,139,141,171,30,31,32,291.21496655457344,12,112.88805268109125,1.658011755668905,1.7794166890113225,1.9080379882664786,0.37551456121066473,10673,10630,Frontier and Nearby Counties,Red Willow,31,145,Nebraska,NE
31079,31CS008,488,462,515,549,34,61,87,116.39600891339549,111,213.236000384209,-1.4844643633669872,-0.955740191339824,-0.42214491161825923,1.8022423077984264,594,562,626,625,-1,31,63,49.2276036086722,53,85.36133614649938,-0.8367698524081085,-0.35373385306094485,0.1255676409318667,1.6790788183388272,62466,62089,Hall,Hall,31,79,Nebraska,NE
31093,31CS009,64,63,65,70,5,6,7,111.39152836221083,14,258.8996763754045,-1.5975662858801754,-1.4749785390400016,-1.357539799826202,1.9933090605623223,79,79,80,93,13,14,14,208.04010898504802,6,91.93993257738278,1.038524962061262,1.160433356049229,1.2781958311345631,0.4116158680600105,6489,6526,Howard+Merrick+Nance+Platte,Howard,31,93,Nebraska,NE
31121,31CS009,73,72,74,90,16,17,18,268.1404046821735,17,265.52128074970716,-0.08784549830239148,0.02514818153406093,0.13502745891159038,0.9357271371477862,90,89,91,95,4,5,6,68.63195796492997,4,52.192066805845506,0.045437456148437146,0.1663228643014781,0.2983475832113713,0.6389824068753152,7683,7664,Howard+Merrick+Nance+Platte,Merrick,31,121,Nebraska,NE
31125,31CS009,44,44,45,52,7,8,8,270.99414918060603,3,105.97586105387106,1.534707352831807,1.649754170932825,1.7721674355284116,0.3459651870904305,54,54,55,49,-6,-5,-5,-158.94140396443194,4,118.02891708468574,-2.886257769897745,-2.766608497677135,-2.639449571619949,-0.9118837228606471,3397,3389,Howard+Merrick+Nance+Platte,Nance,31,125,Nebraska,NE
31141,31CS009,264,249,278,305,27,41,56,144.89685428254307,51,179.20937042459738,-0.8497291651668349,-0.3497019675718989,0.1612942996556822,1.2075227307666423,326,309,344,344,-0,18,35,51.39730242616922,32,93.43884135836716,-0.9266706892490852,-0.41527287964849136,0.06702818044851463,1.7202419757704843,34150,34247,Howard+Merrick+Nance+Platte,Platte,31,141,Nebraska,NE
31109,31CS010,1974,1835,2113,2179,66,205,344,76.29657302550925,148,55.083431548911356,-0.2839646226200352,0.20669173037355243,0.7260328964280386,0.7184599401015719,2451,2284,2619,2552,-67,101,268,31.068980304714703,179,55.199210558776365,-0.7431128060601226,-0.2569392592041016,0.2966307038184185,1.759205298912295,322420,324280,Lancaster,Lancaster,31,109,Nebraska,NE
31049,31CS011,20,19,20,18,-2,-2,-1,-109.37770700838333,7,458.76570180229385,-5.805975954516202,-5.6793688177558534,-5.564308106999845,-10.464605886298097,24,24,25,35,10,11,11,564.8761723216971,3,161.29032258064515,3.9049455225581062,4.034557239374515,4.164201185690059,0.26071774122427144,1831,1860,Lincoln and Nearby Counties,Deuel,31,49,Nebraska,NE
31101,31CS011,82,81,83,78,-5,-4,-3,-56.463268442389875,1,14.5032632342277,-0.8337150767831452,-0.7061508802723638,-0.5861560031682359,-0.3456449340813353,101,100,102,132,30,31,32,378.95094313036157,15,181.05009052504525,1.8491504981043787,1.9835359508311992,2.0953468372950916,0.46301890195780365,8274,8285,Lincoln and Nearby Counties,Keith,31,101,Nebraska,NE
31111,31CS011,316,301,331,406,75,90,105,312.1407110394446,55,191.01643899050708,0.6947046705658887,1.2138074097012639,1.7176358757501247,0.6052221955969629,383,366,401,501,100,118,135,344.19379702386686,60,175.4693805930865,1.1777747713247169,1.6982741389090763,2.1953866761392513,0.5055031305352288,34552,34194,Lincoln and Nearby Counties,Lincoln,31,111,Nebraska,NE
31113,31CS011,9,9,9,12,3,3,3,486.82035928043746,6,1005.586592178771,-5.721025614955638,-5.205192659523823,-4.691480335073008,1.5366117690069658,11,10,11,6,-5,-5,-4,-683.3122070021251,6,868.3068017366137,-16.002543724277096,-15.52066418754887,-15.013185246429739,-1.6121719626394257,716,691,Lincoln and Nearby Counties,Logan,31,113,Nebraska,NE
31117,31CS011,5,5,5,2,-3,-3,-3,-918.9630402127752,2,588.2352941176471,-15.580505872562176,-15.071109094552611,-14.603427790069059,-0.9414093479164299,6,6,6,8,2,2,2,545.9904942484042,8,2099.737532808399,-16.078972496071138,-15.526727293186074,-14.9980507965618,2.597213892032191,408,381,Lincoln and Nearby Counties,McPherson,31,117,Nebraska,NE
31135,31CS011,29,29,29,28,-1,-1,-1,-34.90674643107085,11,462.5087596355991,-5.098041629463068,-4.974330518493649,-4.859661715472527,64.78163340404636,35,35,35,36,1,1,1,30.857078515168773,3,105.82010582010582,-0.8816811050619345,-0.7501682898401294,-0.6241583496187509,1.6001722417677244,2854,2835,Lincoln and Nearby Counties,Perkins,31,135,Nebraska,NE
31005,31CS012,6,6,6,8,2,2,2,511.274333724719,8,2196.796338672769,-17.392905701838487,-16.85556846465477,-16.310244829357533,2.7953548344039367,8,7,8,6,-2,-2,-1,-345.70724200418,6,1369.86301369863,-17.677574309793567,-17.157235179553705,-16.608855078239355,-11.668663175428147,437,438,Northwest Nebraska,Arthur,31,5,Nebraska,NE
31009,31CS012,6,6,6,4,-2,-2,-2,-592.2901897797536,4,1095.890410958904,-17.392498414209136,-16.878159597715175,-16.405287393394886,-3.4427579737248353,8,8,8,3,-5,-5,-5,-1058.048471044154,3,656.4551422319474,-17.678818077434638,-17.142628029338262,-16.668286263871405,-0.7822111597513741,438,457,Northwest Nebraska,Blaine,31,9,Nebraska,NE
31013,31CS012,98,97,99,112,13,14,15,153.6941577960866,5,55.576139310855865,0.8666900797972867,0.9800178463012037,1.1048877622270723,0.3372146500569837,117,116,119,130,11,13,14,117.92395137567675,15,141.03046257991727,-0.35795617203745694,-0.2356631305759319,-0.1025890618420623,1.1076330229482112,10796,10636,Northwest Nebraska,Box Butte,31,13,Nebraska,NE
31017,31CS012,30,30,30,40,10,10,10,406.7105254494687,7,288.36251287332647,1.0705179713635,1.1856655348057927,1.3039120597395897,0.6438025995090686,37,36,37,50,13,13,14,463.5564348919414,4,137.59889920880633,3.1361048602905526,3.2596814632429982,3.3838558567893715,0.27632733631274486,2913,2907,Northwest Nebraska,Brown,31,17,Nebraska,NE
31031,31CS012,52,51,52,70,18,18,19,402.4662406140111,10,217.98365122615803,1.7170125147287203,1.8428371880634007,1.9658756047481942,0.5137917428857521,62,61,63,79,16,17,18,310.2258996928291,10,183.18373328448433,1.147580264029541,1.2688154650769574,1.3872791628964727,0.5575617909876665,5505,5459,Northwest Nebraska,Cherry,31,31,Nebraska,NE
31041,31CS012,100,99,101,126,25,26,27,297.3219725091321,15,170.85904129093498,1.1313847632606646,1.2613290655191798,1.38407538834484,0.5534566939685117,121,119,122,144,22,23,25,224.42916126191744,14,133.7792642140468,0.780552337324437,0.9027355310087752,1.0443219907191255,0.571743340032405,10535,10465,Northwest Nebraska,Custer,31,41,Nebraska,NE
31045,31CS012,70,70,71,90,19,20,20,285.03821597129104,16,233.8611449451888,0.3933428129343888,0.5098951784406024,0.6428009405871381,0.7804358541425077,85,84,86,107,21,22,23,270.4593854347983,4,49.09180166912125,2.0866484132687475,2.2107581329988863,2.340407479543396,0.17363348808749401,8210,8148,Northwest Nebraska,Dawes,31,45,Nebraska,NE
31069,31CS012,26,26,27,24,-3,-2,-2,-155.56243381867503,2,128.34224598930481,-3.3316656168570713,-2.841265977442588,-2.316229748538242,-1.4043156272966981,32,31,33,36,3,4,5,227.14168230053843,6,323.97408207343415,-1.5186595511764929,-0.974478967438296,-0.4620747514755891,1.1523693578972825,1870,1852,Northwest Nebraska,Garden,31,69,Nebraska,NE
31075,31CS012,9,9,9,14,5,5,5,980.3843901202847,4,785.5973813420621,1.8247287297090429,1.947183670970732,2.071856762246793,0.667580080920968,10,10,11,7,-4,-3,-3,-593.0719679811766,7,1198.6301369863013,-18.046784362259164,-17.91665050178303,-17.788396929324925,-2.8414392165053917,611,584,Northwest Nebraska,Grant,31,75,Nebraska,NE
31091,31CS012,13,13,13,10,-3,-3,-3,-522.4722034570899,2,340.90909090909093,-8.756678428911627,-8.634450085844845,-8.511678461156823,-0.9684431537994802,16,16,17,15,-2,-1,-1,-200.5377903659875,7,958.9041095890411,-11.717463968458798,-11.598364799131211,-11.464620347529987,-15.088617508985786,704,730,Northwest Nebraska,Hooker,31,91,Nebraska,NE
31103,31CS012,11,11,11,6,-5,-5,-5,-753.8164813561227,6,936.2808842652795,-17.45766706515471,-16.92525216210371,-16.380513385138446,-1.5662903881951888,13,13,14,3,-11,-10,-10,-1332.39454520402,3,382.65306122448976,-17.672525114791252,-17.158543111837727,-16.614198232679676,-0.3175956490195063,769,784,Northwest Nebraska,Keya Paha,31,103,Nebraska,NE
31115,31CS012,10,10,10,8,-2,-2,-2,-400.97398030798746,8,1563.5179153094462,-19.767131514176537,-19.642468084237134,-19.522603945816925,-7.607092173578344,12,12,12,1,-11,-11,-11,-1826.3970119563694,1,165.56291390728478,-20.052464660909116,-19.92243377310368,-19.796716799357053,-0.09968660572525871,614,604,Northwest Nebraska,Loup,31,115,Nebraska,NE
31149,31CS012,18,17,19,15,-4,-3,-2,-279.85753616640994,6,561.6224648985959,-8.956389689304729,-8.42025827442194,-7.895001641882121,-3.0153612381132535,22,21,22,24,2,2,3,181.78113143773368,3,237.34177215189874,-1.0441973867699808,-0.5561516897730577,-0.08278976450767621,0.9097212352592167,1282,1264,Northwest Nebraska,Rock,31,149,Nebraska,NE
31161,31CS012,62,62,63,86,23,24,24,553.4359703657942,16,375.2931978107897,1.6601235225584643,1.781264941500449,1.9068919383456653,0.6505434830492529,76,75,76,71,-5,-5,-4,-88.45520747303354,13,255.15210991167814,-3.5608826740765984,-3.437623996977248,-3.3087887294386493,-3.707090970151968,5116,5095,Northwest Nebraska,Sheridan,31,161,Nebraska,NE
31165,31CS012,9,9,9,10,1,1,1,143.2566572066408,6,628.2722513089005,-4.969512405085372,-4.85066253253358,-4.735127576620343,2.5336756357187515,10,10,11,13,2,3,3,222.8026447867582,8,699.912510936133,-4.898072282615678,-4.77003288330638,-4.641732742599241,2.25565972733451,1146,1143,Northwest Nebraska,Sioux,31,165,Nebraska,NE
31171,31CS012,10,9,10,7,-3,-3,-2,-447.2556815900036,7,1237.1134020618558,-17.340988911434962,-16.841163352871057,-16.31350048662935,-4.573006220009101,12,11,12,6,-6,-6,-5,-824.0495587078261,6,891.5304606240712,-17.67812823378444,-17.172977126832468,-16.65027923839175,-1.3198841450272523,679,673,Northwest Nebraska,Thomas,31,171,Nebraska,NE
31059,31CS013,69,68,69,71,2,2,3,52.95767876623462,13,280.92922744462453,-2.4022732194642127,-2.2802093526645724,-2.1554368815916294,3.76744262369227,84,83,85,82,-3,-2,-1,-37.91266993027085,2,36.04253018561903,-0.8629990034150119,-0.7429336051866955,-0.623502599143716,-1.8119650411890664,5553,5549,Saline and Nearby Counties,Fillmore,31,59,Nebraska,NE
31067,31CS013,234,225,243,252,9,18,27,100.77485341962257,25,138.63216266173754,-0.9032260351982858,-0.3757827971238191,0.15466454994571585,1.3039125301951915,286,274,297,330,33,44,56,205.1525323338355,30,138.74115525135272,0.16074279180877143,0.6399764717989722,1.1808920819183406,0.6613737357728307,21640,21623,Saline and Nearby Counties,Gage,31,67,Nebraska,NE
31095,31CS013,91,90,92,96,4,5,6,82.6331688843138,3,49.889135254988915,0.21164835619924802,0.33018200107838375,0.4529774849893091,0.5025960856198155,111,110,112,123,11,12,13,162.71141698440402,10,139.12075681691707,0.10554033770193216,0.23437274321045576,0.3640441690990789,0.7876684732982998,7216,7188,Saline and Nearby Counties,Jefferson,31,95,Nebraska,NE
31129,31CS013,52,51,52,70,18,18,19,536.1186868458018,12,352.1643433602348,1.7180824665519479,1.8386441792217536,1.9727492093310506,0.6227863754291089,63,63,64,62,-2,-1,-1,-26.881709855291522,5,123.06177701206006,-1.6294128769330412,-1.4966612821677425,-1.384913936528509,-54.227657938543274,4089,4063,Saline and Nearby Counties,Nuckolls,31,129,Nebraska,NE
31151,31CS013,125,124,127,102,-25,-23,-22,-195.29424548775742,2,16.859852476290833,-2.2472244219116093,-2.116311663972044,-2.0050624129870456,-0.09022510313362479,154,152,156,133,-23,-21,-19,-146.96289919247204,8,56.33802816901409,-2.1490706278888205,-2.030690872370105,-1.9037494671301936,-0.40264271150766784,14235,14200,Saline and Nearby Counties,Saline,31,151,Nebraska,NE
31169,31CS013,67,66,67,65,-2,-2,-1,-46.7198841348982,3,72.04322593556134,-1.3083464560818578,-1.1874413802970734,-1.060261662802537,-3.1729450443884097,81,80,82,95,13,14,15,284.3729873712572,8,162.33766233766235,1.085451942046411,1.2165192577142583,1.3467023619596528,0.5328395396479789,4997,4928,Saline and Nearby Counties,Thayer,31,169,Nebraska,NE
31153,31CS014,916,834,998,1136,138,220,302,138.57629062930468,116,72.97968941689648,0.11215151206092462,0.6635179840675228,1.1373662208488775,0.5242589428826425,1155,1055,1254,1298,44,143,243,74.2967902403145,105,54.38104017981997,-0.34245731193984036,0.18688012167343762,0.7162372972842429,0.7268763573442995,190738,193082,Sarpy,Sarpy,31,153,Nebraska,NE
31001,31CS015,265,252,278,337,59,72,85,277.58714577837287,47,181.01290198343924,0.4424037143008308,0.9635080888585529,1.4838069670418803,0.6431703984990845,323,307,339,364,25,41,57,131.733750642803,32,103.07950006442469,-0.2347207809871801,0.27558410919409726,0.8144971418946467,0.7638065392641028,31158,31044,South Central Nebraska,Adams,31,1,Nebraska,NE
31035,31CS015,58,57,59,74,15,16,17,311.70529390926936,12,235.44800523217788,0.6367794696085731,0.7631849657267473,0.8882885810317159,0.7106234733706402,70,70,71,83,12,13,13,207.78221244615457,11,180.8913007728992,0.15300381206131694,0.27073892312826264,0.39618941925702655,0.8067333580906021,6116,6081,South Central Nebraska,Clay,31,35,Nebraska,NE
31061,31CS015,32,32,33,40,7,8,8,319.55254830538405,6,248.6187845303867,0.593379509745977,0.7075719177249669,0.8247197599057529,0.6887156561407554,39,39,40,65,25,26,26,883.6352751760363,7,241.3793103448276,6.2801231596113665,6.422247743415395,6.544971604713529,0.2629066214358553,2896,2900,South Central Nebraska,Franklin,31,61,Nebraska,NE
31065,31CS015,52,52,52,57,5,5,5,129.794016975844,7,181.6216216216216,-0.6339154380770637,-0.5214032962365932,-0.3971192685672024,1.1661850832263843,63,62,64,79,15,16,17,346.4458308911667,10,217.10811984368218,1.1792098376398155,1.2928860533717994,1.4226267034246591,0.5897166981639425,4625,4606,South Central Nebraska,Furnas,31,65,Nebraska,NE
31083,31CS015,32,32,32,37,5,5,5,197.04239196572144,3,115.97938144329898,0.6921605875407385,0.8121235592405399,0.9232783436172707,0.49205899834749917,39,38,39,62,23,23,24,757.8911008041829,2,64.80881399870383,6.812875189337185,6.928736373526792,7.062375341746751,0.08200579828528534,3104,3086,South Central Nebraska,Harlan,31,83,Nebraska,NE
31137,31CS015,94,93,95,98,3,4,5,54.5196914769199,12,160.5709188224799,-1.1813014638979225,-1.0606854236568133,-0.9398795265808405,2.364793765620897,114,113,115,141,26,27,28,301.72128367877775,11,123.01498546186535,1.653331756119226,1.787874334583633,1.9238049713165237,0.3931391192710621,8968,8942,South Central Nebraska,Phelps,31,137,Nebraska,NE
31181,31CS015,48,48,48,54,6,6,6,209.73637131931284,7,246.9861805351367,-0.49032494561273815,-0.3732728011286084,-0.25157391358622305,1.008024113319417,59,58,59,63,4,4,5,128.8431329656881,7,205.39906103286387,-0.8884784157898445,-0.76503401302536,-0.6505022478380583,1.2984666661431514,3401,3408,South Central Nebraska,Webster,31,181,Nebraska,NE
31025,31CS016,202,190,213,266,53,64,76,289.70597417017234,17,76.75521107683046,1.5949847762701028,2.133081849675118,2.6708323222297317,0.26087605771206956,250,236,264,267,3,17,31,62.59862836469426,22,81.61751066592468,-0.680019992711376,-0.1776033471888755,0.30195928735976335,1.230875256421733,26578,26955,Southeast Nebraska,Cass,31,25,Nebraska,NE
31097,31CS016,59,58,59,51,-8,-8,-7,-175.8763449340708,4,91.32420091324201,-2.795588979589112,-2.6725219455701477,-2.5521587857430705,-0.5967135486838641,73,72,73,67,-6,-6,-5,-108.50505647930034,6,112.95180722891565,-2.3386454342831526,-2.2142003687508436,-2.087961528110217,-1.2595017335094896,5256,5312,Southeast Nebraska,Johnson,31,97,Nebraska,NE
31127,31CS016,72,71,72,81,9,9,10,159.95428965838107,14,237.82559456398639,-0.8902841542809345,-0.7817264592540334,-0.6614620972344238,1.3440891376832147,88,87,89,90,1,2,3,29.53180960916931,10,141.48273910582907,-1.245201806531008,-1.1202988271044536,-0.986944952463551,3.239067504114325,7064,7068,Southeast Nebraska,Nemaha,31,127,Nebraska,NE
31131,31CS016,153,146,160,148,-12,-5,2,-39.43547554997436,4,30.16780843441644,-1.2185391478272278,-0.697262923321629,-0.19632909568285292,-0.9458913653699569,187,179,195,193,-2,6,14,38.01569032281408,14,87.91760864104496,-0.983556561482415,-0.5041408707784631,0.026855471795370692,1.9847968736047648,15911,15924,Southeast Nebraska,Otoe,31,131,Nebraska,NE
31133,31CS016,34,33,35,43,8,9,10,439.57052340764074,4,188.08777429467082,2.0456605196671247,2.498900227640288,3.0227505044519325,0.3865406619660963,41,40,42,41,-1,0,1,6.371976845799001,6,235.6637863315004,-2.8010866446211464,-2.2848275100598516,-1.7550580862666312,5.162486995974466,2552,2546,Southeast Nebraska,Pawnee,31,133,Nebraska,NE
31147,31CS016,98,97,98,129,31,31,32,482.4948810206336,18,275.8268420380539,1.9458200283994413,2.066049078475016,2.1850670981985587,0.5540709911273348,119,118,120,131,11,12,13,159.87553326837582,12,154.44015444015443,-0.06984416448161072,0.05996730486722373,0.17704385685074167,0.8940326271360446,7831,7770,Southeast Nebraska,Richardson,31,147,Nebraska,NE
31003,31CS017,62,61,63,75,12,13,14,250.5571486904089,10,191.0219675262655,0.4821945437955659,0.5957870845110068,0.7141384379383222,0.708382523188384,75,75,76,83,7,8,8,120.96019697570222,7,111.48272017837235,-0.03682770927752585,0.08793263620679666,0.22261301444951237,0.8144183917145367,6282,6279,Wheeler and Nearby Counties,Antelope,31,3,Nebraska,NE
31011,31CS017,56,56,57,62,5,6,6,126.54072329062551,5,112.59148057796958,0.023706739853039206,0.1383613703651425,0.2636481943682092,0.7553483246198771,69,69,70,82,12,13,13,234.21380732811724,5,92.9195316855603,1.2805261728372266,1.415419510769337,1.5457907570406404,0.36756476290212897,5329,5381,Wheeler and Nearby Counties,Boone,31,11,Nebraska,NE
31015,31CS017,26,26,27,33,6,7,7,435.76854889903615,6,396.2575674188222,-0.12536922138214765,0.4076618041001967,0.876103996021357,0.7896542541115237,32,31,33,38,5,6,7,347.6956516332444,2,111.66945840312674,1.826984979653319,2.3530841780917098,2.818659659312271,0.2767312294358342,1817,1791,Wheeler and Nearby Counties,Boyd,31,15,Nebraska,NE
31071,31CS017,27,26,27,23,-4,-4,-3,-234.87527248005756,1,65.46644844517185,-3.4873228804803293,-3.023065254768544,-2.4873176763055307,-0.3864406049574524,33,32,33,40,7,7,8,407.4748122055891,4,218.10250817884406,1.3900790166074726,1.902699725750703,2.37548528992241,0.47208290219975674,1833,1834,Wheeler and Nearby Counties,Garfield,31,71,Nebraska,NE
31077,31CS017,23,23,23,27,4,4,4,208.4740181075882,7,380.77969174977335,-1.8419375980417132,-1.7284410818565723,-1.5968234818449862,1.44854138483629,28,28,28,28,-0,0,0,9.869886038067044,5,230.30861354214645,-2.339980295067217,-2.204984038455846,-2.080958842851988,4.117682625328982,2206,2171,Wheeler and Nearby Counties,Greeley,31,77,Nebraska,NE
31089,31CS017,105,104,106,112,6,7,8,78.41156001222281,17,202.38095238095235,-1.3584943744267146,-1.2424294235273203,-1.125993591481926,2.2408015305026834,128,127,129,125,-4,-3,-2,-31.608648334293104,5,49.731450169086926,-0.9395528006603086,-0.8105890352749631,-0.6831282233990561,-2.295754205487165,10080,10054,Wheeler and Nearby Counties,Holt,31,89,Nebraska,NE
31107,31CS017,89,88,90,104,14,15,16,213.13139301101316,12,171.8787300071616,0.29146243433201,0.4179841737685657,0.5435354460065114,0.7556616331669042,109,108,110,122,12,13,14,155.98865632027093,12,142.89116456299118,0.0035744181049139354,0.13214853675811544,0.2646767005665244,0.8510682144317427,8378,8398,Wheeler and Nearby Counties,Knox,31,107,Nebraska,NE
31119,31CS017,320,305,336,327,-9,7,22,22.425388310918844,41,138.99090344087236,-1.6669635478999973,-1.1483406387072492,-0.6619647911559602,5.38402843796261,392,374,411,357,-54,-35,-17,-100.09735877055809,24,67.8790621376248,-2.2211784438398134,-1.6722228836568422,-1.100199442476399,-0.6978484112724256,35398,35357,Wheeler and Nearby Counties,Madison,31,119,Nebraska,NE
31139,31CS017,62,62,63,64,1,2,2,27.313321397391913,17,279.52863798300905,-2.6443883789013527,-2.520154296517043,-2.398205324910921,6.388323256241649,76,75,77,82,5,6,7,79.18859701565783,4,54.682159945317835,0.1241202809460792,0.2488832324323619,0.3631517814089961,0.5888721531425344,7298,7315,Wheeler and Nearby Counties,Pierce,31,139,Nebraska,NE
31175,31CS017,44,43,44,41,-3,-3,-2,-83.22822681117407,6,177.33990147783254,-2.732580405049969,-2.6028722731991367,-2.485192531657228,-3.304167919559725,53,53,54,73,19,20,20,481.0351334149479,4,98.44942160964804,3.7000806721712114,3.8280076696735836,3.9561191192847254,0.1946997143007824,4060,4063,Wheeler and Nearby Counties,Valley,31,175,Nebraska,NE
31183,31CS017,11,11,12,6,-6,-5,-5,-822.1497758503407,6,927.8350515463918,-18.03957551396649,-17.492596712744483,-16.985283479563467,-1.3899929839656027,14,14,14,5,-9,-9,-9,-1141.5250162302198,5,631.3131313131313,-18.20952780984991,-17.72666195387893,-17.223353565071502,-0.621822631815685,776,792,Wheeler and Nearby Counties,Wheeler,31,183,Nebraska,NE
31023,31CS018,94,94,95,90,-5,-4,-4,-63.74362413089732,11,158.90213073311665,-2.351427246795197,-2.221152942488753,-2.1080296622162114,-3.2232992914774625,117,116,118,109,-9,-8,-7,-97.67128302810612,6,71.17437722419929,-1.815536184942968,-1.688818858607308,-1.5585043687053795,-0.8294522847047581,8307,8430,York and Nearby Counties,Butler,31,23,Nebraska,NE
31081,31CS018,72,71,73,101,28,29,30,365.4176843473738,20,255.7544757033248,0.9742160063619146,1.0968643123511936,1.2147620479225993,0.6762316725351983,89,88,90,112,22,23,24,246.05724299654395,1,10.651896037494673,2.2282247276662432,2.3537973365457456,2.4841205235529187,0.04149402735553671,9384,9388,York and Nearby Counties,Hamilton,31,81,Nebraska,NE
31143,31CS018,50,50,51,90,39,40,40,910.2018739048995,10,230.37051257439046,6.679429862849904,6.796972194929013,6.9166078132702875,0.24685051851466344,62,61,62,63,1,1,2,28.833944071296735,3,57.90387955993051,-0.41910893646128,-0.2897401940635645,-0.1655247374538886,1.2029416049129138,5209,5181,York and Nearby Counties,Polk,31,143,Nebraska,NE
31159,31CS018,156,149,164,155,-9,-1,6,-10.116260113175242,23,157.14855093093433,-2.2029717364395727,-1.6574815450501197,-1.16184264932735,-47.85694820128887,190,181,200,177,-23,-13,-4,-76.38052495960395,19,107.93614724762826,-2.340410996822991,-1.8430122880887096,-1.3559976465447359,-1.526685194636922,17563,17603,York and Nearby Counties,Seward,31,159,Nebraska,NE
31185,31CS018,145,139,151,137,-14,-8,-2,-70.24906531640632,10,85.5188141391106,-2.035484041986861,-1.5552028485125817,-1.0465140360900795,-1.3861056328642565,178,171,185,179,-6,1,8,6.02785721907649,11,77.35039729976795,-1.1991199852053631,-0.7240707589783223,-0.20880197641384488,5.922825874591958,14032,14221,York and Nearby Counties,York,31,185,Nebraska,NE
32005,32CS001,451,429,472,522,50,71,93,173.0541708089693,43,104.36682105944459,0.19369201929871688,0.6831040452130814,1.2408592566128547,0.5947460919337829,555,530,581,660,79,105,130,210.1780383581861,53,106.40220031719902,0.5712883297857818,1.0302103490033103,1.591277615820059,0.5014580949699651,49441,49811,Carson City (city)+Douglas,Douglas,32,5,Nevada,NV
32510,32CS001,708,683,734,786,52,78,103,159.70311058369103,68,139.9560922063666,-0.3000954155123469,0.19770910197067543,0.744421497676248,0.8652013938675687,870,839,900,985,85,115,146,195.60587122662622,110,186.6083091590751,-0.4344317330210783,0.08537309004498864,0.6002304236615715,0.9457989051420597,58304,58947,Carson City (city)+Douglas,Carson City (city),32,510,Nevada,NV
32003,32CS002,15108,14130,16087,18083,1996,2975,3953,156.8603491234394,2428,128.02874143300264,-0.24709302980546738,0.27925704414326513,0.8147091555226406,0.8159214136062567,18894,17712,20076,22834,2758,3940,5122,172.06139710594803,3895,170.11021569713307,-0.5071009669289708,0.022705267326806316,0.5804475746366332,0.9884090840998091,2275739,2289692,Clark+Nye,Clark,32,3,Nevada,NV
32023,32CS002,753,731,776,783,7,30,52,69.11604047637485,66,154.16058394160584,-1.3969233886062318,-0.8648476339092332,-0.3267755337547014,2.1575463327041904,946,918,973,1088,115,142,170,267.31006602146647,187,351.2792576173122,-1.3471592936549612,-0.8517661803944239,-0.3053301294544948,1.3049560926771928,51375,53234,Clark+Nye,Nye,32,23,Nevada,NV
32001,32CS003,252,241,263,325,62,73,84,345.31356811294876,46,216.5810020794915,0.7631307797161893,1.2888816162407004,1.796250231803848,0.6187642331614203,310,296,323,388,65,78,92,304.95384059442864,50,194.58281444582815,0.6115306122509688,1.0829607589073655,1.616208120534368,0.6300328688921261,25487,25696,Lyon and Nearby Counties,Churchill,32,1,Nevada,NV
32009,32CS003,9,9,9,6,-3,-3,-3,-458.8982858524388,6,957.4468085106382,-14.683200877518125,-14.16401093640953,-13.651344844644024,-3.198699039896892,11,10,11,12,1,1,2,165.1571608848595,8,1079.6221322537112,-9.625751325604389,-9.154636953148893,-8.654656311206947,3.5974222563958063,752,741,Lyon and Nearby Counties,Esmeralda,32,9,Nevada,NV
32019,32CS003,576,550,601,699,98,123,149,249.37294539273972,61,123.43389035967826,0.7930622257015364,1.2658608236852733,1.770691870242434,0.49099296939069825,718,687,750,893,143,175,206,287.77864770993006,108,177.95939889269707,0.6090629463108084,1.1066474261948702,1.5992624985902995,0.6148692263156856,59303,60688,Lyon and Nearby Counties,Lyon,32,19,Nevada,NV
32021,32CS003,63,62,63,78,15,15,16,403.4264861684913,2,52.73566249176005,3.3878481846585133,3.5117331172372785,3.6289333743558116,0.1226997667372991,77,77,78,87,9,10,10,211.7093652375962,14,305.61012879284,-1.068478348682988,-0.9399692289405185,-0.8102731946905014,1.3086061579472779,4551,4581,Lyon and Nearby Counties,Mineral,32,21,Nevada,NV
32029,32CS003,33,33,34,36,2,3,3,73.79421976692707,5,145.52510308028135,-0.8394726986922636,-0.7159006726369305,-0.5871254211660988,1.4142485652823842,41,41,42,48,6,7,7,161.09825486703312,1,24.16626389560174,1.2455382013482705,1.369605586392101,1.502629880483027,0.13044194353568644,4123,4138,Lyon and Nearby Counties,Storey,32,29,Nevada,NV
32007,32CS004,283,260,306,340,34,57,80,128.09403865325152,42,93.95973154362417,-0.1774626894774657,0.33891455756235467,0.8769561292947239,0.7209305943734425,354,326,382,505,123,151,179,280.455425464276,101,187.41533836818763,0.4153226821401841,0.9406616750261918,1.4762875571945075,0.6638612139913707,53640,53891,"Northern Nevada, excluding Washoe",Elko,32,7,Nevada,NV
32011,32CS004,12,12,13,11,-2,-1,-1,-92.19511481044387,6,381.55802861685214,-4.8661438294131925,-4.737708478905856,-4.615204577396173,-13.340205602674898,15,15,16,28,12,13,13,662.2494312038526,1,52.770448548812666,5.961605305749634,6.097958817530321,6.217882621962445,0.07380277114402281,1887,1895,"Northern Nevada, excluding Washoe",Eureka,32,11,Nevada,NV
32013,32CS004,130,123,138,124,-14,-6,1,-45.061411676215435,10,69.51283091003882,-1.6346187123319031,-1.147213339687989,-0.6445138717527507,-1.823998855176073,164,155,173,207,34,43,52,246.5341963846963,36,204.60358056265983,-0.11824687745390564,0.42394889433689853,0.942533106965218,0.8112183959122817,17263,17595,"Northern Nevada, excluding Washoe",Humboldt,32,13,Nevada,NV
32015,32CS004,43,43,44,55,11,12,12,243.2792429674547,4,84.18098912662222,1.4643070305677264,1.5946161592234662,1.723355500581811,0.31847593481514563,54,54,55,70,15,16,16,270.2222389881141,12,207.3613271124935,0.5009847341086029,0.6249782085261615,0.7475504546958585,0.721250895565988,5702,5787,"Northern Nevada, excluding Washoe",Lander,32,15,Nevada,NV
32017,32CS004,40,39,40,51,11,11,12,299.2543278756746,3,78.20986313273953,2.0884969032745806,2.2066120802082474,2.3282765278860795,0.24040585778302173,48,47,48,63,15,15,16,336.26843750765096,1,22.114108801415306,3.011145254348602,3.1404358447000584,3.2646254482128074,0.06170531748592542,4603,4522,"Northern Nevada, excluding Washoe",Lincoln,32,17,Nevada,NV
32027,32CS004,47,46,48,54,6,7,8,125.31963540655823,11,198.55595667870034,-0.8429502515702165,-0.7313305561087363,-0.6176365622326516,1.3849181255151193,59,58,60,86,26,27,28,404.93956839765895,19,282.4858757062147,1.1008585667670963,1.2246856269757296,1.3425998837834097,0.6728942350402636,6648,6726,"Northern Nevada, excluding Washoe",Pershing,32,27,Nevada,NV
32033,32CS004,74,73,75,79,4,5,6,60.8421904382752,0,0,0.48679503913767047,0.6055317949827185,0.7269860373116906,0,92,91,93,105,12,13,14,143.9843036858994,18,196.35649612741355,-0.6505901733459782,-0.5231109053912624,-0.39631108393287123,1.2676912369848607,9148,9167,"Northern Nevada, excluding Washoe",White Pine,32,33,Nevada,NV
32031,32CS005,3511,3302,3720,3998,278,487,696,120.31601889496278,441,108.92811197447641,-0.3651705652033451,0.11378444157060211,0.6149450941448295,0.9034952068613034,4362,4108,4617,4849,232,487,741,98.82297285039377,522,105.98640450259485,-0.5566692972336027,-0.06739778865429054,0.461699935977315,1.070288527496892,485825,492516,Washoe,Washoe,32,31,Nevada,NV
33001,33CS001,660,632,687,697,10,37,65,70.64656410359355,44,83.18104480433549,-0.6536475169800732,-0.11385392237024501,0.39845004364668785,1.146738853120465,818,785,851,823,-28,5,38,7.612699234167569,80,124.3104653873048,-1.7063562680449977,-1.165977965214654,-0.6333122705473038,13.56126981805417,63476,64355,Belknap+Carroll,Belknap,33,1,New Hampshire,NH
33003,33CS001,505,483,526,489,-37,-16,6,-37.202858946664996,3,7.181042048990665,-0.9500349231244347,-0.4366627243263391,0.0480555961749308,-0.2062973734857119,632,606,659,611,-48,-21,5,-41.325246218420105,36,70.15902712815715,-1.6208879421006643,-1.115907162086818,-0.5992813720267013,-1.7817539187413287,50132,51312,Belknap+Carroll,Carroll,33,3,New Hampshire,NH
33005,33CS002,646,613,679,631,-48,-15,18,-23.627454404035586,6,9.412133809168987,-0.8585656473196014,-0.31743151979963663,0.19180802917996997,-0.4266845230547803,800,761,840,900,60,100,139,128.88866825953014,76,98.43539529582426,-0.18979029648521584,0.301352547619158,0.8143003478196682,0.7561258907792154,76497,77208,Cheshire,Cheshire,33,5,New Hampshire,NH
33007,33CS003,382,368,395,402,7,20,34,77.50840300499267,20,76.87133660036513,-0.4905091201337572,0.007093741369313653,0.5089097189997196,0.944922867341345,467,451,483,573,90,106,122,337.99416142910025,62,198.26042466103866,0.8724376777893282,1.3983151724516951,1.8705695227331967,0.5810818449262553,31221,31272,Coos+Grafton,Coos,33,7,New Hampshire,NH
33009,33CS003,744,704,783,734,-49,-10,30,-12.568570835951336,11,14.485596707818932,-0.7336851239494652,-0.27822200643398803,0.22583846049928402,-1.2874142358420373,925,877,972,935,-37,10,58,11.35257427712124,44,47.80322454478293,-0.8957561923301034,-0.3466965409242843,0.15725700556591,3.843008401679694,91125,92044,Coos+Grafton,Grafton,33,9,New Hampshire,NH
33011,33CS004,3003,2822,3185,3420,235,417,598,118.42022410354127,412,117.12198311396651,-0.5169122043376666,0.01468701577186917,0.503245325266115,0.9866684275872838,3712,3493,3931,3963,32,251,470,59.281456686731445,297,70.06716539389778,-0.6103404619021396,-0.11862834567343243,0.419618049646433,1.1772556781567214,422124,423879,Hillsborough,Hillsborough,33,11,New Hampshire,NH
33013,33CS005,1236,1170,1302,1280,-22,44,110,34.17345703134919,58,45.27683270340422,-0.6329624234208948,-0.10453711695362,0.382579785868885,1.2953228080541002,1530,1450,1610,1560,-50,30,110,19.617669603481218,101,65.14195787056744,-0.9341082746942889,-0.45227790442586036,0.061336087351626496,3.2148801701759333,153721,155046,Merrimack+Sullivan,Merrimack,33,13,New Hampshire,NH
33019,33CS005,390,371,408,405,-3,15,34,42.42773387771819,3,8.348987685243165,-0.20615962905594445,0.3307972492042858,0.8445376331693699,0.18466827956991486,481,459,504,518,14,37,59,84.60148042858926,45,103.54348826507133,-0.6884915125851004,-0.19553687196245845,0.34762198827336954,1.1914910573494812,43119,43460,Merrimack+Sullivan,Sullivan,33,19,New Hampshire,NH
33015,33CS006,2224,2089,2359,2461,102,237,372,90.5909300296748,183,69.937419385659,-0.30497417643265506,0.20092872033352566,0.7368489811543141,0.7687703075209946,2760,2597,2923,2970,47,210,373,66.33527448495238,256,80.86423652789185,-0.6709805859521552,-0.14759113287913492,0.399043286767093,1.2132459234658124,313995,316580,Rockingham,Rockingham,33,15,New Hampshire,NH
33017,33CS007,1001,945,1058,1019,-39,18,74,16.36487933358301,26,23.796630336127404,-0.5745902097730359,-0.0790668742533001,0.4201514798783361,1.3771091045326367,1243,1175,1312,1338,26,95,163,71.6623995303759,114,86.22645790787384,-0.6557795942970905,-0.16133055622951997,0.3625087634819829,1.1906644584608468,131111,132210,Strafford,Strafford,33,17,New Hampshire,NH
34001,34CS001,2421,2303,2538,2830,292,409,527,180.10428880582558,286,125.83643463435203,0.0253926671759837,0.5656206830269913,1.0412877098357516,0.6969837935915376,2988,2846,3130,3403,273,415,557,151.05479965145813,413,150.2621401258127,-0.5437807808911217,-9.023577763372472e-4,0.5003711624514092,0.9923622980237321,272735,274853,Atlantic,Atlantic,34,1,New Jersey,NJ
34003,34CS002,6316,5906,6726,8114,1388,1798,2208,226.79838337634217,1962,247.4692318930913,-0.728755819084285,-0.20626973586901973,0.29427055833800597,1.0905354692794988,7806,7313,8298,7617,-681,-189,304,-19.778071926332732,626,65.62133762702342,-1.3528123686694955,-0.8563090834007366,-0.3766911190543272,-3.3355623808491957,951391,953958,Bergen,Bergen,34,3,New Jersey,NJ
34005,34CS003,3622,3423,3820,4075,255,453,652,118.32878880506986,523,136.48730054825444,-0.668017174358814,-0.1860343568360441,0.28266374888493057,1.1509197922680912,4479,4240,4719,4560,-159,81,320,17.37052071550511,341,73.5043693066447,-1.0458252961030239,-0.5535029251554535,-0.015814186452460046,4.179691313438585,459823,463918,Burlington,Burlington,34,5,New Jersey,NJ
34007,34CS004,4264,4040,4489,5018,529,754,978,173.67737799195243,700,161.2816515241116,-0.36843324297963337,0.12212923321481603,0.6441024193513418,0.9273975620776843,5265,4995,5536,5644,108,379,649,72.30396632190657,516,98.5319503215655,-0.7369946641982709,-0.24967539057005003,0.26822993665398104,1.3591566238059265,520828,523688,Camden,Camden,34,7,New Jersey,NJ
34009,34CS005,1129,1088,1170,1224,54,95,136,120.12589867293373,112,141.88440221694376,-0.6861806158015288,-0.2313152995863156,0.3095911308126254,1.1688048336083545,1389,1340,1439,1434,-5,45,94,46.83616780013944,97,101.48991378588768,-1.0685375293586483,-0.5595297981186097,-0.02992918989020536,2.1195636810047764,94725,95576,Cape May,Cape May,34,9,New Jersey,NJ
34011,34CS006,1369,1303,1435,1630,195,261,327,204.8754595202767,180,141.06859460412625,0.1452959461266847,0.6431745292877894,1.1525667447445342,0.6859338774203552,1684,1604,1763,1922,159,238,318,155.14779681565733,239,155.5392134531658,-0.4912163186831745,-0.006401535897437051,0.5191117630609282,0.9983351899842542,153117,153659,Cumberland,Cumberland,34,11,New Jersey,NJ
34013,34CS007,5450,5081,5818,7733,1915,2283,2652,321.38768053753114,2055,289.2465046448344,-0.2109011215127206,0.33023907171004346,0.8220278985019498,0.8995985265159738,6727,6286,7169,6771,-398,44,485,5.0841246873115,721,84.23340012033343,-1.3247303440635183,-0.7967930669961103,-0.26872451202858466,16.195761801181018,852560,855955,Essex,Essex,34,13,New Jersey,NJ
34015,34CS008,2401,2271,2531,2802,271,401,531,159.87299862665435,343,136.6388697083975,-0.2968760178021946,0.24733447108448894,0.7592529601192699,0.8525470016916058,2978,2821,3135,3186,51,208,365,68.35714912329851,321,105.52129492051385,-0.9004981707417803,-0.35320317561684117,0.10215517843481454,1.5362881165854279,301232,304204,Gloucester,Gloucester,34,15,New Jersey,NJ
34017,34CS009,3422,3114,3730,5136,1406,1714,2022,288.2314275240238,1511,254.1414316970374,-0.20527502324924313,0.3414478701714586,0.8642471973538528,0.88121277753567,4200,3835,4564,4532,-32,332,697,47.13508765149912,635,90.01882598439485,-0.9475634304034695,-0.4317123626922585,0.06374402811873683,1.9040783550501095,713461,705408,Hudson,Hudson,34,17,New Jersey,NJ
34019,34CS010,793,738,848,925,77,132,187,123.29417226224066,144,134.55743219566892,-0.6237353970691665,-0.10966517265711295,0.4160353382143924,1.0831437641132486,989,922,1056,996,-60,7,74,5.7456962314025946,66,50.860780173543155,-0.9463529298365511,-0.453684487688788,0.04439159566112864,7.805145561273949,128421,129766,Hunterdon,Hunterdon,34,19,New Jersey,NJ
34021,34CS011,2595,2429,2760,3247,487,652,818,203.86220527867945,607,189.7171433036412,-0.35657690610422565,0.15522751967967813,0.6282379692992807,0.9291900172795569,3209,3009,3408,3441,33,232,432,60.161353645946136,296,76.67917020703376,-0.6895619487415394,-0.16887339109447436,0.33817070324444715,1.2690939482812178,383940,386024,Mercer,Mercer,34,21,New Jersey,NJ
34023,34CS012,5282,4913,5651,6749,1098,1467,1836,205.57507965761548,1445,202.49368520990328,-0.4978967868105205,0.030065143078416467,0.5194372137572568,0.9843398627255482,6552,6107,6996,6782,-214,230,675,26.738307913628958,741,86.06591650328467,-1.13112145059535,-0.5954674377618168,-0.08222673173133843,3.204902594388533,856323,860968,Middlesex,Middlesex,34,23,New Jersey,NJ
34025,34CS013,4894,4618,5170,5879,709,985,1261,184.64529303450522,937,175.69628481424073,-0.4203584809170671,0.08056017509774106,0.613253910819095,0.9505687438776818,6065,5732,6398,6325,-73,260,593,40.34054820172414,647,100.30479013509365,-1.0751154695308875,-0.5864052067206638,-0.10183359605938429,2.4769318808130785,639968,645034,Monmouth,Monmouth,34,25,New Jersey,NJ
34027,34CS014,3392,3173,3610,4288,678,896,1115,212.29509624181574,829,196.34236360837315,-0.3577979071059868,0.16786844941354612,0.643020948019173,0.9238252135066725,4213,3950,4477,4198,-279,-15,248,-3.0191146358035903,314,61.48520047308358,-1.15413646673561,-0.649544984537833,-0.14272877993273997,-21.77776332467846,506666,510692,Morris,Morris,34,27,New Jersey,NJ
34029,34CS015,6582,6308,6856,7343,487,761,1035,143.68233767353277,1136,214.5707247585843,-1.197828326166884,-0.7138477844523892,-0.18057503569883124,1.491408248508332,8164,7829,8498,8288,-210,124,459,19.22279807505381,891,137.60320240180135,-1.700592581911304,-1.2025303686578628,-0.6605603235258674,7.101281642126594,635315,647514,Ocean,Ocean,34,29,New Jersey,NJ
34031,34CS016,3297,3073,3521,4800,1279,1503,1727,347.1840224940554,1352,312.3123123123123,-0.13322284211501553,0.35804089630352814,0.8625259948795889,0.8989602978667862,4061,3793,4329,4216,-113,155,423,29.857292633806672,514,99.06638604281827,-1.194898824902569,-0.6916588378198607,-0.18598447300237392,3.296715178672328,519480,518844,Passaic,Passaic,34,31,New Jersey,NJ
34033,34CS017,651,623,679,789,110,138,166,256.20957748164676,94,174.85390088512037,0.2681920661587677,0.8050711914730909,1.330061686414312,0.6775451891495533,802,768,835,913,78,111,145,171.31429308161455,98,150.72517264184316,-0.29444092534803523,0.1993491675163358,0.6818509478736507,0.8719882132931729,64511,65019,Salem,Salem,34,33,New Jersey,NJ
34035,34CS018,2146,1998,2293,2624,331,478,626,167.4422830690682,525,183.7323923124034,-0.7315390491903008,-0.176985312270605,0.34685013748002397,1.09499927932535,2667,2489,2845,2637,-208,-30,148,-8.659642814176607,218,63.086918146170646,-1.2304024790920387,-0.7327927907425794,-0.15616034264180745,-7.537038130780302,342890,345555,Somerset,Somerset,34,35,New Jersey,NJ
34037,34CS019,1081,1019,1143,1321,178,240,302,200.08180346953998,217,181.15790791835371,-0.3156358923555808,0.18124329854352642,0.7478393283570901,0.9016570984178272,1347,1272,1422,1478,56,131,206,90.20509066825429,122,83.94687951558522,-0.45473616886562035,0.05069978010431476,0.5786958197903397,0.9235773207527614,143742,145330,Sussex,Sussex,34,37,New Jersey,NJ
34039,34CS020,3498,3251,3744,5073,1329,1575,1822,330.76586792807666,1389,291.6346623228242,-0.1379658375855454,0.39876985300447293,0.8593665733081316,0.8811358340197708,4322,4027,4618,4420,-198,98,393,17.08557942668384,480,83.85158269862343,-1.2056584352508672,-0.6543898289859211,-0.19892603315527016,4.858068941595289,571537,572440,Union,Union,34,39,New Jersey,NJ
34041,34CS021,901,854,948,1062,114,161,208,177.15451166537986,150,164.97113005224085,-0.4039588632247117,0.1189029329568221,0.6512358528738716,0.9254818104464166,1118,1061,1175,1190,15,72,129,65.33111909009799,106,95.87120698231809,-0.8341931203053904,-0.3038908770093646,0.21874909491198558,1.4474279459130885,109110,110565,Warren,Warren,34,41,New Jersey,NJ
35001,35CS001,4930,4639,5221,6092,871,1162,1453,206.0285138362408,602,106.74263558560688,0.47021339821962116,0.9901485061384732,1.512394626227512,0.5176509172563655,6064,5715,6412,7401,989,1337,1686,198.19104464469999,797,118.12447384958324,0.29958496536748735,0.7845970770950237,1.3292497331058195,0.5955677973900005,676768,674712,Bernalillo,Bernalillo,35,1,New Mexico,NM
35003,35CS002,37,36,39,38,-1,1,2,20.875160440046873,4,133.00083125519535,-1.6468775438056198,-1.1438149630887025,-0.6255942875643467,2.4572734661393345,47,45,49,73,24,26,28,705.1649001206051,10,269.25148088314484,3.8271535438705473,4.34355148653045,4.886273585513993,0.36778464827090157,3609,3714,Catron+Cibola+Sierra+Socorro,Catron,35,3,New Mexico,NM
35006,35CS002,220,208,232,321,89,101,113,448.1211885499678,69,306.32630410654826,0.8969010455093087,1.4283980278012929,1.9394334444133245,0.6768734093982943,271,257,285,396,111,125,139,460.3650925759685,85,312.8680800942285,0.9341052630690793,1.463431460506216,1.9751966940573644,0.6742179695248648,27030,27168,Catron+Cibola+Sierra+Socorro,Cibola,35,6,New Mexico,NM
35051,35CS002,219,214,224,264,40,45,50,475.70964133692456,42,440.9448818897638,-0.15843614642084053,0.362427227355404,0.8793373441044601,0.906905241207596,266,260,272,278,6,12,18,106.85606545102466,29,252.04241265426734,-1.9411706569710996,-1.449906723687619,-0.9739961362260228,2.1812943061831995,11430,11506,Catron+Cibola+Sierra+Socorro,Sierra,35,51,New Mexico,NM
35053,35CS002,150,143,157,194,37,44,51,316.4428561059794,48,348.1203916354405,-0.8327643025206248,-0.31746778612804905,0.2169089316335533,1.075456834007637,182,173,190,224,34,42,51,257.7142460487512,30,183.50868607780768,0.2337765308933473,0.7357399672052395,1.2604137275743417,0.6955533860736607,16546,16348,Catron+Cibola+Sierra+Socorro,Socorro,35,53,New Mexico,NM
35005,35CS003,570,542,598,734,136,164,192,303.5100983551051,106,195.6110538699309,0.5707913172375614,1.076833466040747,1.5687612746022432,0.6406010799178776,696,663,730,846,116,150,183,231.5377012506145,142,219.44736354082957,-0.3961499373405859,0.1252433662969075,0.6476984432600261,0.9414983695812785,65027,64708,Chaves,Chaves,35,5,New Mexico,NM
35009,35CS004,348,328,369,400,31,52,72,127.97141107303405,57,141.31647452584605,-0.644953638356777,-0.1388887717573212,0.40274046128903024,1.0832945429440544,427,402,452,560,108,133,158,277.084828513341,102,212.2921306220992,0.1360737062643887,0.654954914924871,1.1770853988578782,0.7604509015905004,48402,48047,Curry+Roosevelt,Curry,35,9,New Mexico,NM
35041,35CS004,145,137,154,162,8,17,25,104.91459966934481,40,252.39247029130297,-1.9973959047679044,-1.4768846753605858,-0.9448232716286294,2.269218304273082,179,169,189,220,31,41,51,216.4871044741472,47,246.93952608627123,-0.8072905596411446,-0.3182965772253215,0.16811369693067943,1.1136387658576832,19018,19033,Curry+Roosevelt,Roosevelt,35,41,New Mexico,NM
35013,35CS005,1391,1296,1486,1984,498,593,688,323.538805556704,329,179.52309063460595,0.903796634653234,1.4279528489831774,1.9811348256154253,0.5539391983063328,1732,1617,1846,2317,471,585,700,264.54774662866504,323,145.97352591594998,0.7053434410520665,1.2043518902208052,1.7323339246861298,0.5508441653259322,219916,221273,Do�a Ana,Do�a Ana,35,13,New Mexico,NM
35015,35CS006,530,504,557,534,-23,4,30,7.028106426873449,77,150.11453544100206,-1.9253580765839253,-1.4191559127592155,-0.8947534131398519,16.720924168705963,645,614,677,787,110,142,173,231.76453230828142,149,243.83458523573404,-0.651620580724589,-0.12694720836178375,0.4011430966475115,1.044702374588254,61553,61107,Eddy,Eddy,35,15,New Mexico,NM
35017,35CS007,303,291,315,374,59,71,83,304.2833523372932,23,98.60312243221034,1.5385600976803038,2.052965410329913,2.625156518216646,0.31954817498679056,370,356,385,426,41,56,70,199.91203863967445,58,207.61741122565866,-0.6063967914616809,-0.06575813206410963,0.3893394902615897,1.0202748469741914,27991,27936,Grant+Hidalgo+Luna,Grant,35,17,New Mexico,NM
35023,35CS007,45,45,46,47,1,2,2,49.27921491912333,6,173.5357917570499,-1.36457179659932,-1.2426024954431323,-1.122812450627904,2.2190753630969278,55,54,55,61,6,6,7,149.74701289551285,7,171.35862913096696,-0.3386905325597136,-0.21567395188827843,-0.08988514485244561,0.9835376208177359,4149,4085,Grant+Hidalgo+Luna,Hidalgo,35,23,New Mexico,NM
35029,35CS007,274,263,285,337,52,63,74,299.7782654099911,59,281.0416005080978,-0.3285051973055187,0.188177410968876,0.7316744290067868,0.9228345963122393,339,326,352,423,71,84,97,328.5455427357858,57,223.38924596331714,0.5021108776318344,1.0359471424513924,1.5661820202991645,0.6719187871806428,25192,25516,Grant+Hidalgo+Luna,Luna,35,29,New Mexico,NM
35011,35CS008,21,21,21,28,7,7,7,500.0472636188333,7,497.9253112033195,-0.0981020939210746,0.017075627711157542,0.14419562491315988,0.8717493432045922,26,25,26,38,12,12,13,738.6595544340748,6,357.1428571428571,3.6870245139151674,3.8143670278851776,3.9450985676132233,0.447444626472698,1687,1680,Guadalupe and Nearby Counties,De Baca,35,11,New Mexico,NM
35019,35CS008,42,42,42,55,13,13,13,352.29950109477426,5,135.65453312231517,2.0466910490532517,2.1679661158735204,2.2847609233671458,0.3575215121469492,52,51,52,59,7,7,8,158.77672746039363,4,89.90784445942909,0.559962879622819,0.6934539692623558,0.8051135458274238,0.49603318512385547,4423,4449,Guadalupe and Nearby Counties,Guadalupe,35,19,New Mexico,NM
35027,35CS008,205,197,214,208,-6,3,11,15.685635601796061,18,106.78267747676486,-1.4473692751199922,-0.9083604375652754,-0.3749029825477908,4.939524702128564,254,244,265,319,54,65,75,317.968307756018,40,195.92476489028212,0.7484242250984178,1.2278871076082762,1.7387700204547907,0.6068291670479209,20228,20416,Guadalupe and Nearby Counties,Lincoln,35,27,New Mexico,NM
35037,35CS008,104,103,105,140,35,36,37,494.8166092916126,10,138.8085598611914,3.4389921888533435,3.559986145456885,3.6814084183011997,0.27287055536124327,128,127,129,175,46,47,48,539.3292279568143,39,450.08655510675135,0.7691351244443048,0.8918994897940009,1.0166958909116623,0.8170469068471106,8645,8665,Guadalupe and Nearby Counties,Quay,35,37,New Mexico,NM
35057,35CS008,142,136,149,151,2,9,15,69.3163124089028,10,79.2864222001982,-0.5912508924780115,-0.1129941372899856,0.4153015188280931,1.0264284907808232,177,169,185,235,50,58,66,381.23457637061017,45,294.6954813359529,0.40038902373519836,0.863390880682805,1.3918229850527473,0.7599487447171455,15135,15270,Guadalupe and Nearby Counties,Torrance,35,57,New Mexico,NM
35025,35CS009,502,470,533,604,71,102,134,166.22668771160042,134,217.5442394068943,-1.01858715636694,-0.5068041814606151,-0.032598471003973735,1.2960622112954647,614,576,652,742,90,128,166,174.5694026617551,163,222.5711749846385,-0.960436982273564,-0.48851634029396407,0.055815983917773426,1.2650770992331326,73916,73235,Lea,Lea,35,25,New Mexico,NM
35028,35CS010,117,115,119,116,-3,-1,1,-7.814921167333377,5,30.915086562242372,-0.5102332529651321,-0.3848317428774004,-0.2725892883060468,-18.944183794714306,144,141,146,140,-6,-4,-1,-19.849309602045928,10,51.69561621174525,-0.8457443343209367,-0.7143793535652238,-0.5928415900801943,-3.521560198384042,19408,19344,Los Alamos+Santa Fe,Los Alamos,35,28,New Mexico,NM
35049,35CS010,1071,1005,1138,1215,77,144,210,111.66152064016079,87,67.61088768432708,-0.061808166377282134,0.4372036227938019,0.9560252119265862,0.6013135457125987,1324,1244,1404,1591,187,267,347,171.98028889754656,133,85.71354918539906,0.3619806026291981,0.8648069710281139,1.331329472378957,0.49653104989009744,154413,155168,Los Alamos+Santa Fe,Santa Fe,35,49,New Mexico,NM
35031,35CS011,569,562,577,1056,479,487,494,806.8450428421486,374,620.1207632680696,1.7467912893006965,1.8718378591214133,1.9906313107331417,0.76699860287536,696,687,705,1029,324,333,342,462.82896116491736,179,248.94303515798845,2.0115029584603277,2.1403454347312154,2.26121088402052,0.5362612418434378,72373,71904,McKinley,McKinley,35,31,New Mexico,NM
35007,35CS012,123,122,124,150,26,27,28,261.4787403404236,30,292.7543303244694,-0.4357111360309068,-0.31185339615628316,-0.20417345350560562,1.0793294978609573,152,151,154,178,24,26,27,207.59645243285144,32,258.81591717890655,-0.638447880353369,-0.5122178839450798,-0.382569007346779,1.1999748584808587,12297,12364,Northeast New Mexico,Colfax,35,7,New Mexico,NM
35021,35CS012,9,9,10,12,2,3,3,465.9494559463143,5,917.4311926605503,-4.641518451806192,-4.516950853666076,-4.3905402850075355,1.412659021456095,11,11,11,14,3,3,3,408.3611294359372,2,311.52647975077883,0.8443936512393445,0.9683289298444372,1.0948290103668834,0.552230140546995,654,642,Northeast New Mexico,Harding,35,21,New Mexico,NM
35033,35CS012,41,39,43,43,0,2,4,60.0959120404265,4,113.47517730496453,-1.0307274152223507,-0.5341194777127288,-0.004221823443913506,1.2827169383757828,50,48,52,56,4,6,8,148.6490398471613,8,190.74868860276584,-0.9335214591451471,-0.391713079877777,0.09314718589661296,1.1058367717612485,4230,4194,Northeast New Mexico,Mora,35,33,New Mexico,NM
35047,35CS012,243,232,255,264,9,21,32,90.69908229440838,10,44.19726713564877,-0.012872627889237943,0.4648936071111551,0.9744029428888535,0.4646532856813206,298,284,312,391,79,93,107,342.0990549922977,45,165.77638607478357,1.2612979320024928,1.7635421288254038,2.269552473575757,0.4794232169089106,27151,27145,Northeast New Mexico,San Miguel,35,47,New Mexico,NM
35059,35CS012,40,38,41,48,7,8,10,250.52323528960704,3,88.49557522123892,1.1056219888571912,1.6175883140167933,2.1243977593823957,0.3160310652515289,49,47,51,55,4,6,8,154.61232882108953,6,146.3057790782736,-0.42276271876844135,0.10592799248220512,0.5827524660778832,0.8173661308148288,4068,4101,Northeast New Mexico,Union,35,59,New Mexico,NM
35035,35CS013,542,512,571,640,69,98,128,173.92032992876014,45,79.54160467822474,0.46198775779480317,0.945640551481316,1.4495553539954582,0.45274372967909277,670,634,705,855,150,185,221,270.93198234424705,122,178.26353780063707,0.3906647222975097,0.898816295445518,1.4473723755888255,0.6544347094884844,67889,68438,Otero,Otero,35,35,New Mexico,NM
35039,35CS014,367,350,385,438,53,71,88,211.31781651410301,45,134.81799570579716,0.2711976975147223,0.7601744995624198,1.2944952702640031,0.6290682790185181,451,430,471,604,133,153,174,381.8298867474133,70,174.16834614714736,1.5373081235379986,2.086702750187753,2.61767976705966,0.45318809797602394,40054,40191,Rio Arriba+Taos,Rio Arriba,35,39,New Mexico,NM
35055,35CS014,282,267,296,344,48,62,77,218.71902870147406,44,154.48986160283232,0.14895477111331418,0.6580036839314717,1.1622187599146934,0.6951795393941221,349,331,367,425,58,76,94,220.3536207592042,36,104.07933157940386,0.6586527784548543,1.1634600884025996,1.687498932251288,0.46621185352822214,34177,34589,Rio Arriba+Taos,Taos,35,55,New Mexico,NM
35043,35CS015,1029,965,1093,1237,144,208,272,167.4184935295655,153,123.11818943839062,-0.041759775035421505,0.44743783105629537,0.9829106217231007,0.7318740728365458,1288,1210,1366,1557,191,269,347,178.12496745108893,177,117.17586309622322,0.11908485171944776,0.5994673733385607,1.1059356083699516,0.6553937228653218,149125,151055,Sandoval,Sandoval,35,43,New Mexico,NM
35045,35CS016,905,853,958,1336,378,431,483,424.38896018496644,327,322.2680310770191,0.516027372685008,0.9983286194646557,1.5576350609080405,0.7576101509592394,1115,1052,1177,1705,528,590,653,487.4720770049675,369,304.81508710772613,1.2742433337859675,1.8241390342627086,2.329345056454022,0.6242397129723433,121762,121057,San Juan,San Juan,35,45,New Mexico,NM
35061,35CS017,598,565,631,740,109,142,175,222.25318712392232,73,114.49483727617304,0.5720944422123081,1.0659441046541422,1.561371844950996,0.5115450536932493,743,703,783,961,178,218,258,283.0182593254748,142,184.262431225994,0.47377277374416144,0.999010664981773,1.518127393972245,0.6480905318323583,76510,77064,Valencia,Valencia,35,61,New Mexico,NM
36001,36CS001,2389,2255,2524,2634,110,245,379,93.76807578196501,209,80.15314748115217,-0.38004837555181353,0.15941934463535007,0.6947491535870046,0.8513202259734948,2939,2777,3101,3188,87,249,411,79.28152406853953,256,81.57178635839328,-0.5417423093558633,-0.01812304815060433,0.521599097714719,1.0247690758888848,312901,313834,Albany+Greene,Albany,36,1,New York,NY
36039,36CS001,449,428,469,461,-8,12,33,30.504442772464206,28,70.21356626405317,-0.8955216948258907,-0.37937458860553525,0.12316050251211767,2.1269058852817593,555,530,580,653,73,98,123,202.98880618597744,67,138.40115678578806,0.14755022144888363,0.6440294725755566,1.144490391792317,0.6749481727911597,47854,48410,Albany+Greene,Greene,36,39,New York,NY
36003,36CS002,418,398,438,474,36,56,76,144.8676180602978,69,178.91870867366782,-0.8609702038067801,-0.3320000187513682,0.18724050558605404,1.2133319457151517,512,488,536,562,26,50,74,107.67084013180553,81,175.53364394842345,-1.1711814848113207,-0.6630754509282599,-0.19770862106071324,1.598115118195162,46278,46145,Allegany+Steuben,Allegany,36,3,New York,NY
36101,36CS002,852,811,892,972,80,120,161,154.4721983119613,123,157.68219985898338,-0.5714317793150931,-0.02016149197628097,0.4799871417914958,1.0123786892797655,1041,993,1089,1267,178,226,274,242.63574669738634,145,155.89889150512317,0.35517074333762727,0.8761262157251846,1.3978328300713028,0.6396877783070655,93606,93009,Allegany+Steuben,Steuben,36,101,New York,NY
36005,36CS003,8329,7702,8955,14136,5181,5807,6434,478.9119266180804,4277,352.72287434367865,0.7741089655064299,1.2611904690142228,1.8162498121608042,0.7363820475992693,10144,9405,10882,11765,883,1621,2360,113.30056623402905,1456,101.74710115101408,-0.37456311144097565,0.09855129256059109,0.6348561329675485,0.8974746365417506,1455080,1430999,Bronx,Bronx,36,5,New York,NY
36007,36CS004,1842,1757,1927,2054,127,212,297,129.04276888891016,211,128.52074249661186,-0.527875134818346,0.027848638426460206,0.510409619961304,0.9912756412966989,2257,2155,2359,2511,152,254,356,128.54470272803488,298,150.9778093018543,-0.7418766134337011,-0.22580639340264647,0.30491367007771175,1.1699050136603169,197011,197380,Broome,Broome,36,7,New York,NY
36009,36CS005,722,689,755,789,34,67,100,105.02277487865844,53,82.85781286641131,-0.29956622926474424,0.22263837768781505,0.724616290615895,0.7773789421947692,880,841,920,1157,237,277,316,361.8520786178651,161,210.46852122986823,1.0014005082524609,1.5127924771153722,2.0435310815513166,0.5795486996158414,76758,76496,Cattaraugus+Wyoming,Cattaraugus,36,9,New York,NY
36121,36CS005,326,308,343,373,30,47,65,141.20591169747968,28,83.3106047457291,0.07257125620979285,0.5732393376821464,1.0828237099776707,0.5778184152216582,401,380,422,428,6,27,48,67.0331428233057,54,133.40580068185187,-1.1866541883195472,-0.6598205485972657,-0.15397284611085565,1.9194079316140849,40331,40478,Cattaraugus+Wyoming,Wyoming,36,121,New York,NY
36011,36CS006,644,611,676,759,83,115,148,181.69524764375092,29,45.71488623824286,0.8418364797966487,1.3681793477603799,1.899018798170298,0.2494378861393142,787,748,826,940,114,153,192,201.91501100763446,111,146.22386742369355,0.056036326206305345,0.5487438547975433,1.0132280743681372,0.7194911260666109,76124,75911,Cayuga,Cayuga,36,11,New York,NY
36013,36CS007,1279,1224,1333,1291,-42,12,67,11.563981365477781,41,38.665566426971594,-0.7801142424776168,-0.27783321340534334,0.28908332978180645,3.09150319985633,1559,1494,1625,1880,255,321,386,252.90100191861544,286,225.37963860453755,-0.2149125189681993,0.2962677325247684,0.784366623700706,0.888409039204421,127245,126897,Chautauqua,Chautauqua,36,13,New York,NY
36015,36CS008,864,828,900,942,42,78,114,112.46631105970116,100,143.3263660794267,-0.8183755653984872,-0.31501053840929955,0.2193094336440112,1.2583573418175031,1052,1009,1095,1138,43,86,129,103.51716912204537,123,147.89519881683842,-0.9541771774958793,-0.44642055949603543,0.07498137476162742,1.4122976256525577,83725,83167,Chemung,Chemung,36,15,New York,NY
36017,36CS009,487,467,507,519,12,32,52,81.22481258846372,29,73.97801917476244,-0.44923670315914477,0.07853080904917913,0.627443335687473,0.8830478243669633,589,565,613,697,84,108,132,231.33247628352734,83,178.05427437520112,-0.012435633488747218,0.5177926471335238,1.0631113746812209,0.7626178769501355,47041,46615,Chenango+Cortland,Chenango,36,17,New York,NY
36023,36CS009,373,353,393,425,32,52,72,132.76656806854007,28,71.8255664814023,0.08337853171134492,0.6063721385485475,1.1221262653632846,0.5307369300042463,454,430,478,556,78,102,126,219.98766892848548,54,116.45209290289189,0.5569769804496174,1.0332132545207147,1.4983447621123933,0.5242184967310718,46780,46371,Chenango+Cortland,Cortland,36,23,New York,NY
36019,36CS010,619,585,654,676,22,57,91,85.13320533906678,10,15.0472106233307,0.17868577140772482,0.7018495608733507,1.1717059279491613,0.1736792562833957,763,722,805,866,61,103,144,128.86227210457915,57,71.5963473302099,0.07492273345309106,0.5771988979178815,1.0859538106777205,0.5502402099716064,79749,79613,Clinton,Clinton,36,19,New York,NY
36021,36CS011,588,561,614,579,-35,-9,18,-17.266182628678823,44,86.15203876841744,-1.5379381401415069,-1.0298330765421417,-0.5338971077423733,-5.627842691510093,723,691,755,763,8,40,72,65.39172248524369,65,105.27168191756418,-0.9294713721107235,-0.3901109140599642,0.13957674424278618,1.5709544900474393,61287,61745,Columbia,Columbia,36,21,New York,NY
36025,36CS012,452,433,471,476,5,24,43,65.03004793059426,23,62.39967443648119,-0.49788341081133103,0.023230283586691564,0.529359239316728,0.9211225259607,557,534,580,673,93,116,139,262.26485372503157,70,157.83540022547916,0.5076296120334924,1.06289521665609,1.5680217870026936,0.5966868741711197,44231,44350,Delaware+Schoharie,Delaware,36,25,New York,NY
36095,36CS012,246,233,259,258,-1,12,25,48.288014980251205,2,8.018978248521499,-0.16630715848159935,0.404387341958423,0.9300778103515557,0.15333386144960723,304,288,319,357,38,53,69,178.93766719889746,33,110.58240064338851,0.15527167315073845,0.6639877090572424,1.2080647121047907,0.6066334970818745,29929,29842,Delaware+Schoharie,Schoharie,36,95,New York,NY
36027,36CS013,2180,2053,2307,2497,190,317,444,128.63998157001174,264,107.16424070008559,-0.2921943765910324,0.23530150997200738,0.7343343806146972,0.8304350244067578,2700,2547,2853,3137,284,437,590,147.15754019699241,335,112.82804332596864,-0.18397949437115038,0.33937884262161755,0.8675709346355653,0.7649652391837027,295621,296912,Dutchess,Dutchess,36,27,New York,NY
36029,36CS014,8523,8114,8931,9465,534,942,1351,119.28504256279116,1189,150.51204476119344,-0.8333988192634937,-0.30626306581396506,0.2430686994460225,1.2604471206397236,10445,9954,10936,10895,-41,450,941,47.35016019292407,1200,126.17527006765097,-1.2924235187554878,-0.7870875156631357,-0.24526933301713236,2.658823217775733,947964,951058,Erie,Erie,36,29,New York,NY
36031,36CS015,366,350,382,403,21,37,53,120.25583334885245,3,9.657170449058425,0.5886646473446862,1.1035336457514235,1.6265321744048313,0.07821161400619556,447,428,466,490,24,43,62,114.72161868399644,33,88.52406244970224,-0.2739929605825374,0.2650632396639224,0.786003689499474,0.754011253964874,37278,37278,Essex+Franklin,Essex,36,31,New York,NY
36033,36CS015,380,360,401,413,12,33,53,82.16494715235123,11,27.560288130285,3.8699682084198446e-4,0.5452954487595748,1.0650387364479859,0.3255007541193985,465,440,489,547,58,82,107,173.35800596238127,37,77.95053301310412,0.4116037049405128,0.966982278908714,1.455441363097763,0.44425174265954326,47895,47466,Essex+Franklin,Franklin,36,33,New York,NY
36035,36CS016,514,491,537,565,28,51,74,115.47682126634533,48,108.30935860551699,-0.43953337480039106,0.06239865138836939,0.5645921947111002,0.9199554388240403,630,602,657,803,146,173,201,325.8539689032548,117,220.2477316366101,0.5506845750780801,1.0731628678667553,1.5794352831389071,0.6720270092683805,53181,53122,Fulton+Hamilton,Fulton,36,35,New York,NY
36041,36CS016,57,56,57,64,7,7,8,168.65616671756382,2,48.10583283223091,1.0862213339123044,1.202322863640544,1.3176451119273833,0.24962929639834697,72,71,72,79,7,7,8,141.46508584413343,4,78.23195775474281,0.5122155337032139,0.6321048950056865,0.755234247025393,0.48584314774349624,4989,5113,Fulton+Hamilton,Hamilton,36,41,New York,NY
36037,36CS017,539,514,564,607,43,68,93,139.77211258810425,57,117.74224088960803,-0.29908345078736015,0.20397560182422836,0.7221511942774707,0.8301191161024659,661,631,691,734,43,73,103,126.66466589047224,121,208.9376985771515,-1.3538418158739365,-0.8272409421712487,-0.3214163996671998,1.627349339287744,58093,57912,Genesee+Orleans,Genesee,36,37,New York,NY
36073,36CS017,356,339,373,418,45,62,79,184.67913568097384,49,146.09421586165772,-0.08470937647913063,0.39024325222380807,0.8740222218395899,0.7785021294319522,438,417,459,488,29,50,71,124.7517146871826,52,129.35966963530524,-0.5497684214584806,-0.04547395796106613,0.434740195353539,1.0166636197821144,40248,40198,Genesee+Orleans,Orleans,36,73,New York,NY
36043,36CS018,559,533,585,609,24,50,76,100.21813534420421,35,69.77207787892883,-0.2124518446832354,0.2921776514753227,0.8083564259128844,0.6826237137955949,680,649,711,834,123,154,185,256.9280232109283,139,231.87148647972376,-0.2661327358267974,0.2530538730909193,0.7694732906995907,0.8966547818413675,60196,59947,Herkimer,Herkimer,36,43,New York,NY
36045,36CS019,814,765,864,793,-71,-21,28,-22.246606808886526,13,13.53262142491564,-0.8898265536312333,-0.3458510024254795,0.12978413154402055,-0.638161546749036,1015,955,1075,1081,6,66,126,56.479530489141204,119,102.34622265033714,-0.9555174534305226,-0.44708927817313443,0.06116581090319376,1.7849139754372847,115277,116272,Jefferson+Lewis,Jefferson,36,45,New York,NY
36049,36CS019,223,211,234,205,-29,-18,-6,-80.31420418033898,6,27.158537965372865,-1.5809966754327824,-1.0737691690423978,-0.5825215549719358,-0.3583498228913751,275,261,289,304,15,29,43,108.3637329965136,40,150.55706112616681,-0.9353586190422205,-0.4126831416015401,0.03975164186341834,1.3427290087424386,26511,26568,Jefferson+Lewis,Lewis,36,49,New York,NY
36047,36CS020,14153,12990,15315,22012,6697,7859,9022,350.0452286460812,6645,295.95516802526197,0.0422669986334272,0.5326854567305981,1.0797201597138664,0.8453693772327548,17265,15895,18636,18747,111,1482,2852,55.82944639406066,2754,103.7818576198833,-1.0108463328782482,-0.46549910566029484,0.007798298123160036,1.8576550613181364,2694327,2653643,Kings,Kings,36,47,New York,NY
36051,36CS021,482,456,509,482,-27,-0,26,-0.7655079842218674,33,64.01448408528798,-1.145601756451339,-0.65806575356912,-0.12959429030722952,54.51173341593124,593,561,625,678,53,85,117,137.54925328995526,74,120.13767127735566,-0.35249633524956886,0.1513259342206954,0.6755393362472176,0.8632270608810506,61861,61596,Livingston,Livingston,36,51,New York,NY
36053,36CS022,486,457,516,612,96,126,155,220.99214338931688,70,122.98502218122721,0.4274864345499605,0.9576850531185701,1.4788263024499313,0.5521236112173189,594,559,629,716,87,122,157,179.80687635712266,71,104.88684039472906,0.22762555379936733,0.7483162940730241,1.2437342622918728,0.5785769855742293,68301,67692,Madison,Madison,36,53,New York,NY
36055,36CS023,5834,5508,6159,6541,382,707,1033,112.25575879086422,654,103.8266909211179,-0.4623600070944587,0.06733877763717915,0.6066621828354342,0.9236057348761404,7167,6777,7557,8105,548,938,1328,124.08465516270189,896,118.57262904367734,-0.445155598130765,0.04523839448074949,0.5661644478189337,0.9545604702598999,755875,755655,Monroe,Monroe,36,55,New York,NY
36057,36CS024,492,471,513,560,47,68,89,165.07438955026893,33,80.10518863153636,0.31867664589602385,0.8562244833738699,1.3845668160981204,0.4782347371893935,601,576,627,737,110,136,161,273.59685542909307,116,234.15421881308032,-0.13202593114064887,0.3889493252930492,0.9061866876436243,0.8495686252859121,49435,49540,Montgomery,Montgomery,36,57,New York,NY
36059,36CS025,9511,8913,10109,12307,2198,2796,3394,241.7169527787469,2755,238.1621317888094,-0.4398706981384063,0.05111359257985702,0.5649949515912978,0.9849412033722311,11722,11003,12440,12165,-275,443,1162,31.856367600326113,1300,93.43409841485459,-1.1271581302319889,-0.6287155356790061,-0.10900610259326386,2.9263779795719937,1388130,1391355,Nassau,Nassau,36,59,New York,NY
36061,36CS026,8712,7994,9429,12306,2877,3594,4312,258.55750155195574,2787,200.48184219817875,0.06538080093901989,0.5795415072146387,1.059623197952023,0.7751702402863231,10331,9508,11153,11301,148,970,1793,60.90276946993465,1124,70.55616967879995,-0.6122960147359672,-0.10150460961856621,0.4254959414285437,1.1573122705524728,1668181,1593057,New York (county),New York (county),36,61,New York,NY
36063,36CS027,2043,1952,2134,2390,256,347,438,196.5066620855666,234,132.57978158330855,0.1129668673392615,0.650588682528825,1.1450152885355012,0.6727436967251688,2498,2389,2607,2968,361,470,579,222.04085839440694,372,175.68716350240862,-0.01643635000879415,0.458875394994342,0.9801279050696238,0.7895586161120826,211797,211740,Niagara,Niagara,36,63,New York,NY
36065,36CS028,2204,2104,2303,2455,152,251,351,130.5311701869704,246,127.76842405959064,-0.46960462673595466,0.03137813847683768,0.5229207879829654,0.9749552377748513,2691,2572,2810,3040,230,349,468,151.52034989759628,471,204.35523969437827,-1.019658250625658,-0.532911557213044,-0.004654302254230969,1.344847367716222,231043,230481,Oneida,Oneida,36,65,New York,NY
36067,36CS029,3786,3582,3990,4339,349,553,757,140.20991864728782,474,120.19144417796278,-0.32602346526606213,0.20398808794885087,0.7209711042582481,0.8556774907399339,4643,4399,4888,5173,285,530,774,111.89933184314134,514,108.53315540089699,-0.4620926381166792,0.040216435973571996,0.5514037779273875,0.9680910272200481,473245,473588,Onondaga,Onondaga,36,67,New York,NY
36069,36CS030,944,896,993,935,-58,-9,39,-10.07693320079062,74,79.2043883512465,-1.4486171347244303,-0.900785225530143,-0.37641662484384414,-8.794035090078056,1161,1103,1219,1194,-25,33,91,29.18715669654065,103,91.55311413917852,-1.1193182434287423,-0.6220136443492652,-0.10755806855680003,3.0440566407780816,112115,112503,Ontario,Ontario,36,69,New York,NY
36071,36CS031,2455,2283,2627,3006,379,551,723,165.62202891663432,594,178.52670386807858,-0.6443170620791758,-0.14425217160375925,0.38198143681621344,1.0759638924776505,3060,2851,3269,3163,-106,103,312,25.48102279426828,393,97.26326418484476,-1.2394964208533445,-0.7217012235824602,-0.19929518347119918,3.7803688034478213,399268,404058,Orange,Orange,36,71,New York,NY
36075,36CS032,932,882,983,981,-2,49,99,49.82826164048007,48,49.10737122103433,-0.5070165994932198,0.018273867941339242,0.5311204227543397,0.9657047202317164,1149,1088,1210,1329,119,180,241,153.34206116494823,138,117.5648736603568,-0.17392128964383816,0.3554561121501247,0.8353094760161017,0.7624478805798364,117294,117382,Oswego,Oswego,36,75,New York,NY
36077,36CS033,515,490,540,571,31,56,81,115.06059271037087,19,38.993022301272404,0.2847289920741314,0.7612080934060343,1.2376574573538948,0.3329525321654718,630,600,660,735,75,105,135,179.92208279515924,85,146.15860788224774,-0.21250311643572883,0.3382170868382264,0.8266058786656265,0.8046538416222064,58472,58156,Otsego,Otsego,36,77,New York,NY
36079,36CS034,601,559,643,777,134,176,218,216.33034290853058,116,142.31237156615174,0.19368587025341624,0.7511895196783601,1.2669253821079944,0.6541378027082237,742,691,792,753,-39,11,62,11.289922610182579,53,54.139086377380075,-0.9148677404248677,-0.4251248124382173,0.1641413849048751,4.397470740005732,97813,97896,Putnam,Putnam,36,79,New York,NY
36081,36CS035,12854,11833,13876,20419,6543,7565,8586,383.27628715033285,6559,332.32968990077984,0.016060719130635365,0.5046273276189377,1.0181095356031467,0.8669614428708055,15723,14514,16931,17202,271,1479,2688,63.196203364161924,2511,107.28151378445686,-0.9474970201718192,-0.46598511307346296,0.08099151423464762,1.6964473815254837,2368371,2340571,Queens,Queens,36,81,New York,NY
36083,36CS036,1267,1198,1336,1393,57,126,195,94.33945084171049,78,58.29305963828409,-0.151021329627044,0.36747866460435513,0.9377486085190686,0.6130510334917827,1552,1470,1635,1786,151,234,316,145.7103798330105,167,104.15822070316155,-0.1009551641504769,0.4291231983598588,0.9165849341744071,0.7117837448059123,160568,160333,Rensselaer,Rensselaer,36,83,New York,NY
36085,36CS037,3289,3077,3501,4420,919,1131,1343,275.589475007048,1125,274.1205805670844,-0.47298223938794814,0.017057070535593515,0.5281841224970956,0.993791329090319,4058,3803,4313,4367,54,309,564,62.53293597077682,594,120.29405212742259,-1.0964786170093586,-0.5728642216035729,-0.07414567802392569,1.9174812615064867,492484,493790,Richmond,Richmond,36,85,New York,NY
36087,36CS038,1979,1833,2124,2791,667,812,958,289.7280779536745,819,292.0480209200048,-0.5527009946902425,-0.03173498012073797,0.4992131712285523,1.0067682031709724,2464,2289,2639,2477,-162,13,188,3.933728919751694,273,80.51529790660226,-1.2746031039928676,-0.7682644245920144,-0.2795291837338816,19.040395721229597,336520,339066,Rockland,Rockland,36,87,New York,NY
36089,36CS039,855,809,902,939,37,84,130,92.77377867049815,47,52.12376621936342,-0.12615063764324044,0.4004713135110465,0.910248562899693,0.5552004095567548,1054,998,1110,1261,151,207,263,191.53072815146666,139,128.59772964871541,0.10489269957102164,0.6075757797096805,1.1423122335528708,0.6681932599209106,108204,108089,St. Lawrence,St. Lawrence,36,89,New York,NY
36091,36CS040,1671,1570,1772,1689,-83,18,119,9.1415232412320009,64,32.6836326495872,-0.7326052450816541,-0.23616064912682755,0.2743434702246767,3.386131215085904,2074,1952,2196,2364,168,290,412,122.2795492769418,252,106.27754465132952,-0.34569159203905064,0.1660843923683907,0.7024216617578414,0.8661485832177477,234980,237115,Saratoga,Saratoga,36,91,New York,NY
36093,36CS041,1341,1274,1409,1453,44,112,179,85.06510567291063,88,67.0276171555155,-0.35292707794856315,0.1790298090264338,0.7227153860534415,0.7809638751777772,1648,1566,1729,1851,122,203,285,128.6846023555168,188,118.94518398542289,-0.44484723645881147,0.11196183277271905,0.6102852943062306,0.9197933581912755,157547,158056,Schenectady,Schenectady,36,93,New York,NY
36097,36CS042,176,169,184,192,8,16,23,105.93792260956837,11,73.99103139013452,-0.1919761447232609,0.3118049832528764,0.8274066998308887,0.6567384597016344,215,206,224,259,35,44,53,245.9904767412542,17,95.68300782349299,0.9580106736791039,1.488698533071697,1.9964625524420787,0.3802695744211763,17840,17767,Schuyler+Seneca+Yates,Schuyler,36,97,New York,NY
36099,36CS042,310,295,324,324,-0,14,29,50.20344660923991,30,106.56878126757644,-1.062236327739973,-0.5609698882718899,-0.04321134694328439,1.982463316834648,380,363,397,410,13,30,47,89.06625332586033,52,154.3393090347857,-1.1833282910305738,-0.6481345445466014,-0.14789135181951568,1.6769756557213886,33781,33692,Schuyler+Seneca+Yates,Seneca,36,99,New York,NY
36123,36CS042,231,221,242,256,14,25,35,119.4898759381202,16,77.64791523435919,-0.11202790387060893,0.41801249439968235,0.9120605083811957,0.6244661622699695,283,270,296,279,-17,-4,9,-16.777286027396368,25,101.51459779916352,-1.7098845012570014,-1.1626097101496713,-0.7142531169405982,-7.98277705003333,24727,24627,Schuyler+Seneca+Yates,Yates,36,123,New York,NY
36103,36CS043,10827,10173,11481,13547,2066,2720,3374,215.05769164838935,2804,221.71017561939226,-0.5591836669966632,-0.07423521355196523,0.43772735425492865,1.030554586273682,13397,12609,14185,14328,143,931,1719,61.003948256912096,1770,115.98822293591749,-1.0478377758083135,-0.5528744079755303,-0.01775132757173754,1.8992830152576938,1517657,1526017,Suffolk,Suffolk,36,103,New York,NY
36105,36CS044,648,614,681,739,58,91,125,140.01364635747822,63,96.53569649994253,-0.09952797017278052,0.42081454330189944,0.9620735864230765,0.6820095549298898,807,766,848,876,28,69,110,86.90843872699193,81,101.7127932091014,-0.6561686206989957,-0.15233576450798536,0.34408865685836315,1.1536751689209201,78313,79636,Sullivan,Sullivan,36,105,New York,NY
36107,36CS045,403,382,423,492,69,89,110,221.96890842626473,57,141.62663574623159,0.2692404767514405,0.8059418227817564,1.308275716281634,0.6309840627396948,492,467,517,559,42,67,92,139.19638622407226,59,122.8271052357656,-0.34925755186635216,0.15866444571861682,0.6620596339674405,0.8693988447854868,48296,48035,Tioga,Tioga,36,107,New York,NY
36109,36CS046,612,567,657,584,-73,-28,17,-31.89141110870133,22,25.172104731211505,-1.1114064118299636,-0.5562786064813222,-0.036367281821852754,-0.8186789252032499,758,704,813,759,-54,1,55,0.6053374947623409,54,51.33226232687244,-1.013779340008344,-0.5049583016607638,-0.012388993130296242,32.99126514463329,104878,105197,Tompkins,Tompkins,36,109,New York,NY
36111,36CS047,1504,1426,1582,1664,82,160,238,105.76740505437027,149,98.6368475928306,-0.4035970077253299,0.07227044155634482,0.5678966855464901,0.9267819801344294,1858,1764,1953,2042,89,184,278,100.5160602972245,209,114.35324757751674,-0.652159100803821,-0.15143867583774717,0.3598808853682045,1.131502286634244,181271,182767,Ulster,Ulster,36,111,New York,NY
36113,36CS048,632,604,660,671,11,39,67,71.22158412639634,37,67.89613726029911,-0.4463175600498229,0.04134216940886421,0.5657104969977076,0.929363307997121,776,742,810,883,73,107,141,162.80257062599676,71,108.19707105956934,-0.008328326956164405,0.5376876509979729,1.103052219893399,0.658427513601754,65394,65621,Warren,Warren,36,113,New York,NY
36115,36CS049,552,526,578,627,49,75,101,147.4302619502421,16,31.41001521422612,0.6690558067190782,1.165398899470868,1.6464717352537108,0.2102503708866507,678,647,710,781,71,103,134,168.80564874877723,91,149.22191430398635,-0.3006380316802127,0.20225044337852455,0.7073531432597204,0.8754819462750524,61127,60983,Washington,Washington,36,115,New York,NY
36117,36CS050,768,729,807,832,25,64,103,84.90118864393445,50,66.00877916762929,-0.3174921976642699,0.18032529815082918,0.7161833642769788,0.7655733559680684,943,896,990,1040,50,97,144,106.67473229986277,106,116.54883506140804,-0.6377076457403151,-0.09320193840664501,0.39105393030182395,1.081416344639411,90897,90949,Wayne,Wayne,36,117,New York,NY
36119,36CS051,6302,5872,6732,8319,1587,2017,2447,242.58482121525068,1925,231.55202001571746,-0.39081541728746383,0.09901508298500472,0.6101211082625281,0.9540467522251423,7779,7263,8294,8016,-278,237,753,23.749419266716817,930,93.12338848974892,-1.2170667255463148,-0.7148682619498328,-0.14782319741293626,3.904617944782218,997616,998675,Westchester,Westchester,36,119,New York,NY
37001,37CS001,1520,1446,1594,1726,132,206,280,144.2798196689306,149,104.15635103253429,-0.10623396754672708,0.4097755541732328,0.9153429438623155,0.7184244255100696,1880,1791,1970,1995,25,115,204,66.11777527150115,173,99.66586012213389,-0.8818036305004145,-0.3324565688863515,0.1632764878661586,1.4943779301781586,171665,173580,Alamance,Alamance,37,1,North Carolina,NC
37003,37CS002,335,319,351,440,89,105,121,343.96122706954844,44,144.2780631763034,1.4175184887046948,2.001389603834585,2.521280833899389,0.4154992205568789,410,391,429,614,185,204,223,556.1039358739837,97,264.93322044082703,2.392645251386233,2.9152817251683643,3.3809094103935466,0.47408111999262886,36596,36613,Alexander+Catawba,Alexander,37,3,North Carolina,NC
37035,37CS002,1454,1385,1524,1706,182,252,321,187.93216116426322,174,129.97441595548003,0.07236849418836215,0.5691105715470537,1.10877622001356,0.6888647868830207,1787,1704,1871,2319,448,532,615,329.0531399635451,320,198.04308674906085,0.8180326972131947,1.3142040274385505,1.8201412919471178,0.6007276079417515,160647,161581,Alexander+Catawba,Catawba,37,35,North Carolina,NC
37005,37CS003,121,120,123,129,6,8,9,82.92957938201992,4,43.839620056626174,0.263579890413243,0.3894265663461132,0.504025199354259,0.46692790293362707,150,149,152,170,18,20,21,178.99450606140056,14,126.96109549288111,0.3959371674230525,0.5147175178562867,0.6445577870436912,0.6750981870620572,10949,11027,Alleghany+Ashe+Avery+Watauga,Alleghany,37,5,North Carolina,NC
37009,37CS003,289,277,300,343,43,54,66,243.7693969078212,34,152.93500262388483,0.40678213790326456,0.8951143689171891,1.395688819011342,0.6160089892084951,355,341,368,440,72,85,99,319.67316946385284,57,213.56313225927315,0.5211752765522198,1.0505861797427771,1.5831833012414693,0.6603277601278951,26678,26690,Alleghany+Ashe+Avery+Watauga,Ashe,37,9,North Carolina,NC
37011,37CS003,187,180,195,187,-8,-0,7,-1.26658104618364,19,128.3711502730702,-1.8067166298077726,-1.3050164674691098,-0.7368949607471401,23.383595131083183,231,221,240,247,7,16,26,92.05582189112381,32,179.23154475187633,-1.3529018931526955,-0.8684130204595973,-0.35340017639969235,1.835320537687513,17761,17854,Alleghany+Ashe+Avery+Watauga,Avery,37,11,North Carolina,NC
37189,37CS003,308,284,331,361,30,53,77,117.54289584214335,24,52.931446425289465,0.12495538171501061,0.6501694959029474,1.172951881598603,0.4420222604950799,384,356,412,457,45,73,101,134.74239101301288,39,71.94244604316548,0.10808300164098263,0.6398000392269364,1.1487124045301451,0.526714911656142,54410,54210,Alleghany+Ashe+Avery+Watauga,Watauga,37,189,North Carolina,NC
37007,37CS004,239,229,248,286,38,47,57,253.9812706253853,34,183.34606569900686,0.18928285640954243,0.7061963976656903,1.2138741139902223,0.7068796628912632,290,278,301,417,116,127,139,577.74460225919,73,330.97569822270583,1.9684817719481689,2.4694900259914334,2.981788695384067,0.5684147519887552,22253,22056,Anson+Richmond,Anson,37,7,North Carolina,NC
37153,37CS004,460,442,479,575,96,115,133,319.81390701630056,57,158.56089758449627,1.1312822664781164,1.6139842900248293,2.1705219030806795,0.4915158782833984,557,535,579,726,147,169,191,395.76663335284576,104,243.2919269188481,0.9877876850588903,1.5436883856937131,2.0504707708739662,0.6111235195456216,43138,42747,Anson+Richmond,Richmond,37,153,North Carolina,NC
37013,37CS005,489,470,508,571,63,82,101,219.31873496125706,65,173.47211102215104,-0.04746208712450415,0.4408959564284382,0.9798897153799299,0.7814497769781741,593,570,615,685,70,92,115,207.87267368424503,80,179.81568891885817,-0.24140333354988952,0.277311366009305,0.8098308619642344,0.8557746642729909,44964,44490,Beaufort+Martin+Pamlico,Beaufort,37,13,North Carolina,NC
37117,37CS005,254,244,263,341,78,87,97,475.23058029060735,30,163.6214889555495,2.607173394554085,3.122535049510124,3.6188577220788516,0.34039259583137466,307,296,318,384,66,77,88,353.30039368558926,54,247.91111927279402,0.5295888860972184,1.073301269656348,1.5280933811398334,0.6926994071388121,22002,21782,Beaufort+Martin+Pamlico,Martin,37,117,North Carolina,NC
37137,37CS005,149,144,154,152,-2,3,8,28.160555675389322,1,9.723685276719875,-0.3339563762528666,0.18234133458832832,0.7100122820514326,0.25666834103953484,182,176,188,207,19,25,31,203.13575639380608,21,170.24726388325902,-0.19612700601612562,0.3095571973188831,0.8231831265873109,0.805931794596755,12341,12335,Beaufort+Martin+Pamlico,Pamlico,37,137,North Carolina,NC
37017,37CS006,320,307,333,421,88,101,114,404.4330672730861,27,107.75933747962883,2.454865700332508,2.966338460945045,3.479621825130124,0.2638417352763946,387,372,402,575,173,188,203,636.6882393740285,87,294.5557963163597,2.919227505450958,3.4191772857209455,3.927402397621583,0.46019026669460217,30067,29536,Bladen+Columbus,Bladen,37,17,North Carolina,NC
37047,37CS006,549,528,571,753,182,204,225,477.22702223635054,85,199.28491882070216,2.311175192591795,2.785772116295983,3.3068008857844218,0.4155478333372791,663,637,689,908,219,245,271,488.6510821749778,154,307.0665177859308,1.3042316252402957,1.8307888137178467,2.34882178814843,0.6258425233972087,51183,50152,Bladen+Columbus,Columbus,37,47,North Carolina,NC
37019,37CS007,1325,1265,1385,1530,145,205,265,176.5552780895359,84,72.29019349101392,0.5434421995830517,1.032242704746342,1.5734302790345212,0.4074618082168046,1669,1595,1743,2039,296,370,444,258.0732391975669,203,141.64009461279227,0.6514670614392588,1.1444586453815235,1.6487304667817024,0.5473569643954505,139438,143321,Brunswick,Brunswick,37,19,North Carolina,NC
37021,37CS008,2394,2279,2510,2542,32,148,263,65.89821903530834,158,70.55776358683516,-0.5707831633704159,-0.036070454367705986,0.4425319716076556,1.0635012426439068,2968,2828,3108,3154,46,186,326,68.42393998676475,264,97.32539492359588,-0.8196762917432704,-0.28465707523076184,0.21033815578414586,1.4147655339535299,268716,271255,Buncombe+Madison,Buncombe,37,21,North Carolina,NC
37115,37CS008,221,212,231,239,8,18,27,99.02599663134023,14,78.86583419397239,-0.30897792993627854,0.1824697054932233,0.7193913334048508,0.7535484798951508,274,263,285,296,11,22,33,103.91572008188265,40,186.40197586094413,-1.357669976776347,-0.8254169962060075,-0.3187501459562097,1.7167916631529474,21302,21459,Buncombe+Madison,Madison,37,115,North Carolina,NC
37023,37CS009,859,821,897,1016,119,157,195,214.24596405035533,85,115.94598281271314,0.4714001445164622,1.0025166533757626,1.5070739825838024,0.5377578233582695,1049,1003,1094,1317,223,268,314,306.44592843878996,178,203.19170795187327,0.5138614301735571,1.0385949106657562,1.5308405559876215,0.6605981639462121,87972,87602,Burke,Burke,37,23,North Carolina,NC
37025,37CS010,1467,1369,1564,1580,16,113,211,60.14317479857485,127,67.45153580596619,-0.5981099534158032,-0.06922986440324623,0.39057004565167097,1.1116988206303298,1835,1716,1954,1971,17,136,255,59.0762022562075,272,117.92043838657095,-1.1026532518870942,-0.5885370000952915,-0.060496150992017106,1.981531959357995,225940,230664,Cabarrus,Cabarrus,37,25,North Carolina,NC
37027,37CS011,820,785,855,976,121,156,191,231.83719746348544,108,160.4675350403645,0.17545910624572314,0.7046333830267123,1.2416367630879848,0.6877484412461039,1002,961,1044,1322,278,320,361,397.2726470384214,173,214.98695165900338,1.3180834426571282,1.822785415623081,2.3379320384298596,0.539469693499285,80764,80470,Caldwell,Caldwell,37,27,North Carolina,NC
37029,37CS012,77,76,78,95,17,18,19,207.90320493037316,6,68.5844922842446,1.2755108126903087,1.3955273818670237,1.5089575109527074,0.31269436922399335,97,95,98,105,7,8,10,76.37551115657035,10,92.8418902608857,-0.29070464960253173,-0.16553157132196691,-0.04048301658374122,1.0838456130819,10498,10771,Camden+Currituck+Pasquotank,Camden,37,29,North Carolina,NC
37053,37CS012,207,194,219,262,43,55,68,233.0355059352554,13,54.834967837182326,1.2892714513566326,1.7886608956646244,2.2702022815089937,0.23112387913543175,262,247,277,317,40,55,70,187.15421885377376,27,91.62481335686168,0.4886040609010598,0.9483080474588543,1.4438494967335025,0.4808496702420497,28449,29468,Camden+Currituck+Pasquotank,Currituck,37,53,North Carolina,NC
37139,37CS012,371,354,389,442,53,71,88,209.69075012004987,41,121.28682361641809,0.3961138263047495,0.8590260221930255,1.392897517811048,0.5703616917584386,455,434,476,537,61,82,103,201.1812652984113,56,137.27172447603874,0.1262505176504879,0.6329369183061082,1.180004173558027,0.6741148559503743,40565,40795,Camden+Currituck+Pasquotank,Pasquotank,37,139,North Carolina,NC
37031,37CS013,710,681,739,754,15,44,73,77.38263419710412,31,54.69060115555948,-0.24405047708291286,0.23808298743185857,0.7506497537762467,0.6910016397807164,878,842,913,1064,151,186,222,272.15637907353283,79,115.47681693270185,1.0670639994621922,1.5758532142442463,2.0680802570480736,0.42203645269955253,68019,68412,Carteret,Carteret,37,31,North Carolina,NC
37033,37CS014,238,229,248,279,31,41,50,215.08727160358296,16,84.65235218905691,0.8139905323349743,1.3104389270216994,1.8099758902808867,0.3841233491335967,293,281,305,362,57,69,81,303.79058915448263,44,193.73871692131564,0.5790228367248971,1.087748630971224,1.5804633868757032,0.6286263821659053,22681,22711,Caswell+Person,Caswell,37,33,North Carolina,NC
37145,37CS014,385,368,402,449,47,64,81,195.80646567872157,26,79.56545023334098,0.6401333366860533,1.1620331662705221,1.6543686793554357,0.40009443569205355,473,453,493,537,44,64,84,163.77028802192743,76,194.2243802708919,-0.7783448976387307,-0.29824016263039776,0.1927969070642685,1.1677340269863965,39213,39130,Caswell+Person,Person,37,145,North Carolina,NC
37037,37CS015,647,614,680,727,47,80,113,126.1712562838987,51,80.07955616036847,-0.0987282523430642,0.4473359814373235,0.9550508442397652,0.6268878279923465,806,766,846,833,-13,27,67,34.483188577143665,55,70.78233787627248,-0.9019691533212577,-0.34543919762213177,0.17939702575059457,1.978810749138533,76424,77703,Chatham,Chatham,37,37,North Carolina,NC
37039,37CS016,346,334,358,351,-7,5,17,21.033416621410577,28,116.46447140381282,-1.4867936416700003,-0.9520744057598667,-0.43350041269534934,4.6229154619742365,430,415,445,545,100,115,130,393.9203955952931,94,322.8243698056185,0.17706909743648977,0.7160665401115642,1.2330249674661127,0.8124337573370493,28850,29118,Cherokee+Clay+Graham+Swain,Cherokee,37,39,North Carolina,NC
37043,37CS016,136,134,137,111,-26,-25,-23,-263.50772753015696,5,53.75862377923126,-3.296849511914674,-3.16816258204084,-3.0466320371049944,-0.21268980039707722,169,167,170,191,21,22,24,198.14988409254082,42,372.307419555004,-1.8572469542929282,-1.7397893600074146,-1.625872990666171,1.79846192264617,11161,11281,Cherokee+Clay+Graham+Swain,Clay,37,43,North Carolina,NC
37075,37CS016,86,85,87,113,26,27,28,397.105705750367,10,148.4230055658627,2.372534822561513,2.4871781754042384,2.6016115949870637,0.36029548218099355,106,105,107,130,23,24,25,301.43631061822225,15,186.59037193680805,1.028982993593953,1.1492563227476398,1.2771659108744078,0.5944722401754746,8085,8039,Cherokee+Clay+Graham+Swain,Graham,37,75,North Carolina,NC
37173,37CS016,173,167,179,211,32,38,44,323.2759811318382,10,84.9737997450786,1.8658475301109796,2.3957980740031335,2.8648595783908717,0.25612001958723035,213,206,221,249,28,36,43,251.80656245108707,30,212.34428086070213,-0.12661811182655625,0.4005667051635367,0.90213174503926,0.820227215588441,14122,14128,Cherokee+Clay+Graham+Swain,Swain,37,173,North Carolina,NC
37045,37CS017,1069,1026,1112,1263,151,194,237,234.11557499458405,162,195.31014527699074,-0.11015961030630987,0.38917190007015867,0.9490311272351368,0.8299726116529224,1314,1262,1366,1480,114,166,218,165.67077578969528,218,217.419489961802,-1.0302179307325972,-0.525156794781763,0.016650835817251537,1.3045056200567826,99534,100267,Cleveland,Cleveland,37,45,North Carolina,NC
37049,37CS018,928,885,971,1121,150,193,236,230.00826361370505,102,121.45266918039293,0.5675744518474011,1.0839684087763566,1.57955881308876,0.5253166395972,1137,1085,1189,1292,103,155,207,154.20428430923965,108,107.29613733905579,-0.03072183453934048,0.4796157904218278,0.9666494697817802,0.6913510379046237,100780,100656,Craven,Craven,37,49,North Carolina,NC
37051,37CS019,2225,2081,2369,2594,225,369,513,132.3437066682845,148,53.046119658425994,0.2871117711622894,0.7659168956555369,1.298341677670779,0.39973827925143446,2754,2581,2927,3572,645,818,991,243.84853423884135,444,132.40214467618134,0.5900696560913704,1.1286644445345482,1.647854103437611,0.5423056075132945,334803,335342,Cumberland,Cumberland,37,51,North Carolina,NC
37055,37CS020,314,298,330,324,-6,10,26,32.298751493851405,5,16.173814594172036,-0.32337885281055717,0.17993327067930093,0.6870427193071681,0.455170699028797,394,375,414,414,0,20,39,52.914392624146814,26,68.95454304354745,-0.6498570248302897,-0.16804551597388284,0.3443674080904858,1.2409375237770754,37097,37706,Dare+Hyde+Tyrrell+Washington,Dare,37,55,North Carolina,NC
37095,37CS020,49,49,50,49,-1,-0,-0,-12.31752924083718,4,104.32514670723756,-1.2931629641379434,-1.1693240002212717,-1.0487230122425493,7.579699598205576,60,59,60,51,-9,-9,-8,-191.4301762815078,4,88.61320336730172,-2.935621323242148,-2.8038397194018945,-2.6810715206954034,-0.5234808542935142,4601,4514,Dare+Hyde+Tyrrell+Washington,Hyde,37,95,North Carolina,NC
37177,37CS020,36,35,38,39,1,3,4,104.8273920188613,2,72.31093702922567,-0.16643312325568313,0.3184046217611425,0.7900753503731099,0.512905872072702,44,42,46,49,3,5,7,158.44170169816226,5,153.79883112888342,-0.4859550186563507,0.039352488524345725,0.5779962715101484,0.8128839211264061,3319,3251,Dare+Hyde+Tyrrell+Washington,Tyrrell,37,177,North Carolina,NC
37187,37CS020,134,129,139,167,28,33,38,356.45994569353644,12,130.34033309196235,1.7913813747177256,2.2558582753741896,2.7540701999560993,0.35483978850290054,163,157,168,215,47,52,58,479.20029610438945,33,302.72452068617554,1.2585601294227884,1.768850081893229,2.276455523681289,0.6198623707825094,11048,10901,Dare+Hyde+Tyrrell+Washington,Washington,37,187,North Carolina,NC
37057,37CS021,1583,1510,1655,1849,194,266,339,188.97469184196322,137,97.18724506083069,0.4094652729445176,0.9356474502791536,1.411641355817831,0.5123637211348728,1951,1863,2039,2384,345,433,521,254.15912084415095,349,204.79177546840984,0.007550585484872058,0.4957798275143368,1.0089822264292558,0.8039060176945607,169158,170417,Davidson,Davidson,37,57,North Carolina,NC
37059,37CS022,411,393,429,438,9,27,45,75.6237947641285,34,95.18032939859096,-0.7071855497742923,-0.2006501580864341,0.36547951092928194,1.2136754138620014,508,486,531,579,48,71,93,162.39148239932766,84,193.42805167292238,-0.8154006549679312,-0.3203713119091456,0.21014528755135153,1.1744679220261298,42866,43427,Davie+Yadkin,Davie,37,59,North Carolina,NC
37197,37CS022,373,357,389,433,44,60,76,193.2793083693525,40,128.8728991032594,0.14441704265780014,0.6528243403453626,1.1477827175989233,0.6558379514041877,455,436,474,507,33,52,71,139.55521494599208,66,177.46228926353152,-0.9052879305411421,-0.37983955308563305,0.11028978497941733,1.2475903550636926,37246,37191,Davie+Yadkin,Yadkin,37,197,North Carolina,NC
37061,37CS023,390,369,411,596,185,206,227,492.93459582489845,74,177.12177121771217,2.6565525352514983,3.1619604945749833,3.6631194664982036,0.3575847187339354,469,444,494,752,258,283,308,583.219963898361,107,220.44583625200872,3.0894279802527116,3.628828449719787,4.130398758172767,0.3766500801388275,50135,48538,Duplin,Duplin,37,61,North Carolina,NC
37063,37CS024,1829,1689,1969,2037,68,208,348,76.68348763911806,138,50.911080845935565,-0.24031406491902954,0.26401337142513437,0.759330212997224,0.6607331532816131,2270,2102,2439,2269,-170,-1,167,-0.38984295700302596,133,40.79128967949701,-0.9395494360281944,-0.4037964828185839,0.0960356382853912,-490.62471266391395,325273,326050,Durham,Durham,37,63,North Carolina,NC
37065,37CS025,546,525,567,680,113,134,155,328.9321329354308,85,207.9086832450061,0.6780349015025801,1.2077330117653442,1.70442058282581,0.6274061934099139,663,638,688,703,15,40,65,82.77367591674988,61,126.01222938357296,-0.9514117671150074,-0.43399414904202976,0.075779385212952,1.48530228723367,49060,48408,Edgecombe,Edgecombe,37,65,North Carolina,NC
37067,37CS026,2987,2822,3152,3325,173,338,503,105.86836869140005,244,76.46226242642335,-0.2554650601591891,0.25950837743479754,0.8296451804035694,0.7201074631157874,3693,3494,3892,4133,241,440,639,114.1986071379386,409,106.20176777905877,-0.390034929964773,0.06361700731534296,0.6248923470298314,0.9278645270171394,382934,385116,Forsyth+Stokes,Forsyth,37,67,North Carolina,NC
37169,37CS026,469,450,488,554,66,85,104,227.55461300669882,35,93.99337570495031,0.8230018493204642,1.3474029899185487,1.848844848768136,0.40824061569140063,573,550,596,671,75,98,121,220.9288030317497,76,170.60249618389153,-0.008761483396893335,0.4944662371038984,1.005775151753207,0.7644386120894917,44684,44548,Forsyth+Stokes,Stokes,37,169,North Carolina,NC
37069,37CS027,544,515,574,593,19,49,78,84.01343798110128,43,74.30875576036865,-0.3548150171998963,0.1062780898369253,0.6171506265746352,0.8666598281798025,688,651,725,758,33,70,107,98.5932272084931,73,102.35845088196528,-0.5394895193619538,-0.04062993772078492,0.47373729238122214,1.0236316187162484,69440,71318,Franklin+Warren,Franklin,37,69,North Carolina,NC
37185,37CS027,205,197,214,262,48,57,65,361.2789479860219,14,89.48069241011984,2.240207508723157,2.7055305627890336,3.262929404412035,0.2433720149316342,251,242,261,302,41,51,60,270.02772418501826,29,154.7657167253709,0.6657943075328528,1.1547542119208942,1.677911897745654,0.562039521722283,18775,18738,Franklin+Warren,Warren,37,185,North Carolina,NC
37071,37CS028,2085,1987,2183,2346,163,261,359,137.23759519462664,226,118.94163000907852,-0.32655871025275357,0.18928511296932318,0.6959423377551243,0.8633730784899635,2580,2461,2699,3062,363,482,601,209.1562684473627,452,196.11331184185977,-0.3987343740349315,0.11674508816641022,0.5952333932399069,0.9356990976074354,228011,230479,Gaston,Gaston,37,71,North Carolina,NC
37015,37CS029,200,192,207,261,54,61,69,408.5776336353209,38,253.65745118762865,1.0392758126458284,1.5302630113126396,2.036963417570024,0.610850626494591,242,233,251,313,62,71,80,406.7873102113772,28,159.49871831387068,1.9797677638223448,2.4745254366218643,2.962984238637044,0.38667884577599726,17977,17555,Gates and Nearby Counties,Bertie,37,15,North Carolina,NC
37041,37CS029,167,161,173,194,21,27,33,235.85540621183765,22,192.58826962357747,-0.08253553763847661,0.45497703230726416,0.912565096970674,0.7873297391007912,206,199,213,237,24,31,38,227.5865801196859,21,153.12819017062856,0.23004929733079893,0.7485418203625089,1.2707744683117081,0.6519466712079738,13708,13714,Gates and Nearby Counties,Chowan,37,41,North Carolina,NC
37073,37CS029,105,104,106,126,20,21,22,233.82989974893667,18,203.75436279596263,0.17469130629413818,0.30557698711006204,0.4185400894454442,0.8311429998557465,127,126,128,164,36,37,38,355.7203932220417,19,183.06195201849889,1.5992631578209433,1.7279378087660846,1.8426689711398463,0.5010519504936881,10601,10379,Gates and Nearby Counties,Gates,37,73,North Carolina,NC
37091,37CS029,215,206,224,315,91,100,109,551.8209932008112,47,259.28650239058476,2.4075023265469766,2.926836477429909,3.4282813074390437,0.4652233101989579,262,251,273,304,31,42,53,196.79340369888723,30,140.8252358822701,0.06402929078794842,0.5723347691951713,1.1575139318891898,0.6989276317704686,21752,21303,Gates and Nearby Counties,Hertford,37,91,North Carolina,NC
37143,37CS029,151,145,156,182,26,31,37,285.53178805843413,15,137.44654856444714,0.9216069775914415,1.5118577516127174,1.9774086938242752,0.4664028886281645,186,180,193,196,3,10,16,72.67502782641031,26,198.30676531157044,-1.7709902722803523,-1.254095778273009,-0.7519642299840918,2.4695056658625623,13096,13111,Gates and Nearby Counties,Perquimans,37,143,North Carolina,NC
37077,37CS030,483,457,510,594,84,111,137,217.28634393217166,48,94.36435124508519,0.7356437971229934,1.23296675848703,1.7043382606437518,0.4303916768653306,601,569,633,706,73,105,137,169.46407489079948,67,108.33009959901693,0.06414951070658255,0.6276197383074489,1.0957950611457872,0.6332096275691165,61040,61848,Granville+Vance,Granville,37,77,North Carolina,NC
37181,37CS030,430,411,448,566,118,136,155,381.94661531890193,71,199.0421679710314,1.3129029672323271,1.8215742539590365,2.3604145062459305,0.5173285365833544,520,498,542,629,87,109,131,257.9153487876409,60,142.06227062862555,0.6542181413968218,1.156790129780559,1.6898020156429774,0.5457991552984934,42805,42235,Granville+Vance,Vance,37,181,North Carolina,NC
37079,37CS031,173,164,182,206,24,33,42,193.01270455815998,26,152.12091662603606,-0.08877688243696759,0.4076812317854363,0.9147800892063782,0.7649513847839676,212,202,223,266,43,54,64,261.99510244282936,21,102.8353165858675,1.054040848693984,1.5695233190896376,2.103200540511998,0.3853068207407287,20510,20421,Greene+Jones+Lenoir,Greene,37,79,North Carolina,NC
37103,37CS031,98,97,99,135,36,37,38,483.269514832989,17,221.9079734580659,2.5010254609860447,2.6179735853717863,2.7348681421994243,0.44710401688938556,121,120,122,169,47,48,49,521.1942814081069,16,173.14143490964182,3.3577842998696292,3.4803835961079987,3.601195477147395,0.32544426901398255,9193,9241,Greene+Jones+Lenoir,Jones,37,103,North Carolina,NC
37107,37CS031,607,584,631,733,102,126,149,273.4305888972913,78,169.80515946446064,0.5210456844250538,1.0489102286436904,1.5780538777358863,0.6161120845152929,740,711,768,944,176,204,233,373.30823872910867,111,202.74713231533573,1.1903233953065817,1.7062284399230083,2.209211150160898,0.5404647556186672,55122,54748,Greene+Jones+Lenoir,Lenoir,37,107,North Carolina,NC
37081,37CS032,3938,3705,4171,4378,207,440,673,97.59008446110461,346,76.75371706494673,-0.347735566209649,0.20635001021499688,0.7312720025654129,0.7847072237548032,4862,4583,5142,5761,619,899,1178,165.7000899113104,547,100.87504956155314,0.14525374777153904,0.6618158038350161,1.1327181004135414,0.608104111748992,540951,542255,Guilford,Guilford,37,81,North Carolina,NC
37083,37CS033,541,520,562,696,134,155,176,381.1875185408949,53,130.59011950227915,1.9816258510163747,2.529593026438593,3.0196015524216464,0.3403873704872972,659,634,683,863,180,204,229,423.32135065440616,92,190.45647448504295,1.8188931138127482,2.343301388643075,2.8608110014590893,0.44772042031070236,48702,48305,Halifax+Northampton,Halifax,37,83,North Carolina,NC
37131,37CS033,202,194,209,305,96,103,111,701.2112265537572,43,291.42663503896983,3.607252907431026,4.109446046208954,4.602509617553982,0.41162617461588147,241,232,250,323,73,82,91,477.75104381429156,45,262.02398975195064,1.6511750192926922,2.14345107704951,2.679210115866015,0.5418490212182628,17706,17174,Halifax+Northampton,Northampton,37,131,North Carolina,NC
37085,37CS034,878,820,935,1068,133,190,248,170.00440202829472,97,86.64453409953701,0.3091016179688279,0.8291708758838939,1.3369660216281474,0.5069966545066311,1094,1024,1164,1426,262,332,402,244.73121968934677,187,137.86087110377164,0.5036612182264567,1.0571253339720175,1.6128950322720021,0.5616236005023393,134342,135644,Harnett,Harnett,37,85,North Carolina,NC
37087,37CS035,696,669,722,806,84,110,137,212.65719122189734,72,138.85763877728132,0.23205284546023702,0.7284555772422926,1.1999610667903216,0.6470962127455097,853,821,886,959,73,106,138,169.32746683991877,107,171.40294108224137,-0.5572401216713266,-0.01657374235318414,0.4960863480457275,1.0027706041082534,62222,62426,Haywood,Haywood,37,87,North Carolina,NC
37089,37CS036,1215,1165,1265,1298,33,83,133,85.04366976816836,98,100.81180938338491,-0.6570797366850339,-0.16749558195632516,0.3387035756687902,1.1712448385463714,1485,1425,1545,1646,101,161,221,137.81008198682184,149,127.59034081178285,-0.3954758700642448,0.10670614852434095,0.5697717881289132,0.9201244660104487,116653,116780,Henderson,Henderson,37,89,North Carolina,NC
37093,37CS037,297,274,319,410,91,113,136,257.8831528432838,40,91.00388662432458,1.1650750977265623,1.67629190582162,2.1474146960242755,0.34980204018597977,373,346,400,499,99,126,153,237.64299940840107,77,145.326891136947,0.4598480994007165,0.9151112756512284,1.424187400127167,0.6067159509442489,52745,52984,Hoke+Scotland,Hoke,37,93,North Carolina,NC
37165,37CS037,337,322,352,484,132,147,162,515.8108193919849,56,196.38212688857067,2.6213588504997594,3.182836849942699,3.729116586310552,0.37815415960341103,414,396,432,550,118,136,154,397.5552487515914,78,228.00350774627304,1.2127963622066218,1.7043675863991936,2.1836391005064852,0.5693278949837306,34219,34210,Hoke+Scotland,Scotland,37,165,North Carolina,NC
37097,37CS038,1422,1341,1503,1614,111,192,273,123.1592899244079,134,85.87862701010995,-0.17856417623024518,0.36477075937049674,0.8796506869673504,0.6936874432605152,1779,1681,1878,2032,154,253,351,132.05146504463212,302,157.83834635586797,-0.7832389999062103,-0.26424020808294235,0.22816963378510227,1.1905669067037101,187241,191335,Iredell,Iredell,37,97,North Carolina,NC
37099,37CS039,339,320,357,381,24,42,61,117.67534876589758,31,86.00957203301657,-0.19140390484152545,0.31353905575558766,0.8282221905446383,0.7140695588662576,417,395,439,464,25,47,69,108.24844444745216,50,115.28706479133041,-0.6001034130629056,-0.06931477326268219,0.46529467757562526,1.0428104916718577,43251,43370,Jackson+Macon+Transylvania,Jackson,37,99,North Carolina,NC
37113,37CS039,422,406,438,463,25,41,57,132.9867154111287,16,52.01842319154701,0.29518237438204703,0.8123884424400079,1.3314307215928929,0.38182059357089504,521,502,541,630,89,109,128,290.10970126394926,90,240.070420656726,-0.02696603907602797,0.5119393270800687,1.032743292789645,0.8199766284465911,36910,37489,Jackson+Macon+Transylvania,Macon,37,113,North Carolina,NC
37175,37CS039,353,339,368,369,1,16,30,56.36180118219391,14,50.58869583546628,-0.4670317414135798,0.05227930968640001,0.5611744266617624,0.8434924571289167,431,414,448,513,65,82,99,246.48852803084895,47,141.814012431356,0.5502816652532806,1.0283974838181436,1.5646741298699776,0.5683795144842243,33209,33142,Jackson+Macon+Transylvania,Transylvania,37,175,North Carolina,NC
37101,37CS040,1416,1322,1509,1536,27,120,214,66.47685940752473,121,66.79025009544749,-0.5496061217434128,-0.003394224162324268,0.47789158025415135,0.9964404153129877,1801,1685,1917,2110,193,309,425,137.22548305997978,249,110.56494691550441,-0.2913713423653685,0.2631173108030225,0.7829140462399803,0.8031185677523682,217397,225207,Johnston,Johnston,37,101,North Carolina,NC
37105,37CS041,533,506,560,646,86,113,140,214.58421873507078,46,87.30033212082871,0.7300426369775398,1.2744858554984102,1.776788898094554,0.40326822153308656,659,626,692,784,92,125,158,194.66193411825822,85,132.7544199412757,0.10008881679043799,0.6246828280317402,1.125233290650526,0.6765461336060186,63230,64028,Lee,Lee,37,105,North Carolina,NC
37109,37CS042,733,695,770,850,80,117,155,161.29056922605122,74,101.64137078497356,0.08940791867281614,0.6043020966140763,1.120435636259487,0.6248543470584712,915,869,962,1057,95,142,188,158.48067720931812,174,194.83137009002553,-0.854295303480911,-0.3541381452138131,0.13497679605050386,1.2207448907689755,87366,89308,Lincoln,Lincoln,37,109,North Carolina,NC
37111,37CS043,448,429,467,541,74,93,112,250.00701324839372,64,171.66998234123875,0.2730624278664492,0.7977027398542158,1.2985892103330043,0.6793716386313058,551,528,574,685,111,134,157,300.5474970760321,110,246.13456848134973,0.007086481406474573,0.5656284731660208,1.0340265504262767,0.8129018945687759,44737,44691,McDowell+Mitchell+Yancey,McDowell,37,111,North Carolina,NC
37121,37CS043,200,194,206,214,8,14,20,112.2470111221946,26,209.45220193340495,-1.4900451886514923,-0.9607306202626106,-0.47291531712161194,1.741040846026774,245,238,253,271,18,26,33,171.67421665667757,36,240.78656946023676,-1.2151314476076975,-0.7005065128064552,-0.2107871567707903,1.3499825110268635,14896,14951,McDowell+Mitchell+Yancey,Mitchell,37,121,North Carolina,NC
37199,37CS043,207,199,215,234,19,27,35,177.22372867758307,19,123.61743656473651,0.008461421563080983,0.5425426140789634,1.0690817969233062,0.6728215175629393,257,247,266,306,40,49,59,262.96785990398934,50,267.1511006625347,-0.5660691551853153,-0.042647487621134225,0.47240870088895726,0.995677472168039,18444,18716,McDowell+Mitchell+Yancey,Yancey,37,199,North Carolina,NC
37119,37CS044,5557,5076,6038,6552,514,995,1476,106.78199393403017,611,65.58063278333972,-0.1204512119236491,0.39960680576990776,0.9266732582200874,0.6135377075891422,6926,6347,7505,7967,462,1041,1620,92.77636312953504,847,75.51025138584045,-0.3379287626065519,0.1828208685665972,0.7050049505961241,0.8131140253022098,1118013,1121702,Mecklenburg,Mecklenburg,37,119,North Carolina,NC
37123,37CS045,252,241,263,314,51,62,73,288.40798089721795,38,175.75640778570053,0.5869581132625422,1.1373221804660247,1.615904963704601,0.5997833626390144,308,294,321,403,82,95,109,369.1860213748135,65,252.06499398921937,0.6454234650097642,1.169559177608354,1.7025005012912364,0.6756616333485155,25945,25787,Montgomery+Moore,Montgomery,37,123,North Carolina,NC
37125,37CS045,1005,962,1048,1118,70,113,156,134.68982658672996,97,115.72417084228107,-0.30833982970478435,0.1830741605456551,0.6685099112313626,0.8516465686623146,1254,1201,1307,1386,79,132,185,128.96141879023762,149,145.52913024368806,-0.6863642666680273,-0.1608038185982301,0.36406791984566456,1.119987924697669,100584,102385,Montgomery+Moore,Moore,37,125,North Carolina,NC
37127,37CS046,934,893,975,1058,83,124,165,156.99603720688683,115,145.3702728326135,-0.38995749324843915,0.12031578316091525,0.6069706793264955,0.9185527398126314,1147,1098,1196,1240,44,93,142,97.86095032911477,133,139.77341992979802,-0.9067727864279267,-0.4438105996697537,0.1329327193274243,1.413110561989005,94930,95154,Nash,Nash,37,127,North Carolina,NC
37129,37CS047,1684,1586,1781,1952,171,268,366,141.46881313924268,88,46.40412012339277,0.4691854574118286,0.9627823558034888,1.429686539245875,0.32679847856120847,2084,1966,2202,2373,171,289,407,126.5257230735709,205,89.68139045527523,-0.11579792811321482,0.36883916826331575,0.88655715194564,0.7063573949649592,227566,228587,New Hanover,New Hanover,37,129,North Carolina,NC
37133,37CS048,1081,993,1169,1205,36,124,212,72.76164030910977,79,46.334084388639354,-0.2574991572428031,0.2615718893865933,0.7890958295110257,0.6317008109609671,1353,1247,1459,1649,190,296,402,143.69892106734042,220,106.82100683654444,-0.12195337911395314,0.37616108466737636,0.9132044467223855,0.740863464856988,204601,205952,Onslow,Onslow,37,133,North Carolina,NC
37135,37CS049,717,653,781,754,-27,37,101,30.146134699366847,52,41.9597347929583,-0.6235227212467672,-0.11784391580861141,0.425145476366554,1.355592782138838,892,816,969,929,-40,37,113,24.543329273313734,51,34.2578473980829,-0.6087309723282391,-0.1017966213947376,0.41692233230635894,1.3586268911434332,148714,148871,Orange,Orange,37,135,North Carolina,NC
37141,37CS050,509,482,535,579,44,70,97,138.2261041720932,31,60.824068018312616,0.27667975361789765,0.7647900121216618,1.3031108767420456,0.4338744676920924,639,606,671,770,99,131,164,210.34790652550333,88,140.82929249283853,0.18090706936771445,0.6959835201260716,1.1906629306298804,0.6644513438517076,61160,62487,Pender,Pender,37,141,North Carolina,NC
37147,37CS051,1074,1000,1148,1393,245,319,393,222.03909612670878,126,87.75646420383643,0.7912088890163562,1.3339068416664623,1.8941780858738624,0.39399392669677313,1330,1241,1419,1667,248,337,426,196.01547262030894,180,104.69011725293132,0.4603994965402371,0.9103493356014676,1.4308105508353723,0.5325110368832972,172295,171936,Pitt,Pitt,37,147,North Carolina,NC
37149,37CS052,244,236,253,275,22,31,39,188.37275301594823,17,104.08694321138833,0.3534483616510793,0.8574845340758316,1.346111595709243,0.5351637210887936,299,289,309,358,49,59,69,300.3475655614173,53,270.2013764975784,-0.23695637203773953,0.31429009779606265,0.7826069387772668,0.8846134429260748,19599,19615,Polk+Rutherford,Polk,37,149,North Carolina,NC
37161,37CS052,713,685,741,889,148,176,204,326.0145995623576,115,212.90053842237614,0.632460082306933,1.14562238605703,1.627588685897552,0.6493524725903592,869,836,903,1122,219,253,286,391.24024537505863,210,325.26873393017564,0.1806186117856621,0.6558009338508733,1.1467617000362145,0.8281001112410877,64819,64562,Polk+Rutherford,Rutherford,37,161,North Carolina,NC
37151,37CS053,1345,1283,1407,1564,157,219,281,181.97433276847195,137,113.93010346572046,0.15307213707283543,0.6787845970621794,1.1918519601866464,0.623229769572301,1658,1583,1733,2047,314,389,464,268.35137141446114,294,202.68872802481903,0.09103868500913141,0.6517808324847001,1.1777661845896608,0.7533754598554975,144299,145050,Randolph,Randolph,37,151,North Carolina,NC
37155,37CS054,1083,1032,1133,1529,396,446,497,452.1590053552693,194,196.6033561071184,2.0520891411175506,2.5711278646945326,3.084294446944047,0.4338378625531949,1317,1257,1377,1932,555,615,675,528.7976061995229,300,257.8803950727653,2.2149479180013314,2.7136333213740897,3.227643851749819,0.4868816876522251,118411,116333,Robeson,Robeson,37,155,North Carolina,NC
37157,37CS055,998,958,1037,1204,167,206,246,271.78453757069434,104,136.98479776082542,0.8350065509538536,1.3422093399314097,1.8362790701875027,0.5015889619817909,1222,1175,1269,1518,249,296,343,324.2785768319962,167,183.03576321529172,0.9197010617141693,1.4259017923159718,1.8874105437849882,0.5625385742212751,91105,91239,Rockingham,Rockingham,37,157,North Carolina,NC
37159,37CS056,1449,1386,1512,1687,175,238,301,195.38513500540455,157,128.70259044704338,0.22313985583726492,0.6774463756067991,1.1628652426666009,0.6559601344989182,1785,1709,1862,2150,288,365,441,246.31124475756144,349,235.83311934912763,-0.4395167379816263,0.11476470162813747,0.5931696611976364,0.9548402721116214,146384,147986,Rowan,Rowan,37,159,North Carolina,NC
37163,37CS057,557,531,582,647,65,90,116,181.69086774164532,57,114.66505733252866,0.17304919269045593,0.6682054100786483,1.1840618722624754,0.6241887575150964,677,646,707,889,182,212,243,359.97660966575694,118,200.01695058903297,1.0944685271499766,1.6075832050592214,2.096964362665455,0.5530346111443999,59652,58995,Sampson,Sampson,37,163,North Carolina,NC
37167,37CS058,623,596,650,718,68,95,122,181.93657982832576,74,141.6290530949457,-0.11266962982309663,0.3971876525075775,0.9105747875035305,0.7703490820933444,768,735,800,922,122,154,187,243.77524329999923,138,217.98881622595016,-0.24183085547314515,0.2501825798555905,0.7946321701248447,0.8884633677370921,62699,63306,Stanly,Stanly,37,167,North Carolina,NC
37171,37CS059,805,775,836,919,83,114,144,191.0447770342877,85,143.02941918837814,-0.06146930127357216,0.4738872657208563,0.9613942284174445,0.7421329957455755,985,948,1021,1087,66,102,139,143.83136243397954,169,237.46961372546264,-1.4430050281211761,-0.9592567885401866,-0.4304656087108789,1.6350545525304925,71314,71167,Surry,Surry,37,171,North Carolina,NC
37179,37CS060,1303,1199,1406,1448,42,145,249,72.77792431495024,117,58.53682942184457,-0.3565485888731543,0.1441714879586191,0.6584790218391502,0.7988296408827523,1637,1511,1762,1997,235,360,486,148.26428492681828,292,120.15867529175513,-0.23851562832724865,0.28138436537928496,0.7890880503764799,0.8081926285564192,239849,243012,Union,Union,37,179,North Carolina,NC
37183,37CS061,5162,4674,5650,5693,43,531,1019,56.278736504648705,449,47.586243442318896,-0.4624954789233754,0.10406645249380891,0.606134712589038,0.8439563784766014,6523,5930,7115,6958,-157,435,1028,37.93103289985853,525,45.74063231850117,-0.5850726896222687,-0.08206404245509474,0.44060310481952464,1.2031259489797583,1132260,1147776,Wake,Wake,37,183,North Carolina,NC
37191,37CS062,1041,990,1091,1316,225,275,326,279.77561880329597,149,151.32152438663158,0.8027518748354684,1.2886351480258174,1.816366424739283,0.5389112075235891,1273,1213,1334,1508,174,235,295,200.76091016392795,191,163.39869281045753,-0.14428172307434864,0.3643382254535387,0.8862186292566518,0.8104434571858341,118159,116892,Wayne,Wayne,37,191,North Carolina,NC
37193,37CS063,688,660,717,827,110,139,167,251.2997792041392,77,139.5390981304177,0.589253492310566,1.130947520102715,1.5995203353880965,0.5512939400594747,839,805,873,1055,182,216,250,328.7442504194598,157,238.54744359188632,0.34486678921432484,0.912494395316772,1.404882329636406,0.7222939482665043,66218,65815,Wilkes,Wilkes,37,193,North Carolina,NC
37195,37CS064,741,707,775,942,167,201,235,304.88241006507997,110,166.6729800371226,0.8577893042166944,1.3894426906814774,1.9042450694702517,0.5439760941843007,904,864,945,1183,238,279,319,355.09114094405373,136,173.396402024658,1.315311476812728,1.81701963728771,2.300658072395366,0.4865681527369943,79197,78433,Wilson,Wilson,37,195,North Carolina,NC
38005,38CS001,51,50,51,91,40,40,41,799.8143538041494,15,296.68699522004283,4.91760673609349,5.033026104707327,5.153930145003369,0.3619928659653064,60,59,60,101,41,41,42,709.411652187093,4,68.61063464837049,6.283526551705916,6.406808716571531,6.52916928949805,0.094431605879706,6067,5830,Benson and Nearby Counties,Benson,38,5,North Dakota,ND
38027,38CS001,39,38,40,32,-8,-7,-6,-366.460129097701,4,206.89655172413794,-6.285110827969236,-5.725155892203865,-5.212135544537952,-0.6573654031660368,48,47,49,49,0,1,2,52.63346478783025,5,214.04109589041096,-2.1382700957259178,-1.6106728825825267,-1.102723483587659,2.2426374619171328,2320,2336,Benson and Nearby Counties,Eddy,38,27,North Dakota,ND
38031,38CS001,37,37,38,52,14,15,15,520.0521986701044,21,749.7768521273431,-2.412458072903487,-2.2960018754156004,-2.1810220272374967,1.3491119183651745,46,46,46,45,-1,-1,-1,-27.646823958139898,3,89.07363420427554,-1.301772363395254,-1.169992361780025,-1.0404595819326483,43.5698401967957,3361,3368,Benson and Nearby Counties,Foster,38,31,North Dakota,ND
38039,38CS001,33,33,33,30,-3,-3,-3,-152.9062169347168,5,262.81208935611033,-4.287405081690263,-4.1577125439061895,-4.046629900642785,-2.6191163959200936,40,40,41,24,-17,-16,-16,-711.4586139489768,1,43.802014892685065,-7.680511380341415,-7.547383483719043,-7.42455897662238,-0.06560560466952264,2283,2283,Benson and Nearby Counties,Griggs,38,39,North Dakota,ND
38069,38CS001,43,43,43,53,10,10,10,299.91734995274436,21,634.6008562075044,-3.4699891634595357,-3.3451321883259104,-3.229219700652396,1.9222381491468865,53,52,53,58,5,5,6,137.62134920479497,4,101.1378002528445,0.23299396566450487,0.36685756920373835,0.49210963049260464,0.6208360948922182,3971,3955,Benson and Nearby Counties,Pierce,38,69,North Dakota,ND
38071,38CS001,115,114,117,150,33,35,36,359.1311192563962,20,207.8461938165757,1.392579779441551,1.5105442432177623,1.626985031740576,0.5624709491593837,142,140,143,126,-17,-16,-14,-136.2627949839583,16,138.2886776145203,-2.8759014247392622,-2.746440465947394,-2.6283308864114177,-1.0835993234695123,11547,11570,Benson and Nearby Counties,Ramsey,38,71,North Dakota,ND
38079,38CS001,110,105,115,159,44,49,54,472.1240223968708,21,202.27965965644563,2.2105449847299425,2.7018449577380155,3.207939841230229,0.4198795595763386,133,126,139,194,55,61,68,509.3452191428967,13,107.74968918358888,3.5186218280793806,4.002252907326228,4.555008556738123,0.208158197933727,12458,12065,Benson and Nearby Counties,Rolette,38,79,North Dakota,ND
38095,38CS001,23,23,23,35,12,12,12,667.3416661765651,4,224.08963585434174,4.312039699178854,4.434392226658969,4.547514644371699,0.30978817383338364,28,28,29,30,1,2,2,81.88851217884844,4,186.9158878504673,-1.1778089607219449,-1.0517425350072838,-0.9168549510819086,1.453269663126672,2142,2140,Benson and Nearby Counties,Towner,38,95,North Dakota,ND
38103,38CS001,55,54,55,60,5,5,6,166.14119806770805,8,244.52368823229747,-0.9155406293859405,-0.7850631547878756,-0.6628167937745955,1.2430880040112655,66,66,67,57,-10,-9,-9,-242.711662822034,3,76.68711656441718,-3.3158624097511207,-3.1940172483479867,-3.075170950437034,-0.3531538893843711,3926,3912,Benson and Nearby Counties,Wells,38,103,North Dakota,ND
38017,38CS002,1012,933,1092,1197,105,185,264,119.98672381062016,153,99.42543363243996,-0.30263547274468794,0.18812117993748206,0.7587364238208242,0.8241732933786355,1267,1171,1363,1289,-74,22,118,11.888590022504712,104,55.81944556262244,-0.9719836557446062,-0.43592015927588673,0.05065537636939177,4.492396650981788,184661,186315,Cass,Cass,38,17,North Dakota,ND
38003,38CS003,111,110,112,151,39,40,41,444.9431561285026,26,289.66669761396344,1.4311205612341316,1.5526696629063779,1.6710021246035662,0.6351167359809307,136,135,138,158,20,22,23,200.43050297799715,12,111.00832562442183,0.7811277189635145,0.8892421351636307,1.0169146399533133,0.52941478458307345,10771,10810,LaMoure and Nearby Counties,Barnes,38,3,North Dakota,ND
38021,38CS003,58,58,59,82,23,24,24,573.9841304375916,35,850.7190601579906,-2.884498564906252,-2.7705220853967414,-2.655473149239907,1.4219166401024774,71,70,72,66,-6,-5,-4,-100.20541168897999,5,101.9160211985324,-2.1422554783530647,-2.0189070290249522,-1.896583100933254,-1.276787806993428,4937,4906,LaMoure and Nearby Counties,Dickey,38,21,North Dakota,ND
38045,38CS003,36,36,37,50,13,14,14,401.86262471132846,14,412.16879293424927,-0.21780835178663235,-0.10461995849386638,0.012194627095741123,0.9556357163537148,44,44,45,36,-9,-8,-8,-206.81780309263448,2,49.164208456243855,-2.6870060833646194,-2.5590822338130312,-2.441942926025024,-0.2697836305541657,4076,4068,LaMoure and Nearby Counties,LaMoure,38,45,North Dakota,ND
38073,38CS003,72,71,72,73,1,1,2,27.01679309907781,5,106.59086871558003,-0.9049721258137272,-0.7943704557170944,-0.6733761444593831,2.2052537878754053,88,88,89,67,-22,-21,-21,-377.182332528977,4,70.43493572812115,-4.6074102419464715,-4.476219578975005,-4.347446957424291,-0.19588461445155514,5629,5679,LaMoure and Nearby Counties,Ransom,38,73,North Dakota,ND
38077,38CS003,128,126,129,136,7,8,10,61.399024419550045,20,145.63990533406152,-0.9753500291206474,-0.8392456165599304,-0.7251439196008306,2.120526253095397,157,155,159,121,-38,-36,-34,-217.69105400251897,3,18.12141347025068,-2.4891569093264945,-2.3551099512342506,-2.2228989669509773,-0.08561948295439319,16479,16555,LaMoure and Nearby Counties,Richland,38,77,North Dakota,ND
38081,38CS003,30,30,31,38,7,8,8,242.58648864648748,5,155.60165975103735,0.7494702785676027,0.8722442522691236,0.9947462666427811,0.5684975603158801,37,36,37,46,9,9,10,241.09112293067957,4,104.41138084051163,1.2383098419067269,1.3683711720281033,1.492776476605174,0.3907699772080494,3856,3831,LaMoure and Nearby Counties,Sargent,38,81,North Dakota,ND
38093,38CS003,211,201,220,244,24,33,43,186.72864379709026,65,364.2817111899869,-2.305525627499703,-1.7882122789812427,-1.2554690214023325,1.8940158641937446,260,249,271,248,-23,-12,-1,-56.26114751370744,15,69.54425332653345,-1.7752235017216231,-1.2562079047680799,-0.7416184887935509,-1.3471077305365238,21412,21569,LaMoure and Nearby Counties,Stutsman,38,93,North Dakota,ND
38009,38CS004,70,69,71,68,-3,-2,-1,-35.39795011299934,21,395.8529688972667,-4.436932377456898,-4.315193518068794,-4.187618057970997,-23.9217756979279,87,86,87,64,-23,-23,-22,-352.62791456491107,4,62.61740763932373,-4.2889503667835625,-4.153247494504648,-4.021577290670754,-0.1858229089129397,6366,6388,McHenry and Nearby Counties,Bottineau,38,9,North Dakota,ND
38049,38CS004,51,50,51,80,29,29,30,650.4843703900694,11,245.49005021387393,3.919717697466347,4.050849421628015,4.168552320978887,0.36487730233653853,62,61,62,75,13,13,14,256.30166299590604,4,76.04562737642586,1.6798906125969884,1.8032595666388989,1.9406469917945826,0.27621510094169094,5377,5260,McHenry and Nearby Counties,McHenry,38,49,North Dakota,ND
38055,38CS004,96,95,97,114,17,18,19,220.99321881245234,22,271.9126583582243,-0.6240871203786732,-0.505168442551188,-0.39681516294446795,1.1652423249020294,120,119,121,113,-8,-7,-6,-69.20139286005251,10,102.15548064153641,-1.8438424235417907,-1.7125670706841907,-1.5857466956288475,-1.7318643310952295,9709,9789,McHenry and Nearby Counties,McLean,38,55,North Dakota,ND
38075,38CS004,24,23,24,30,6,6,7,336.73016099388167,12,631.8560772268539,-3.0766115660342415,-2.948978556037562,-2.823824993045598,1.6227033564200923,29,29,29,31,2,2,2,88.32597813702138,4,176.444640494045,-1.011685428906111,-0.8790263799404019,-0.7568036294885709,1.332289739959044,2279,2267,McHenry and Nearby Counties,Renville,38,75,North Dakota,ND
38083,38CS004,10,10,10,18,8,8,8,757.7170306715312,3,284.8101265822785,4.610713453309093,4.731159608120106,4.844789534557189,0.3340278865586239,12,12,13,19,6,7,7,516.8619946664987,3,236.77979479084453,2.6748680320497713,2.8006375470370024,2.932999119597073,0.3974225045604708,1264,1267,McHenry and Nearby Counties,Sheridan,38,83,North Dakota,ND
38101,38CS004,412,382,442,638,196,226,256,390.4411960544515,159,274.2876858054685,0.6270823771588315,1.160042617719252,1.6834828395011852,0.6994168104291576,509,473,545,569,24,60,96,86.4312231593412,50,72.27104532839962,-0.3936924012951573,0.13668375439317348,0.7014236941749451,0.8224147166361399,69562,69184,McHenry and Nearby Counties,Ward,38,101,North Dakota,ND
38019,38CS005,39,39,39,40,1,1,1,28.763620404480132,4,129.87012987012986,-1.1292697332160002,-1.0136265618409255,-0.8895876148149159,2.120981294302734,48,47,48,57,9,9,10,254.14567337626636,3,81.81074447777475,1.6075420137252698,1.7247270843079834,1.8439308415863152,0.2907111439586667,3696,3667,Northeast North Dakota,Cavalier,38,19,North Dakota,ND
38035,38CS005,456,425,488,486,-2,30,61,48.91430731094537,66,109.19619467806424,-1.1080954043606794,-0.6036688756390122,-0.08139446650100281,2.159359234138025,568,530,605,536,-69,-32,6,-43.40496501370352,37,50.85421334029716,-1.4263741524005913,-0.9279453395070713,-0.4298719326423733,-1.2099351874353486,72530,72757,Northeast North Dakota,Grand Forks,38,35,North Dakota,ND
38063,38CS005,47,47,47,52,5,5,5,203.2386075610249,11,443.54838709677415,-2.525814782531136,-2.401994720208837,-2.2887990912906666,1.8210963346150588,59,58,59,42,-17,-17,-16,-552.5651908100109,6,197.04433497536945,-7.620437189008098,-7.493716136331825,-7.363583116597263,-0.37913230372728557,2976,3045,Northeast North Dakota,Nelson,38,63,North Dakota,ND
38067,38CS005,67,67,68,77,9,10,10,169.388955853953,10,176.21145374449335,-0.19584685549339992,-0.06672936077584357,0.05574518805743154,0.9422563411656563,82,82,83,84,1,2,2,23.011979743536557,5,73.78984651711924,-0.6288843834041968,-0.511319273277785,-0.39378692148633004,1.9536655033707966,6810,6776,Northeast North Dakota,Pembina,38,67,North Dakota,ND
38091,38CS005,15,14,15,13,-2,-2,-1,-111.12187019886525,5,330.9431880860452,-4.5404392998493215,-4.42248365091574,-4.303530439280962,-7.365220997279223,18,18,18,26,8,8,8,440.2797965496556,1,55.309734513274336,3.7265404557885744,3.848517771443542,3.9773004076050857,0.1116039202737943,1813,1808,Northeast North Dakota,Steele,38,91,North Dakota,ND
38097,38CS005,81,80,81,87,6,6,7,97.31470584379639,14,210.36814425244174,-1.2543224570142204,-1.1289027651351777,-1.0095729754658733,1.8725856167028025,99,98,100,95,-5,-4,-3,-51.84509489598686,2,25.003125390673837,-0.8952278415238883,-0.768414611204025,-0.6463720073895258,-0.6355078965243693,7986,7999,Northeast North Dakota,Traill,38,97,North Dakota,ND
38099,38CS005,121,120,122,128,6,7,8,80.76398815087528,22,250.87902689347143,-1.8159019970616699,-1.698837309683864,-1.5806622725670516,2.7219877762309808,148,146,149,121,-28,-27,-25,-255.87752803976812,11,105.00190912562047,-3.7366392411908955,-3.6078834923239307,-3.492486142070557,-0.4262619220340031,10523,10476,Northeast North Dakota,Walsh,38,99,North Dakota,ND
38007,38CS006,8,8,8,4,-4,-4,-4,-506.2013694741079,4,513.9186295503212,-10.322600583955337,-10.201443974325237,-10.07976356330983,-1.3605747647161832,10,10,10,3,-7,-7,-7,-721.3722660942085,3,315.1260504201681,-10.492322158673838,-10.36753886516295,-10.247531262406074,-0.5112941491748497,934,952,Northwest North Dakota,Billings,38,7,North Dakota,ND
38013,38CS006,16,15,16,19,3,3,4,183.96931644345017,3,165.36518144235185,0.05511170542321882,0.18644086590014766,0.31342402126167657,0.6916410542140661,19,19,19,21,2,2,2,92.64498770137342,5,231.16042533518262,-1.5086443824106164,-1.3862840182736247,-1.2569136137164498,1.6644966712443852,2177,2163,Northwest North Dakota,Burke,38,13,North Dakota,ND
38023,38CS006,22,22,23,18,-5,-4,-4,-244.15824283251948,3,163.3393829401089,-4.196787490483464,-4.073840005536796,-3.957211814126808,-0.8609870264521523,27,27,28,30,2,3,3,125.73221664992815,4,182.7318410232983,-0.6972499559011255,-0.5693950626151777,-0.44284335598905733,1.0660190323973922,2204,2189,Northwest North Dakota,Divide,38,23,North Dakota,ND
38025,38CS006,27,27,28,34,6,7,7,191.39910143276907,4,115.91403042743298,0.6423821112688878,0.753071358235793,0.872436561378606,0.5259791633667731,33,32,33,42,9,9,10,230.20083832784613,5,123.60939431396785,0.9427724244110685,1.062937010121397,1.1849338400924665,0.48488967823737983,4141,4045,Northwest North Dakota,Dunn,38,25,North Dakota,ND
38033,38CS006,10,10,10,12,2,2,2,134.1235046728107,1,69.00517538815411,0.5299196099021458,0.6516847853102329,0.7683674520871165,0.33971163189483466,12,12,13,19,6,7,7,370.12344737499103,3,170.06802721088434,1.8675075381244721,2.0023273939508615,2.118261453309991,0.3984604756082775,1739,1764,Northwest North Dakota,Golden Valley,38,33,North Dakota,ND
38053,38CS006,66,65,68,90,22,24,25,194.26279386434692,11,89.85092914028998,0.9181404887916246,1.0402991643125552,1.158659271778151,0.4438594011896568,77,75,79,94,15,17,19,121.92766651947129,17,121.82886627490326,-0.1295924499453591,0.002742576162359727,0.13465909359260464,0.9437216278054624,14691,13954,Northwest North Dakota,McKenzie,38,53,North Dakota,ND
38061,38CS006,77,76,78,108,30,31,32,383.01822082566684,18,219.20032474122183,1.518481296417468,1.6328403682159367,1.7618139174689071,0.5546622827889881,91,90,92,96,4,5,6,51.255177055103616,16,166.5972511453561,-1.2792272584770346,-1.1595036287680118,-1.0361046525096467,2.701540308228942,9854,9604,Northwest North Dakota,Mountrail,38,61,North Dakota,ND
38089,38CS006,213,199,228,258,30,45,59,160.48757236485207,45,161.7395992452152,-0.5261320030569397,-0.00793413989460648,0.4950195390839973,0.9857254939878282,259,242,277,266,-11,7,24,19.856874109593008,28,84.44672316554573,-1.1223772295630758,-0.6366441235407955,-0.09585278396450957,3.692010506469338,33387,33157,Northwest North Dakota,Stark,38,89,North Dakota,ND
38105,38CS006,224,207,242,193,-49,-31,-14,-92.68952542292321,31,92.08604599351438,-2.336214009545877,-1.853635459107801,-1.3229855715851915,-1.0263827949177933,265,245,285,233,-52,-32,-12,-83.15707686815549,30,77.17438839297199,-2.1272879323834504,-1.609435740806665,-1.08504496525134,-0.9576816292660636,40397,38873,Northwest North Dakota,Williams,38,105,North Dakota,ND
38015,38CS007,662,620,704,871,167,209,251,255.76536681823848,161,196.88369391311437,0.06294109743549749,0.5792097867607555,1.1272492320066856,0.7661194482024689,825,774,876,888,12,63,114,64.12064687948863,87,87.99878622363829,-0.7480114770872863,-0.24245021836630687,0.26594321297643475,1.3510811028667087,98129,98865,South Central North Dakota,Burleigh,38,15,North Dakota,ND
38029,38CS007,39,39,39,52,13,13,13,479.5844556456967,11,403.1765424557116,0.6468813896404749,0.763435432288995,0.8890996323227544,0.7809913762107981,48,47,48,45,-3,-3,-2,-82.32973350829394,7,213.87106630003055,-3.0865614756922306,-2.961014099050474,-2.834683075482379,-4.130641138048266,3274,3273,South Central North Dakota,Emmons,38,29,North Dakota,ND
38043,38CS007,18,18,19,24,5,6,6,278.0748683000767,3,150.18773466833542,1.1593434484959035,1.2815201268003924,1.3989102503171673,0.4576976393880564,22,22,23,35,12,13,13,528.2959331618371,6,253.05778152678195,2.6276504159280525,2.7499338712155246,2.8803285738723488,0.44359351460452007,2397,2371,South Central North Dakota,Kidder,38,43,North Dakota,ND
38047,38CS007,22,22,22,25,3,3,3,180.86319624312384,4,255.31914893617022,-0.869697699923009,-0.7487716420951644,-0.6192991425464898,1.0434265229349964,27,27,27,25,-2,-2,-2,-118.4585085362889,2,106.21348911311736,-2.3688203047618765,-2.244455439590611,-2.110704497569486,-1.6252581819529923,1880,1883,South Central North Dakota,Logan,38,47,North Dakota,ND
38051,38CS007,39,39,40,51,11,12,12,554.9957747098257,4,191.54030327214684,3.515974152803385,3.6361256952521606,3.7474595143747766,0.31770838815736224,48,48,49,43,-6,-5,-5,-212.92939772358582,3,119.3792280143255,-3.452466759023285,-3.32052880506624,-3.1923838319230566,-0.6895100163223311,2506,2513,South Central North Dakota,McIntosh,38,51,North Dakota,ND
38001,38CS008,28,27,29,24,-5,-4,-3,-214.55576105224424,3,164.23357664233575,-4.27597256681242,-3.801114971663552,-3.2938626782862963,-1.0276722792585131,34,33,35,40,5,6,7,286.4250436916282,2,92.16589861751152,1.4246194053083292,1.9556088925521913,2.4596559800362496,0.2771840092800569,2192,2170,Southwest North Dakota,Adams,38,1,North Dakota,ND
38011,38CS008,28,28,29,41,12,13,13,510.8765109273056,6,241.5296880241529,2.5668087358148366,2.695633895526495,2.8124070898866065,0.43824333398149684,34,34,34,36,2,2,2,67.69975873995178,5,171.58544955387782,-1.172252055956455,-1.0376507955771526,-0.9081027340604932,1.6819324633456465,2981,2914,Southwest North Dakota,Bowman,38,11,North Dakota,ND
38037,38CS008,29,28,30,37,7,8,9,412.1466893765695,5,262.6970227670753,0.9406721655847115,1.5079899618103003,2.0022262024849247,0.5653214636688838,36,35,37,46,9,10,11,428.7444656598295,4,172.63703064307293,2.0564167838515646,2.570987100036056,3.0924001921010347,0.36583104161224933,2284,2317,Southwest North Dakota,Grant,38,37,North Dakota,ND
38041,38CS008,24,24,24,38,14,14,14,666.8513359300405,8,387.72213247172857,2.672225449703133,2.793274218960465,2.916942539126888,0.542028706061925,29,29,30,24,-6,-5,-5,-218.11067442574344,6,246.30541871921181,-4.780357574173277,-4.645024554029721,-4.5048917107401,-1.3910862806532918,2476,2436,Southwest North Dakota,Hettinger,38,41,North Dakota,ND
38057,38CS008,66,65,67,60,-7,-6,-5,-89.21390397231256,6,86.60091412076017,-1.8835341427318295,-1.7545117943419757,-1.6347934920977847,-1.1580693998007487,82,81,83,91,8,9,10,112.60407403480782,10,120.13455069678041,-0.20145399031853298,-0.0752551607253245,0.06295303722420743,0.9640261009833802,8314,8324,Southwest North Dakota,Mercer,38,57,North Dakota,ND
38059,38CS008,280,265,294,326,32,46,61,168.11458226773385,61,221.37543095626927,-1.042759037406787,-0.5266374488651031,-0.02459800799883117,1.2889872922239254,348,331,365,369,4,21,38,62.17381063391863,32,95.3232052427763,-0.8342710526961155,-0.3247953572872701,0.1453091250397726,1.4630746323419583,33066,33570,Southwest North Dakota,Morton,38,59,North Dakota,ND
38065,38CS008,11,10,11,16,5,5,6,345.9203986777362,2,127.72751463544438,2.063367907126123,2.178748333915481,2.2977898903403915,0.31169461475435856,13,13,13,13,-0,-0,0,-3.0435197932306894,5,267.0940170940171,-2.816971267054196,-2.701316934656184,-2.5697874569927297,5.30208463101195,1879,1872,Southwest North Dakota,Oliver,38,65,North Dakota,ND
38085,38CS008,33,32,33,53,20,20,21,615.1576477281134,3,91.76650522559267,5.109592404498367,5.231754719573158,5.34959860733349,0.1421091832002188,39,38,39,57,18,18,19,484.22229345847967,5,133.01409949454643,3.3868284093876104,3.5110735235773647,3.644598773668968,0.26039068169595975,3923,3759,Southwest North Dakota,Sioux,38,85,North Dakota,ND
38087,38CS008,9,9,9,4,-5,-5,-5,-844.3720268533663,4,677.9661016949152,-15.723424083150949,-15.23531003336762,-14.733285706897686,-1.0045720690681408,11,10,11,2,-9,-9,-8,-1266.9811128539488,2,289.01734104046244,-16.084390357346006,-15.556384240839206,-15.068935632101274,-0.2574827943566884,708,692,Southwest North Dakota,Slope,38,87,North Dakota,ND
39001,39CS001,305,294,317,347,30,42,53,181.65086808083188,30,131.02820746132846,0.012658561964551526,0.5183659498098904,1.0271893248966544,0.70438276340024,375,360,389,515,126,140,155,509.68094248986506,95,345.128242389014,1.1637751700779326,1.6532967499799305,2.1501835023769087,0.6723532358020083,27475,27526,Adams+Brown,Adams,39,1,Ohio,OH
39015,39CS001,457,438,475,544,69,87,106,240.62783002414943,30,82.54987388213712,1.0634461965671598,1.5792612058929734,2.0945844423842557,0.3391817159228594,560,538,583,681,98,121,143,276.98766900772296,118,270.28884256820214,-0.44465245801039105,0.06981863327065085,0.6003246838852425,0.9678119947642083,43610,43657,Adams+Brown,Brown,39,15,Ohio,OH
39003,39CS002,969,925,1013,1178,165,209,253,246.11958118472813,172,202.2022806536306,-0.038125860603663346,0.43668762626636987,0.9576790574350209,0.8176555808945828,1184,1132,1237,1359,122,175,227,171.79919823980603,215,211.34998574616372,-0.8971144982588853,-0.40516063197346863,0.12725336295780706,1.2232160461753114,102076,101727,Allen,Allen,39,3,Ohio,OH
39005,39CS003,489,467,512,570,58,81,103,184.38038374891718,69,157.5492341356674,-0.23459276100277984,0.2703124236261733,0.7677941424959307,0.8440271412494733,598,571,625,725,100,127,154,242.45639813264813,104,198.73497544476504,-0.030695598471446692,0.43329273593682577,0.9709417144117548,0.8132633384567255,52555,52331,Ashland,Ashland,39,5,Ohio,OH
39007,39CS004,1034,992,1076,1111,35,77,119,94.62282756415475,125,154.07054376630578,-1.077213579365471,-0.6033514747360053,-0.0755971836473857,1.6073226627050583,1265,1215,1316,1543,227,278,328,285.2483141148286,229,235.23852570160662,0.0028220953352986024,0.48071910067671914,1.02860757015529,0.8217206125023959,97358,97348,Ashtabula,Ashtabula,39,7,Ohio,OH
39009,39CS005,415,388,442,494,52,79,106,150.42976280611794,25,47.777547737733116,0.5511366224600168,1.0129541405393259,1.5011554148037816,0.3136226634062952,514,482,546,648,102,134,166,216.48503420787372,77,123.99555548398526,0.4178692062950889,0.9113252718999866,1.4196470668041008,0.5685382394996877,62791,62099,Athens+Hocking,Athens,39,9,Ohio,OH
39073,39CS005,273,261,285,328,43,55,67,237.01264178315594,42,179.7175866495507,0.04386884824778508,0.5828878202132576,1.071337007434867,0.7448148334175895,336,322,351,434,83,98,112,347.6711512495493,68,242.1393725741552,0.5261439134097032,1.0527846688076574,1.5638603278870131,0.6894000426202282,28044,28083,Athens+Hocking,Hocking,39,73,Ohio,OH
39011,39CS006,416,396,436,541,105,125,145,324.29177345829095,66,171.18402282453638,1.040517132855016,1.5566241311690934,2.0531403557061854,0.5236819563111931,507,483,531,609,78,102,126,220.93174571912556,86,186.2278042442616,-0.19753354621466687,0.35097529428217783,0.8584521052423191,0.8347384750329071,46266,46180,Auglaize+Mercer,Auglaize,39,11,Ohio,OH
39107,39CS006,355,337,373,456,83,101,119,286.17008236040556,75,212.8817087305154,0.2478001957950074,0.7324598586025586,1.2081839510939456,0.736593231485799,434,413,456,460,4,26,47,60.24714362364057,37,87.40226300994496,-0.755832384013088,-0.28275727368653697,0.28778238895102337,1.3959933995533034,42277,42333,Auglaize+Mercer,Mercer,39,107,Ohio,OH
39013,39CS007,741,712,769,879,110,138,167,249.94602309549626,98,177.36753993031988,0.1881140914517545,0.7284455916015061,1.2053268135384558,0.7045218911742493,901,867,935,1119,184,218,252,330.7518866421504,166,251.87770275396406,0.29130285730254046,0.7795987639736647,1.2943983292746217,0.75805306638261,66303,65905,Belmont,Belmont,39,13,Ohio,OH
39017,39CS008,3004,2837,3172,3648,476,644,811,198.2416563151735,399,122.91389096398068,0.2295505316776999,0.7454075499870367,1.2706773754684384,0.619058523095549,3699,3498,3901,4220,319,521,722,133.44839153934285,547,140.15327182304304,-0.5758270978825012,-0.04735239153099857,0.45326164117694895,1.04823063635412,389541,390287,Butler,Butler,39,17,Ohio,OH
39019,39CS009,275,263,286,331,45,56,68,252.99261619824495,27,121.20305252132275,0.7787324816577421,1.3202967206767533,1.8545916283757111,0.4707250692116729,338,324,351,398,47,60,74,226.65279269500041,81,303.47308081375746,-1.272057059754014,-0.7689416141831971,-0.2483543915436269,1.3171610478997857,26732,26691,Carroll+Harrison+Tuscarawas,Carroll,39,19,Ohio,OH
39067,39CS009,169,163,175,198,23,29,35,237.0357864562175,17,139.98490358882864,0.43880267462716177,0.9737540907784981,1.48645929615754,0.5707375288192654,207,199,214,288,74,81,89,561.5488856942643,46,317.70149872228745,1.927206338196348,2.444203821480915,2.9296882873815417,0.5588854927912864,14573,14479,Carroll+Harrison+Tuscarawas,Harrison,39,67,Ohio,OH
39157,39CS009,949,909,989,1157,168,208,248,269.1740747106987,178,230.0534206444942,-0.1661197832608052,0.3990892866687241,0.8926719208787223,0.8505800623347926,1163,1115,1211,1374,163,211,259,227.74362153665044,266,287.3128685921669,-1.1118721883274905,-0.6058099282009834,-0.11350904248120862,1.2556077537456067,92848,92582,Carroll+Harrison+Tuscarawas,Tuscarawas,39,157,Ohio,OH
39021,39CS010,350,334,367,432,65,82,98,253.16644088507667,36,111.52128455998142,0.9225028584806759,1.418455033754214,1.934580958935443,0.43518080523946545,428,408,448,502,54,74,94,190.94500975887254,77,198.96640826873386,-0.5986413473783406,-0.07895088742808937,0.46426656142394,1.0280961483204487,38737,38700,Champaign+Logan+Madison+Shelby,Champaign,39,21,Ohio,OH
39091,39CS010,440,420,459,473,14,33,53,87.34319736660647,43,112.19098558476288,-0.7573718788698374,-0.24119804360779842,0.25516985639040773,1.2472276749889755,537,513,561,624,63,87,111,188.5517427933367,98,212.8630074502053,-0.744897077100277,-0.24932608049728067,0.2562726248226664,1.1160798573254773,45993,46039,Champaign+Logan+Madison+Shelby,Logan,39,91,Ohio,OH
39097,39CS010,362,343,381,395,14,33,52,89.79547770685443,45,122.65479489392632,-0.8601957165983003,-0.3356329696765607,0.23006047850349132,1.3256948102711807,447,424,470,557,87,110,133,248.67991185923026,68,153.4850126399422,0.453798114588398,0.9641475501726521,1.460811219783175,0.6116474871540852,44026,44304,Champaign+Logan+Madison+Shelby,Madison,39,97,Ohio,OH
39149,39CS010,396,375,416,518,102,122,143,304.58151038001256,54,134.51518485458658,1.174857571506996,1.7018612672027893,2.239255131057037,0.4380567152572136,483,459,508,597,89,114,138,236.6264430442177,104,216.6756948206175,-0.3502340913939887,0.20856328416938538,0.6780122868297348,0.907694771921215,48173,47998,Champaign+Logan+Madison+Shelby,Shelby,39,149,Ohio,OH
39023,39CS011,1505,1447,1563,1775,212,270,328,239.05115841415238,209,185.08542120216967,-0.0011111709093352313,0.5450063501883976,1.065120084953775,0.7713925986230482,1836,1766,1906,2135,229,299,369,220.5867298065159,235,173.2450643586984,-0.05344703500063869,0.4887620512426731,0.9957505920496121,0.7827669348859297,135505,135646,Clark,Clark,39,23,Ohio,OH
39025,39CS012,1600,1510,1690,1865,175,265,355,152.53030344732014,147,84.61243284727551,0.1578191782274105,0.6949292484244494,1.1613188189826076,0.5526399297886307,1977,1869,2086,2409,323,432,540,205.9855552252235,288,137.47344805365285,0.1528703207174829,0.6646298491765553,1.197104768577104,0.6658506313922353,208480,209495,Clermont,Clermont,39,25,Ohio,OH
39027,39CS013,388,370,406,475,69,87,105,249.4852708585484,45,128.65720003812064,0.6786614389517452,1.2057736209966323,1.747690907848433,0.5098478149476766,475,454,497,574,77,99,120,235.1202132551293,85,202.39059002809657,-0.1905264195006023,0.3190127351999722,0.8234093546358536,0.8521663161692364,41972,41998,Clinton+Fayette+Highland,Clinton,39,27,Ohio,OH
39047,39CS013,321,309,333,336,3,15,27,62.14665739857714,31,128.85348112227226,-1.161708585443476,-0.6619846711393098,-0.1767229540646695,1.9433969961743491,392,377,407,441,34,49,64,169.10106305640554,65,224.82792016879387,-1.0355117185931364,-0.5608561810901191,-0.061814636543623,1.3028974265471638,28870,28911,Clinton+Fayette+Highland,Fayette,39,47,Ohio,OH
39071,39CS013,431,413,450,486,36,55,73,151.67752170178625,41,113.63636363636364,-0.13055617351258691,0.3822282613335849,0.8975295244626015,0.7357526457947636,528,506,550,642,92,114,136,262.9876502126531,102,235.29954554891694,-0.24135379106705163,0.2680946602198317,0.7642897055522672,0.8869371133131997,43296,43349,Clinton+Fayette+Highland,Highland,39,71,Ohio,OH
39029,39CS014,1105,1061,1148,1284,136,179,223,211.89479252296354,161,190.15186559451985,-0.2940166347558234,0.20823879574249649,0.7422154898125012,0.892413929877316,1348,1295,1400,1625,225,277,330,273.661315622917,251,247.64930490464022,-0.2297578919118166,0.2615953552748046,0.7709249115165696,0.9016972100502375,101603,101353,Columbiana,Columbiana,39,29,Ohio,OH
39031,39CS015,360,345,376,426,50,66,81,215.6675009798933,37,121.46081247435369,0.4176446220265764,0.9457595308547105,1.4548822886406556,0.5547416638579079,444,425,463,550,87,106,125,290.4987674806583,98,267.70104895104896,-0.2995772643331739,0.24805732215017587,0.7689743442230473,0.9129375366853828,36555,36608,Coshocton+Holmes,Coshocton,39,31,Ohio,OH
39075,39CS015,295,276,314,372,58,77,96,208.36730223027809,75,203.7259207279806,-0.4411413469197158,0.05219332222044072,0.5599522816739787,0.9651430739079252,368,345,391,418,27,50,73,113.32324952272113,77,173.97198373248983,-1.087418572256325,-0.6280842557002363,-0.052547731754345496,1.5051741758365997,44177,44260,Coshocton+Holmes,Holmes,39,75,Ohio,OH
39033,39CS016,488,470,506,584,78,96,114,275.55476965489515,75,215.14629948364887,0.14125265111562724,0.6055627555258521,1.1405801783124985,0.7727307027482756,596,574,617,722,105,126,148,302.41603733891975,100,239.3546997295292,0.10999677157661654,0.6265231513029565,1.1307678873782454,0.7852597556955854,41832,41779,Crawford+Richland,Crawford,39,33,Ohio,OH
39139,39CS016,1292,1238,1346,1455,109,163,217,157.28235639159726,141,136.04238862132456,-0.32611634879139445,0.21441939279681427,0.7054749297011422,0.8596827750296,1591,1526,1656,1784,128,193,258,154.27784783417246,281,224.54312266766817,-1.2238089653855786,-0.7046064068093799,-0.15705024516066352,1.4479466245512822,124373,125143,Crawford+Richland,Richland,39,139,Ohio,OH
39035,39CS017,11937,11396,12478,13820,1342,1883,2424,179.84094819119557,1496,142.8612355204981,-0.1647925606721888,0.3653517812644785,0.8994958183645198,0.7939538684165174,14539,13893,15185,15985,800,1446,2092,115.57378445642321,1677,134.03325815109233,-0.7019253357992143,-0.18224809533613473,0.32527393975479585,1.1589188055377622,1256604,1251182,Cuyahoga,Cuyahoga,39,35,Ohio,OH
39037,39CS018,542,520,564,607,43,65,87,150.7055810622328,98,227.2463768115942,-1.2709739921247432,-0.761958816365525,-0.22628618812012735,1.4850333977626193,663,637,690,727,37,64,90,123.45711003437239,106,205.2712097445729,-1.3379580615528177,-0.820353634407912,-0.31799481261918383,1.63701464183094,51750,51639,Darke+Preble,Darke,39,37,Ohio,OH
39135,39CS018,414,396,431,486,55,72,90,211.59605913028196,70,205.19334587292667,-0.45902696865887616,0.06937983010068073,0.619744714221368,0.9564901868482153,507,486,529,631,102,124,145,302.18080489918555,92,225.04341870306502,0.26103140369324773,0.770583140433172,1.2873220379125667,0.7387509023918144,40937,40881,Darke+Preble,Preble,39,135,Ohio,OH
39039,39CS019,352,335,368,409,41,57,74,179.83298564139852,70,219.99895238594104,-0.9168573959202172,-0.37953402246335677,0.0986371011376572,1.2023388827313148,432,412,452,486,34,54,74,141.32451035398265,65,170.35328650801972,-0.8362014345732767,-0.28106698868598634,0.21223583406338906,1.1834582360868893,38182,38156,Defiance+Williams,Defiance,39,39,Ohio,OH
39171,39CS019,368,353,384,368,-16,-0,15,-1.420234756352345,51,165.60681910431606,-2.1704657074985905,-1.6906118588559897,-1.1725689134151995,90.64622147318832,450,431,469,517,48,67,86,183.0452238010791,87,236.66385571665623,-1.044150283172928,-0.5464033427055744,-0.0588132006679623,1.2739925242234407,36955,36761,Defiance+Williams,Williams,39,171,Ohio,OH
39041,39CS020,1050,957,1142,1241,99,191,284,106.87154407852341,89,49.70192804389406,0.052176896332422555,0.58072381052635,1.0899096099111332,0.46264480515120104,1339,1225,1452,1526,74,187,301,85.20184828977885,132,60.024009603841534,-0.27038051036790484,0.2584637705760744,0.7296938405120217,0.7007519172775718,214881,219912,Delaware,Delaware,39,41,Ohio,OH
39043,39CS021,827,795,859,1025,166,198,230,316.09871958808907,114,181.9463471078777,0.8472972554362385,1.3497664130058233,1.8415319933282517,0.5727080876650614,1006,967,1044,1136,92,130,169,174.07170014899134,111,148.12640119568698,-0.2644444612572693,0.2569002546049621,0.7790515378463805,0.844476561519782,75187,74936,Erie,Erie,39,43,Ohio,OH
39045,39CS022,1214,1146,1283,1439,156,225,293,169.24297027416705,136,102.45206975780631,0.1542522686085172,0.6601446554377668,1.1354609021508524,0.6026723710050891,1511,1428,1594,1816,222,305,388,189.44943524077752,221,137.42499144980255,0.017601117531575252,0.5141071124830033,1.0082116953068376,0.7230182291830934,159294,160815,Fairfield,Fairfield,39,45,Ohio,OH
39049,39CS023,8660,8091,9229,10063,834,1403,1972,127.2971537818442,1033,93.69777403537627,-0.15976864321657477,0.3438409855156802,0.8020447234846564,0.7355314335365379,10669,9987,11352,11859,507,1190,1872,90.01834347984489,1056,79.89148073866332,-0.35946247111490837,0.10458853130170331,0.6191775853278683,0.886756967766972,1322977,1321793,Franklin,Franklin,39,49,Ohio,OH
39051,39CS024,378,360,396,450,54,72,90,203.6069880247504,47,132.5904506664786,0.22161615022400746,0.7179824563997469,1.1867990837691362,0.6423082682630852,463,441,485,545,60,82,104,192.81140107933868,103,242.49558563861095,-1.0259648769671523,-0.5073933781303519,0.015366825987465832,1.2425111169641254,42537,42475,Fulton+Henry,Fulton,39,51,Ohio,OH
39069,39CS024,255,244,267,315,48,60,71,259.58661129947274,50,218.03117845851955,-0.06893820830888371,0.42302424873412525,0.9383645199972046,0.8260407750322737,313,299,328,370,42,57,71,205.56104627458947,45,163.33345432107728,-0.08471182043828408,0.41738270650334974,0.9157238416287523,0.7807874395731852,27519,27551,Fulton+Henry,Henry,39,69,Ohio,OH
39053,39CS025,324,311,336,381,45,57,70,235.41877521213772,30,122.9298275567697,0.5623688343100365,1.1233496408423302,1.6515776254755137,0.5132417196191524,395,380,410,439,29,44,59,150.07783281499957,63,216.02715769982512,-1.1696953631717595,-0.6401355268657385,-0.17581923725832807,1.4072803810466732,29285,29163,Gallia+Meigs,Gallia,39,53,Ohio,OH
39105,39CS025,251,242,261,299,38,48,57,257.14074498090696,22,118.8118811881188,0.8940567808700486,1.388573932434827,1.8768219452921984,0.4525455155455622,306,295,318,380,62,74,85,334.51749553496836,49,222.1315562808831,0.5757477855218681,1.1125044111245062,1.640107818042148,0.6551571656158452,22220,22059,Gallia+Meigs,Meigs,39,105,Ohio,OH
39055,39CS026,732,691,773,887,114,155,196,196.00589027717965,118,148.91155747186875,-0.08395507291103918,0.4686871185285317,0.9420293512651233,0.754869865959357,904,855,953,1095,142,191,240,200.11493531685733,109,114.09908825407459,0.33928074681107645,0.8814276990992953,1.3816153673356737,0.567200810150086,95090,95531,Geauga,Geauga,39,55,Ohio,OH
39057,39CS027,1320,1248,1393,1595,202,275,347,195.8529050010827,169,120.52847098817894,0.2292940350363638,0.76048909658767,1.2536304766219197,0.6131702077410369,1629,1542,1716,1913,197,284,371,168.8622413728048,255,151.46475326094705,-0.3629489340154475,0.18220978850449177,0.6922980568605356,0.8938282262418362,168259,168356,Greene,Greene,39,57,Ohio,OH
39059,39CS028,407,391,424,458,34,51,67,158.45490587088725,38,118.59557867360206,-0.11283908563235387,0.3887914722830701,0.8839427732852145,0.7339932572482141,497,477,517,656,139,159,179,414.83062057370023,74,193.20139940473084,1.685245638866014,2.212521803824742,2.693565407423707,0.46282274859868267,38450,38302,Guernsey+Monroe+Noble,Guernsey,39,59,Ohio,OH
39111,39CS028,146,140,152,163,11,17,23,153.5716770367693,27,241.7369245691263,-1.356942630076133,-0.8859130244356911,-0.37126733176472515,1.4873839628675276,178,171,185,235,50,57,64,428.73960124355455,37,277.5069376734418,1.00953616034596,1.5038502806739857,1.9975961289615332,0.6361339447502656,13403,13333,Guernsey+Monroe+Noble,Monroe,39,111,Ohio,OH
39121,39CS028,120,118,121,135,14,15,17,130.71341696379048,32,271.3397399660825,-1.5288207931061593,-1.403314007610908,-1.2892292081534376,1.9493807975161086,148,146,149,162,13,14,16,102.15539092460209,19,134.15236884840783,-0.44868826804950224,-0.31966899937889326,-0.19180345515905367,1.2283211009498116,14152,14163,Guernsey+Monroe+Noble,Noble,39,121,Ohio,OH
39061,39CS029,6946,6590,7302,7950,648,1004,1360,145.51014763463613,802,116.24943379133323,-0.2683461193199175,0.28733364417509205,0.8079585963765539,0.7981144233405778,8496,8069,8923,9038,115,542,969,65.56270944653211,928,112.25503181970487,-0.9632428712943316,-0.46704317355680997,0.01694401494981145,1.7090248629456046,827875,826689,Hamilton,Hamilton,39,61,Ohio,OH
39063,39CS030,663,631,695,766,71,103,135,164.46233163958263,96,153.72913247127588,-0.3973648891018836,0.08988055683592916,0.6117727239224352,0.9257240081746647,811,772,849,920,71,109,148,146.05800098648456,136,182.1078989301161,-0.8728715319790847,-0.369248760245412,0.16298883649610407,1.235492325430518,74937,74681,Hancock,Hancock,39,63,Ohio,OH
39065,39CS031,267,254,280,340,60,73,86,283.37007957639184,47,183.0693326408725,0.48602046321281384,1.0026040499138889,1.5055169192457636,0.6372834253421693,327,311,343,486,143,159,175,519.7303417043878,80,261.13069591330463,2.125413337314127,2.5657165467382215,3.0856713833814595,0.4992991478771075,30808,30636,Hardin+Wyandot,Hardin,39,65,Ohio,OH
39175,39CS031,218,209,227,274,47,56,65,308.4366186704293,34,186.89876316994958,0.716754450371854,1.2018741712145273,1.6915586046330264,0.5953448076006924,266,254,277,304,27,38,50,177.0142677088231,49,225.5050853697823,-0.9778724115025192,-0.4755112375503187,0.022677369224362594,1.241655875170004,21830,21729,Hardin+Wyandot,Wyandot,39,175,Ohio,OH
39077,39CS032,527,502,553,652,99,125,150,255.85739514800568,79,162.30931223997126,0.447082765036642,0.9288483131751778,1.4260480809251272,0.6293206514503863,649,619,679,733,54,84,114,144.16510014066256,107,183.28822501627326,-0.9091548937524869,-0.3882264647106331,0.08878541226894827,1.2564480715391775,58407,58378,Huron,Huron,39,77,Ohio,OH
39079,39CS033,373,359,387,405,18,32,46,118.08017644677676,36,132.56006628003314,-0.6098664314346262,-0.13896465629224225,0.37618521353889345,1.0886781611128429,458,441,475,519,44,61,78,187.7809025448363,80,245.92683676606208,-1.115942437113039,-0.5816503342977707,-0.05720603929233127,1.2885533636688442,32589,32530,Jackson+Pike+Vinton,Jackson,39,79,Ohio,OH
39131,39CS033,315,304,327,363,36,48,59,211.34948484994794,14,61.853392732226354,0.930088144499664,1.5084014581234533,1.9932243174049429,0.2866667526730563,387,373,401,481,80,94,108,346.36844783282794,74,273.23413211239523,0.19767449275104354,0.7436215363784998,1.2820910177587377,0.7805333569359445,27161,27083,Jackson+Pike+Vinton,Pike,39,131,Ohio,OH
39163,39CS033,137,132,143,163,20,26,31,239.6941663866815,10,93.67681498829039,0.9485664941887821,1.4703563675382494,1.9909904126697033,0.376118686115876,168,162,175,226,51,58,64,454.3666843512014,35,275.3953890943426,1.2664169142571702,1.7961224260460038,2.3027924367920494,0.59579070211623,12810,12709,Jackson+Pike+Vinton,Vinton,39,163,Ohio,OH
39081,39CS034,783,755,811,867,56,84,112,153.86696515789382,91,167.66467065868264,-0.6247170408398183,-0.15609405073005037,0.3962055933113398,1.0767791409951852,951,918,985,1178,193,227,260,349.9135370604555,170,262.20405645099095,0.38768564130892563,0.8762414581399541,1.374524118660621,0.7460510582078841,65130,64835,Jefferson,Jefferson,39,81,Ohio,OH
39083,39CS035,532,505,559,642,83,110,137,209.7911960085977,73,139.70846225000798,0.17098390433389551,0.6893964011519912,1.2326634658710034,0.6599204330614277,650,618,683,816,133,166,198,263.2159906851139,125,198.79767168166927,0.08828291862416275,0.6409484243680801,1.177190425522612,0.7507284289884881,62702,62878,Knox+Morrow,Knox,39,83,Ohio,OH
39117,39CS035,276,261,291,320,29,44,59,150.42412870862725,26,89.04363709009961,0.059913470989526325,0.6176593641598994,1.1182880956654753,0.578773370243681,338,320,356,416,60,78,96,222.1748938144104,58,165.1292563489352,0.07082906042674951,0.5733042214506949,1.132875866633937,0.7338362163313132,35039,35124,Knox+Morrow,Morrow,39,117,Ohio,OH
39085,39CS036,2183,2083,2283,2476,193,293,393,151.48696796040952,246,127.25234934046038,-0.24697474029095434,0.2594924677206797,0.7209623057971665,0.8371630796350422,2675,2555,2795,3088,293,413,533,177.981932719236,359,154.6887051391983,-0.2976251242569806,0.23701169068123007,0.7535049996910836,0.8670268466435334,231980,232079,Lake,Lake,39,85,Ohio,OH
39087,39CS037,703,678,728,814,86,111,136,229.37004453311988,59,121.50751699045789,0.5460627327776431,1.0883144832107563,1.6200322465628796,0.5250303878912673,851,821,880,1088,208,237,267,412.29440297188785,137,238.07455035189852,1.2106890556098626,1.7509969971520485,2.2487988675945467,0.5750146139361861,58268,57545,Lawrence,Lawrence,39,87,Ohio,OH
39089,39CS038,1477,1401,1554,1618,64,141,217,94.3932759937213,156,104.79175996417375,-0.6078911549782248,-0.09508411900354634,0.3887023984295073,1.1023167314271056,1830,1737,1923,2179,256,349,442,193.70098356036948,247,137.10796558423536,0.05277021888208473,0.5651786890409009,1.1044444316988604,0.7058104334620475,178640,180150,Licking,Licking,39,89,Ohio,OH
39093,39CS039,2763,2628,2898,3103,205,340,475,130.22191620916706,314,120.33609795511668,-0.44333542596117315,0.09848561101371384,0.611603184256455,0.9213732838053225,3412,3249,3575,4045,470,633,796,200.70885694115358,497,157.6426555016335,-0.11421448077023828,0.4236955938252768,0.9993373691734491,0.7841902038188145,313123,315270,Lorain,Lorain,39,93,Ohio,OH
39095,39CS040,3935,3750,4120,4860,740,925,1110,258.0389622739786,591,164.81524517778294,0.4290331347751459,0.921332855856628,1.4493738832519278,0.6380327691936887,4823,4601,5045,5498,453,675,897,157.19289651721041,602,140.19072459043116,-0.30168672481734216,0.17563378195258475,0.6611768426004961,0.8905195335993162,430300,429415,Lucas+Ottawa,Lucas,39,95,Ohio,OH
39123,39CS040,429,412,446,506,60,77,94,229.84335977541738,54,160.86190204304543,0.20436680486825942,0.6970153152345272,1.2219964263866494,0.6909214159281016,523,503,544,626,82,103,123,255.8867865696742,72,179.43030876965634,0.23574616775427099,0.7578538633132573,1.2719910368979932,0.694446515146154,40283,40127,Lucas+Ottawa,Ottawa,39,123,Ohio,OH
39099,39CS041,2566,2468,2664,3285,621,719,817,378.9727379971861,476,250.78920447310992,0.7596178193767601,1.2865294299802887,1.768229164481316,0.6608418044690488,3118,3001,3235,3624,389,506,623,222.83604680251204,459,202.26055919095776,-0.30072993701310213,0.2154458058629243,0.7455195916748788,0.9058740017541469,227761,226935,Mahoning,Mahoning,39,99,Ohio,OH
39101,39CS042,665,637,693,709,16,44,72,81.23567072388734,111,203.9472676884445,-1.7704059293806242,-1.2207490807146792,-0.6993714416833373,2.455035757164446,814,780,847,934,87,120,154,184.24630214961994,120,183.7615999509969,-0.48839353325957274,-0.009573191244695967,0.4691137322999308,0.9891480547970579,65311,65302,Marion,Marion,39,101,Ohio,OH
39103,39CS043,1338,1259,1416,1593,177,255,334,167.94732885093268,182,119.83407589491472,-0.02903291993106627,0.4733257175533258,0.9799328521966806,0.7107353712622484,1653,1559,1748,2004,256,351,445,191.59073543985068,245,133.870271510767,0.07563937263814657,0.5723875303161011,1.0968501069079133,0.6967433169255254,182252,183013,Medina,Medina,39,103,Ohio,OH
39109,39CS044,989,943,1036,1096,60,107,153,117.827059957004,130,143.6450861410116,-0.7855988674422743,-0.2512284919982571,0.2571948947274837,1.2077915058912678,1219,1163,1275,1465,190,246,302,225.37586437023498,257,235.35014056905285,-0.6159565371668128,-0.09946747245804846,0.39759162886585964,1.0400302792918232,108601,109199,Miami,Miami,39,109,Ohio,OH
39113,39CS045,5413,5182,5643,6341,698,928,1159,207.88646387266962,692,154.95659573197585,0.04066051806513514,0.5391482866817866,1.042364174222937,0.7445884659481343,6624,6347,6900,7364,464,740,1017,138.15608045636282,886,165.3123863010887,-0.792213904021192,-0.2678534837488393,0.20210458499491152,1.1949487047271525,535892,535955,Montgomery,Montgomery,39,113,Ohio,OH
39115,39CS046,149,144,155,188,33,39,44,333.94391737814146,16,138.66820742452694,1.4380988311832639,1.95172276831283,2.4675672770695924,0.4047398851840676,182,175,189,267,78,85,92,622.459654570087,36,262.94646117887663,3.0762628891590844,3.584718206028215,4.073713983985698,0.41753192761395214,13846,13691,Morgan+Perry,Morgan,39,115,Ohio,OH
39127,39CS046,312,296,327,372,45,60,76,203.94794509170518,36,121.54633954195036,0.2675372218211149,0.8257140829896222,1.365419498173652,0.5862620987081046,383,365,402,491,89,108,126,303.64960252209005,66,186.14095947203654,0.6720388442118767,1.1704847330262762,1.697486648561476,0.6073710575493523,35542,35457,Morgan+Perry,Perry,39,127,Ohio,OH
39119,39CS047,865,828,902,983,81,118,155,164.5345163690234,84,116.79508719077688,-0.041228802448558144,0.4822319952766406,0.9787877901284074,0.7039031706887191,1059,1015,1104,1181,77,122,166,140.99742315122427,165,190.97664297784672,-1.0179514568267896,-0.4973442731147354,0.017956517393372208,1.3434408541255687,86305,86398,Muskingum,Muskingum,39,119,Ohio,OH
39125,39CS048,182,173,190,204,14,22,31,143.26995858187064,28,178.7994891443167,-0.8341972677597774,-0.3628719544488616,0.1453964032401972,1.1947392806175294,223,213,233,220,-13,-3,7,-16.3910555807208,42,222.68172419277874,-2.892264733883858,-2.4028543746770135,-1.9059815895274255,-20.081118221351463,18792,18861,Paulding+Putnam+Van Wert,Paulding,39,125,Ohio,OH
39137,39CS048,272,257,287,350,63,78,93,273.5349425515352,81,283.42323953929144,-0.6155128168620438,-0.09674641944071882,0.4003665398474486,1.023063034737909,334,317,352,381,29,47,64,135.63923403168397,56,163.13688932909955,-0.8167837528512392,-0.2677555649777615,0.20436381337792695,1.1774382677046895,34295,34327,Paulding+Putnam+Van Wert,Putnam,39,137,Ohio,OH
39161,39CS048,282,269,294,342,48,60,73,251.17887544316775,56,233.59288097886537,-0.36101767130578793,0.1595825604218482,0.6639945402598199,0.9147942790742897,344,330,359,402,43,58,72,200.15434014114385,66,229.54126525927728,-0.825691375875237,-0.2867233031864377,0.2505402864041521,1.1272344074860323,28768,28753,Paulding+Putnam+Van Wert,Van Wert,39,161,Ohio,OH
39129,39CS049,530,505,556,627,71,97,122,197.50284664912292,83,169.71679787342805,-0.2317761687569147,0.25513036590611815,0.8042609503220473,0.8505077215416751,658,627,688,766,78,108,139,183.1774968175733,104,175.58669593111597,-0.43649130063241726,0.051132920879348495,0.5537265181464686,0.9498061135501298,58686,59230,Pickaway,Pickaway,39,129,Ohio,OH
39133,39CS050,1286,1217,1356,1453,97,167,236,123.58556964491646,125,92.63090290428757,-0.16330302572033034,0.31784724389770186,0.8280777126255352,0.7450609148523947,1584,1501,1668,1947,279,363,446,223.43371936423017,250,154.04238013962402,0.17210457519480551,0.6997488476894902,1.2154795428320122,0.6875360702313758,161933,162293,Portage,Portage,39,133,Ohio,OH
39141,39CS051,749,715,782,948,166,199,233,311.1997386430293,102,159.12429635600162,0.9924904425459448,1.5236016841052054,2.064385769314835,0.5087748046350874,916,877,956,1146,190,230,269,298.5286023492922,154,200.2470580586438,0.45113591387015894,0.9752078145962072,1.501939899568468,0.6678710850367294,76921,76905,Ross,Ross,39,141,Ohio,OH
39143,39CS052,586,561,611,633,22,47,72,96.05471343271707,87,177.6295640929663,-1.3403286774595933,-0.8140537251766313,-0.2987899169731234,1.810764769492689,718,687,748,860,112,142,173,242.2035786449321,115,195.80467206974052,-0.08620057676014455,0.4486871246193524,0.9898419007747458,0.8027866844630535,58774,58732,Sandusky,Sandusky,39,143,Ohio,OH
39145,39CS053,876,845,908,1092,184,216,247,350.16093568401413,66,107.20812182741116,1.9313506199401267,2.4267919367527973,2.9609581941059235,0.30475440978344476,1068,1030,1106,1314,208,246,284,334.98315051314245,142,193.45785479761855,0.9079279701251806,1.4193012569184358,1.9338664551249438,0.5751759356772105,73875,73401,Scioto,Scioto,39,145,Ohio,OH
39147,39CS054,521,498,545,609,64,88,111,191.2187456165881,76,165.77297100790693,-0.2541857940567821,0.26572951029947167,0.7652759265519761,0.8571509702623513,638,610,666,774,108,136,164,247.87671078026793,129,234.89566262427618,-0.37814275911798523,0.11984272472818108,0.6508603422863585,0.9407205182291651,55015,54918,Seneca,Seneca,39,147,Ohio,OH
39151,39CS055,3753,3593,3914,4484,570,731,891,234.5565825494274,643,206.43545681469766,-0.25172505392766226,0.2632727733111385,0.8146680404062555,0.878906408220355,4599,4406,4792,5406,614,807,1000,215.9258787126606,796,212.88545371880934,-0.46679590693344997,0.039625585536965276,0.5842677687161392,0.9846994856774016,373773,373910,Stark,Stark,39,151,Ohio,OH
39153,39CS056,5004,4772,5236,5794,558,790,1022,175.6642096965875,651,144.79537366548044,-0.19578958457889434,0.31537179301667495,0.7890198810547892,0.823231271040056,6112,5835,6390,7035,645,923,1200,171.51398317828938,805,149.6532877247123,-0.30834942456588726,0.22902325214932628,0.750947423021121,0.871598051515449,539520,537910,Summit,Summit,39,153,Ohio,OH
39155,39CS057,2225,2138,2311,2647,336,422,509,252.2784688661621,353,210.83962550582098,-0.10126947490086227,0.39528981313424266,0.91355795214621,0.833767678228547,2721,2617,2825,3260,435,539,643,267.81549252719554,435,216.0470833643746,-0.003924175528871783,0.5283093284859,1.0426400822194375,0.8052079690027084,200911,201345,Trumbull,Trumbull,39,155,Ohio,OH
39159,39CS058,377,350,404,412,8,35,62,67.52014247753786,27,51.68453292496171,-0.38320970239035756,0.16761596917267213,0.6669103100291842,0.7443651058982104,479,446,512,493,-19,14,47,21.673707340866898,56,86.56001236571605,-1.1920767576855797,-0.6439515007118705,-0.11640395539792,3.727914197631833,62688,64695,Union,Union,39,159,Ohio,OH
39165,39CS059,1615,1510,1719,1888,169,273,378,135.25565103672508,208,103.01534499409807,-0.18784635456131596,0.32694546681453796,0.8736237199940113,0.7588556098241953,2024,1897,2151,2351,200,327,454,132.7350069254544,291,118.27585506127177,-0.363017894692896,0.14000717816893607,0.6741495134164746,0.8883473347453107,242294,246035,Warren,Warren,39,165,Ohio,OH
39167,39CS060,636,610,662,696,34,60,86,120.97600453517927,80,160.93341380004023,-0.9060155422731748,-0.391143009062076,0.13487160201329143,1.3085328871684345,774,743,804,877,73,103,134,174.0042080274758,88,148.0210593598089,-0.2947571706582067,0.25631484134972804,0.8269315897093515,0.8425306265206544,59652,59451,Washington,Washington,39,167,Ohio,OH
39169,39CS061,1009,959,1060,1153,93,144,194,147.68117683634074,156,160.44155710588115,-0.6614940386887973,-0.11212016109674186,0.39763732466764634,1.0788913757735867,1242,1182,1303,1494,191,252,312,215.50841988029865,208,178.19050964199127,-0.14058620796116852,0.3733811312738169,0.9362587743514668,0.8235639920920116,116678,116729,Wayne,Wayne,39,169,Ohio,OH
39173,39CS062,1013,956,1070,1197,127,184,241,167.20737799361294,145,131.74332765474162,-0.18248113261862733,0.3684090160728034,0.8627628815263243,0.7836456062894998,1250,1181,1318,1361,43,111,180,84.160521127135425,152,114.77415165289881,-0.8299429741460171,-0.29993828948522305,0.21283631836967704,1.3516259959195414,132075,132434,Wood,Wood,39,173,Ohio,OH
40001,40CS001,191,182,199,241,42,50,59,303.5947908290704,28,169.4829760403531,0.841025111366798,1.3277026904278804,1.829823007544636,0.5473412085480402,230,220,240,345,105,115,125,591.9394952316342,61,314.2062429174822,2.3065371515505455,2.7775705121965535,3.3132596697338568,0.5262289158254482,19825,19414,Adair+Cherokee+Sequoyah,Adair,40,1,Oklahoma,OK
40021,40CS001,405,384,425,514,89,109,130,276.76125130700785,52,131.67057036146105,0.9229525171072035,1.4417477773466685,1.94220366982727,0.47144179165500316,498,473,522,636,114,138,163,291.0260054772369,72,151.42911224682945,0.8858824085295457,1.391862226149494,1.9356347690747968,0.5165951350355321,47391,47547,Adair+Cherokee+Sequoyah,Cherokee,40,21,Oklahoma,OK
40135,40CS001,420,403,437,560,123,140,157,423.4016330017065,54,163.54137748277515,2.078458410132938,2.574607034181487,3.112416300941803,0.3835126740375831,512,492,532,693,161,181,201,458.8538759188944,108,273.6186060652124,1.3252978882791335,1.8617934025866945,2.3989781415024756,0.5930344370440049,39623,39471,Adair+Cherokee+Sequoyah,Sequoyah,40,135,Oklahoma,OK
40005,40CS002,150,144,156,180,24,30,36,253.06918837599326,20,169.8994761432819,0.31848080506556065,0.8431109152836128,1.3369304555987378,0.6495518144580972,185,177,192,195,3,10,18,73.01572015566315,33,230.73695986575302,-2.1202159649009515,-1.5751652652582298,-1.0736088744090788,2.88393264465405,14126,14302,Atoka+Bryan+Coal,Atoka,40,5,Oklahoma,OK
40013,40CS002,436,416,456,524,68,88,108,227.5884095799299,68,174.95711835334475,0.056986993038913206,0.5215033213724921,1.023094730072417,0.7601499990826547,536,511,560,716,156,180,205,384.00595152118177,110,234.10730627620407,0.9838542819781513,1.4953963759548086,1.9874023345077176,0.60628482641961845,46640,46987,Atoka+Bryan+Coal,Bryan,40,13,Oklahoma,OK
40029,40CS002,70,70,71,93,22,23,23,512.9435725446649,10,225.8610954263128,2.7550471078475813,2.8682606106775563,2.9963171923886973,0.4217527113455038,85,85,86,93,7,8,8,146.32931672490704,6,113.72251705837756,0.20530676200262435,0.3253184513580503,0.4591220624227387,0.6880469811919304,5313,5276,Atoka+Bryan+Coal,Coal,40,29,Oklahoma,OK
40009,40CS003,206,196,215,249,34,43,53,232.82176953572878,49,264.7813752420408,-0.8289651643255829,-0.30218791099606607,0.18912395632293155,1.1114738237323674,252,240,263,301,38,49,61,222.42389678618343,46,208.30503101933613,-0.4141529197760628,0.1423753309205583,0.6878520431994298,0.9178363087059022,22207,22083,Beckham+Custer+Roger Mills+Washita,Beckham,40,9,Oklahoma,OK
40039,40CS003,261,248,273,341,68,80,93,339.2082331754964,72,303.50932658868163,-0.17476244357404644,0.36281724632053786,0.8441507493096899,0.8837752874447256,318,304,333,333,0,15,29,52.199307258888055,55,195.02854508705366,-1.9385089357685006,-1.4317689132352291,-0.8899798606403623,3.4985660179206284,28467,28201,Beckham+Custer+Roger Mills+Washita,Custer,40,39,Oklahoma,OK
40129,40CS003,30,30,30,47,17,17,17,591.7701699088792,11,382.9416884247171,1.9685187556487604,2.0848468608834163,2.211867242600038,0.6111587091485001,36,36,37,52,15,16,16,460.64114045422957,3,88.4433962264151,3.5894178472540594,3.72451293423446,3.8458339745942975,0.18045169783843162,3447,3392,Beckham+Custer+Roger Mills+Washita,Roger Mills,40,129,Oklahoma,OK
40149,40CS003,119,118,120,138,18,19,20,208.59811143019138,20,219.98166819431714,-0.2347676316741879,-0.1130130878390247,0.007200561411417642,1.0017508117746685,146,145,148,163,15,17,18,152.80322565511304,27,247.41134426830388,-1.0712808281190476,-0.9485449443874054,-0.8225249562356647,1.5275453757893245,10910,10913,Beckham+Custer+Roger Mills+Washita,Washita,40,149,Oklahoma,OK
40015,40CS004,298,286,309,413,104,115,127,510.91361857378683,81,358.55251023645286,0.9900717503261031,1.5410646703344857,2.0201829648620917,0.6957588700897808,358,344,371,438,67,80,94,303.89812733331985,73,276.10726578161047,-0.24487391763229577,0.25632240222779323,0.7989441703881481,0.8973832881442662,27109,26439,Caddo+Grady,Caddo,40,15,Oklahoma,OK
40051,40CS004,482,458,505,608,103,126,150,275.7629386676854,92,200.6616016576393,0.2477870585159647,0.753521958367863,1.2296562149275874,0.7219496394583024,598,570,627,750,123,152,180,273.9678459798626,114,205.75760310441296,0.18910321969203575,0.6880608574725994,1.1929640974485554,0.7461129231529283,55018,55405,Caddo+Grady,Grady,40,51,Oklahoma,OK
40017,40CS005,984,917,1051,1086,35,102,169,78.68794919094536,157,121.42774275880738,-0.9279733171320879,-0.461482977505568,0.07384078464666569,1.5281354472194801,1257,1174,1340,1358,18,101,184,62.91828588622029,186,115.6515034695451,-1.073632826336434,-0.5144201610688601,0.012283247186416687,1.8201350236668845,155154,160828,Canadian,Canadian,40,17,Oklahoma,OK
40019,40CS006,482,461,503,590,87,108,129,269.5905894183733,51,127.28785357737104,0.9130414055567524,1.4202534251336818,1.925315774630476,0.46782139677059104,587,562,612,817,205,230,255,477.4594561585748,153,317.1050177205745,1.0705691779734843,1.5971354480647788,2.1426810140484807,0.6612801494150395,48080,48249,Carter+Johnston+Love+Marshall,Carter,40,19,Oklahoma,OK
40069,40CS006,121,117,126,125,-1,4,8,44.68531342232726,19,220.24729520865532,-2.226123181542059,-1.7461590556442608,-1.232339057640474,3.9136097121120694,146,141,152,177,25,31,36,296.64414013413773,34,330.4499951404413,-0.7962953917653854,-0.33419549825835443,0.18217673886617838,1.0786214955665892,10352,10289,Carter+Johnston+Love+Marshall,Johnston,40,69,Oklahoma,OK
40085,40CS006,100,99,101,119,18,19,20,224.63913238804213,17,200.86648286727058,0.11667610796651964,0.2359313976847246,0.3509630341314629,0.8494920644370887,123,122,125,148,23,25,26,242.7946932501539,25,244.9779519843214,-0.15327161359662864,-0.018213006325895603,0.1134658018574739,0.9698493826704649,10156,10205,Carter+Johnston+Love+Marshall,Love,40,85,Oklahoma,OK
40095,40CS006,159,153,166,220,54,61,67,467.01813446339054,19,146.1351108832201,2.6820780664314032,3.2094621404133217,3.765093646751027,0.30784116264976336,194,186,202,267,65,73,81,471.4648491806325,34,218.55113453750724,1.9742715380371068,2.5290381863713933,3.0621841739662083,0.4573224867316289,15602,15557,Carter+Johnston+Love+Marshall,Marshall,40,95,Oklahoma,OK
40023,40CS007,170,164,176,232,56,62,68,519.5362029591486,22,184.96461851047434,2.836991308061672,3.348914677175627,3.8686007576048134,0.3503491443291113,206,199,214,295,81,89,96,619.6303556274593,54,377.86019172906026,1.9177014391709546,2.4312647137955694,2.9356526092563633,0.6030058224008824,14273,14291,Choctaw+McCurtain+Pushmataha,Choctaw,40,23,Oklahoma,OK
40089,40CS007,325,312,338,476,138,151,164,583.5744282523154,84,324.3034553761019,2.0827446146073694,2.6003194601377353,3.1031621176258417,0.552066788625269,392,376,408,602,194,210,226,680.1227049422982,114,369.29057337220604,2.5824288200709176,3.0960436455582916,3.6305428981345593,0.540402482912023,31082,30870,Choctaw+McCurtain+Pushmataha,McCurtain,40,89,Oklahoma,OK
40127,40CS007,138,133,143,159,16,21,26,233.62437792749222,10,110.77263915812793,0.7132814100996184,1.2319373495345918,1.742347565540013,0.4526844949780162,167,161,172,253,81,86,92,799.157999068949,45,416.20421753607104,3.3442620235290716,3.838736624536392,4.378143870030391,0.5148449072899988,10833,10812,Choctaw+McCurtain+Pushmataha,Pushmataha,40,127,Oklahoma,OK
40027,40CS008,1824,1697,1951,2071,120,247,374,100.51140728431326,238,96.97496511142275,-0.4929042217719685,0.02244346130238549,0.5370076296812415,0.9609200915530732,2274,2121,2428,2571,143,297,450,99.71160883774759,309,103.91200099540299,-0.5778263346544996,-0.0413159490326603,0.4478415871344624,1.0386225758940684,294509,297367,Cleveland,Cleveland,40,27,Oklahoma,OK
40031,40CS009,883,831,935,1077,142,194,246,191.9619741179638,92,91.05905641702408,0.5089381570063942,1.0136039723416999,1.5725591821262221,0.471926572745635,1092,1029,1155,1431,276,339,402,278.3233479733122,224,183.7164860941383,0.4101330942906114,0.9403013922643247,1.4376354844533328,0.6581434959017113,121240,121927,Comanche,Comanche,40,31,Oklahoma,OK
40033,40CS010,62,61,62,84,22,22,23,477.5609859588447,13,280.97982708933716,1.8488330052601585,1.9664094970399981,2.0780109678392633,0.5628886243863856,75,74,76,107,31,32,33,582.0113754319121,15,273.2738203680087,2.9663981506646375,3.0844465158057495,3.216199851509768,0.4552821231300389,5552,5489,Cotton+Jefferson+Stephens,Cotton,40,33,Oklahoma,OK
40067,40CS010,65,64,65,88,23,23,24,513.508932469615,5,110.4158998895841,3.915529367187712,4.028462065889776,4.154114313245001,0.20615669522280491,79,78,80,97,17,18,19,328.7890057382029,12,221.32054592401326,0.9479647351943377,1.073018958976607,1.195867250948903,0.6373845175793309,5434,5422,Cotton+Jefferson+Stephens,Jefferson,40,67,Oklahoma,OK
40137,40CS010,484,465,502,541,39,57,76,160.24031656661015,56,156.7676013623851,-0.48534186538703794,0.030830722518234318,0.520111792053284,0.9615300126624698,597,574,619,698,79,101,124,235.39410878406778,110,255.3744718391605,-0.6891841534272798,-0.1977173548361934,0.3187833573771101,1.0742852799665135,42866,43074,Cotton+Jefferson+Stephens,Stephens,40,137,Oklahoma,OK
40035,40CS011,172,166,178,196,18,24,30,206.89240020330493,19,161.2675060121658,-0.059320045619152495,0.4557400379792935,0.9684480765726549,0.7487574679975781,209,201,216,225,9,16,24,116.10585742577722,27,191.21813031161474,-1.2544068411768567,-0.7561876765903647,-0.26810291771134553,1.5522462753500061,14138,14120,Craig+Mayes,Craig,40,35,Oklahoma,OK
40097,40CS011,402,385,419,470,51,68,85,207.03149669354906,53,161.51150388541825,-0.018758912290684698,0.44006228059002783,0.9778390811013836,0.7688136053894186,489,469,509,652,143,163,183,415.6899668637239,86,219.69600204368376,1.4178597429916078,1.954490099563408,2.483756773790483,0.5252811799456467,39378,39145,Craig+Mayes,Mayes,40,97,Oklahoma,OK
40037,40CS012,733,703,764,801,37,68,98,113.06541309498782,100,167.266036631262,-1.0590071170581672,-0.5468689395232946,-0.011846283473459038,1.4578076098486918,898,861,935,1072,137,174,211,241.50437323257864,188,261.1401266807423,-0.6864139737496436,-0.18092906267362185,0.3264938173846309,1.075122292267535,71742,71992,Creek,Creek,40,37,Oklahoma,OK
40041,40CS013,450,433,468,612,144,162,179,475.85261408292644,88,258.5510368973876,1.6735431960099991,2.1659621536393234,2.690124939359358,0.540008484107349,551,530,573,751,178,200,221,487.6470842480752,118,288.42393429800546,1.4909351386633982,1.9797373909109925,2.5002969480739177,0.5885105530375433,40843,40912,Delaware+Ottawa,Delaware,40,41,Oklahoma,OK
40115,40CS013,360,347,373,408,35,48,61,190.4125442209561,53,209.45856935845077,-0.7112248112897205,-0.19815604763473207,0.3044864265725468,1.0776580572078578,438,423,454,566,112,128,143,420.9536998588386,74,244.05527522179347,1.2613276110506086,1.7874088702678133,2.2638650951992227,0.5752605112533653,30364,30321,Delaware+Ottawa,Ottawa,40,115,Oklahoma,OK
40047,40CS014,600,573,627,709,82,109,136,209.5753911567474,128,246.28409254894413,-0.9278143467253431,-0.36831358105060835,0.164217731486601,1.1644666265526809,730,698,762,862,100,132,164,213.28686523436636,92,148.31772235567234,0.1539094076296228,0.6581938999105698,1.1524942402462193,0.690174046523192,62367,62029,Garfield,Garfield,40,47,Oklahoma,OK
40049,40CS015,285,274,296,361,65,76,87,350.9950166117605,47,217.3745471363601,0.8100769665450197,1.326965109717006,1.8573209283057337,0.6112551118385412,349,336,362,454,92,105,118,407.3822729871764,72,279.3079370005431,0.765109479692896,1.2879750477165834,1.7635465234192136,0.6791491620728354,25946,25778,Garvin+McClain+Murray,Garvin,40,49,Oklahoma,OK
40087,40CS015,349,331,367,389,22,40,58,115.15425802628323,62,177.78202585485914,-1.1704792865739817,-0.6134810153910238,-0.11697774428056512,1.5063501941312474,444,422,466,438,-28,-6,16,-14.049482289657268,51,117.84278386247054,-1.878298136284544,-1.314518058219248,-0.8126239285941143,-10.038708185373194,41849,43278,Garvin+McClain+Murray,McClain,40,87,Oklahoma,OK
40099,40CS015,165,159,171,183,12,18,24,152.5908534572698,16,138.28867761452028,-0.3596481851765588,0.1429911958697159,0.6463083182356852,0.8576898605678095,201,193,208,242,34,41,49,301.43088834549053,42,305.6768558951965,-0.5494622155854473,-0.05758035027530088,0.49494940588192265,0.990178278815198,13884,13740,Garvin+McClain+Murray,Murray,40,99,Oklahoma,OK
40053,40CS016,50,50,51,66,15,16,16,447.64417505662965,5,143.3006926200143,2.9175737949505245,3.0418502897513444,3.1649080583143627,0.30085953146791156,61,61,62,70,8,9,9,214.00888458377554,4,96.71179883945841,1.049185771352871,1.174749343937763,1.3058305007334472,0.4060333524573853,4187,4136,Grant+Kay,Grant,40,53,Oklahoma,OK
40071,40CS016,500,481,518,606,88,106,125,293.1799794018434,102,280.8692260033502,-0.4002327106180062,0.13146690119381163,0.641952916573954,0.9490954278300764,614,591,637,681,44,67,90,153.44285121376035,90,205.9308072487644,-1.021262441055863,-0.5294188718210885,-0.034879996638305225,1.3223497261799904,43579,43704,Grant+Kay,Kay,40,71,Oklahoma,OK
40061,40CS017,137,132,142,152,10,15,20,150.70175903746815,13,133.1285202252944,-0.35581549583543765,0.16701514226320596,0.6983708781426808,0.8271810801956752,166,160,172,197,25,31,37,264.1591956603083,34,293.2551319648094,-0.8203672026841952,-0.297366095039404,0.2755357551565013,1.0750438418460406,11718,11594,Haskell+Latimer+Pittsburg,Haskell,40,61,Oklahoma,OK
40077,40CS017,116,115,117,100,-17,-16,-15,-203.8483298726981,10,125.75979878432193,-3.4171802974541676,-3.2975812193507554,-3.176982586930458,-0.6574907391899146,140,139,142,168,26,28,29,291.7481314743917,27,286.25954198473283,-0.06849824507703448,0.05652275372434629,0.17688774709476096,0.9467809597230328,9542,9432,Haskell+Latimer+Pittsburg,Latimer,40,77,Oklahoma,OK
40121,40CS017,509,490,528,586,58,77,96,211.0627984048163,52,142.7623601546592,0.17411454774667484,0.6787067325593447,1.1791738609606992,0.6677121887113368,619,597,642,810,168,191,213,437.0561944749659,136,311.59071642953694,0.7653223945437321,1.2589992444523088,1.7816686019786125,0.7092127674985262,43709,43647,Haskell+Latimer+Pittsburg,Pittsburg,40,121,Oklahoma,OK
40063,40CS018,167,161,173,183,10,16,22,143.2347810643793,26,234.093637454982,-1.4141630848032354,-0.9023666973549433,-0.40012253321894636,1.5376781702693272,205,198,212,229,17,24,31,176.79484847227727,29,216.49869354236654,-0.9256476133455745,-0.39128394956218776,0.12244028138583328,1.1749610158221,13328,13395,Hughes+Okfuskee+Pontotoc+Seminole,Hughes,40,63,Oklahoma,OK
40107,40CS018,153,149,158,174,16,21,25,218.3058703721924,28,296.34856235667667,-1.2963873558045989,-0.7931816549113748,-0.22839058719966165,1.2947218714032562,186,180,192,191,-1,5,11,45.97473779858197,30,267.78541462108365,-2.744785668532582,-2.2142821123223855,-1.713334291267402,4.8776126699069655,11338,11203,Hughes+Okfuskee+Pontotoc+Seminole,Okfuskee,40,107,Oklahoma,OK
40123,40CS018,376,360,393,429,36,53,69,166.4198625086785,43,135.34071237475737,-0.19363927179929014,0.3102330161844287,0.8262180736451681,0.7981532740370443,463,443,483,599,116,136,156,356.58287536560414,79,207.0773263433814,0.9773030578004674,1.4828566163245593,1.977595265461931,0.5764893054095938,38126,38150,Hughes+Okfuskee+Pontotoc+Seminole,Pontotoc,40,123,Oklahoma,OK
40133,40CS018,282,272,292,353,61,71,81,359.30806384507446,41,208.18347226336053,1.0373129602236257,1.5042192599851976,2.027473141928113,0.5713272140756869,345,333,357,428,71,83,95,351.4968082097689,62,263.18023601324387,0.4143849183637372,0.8747491404527876,1.3981868317238488,0.7398072041214778,23633,23558,Hughes+Okfuskee+Pontotoc+Seminole,Seminole,40,133,Oklahoma,OK
40079,40CS019,524,503,545,630,85,106,127,262.20358784574535,59,146.2477536097168,0.6190578349804808,1.1607482913442693,1.6960203531999336,0.552540606670555,643,618,668,798,130,155,180,320.4329035984127,104,214.76066575806385,0.5589590351935687,1.0457471561890639,1.609303357422871,0.6659288606183797,48411,48426,Le Flore,Le Flore,40,79,Oklahoma,OK
40081,40CS020,321,307,335,382,47,61,75,217.060151554616,50,177.93066635034546,-0.08837281354805811,0.39610727341714336,0.9202391926788017,0.8065073995216022,393,376,411,485,74,92,109,271.22129855625127,69,204.2870677404074,0.13878631584029716,0.6546137047934822,1.2165657417334925,0.745078386335883,33721,33776,Lincoln+Logan,Lincoln,40,81,Oklahoma,OK
40083,40CS020,343,322,365,366,1,23,44,54.96547606148621,31,74.98941681617514,-0.768830707851748,-0.2088734740131351,0.29609326710896244,1.3067889504672932,430,404,456,509,53,79,105,155.8012449817006,84,165.62820411704394,-0.6088371935473871,-0.1119614543045609,0.4016561300149107,1.0497879506428274,49607,50716,Lincoln+Logan,Logan,40,83,Oklahoma,OK
40091,40CS021,249,241,258,306,48,57,65,356.3709087480685,34,213.92617449664428,0.8812207171665563,1.4282384182941736,1.927814578982436,0.5898761660141436,308,298,318,416,98,108,118,563.9923410633824,67,348.9401593666997,1.6623799354791458,2.152780887274712,2.64102909143166,0.6130356855680931,19072,19201,McIntosh+Okmulgee,McIntosh,40,91,Oklahoma,OK
40111,40CS021,426,410,442,538,96,112,128,363.4579682078546,57,185.11502029769957,1.2571743783197447,1.7984101853349246,2.31479078814279,0.5048055448991285,522,503,541,670,129,148,167,401.18280328272033,103,279.7468698226459,0.6916213909275499,1.2092167343975706,1.7475320309655,0.6926162572128925,36950,36819,McIntosh+Okmulgee,Okmulgee,40,111,Oklahoma,OK
40003,40CS022,51,51,52,66,14,15,15,305.51267259729394,5,105.15247108307045,1.8746802414363724,2.000527813644538,2.1243097429046864,0.32201706166154515,64,63,64,53,-11,-11,-10,-186.69531443847825,2,35.02626970227671,-2.3464481352334747,-2.215345288347807,-2.096257415744592,-0.20703285527891238,5706,5710,Major and Nearby Counties,Alfalfa,40,3,Oklahoma,OK
40011,40CS022,104,103,105,135,30,31,32,421.90822283070105,17,231.71285779191274,1.7823091866719547,1.902960742918221,2.0194069919527124,0.5320147720936601,125,124,126,162,36,37,38,432.37404794290734,21,244.64119291705498,1.7549417803030427,1.8783938195365228,2.013108088336122,0.5509643568103407,8804,8584,Major and Nearby Counties,Blaine,40,11,Oklahoma,OK
40043,40CS022,54,53,54,61,7,7,8,197.5173861404582,13,344.82758620689657,-1.5879038623084614,-1.474552383634131,-1.3491599538598755,1.5391162625829076,64,64,65,85,20,21,21,463.82867182829324,10,226.03978300180833,2.250646454116076,2.379618690464969,2.515224549334893,0.464688755868069,4524,4424,Major and Nearby Counties,Dewey,40,43,Oklahoma,OK
40073,40CS022,138,132,145,152,7,14,20,108.40101454207529,33,259.3999737979824,-2.0163956343280964,-1.5168433899683036,-0.9815018452861531,2.231174606244511,170,162,177,173,-4,3,11,22.717072701930757,19,125.03290339563043,-1.54863489587016,-1.0186491657779861,-0.4776266230926741,4.267662042111544,15266,15196,Major and Nearby Counties,Kingfisher,40,73,Oklahoma,OK
40093,40CS022,89,88,90,99,9,10,11,155.5619819433785,20,310.7198342827551,-1.670750360520725,-1.5495101475627606,-1.433227830776668,1.816034565696946,109,108,110,120,10,11,12,143.7003695395591,14,182.29166666666666,-0.5057751363029969,-0.3852290253951064,-0.2610555292348728,1.1631589301577336,7724,7680,Major and Nearby Counties,Major,40,93,Oklahoma,OK
40151,40CS022,84,84,85,93,8,9,9,118.98667639541016,3,41.78272980501393,0.6537272358209995,0.7720661547460232,0.8882204787735224,0.3143585346406107,104,103,105,100,-5,-4,-3,-44.728744648457436,21,244.64119291705498,-3.017422884718853,-2.896526433666986,-2.7759859789464536,-7.395628035531368,8616,8584,Major and Nearby Counties,Woods,40,151,Oklahoma,OK
40101,40CS023,751,723,780,896,116,145,173,261.57057350634074,108,195.06027904456585,0.15400520480349386,0.6522018567168846,1.169111849687375,0.740613306049962,912,878,947,1150,203,238,272,359.0938386758515,185,279.6758783334341,0.2953386556523838,0.781880066328978,1.2968744632241245,0.7755727537053071,66441,66148,Muskogee,Muskogee,40,101,Oklahoma,OK
40103,40CS024,118,117,119,123,4,5,6,55.91387512412322,12,131.59097139724022,-0.8767029970265473,-0.7558673933092694,-0.634043217916318,1.9675745477604838,145,143,146,178,32,33,35,305.88531610324213,23,210.46852122986823,0.8369008495481097,0.9548047956303568,1.0906421112947462,0.6680774265244857,10943,10928,Noble+Osage+Pawnee,Noble,40,103,Oklahoma,OK
40113,40CS024,388,368,407,442,35,54,74,141.96705233995195,43,112.37178509984973,-0.22703373205630223,0.28598939957509184,0.7824786021941863,0.7772272328708676,477,453,500,616,116,139,163,304.7662568467043,99,216.3130639980772,0.3619981495001956,0.8722188123635389,1.386895502853639,0.7047147485283275,45919,45767,Noble+Osage+Pawnee,Osage,40,113,Oklahoma,OK
40117,40CS024,174,167,181,211,30,37,44,283.93125764914697,26,198.90348081091417,0.33284318673778573,0.8574822997760665,1.3784756915757073,0.6821542340874795,214,206,222,258,36,44,52,281.4692134767991,31,197.30142566191446,0.34616097520567723,0.8351160165502441,1.342013047008921,0.685470026073594,15686,15712,Noble+Osage+Pawnee,Pawnee,40,117,Oklahoma,OK
40105,40CS025,106,105,107,120,13,14,15,182.27628237110153,14,178.4007645747053,-0.07593290562225175,0.04006826647723865,0.15602430167207035,0.9147856721171865,128,127,129,164,35,36,37,388.2102086687855,21,225.75790152655344,1.4988561923684371,1.627004560246895,1.7463657816924303,0.565865175791884,9417,9302,Nowata+Washington,Nowata,40,105,Oklahoma,OK
40147,40CS025,556,534,579,598,19,42,64,94.94257994511935,70,160.0731763091699,-1.1607016545738895,-0.6567398235703551,-0.13525156682657863,1.6463464316091487,683,656,711,786,75,103,130,194.36824885737542,135,255.94357865999316,-1.1201340801507471,-0.6145469018088553,-0.11121958675350631,1.3040772263794256,52476,52746,Nowata+Washington,Washington,40,147,Oklahoma,OK
40109,40CS026,6263,5920,6606,7521,915,1258,1601,189.26982545163744,864,130.0114863543114,0.04036150685467059,0.5862619824785329,1.1223845337166019,0.6863651107157941,7705,7293,8117,8951,834,1246,1658,156.06937042064624,1058,132.51702179892482,-0.30552973283020435,0.22640150689241875,0.7343406346116957,0.8484096278080213,797468,798388,Oklahoma (county),Oklahoma (county),40,109,Oklahoma,OK
40007,40CS027,44,43,44,56,12,12,13,294.23231943997314,10,237.5296912114014,0.44675344653618293,0.5671636303720688,0.6871561921672029,0.7469832717300404,52,52,53,63,10,11,11,212.38662298683187,8,160.481444332999,0.38941578589451825,0.523784303162284,0.642849586054105,0.6904007364134497,5052,4985,Oklahoma Panhandle,Beaver,40,7,Oklahoma,OK
40025,40CS027,24,24,24,22,-2,-2,-2,-110.62284599558981,0,0,-1.2214274422087146,-1.1064667642335062,-0.9745344849422308,-0,29,29,29,31,2,2,2,80.25320205047035,4,177.46228926353152,-1.105755343968203,-0.9754537156709582,-0.848862367425725,1.4240413626748514,2265,2254,Oklahoma Panhandle,Cimarron,40,25,Oklahoma,OK
40045,40CS027,42,42,42,44,2,2,2,62.636294576111496,6,191.28586609989372,-1.4181422753302388,-1.285541834849169,-1.1561082909362472,2.0238191552424425,51,51,52,50,-2,-1,-1,-29.712577217932495,5,132.9787234042553,-1.7518050475107956,-1.6251309054942893,-1.5030791223545616,-42.66469944156037,3764,3760,Oklahoma Panhandle,Ellis,40,45,Oklahoma,OK
40059,40CS027,29,29,30,51,21,22,22,778.7839696592692,7,253.5466344702686,5.135319688601873,5.250337951468365,5.372866302364912,0.31109828792990746,35,34,35,38,3,3,4,106.47096907136222,7,219.36696960200564,-1.253892825837387,-1.130658032094048,-1.0026883594507532,1.591817648664575,3313,3191,Oklahoma Panhandle,Harper,40,59,Oklahoma,OK
40139,40CS027,157,154,159,159,0,2,5,14.149368693977443,38,216.27774615822426,-2.143101629051112,-2.0248477937452756,-1.8971827555282594,10.900608005250255,189,187,192,162,-30,-27,-25,-130.18253440315652,25,119.46860365096053,-2.6268530913490347,-2.493767662309789,-2.3755552571166976,-0.9526713937912997,21084,20926,Oklahoma Panhandle,Texas,40,139,Oklahoma,OK
40153,40CS027,171,162,180,215,35,44,53,259.8858150978225,28,165.27299557304477,0.41447520888356104,0.967377892034292,1.4622072189278763,0.6218216515153486,209,199,219,251,32,42,52,207.36887567151513,34,168.05891948000593,-0.13164964867199158,0.3838780903691891,0.9421641673513408,0.7915666076953316,20330,20231,Oklahoma Panhandle,Woodward,40,153,Oklahoma,OK
40119,40CS028,512,477,547,568,21,56,91,81.85936119312575,55,80.83579310936102,-0.5458763497510892,0.0037974227790895506,0.5411967913761483,0.970078763717491,638,595,680,764,84,126,169,154.22285311134306,82,100.08421720716213,0.05278561931791965,0.5319869619571167,1.0540294741935992,0.6438627959473382,81647,81931,Payne,Payne,40,119,Oklahoma,OK
40125,40CS029,732,701,764,850,86,118,149,194.65994462875886,79,130.68831938681262,0.14892324743923757,0.6420386334805156,1.1733962501240218,0.6657098738197764,900,863,938,1142,204,242,279,331.37358797880677,146,200.178240899431,0.8039518376566235,1.32439621430609,1.8739187009543838,0.6015971339350773,72539,72935,Pottawatomie,Pottawatomie,40,125,Oklahoma,OK
40131,40CS030,792,751,833,929,96,137,178,172.662720078658,114,143.90154105085995,-0.2620672497639999,0.2759053951411488,0.8057994947146837,0.8273769108563572,983,933,1033,1125,92,142,192,146.88380841414363,167,173.06775550811452,-0.7545325041946306,-0.25644948745544155,0.2363141842856267,1.170008038399139,95065,96494,Rogers,Rogers,40,131,Oklahoma,OK
40055,40CS031,57,56,57,73,16,16,17,349.16257381536826,19,413.11831853596664,-0.7576125342778552,-0.6397794445278683,-0.517659408523442,1.1138097413628216,70,69,70,97,27,27,28,499.3261971562944,4,72.89958082741025,4.131809619956604,4.262041151736972,4.392077917207993,0.14085484873493267,5519,5487,Southwest Oklahoma,Greer,40,55,Oklahoma,OK
40057,40CS031,25,24,25,39,14,14,15,699.6761748507814,6,289.6218825422365,3.981037996412455,4.101874141112487,4.2243572554199575,0.3872227317776702,29,29,30,45,15,16,16,643.5342948745263,7,288.659793814433,3.4210410279791863,3.546633019586756,3.683091535029428,0.42154183180767313,2486,2425,Southwest Oklahoma,Harmon,40,57,Oklahoma,OK
40065,40CS031,220,210,231,281,50,61,71,295.5147575290889,55,267.2930503806901,-0.18661992341574768,0.283072283122081,0.7764094661570797,0.8898655966298973,272,259,285,287,2,15,28,61.32352587426938,35,141.29995962858297,-1.3058633882204689,-0.8188182376930695,-0.29658345668077535,2.161850006505541,24692,24770,Southwest Oklahoma,Jackson,40,65,Oklahoma,OK
40075,40CS031,126,122,129,160,31,34,38,483.5546275286147,27,380.54968287526424,0.5122897740133471,1.0416521748688792,1.5748569078895887,0.764694868912531,152,147,156,140,-16,-12,-7,-140.6720816039276,20,237.50148438427738,-4.307461415162574,-3.772852613112422,-3.288613613644469,-1.8439984686512618,8514,8421,Southwest Oklahoma,Kiowa,40,75,Oklahoma,OK
40141,40CS031,77,76,77,106,29,29,30,500.0342248327336,18,307.9994296306858,1.796125592651104,1.9191069020636728,2.027268991946571,0.5955761893137579,95,94,96,123,27,28,29,397.54260969075165,18,255.02975347123834,1.3059047242144664,1.4183827943807317,1.556972283224642,0.6194388715584374,7013,7058,Southwest Oklahoma,Tillman,40,141,Oklahoma,OK
40143,40CS032,5207,4919,5495,5987,492,780,1068,140.1444450110543,621,111.58779003167044,-0.2032021559266835,0.2780504681967584,0.8045916193053384,0.7952145198591658,6434,6086,6781,7801,1020,1367,1715,203.34636429405967,1169,173.8383021247234,-0.26999416586415453,0.2906272910208061,0.7801850805238733,0.8542629615126955,667815,672464,Tulsa,Tulsa,40,143,Oklahoma,OK
40145,40CS033,556,521,592,648,56,92,127,134.53349168272828,64,94.03928099133076,-0.1332970246348966,0.3937105515769545,0.9010585677182423,0.6914507837457543,703,659,746,907,161,204,248,244.36536831564638,169,202.0081281377002,-0.10050853293589557,0.4125754030918897,0.9401840410301134,0.8226403589136856,81668,83660,Wagoner,Wagoner,40,145,Oklahoma,OK
41001,41CS001,188,180,195,206,11,18,26,132.96395596743088,1,7.2189135535101965,0.7483710477372868,1.27053700729847,1.737980892861927,0.05149640307820783,231,222,240,274,34,43,52,254.90743021272638,31,184.2605801236329,0.1316068825167899,0.7103785475592281,1.2300286532848295,0.7063816284250153,16623,16824,Baker+Harney+Lake+Malheur,Baker,41,1,Oregon,OR
41025,41CS001,75,75,76,78,2,3,3,40.43770920438328,5,80.18174528932245,-0.518183162220253,-0.3951235841471507,-0.2723781293066239,1.4197978285354251,94,93,94,124,30,30,31,403.22968474403325,30,396.6679888932963,-0.0653570700940642,0.06524219303180004,0.18954751392340496,0.9524940101787223,7483,7563,Baker+Harney+Lake+Malheur,Harney,41,25,Oregon,OR
41037,41CS001,87,86,88,98,10,11,12,166.68203143030877,4,59.02606984751598,0.9594504163670595,1.0784090619291402,1.199060615422653,0.3253226517072165,108,107,109,144,35,36,37,437.4924841106177,16,193.7749788058617,2.3120736981453565,2.4385853130599497,2.5559504199835548,0.43099089122276957,8132,8257,Baker+Harney+Lake+Malheur,Lake,41,37,Oregon,OR
41045,41CS001,269,255,282,326,44,57,71,219.06225798491673,42,160.08131114216746,0.0781706597213907,0.5827270518441038,1.1035919474383182,0.7182601553067948,331,314,347,392,45,61,78,193.00600859814173,46,145.19743694959124,-0.028697953052810827,0.4824429222811035,0.9941227619152616,0.7401896679360446,31484,31681,Baker+Harney+Lake+Malheur,Malheur,41,45,Oregon,OR
41003,41CS002,519,478,560,504,-56,-15,26,-19.323468731589724,10,12.637432073802604,-0.8126314436404545,-0.3139792621999365,0.19474676983487954,-0.69975770433841,649,600,699,741,42,92,141,95.71635908350666,23,23.985066688913687,0.20009568247711432,0.7162198572448714,1.253915198680935,0.24788412519094788,94956,95893,Benton,Benton,41,3,Oregon,OR
41005,41CS003,2989,2807,3170,3188,18,199,381,56.715649296752964,116,33.01535498621988,-0.26095358185707307,0.23753349879488442,0.7868067313355525,0.5792140671402298,3680,3462,3898,4005,107,325,543,76.95192605577996,302,71.48233534209741,-0.42384550901697365,0.058872586681554755,0.5931265180072441,0.9260734678083392,421622,422482,Clackamas,Clackamas,41,5,Oregon,OR
41007,41CS004,350,333,368,348,-20,-2,15,-7.091730757184452,5,14.621308119699776,-0.7632368118313655,-0.22137582165112432,0.3027941384342865,-3.508438251662984,433,412,455,542,87,109,130,260.36843492331286,29,69.53602685529313,1.3563050511875976,1.9115905540851448,2.4280095490065006,0.26463075994359303,41036,41705,Clatsop+Lincoln+Tillamook,Clatsop,41,7,Oregon,OR
41041,41CS004,538,517,560,592,32,54,75,127.43453428951258,14,33.29237842336807,0.4355768514121604,0.9383463702732658,1.4911458909296231,0.25646499911023696,658,632,685,729,44,71,97,138.99551868074394,34,66.92254699340616,0.18302663588071819,0.7033829694983661,1.2279794155225663,0.47474978171401955,50462,50805,Clatsop+Lincoln+Tillamook,Lincoln,41,41,Oregon,OR
41057,41CS004,266,254,278,303,25,37,49,160.78002199006121,1,4.371584699453551,1.0636604668455758,1.562289513349935,2.0770439437176544,0.02647013121508492,327,312,341,412,71,85,100,308.0118728446693,42,151.580770896492,1.0381655631957596,1.5682245238470591,2.055891819445009,0.48642678335819206,27450,27708,Clatsop+Lincoln+Tillamook,Tillamook,41,57,Oregon,OR
41009,41CS005,402,380,425,447,22,45,67,101.59879656301595,22,50.118652112007595,-0.03574384661102491,0.5137818295514668,1.0135792672481327,0.4824811277101745,497,469,524,629,105,132,160,249.5613029536571,58,109.41538229357279,0.9125057055549137,1.3875079541859918,1.9418855702608897,0.43514158065833497,52675,53009,Columbia+Washington,Columbia,41,9,Oregon,OR
41067,41CS005,2960,2701,3218,3194,-24,234,493,46.8122643649176,131,26.16785714880222,-0.32900464408624663,0.220031304973543,0.7003580040334985,0.5566205771550012,3675,3365,3986,4156,170,481,791,79.98729596451068,243,40.44654315213393,-0.09068258275568984,0.40034863256158393,0.9047040950399747,0.5046120345459173,600737,600793,Columbia+Washington,Washington,41,67,Oregon,OR
41011,41CS006,783,755,811,777,-34,-6,22,-11.253365578643175,10,18.4991058765493,-0.8010403057379689,-0.3138917645260409,0.23968166963878318,-1.9672669135203842,953,919,986,1139,153,186,220,286.5185799853895,98,150.80867303756366,0.8422419674974442,1.352268879136684,1.8755379559735226,0.5235368020542108,64868,64983,Coos+Curry,Coos,41,11,Oregon,OR
41015,41CS006,336,326,346,393,47,57,67,293.6763288575175,5,25.590719099206687,2.1789061988534635,2.683718984911281,3.2193250785359804,0.08564656122953047,410,398,422,512,90,102,114,431.20554844562133,36,152.17483197362304,2.3235495864629443,2.788665659527521,3.312939078925291,0.3494796266946637,23446,23657,Coos+Curry,Curry,41,15,Oregon,OR
41017,41CS007,1368,1282,1454,1333,-121,-35,51,-20.770327245011078,24,14.425966740132237,-0.8831787889751518,-0.3511204121915953,0.16674711805435896,-0.7152457381197287,1713,1608,1818,1824,6,111,216,54.40715857780534,167,81.85993617866053,-0.7527737537249092,-0.2741966122178324,0.21468091106131537,1.4911458260994612,199640,204007,Deschutes,Deschutes,41,17,Oregon,OR
41019,41CS008,1302,1254,1350,1421,71,119,167,128.3058141424602,35,37.74704090161504,0.40484324250531206,0.920076569846308,1.4173979247512016,0.2917435933298847,1596,1539,1654,2054,400,458,515,408.9772537050084,244,218.11030660588185,1.3803335551379374,1.9051958528043156,2.4170880798415433,0.5321435955057333,111267,111870,Douglas,Douglas,41,19,Oregon,OR
41027,41CS009,166,155,176,156,-20,-10,1,-48.52133692278152,12,60.331825037707375,-1.6123277120272448,-1.1014421822555382,-0.5746723168045236,-1.3871398862794446,204,192,217,200,-17,-4,8,-17.132308298314385,17,70.71547420965058,-1.4035349832781334,-0.8673540684737272,-0.3551677862289971,-5.451151896924642,23868,24040,Hood River+Jefferson+Sherman+Wasco,Hood River,41,27,Oregon,OR
41031,41CS009,182,171,192,272,80,90,101,439.5836418359744,19,92.70553793608197,2.9520588550696476,3.467629448445593,3.975787752115902,0.20857880819057512,226,213,239,327,88,101,114,403.81267073392655,37,148.07107411557547,2.0601536685952238,2.5366359558127614,3.054970806117661,0.3630842965042498,24594,24988,Hood River+Jefferson+Sherman+Wasco,Jefferson,41,31,Oregon,OR
41055,41CS009,17,16,17,16,-1,-1,0,-44.3560116708063,2,128.75536480686694,-2.254315920855497,-1.7466719756316735,-1.2147401597459437,6.430800232722243,21,20,22,26,4,5,6,278.3013783586351,5,262.88117770767616,-0.34593624242517657,0.16543971909437008,0.6671851515140372,0.7944967161996958,1864,1902,Hood River+Jefferson+Sherman+Wasco,Sherman,41,55,Oregon,OR
41065,41CS009,278,266,289,295,6,17,29,78.1924385959429,27,121.75416181278418,-0.9340730391871283,-0.4442951299615149,0.09255535817132143,1.4722059890274282,339,325,353,374,21,35,49,130.984857554456,28,104.83357669699353,-0.25870594099722644,0.252914903915888,0.7519314048486089,0.7781074877660565,26611,26709,Hood River+Jefferson+Sherman+Wasco,Wasco,41,65,Oregon,OR
41029,41CS010,2084,1988,2180,2242,62,158,254,85.09642379826983,68,36.58323358125647,-0.008028474842019214,0.4742097404559887,1.0196727451144183,0.4272024820576492,2551,2435,2666,2929,263,378,494,169.02229628209386,292,130.5412993329876,-0.10697397431868874,0.381757546680957,0.9266548204558434,0.7702944224194177,223053,223684,Jackson,Jackson,41,29,Oregon,OR
41033,41CS011,1068,1030,1106,1112,6,44,82,59.613595655666686,25,34.06458645592043,-0.2697230608499906,0.246192839758525,0.7737568756243939,0.5586540014632234,1305,1259,1350,1583,233,278,324,315.0422681034353,224,253.64903579395545,0.10535198349429101,0.6045766242074513,1.1253467395448176,0.8022434813885864,88068,88311,Josephine,Josephine,41,33,Oregon,OR
41035,41CS012,719,689,748,779,31,60,90,104.48106970115617,25,43.22579715574255,0.13933657989997614,0.6088425619912603,1.1636447177127212,0.40698386038335443,887,851,924,1074,150,187,223,266.2847333693582,150,214.0777530399041,-0.010309034793756123,0.5219391785731109,1.0303077735395398,0.7996571625486553,69403,70068,Klamath,Klamath,41,35,Oregon,OR
41039,41CS013,3182,3017,3346,3372,26,190,355,59.609098021666256,76,23.822086626719393,-0.1519381778996774,0.34323577224448204,0.88392354530296,0.39754796827313926,3910,3712,4108,4528,420,618,816,161.2653554348974,233,60.81121640702278,0.4646638035572796,1.0148677289966503,1.508973874056205,0.3764786193881578,382838,383153,Lane,Lane,41,39,Oregon,OR
41043,41CS014,1155,1099,1210,1247,37,92,148,85.96080945600544,35,32.52611769808018,0.01976011604628743,0.5378467110719125,1.049376533729582,0.3743361735327399,1420,1353,1487,1726,239,306,373,235.85129830060114,152,117.18719884046351,0.6767499811823102,1.1766070346492847,1.6898390091971864,0.4952500898070279,129127,129707,Linn,Linn,41,43,Oregon,OR
41047,41CS015,2445,2296,2594,2685,91,240,389,83.1130255620398,182,63.031212571609984,-0.29900643299242974,0.20441638492508354,0.6813919174210423,0.7552324800934862,3013,2834,3192,3458,266,445,624,128.27503035381184,304,87.61185642030635,-0.13553818131682743,0.42041056960039924,0.9077729886330912,0.6814690195197568,346495,346985,Marion,Marion,41,47,Oregon,OR
41051,41CS016,4978,4628,5328,5449,121,471,821,69.47000368063603,389,57.34157669681562,-0.3874875025507256,0.12406955074440609,0.6198258241304138,0.8236671774922589,6081,5665,6497,6896,399,815,1231,101.226361120992,422,52.40940438326426,-0.007057668737574758,0.48007853467498535,1.0100073528672089,0.5171101913433485,814069,805199,Multnomah,Multnomah,41,51,Oregon,OR
41053,41CS017,631,593,668,669,1,38,76,52.63816057245575,25,34.20557550880793,-0.31975771563450156,0.1986939447826635,0.6844312818758616,0.6333617108434386,786,740,832,842,10,56,102,62.77184913270274,68,76.42682131858746,-0.6597222684301913,-0.13099412391577733,0.3439427130712993,1.1961170161873622,87705,88974,Polk,Polk,41,53,Oregon,OR
41013,41CS018,245,234,256,211,-45,-34,-23,-163.41373002423921,2,9.626955475330925,-2.2564652082053334,-1.7393354488752215,-1.206411850036876,-0.06069949660569293,308,295,321,321,0,13,26,51.66855739033317,46,179.5472287275566,-1.7991862216555579,-1.2585119814110426,-0.717456249002697,3.2309078413461907,24930,25620,Umatilla and Nearby Counties,Crook,41,13,Oregon,OR
41021,41CS018,18,18,18,14,-4,-4,-4,-239.61909495177864,5,300,-5.520511619061094,-5.398180172505092,-5.277283605088227,-1.6702010444966298,22,22,22,37,15,15,15,747.3595367930144,5,249.1280518186348,4.855670037291671,4.981519706431523,5.100787200520299,0.31250965062154074,2000,2007,Umatilla and Nearby Counties,Gilliam,41,21,Oregon,OR
41023,41CS018,77,77,78,85,7,8,8,125.33292736174772,5,83.10249307479225,0.2990737918310645,0.42595077129163117,0.5474873742101107,0.5854208343547054,95,94,96,115,19,20,21,276.15027002122895,14,192.70474879559532,0.7092374078133851,0.8364451391398067,0.960950051663477,0.6646941987532841,7220,7265,Umatilla and Nearby Counties,Grant,41,23,Oregon,OR
41049,41CS018,77,75,78,96,18,19,21,192.62228647283007,11,108.92886614952963,0.7145836827876701,0.8380820430024215,0.9629362175597126,0.5378541621873228,95,93,96,122,26,27,29,222.71880020050338,14,113.94156425490357,0.9580892033551185,1.0915720026285596,1.2066980560508762,0.49355802807764654,12118,12287,Umatilla and Nearby Counties,Morrow,41,49,Oregon,OR
41059,41CS018,593,559,627,709,82,116,150,174.50586984297573,60,90.36371394864328,0.2745103672380364,0.8384166199380368,1.3410668276368871,0.5133953877685848,733,692,775,885,110,152,193,189.76266660961056,101,126.26420472303134,0.1031937206444304,0.6441651533751819,1.18576275621991,0.6610248105379088,79678,79991,Umatilla and Nearby Counties,Umatilla,41,59,Oregon,OR
41061,41CS018,242,231,254,247,-7,5,16,21.55393169451207,5,22.86498227963873,-0.5415406837668173,-0.010993963433543993,0.48011332256759737,0.8751500424382584,297,284,311,374,63,77,90,293.0954299878469,49,187.0014883791932,0.5006921787417924,1.0575372308010054,1.5533173928585144,0.6298217067624905,26241,26203,Umatilla and Nearby Counties,Union,41,61,Oregon,OR
41063,41CS018,77,76,78,61,-17,-16,-15,-260.48033583103353,3,48.833423765599555,-3.216498687467504,-3.0975908101065723,-2.9700914078928524,-0.19997100023372208,96,95,97,103,6,7,8,96.94116796647172,1,13.294336612603033,0.7037085552703128,0.8376894778340538,0.966454118950641,0.12059940817948235,7372,7522,Umatilla and Nearby Counties,Wallowa,41,63,Oregon,OR
41069,41CS018,16,15,16,17,1,1,2,120.32215924385689,6,500,-4.320249530153256,-3.8006374563893504,-3.278592736935394,2.455126516219484,19,18,20,21,1,2,3,131.43010877004602,1,68.87052341597796,0.13311541228102053,0.6333850857960226,1.1523329092820858,0.3438357765741661,1440,1452,Umatilla and Nearby Counties,Wheeler,41,69,Oregon,OR
41071,41CS019,828,781,874,883,9,55,102,61.64120193093674,37,41.209556161942416,-0.3162778365060197,0.2161528933901548,0.7256138254937299,0.6566739450231287,1018,962,1074,1251,177,233,289,215.2730186186624,102,94.28729894620078,0.6961003257677765,1.197810505125948,1.6828976789490866,0.4361167028108466,107742,108180,Yamhill,Yamhill,41,71,Oregon,OR
42001,42CS001,907,862,952,996,44,89,134,102.90016364020039,81,93.74909578418416,-0.40667921808558793,0.09405705831459364,0.5693468384642478,0.9009349814495708,1114,1060,1168,1234,66,120,174,115.14120606176876,172,165.25908204344776,-0.9938645482771994,-0.5131073831511536,0.02346387807086945,1.423395472519176,103681,104079,Adams,Adams,42,1,Pennsylvania,PA
42003,42CS002,11874,11339,12410,12850,440,976,1511,94.19354238750451,1108,106.98448741025284,-0.6197570525363368,-0.13842936040384995,0.39711000884745856,1.1346311944718364,14463,13823,15103,15249,146,786,1426,63.37353628625279,1390,112.12932786938143,-1.0036784612039704,-0.49434193985393743,0.00600998585074261,1.7670905829424957,1242797,1239640,Allegheny,Allegheny,42,3,Pennsylvania,PA
42005,42CS003,727,699,755,785,30,58,86,105.91937817196339,43,79.0199081163859,-0.24853292780684177,0.2686933851741868,0.7974409146025982,0.733315433038038,885,851,919,1101,182,216,250,331.5437283595405,185,283.9862458553359,-0.025256118593954897,0.4721116930700214,1.0281735210977478,0.8526098181808693,65300,65144,Armstrong,Armstrong,42,5,Pennsylvania,PA
42007,42CS004,1872,1800,1944,2109,165,237,309,170.2805402514962,243,174.54179785234578,-0.5598644925387258,-0.04943878904180778,0.47662426078351927,1.020719316149537,2279,2193,2366,2444,78,165,251,98.64343682932366,310,185.86691928579137,-1.401975734589185,-0.8684261605643464,-0.36006452609699324,1.8728464997099485,167066,166786,Beaver,Beaver,42,7,Pennsylvania,PA
42009,42CS005,479,459,500,635,135,156,176,392.34060771847663,98,247.1990414731045,0.918161924224915,1.4746245813725782,1.9335551355708978,0.6260374157649443,582,558,607,709,102,127,151,267.1425579825802,138,290.7099220560354,-0.7580053745771389,-0.2280756518278038,0.31524433078165354,1.0797059909239866,47573,47470,Bedford+Fulton,Bedford,42,9,Pennsylvania,PA
42057,42CS005,146,139,152,146,-6,0,7,2.485277277730058,13,107.29761331590893,-1.5357052052470055,-1.0370350328586524,-0.5426565248677515,9.991453058646645,177,170,185,237,52,60,67,412.73577472690033,44,302.88428443587804,0.5835282612978296,1.1082874212400664,1.6191107951535364,0.7218069663741712,14539,14527,Bedford+Fulton,Fulton,42,57,Pennsylvania,PA
42011,42CS006,3470,3286,3654,3927,273,457,641,128.19809981339546,575,161.38538830727776,-0.8241770478601894,-0.3323708154952586,0.14164769875978345,1.2561249476433742,4268,4046,4489,4822,333,554,776,129.1229290070497,678,157.9506485761145,-0.8086640647627358,-0.2665784820997966,0.21977889939340683,1.2210548974730426,427548,429248,Berks,Berks,42,11,Pennsylvania,PA
42013,42CS007,1353,1300,1406,1613,207,260,313,254.93150715770105,193,189.2837294452254,0.10720521337811512,0.6467342575486462,1.1408930475011803,0.7396430927484009,1643,1580,1706,1874,168,231,294,189.28296588144065,302,247.79080548421769,-1.0945848718485662,-0.606381962001419,-0.07517078600256791,1.3034523341005122,122356,121877,Blair,Blair,42,13,Pennsylvania,PA
42015,42CS008,587,562,613,592,-21,5,30,9.28672568986278,57,114.10459587955626,-1.5079830869922295,-1.0609809229142833,-0.541938598887722,10.107984432953327,720,689,751,841,90,121,152,202.42157418464404,106,177.00001669811476,-0.3144892434851949,0.2634675273832447,0.743137301194449,0.8672586357488076,59945,59887,Bradford+Sullivan,Bradford,42,15,Pennsylvania,PA
42113,42CS008,80,79,80,88,8,8,9,172.22418069620235,3,61.443932411674346,0.982898640533377,1.108797519693321,1.2316678247254076,0.31884889181606135,98,97,98,131,33,33,34,569.6530259576218,23,392.22373806275584,1.643168000278013,1.7780239712300991,1.9042299037815658,0.6685181044561707,5859,5864,Bradford+Sullivan,Sullivan,42,113,Pennsylvania,PA
42017,42CS009,5337,5060,5614,6046,432,709,986,132.20658457777628,875,163.1792920816083,-0.812388656917865,-0.3221186599179324,0.16343657306473686,1.232536458862604,6569,6235,6902,6909,7,340,674,52.68767171229475,589,91.16447526254285,-0.9273030177261242,-0.37805238510096134,0.15469872473589025,1.7252128747939781,643464,646085,Bucks,Bucks,42,17,Pennsylvania,PA
42019,42CS010,1774,1691,1857,1973,116,199,282,123.73959584217938,226,140.4548208838503,-0.6782019109850871,-0.16182548665119698,0.31662605386134357,1.1294114193621418,2184,2084,2284,2421,137,237,337,122.13236837428653,332,170.94809253852767,-0.9649629041915149,-0.4923816686370363,0.03468300701327249,1.3938189523344322,193087,194211,Butler,Butler,42,19,Pennsylvania,PA
42021,42CS011,1594,1537,1651,1844,193,250,307,226.54660611152767,280,253.66339773061853,-0.8074172954758453,-0.27791905836408237,0.24638661682781215,1.1152365681529024,1938,1869,2006,2071,65,133,202,100.76810757409065,297,224.52034290379643,-1.7416120690936434,-1.2302798269158672,-0.6964783394957941,2.2114986781846175,132459,132282,Cambria,Cambria,42,21,Pennsylvania,PA
42025,42CS012,685,657,712,827,115,142,170,263.9846887814044,93,172.4111294782864,0.3806982958007139,0.9070589408870133,1.4348804929355308,0.6485557315850509,839,805,873,996,123,157,191,240.34356801030205,143,218.93563598505725,-0.281120633398766,0.22636592937859823,0.7635062332326488,0.9051617997741153,64729,65316,Carbon,Carbon,42,25,Pennsylvania,PA
42027,42CS013,826,758,894,1047,153,221,289,167.54404911807902,141,106.75415628253256,0.0699223596301313,0.6123211763367526,1.116439414407018,0.6343042997205273,1021,940,1102,1222,120,201,282,127.58762039976925,127,80.59091543665046,-0.03229488142819849,0.4674767318609939,0.9756596068509891,0.6285254727359523,158495,157586,Centre,Centre,42,27,Pennsylvania,PA
42029,42CS014,3516,3286,3745,3919,174,403,633,90.68498544255297,555,124.79762547220724,-0.8571497621287705,-0.3475178674959381,0.16637329709432078,1.3727624775913896,4368,4090,4645,4407,-238,39,317,7.314592800736435,351,65.2337542861922,-1.0817014897787147,-0.5725251362862361,-0.08231142018994948,8.697319078562433,533664,538065,Chester,Chester,42,29,Pennsylvania,PA
42031,42CS015,341,325,357,451,94,110,126,352.76874861056075,48,154.1425818882466,1.4651974238984011,1.9834726275243333,2.497017124858868,0.43300904320078765,416,397,436,599,163,183,202,491.52080576211796,116,312.17201754622033,1.2938388872159945,1.7990087291792474,2.2834851008226673,0.6316561577162082,37368,37159,Clarion+Jefferson,Clarion,42,31,Pennsylvania,PA
42065,42CS015,475,456,494,526,32,51,70,138.5493874507062,58,157.3485858974069,-0.6932683692395144,-0.175094761393262,0.30409914850758163,1.1138753401629,578,555,601,656,55,78,101,176.21893885203494,123,278.5326086956522,-1.5278267205839011,-1.0264383648547963,-0.5251707298215029,1.5605516220185807,44233,44160,Clarion+Jefferson,Jefferson,42,65,Pennsylvania,PA
42033,42CS016,826,792,861,878,17,52,86,77.79097521472964,54,80.81311966078444,-0.5179831761056968,-0.04605261413707723,0.49354087721215856,1.0192414304234327,1011,969,1052,1231,179,220,262,275.1596131718087,206,257.08865814696486,-0.3450819827892171,0.17915157043636964,0.6853520505837591,0.9301069975072522,80185,80128,Clearfield,Clearfield,42,33,Pennsylvania,PA
42035,42CS017,346,330,362,371,9,25,41,79.15012722660131,29,92.79752539932268,-0.6042290365461626,-0.1398985902549955,0.36216712770843057,1.126866766103547,426,407,445,491,46,65,84,173.73183634292508,74,197.60734885708183,-0.7310951199940943,-0.25976130061194663,0.29039176863944516,1.120209057614474,37501,37448,Clinton+Potter+Tioga,Clinton,42,35,Pennsylvania,PA
42105,42CS017,181,174,188,188,0,7,14,54.00403223194732,15,109.9370915531668,-1.0795555284757425,-0.5642437136265173,-0.0647268163693201,1.7924573042917729,220,212,229,298,69,78,86,478.4712629287557,63,387.14434953604126,0.4371262214075093,0.9078107659783569,1.401848015439788,0.7988676001918306,16373,16273,Clinton+Potter+Tioga,Potter,42,105,Pennsylvania,PA
42117,42CS017,396,379,414,463,49,67,84,196.02235238956442,79,231.6715542521994,-0.8618530273082954,-0.34917458989737876,0.15592818586654125,1.1644425441797843,487,466,508,596,88,109,130,266.94049499715845,103,251.61841944546234,-0.33399940991970917,0.14429984864558174,0.6669696954775134,0.9340531995014728,40920,40935,Clinton+Potter+Tioga,Tioga,42,117,Pennsylvania,PA
42037,42CS018,592,564,620,659,39,67,95,123.9537067934932,83,153.84615384615384,-0.7935453617346131,-0.29612676875581895,0.18561248813306722,1.2228716817339687,727,693,760,871,111,144,178,222.6368288897686,113,174.26976342494063,-0.03344514761545154,0.4705692687906733,0.963927320993234,0.7773686784369193,64740,64842,Columbia,Columbia,42,37,Pennsylvania,PA
42039,42CS019,836,800,872,921,49,85,121,121.58057844154618,90,128.89981619841024,-0.5767620238876419,-0.07546562380086816,0.4542854232188986,1.0478569518200638,1018,975,1061,1217,156,199,242,238.34152845150547,153,183.44223967388047,0.030914433056473307,0.543833596212878,1.0244011958667547,0.7658088787168033,83786,83405,Crawford,Crawford,42,39,Pennsylvania,PA
42041,42CS020,2098,1986,2209,2361,152,263,375,121.88455283367509,321,148.55379868877748,-0.7881685486928185,-0.26412805749339696,0.23600866541957205,1.2141972357049524,2593,2458,2729,2793,64,200,335,76.16149637506558,365,139.05132708300792,-1.1094914243292056,-0.6242796688302001,-0.07524601800174509,1.816656128559825,259300,262493,Cumberland+Perry,Cumberland,42,41,Pennsylvania,PA
42099,42CS020,386,367,406,450,44,64,83,166.12023503551853,42,109.7752221641401,0.03346536793457153,0.5638333401371162,1.0688865096903766,0.6505817866199672,473,449,497,580,83,107,131,232.31631872219802,102,221.92245768243333,-0.3792259386957978,0.12582152286620055,0.6291849091449238,0.9463965941277754,45912,45962,Cumberland+Perry,Perry,42,99,Pennsylvania,PA
42043,42CS021,2247,2124,2370,2589,219,342,465,143.68049439245692,329,138.30841936738258,-0.4960156011824891,0.040612023413255406,0.568431523632762,0.9598027078837369,2770,2622,2919,3175,256,405,553,140.86581322812646,386,134.36602558524064,-0.46128634265350743,0.07261549681733989,0.5575876827911092,0.9515070004761811,285449,287275,Dauphin,Dauphin,42,43,Pennsylvania,PA
42045,42CS022,4758,4511,5006,5578,572,820,1067,171.13858187661165,979,204.42609999965197,-0.8425600460101486,-0.328584971686192,0.16747551327005347,1.1930505414063628,5828,5531,6124,5923,-201,95,392,16.614376929616245,544,94.73737371978287,-1.2796885823733557,-0.7768913237120716,-0.22822509287812515,5.642983238743431,574682,574219,Delaware,Delaware,42,45,Pennsylvania,PA
42049,42CS023,2451,2335,2567,2777,210,326,442,144.82110257164442,259,115.04762186793214,-0.1909468471131521,0.29156090411728197,0.8253238511850155,0.7919828092182707,2994,2855,3133,3389,256,395,534,146.5445225880453,358,132.9777355154559,-0.38253210869028914,0.14271256041996377,0.6949729265879565,0.9051278538524895,270149,269218,Erie,Erie,42,49,Pennsylvania,PA
42051,42CS024,1507,1452,1562,1679,117,172,227,160.90262929143347,164,153.2817720868285,-0.4471913634111228,0.08862785510841474,0.566692453540362,0.9471351566172691,1821,1756,1887,2307,420,486,551,382.01968375213846,378,297.3006984206883,0.33358440744516804,0.8416084972043115,1.3465985536894296,0.7766350269159917,128391,127144,Fayette+Greene,Fayette,42,51,Pennsylvania,PA
42059,42CS024,375,359,390,401,11,26,42,88.5149397220935,34,113.95693098343713,-0.7612633597257535,-0.24562301259591454,0.24893116814799263,1.240460770454775,453,435,472,540,68,87,105,244.53518681775478,68,191.9060789072642,0.03813310057300778,0.5290765588778564,1.0347931280444076,0.775825300990467,35803,35434,Fayette+Greene,Greene,42,59,Pennsylvania,PA
42055,42CS025,1363,1296,1430,1699,269,336,403,259.0034918980227,235,180.92464039623778,0.2771692740700274,0.7809021213151106,1.2753358113784026,0.6964710457281243,1673,1592,1754,2038,284,365,446,233.72430632107523,289,184.9860460352818,-0.01653193716688159,0.47586825406156397,0.966818504782236,0.7893095062248081,155866,156228,Franklin,Franklin,42,55,Pennsylvania,PA
42061,42CS026,395,376,414,489,75,94,113,254.72174211787672,75,203.89207312929022,-0.004091392502680028,0.5086147647019467,1.045238839970869,0.7919974871055321,482,459,504,593,89,111,134,253.82076893576252,101,230.01594169892962,-0.26521284227935765,0.24312773333617557,0.7636302378396521,0.8981554051046474,44141,43910,Huntingdon+Juniata+Mifflin,Huntingdon,42,61,Pennsylvania,PA
42067,42CS026,208,198,218,295,77,87,97,442.9202912982804,64,325.0656056886481,0.6699322050990396,1.1823787651344042,1.6990177166418432,0.725593774586257,252,240,264,354,90,102,114,438.21342947431873,73,313.0494446588619,0.7740473208238292,1.2542335280612986,1.8074567879910501,0.7074535294561597,23626,23319,Huntingdon+Juniata+Mifflin,Juniata,42,67,Pennsylvania,PA
42087,42CS026,474,454,494,614,120,140,160,364.3932911429727,126,328.11075908163707,-0.13414081186306534,0.3801347748546595,0.8705546460128333,0.8940412342016664,579,555,603,658,55,79,103,171.36691567904077,105,227.63240618292974,-1.07600943961412,-0.5450481203744969,-0.07863285107558544,1.3117389094861702,46082,46127,Huntingdon+Juniata+Mifflin,Mifflin,42,87,Pennsylvania,PA
42063,42CS027,761,725,797,935,138,174,210,251.19494631125224,116,167.25944439104106,0.29058897319330035,0.8076815321233398,1.3584962912047016,0.6620548518049039,929,886,972,1115,143,186,229,224.4261731597902,159,191.75108538350216,-0.17152048814255005,0.32188161233701595,0.8408815891892372,0.8498393570230988,83224,82920,Indiana,Indiana,42,63,Pennsylvania,PA
42069,42CS028,2323,2231,2415,2524,109,201,293,112.34042296685321,267,149.23218086716753,-0.8578226503469417,-0.36331999978488366,0.13099023617835628,1.3218161795091434,2853,2741,2964,2941,-23,88,200,41.0008174590066,315,146.07543984938,-1.5625491257845474,-1.0406398761455693,-0.5545179960782757,3.522899520739114,214699,215642,Lackawanna+Wyoming,Lackawanna,42,69,Pennsylvania,PA
42131,42CS028,269,258,280,278,-2,9,20,41.211624206617806,30,137.82542113323123,-1.514000037160928,-0.9593945330665973,-0.4868522837335563,3.008907307727633,329,316,343,394,51,65,78,248.89418661794934,54,207.46090898613085,-0.07745629912746664,0.3966345342799455,0.939998313060528,0.8208599629265824,26120,26029,Lackawanna+Wyoming,Wyoming,42,131,Pennsylvania,PA
42071,42CS029,4410,4172,4647,5188,541,778,1016,169.34246144842223,748,162.70803008358362,-0.4204586107745363,0.07300183602620458,0.5619938927907374,0.9595897850139045,5424,5138,5710,5904,194,480,766,86.74244883941535,739,133.51448424384552,-0.9887597304352342,-0.47240906132830623,0.04785562036914167,1.5360066156013625,551663,553498,Lancaster,Lancaster,42,71,Pennsylvania,PA
42073,42CS030,994,957,1031,1217,186,223,260,312.24390450531536,140,195.86354839461842,0.6518219821430055,1.1643882292049625,1.6751767282783419,0.6244793991934439,1210,1166,1254,1387,133,177,221,207.1482893754295,196,229.10310808757347,-0.7475479464279441,-0.20027292696258972,0.28467292447087816,1.0997801766793405,85774,85551,Lawrence,Lawrence,42,73,Pennsylvania,PA
42075,42CS031,1321,1260,1383,1523,140,202,263,169.2609180343309,156,130.9200772092763,-0.10731882198356918,0.38239327429869446,0.944401381740099,0.7696646813609601,1622,1548,1696,1877,181,255,329,177.71890368712792,226,157.53959402186035,-0.3425530507777434,0.18809797707128695,0.7036389564202611,0.8829903726386868,142988,143456,Lebanon,Lebanon,42,75,Pennsylvania,PA
42077,42CS032,2961,2800,3122,3397,275,436,597,140.03032008043766,518,166.26811536054183,-0.8231370282373782,-0.25831482282299634,0.2930177328025085,1.1846567447405882,3646,3452,3840,3976,136,330,524,87.86041636471437,472,125.73657122763647,-0.8874741018545453,-0.371502663260063,0.1256408983787537,1.4267687089712877,373854,375388,Lehigh,Lehigh,42,77,Pennsylvania,PA
42079,42CS033,3543,3404,3683,3970,287,427,566,157.94024450783903,463,171.45502237309057,-0.6340681691340146,-0.1438233104097062,0.3784319608660024,1.0830296148934653,4351,4183,4519,4602,83,251,419,76.99177077394057,534,163.8499208365551,-1.3774048724360621,-0.8754971830851291,-0.35430539339332184,2.1197008545448863,324050,325908,Luzerne,Luzerne,42,79,Pennsylvania,PA
42081,42CS034,1096,1047,1145,1268,123,172,221,181.24094778338082,130,136.9826927636258,-0.07594912605800651,0.4274118939045372,0.9708327790223572,0.7514355722706914,1341,1282,1399,1563,164,222,281,195.56034666007267,261,229.6322364948091,-0.8715594045066559,-0.32954460298421645,0.15189708301229796,1.1689678537146602,113883,113660,Lycoming,Lycoming,42,81,Pennsylvania,PA
42023,42CS035,53,52,53,57,4,4,5,112.80169595513944,5,133.3629695487886,-0.3312361694626484,-0.2080396925249,-0.07805436337785783,0.9561831766841881,64,64,65,77,12,13,13,283.9514318491641,3,67.14413607878245,2.0407930622121375,2.1652642559322643,2.282621200336196,0.2191868901015307,4499,4468,McKean and Nearby Counties,Cameron,42,23,Pennsylvania,PA
42047,42CS035,334,321,347,317,-30,-17,-4,-66.04686283640041,21,81.92191411202496,-1.9875605494607897,-1.4521870397721364,-0.9264394679825231,-1.3182208397155928,408,392,424,468,44,60,76,195.0729676891477,57,185.04090377873004,-0.39318973613495806,0.09426352541862235,0.5880300722260238,0.9330453687552128,30761,30804,McKean and Nearby Counties,Elk,42,47,Pennsylvania,PA
42053,42CS035,71,70,72,87,15,16,17,277.096147058298,4,68.84681583476764,1.9587854867669947,2.075250810649451,2.207787742729209,0.23392789419944227,88,87,89,109,20,21,22,302.84751801036134,21,299.1452991452992,-0.08234465986759411,0.036635429145114466,0.16558641805524893,0.9434006440251883,6972,7020,McKean and Nearby Counties,Forest,42,53,Pennsylvania,PA
42083,42CS035,435,418,452,444,-8,9,26,27.282213683867035,26,77.39054942329157,-1.014454099411732,-0.5103813470696117,-0.015792519893098416,2.5576234936773345,528,507,548,631,83,103,124,258.439171652442,97,242.53638045706856,-0.3395904097812056,0.16420656785087176,0.678025117325898,0.9294734489894082,40315,39994,McKean and Nearby Counties,McKean,42,83,Pennsylvania,PA
42123,42CS035,414,398,431,501,70,87,103,269.4617646925092,40,124.52977039823581,0.9474971181038702,1.4483762875193393,1.9674781996618944,0.4568642256559655,503,483,522,683,161,180,200,472.6480912825522,90,235.7008170961659,1.8300281847711173,2.360411125571234,2.890000858102138,0.49593349091628164,38545,38184,McKean and Nearby Counties,Warren,42,123,Pennsylvania,PA
42085,42CS036,1251,1204,1298,1446,148,195,242,212.54902320492727,170,185.21208599651362,-0.23543031594446312,0.27903711596475017,0.8005166238258671,0.8669414957491943,1526,1470,1583,1842,259,316,372,286.9116851308984,244,221.76778004998863,0.13131117205777035,0.6428370841077203,1.1986214591728248,0.7705070574150527,110144,110025,Mercer,Mercer,42,85,Pennsylvania,PA
42089,42CS037,1281,1209,1354,1540,186,259,331,184.2865700074739,213,151.58164415082254,-0.17528154668493023,0.3169987041444529,0.8679846275998195,0.8193681182329188,1579,1492,1667,1808,141,229,316,135.17791231350304,202,119.43899150918853,-0.3794616846606225,0.1600658460051445,0.6680084316451655,0.8797208526817164,168622,169124,Monroe,Monroe,42,89,Pennsylvania,PA
42091,42CS038,6737,6369,7105,7627,522,890,1258,125.12886130464364,1168,164.22696973354124,-0.8910009865561268,-0.3922281287439006,0.12315803337850738,1.3109896146923483,8327,7883,8771,8373,-398,46,490,5.307586979490341,715,83.1348947965695,-1.3147486332026117,-0.7915037329065886,-0.2554599933260266,15.327626735658175,853453,860048,Montgomery,Montgomery,42,91,Pennsylvania,PA
42093,42CS039,197,189,205,217,12,20,28,133.6219999755669,28,185.40999889636905,-1.0464322612665755,-0.5231605182346633,-0.06294290001816565,1.3220550061199168,240,231,249,253,4,13,22,71.36999158165888,48,265.32529987286495,-2.42508264459773,-1.967024683773383,-1.4026300550453943,3.4503715718961074,18122,18091,Montour+Northumberland,Montour,42,93,Pennsylvania,PA
42097,42CS039,996,957,1035,1265,230,269,308,353.6483081558933,239,314.00886845130566,-0.1459231924165369,0.4112990503903569,0.8961449934001405,0.8846263354553933,1215,1168,1262,1308,46,93,140,101.50136524860405,206,225.639677532422,-1.7435337068158157,-1.2629791035772593,-0.7492977332293461,2.1992877924825165,91335,91296,Montour+Northumberland,Northumberland,42,97,Pennsylvania,PA
42095,42CS040,2661,2527,2795,3032,237,371,505,142.78567738504492,417,160.45404261459285,-0.6497262994345232,-0.1663583818225527,0.33653942182962426,1.120720317877639,3275,3113,3437,3550,113,275,437,87.80103991840376,381,121.52528587148942,-0.8342864248844357,-0.33903391620342277,0.1845767100180323,1.3790885208907127,311865,313515,Northampton,Northampton,42,95,Pennsylvania,PA
42101,42CS041,12228,11541,12914,15527,2613,3299,3986,248.06891431636097,2461,185.0363186719891,0.12091649574693385,0.6411675230338135,1.1343607104413689,0.7456809061894608,14859,14044,15675,16427,752,1568,2383,99.22426083651844,1576,99.75561141138365,-0.520075297102807,-0.026678742595202455,0.5128372716184205,1.0047141240926205,1596011,1579861,Philadelphia,Philadelphia,42,101,Pennsylvania,PA
42103,42CS042,477,452,502,525,23,48,73,99.42096262615841,45,92.57671866963827,-0.44720743155345644,0.07833657482095095,0.6025390717839985,0.9122816294506743,597,566,628,684,56,87,118,145.59274971114118,77,128.86166616460824,-0.3661255479823962,0.1657844753001621,0.6720602730883747,0.8750249415677952,58330,59754,Pike,Pike,42,103,Pennsylvania,PA
42107,42CS043,1647,1585,1708,1916,208,269,331,226.72106734477694,239,201.13189286991644,-0.24292963748344698,0.2637693774607867,0.7776792578044601,0.8838529363074807,2014,1940,2088,2133,45,119,193,83.19777877273246,261,182.27147975110515,-1.5002076432157014,-0.984993778126662,-0.5070287279965152,2.1725848938351433,142593,143193,Schuylkill,Schuylkill,42,107,Pennsylvania,PA
42109,42CS044,304,287,321,361,40,57,74,171.8259830050991,42,126.61407827965633,-0.07103590399979096,0.44733038688661975,0.959255632738018,0.724168616691065,374,354,394,435,41,61,81,153.9312986208531,79,199.31878390311593,-0.942594369676799,-0.4506188346644046,0.006723116617393297,1.27397429723845,39806,39635,Snyder+Union,Snyder,42,109,Pennsylvania,PA
42119,42CS044,306,288,325,390,65,84,102,233.99116215271394,42,117.50442973048587,0.6285917166956673,1.1520806919036177,1.7069663013212821,0.49624132020263545,377,355,399,484,85,107,129,251.26708616244616,78,183.20180383314542,0.18807216359156093,0.6780757777941895,1.2035601595064946,0.7223595066162019,42892,42576,Snyder+Union,Union,42,119,Pennsylvania,PA
42111,42CS045,824,793,856,950,94,126,157,204.2194094523724,103,167.43883605624643,-0.11334199403581853,0.36641510613155565,0.9030017949468826,0.813421809070589,1003,965,1041,1190,149,187,225,253.57250940063344,212,287.7736904260951,-0.8372000630788972,-0.34326804542849765,0.14691570743529572,1.1288344512524005,73818,73669,Somerset,Somerset,42,111,Pennsylvania,PA
42115,42CS046,394,378,411,465,54,71,87,219.73869204583434,37,114.92765252504336,0.575270446732331,1.0643672723013502,1.567426898228789,0.515729464684429,480,460,500,577,77,97,117,253.4468875184789,56,145.89412255106294,0.56429681634959306,1.0620306316105341,1.5501166921250493,0.5697828681223737,38633,38384,Susquehanna+Wayne,Susquehanna,42,115,Pennsylvania,PA
42127,42CS046,517,495,539,594,55,77,99,181.1363709849243,29,68.02189210320563,0.6611889448284808,1.127209936728783,1.620680388943529,0.37072796978841366,634,607,660,833,173,199,226,387.4506612739115,109,212.13241733647314,1.205953840126788,1.7567142788792678,2.285346525797517,0.5447718133852395,51160,51383,Susquehanna+Wayne,Wayne,42,127,Pennsylvania,PA
42121,42CS047,538,516,559,635,76,97,119,232.13334575500065,58,138.29554712182326,0.47783413994062,0.9149793159731582,1.4486536451396548,0.5897018289482345,654,628,680,870,190,216,242,432.5573770723086,136,272.07073839198193,1.0588116356131725,1.6020025640657756,2.1228594777293592,0.6260862824960736,50327,49987,Venango,Venango,42,121,Pennsylvania,PA
42125,42CS048,2203,2113,2293,2308,15,105,195,60.306451387875455,135,77.56540391465889,-0.6915915317982813,-0.16558805121788936,0.35995148457376036,1.27404923139372,2696,2588,2804,2991,187,295,403,140.91232349869617,354,169.03506761402704,-0.8210714502355301,-0.2882937050142469,0.2546324325119097,1.1955249904335614,208856,209424,Washington,Washington,42,125,Pennsylvania,PA
42129,42CS049,3880,3728,4032,4253,221,373,525,126.70146079315573,425,144.40964769709086,-0.7017520188740293,-0.19400817377393484,0.3411809732771542,1.1367146477521552,4736,4554,4918,5235,317,499,681,141.2765934978429,589,166.76387481101037,-0.7785944909274722,-0.25376532716960865,0.2208977814131431,1.1780460577397616,353162,353194,Westmoreland,Westmoreland,42,129,Pennsylvania,PA
42133,42CS050,3645,3449,3841,4231,390,586,782,154.3017198325035,424,111.67666444981464,-0.09123077637074513,0.42300883121990057,0.9244164680560911,0.7225218275721758,4495,4259,4732,5253,521,758,994,165.32433860178065,684,149.22768129854262,-0.3554648013935603,0.14922160670352153,0.7043294057778927,0.9014463013034737,455601,458360,York,York,42,133,Pennsylvania,PA
44001,44CS001,460,438,481,495,14,35,57,84.08604527084826,63,149.9018499791803,-1.1498654518858982,-0.6556689430648541,-0.14619003515768708,1.7336620327536583,564,537,590,594,4,30,57,59.581850598273036,66,129.90080302314595,-1.241975051438228,-0.703840167500317,-0.18076320668207,2.1104908030891614,50433,50808,Bristol+Providence,Bristol,44,1,Rhode Island,RI
44007,44CS001,4959,4676,5242,5966,724,1007,1290,184.0693138540568,1192,217.8896811626876,-0.8955795336172017,-0.340400529214995,0.19143411397862226,1.182562763928002,6080,5741,6420,6267,-153,187,526,28.324960110347927,626,95.06699489584393,-1.164272749126218,-0.6570991721105729,-0.14597185412844774,3.338398756455544,656479,658483,Bristol+Providence,Providence,44,7,Rhode Island,RI
44003,44CS002,1556,1483,1629,1691,62,135,208,95.84019780813715,205,145.15329604191743,-1.021421523558834,-0.5069780649333588,0.04720372449862295,1.503427322589344,1917,1828,2005,2106,101,189,278,110.9985992623872,163,95.51266275240539,-0.36241733322889225,0.1337281701457588,0.6516756495015052,0.8559666066053894,169476,170658,Kent,Kent,44,3,Rhode Island,RI
44005,44CS003,721,684,757,719,-38,-2,35,-2.163311909460421,38,53.67863449087698,-1.056725238862506,-0.5804095525603518,-0.05586684096391675,-71.50322564740961,885,841,929,887,-42,2,46,1.9976790552501318,52,60.97417978002392,-1.105280339964759,-0.5912313121738338,-0.07157321140805392,19.233182967502742,84950,85282,Newport,Newport,44,5,Rhode Island,RI
44009,44CS004,1055,999,1111,1163,52,108,164,100.28703098487725,87,80.75807387352543,-0.3473951916084734,0.19014489445197935,0.7395540055459646,0.7978841743799617,1307,1239,1374,1380,6,73,141,56.32656164260612,71,54.41864030045221,-0.4800219896954756,0.028416381532984893,0.5227185270379673,0.9531574787820205,129275,130470,Washington,Washington,44,9,Rhode Island,RI
45001,45CS001,262,251,272,301,29,39,50,193.544502812524,34,168.07415036045313,-0.24929594814946054,0.25122135304204735,0.7884418107659621,0.8467729472793177,322,310,335,418,83,96,108,393.9553824517126,41,168.82154327596146,1.7196773505538283,2.257009499538125,2.7656185076504096,0.4240969653929822,24275,24286,Abbeville+Edgefield+Greenwood+McCormick,Abbeville,45,1,South Carolina,SC
45037,45CS001,196,185,207,275,68,79,90,363.39031448136114,27,124.76414186145018,1.868572282414935,2.3845697113882665,2.90289259398233,0.33902266816224785,246,232,259,370,111,124,138,476.4593408202405,56,214.69922938312308,2.101840852425694,2.6195608745853893,3.116121205335846,0.44701695654920315,25969,26083,Abbeville+Edgefield+Greenwood+McCormick,Edgefield,45,37,South Carolina,SC
45047,45CS001,687,657,717,838,121,151,181,260.473815283189,84,144.83591010977642,0.6131797950141774,1.1652533405655092,1.6597982527101738,0.5523912509444243,843,808,879,1014,135,171,206,246.17176697588505,131,189.13963124990977,0.04911774513851458,0.5749831131130895,1.1081298059296179,0.7638438200072929,69596,69261,Abbeville+Edgefield+Greenwood+McCormick,Greenwood,45,47,South Carolina,SC
45065,45CS001,138,134,142,136,-6,-2,2,-24.537783633217515,13,163.67642429965375,-2.4060081656291192,-1.8782472519224884,-1.396191131231178,-13.699879365779976,172,167,177,180,3,8,13,84.324292766969,19,195.39284245166598,-1.601944044123398,-1.1300721152619448,-0.6321017952465064,2.0652860331823604,9531,9724,Abbeville+Edgefield+Greenwood+McCormick,McCormick,45,65,South Carolina,SC
45003,45CS002,1553,1480,1625,1928,303,375,448,265.76185634000836,157,111.12159675364506,1.0307024452782314,1.5478418838055616,2.098229025093761,0.4170141030575801,1919,1831,2007,2501,494,582,670,341.2628494994344,390,228.70949203035386,0.6163406178679068,1.1318162496424091,1.651344390114996,0.6690360421150028,169544,170522,Aiken,Aiken,45,3,South Carolina,SC
45007,45CS003,1947,1860,2035,2446,411,499,586,293.1017542522828,295,173.44693944545975,0.6913300206398457,1.180572122303956,1.6910728663264094,0.5905788781559083,2405,2298,2512,3032,520,627,734,303.6906019764075,504,244.0807984928979,0.06313093378934329,0.6035904851377096,1.085666294048933,0.8024357272707824,204097,206489,Anderson,Anderson,45,7,South Carolina,SC
45013,45CS004,1381,1300,1462,1638,176,257,338,163.55742124046716,100,63.54754150448804,0.4939524370533358,1.0104827106136138,1.5762971143102766,0.3870297850814773,1723,1624,1821,2109,288,386,485,202.1725251308714,184,96.25646069179099,0.5362815590674811,1.05883514299344,1.545715145073791,0.4748817098925113,188835,191156,Beaufort,Beaufort,45,13,South Carolina,SC
45015,45CS005,1399,1299,1499,1617,118,218,318,112.76208023708027,126,65.25088360571549,-0.01313213093881028,0.4658010786052955,0.9757098840188092,0.5760144388800674,1760,1638,1882,2139,257,379,501,160.50139599085915,282,119.51583372889401,-0.1266233047860022,0.41484448118198575,0.9104681545930091,0.7426793662918502,231721,235952,Berkeley,Berkeley,45,15,South Carolina,SC
45017,45CS006,149,143,156,193,37,44,50,368.3099913202544,15,126.88566192020302,1.926865233643694,2.398941347887999,2.9287880564897306,0.3367730624923528,183,175,190,235,45,52,60,369.395098416461,39,275.44318101560845,0.4350476688223771,0.9316815625485045,1.447909785981359,0.7316709121927203,14186,14159,Calhoun+Richland,Calhoun,45,17,South Carolina,SC
45079,45CS006,2673,2494,2852,3272,420,599,778,172.46337107161355,304,87.52714229158919,0.35743822351491283,0.8579882130123067,1.368377045412155,0.5066656384726174,3317,3102,3533,3987,454,670,885,160.16597355521773,429,102.62004033039346,0.023497098874445618,0.5658014510177528,1.0764439330485196,0.6397551476907802,416785,418047,Calhoun+Richland,Richland,45,79,South Carolina,SC
45019,45CS007,2865,2688,3041,3276,235,411,588,120.28256467468722,274,80.14429873738605,-0.12013106089621879,0.4026162421565655,0.9351048909894811,0.6646838685492442,3549,3336,3762,3835,73,286,499,69.28612726890942,378,91.63680793603848,-0.7591012343816197,-0.22480054886732664,0.2918174620674014,1.3179737589091003,410260,412498,Charleston,Charleston,45,19,South Carolina,SC
45021,45CS008,561,537,585,680,95,119,143,253.71236795098588,85,181.06294600063902,0.19797027891725016,0.7180374441674158,1.2320045137563584,0.7077124858637448,685,656,714,935,221,250,279,446.4529881715489,187,333.505733801787,0.6135903405670953,1.1262335615727466,1.612064575264155,0.7440397591043331,56334,56071,Cherokee,Cherokee,45,21,South Carolina,SC
45023,45CS009,365,351,379,474,95,109,123,405.72274715946736,46,171.13095238095238,1.821372036782915,2.3614394163044716,2.8787748299721287,0.41796039630400694,447,430,463,546,83,99,116,307.80105292087364,85,263.81948539681554,-0.07016408756105744,0.4479201332650555,0.9549964714817042,0.8485538839440244,32256,32219,Chester+Fairfield,Chester,45,23,South Carolina,SC
45039,45CS009,236,227,245,329,84,93,102,528.3402889866703,41,233.68481048731832,2.428155782684861,2.9514181806628654,3.4804251623167723,0.4375792939579924,286,276,297,392,95,106,116,510.21075965256716,50,241.38263976054841,2.160096557227808,2.703756710374404,3.172651940137489,0.46866919811543806,21054,20714,Chester+Fairfield,Fairfield,45,39,South Carolina,SC
45025,45CS010,432,413,450,597,147,165,184,455.383384071605,67,184.38252493980048,2.2144244618642617,2.7170609981397584,3.2210630064277335,0.4024629841111253,526,504,549,694,145,168,190,387.2221606681767,113,261.16902026948947,0.7590650510085978,1.2827038154729786,1.7674300487046961,0.6704663229046953,43605,43267,Chesterfield+Marlboro,Chesterfield,45,25,South Carolina,SC
45069,45CS010,300,289,312,356,44,56,67,253.05435634583452,38,172.303041753259,0.2504160815338546,0.7968125815836921,1.330849919882619,0.6689077481272547,366,352,379,458,79,92,106,349.05741673741215,73,276.462791138042,0.22721944255912432,0.7230637518927961,1.2423915512744275,0.7835256885666019,26465,26405,Chesterfield+Marlboro,Marlboro,45,69,South Carolina,SC
45027,45CS011,321,308,335,501,166,180,193,684.6367381718186,77,293.51037133509095,3.3890582657063337,3.8924125666548877,4.43213603911956,0.426335949970826,391,375,407,563,156,172,188,553.6396842933742,70,225.55906425211057,2.7401129707742324,3.285779659805703,3.8102018987180113,0.40505382269810475,31481,31034,Clarendon+Williamsburg,Clarendon,45,27,South Carolina,SC
45089,45CS011,357,344,370,469,99,112,125,437.03881524379483,79,308.152385905604,0.7786698078481705,1.2960799798030656,1.827305824298394,0.6988541535318042,434,418,450,540,90,106,122,347.8758008561843,72,235.71779341954496,0.5950193074915426,1.1496099187905922,1.6094130226113044,0.6712744475530812,30764,30545,Clarendon+Williamsburg,Williamsburg,45,89,South Carolina,SC
45031,45CS012,690,663,717,879,162,189,216,357.3807002947879,101,191.2214824398094,1.1780025169394996,1.6470768898389865,2.194416516182328,0.5322441698007304,840,807,872,1099,227,259,292,413.37308841928507,154,245.35576586049774,1.1692801993070427,1.6823868234735453,2.1619342744511876,0.591266715684337,63382,62766,Darlington,Darlington,45,31,South Carolina,SC
45033,45CS013,304,292,316,461,145,157,169,659.4205665611786,48,201.64537020829684,4.070291302447987,4.576602056313881,5.090778595030465,0.30385598813592024,368,354,383,503,120,135,149,478.71720560678995,65,231.1850903400199,2.0023251702232407,2.4561391004017925,2.993951598537782,0.4793647150996564,28565,28116,Dillon+Marion,Dillon,45,33,South Carolina,SC
45067,45CS013,340,328,353,468,115,128,140,525.0019321705788,80,328.3398317258362,1.4896429401046893,1.963212277148395,2.4473077855185568,0.6205556542245733,412,397,426,517,91,105,120,366.0028972165573,80,277.5657483866491,0.3948488530651972,0.8851237728818723,1.388170359347971,0.7512487982778958,29238,28822,Dillon+Marion,Marion,45,67,South Carolina,SC
45035,45CS014,1037,967,1107,1252,145,215,285,158.71858190927148,103,76.13603464312773,0.29939977810119434,0.8246795752803053,1.3159869574434602,0.4774683366838717,1288,1204,1372,1589,217,301,385,184.38074815432242,229,140.3788389627904,-0.054288790383614366,0.44053817129650275,0.9828920218843832,0.7588301457191535,162341,163130,Dorchester,Dorchester,45,35,South Carolina,SC
45041,45CS015,1317,1259,1376,1751,375,434,492,379.8638903951153,240,210.26962699044293,1.2011469326743955,1.7144482274001993,2.221059497395135,0.5522656388784594,1616,1546,1687,2061,374,445,515,325.7389921152107,275,201.39438146292878,0.741454521041482,1.2316252798944545,1.7241740483269663,0.6168822793131264,136967,136548,Florence,Florence,45,41,South Carolina,SC
45043,45CS016,687,660,714,885,171,198,225,374.68974550585676,91,172.15828472331705,1.4945514454535918,2.0473752586646508,2.543701473620472,0.4571606448796111,845,812,878,1053,175,208,241,326.16310427365227,126,197.33441919468765,0.7741143623301289,1.2910905132226713,1.8192020294925597,0.6021263555787958,63430,63851,Georgetown,Georgetown,45,43,South Carolina,SC
45045,45CS017,3872,3645,4099,4546,447,674,901,153.38836910885055,449,102.16774624171356,-0.0062979356789476,0.5091216700504334,1.0189333819753836,0.665085689678147,4801,4526,5076,5780,704,979,1254,183.72794349106977,881,165.34230172999472,-0.3070659898645592,0.1809321203858448,0.7532666268394416,0.8990117448806004,527368,532834,Greenville,Greenville,45,45,South Carolina,SC
45005,45CS018,91,90,92,119,27,28,29,411.72653969207073,14,208.20423844342542,1.9188500697552904,2.0385019810225904,2.160892823811149,0.48805692050920024,110,109,111,155,44,45,46,572.7277574155777,17,215.81820490034278,3.4436278477750912,3.5679260460402547,3.697655960517345,0.36865347762228595,8069,7877,Hampton and Nearby Counties,Allendale,45,5,South Carolina,SC
45009,45CS018,160,154,166,205,39,45,51,405.70730161632895,31,278.2348541510845,0.8048793316638322,1.2800704292037566,1.7868075976825795,0.6709585622175752,195,188,201,237,36,42,49,321.4144729400869,24,181.84573420215185,0.9110375187968801,1.3903924614877412,1.9322599041729147,0.5527370808732329,13370,13198,Hampton and Nearby Counties,Bamberg,45,9,South Carolina,SC
45011,45CS018,219,210,228,296,68,77,86,446.1820756227928,34,197.86614936954413,1.953130779479107,2.496359238676006,3.0069022605215467,0.437755351954879,270,259,281,317,36,47,58,228.5430031254046,51,247.83749635533093,-0.7175650940887501,-0.1985098515523762,0.3028448382410716,1.0618456556849576,20620,20578,Hampton and Nearby Counties,Barnwell,45,11,South Carolina,SC
45029,45CS018,474,458,491,558,67,84,100,261.1445074328778,59,184.31740081224615,0.23596107347964546,0.7725116728004734,1.2961552210479963,0.6974625393057889,583,563,603,729,126,146,166,380.41125324691154,122,317.097260487602,0.09907755563474961,0.6483364029989979,1.162364254745937,0.8279076789598055,38412,38474,Hampton and Nearby Counties,Colleton,45,29,South Carolina,SC
45049,45CS018,199,191,207,250,43,51,59,329.33781373122997,31,200.05377789728422,0.8168243857507095,1.305564413892687,1.8078167521475088,0.5957684444701565,241,232,250,294,44,53,62,290.60456942247345,36,197.49835418038185,0.40628512711385356,0.9432953480748247,1.408307109217262,0.6670199288905735,18595,18228,Hampton and Nearby Counties,Hampton,45,49,South Carolina,SC
45053,45CS018,227,214,240,269,29,42,55,171.21721966288308,24,98.02253156802014,0.2099500590962791,0.7329623520226043,1.2245276595645684,0.5591654158505083,290,275,306,387,81,97,112,321.17103678826174,68,225.5988321942804,0.4773580022601838,0.9507195698393883,1.443603530642607,0.6952441036139398,29381,30142,Hampton and Nearby Counties,Jasper,45,53,South Carolina,SC
45051,45CS019,3289,3137,3442,4023,581,734,886,248.0218076011851,353,119.36059240724617,0.7789909082051952,1.3005230416880413,1.8005481361706126,0.48059519020582014,4129,3941,4317,5256,939,1127,1315,309.82477919052866,639,175.63775194672047,0.8222610621627815,1.3486749428379512,1.904596274480012,0.5663913393920471,354891,363817,Horry,Horry,45,51,South Carolina,SC
45055,45CS020,598,569,626,716,90,118,147,215.9967365795995,73,133.1812998859749,0.30089811218348567,0.8271211217935738,1.3291655659992683,0.6114250487380606,739,705,773,985,212,246,280,372.33733145501463,124,187.756461699196,1.3262989121499107,1.836306811809307,2.3295024206762593,0.502222041298975,65775,66043,Kershaw+Lee,Kershaw,45,55,South Carolina,SC
45061,45CS020,202,195,209,267,58,65,72,469.91569387341536,51,370.95405503697424,0.4631596425429312,0.9993371056688202,1.4836608716724007,0.7773729479342175,245,237,253,296,43,51,59,312.6018385395444,53,325.03372991536855,-0.6661185746962678,-0.11295640571800454,0.3954467190933337,1.0197630896375505,16498,16306,Kershaw+Lee,Lee,45,61,South Carolina,SC
45057,45CS021,816,774,858,968,110,152,194,187.31009420721514,94,115.96229169450926,0.1890808212160957,0.7082312760241319,1.2206606272114,0.6150418698368746,1026,975,1078,1295,217,269,320,269.1087827086174,174,174.3504443932304,0.4338656016015764,0.9381737606523795,1.442094022371716,0.6454775095501845,97273,99799,Lancaster,Lancaster,45,57,South Carolina,SC
45059,45CS022,745,716,774,851,77,106,135,188.45206920576618,79,140.315562002309,-0.03678901745386293,0.47524385498072835,0.9754673895733073,0.7376169806833173,915,880,950,1127,177,212,247,312.5657537649736,180,265.61992739721984,-0.039326198989837025,0.47384264429158324,0.9846077013802826,0.8458117638536042,67562,67766,Laurens,Laurens,45,59,South Carolina,SC
45063,45CS023,2200,2073,2327,2618,291,418,545,169.4291510815314,235,95.23873852575836,0.2538035177871429,0.7324474727615027,1.2614283663623773,0.5607740599977467,2740,2585,2894,3290,396,550,705,183.76361074481292,405,135.28319281696352,-0.05182170518854152,0.46603774573597134,1.0152696245334212,0.7348447833308543,296098,299372,Lexington,Lexington,45,63,South Carolina,SC
45071,45CS024,364,348,381,488,107,124,140,391.770700860987,67,212.44550138723739,1.253708548390715,1.7968771595867894,2.2964760147913923,0.5379163386441205,444,425,464,562,98,118,137,310.18002964995395,71,187.0636279805032,0.7425443318225516,1.242331879313042,1.7372199560905597,0.5980013434674875,37845,37955,Newberry+Saluda,Newberry,45,71,South Carolina,SC
45081,45CS024,168,160,177,267,90,99,107,620.7102360590877,30,188.92679086853843,3.8119270170467985,4.315119539580164,4.818329494010437,0.30131489934847516,203,194,213,285,72,82,91,434.29008574545884,44,233.76899373074062,1.4878346286432838,2.00309983924754,2.541095375440102,0.5317729507456507,19055,18822,Newberry+Saluda,Saluda,45,81,South Carolina,SC
45073,45CS025,801,767,835,869,34,68,102,103.99239074898232,75,114.191461016304,-0.589317949297269,-0.09935840066141276,0.42820167874801357,1.0822302240879165,985,944,1025,1193,168,208,249,263.46249969090974,205,259.0968263798486,-0.4316220872079441,0.06104631600418259,0.5652124311629326,0.9787344195632496,78815,79121,Oconee,Oconee,45,73,South Carolina,SC
45075,45CS026,881,845,918,1155,237,274,310,389.881707340018,132,188.15480008552493,1.4815555422137954,2.0156600113438548,2.509102053169075,0.48083663514017566,1069,1026,1112,1417,305,348,391,418.51177659894006,190,228.6209344579879,1.403516347120089,1.8915043023731144,2.4211962805299687,0.5447051216260264,84186,83107,Orangeburg,Orangeburg,45,75,South Carolina,SC
45077,45CS027,1108,1052,1165,1319,154,211,267,193.14812286959676,145,132.83253939171857,0.048120159623291095,0.595207819686978,1.0963865530046364,0.6844772657353357,1370,1302,1438,1697,259,327,395,247.5161054967665,296,224.0082338161619,-0.2872862674187901,0.2510403072382514,0.7645449711784256,0.9022661868260342,130992,132138,Pickens,Pickens,45,77,South Carolina,SC
45083,45CS028,2833,2691,2975,3356,381,523,665,190.96206294600142,382,139.45295744311906,-0.03864355705517458,0.5218207033876334,1.048127514753262,0.7288718673255442,3518,3345,3691,4304,613,786,959,234.5997693436643,803,239.76161186685616,-0.5438660477836202,-0.04286203348709453,0.4909898100337642,1.020703679516805,328713,334916,Spartanburg+Union,Spartanburg,45,83,South Carolina,SC
45087,45CS028,328,317,340,409,69,81,92,356.1929157502264,43,190.09025603241852,1.1291060447790027,1.6797269632745067,2.191080854073597,0.5271299968088438,398,384,412,516,104,118,132,437.66625704386354,71,262.6225263547254,1.210568545678451,1.7386362076164705,2.2753096083677593,0.5950232294376413,27145,27035,Spartanburg+Union,Union,45,87,South Carolina,SC
45085,45CS029,963,917,1008,1223,215,260,306,296.1406916026439,127,144.41938479616397,0.9896380141238127,1.5194954663609284,2.036425301950521,0.48580606920336866,1173,1119,1227,1514,287,341,395,325.22767955176687,206,196.46365422396855,0.7790637672354614,1.2772083605595164,1.8231971690884146,0.6023141181204328,105526,104854,Sumter,Sumter,45,85,South Carolina,SC
45091,45CS030,1932,1810,2055,2240,185,308,430,129.9385267370902,224,94.63522486427873,-0.16935603866477664,0.3362906989914897,0.8874254266165587,0.7259473380074761,2408,2259,2556,2837,281,429,578,149.17263246737488,370,128.512382341704,-0.30676923137824647,0.21352934948234237,0.7343129139051146,0.8594998257431563,284038,287910,York,York,45,91,South Carolina,SC
46005,46CS001,174,166,182,195,13,21,29,132.50672702297993,36,226.97420270057268,-1.4193938225679081,-0.9286045042188196,-0.4462194224613527,1.6351245739999631,213,204,223,184,-39,-29,-20,-153.70874749229571,13,67.97385620915033,-2.7597012726714953,-2.242841012419153,-1.7287712144245064,-0.45779809467506116,19033,19125,Clark and Nearby Counties,Beadle,46,5,South Dakota,SD
46025,46CS001,35,35,36,34,-2,-1,-1,-41.533040714290294,0,0,-0.5361375103634918,-0.4119612136027063,-0.2984148626273497,-0,43,43,44,31,-13,-12,-12,-319.2007972672459,6,155.68240788790868,-4.880092535502364,-4.747709956146657,-4.60662299570181,-0.5308795501663185,3834,3854,Clark and Nearby Counties,Clark,46,25,South Dakota,SD
46029,46CS001,210,198,223,300,77,90,102,379.98463908924043,68,288.441145281018,0.4135340518161876,0.9188620674764085,1.4160337956660676,0.7507061716434018,260,245,274,280,6,20,35,72.06915009477835,17,59.8380851812742,-0.38836381684173504,0.11446103652016744,0.601213955803563,0.7916238543746432,28290,28410,Clark and Nearby Counties,Codington,46,29,South Dakota,SD
46039,46CS001,40,40,40,40,-0,-0,0,-0.7550733576320152,4,111.6019530341781,-1.2406690390169983,-1.122263266801084,-0.9960076970072628,4.111263483779964,49,48,49,41,-8,-8,-7,-175.9171252065025,4,93.54536950420955,-2.810536650491805,-2.690351829679866,-2.5765113522165617,-0.61328846393054,4301,4276,Clark and Nearby Counties,Deuel,46,39,South Dakota,SD
46057,46CS001,54,54,55,90,35,36,36,689.2715159453571,28,543.3376455368692,1.3426845301566142,1.4625348395245916,1.5800747144893634,0.7666935446305471,67,66,68,53,-15,-14,-13,-225.2949228519024,5,80.10253123998719,-3.1822650656272704,-3.0546648181545972,-2.9249821593821563,-0.38276313244536597,6184,6242,Clark and Nearby Counties,Hamlin,46,57,South Dakota,SD
46077,46CS001,56,56,57,57,0,1,1,16.821853815588746,12,278.7996127783156,-2.741290496945504,-2.626580848172472,-2.4970942892524346,6.9603928285995105,69,68,70,72,2,3,4,57.78029967928361,8,153.99422521655438,-1.082767331902641,-0.9655040681366562,-0.8269675495407784,1.9991570712448459,5165,5195,Clark and Nearby Counties,Kingsbury,46,77,South Dakota,SD
46115,46CS001,61,60,61,95,34,34,35,646.5235879968129,20,378.5488958990536,2.5510786489243196,2.676485891366412,2.7873173688061823,0.5688606332323628,73,73,74,68,-6,-5,-5,-87.16969401153202,10,159.26102882624622,-2.586149729879825,-2.463257854613655,-2.336195482988297,-2.2354435859090964,6340,6279,Clark and Nearby Counties,Spink,46,115,South Dakota,SD
46027,46CS002,94,93,96,98,2,4,5,31.201364597386757,12,96.76118801236393,-0.7805332606509502,-0.6567539941408509,-0.5418943067364695,2.4643241675374767,118,116,119,115,-4,-3,-1,-16.536486286980672,5,33.051295610787946,-0.6246568217566195,-0.49718443518922745,-0.3538875994020398,-3.3296936552002667,14882,15128,Clay+Turner+Union+Yankton,Clay,46,27,South Dakota,SD
46125,46CS002,92,92,93,127,34,35,35,481.49755635900993,37,514.7826086956521,-0.45347235532928176,-0.32990011402534053,-0.2028878866984194,1.0391029357562083,114,113,115,109,-6,-5,-4,-57.950141010109874,4,45.96116281741928,-1.1660241748483693,-1.0411470841854567,-0.9038268069939415,-0.9892662700147787,8625,8703,Clay+Turner+Union+Yankton,Turner,46,125,South Dakota,SD
46127,46CS002,119,117,121,142,21,23,25,165.96047420083943,26,186.65868979958123,-0.3276065880491935,-0.20685499568035667,-0.09037140187016425,1.078081680680287,147,145,149,129,-20,-18,-16,-107.63524878779143,8,47.43270484999407,-1.683887990562499,-1.546226554344839,-1.4267863611145848,-0.4663700264776807,16715,16866,Clay+Turner+Union+Yankton,Union,46,127,South Dakota,SD
46135,46CS002,215,205,225,228,3,13,23,67.5292996291857,27,139.7394979729147,-1.2341022525935246,-0.7368870591891092,-0.17613936409013545,1.9220110315182677,263,251,275,268,-7,5,17,19.763091764751362,13,55.8227413260048,-0.8617876373177122,-0.34218810434500485,0.15153934086290918,2.3204221669696214,23186,23288,Clay+Turner+Union+Yankton,Yankton,46,135,South Dakota,SD
46003,46CS003,25,24,25,41,16,16,17,714.02577289073065,11,482.2798684691268,2.203262556575706,2.317757801973961,2.4357656451117133,0.6363627693494497,31,30,31,46,15,15,16,563.4220724148414,6,218.49963583394026,3.3234105444903546,3.4528091227620985,3.5804889245234164,0.3642639991496348,2737,2746,Douglas and Nearby Counties,Aurora,46,3,South Dakota,SD
46009,46CS003,69,68,69,95,26,26,27,452.0519598143733,21,361.3939480854725,0.7815168177159221,0.9108639985144138,1.0166547965987864,0.7701338862007242,85,84,86,106,20,21,22,299.9240444975466,2,28.534741047224998,2.5892747373156904,2.709221122606344,2.846664187635447,0.09081960767547813,6973,7009,Douglas and Nearby Counties,Bon Homme,46,9,South Dakota,SD
46015,46CS003,47,46,47,48,1,1,2,33.36215937362409,4,91.34157944814463,-0.6987567693883541,-0.5779138044673156,-0.45573203624355824,1.6253657421657628,57,57,58,49,-9,-8,-8,-156.49070022939856,5,95.32888465204957,-2.6386591138708466,-2.5185343731361334,-2.3953033085340825,-0.6936797370055444,5255,5245,Douglas and Nearby Counties,Brule,46,15,South Dakota,SD
46023,46CS003,97,96,98,130,32,33,34,424.5397129718138,16,205.9643853250375,2.0697864111881374,2.1852163291181794,2.3155555952690445,0.47086992580372894,118,116,119,117,-2,-1,1,-6.326739649027179,13,141.45810663764962,-1.6036471048487384,-1.4785768053002646,-1.3626587312024647,31.057931609934737,9322,9190,Douglas and Nearby Counties,Charles Mix,46,23,South Dakota,SD
46035,46CS003,193,184,201,221,20,28,37,170.6422387302199,52,313.2530120481928,-1.9666945414246642,-1.4227151031666765,-0.8904800636683721,1.7731335845220946,236,225,246,235,-11,-1,10,-3.3070383765539333,14,70.40128733782561,-1.2032036552317267,-0.7253662687312343,-0.19448397694317834,40.89234713996449,19920,19886,Douglas and Nearby Counties,Davison,46,35,South Dakota,SD
46043,46CS003,38,37,39,44,5,6,7,261.4389038977951,10,423.1311706629055,-2.0874601553838326,-1.6169144551672847,-1.0686063162477575,1.3930151619071358,46,44,47,47,-0,1,3,38.18618913633315,7,248.13895781637717,-2.6152284343794467,-2.093015688637987,-1.5981018342294206,3.3698684918660202,2836,2821,Douglas and Nearby Counties,Douglas,46,43,South Dakota,SD
46067,46CS003,96,95,97,103,6,7,8,114.53941458460872,16,259.70512647098604,-1.568880826954101,-1.4525632436848883,-1.3327742328991399,1.9859537380768486,118,117,119,109,-10,-9,-8,-121.20048493165338,5,67.46727836999055,-2.017220506842545,-1.8840612522627933,-1.7559289353820011,-0.6263962420558111,7393,7411,Douglas and Nearby Counties,Hutchinson,46,67,South Dakota,SD
46083,46CS004,267,239,295,323,28,56,84,102.79081140386765,66,121.45376476000614,-0.7093955483289692,-0.19444769608417745,0.3784250636629085,1.1607816191170202,345,310,380,310,-70,-35,-0,-52.344488334272455,14,20.72815030870138,-1.2550145817854574,-0.7205726172999475,-0.21184647144467925,-0.40752179432860236,65210,67541,Lincoln+Minnehaha,Lincoln,46,83,South Dakota,SD
46099,46CS004,1301,1216,1386,1619,233,318,403,193.40477879953622,267,162.43510707332902,-0.21749875230730245,0.27883194367191155,0.8436536910315533,0.8372376155129114,1620,1517,1723,1681,-42,61,164,30.409699975928405,124,62.1965410697805,-0.803992382158464,-0.31944349706216835,0.2057120850772645,2.012098206232967,197248,199368,Lincoln+Minnehaha,Minnehaha,46,99,South Dakota,SD
46011,46CS005,166,152,181,221,40,55,69,189.67178377937475,29,100.77025540047488,0.34153164307940725,0.8873878937434603,1.4006108546899585,0.5217293230939243,208,190,226,203,-23,-5,13,-15.351956438054605,5,14.452955629426219,-0.8167371862495133,-0.2819651518205764,0.22824599733574927,-1.1598211967441427,34534,34595,Miner and Nearby Counties,Brookings,46,11,South Dakota,SD
46061,46CS005,21,21,22,19,-3,-2,-2,-78.56568917656622,4,138.4881708020773,-2.289487432370604,-2.1727336374122004,-2.0437856494540543,-3.151494741738499,27,26,27,34,7,7,8,213.53016068476182,2,57.15918833952558,1.4376428832829955,1.5661175049392615,1.6845606112504306,0.236087919604357,3466,3499,Miner and Nearby Counties,Hanson,46,61,South Dakota,SD
46073,46CS005,20,19,21,32,11,12,13,831.9763103397831,15,1054.481546572935,-2.710851315562837,-2.2116017422683845,-1.7257478095426655,1.168691865503861,24,23,25,12,-13,-12,-11,-727.3263142231323,2,122.02562538133007,-9.033786960649131,-8.497291539323406,-7.979974537779706,-0.18313545365759662,1707,1639,Miner and Nearby Counties,Jerauld,46,73,South Dakota,SD
46079,46CS005,89,88,90,91,1,2,3,24.094504907680708,14,149.33333333333334,-1.3642581451283033,-1.2527901279048743,-1.1385750470332598,4.29598102048829,106,104,107,118,11,12,14,113.85090643275474,4,36.78499172337686,0.646780044292326,0.7666851168324312,0.8975793066423375,0.29895036511513967,11250,10874,Miner and Nearby Counties,Lake,46,79,South Dakota,SD
46087,46CS005,63,63,64,80,16,17,17,355.0419144359033,23,488.4955752212389,-1.4528214334506646,-1.3361181051409072,-1.2202907773082508,1.2982206561667087,78,77,79,74,-5,-4,-3,-73.72185356323587,2,35.149384885764505,-1.20479590056084,-1.0898884672502556,-0.9654609333449287,-0.6260224770833993,5650,5690,Miner and Nearby Counties,McCook,46,87,South Dakota,SD
46097,46CS005,27,26,28,26,-2,-1,-0,-74.31374475915479,2,105.03282275711159,-2.3078393216588586,-1.7875278131424497,-1.23399084478667,-4.818608814351461,34,33,35,40,5,6,7,271.5164749035338,3,129.81393336218088,0.8677783271172865,1.4128389401957155,1.9103931816895197,0.41238554710688835,2285,2311,Miner and Nearby Counties,Miner,46,97,South Dakota,SD
46101,46CS005,49,48,49,67,18,18,19,342.533058826847,15,283.15243039169417,0.4718036908441825,0.5939977735376926,0.7114345798168308,0.7834661977152393,60,59,61,71,10,11,12,177.4485594386474,11,174.16086130462318,-0.09070742621431063,0.03602495929683544,0.15414100327668404,0.9010742514882126,6357,6316,Miner and Nearby Counties,Moody,46,101,South Dakota,SD
46111,46CS005,22,22,22,18,-4,-4,-4,-209.6372495255089,3,154.63917525773198,-3.761579668117606,-3.6392517881536532,-3.5150903574271597,-0.9781664634892591,28,27,28,30,2,2,3,101.54424699861666,6,253.2714225411566,-1.6421671268484042,-1.5167902093765053,-1.39935044600172,1.7618127726024186,2328,2369,Miner and Nearby Counties,Sanborn,46,111,South Dakota,SD
46017,46CS006,26,25,27,31,4,5,6,323.8187816808736,12,739.5993836671803,-4.681255887295962,-4.1395895121527815,-3.612311325678519,1.918784340282408,31,30,32,53,21,22,23,1136.2313621478643,3,155.76323987538942,9.347806422712106,9.796589473890602,10.319438438963706,0.13109701613646155,1947,1926,North Central South Dakota,Buffalo,46,17,South Dakota,SD
46021,46CS006,13,12,13,16,3,3,4,298.1863906954534,8,697.6744186046511,-4.117430080923039,-4.000045645931882,-3.8735317783087275,1.8102807873532005,15,15,15,26,11,11,11,778.3265124459231,8,580.1305293691081,1.8517765025491666,1.9826255366925853,2.1056193463840858,0.681830427262386,1376,1379,North Central South Dakota,Campbell,46,21,South Dakota,SD
46045,46CS006,34,34,35,42,7,8,8,227.17741800347332,10,302.6481715006305,-0.8795194559444113,-0.7567674318455248,-0.6269035152536004,1.175596425816198,42,42,43,59,16,17,17,413.3193359558581,4,99.37888198757764,3.011779230800593,3.1361277567424097,3.2705743072261644,0.226807472050811,3965,4025,North Central South Dakota,Edmunds,46,45,South Dakota,SD
46049,46CS006,28,27,29,38,9,10,11,535.0836190998451,4,222.73781902552201,2.6537051002661634,3.1296750641261566,3.6193422789520904,0.37703090075874585,35,33,36,30,-6,-5,-3,-210.70338523511973,6,280.8988764044944,-5.445555343744257,-4.911790488792423,-4.401694912226958,-1.7139799850049018,2155,2136,North Central South Dakota,Faulk,46,49,South Dakota,SD
46059,46CS006,41,40,43,42,-1,1,2,21.935885119066732,3,114.94252873563218,-1.435263435053556,-0.9427363311436949,-0.37009806975789333,1.9077578699991522,50,48,52,58,6,8,10,255.37746362634985,4,129.03225806451613,0.7750226273070269,1.278101892506341,1.8245353532343316,0.44859638479917063,3132,3100,North Central South Dakota,Hand,46,59,South Dakota,SD
46065,46CS006,156,148,163,175,12,19,27,131.06141966041034,28,190.1420406315432,-1.1099734272964392,-0.5656104403321555,-0.012992620627041087,1.3793180755661696,192,183,201,209,8,17,26,97.89508977642244,20,113.02627860977678,-0.6736221322869067,-0.15435811720840623,0.3118892675971362,1.0915519473732602,17671,17695,North Central South Dakota,Hughes,46,65,South Dakota,SD
46069,46CS006,18,18,18,20,2,2,2,162.7177139901567,5,475.81284694686747,-3.249241137268343,-3.134516346972202,-3.007410814515039,1.8450919966091373,22,22,22,36,14,14,14,1146.7035633836429,8,645.682001614205,4.8817519264333145,5.009810264214117,5.138624187813837,0.5260507861876613,1261,1239,North Central South Dakota,Hyde,46,69,South Dakota,SD
46085,46CS006,30,29,30,51,21,21,22,681.7935453432541,3,96.51474530831098,5.728815661343892,5.854812538201066,5.971970690973376,0.13518131578585804,36,36,37,50,13,14,14,364.3781858555416,1,26.616981634282673,3.244676428492957,3.3794308022431165,3.5140205091554586,0.06807496318985934,3730,3757,North Central South Dakota,Lyman,46,85,South Dakota,SD
46089,46CS006,32,31,33,30,-3,-2,-1,-88.3142580588508,2,100.0834028356964,-2.3789931167659173,-1.8954251309666037,-1.3648880667406789,-2.615017433365659,39,38,40,37,-3,-2,-1,-84.33921583377109,1,41.37360364087712,-1.7687265120406894,-1.2551091617093482,-0.7128206323235903,-0.9629469133392179,2398,2417,North Central South Dakota,McPherson,46,89,South Dakota,SD
46107,46CS006,32,31,33,34,1,2,3,81.12008140544644,5,247.52475247524748,-2.1859260965974077,-1.6609947306745203,-1.1407637892075677,1.894925871970698,40,39,41,32,-9,-8,-7,-322.2713492355454,1,40.42037186742118,-4.174145479028224,-3.611429407720088,-3.1127610695253938,-0.14341043712127466,2424,2474,North Central South Dakota,Potter,46,107,South Dakota,SD
46117,46CS006,17,16,17,18,1,1,2,57.393587240537144,6,239.68042609853526,-1.9528181411744248,-1.8225229032880517,-1.704641249472835,2.4622932611596435,20,20,20,34,14,14,14,459.2533434654943,2,66.13756613756614,3.7976995053882723,3.9274280967511066,4.059556462258741,0.13433799249110406,3004,3024,North Central South Dakota,Stanley,46,117,South Dakota,SD
46119,46CS006,11,11,11,10,-1,-1,-1,-90.63445492021806,3,250.17373175816536,-3.526862578974393,-3.409827657236701,-3.2843105278377394,-34.539064474238224,14,14,14,15,1,1,1,87.67011757675095,8,543.4782608695652,-4.685577715481036,-4.552291716948721,-4.42903108655041,3.4926808874390165,1439,1472,North Central South Dakota,Sully,46,119,South Dakota,SD
46129,46CS006,61,61,62,69,7,8,8,178.69414834298726,14,316.7420814479638,-1.506958125302843,-1.3821182483884276,-1.2511646380001606,1.5733375287537048,73,73,74,86,12,13,13,241.1459664175537,5,95.1655881233346,1.3361449619003505,1.4621762644277647,1.5811439384357873,0.36576955627951857,5304,5254,North Central South Dakota,Walworth,46,129,South Dakota,SD
46013,46CS007,299,283,316,390,74,91,107,284.053026306189,58,181.73747290910515,0.5602162506652998,1.0082989040356176,1.550243479672236,0.6328205419350613,366,346,385,372,-13,6,26,16.94247843140542,38,99.69305034499043,-1.382878322783804,-0.8178921945153902,-0.2651893005601661,5.0952240361500465,38297,38117,Northeast South Dakota,Brown,46,13,South Dakota,SD
46037,46CS007,63,63,64,93,29,30,30,654.2623781614262,25,553.3013648100332,0.897422195277112,1.0145654632218721,1.1305719229276996,0.8180158469923511,77,77,78,71,-7,-6,-6,-119.75836117003558,6,110.78286558345643,-2.4361786845068623,-2.3103389515491055,-2.181305027302719,-1.0936705412242476,5422,5416,Northeast South Dakota,Day,46,37,South Dakota,SD
46051,46CS007,78,77,78,94,16,16,17,263.47568805305286,33,530.262453133369,-2.786717808380326,-2.6701470714729942,-2.5492532410041866,1.896882008379089,96,95,97,96,-1,0,1,4.759932449298238,2,26.592208482914504,-0.3431024011865186,-0.21442250826106443,-0.09182733772426555,1.4727599936994729,7468,7521,Northeast South Dakota,Grant,46,51,South Dakota,SD
46091,46CS007,33,33,34,41,7,8,8,205.54514061523543,7,191.34396355353076,0.02256182087322021,0.1389742138587266,0.2594650498206463,0.8216419171829624,40,40,41,53,12,13,13,296.1935285722187,5,116.19800139437602,1.672307968837721,1.8008559258973855,1.9165162305667782,0.36376315071735266,4390,4303,Northeast South Dakota,Marshall,46,91,South Dakota,SD
46109,46CS007,95,94,96,108,12,13,14,149.59969675515606,29,338.91702376314765,-2.0224962217473186,-1.8937001127071218,-1.7665329270956127,2.1013354704314873,116,114,117,121,4,5,7,53.52863246900132,10,98.26078412105728,-0.5566957890764717,-0.4479389216468369,-0.32584350034326837,1.5509625528156192,10268,10177,Northeast South Dakota,Roberts,46,109,South Dakota,SD
46019,46CS008,95,94,96,101,5,6,7,74.49098996433837,19,221.46673142302086,-1.5917309269356665,-1.472825909552312,-1.3532103153298785,2.5707962859680062,117,116,119,141,22,24,25,226.30937747903297,22,211.01093420295416,0.019865306201030452,0.1533353339216518,0.2780091445806952,0.8944901793093867,10295,10426,Northwest South Dakota,Butte,46,19,South Dakota,SD
46031,46CS008,40,40,40,56,16,16,16,487.3249017520383,14,428.7901990811638,0.47273820775253445,0.5822911518049527,0.7080662675136972,0.827855784036855,49,48,49,57,8,8,9,217.9095549747721,4,103.22580645161291,1.0166848930680903,1.1479779780925086,1.2683148103828739,0.4235495562925944,3918,3875,Northwest South Dakota,Corson,46,31,South Dakota,SD
46041,46CS008,46,45,47,82,35,36,37,811.4206032624364,16,360.7666290868095,4.385294605409189,4.508696836643331,4.619926953216111,0.43259022550817766,56,55,56,92,36,36,37,694.7985859620205,11,209.8035475872592,4.730471409353065,4.848639305388527,4.979059865134305,0.29389534067842443,5322,5243,Northwest South Dakota,Dewey,46,41,South Dakota,SD
46063,46CS008,11,11,11,11,0,0,0,18.532756067676242,6,546.6970387243736,-5.398834052323694,-5.28236828850972,-5.165051656936273,4.985885797252127,13,13,14,11,-3,-2,-2,-175.873589810919,5,377.0739064856712,-5.658405290075459,-5.535249964852707,-5.399849926031199,-3.753517606511627,1317,1326,Northwest South Dakota,Harding,46,63,South Dakota,SD
46081,46CS008,210,199,221,248,27,38,49,177.90392777408098,36,167.03398677647604,-0.3887860131737132,0.10292358207794075,0.5969168753821158,0.9150353104333103,261,247,274,305,31,44,58,170.3270261563732,36,137.85708815194914,-0.247574570813375,0.320398218080126,0.7958072171031373,0.7915706588580347,25863,26114,Northwest South Dakota,Lawrence,46,81,South Dakota,SD
46093,46CS008,195,182,208,193,-15,-2,11,-9.064891428659754,18,72.7664735210888,-1.2923222194400719,-0.8111394689352107,-0.27378275622546383,-14.488647615081309,245,229,260,246,-14,1,17,4.704099092543606,28,92.94297284737436,-1.4476121854433779,-0.8819121086748138,-0.3548688484115597,11.583857086601409,29684,30126,Northwest South Dakota,Meade,46,93,South Dakota,SD
46105,46CS008,32,32,32,45,13,13,13,549.7539919987559,11,467.2566371681416,0.6975029683322918,0.8233148440549825,0.9463957623032031,0.7889758426261151,39,39,40,34,-6,-5,-5,-182.90984135345582,2,70.92198581560284,-2.6680324321801345,-2.5404893623464835,-2.4191820568877476,-0.480993826423424,2825,2820,Northwest South Dakota,Perkins,46,105,South Dakota,SD
46137,46CS008,14,13,14,23,9,9,10,457.2978064815263,3,147.11892112791173,2.9868560313323544,3.1059116860242204,3.2228879773494774,0.29055508740461916,16,16,17,41,24,25,25,1033.949506503992,4,167.99664006719865,8.53423605272986,8.659453278731146,8.78905564631501,0.15613815537356054,2447,2381,Northwest South Dakota,Ziebach,46,137,South Dakota,SD
46103,46CS009,815,768,862,1003,141,188,235,204.23361786191145,129,140.1704139011382,0.1361249009137762,0.6284689138631023,1.157450503184215,0.6826917513502097,1017,960,1075,1252,177,235,292,210.6145361982208,130,116.62749179121884,0.4206267739664419,0.9573337517872698,1.4279705237297693,0.5513997945239373,110437,111466,Pennington,Pennington,46,103,South Dakota,SD
46007,46CS010,32,31,32,32,0,0,1,12.768216279112334,2,70.90103397341211,-0.6987587571151509,-0.5805012257541252,-0.45236203824268756,1.4704043256912536,39,38,39,50,11,11,12,328.02504028496423,3,88.15750808110491,2.272970757000353,2.4029538381273827,2.5312801266032454,0.2466559187867256,3385,3403,Southwest Central South Dakota,Bennett,46,7,South Dakota,SD
46033,46CS010,82,81,83,91,8,9,10,123.97347916256322,11,156.30550621669624,-0.44554585392847035,-0.3217982251479276,-0.20206006148610167,1.1311480161525704,102,101,103,96,-7,-6,-5,-68.85968121674505,5,58.356676003734826,-1.4006169832489965,-1.2736975658400649,-1.1491016015477165,-1.0204295117646858,8445,8568,Southwest Central South Dakota,Custer,46,33,South Dakota,SD
46047,46CS010,100,100,101,109,8,9,9,150.97451704816402,3,51.80601525399338,0.8761826059510797,0.9926773538195218,1.1152463770063104,0.3079234031621543,126,125,127,149,22,23,24,319.6338986180605,18,251.15110925073253,0.5532326162204404,0.685216909445033,0.8077712867012845,0.7528809770459552,6949,7167,Southwest Central South Dakota,Fall River,46,47,South Dakota,SD
46053,46CS010,48,47,48,76,28,28,29,840.9856055025313,26,776.1194029850745,0.5297146181581751,0.6515728029285632,0.7683403136867744,0.891234502793241,58,57,58,75,17,17,18,433.2637834094947,3,75.39582809751194,3.4432328790119238,3.5779665766581434,3.7113575265090373,0.16447759829165362,4020,3979,Southwest Central South Dakota,Gregory,46,53,South Dakota,SD
46055,46CS010,22,21,22,24,2,2,3,153.83136708609126,5,321.71581769436995,-1.7992166653697061,-1.6842330339304707,-1.5674877314563824,1.474580083994262,26,26,26,28,2,2,2,108.1782055015452,7,380.4347826086957,-2.8377318677727916,-2.721361751460785,-2.6113209321234327,2.3407621467797557,1865,1840,Southwest Central South Dakota,Haakon,46,55,South Dakota,SD
46071,46CS010,25,25,25,42,17,17,17,712.2431643389767,13,539.0463026952315,1.6157549185282947,1.7326416440535042,1.851965019143803,0.7151922408860842,30,30,30,70,40,40,40,1392.9838042297367,3,104.60251046025104,12.74764893139859,12.883893171716537,13.013490620475178,0.07325868589743999,2894,2868,Southwest Central South Dakota,Jackson,46,71,South Dakota,SD
46075,46CS010,10,10,11,4,-7,-6,-6,-838.2143471327213,4,522.8758169934641,-13.7279545816182,-13.6099659049341,-13.484793077354947,-0.7390519037329356,12,12,12,13,1,1,1,84.07898835639153,2,225.7336343115124,-1.5448622965985832,-1.4156551738950696,-1.2893592672190362,1.1461713222300083,918,886,Southwest Central South Dakota,Jones,46,75,South Dakota,SD
46095,46CS010,23,23,23,27,4,4,4,235.6844974554287,3,185.8544140423335,0.381431185909277,0.4981999308251155,0.6215138125938585,0.6244353288006882,28,28,28,30,2,2,2,110.78328657244506,4,209.53378732320587,-1.1153759971650805,-0.9906247930170128,-0.8677617735283272,1.2841697750078067,1937,1909,Southwest Central South Dakota,Mellette,46,95,South Dakota,SD
46102,46CS010,134,128,140,191,51,57,63,499.10350568891533,33,288.2935352358765,1.5718124378659057,2.114170489975961,2.602730903502812,0.5676861228515218,162,155,169,194,25,32,39,232.90205400192335,6,44.12089124200309,1.3333184180536788,1.8939787794544733,2.411089538562136,0.1836415176916041,13736,13599,Southwest Central South Dakota,Southwest Central South Dakota,46,102,South Dakota,SD
46121,46CS010,72,71,73,118,45,46,47,578.8884765116685,23,291.7856010149064,2.749803093186993,2.8723015378780206,2.982236185549299,0.49323533992135327,87,86,88,140,52,53,54,571.9812458625056,15,161.44656118824668,3.9816034295203893,4.107152883228979,4.223528630185622,0.2770452621366339,9459,9291,Southwest Central South Dakota,Todd,46,121,South Dakota,SD
46123,46CS010,65,64,66,81,15,16,17,344.8070085178284,13,279.9210479095639,0.5321184040911138,0.6522013255491919,0.778283653199863,0.7641030430811122,79,79,80,68,-12,-11,-11,-202.67586837350694,2,35.88087549336204,-2.5078655604340256,-2.3865421811257814,-2.259376429497279,-0.19422844535893635,5573,5574,Southwest Central South Dakota,Tripp,46,123,South Dakota,SD
47001,47CS001,863,830,897,928,31,65,98,100.43490923351837,69,107.23305057307516,-0.5672489272688781,-0.08343732193617752,0.40235404042364886,1.0514176878915131,1062,1022,1102,1271,169,209,249,270.111657243561,140,180.59389592631769,0.39541311870385903,0.8843184789230809,1.4395331874055286,0.6654120198557356,77215,77522,Anderson,Anderson,47,1,Tennessee,TN
47003,47CS002,450,428,472,514,42,64,86,152.52334647130075,68,162.2363162812891,-0.5862860288518921,-0.10492414882602531,0.42778323967398135,1.0472995976245163,560,533,586,668,82,108,135,212.35068370463713,112,219.6078431372549,-0.5890154449991079,-0.05740749857627046,0.42800194765185817,1.0247134470584582,50297,51000,Bedford+Lincoln+Moore,Bedford,47,3,Tennessee,TN
47103,47CS002,385,369,400,461,61,76,92,260.51180112033154,42,143.2021593976417,0.6678451746994145,1.1654035861623517,1.6877899326203287,0.5425940156167695,473,454,491,550,59,77,96,218.83091902833428,94,265.424255259071,-0.9831974070280743,-0.4593884172178402,0.07859733566365723,1.1974679416974818,35195,35415,Bedford+Lincoln+Moore,Lincoln,47,103,Tennessee,TN
47127,47CS002,59,58,60,68,8,9,10,164.92058991599598,4,74.14272474513439,0.7840603514585359,0.9112281668991296,1.028107831727981,0.40414385564284533,74,73,75,95,20,21,22,314.1233205321792,17,256.91400936980506,0.4481500706654013,0.5728644629113195,0.7103483592175279,0.7803341072408986,6474,6617,Bedford+Lincoln+Moore,Moore,47,127,Tennessee,TN
47005,47CS003,215,208,222,264,42,49,56,372.2989231207245,34,257.00787401574803,0.6583637303484254,1.1668450296970732,1.6869658878626734,0.6765893800818236,261,253,269,331,62,70,78,440.8157158008669,56,353.02275735989406,0.36694545788045635,0.8731667221723806,1.4015093871479292,0.7895486653896644,15875,15863,Benton+Carroll+Henry,Benton,47,5,Tennessee,TN
47017,47CS003,367,355,379,459,80,92,104,390.48240552332305,53,224.62386098749732,1.1555984828947778,1.6495594348819123,2.13964980393383,0.5690705419966609,447,432,462,484,22,37,52,129.79650065903516,73,256.7710165318326,-1.800854282304765,-1.2600309269503682,-0.7760181953737649,1.9260631765987237,28314,28430,Benton+Carroll+Henry,Carroll,47,17,Tennessee,TN
47079,47CS003,401,387,415,473,58,72,86,268.63497520824177,46,171.6631421818634,0.42742619618534927,0.9650967051984424,1.4786651460577187,0.630264603170647,489,472,505,567,62,78,95,242.63736649007382,71,220.35318581049623,-0.3191340014505032,0.2336603033587179,0.7336988609629325,0.8966889788366466,32156,32221,Benton+Carroll+Henry,Henry,47,79,Tennessee,TN
47007,47CS004,141,135,148,150,2,9,15,69.04506715410103,6,48.05125467164975,-0.307176787505132,0.2096724327570104,0.7258048385918873,0.6236080946951367,174,167,182,184,2,10,17,62.891219777861416,37,243.5813034891376,-2.3092247180278824,-1.7997817007131343,-1.3286679209893175,3.506053438640581,14984,15190,Bledsoe+Rhea+Van Buren+White,Bledsoe,47,7,Tennessee,TN
47143,47CS004,360,346,374,431,57,71,85,258.08402207437956,46,167.41985381092476,0.38323696085514103,0.8852503070161966,1.4522574782295377,0.6396819544476455,439,422,456,552,96,113,130,340.3520392074738,66,199.3837230378829,0.9017729111979454,1.4225056986369735,1.9404820436731562,0.5806621962242154,32971,33102,Bledsoe+Rhea+Van Buren+White,Rhea,47,143,Tennessee,TN
47175,47CS004,78,77,79,77,-2,-1,-0,-20.627525186873438,7,136.71875,-1.695475548495973,-1.574678957402001,-1.4515466620102884,-124.7120719660906,98,97,99,146,47,48,49,758.8123009388287,36,571.2472231037766,1.7492477990253685,1.8763613072089078,2.0004335663730752,0.737397399062368,6144,6302,Bledsoe+Rhea+Van Buren+White,Van Buren,47,175,Tennessee,TN
47185,47CS004,320,308,332,346,14,26,38,113.92879139977614,32,139.93659123209798,-0.8172946292538026,-0.2651304707470376,0.27491010077601924,1.1828778560449411,391,376,405,483,78,92,107,334.03768637787323,73,264.3299417025745,0.18103373164302367,0.7061673855035131,1.2136554042354704,0.782831851105115,27441,27617,Bledsoe+Rhea+Van Buren+White,White,47,185,Tennessee,TN
47009,47CS005,1284,1226,1342,1417,75,133,191,117.68494089753162,105,93.01501528103823,-0.26184400568767985,0.2476686215147153,0.7661781973517597,0.7844681549262068,1594,1523,1665,1917,252,323,394,235.0875256924672,192,139.83161942494246,0.4418692789156827,0.9427544155944235,1.4297400689609352,0.5929696411642682,135462,137308,Blount+Loudon,Blount,47,9,Tennessee,TN
47105,47CS005,596,572,620,600,-20,4,28,8.64945806212322,47,102.34263006042569,-1.4483140124461218,-0.9537524550892607,-0.41470820600221825,9.45257230291611,745,716,775,834,59,89,118,156.83803597031434,94,166.4954479436041,-0.6631839883062826,-0.10242638175426197,0.4533580187570463,1.0497208271310032,55109,56458,Blount+Loudon,Loudon,47,105,Tennessee,TN
47011,47CS006,970,923,1017,1194,177,224,271,246.9533972287919,72,79.40081790194367,1.1614130303680357,1.6734733379522873,2.160282418528639,0.3200920689181599,1204,1147,1261,1597,336,393,450,357.23649820268287,219,199.17238870447002,1.0341985389302997,1.5637270197193402,2.062732323329661,0.5561207169744383,108815,109955,Bradley+Polk,Bradley,47,11,Tennessee,TN
47139,47CS006,216,209,224,246,22,30,37,205.42540529939765,13,89.28060436101414,0.6782760679577627,1.1520437051102619,1.6908034432376329,0.4205534038370703,267,258,276,347,71,80,89,449.8770173973569,41,231.03798038994705,1.6810398858949738,2.1985976204502875,2.6585885760422534,0.5072049357557178,17473,17746,Bradley+Polk,Polk,47,139,Tennessee,TN
47013,47CS007,505,488,522,548,26,43,60,131.627123464715,41,124.93334349051571,-0.45407493400631066,0.057395952795732626,0.5964776720035071,0.9276704146862269,616,596,637,779,142,163,183,411.8370411736783,80,202.3574644609703,1.598853413774453,2.1010694686082454,2.6106058765154523,0.48835381197961086,39381,39534,Campbell+Claiborne+Hancock+Scott,Campbell,47,13,Tennessee,TN
47025,47CS007,368,354,382,409,27,41,55,153.2210785748821,24,89.8764199226064,0.11674557989933554,0.6566490418089308,1.1514911002103052,0.5725855302695312,450,434,467,598,131,148,164,457.84367005785185,111,344.3568902401191,0.6229327707592281,1.135854480828661,1.6543660955455173,0.7470656040101054,32044,32234,Campbell+Claiborne+Hancock+Scott,Claiborne,47,25,Tennessee,TN
47067,47CS007,85,85,86,94,8,9,9,154.30657326759476,5,90.40229019135151,0.518224945154188,0.6410817703372235,0.7572900676213936,0.5244146819313303,106,106,107,126,19,20,20,289.40575778216834,18,266.1540736359604,0.1015399887807693,0.22928054614697715,0.36059350610189234,0.8749539446624346,6637,6763,Campbell+Claiborne+Hancock+Scott,Hancock,47,67,Tennessee,TN
47151,47CS007,232,223,242,242,0,10,19,53.21827833794913,28,153.50877192982455,-1.5171004300182864,-1.008433647890848,-0.49177086471851544,2.615108197437843,283,272,295,377,82,94,105,427.09967790246895,56,255.63772482424906,1.181185596461905,1.707782355870734,2.2131082249533214,0.5922137297102398,21888,21906,Campbell+Claiborne+Hancock+Scott,Scott,47,151,Tennessee,TN
47015,47CS008,159,152,165,181,16,22,29,183.90686354577875,16,131.93156050298907,0.020730646400162395,0.5319522518482941,0.9921452963909597,0.6865978917919586,193,186,201,215,14,22,29,150.07134575248253,27,185.54150632215504,-0.9016899310637415,-0.3590774782624925,0.1753063685573081,1.1822203395790987,14553,14552,Cannon+DeKalb+Warren,Cannon,47,15,Tennessee,TN
47041,47CS008,215,206,224,274,50,59,68,350.03317875723127,30,177.8831900385414,1.200702088622551,1.717384729730393,2.2321259535586346,0.4997243553986538,264,254,275,335,60,71,81,345.85355956791904,45,220.23197768315958,0.7402792314329855,1.2601411493588623,1.7954895851880144,0.6278930361183237,20238,20433,Cannon+DeKalb+Warren,DeKalb,47,41,Tennessee,TN
47177,47CS008,434,416,451,503,52,69,87,201.99892726537138,51,148.86526720342488,0.016616769952810917,0.5557694448856897,1.023051428322804,0.7264631375174778,533,511,554,612,58,79,101,191.60964854738276,90,217.12907117008442,-0.7846241282599051,-0.25095655589335575,0.21625688948502544,1.1190939909347115,41111,41450,Cannon+DeKalb+Warren,Warren,47,177,Tennessee,TN
47019,47CS009,654,630,678,786,108,132,156,281.1063635085986,87,185.40882290260708,0.4619533312160869,0.9568490368272835,1.4948366689593882,0.6546054928910605,804,775,833,955,122,151,180,269.2671789519842,128,227.92022792022792,-0.10466719524330267,0.4217761031233351,0.9715846328086236,0.8408857149910726,56308,56160,Carter+Johnson+Unicoi,Carter,47,19,Tennessee,TN
47091,47CS009,224,216,232,258,26,34,42,225.9383730498713,33,220.50225513670026,-0.5152539324344995,0.03997833194316334,0.5802198430887109,0.9479064959565057,278,269,288,303,15,25,34,136.7712373290827,44,242.55788313120178,-1.6003860666969905,-1.0615250653318427,-0.497336122695744,1.7047456178666507,17959,18140,Carter+Johnson+Unicoi,Johnson,47,91,Tennessee,TN
47171,47CS009,251,244,259,291,32,40,47,267.1920654671387,26,174.7311827956989,0.43909143579984206,0.9343366282459871,1.4253179609352866,0.637908768744247,306,297,315,375,60,69,78,389.79820683393325,34,191.8411104214862,1.449979548569134,1.9766027291028518,2.4701629313165694,0.48513256881494976,17856,17723,Carter+Johnson+Unicoi,Unicoi,47,171,Tennessee,TN
47021,47CS010,374,356,392,434,42,60,78,175.01634598083868,29,84.68183477308675,0.38402605356329295,0.9022533568630694,1.3943247434422068,0.47591066454895087,461,440,483,565,82,104,125,249.9766862679688,64,154.3693769748426,0.4086803159275559,0.9441619909428688,1.4571276610380435,0.6116334535356641,41095,41459,Cheatham+Dickson,Cheatham,47,21,Tennessee,TN
47043,47CS010,516,492,539,565,26,49,73,108.75483128811474,68,149.8952937286454,-0.9259939847285724,-0.397053223681052,0.08660827103055858,1.350904918783985,638,610,667,771,104,133,161,240.8629664749403,140,253.77490166222563,-0.6636655330766893,-0.12454972211395479,0.45001387580565,1.0457370056573863,54438,55167,Cheatham+Dickson,Dickson,47,43,Tennessee,TN
47023,47CS011,167,160,174,195,21,28,35,193.65457096778533,27,186.6682030304776,-0.4468535249261139,0.06920541630756406,0.5698720034040349,0.9306968675789739,206,197,215,263,48,57,66,324.57686765643916,41,234.54035810308335,0.3825958831726823,0.898382277967859,1.3982167945035293,0.7100884945731312,17357,17481,Chester+Madison,Chester,47,23,Tennessee,TN
47113,47CS011,909,867,952,1128,176,219,261,265.80998972217856,155,188.50714502888414,0.2744641875410057,0.7785931682472607,1.316143749755918,0.705950089699226,1118,1067,1169,1300,131,182,233,184.6874109108627,171,173.12072892938497,-0.3564142549278925,0.1330702209266152,0.5967156801926063,0.9322611923348725,98670,98775,Chester+Madison,Madison,47,113,Tennessee,TN
47029,47CS012,461,445,476,571,95,110,126,367.62946409207444,65,216.2881623824973,1.0168651800061808,1.5270176236537043,2.027335518163244,0.5830545787710166,566,547,585,737,152,171,190,470.95482906992345,97,266.77667766776676,1.5193011300906623,2.03897026731455,2.5671203041050896,0.5631703677250208,36063,36360,Cocke+Jefferson,Cocke,47,29,Tennessee,TN
47089,47CS012,565,541,589,642,53,77,101,168.27574756299887,61,133.323619408422,-0.16798944462846974,0.32054691702942417,0.8720165889796956,0.7821338703576937,698,670,727,891,164,193,221,346.9389044247001,132,237.77785783766257,0.6003039949255055,1.0779059094188304,1.6421517301788038,0.6818193672459283,54904,55514,Cocke+Jefferson,Jefferson,47,89,Tennessee,TN
47031,47CS013,604,579,629,669,40,65,90,134.83854969026126,70,144.83507767643152,-0.6485679407503416,-0.11386932546192846,0.3586826289818384,1.0579036821975096,745,715,776,875,99,130,160,220.16416319180493,129,219.03015484922577,-0.4848891219688297,0.015613878716561799,0.5331021026935656,0.9872356888122809,57997,58896,Coffee+Franklin,Coffee,47,31,Tennessee,TN
47051,47CS013,436,418,455,546,91,110,128,308.02816292629194,51,143.1578947368421,1.1164814955698918,1.643779163080078,2.133079568284352,0.46055885476125835,536,514,558,650,92,114,136,264.4645737200463,81,187.70856507230255,0.24307789556578585,0.7622385905928463,1.3458480048805774,0.7036029073007803,42750,43152,Coffee+Franklin,Franklin,47,51,Tennessee,TN
47033,47CS014,167,161,173,208,35,41,47,351.5579081790337,27,232.45802841153682,0.6782255136092608,1.2035412293603918,1.743480607357733,0.6454165107586701,205,198,212,212,-0,7,14,49.58832447557468,23,164.69745793054065,-1.6679747598175818,-1.1593755926974303,-0.6000978401684386,2.902204718143328,13938,13965,Crockett+Gibson+Haywood,Crockett,47,33,Tennessee,TN
47053,47CS014,597,575,618,724,106,127,149,304.5552458025829,87,207.93499043977053,0.4519962059468192,0.9667446215653249,1.4632991115152254,0.6774333677577039,733,707,759,919,160,186,212,368.03263584608777,102,201.91222756695765,1.1186936568139765,1.6793394871422316,2.165776706947677,0.5456907780553304,50208,50517,Crockett+Gibson+Haywood,Gibson,47,53,Tennessee,TN
47075,47CS014,190,182,197,230,33,40,48,272.71152078321677,40,271.1251694532309,-0.49529776922352725,0.03013823613957082,0.5186501525821459,0.9700723065568561,232,223,241,286,45,54,63,303.3565377176277,41,231.52069569145635,0.24620084875859793,0.7289784938172186,1.2551515165907574,0.7492497095951489,17704,17709,Crockett+Gibson+Haywood,Haywood,47,75,Tennessee,TN
47035,47CS015,738,712,765,865,100,127,153,247.71678616031215,64,125.2221551906866,0.73850373937483,1.226218927573302,1.7288967219623241,0.5015438731173427,912,880,944,1248,304,336,368,539.8592223057997,182,292.2333370799146,1.9638174730452593,2.4908596153382323,3.010901157885233,0.539708736595106,61331,62279,Cumberland+Fentress,Cumberland,47,35,Tennessee,TN
47049,47CS015,222,214,230,273,43,51,59,330.14388022265797,32,206.86311479825457,0.700412956979718,1.251044144532566,1.701395767364693,0.614551342011984,274,264,283,378,95,104,114,555.555751924239,62,329.75215402616743,1.750487483890162,2.239008100202327,2.798789628200424,0.5879251971738015,18563,18802,Cumberland+Fentress,Fentress,47,49,Tennessee,TN
47037,47CS016,4782,4476,5088,5572,484,790,1096,133.3566607361085,539,90.96982440348519,-0.08327383517137363,0.4318845680307256,0.9527503433755142,0.6812920982158568,5843,5478,6207,5938,-269,95,460,13.491890649853104,687,97.35911625698839,-1.3292722661084504,-0.840050933924078,-0.33817875320275836,7.141112137555218,711005,705635,Davidson,Davidson,47,37,Tennessee,TN
47039,47CS017,151,146,156,199,43,48,53,499.69255924560963,22,230.95092292887762,2.1944311904729927,2.6851337535509994,3.2392172452216608,0.45267601136546537,183,178,189,210,21,27,32,233.41178520455227,22,193.10102694637058,-0.10919039603811842,0.400141506394151,0.8722022068135554,0.7973150867226761,11431,11393,Decatur+Henderson+Lewis+Perry,Decatur,47,39,Tennessee,TN
47077,47CS017,293,281,305,366,61,73,85,314.9494105241175,55,236.84777147778655,0.2348200117063036,0.7797365417735213,1.2944621165980166,0.7418747622038175,358,343,372,436,64,78,93,280.5169408414662,74,264.91962911251926,-0.361802925180593,0.1635208781576358,0.6844397102354258,0.9324973123664207,27866,27933,Decatur+Henderson+Lewis+Perry,Henderson,47,77,Tennessee,TN
47101,47CS017,152,147,158,171,13,19,24,179.22907667820712,15,143.08426073131955,-0.09819922746931369,0.34690518258676367,0.8612065652200357,0.7579899133710455,188,182,195,224,29,36,42,279.76171304957353,27,210.60842433697348,0.16599471246394354,0.6807570195676537,1.2177467339613124,0.7323930351774562,12580,12820,Decatur+Henderson+Lewis+Perry,Lewis,47,101,Tennessee,TN
47135,47CS017,109,108,110,112,2,3,4,44.79305009693836,17,244.86856319769532,-2.116908587483118,-2.005374483055705,-1.867889257223527,4.136497101756847,135,134,136,145,9,10,11,114.85245840089581,21,248.34437086092717,-1.4610389843865532,-1.339759395186004,-1.2164766858533809,1.9604321530461306,8331,8456,Decatur+Henderson+Lewis+Perry,Perry,47,135,Tennessee,TN
47045,47CS018,407,392,423,533,110,126,141,410.3537666531367,63,205.927217258662,1.5480208510700022,2.038505267700841,2.5637729502782407,0.4978627633573142,498,480,517,627,110,129,147,351.0464196197044,85,232.11359912616055,0.658002021624416,1.187772106821516,1.7285833185436943,0.6561011286857303,36712,36620,Dyer+Lake+Lauderdale,Dyer,47,45,Tennessee,TN
47095,47CS018,80,79,81,93,12,13,14,220.88705079121155,12,205.7142857142857,0.03835012056285372,0.14886294696736443,0.2718788594587458,0.8642371351555789,100,99,101,137,36,37,38,524.0763343634636,16,225.1618350689558,2.866620534152646,2.9872032136487774,3.116617990471625,0.4184005849388538,7000,7106,Dyer+Lake+Lauderdale,Lake,47,95,Tennessee,TN
47097,47CS018,255,244,265,296,31,41,52,197.04890195734436,32,152.53227408142996,-0.07767722141774411,0.4592073309437936,0.9400412349293907,0.7558004575148692,312,299,325,358,33,46,59,182.33148097312676,51,203.13060102760187,-0.6934373665578152,-0.2042735856591163,0.29894613266592396,1.090256920722877,25175,25107,Dyer+Lake+Lauderdale,Lauderdale,47,97,Tennessee,TN
47047,47CS019,378,360,396,461,65,83,101,237.81806509877595,41,116.9980024731285,0.7009528132288492,1.1988400633068992,1.7487284772162892,0.4861311681748818,468,446,491,565,74,97,119,225.88908460950853,83,194.2383749502703,-0.19698896332866517,0.3263144837293375,0.8087575142192379,0.8510667554454747,42052,42731,Fayette+Hardeman,Fayette,47,47,Tennessee,TN
47069,47CS019,259,248,270,333,63,74,85,348.67367456856334,50,236.6023896841358,0.6015594160149647,1.1163452653106423,1.640536172961581,0.6694922428041923,317,304,330,383,53,66,79,259.61052210978625,42,165.19823788546256,0.42820393535706053,0.9484426057126373,1.4542743596612777,0.6268340573017371,25359,25424,Fayette+Hardeman,Hardeman,47,69,Tennessee,TN
47055,47CS020,343,330,356,413,57,70,83,279.8871109289837,43,170.84961260843653,0.6133794821950894,1.0886615850580341,1.5756567354832347,0.6018790858025974,423,407,439,526,87,103,119,338.03041653268065,79,258.96544941978624,0.2861351350107224,0.7744648910612594,1.3075493254743635,0.7587431301026175,30202,30506,Giles+Marshall,Giles,47,55,Tennessee,TN
47117,47CS020,325,310,340,369,29,44,59,153.966583736876,31,107.80421363781261,-0.041915773967829265,0.4548912540364243,0.9479691408082758,0.6847140472290886,404,386,422,466,44,62,80,178.50531636592146,67,191.94957742443776,-0.6072127762638511,-0.13923241072420167,0.36752020851516987,1.0583300890980474,34507,34905,Giles+Marshall,Marshall,47,117,Tennessee,TN
47057,47CS021,258,248,269,332,63,74,84,375.38183791252453,27,137.68485466598673,1.8583508763662677,2.3510563221614302,2.881787682106616,0.36187024959788744,319,306,331,394,63,75,88,317.8571254223581,59,248.65138233310856,0.17777721584343392,0.6770311408791096,1.2132687234925639,0.7720376977893895,23532,23728,Grainger+Hamblen,Grainger,47,57,Tennessee,TN
47063,47CS021,664,636,692,859,167,195,223,362.8964785104619,79,146.97218690893305,1.6401961349133138,2.1600575859566153,2.6596797212714094,0.4029319049873518,813,780,846,1111,265,298,331,462.0077586650865,169,262.1658936133906,1.4951206068084488,2.011238804600648,2.4922669135827973,0.5655501741379759,64502,64463,Grainger+Hamblen,Hamblen,47,63,Tennessee,TN
47059,47CS022,837,807,867,931,64,94,124,160.55438172366232,88,150.63764229265925,-0.40701903734722494,0.11413144044866644,0.6430933497534085,0.9283366915138302,1030,993,1066,1286,220,256,293,363.155997695362,167,236.6679421226422,0.7562757440399123,1.2668415302190956,1.7450852637961591,0.6491644502323453,70102,70563,Greene,Greene,47,59,Tennessee,TN
47061,47CS023,181,175,186,197,11,16,22,146.20375931201633,17,150.8541004215041,-0.5568750391280705,-0.07042368104904635,0.4478326419961761,0.9727656901320055,220,213,227,246,19,26,33,192.41904362410742,42,308.6192960540819,-1.6966623800697946,-1.1464489744097481,-0.6407818661580941,1.5448953401708556,13523,13609,Grundy+Marion+Sequatchie,Grundy,47,61,Tennessee,TN
47115,47CS023,314,301,326,359,33,45,58,189.1265692179563,36,149.76599063962558,-0.12811531215456676,0.37161569833557595,0.9102126844956118,0.7748384293192793,381,366,396,476,80,95,110,329.8385453165163,72,249.38519621765784,0.27438939657222483,0.8072444376918653,1.308110737161775,0.7482254087144297,28845,28871,Grundy+Marion+Sequatchie,Marion,47,115,Tennessee,TN
47153,47CS023,155,148,162,165,3,10,17,76.77473391169572,12,91.121938872366,-0.6766525055717858,-0.15227166382571913,0.40249026694338813,1.0800503951461502,194,185,202,229,27,35,44,217.42846754925893,48,294.15369530579727,-1.2870695399862415,-0.7805985985462435,-0.2329984522547716,1.3157902911951036,15803,16318,Grundy+Marion+Sequatchie,Sequatchie,47,153,Tennessee,TN
47065,47CS024,3189,3031,3347,3584,237,395,553,128.89371518840287,257,83.95743325465726,-0.05941690692323804,0.4425489692725197,0.9667259725685743,0.649722758007277,3932,3741,4122,4514,392,582,773,157.87878082554053,527,142.88735487579376,-0.3869960771448883,0.15327567713805454,0.6879218448893726,0.9034930906192326,367329,368822,Hamilton,Hamilton,47,65,Tennessee,TN
47071,47CS025,348,336,359,404,45,56,68,253.41647989873027,36,162.16824955891738,0.4144565439470666,0.9135031160106052,1.4363869394313942,0.6287512573505656,427,413,441,530,89,103,117,382.40855272325985,71,264.1467316492429,0.6785101128140071,1.192242295167215,1.6969025339519843,0.6840894624993903,26639,26879,Hardin+McNairy,Hardin,47,71,Tennessee,TN
47109,47CS025,329,318,340,404,64,75,86,349.7898441937925,35,162.69610691458453,1.3470052593880777,1.8824252376938446,2.374260139335708,0.4590251812483114,402,389,415,464,49,62,75,239.73705072423195,50,193.37123409521598,-0.015112918431614716,0.46149057299142693,0.9983356260747495,0.7937917962009046,25815,25857,Hardin+McNairy,McNairy,47,109,Tennessee,TN
47073,47CS026,639,614,663,767,104,128,153,271.3880411379706,55,116.27702119412976,1.0477074064224599,1.5359386495496175,2.07685828827558,0.42514113034635254,787,758,817,1039,222,252,281,440.0050314618305,155,270.9884961012623,1.167059806958563,1.6885147498296589,2.2130464463652584,0.6134384709779415,56761,57198,Hawkins,Hawkins,47,73,Tennessee,TN
47081,47CS027,252,241,262,326,64,74,85,356.3526773988909,34,163.12822358162407,1.4047207580903824,1.9408592974728531,2.439387534607635,0.4516903441141971,311,298,324,378,54,67,80,264.4169124773827,60,237.58612497030174,-0.27313906666567067,0.2757156872343637,0.8238997528722588,0.8852711192499044,25011,25254,Hickman+Houston+Humphreys+Stewart,Hickman,47,81,Tennessee,TN
47083,47CS027,102,101,103,128,25,26,27,380.1977211533895,17,246.46611090974986,1.2222509288843553,1.3385937103112908,1.454971092799083,0.6244458544307792,125,124,126,141,15,16,17,188.16104408657432,23,276.7083734359961,-1.010700483013928,-0.885023236934317,-0.7471713093479081,1.382216025307861,8277,8312,Hickman+Houston+Humphreys+Stewart,Houston,47,83,Tennessee,TN
47085,47CS027,223,215,231,241,10,18,26,114.55887465475149,19,120.35472972972971,-0.5696612585316101,-0.06512913551143742,0.459729865746651,0.9955447966719787,275,265,285,350,65,75,85,390.7721095151844,43,224.2386316228619,1.1654458591500572,1.6603132631713051,2.157321536175639,0.5662778158717404,18944,19176,Hickman+Houston+Humphreys+Stewart,Humphreys,47,85,Tennessee,TN
47161,47CS027,151,146,157,158,1,7,12,57.294833359673405,20,175.1441290228417,-1.73164102480425,-1.1770223534331579,-0.6752437214693551,2.6516081793156565,187,180,194,208,14,21,28,153.52375312920879,25,180.76644974692695,-0.8159915526410042,-0.28761763298050685,0.25053037007878437,1.1244882705770127,13703,13830,Hickman+Houston+Humphreys+Stewart,Stewart,47,161,Tennessee,TN
47087,47CS028,146,141,151,170,19,24,29,243.29991842915084,23,236.64580296664667,-0.43848964996836043,0.05911841787929747,0.592791062886812,0.9331868797745061,179,173,185,182,-3,3,9,23.551303871856835,21,179.01287187793028,-2.073986606698353,-1.531030599045109,-1.028914093794459,5.580945228424088,11663,11731,Jackson+Putnam+Smith,Jackson,47,87,Tennessee,TN
47141,47CS028,734,700,769,924,155,190,224,284.3976270450217,118,176.77019874163585,0.537804884708184,1.0692967747608968,1.626817205049385,0.6183031482089717,907,866,949,1043,94,136,177,167.305959512273,91,112.32903767343109,0.0461383147206267,0.5594317316199686,1.043956787439828,0.666481595127339,80104,81012,Jackson+Putnam+Smith,Putnam,47,141,Tennessee,TN
47159,47CS028,184,175,193,217,24,33,42,198.0319984883967,21,126.06933813597479,0.2148977266316925,0.7274702462150856,1.2364767571075674,0.6178800332486333,227,216,237,286,49,59,70,294.44286461146714,39,193.6637203297249,0.466661038355178,1.0071796710682188,1.5450988175301394,0.6468208316774611,19989,20138,Jackson+Putnam+Smith,Smith,47,159,Tennessee,TN
47093,47CS029,3993,3787,4200,4556,356,563,769,140.8704142721515,287,71.84699344114554,0.2120342052543888,0.711356253324178,1.2058326672565067,0.5091171376755919,4946,4696,5197,5783,586,837,1087,172.25792733028834,606,124.76272435673081,-0.057661538709541604,0.45488557219885406,0.9804426719096366,0.7234139553761334,479352,485722,Knox+Union,Knox,47,93,Tennessee,TN
47173,47CS029,194,185,202,247,45,53,62,321.9200874671056,17,102.71903323262839,1.6862567309461063,2.1823107176659517,2.6967611549275574,0.31320370380288265,238,228,249,349,100,111,121,553.3955226741846,48,239.90403838464613,2.6267179817812987,3.1507996126271363,3.6500996621381328,0.4296325589382928,19860,20008,Knox+Union,Union,47,173,Tennessee,TN
47099,47CS030,484,465,503,595,92,111,130,300.3968731744777,62,168.12799421495072,0.8141244798228268,1.3097562353371672,1.8227521717632122,0.5546790354530601,597,574,620,694,74,97,120,216.97664025652807,102,228.00938862188443,-0.6301469263117473,-0.10665974049441394,0.3643449241231131,1.0401317498227125,44252,44735,Lawrence+Wayne,Lawrence,47,99,Tennessee,TN
47181,47CS030,176,169,183,196,13,20,27,148.42452610576575,19,139.98035363457763,-0.4651719326233779,0.08220267975160533,0.6226544794965267,0.8985084707801043,216,208,225,264,39,48,56,292.71111576119404,32,195.37212284022223,0.5279316380476116,0.9708753686455266,1.4681442094947472,0.6538197401110075,16288,16379,Lawrence+Wayne,Wayne,47,181,Tennessee,TN
47107,47CS031,600,577,623,708,85,108,131,242.86009811122557,61,136.911998503694,0.5405294363532251,1.0464257005634139,1.5553452027852113,0.5585860994257634,743,715,771,948,177,205,233,379.58834385927366,123,227.98887859128823,0.9738228381600835,1.5174238140935372,2.0251992772818745,0.5977027469506189,53465,53950,McMinn+Meigs+Monroe,McMinn,47,107,Tennessee,TN
47121,47CS031,162,157,168,156,-12,-6,-1,-57.432088295848665,17,160,-2.6548550150097094,-2.187361177743229,-1.6506426807288288,-3.3319225702475577,202,195,209,211,2,9,16,68.96624778661155,29,222.9054573405073,-2.069480796946405,-1.5347470679635689,-1.04463623651619,2.9079944148350343,12750,13010,McMinn+Meigs+Monroe,Meigs,47,121,Tennessee,TN
47123,47CS031,516,496,536,606,70,90,110,232.96376392396792,53,136.90373686929564,0.4447313570449953,0.9697781908265323,1.4430356023305473,0.5812165815503089,636,612,660,824,164,188,212,402.52980132098196,127,272.2284146446026,0.8164166210678795,1.297674290309815,1.8288328935369222,0.6727115256191123,46456,46652,McMinn+Meigs+Monroe,Monroe,47,123,Tennessee,TN
47119,47CS032,894,850,938,909,-29,15,59,17.625684662553297,105,124.3793372358173,-1.5682750935310699,-1.0706363036542186,-0.5693618977104421,6.612317151371091,1124,1070,1178,1199,21,75,129,72.19540024502436,143,137.08610541250454,-1.1741886275075346,-0.6724352793582742,-0.12079512335727674,1.8739374788026841,101303,104314,Maury,Maury,47,119,Tennessee,TN
47125,47CS033,1274,1179,1369,1493,124,219,314,119.48435184037295,112,61.03375929811176,0.06162130593666522,0.5839585085071811,1.101197220105566,0.5084905208240514,1621,1504,1739,1949,210,328,445,144.34384574514058,304,133.9696893577828,-0.4324272555332533,0.11062296991273841,0.5914826018222321,0.9253038584771467,220206,226917,Montgomery,Montgomery,47,125,Tennessee,TN
47129,47CS034,214,205,223,227,4,13,22,73.35405412619922,11,62.56517205422315,-0.4056019810821373,0.12390107829671954,0.6538452486062325,0.7915454151730329,265,254,276,335,59,70,81,330.8638564253585,42,197.92648444863337,0.8123025551886918,1.3178397377683078,1.8297576376018683,0.5898105149919463,21098,21220,Morgan+Roane,Morgan,47,129,Tennessee,TN
47145,47CS034,659,636,682,750,68,91,114,203.14180901794884,54,120.9903282422794,0.2788462009049102,0.8144533609087967,1.3384342704606496,0.589097924316236,812,784,840,923,83,111,139,205.6921132419112,114,211.41649048625794,-0.5855842228206702,-0.06608687030276944,0.428011508457334,1.0186456719032888,53558,53922,Morgan+Roane,Roane,47,145,Tennessee,TN
47027,47CS035,96,95,97,137,40,41,42,652.0988587895425,19,301.58730158730157,3.378373183467871,3.5041971722179377,3.634605133235897,0.4514970061271749,117,116,118,139,21,22,23,291.43392313834295,16,211.78027796161484,0.664381226902861,0.7946116551287893,0.9164332497568798,0.6951132226177131,7560,7555,North Central Tennessee,Clay,47,27,Tennessee,TN
47111,47CS035,241,230,252,301,49,60,71,285.1660207514206,41,195.2380952380952,0.34770245995680504,0.9121527282464241,1.4504930103319076,0.6734021736347776,298,285,312,342,30,44,57,170.5654614424361,59,230.18102372034957,-1.1106492613176118,-0.5892877235329897,-0.10096311239834785,1.3193397133734355,25200,25632,North Central Tennessee,Macon,47,111,Tennessee,TN
47133,47CS035,268,259,278,343,65,75,84,397.63925762126894,42,223.32506203473943,1.2427930042303095,1.7466654346712338,2.2926416875409314,0.5542162749440899,329,317,341,404,63,75,87,329.3878243769684,55,241.20691167441453,0.3698538815118158,0.8992341803957518,1.4218668827366696,0.7226666605485358,22568,22802,North Central Tennessee,Overton,47,133,Tennessee,TN
47137,47CS035,63,63,64,79,15,16,16,376.3799675456571,18,430.793777423215,-0.6712427347500339,-0.5425276181388347,-0.42082345616466643,1.0761424826463781,78,77,79,80,1,2,3,38.81647537014649,1,19.73554371422933,0.06702855063717666,0.1890019516264214,0.32301376637577445,0.3370600027607863,5014,5067,North Central Tennessee,Pickett,47,137,Tennessee,TN
47169,47CS035,98,96,99,107,8,9,11,97.16186526761065,13,133.97457918241153,-0.4903739337631393,-0.37049098044752676,-0.2438623860592729,1.2466508652821189,123,121,124,152,28,29,31,244.20869825225034,20,166.9449081803005,0.6475702023460711,0.7720755617442938,0.89546840584204,0.6610214978912211,11644,11980,North Central Tennessee,Trousdale,47,169,Tennessee,TN
47131,47CS036,336,323,349,455,106,119,132,466.9248130837427,72,282.1500881719025,1.3410935154695427,1.8601456397506733,2.3575141556223866,0.5992438031650024,410,395,426,497,71,87,102,284.1754699072711,74,242.60704216116977,-0.13588807469441183,0.41278086099403294,0.9559817956060551,0.8439857851641467,30622,30502,Obion+Weakley,Obion,47,131,Tennessee,TN
47183,47CS036,338,323,352,380,28,42,57,154.44284299995502,35,127.50068303937341,-0.24253461767230605,0.2465035897442297,0.7430343805324884,0.8065287827074232,416,399,433,496,63,80,97,241.9346019823873,59,178.7283026869831,0.1630161871872623,0.6369667065352488,1.085139357102886,0.7296107963414112,32941,33011,Obion+Weakley,Weakley,47,183,Tennessee,TN
47147,47CS037,608,576,639,769,130,161,193,265.97986431327314,73,120.298273802167,0.961487801033027,1.4596844954670056,1.9682667213064284,0.4494984457989343,755,717,794,959,165,204,242,275.38105526185035,116,156.93277595140495,0.6299366706404277,1.1848095568860348,1.7126124957476048,0.5670890423251239,72819,73917,Robertson,Robertson,47,147,Tennessee,TN
47149,47CS038,1913,1766,2061,2287,226,374,521,130.88816124814565,235,82.34370026893102,-0.013906965560050924,0.4894364907987628,1.0234277639154774,0.6274352620606596,2426,2245,2607,2886,279,460,641,131.1798436810614,432,123.12533132684646,-0.44222410199247,0.08417629427610958,0.5987161581032591,0.9365646078534656,342467,350862,Rutherford,Rutherford,47,149,Tennessee,TN
47155,47CS039,942,899,984,1105,121,163,206,198.80174811962902,86,104.67699236223106,0.44380200695623495,0.9408180713789346,1.465692944784152,0.5233354478684392,1164,1112,1215,1479,264,315,367,317.43887202939703,219,220.39288302069076,0.449722109285586,0.9577549740846462,1.4580984552955765,0.6920903838949302,98589,99368,Sevier,Sevier,47,155,Tennessee,TN
47157,47CS040,7068,6669,7468,9054,1586,1986,2385,256.39372926610287,955,123.30058228861373,0.8187877603387896,1.3308342760268481,1.8341565897893972,0.48066122444872106,8666,8188,9143,12568,3425,3902,4380,421.8398794129341,1620,175.1228292065963,2.010341315581726,2.4742973316662504,2.9872028540542828,0.41503416899355927,929436,925065,Shelby,Shelby,47,157,Tennessee,TN
47163,47CS041,1807,1739,1875,2145,270,338,406,256.0350738353637,184,139.50931641698628,0.6493261428117577,1.1706744859097509,1.6385518255530684,0.5432748015887142,2218,2136,2300,2690,390,472,554,296.6520102858802,319,200.51039008384979,0.45743543779553714,0.9687718066177906,1.44274560825542,0.674481989924341,158269,159094,Sullivan,Sullivan,47,163,Tennessee,TN
47165,47CS042,1486,1402,1571,1729,158,243,327,147.93849058779367,188,114.65045839855263,-0.1650699858917687,0.34713416037024436,0.8849282963630568,0.7718057532829601,1855,1752,1959,2298,339,443,546,221.2839067459041,337,168.43431061885863,0.03037957269708231,0.5245258660187294,1.0424679573367794,0.7594530240079067,196772,200078,Sumner,Sumner,47,165,Tennessee,TN
47167,47CS043,519,492,545,598,53,79,106,155.99652675667843,64,125.74703233729022,-0.20818812779519075,0.30557322218351607,0.8435780931840272,0.7960621565078211,635,603,666,804,138,169,201,277.31458340536045,126,206.56414964425065,0.15592857294410795,0.7121871805130894,1.283431976674929,0.7404954343864333,61075,60998,Tipton,Tipton,47,167,Tennessee,TN
47179,47CS044,1297,1240,1354,1539,185,242,299,219.0871156734588,151,136.5455189407926,0.32499063108518284,0.8152785159965389,1.3308019491256482,0.6206857393268559,1602,1532,1671,1902,231,300,370,224.10365142848934,199,148.4332460635354,0.2627982051611749,0.7641409263766968,1.2549137615093402,0.660144741020375,132703,134067,Washington,Washington,47,179,Tennessee,TN
47187,47CS045,1254,1147,1362,1390,28,136,243,65.44013197431445,138,66.64091172493721,-0.5125600564152774,-0.003660745546601193,0.47170612430687403,1.0108895861663818,1598,1466,1729,1670,-59,72,204,28.316507216699097,173,67.89239252006357,-0.9178701138553823,-0.39711007645744045,0.14456660299056978,2.3648512180661236,248496,254815,Williamson,Williamson,47,187,Tennessee,TN
47189,47CS046,1045,981,1109,1283,174,238,302,192.75734554234174,144,116.5032833969337,0.23484584213028137,0.7772538138722809,1.2757798105488358,0.6018776282005752,1312,1234,1390,1558,168,246,324,162.6140033289099,244,161.13268351956046,-0.4899950251949981,0.017954838559976535,0.5779136784309827,0.9868828188590599,148322,151428,Wilson,Wilson,47,189,Tennessee,TN
48001,48CS001,566,541,591,612,21,46,71,94.90165261468535,76,157.44225391016124,-1.1563677095345573,-0.6377343406586611,-0.09971239497807939,1.623563567228909,697,667,727,884,157,187,217,320.8659358044977,138,236.6011727188561,0.30915217501208253,0.8368163198044953,1.3799936626443006,0.7334641086053235,57926,58326,Anderson+Houston,Anderson,48,1,Texas,TX
48225,48CS001,237,227,246,308,62,71,81,384.01229816926735,27,145.91965411637543,1.8648512249857485,2.384840915386137,2.884982510883931,0.37471336732275556,290,279,301,394,93,104,115,468.191526149244,70,315.0882247029168,0.9795725514096011,1.537468039511228,2.0670673864643483,0.6665814112259326,22204,22216,Anderson+Houston,Houston,48,225,Texas,TX
48005,48CS002,769,732,807,990,183,221,258,306.22313413589524,163,226.33125824442848,0.23839109760386268,0.7840839428186173,1.2939545860169892,0.7357694155097207,945,901,990,1257,267,312,356,360.33933002030517,262,302.9497126602916,0.05922163233975704,0.5594908736476519,1.0770092083172749,0.8380453049503274,86422,86483,Angelina,Angelina,48,5,Texas,TX
48007,48CS003,285,274,295,380,85,95,106,479.1260982196581,23,115.49566891241578,3.101218304851798,3.647176573561373,4.132039514269606,0.23855464162836718,354,341,366,429,63,75,88,307.877169284426,46,188.34704991196824,0.6904635960591861,1.1860543987245618,1.6808489964890572,0.6037312608831064,23897,24423,Aransas+Calhoun+Refugio,Aransas,48,7,Texas,TX
48057,48CS003,163,154,172,216,44,53,62,314.5100595451768,11,65.3886164363204,1.9955691239632727,2.503268090831493,2.9704998761287875,0.20404962537965776,197,187,207,268,61,71,81,359.3653328302688,29,146.65722666127238,1.6281211928599977,2.130921326956507,2.641197795868561,0.4024373777212003,20187,19774,Aransas+Calhoun+Refugio,Calhoun,48,57,Texas,TX
48391,48CS003,72,71,73,100,27,28,29,495.96568036515544,17,301.81979582778513,1.8184220288215434,1.9420484443282895,2.055017610124936,0.5875183398650734,88,87,89,112,23,24,25,353.8145441155961,13,192.4500370096225,1.4928814699891237,1.6065736978097904,1.7306672062781592,0.5220847375049056,6759,6755,Aransas+Calhoun+Refugio,Refugio,48,391,Texas,TX
48009,48CS004,76,75,77,76,-1,0,1,0.518161256148675,4,55.878928987194406,-0.6746441047239727,-0.5539776159130866,-0.43672974873486714,3.8569395182140824,94,93,95,112,17,18,19,207.41042956211757,22,253.95359575204895,-0.5980208741972612,-0.46688130653472276,-0.33712478363144993,1.1598502741351515,8590,8663,Archer+Wichita,Archer,48,9,Texas,TX
48485,48CS004,1163,1107,1219,1403,184,240,296,221.25707274679814,240,221.52823715828498,-0.5188719568601796,-0.01346527392033816,0.4984019765158831,0.9970660293641607,1430,1362,1497,1775,278,345,413,265.72178063682446,306,235.39729062334126,-0.20928582608733337,0.3060184133372863,0.8324174736947528,0.8833215529187604,130006,129993,Archer+Wichita,Wichita,48,485,Texas,TX
48013,48CS005,350,328,371,485,114,135,157,328.5502024825172,89,215.85787335529636,0.6265783744583789,1.130503273279957,1.643104594857311,0.6521867222747609,434,409,460,627,167,193,218,386.4972818290539,136,273.01013750878246,0.6314760201920117,1.1436102623878701,1.6262305556832601,0.7027202784572217,49477,49815,Atascosa+Live Oak+McMullen,Atascosa,48,13,Texas,TX
48297,48CS005,101,100,102,131,29,30,31,314.864178182357,17,177.74679794371352,1.2395298116883424,1.3729220529057709,1.4964094415788938,0.5463754696358886,122,121,124,155,31,33,34,286.3745299178454,30,263.8058389025677,0.09808686855635071,0.22374773658455593,0.3476123663770744,0.8937479237969832,11477,11372,Atascosa+Live Oak+McMullen,Live Oak,48,297,Texas,TX
48311,48CS005,8,8,8,17,9,9,9,1822.6047423599755,6,1163.1663974151857,6.4776778867896905,6.5933625389458985,6.7144300540657085,0.5768341781233343,9,9,9,14,5,5,5,807.8647943061889,3,494.23393739703454,3.0065697396781115,3.134021500794358,3.2662004949416974,0.508152519415786,619,607,Atascosa+Live Oak+McMullen,McMullen,48,311,Texas,TX
48015,48CS006,241,228,254,271,17,30,43,118.1120423313879,19,75.65451106613133,-0.06916195688974672,0.42980999234470385,0.9748959759152769,0.6196422315555253,297,282,313,365,52,68,83,223.50364254956702,42,138.43111404087014,0.3280579137429483,0.845828099939174,1.3507266328227767,0.6103674827700377,30137,30340,Austin+Waller+Washington,Austin,48,15,Texas,TX
48473,48CS006,305,280,329,395,66,90,115,189.34113355150393,27,56.539568973038996,0.8084134117151895,1.3245822319571916,1.8709013277245976,0.2953457432893485,389,358,420,501,81,112,143,188.7095560093396,78,131.2556793322788,0.09689095988795049,0.5733752343546531,1.1228601274342487,0.6893958671965432,57305,59426,Austin+Waller+Washington,Waller,48,473,Texas,TX
48477,48CS006,320,305,336,416,80,96,111,320.45145970166925,65,217.80408801519042,0.512052625925776,1.035155159311345,1.5299494421621984,0.6726452947186577,392,373,410,522,112,130,149,362.83673603429094,76,211.79945935401165,0.9769370676262412,1.4971921519169382,2.0319967312797464,0.5792828366064816,35812,35883,Austin+Waller+Washington,Washington,48,477,Texas,TX
48019,48CS007,204,194,213,264,51,60,70,339.7689629515754,15,84.24205550615434,2.0010795097246032,2.555649850193005,3.07733468433112,0.24390761358765956,251,240,262,329,67,78,89,362.70920310542897,49,228.10856105395465,0.8171748195942362,1.3456696486739412,1.8779746739092267,0.6209325439951945,21367,21481,Bandera+Kendall+Kerr,Bandera,48,19,Texas,TX
48259,48CS007,329,310,349,379,30,50,69,132.23579017544327,38,100.92067988668555,-0.17841979769207736,0.3160068008005429,0.8170483098496033,0.7481613512368622,416,392,440,457,17,41,65,87.60753710422622,58,124.84394506866417,-0.8770408400191015,-0.3667978136077929,0.159715813153747,1.3908636225426556,45184,46458,Bandera+Kendall+Kerr,Kendall,48,259,Texas,TX
48265,48CS007,635,612,657,699,42,64,87,146.20815688059793,51,116.15327677503842,-0.22264841210907857,0.29967325837974246,0.7986751181757773,0.7822524228993093,778,750,805,863,58,85,113,160.79106707727263,92,173.29063853833114,-0.6521720167647159,-0.11022935409187769,0.3881484948613033,1.0652589499822072,52689,53090,Bandera+Kendall+Kerr,Kerr,48,265,Texas,TX
48021,48CS008,680,638,722,697,-25,17,59,20.593390590675465,53,65.52715358699348,-0.9633088619097939,-0.4470945014326954,-0.004993362663631933,3.001736054981377,870,817,922,945,23,75,128,74.16020573378704,144,141.9222581408184,-1.1670019371206644,-0.6761990352087358,-0.20114411259767934,1.8886258664385447,97059,101464,Bastrop+Caldwell,Bastrop,48,21,Texas,TX
48055,48CS008,332,312,352,414,62,82,102,215.7227869918002,50,131.27666557269444,0.3279760148624548,0.8624064860205534,1.3458741757987165,0.6012259008467308,415,391,439,489,50,74,98,157.79229203061038,102,218.55113453750724,-1.0914596044130385,-0.6214767056197253,-0.05903502299035133,1.366500156765798,45705,46671,Bastrop+Caldwell,Caldwell,48,55,Texas,TX
48025,48CS009,224,211,238,276,38,52,65,198.95525478089652,49,188.33477467089457,-0.3919488852718115,0.10536254344204797,0.6389407656505294,0.9286778551022817,276,260,292,398,106,122,138,394.8531044369357,90,290.942005560225,0.5281696542456787,1.044488229762956,1.5189172514526499,0.730852520720183,31221,30934,Bee+Goliad+Karnes,Bee,48,25,Texas,TX
48175,48CS009,67,67,68,64,-4,-3,-3,-56.81405945212961,4,67.52004501336334,-1.3677583945333853,-1.246050229189933,-1.1376664828556615,-1.6907888896525962,83,82,84,98,14,15,16,210.35844143649385,19,266.1064425770308,-0.6835831769882323,-0.5546079704817433,-0.42657997338109055,1.1860476314095203,7109,7140,Bee+Goliad+Karnes,Goliad,48,175,Texas,TX
48255,48CS009,133,127,140,156,16,23,29,183.34820922854306,24,194.37133022879124,-0.6327273984548004,-0.1025947534275895,0.3992602455390203,1.015274803732627,164,156,171,175,4,11,19,76.58340115404424,30,203.40362058444643,-1.724005611565296,-1.2612633597793959,-0.7463496710710356,2.439959542188853,14817,14749,Bee+Goliad+Karnes,Karnes,48,255,Texas,TX
48027,48CS010,2089,1929,2249,2385,136,296,456,95.475435361876,202,65.23704947681178,-0.24713103448012527,0.29636211236023413,0.8188825418474461,0.6809827259119493,2632,2437,2828,3353,525,721,916,190.4413667453453,551,145.5734829050232,-0.06638384995183236,0.4396871239146135,0.9649145631357712,0.7633415551673806,371568,378503,Bell,Bell,48,27,Texas,TX
48029,48CS011,11851,10985,12718,14275,1557,2424,3290,144.4195156768855,1952,116.31527278523535,-0.22441187008280913,0.2933795601783484,0.8472570333457848,0.8050664077547547,14736,13690,15782,18960,3178,4224,5270,208.46118632598547,3396,167.60702962439444,-0.07387685365194716,0.4093863729124111,0.9768633302304065,0.8038300086038769,2013837,2026168,Bexar+Wilson,Bexar,48,29,Texas,TX
48493,48CS011,356,334,377,382,5,26,48,63.08692826397706,37,88.33184124142048,-0.7702015331162959,-0.26126110270118924,0.29478521319941703,1.3491075816197968,445,418,471,641,170,196,223,384.3882994720323,115,225.16789693184268,1.1140738822850285,1.5931460729846154,2.107998619005328,0.5828136775162159,50265,51073,Bexar+Wilson,Wilson,48,493,Texas,TX
48035,48CS012,209,201,217,274,57,65,73,427.28252863233763,20,131.01867016049786,2.437366512269714,2.9650450933190444,3.4559998201716007,0.3020022234202581,255,246,265,305,40,50,59,269.03208895966367,36,194.97400346620452,0.23272613044077176,0.7428244818717322,1.2362317118167079,0.7104223010070367,18318,18464,Bosque+Hamilton+Hill,Bosque,48,35,Texas,TX
48193,48CS012,115,115,116,105,-11,-10,-10,-151.436837390702,16,232.33301064859631,-3.9690237525343077,-3.8373061584197883,-3.7250786291659304,-1.6969015275123231,140,139,141,157,16,17,18,201.518617048507,6,72.91286912139992,1.1630729059536233,1.2855586828004777,1.4115833847344488,0.3412393369702882,8264,8229,Bosque+Hamilton+Hill,Hamilton,48,193,Texas,TX
48217,48CS012,381,365,396,451,55,70,86,232.97119946035968,40,132.96030580870337,0.4736390294957251,0.9874118983447246,1.5055624581822695,0.562687273421066,466,447,485,673,188,207,226,568.101292861037,139,381.8996071104761,1.3595692931261534,1.8539410843939943,2.3778370952888346,0.6690031157284749,36101,36397,Bosque+Hamilton+Hill,Hill,48,217,Texas,TX
48037,48CS013,891,851,931,1063,132,172,212,221.9969941528811,126,162.80121454874345,0.0989097876620429,0.6073085629262533,1.10461088837398,0.7291051753175043,1089,1042,1137,1381,244,292,339,314.83363966915556,228,246.18839891158814,0.1604766513324136,0.6850794757939302,1.22162249237371,0.7792907439480365,92874,92612,Bowie,Bowie,48,37,Texas,TX
48039,48CS014,2077,1916,2238,2443,205,366,527,117.31908821239463,239,76.63920517555134,-0.12299254765670169,0.4082102734402129,0.9253519126927215,0.6514736927467779,2603,2408,2799,3459,660,856,1051,225.94318808536585,605,159.72880425169035,0.09797494493413023,0.6516671340566548,1.1553339848987216,0.7061172340626666,374221,378767,Brazoria,Brazoria,48,39,Texas,TX
48041,48CS015,931,830,1032,1141,109,210,311,107.69756862827144,146,74.86923523982087,-0.18482078140538774,0.30115032911609096,0.8267457997094432,0.6918859451855037,1172,1050,1294,1414,120,242,364,102.3132578014149,216,91.27017662469365,-0.4011789554059738,0.11327354296983524,0.6142006167678977,0.8883969585855285,234008,236660,Brazos+Burleson+Grimes+Robertson,Brazos,48,41,Texas,TX
48051,48CS015,193,186,201,211,10,18,25,120.13785303336384,20,134.8314606741573,-0.6335694502978675,-0.15708825130636028,0.35164607015172605,1.0626739484373293,238,229,247,297,50,59,68,327.2398078842647,41,227.87905735882612,0.46597105694998464,0.9823191980603907,1.4619450172515787,0.6847372016922137,17800,17992,Brazos+Burleson+Grimes+Robertson,Burleson,48,51,Texas,TX
48185,48CS015,252,240,265,314,49,62,74,251.33066124177736,47,191.60211985324094,0.050061334717712805,0.5842986953619472,1.1390103284458433,0.7501826231496528,315,300,331,396,65,81,96,267.60724422075197,64,212.20159151193633,0.04023066189297412,0.5668691259866662,1.0641728041387748,0.7832545574495128,29436,30160,Brazos+Burleson+Grimes+Robertson,Grimes,48,185,Texas,TX
48395,48CS015,162,154,169,202,33,40,48,288.22524710473215,23,164.12940057088488,0.7376571963086419,1.2397847844726133,1.7454504583061454,0.5556902550396843,199,190,207,267,60,68,77,404.5255492238781,48,283.58738036157393,0.6993207262738387,1.2086585714005875,1.7293624979935491,0.6909457870550011,16816,16926,Brazos+Burleson+Grimes+Robertson,Robertson,48,395,Texas,TX
48049,48CS016,432,416,448,584,136,152,168,480.15568170227596,73,230.59913656944298,2.00281310346241,2.487814993836924,3.0120415692546416,0.47712018006941675,531,512,551,647,96,116,135,302.8982443740924,107,280.36893407399646,-0.2447305529114919,0.20631624735769688,0.726296948728043,0.9176823023978806,37988,38164,Brown+Coleman+Mills,Brown,48,49,Texas,TX
48083,48CS016,127,124,130,124,-6,-3,0,-47.22276374353549,16,247.93388429752065,-3.4814516354932747,-2.9421239059828777,-2.4413323841315857,-7.814627831646428,155,151,159,214,55,59,63,766.0630388157782,42,543.6189490033653,1.7130803356431377,2.2265499556506363,2.723900322555956,0.6978363539775743,7744,7726,Brown+Coleman+Mills,Coleman,48,83,Texas,TX
48333,48CS016,57,57,58,74,16,17,17,444.716012986363,14,372.8362183754993,0.5892718428893928,0.7144914284374301,0.840329351965761,0.7910012851781174,70,70,71,92,21,22,22,488.86457996311646,14,312.9190880643719,1.628259723390156,1.7632636639025596,1.8828430438611827,0.6121074510812007,4506,4474,Brown+Coleman+Mills,Mills,48,333,Texas,TX
48053,48CS017,473,452,495,498,3,25,46,59.49766275525882,30,72.846476051721,-0.6946153285265048,-0.13037986294369375,0.3943597882150577,1.1763494950865485,596,570,622,692,70,96,122,189.7794363926049,114,224.71467150263152,-0.8512916222915926,-0.36001000633634817,0.11269188024017607,1.1719110695586934,49419,50731,Burnet+Lampasas+Llano,Burnet,48,53,Texas,TX
48281,48CS017,197,187,206,252,46,55,65,306.5072668333924,13,71.81328545780968,1.851963262940385,2.3272548985310304,2.9131346901050277,0.23014764971883134,246,235,258,331,73,85,96,381.7672071572128,54,243.5394398592883,0.8686148007404613,1.362564145738787,1.8646718287040625,0.6304784281514875,21723,22173,Burnet+Lampasas+Llano,Lampasas,48,281,Texas,TX
48299,48CS017,283,274,292,302,10,19,28,106.47094340126723,17,95.29593123744569,-0.38395488159394187,0.09459209711571527,0.6293184760597564,0.8502751046001884,353,342,364,412,48,59,70,269.0121398884532,67,306.32772494513534,-0.877654749635703,-0.36611892978661553,0.10065395190465394,1.119683556290529,21407,21872,Burnet+Lampasas+Llano,Llano,48,299,Texas,TX
48059,48CS018,146,140,152,196,44,50,56,431.844418698389,26,225.82513028372898,1.577803137512502,2.0480043690267036,2.5714027421492074,0.5126214558816838,181,173,188,231,43,50,58,358.7815035041578,36,256.0091025458683,0.5287504781740865,1.0198162295180748,1.5468501690613172,0.6996832278268478,13816,14062,Callahan and Nearby Counties,Callahan,48,59,Texas,TX
48133,48CS018,210,202,217,230,13,20,28,137.54603207935415,18,121.07623318385652,-0.3841226533697286,0.1773821413076411,0.692871287477223,0.8392191305601304,254,245,264,383,119,129,138,720.8537759060877,70,392.2008068130883,2.7925815756429686,3.2975788289393573,3.8018348603739147,0.5398819182700452,17840,17848,Callahan and Nearby Counties,Eastland,48,133,Texas,TX
48253,48CS018,153,145,162,221,59,68,76,411.92438471448804,39,237.27438653417153,1.2369240090981273,1.7519534134121244,2.2537580347825714,0.5676307430523009,188,178,198,261,63,73,83,369.0794317424479,62,312.43700866760736,0.03088447487373466,0.5630548947638492,1.0981098118002635,0.8351279330702509,19724,19844,Callahan and Nearby Counties,Jones,48,253,Texas,TX
48417,48CS018,25,24,25,38,13,13,14,513.5822639679542,8,304.4719314938154,1.9662782825187977,2.0952062689542386,2.2079636671972653,0.5519382905298778,30,30,31,42,11,12,12,361.5099214033948,6,187.5586120662707,1.6118143773415798,1.7354661603107722,1.8577281109266708,0.47752822277997076,3153,3199,Callahan and Nearby Counties,Shackelford,48,417,Texas,TX
48429,48CS018,91,90,92,123,31,32,33,419.01379775760984,17,223.4392113910186,1.8283282935180163,1.956857398940922,2.076103710321836,0.5170321578000899,112,111,113,144,31,32,33,352.1403952247411,24,262.0373403209957,0.7685108727923377,0.8965547222179422,1.0257796199091684,0.7217494022136405,9130,9159,Callahan and Nearby Counties,Stephens,48,429,Texas,TX
48061,48CS019,2342,2161,2523,3734,1211,1392,1573,396.2191903627471,1075,305.98085840676475,0.41960345993478393,0.9059828381982927,1.4175590108744913,0.7716971189243801,2911,2693,3130,3808,678,897,1115,212.1150305940382,740,175.0397978999955,-0.1634206553319657,0.37054339196286545,0.85367930460560415,0.824292456090114,421595,422761,Cameron,Cameron,48,61,Texas,TX
48067,48CS020,331,319,343,455,112,124,136,518.4694201809991,60,251.30890052356023,2.1422913614606407,2.667034172562524,3.155492871077176,0.48082866370326327,403,388,418,589,171,186,201,651.4182389656651,111,388.9687072922872,2.082533711290205,2.643195560158967,3.1329558016605876,0.593915661969222,28650,28537,Cass+Marion+Morris,Cass,48,67,Texas,TX
48315,48CS020,144,140,148,163,15,19,23,232.07384331500725,21,258.32906201947713,-0.7634208021869304,-0.2659828365605674,0.271432169402717,1.0571000381563993,173,168,178,212,34,39,44,399.0519023434427,40,414.03581409791946,-0.6902052524057303,-0.1532826745698779,0.3806368361612714,1.0113165235511414,9755,9661,Cass+Marion+Morris,Marion,48,315,Texas,TX
48343,48CS020,155,150,160,168,8,13,18,129.3288846260467,15,149.68814968814968,-0.7192677765767417,-0.22234954443202734,0.3128113553958188,1.0745114999405163,189,183,195,228,33,39,45,326.1673086678394,43,357.73710482529117,-0.8241834493364976,-0.31151381397385663,0.19613022213759623,1.069510456783947,12025,12020,Cass+Marion+Morris,Morris,48,343,Texas,TX
48071,48CS021,277,257,297,334,37,57,77,146.9696872014196,28,71.86397176772537,0.22822109471379237,0.7611701848609481,1.2266684948944386,0.48057891049761686,352,327,377,418,41,66,91,136.08370851768981,86,176.95473251028807,-0.9100182155634471,-0.40667659470384154,0.08421961599675533,1.2809688683302294,46755,48600,Chambers+Liberty,Chambers,48,71,Texas,TX
48291,48CS021,764,724,804,768,-36,4,44,5.38419049626309,92,119.56851362474549,-1.6547903045573464,-1.1470570468650183,-0.5920746784376398,17.889172389590904,975,925,1025,1155,130,180,230,186.3510480952099,240,247.80076818238135,-1.1365718162715315,-0.6245126783241349,-0.08158106668207793,1.3224254021687494,92332,96852,Chambers+Liberty,Liberty,48,291,Texas,TX
48073,48CS022,464,442,486,601,115,137,159,323.9707357103868,97,228.92656256146006,0.4391998997345754,0.9381973482576975,1.4617682779526873,0.701516866322128,570,544,597,794,197,224,250,438.53675458427074,148,290.15625306330503,0.9596461067030383,1.4692979884337645,1.9493299653227365,0.6587015923844254,50846,51007,Cherokee,Cherokee,48,73,Texas,TX
48077,48CS023,108,107,109,128,19,20,21,233.14087395156886,13,151.7657359665337,0.688032609479155,0.8142744517737107,0.9347431120221581,0.6199196779309037,132,131,134,151,17,19,20,180.33361796143453,16,155.94541910331384,0.12228421819598666,0.24023575133602854,0.3742418402213162,0.8204190317723986,10279,10260,Clay+Cooke+Montague,Clay,48,77,Texas,TX
48097,48CS023,373,355,391,424,33,51,69,147.86484110541414,39,112.32988502988263,-0.15700327842362208,0.36755017069947843,0.854601713211345,0.7451644469891585,463,442,485,520,35,57,78,134.32881098499405,85,201.59377668152925,-1.2224719109813342,-0.6731615318702319,-0.16445173159896057,1.4747113070623776,41663,42164,Clay+Cooke+Montague,Cooke,48,97,Texas,TX
48337,48CS023,245,237,254,325,71,80,88,477.6685674528059,41,246.03690553583039,1.7700393866468969,2.3120824923885293,2.7959770946200564,0.5086881062864574,305,294,315,368,53,63,74,310.65164723800456,55,270.33669206193167,-0.10675320072985967,0.3942155411309024,0.8915311991827225,0.8566700958881407,19997,20345,Clay+Cooke+Montague,Montague,48,337,Texas,TX
48085,48CS024,4222,3759,4684,4832,148,610,1073,68.37635167264591,443,49.61829567314648,-0.3624747008677394,0.1949268708961934,0.7283728103884108,0.7244778229732565,5448,4878,6018,6213,195,765,1335,69.25467802348268,819,74.17362968973868,-0.5815122645516644,-0.05251680921977067,0.4559277806962545,1.0696282151054053,1071379,1104166,Collin,Collin,48,85,Texas,TX
48091,48CS025,1215,1144,1285,1357,72,142,213,104.32995212557586,137,100.41472993690485,-0.481627885709456,0.03956514715591866,0.560030074962329,0.9557581587747257,1574,1484,1663,1784,121,210,300,121.25960643037308,289,166.74167157083346,-0.9728594791836231,-0.4598139580477232,0.048171439862176896,1.3685683646502949,163721,173322,Comal,Comal,48,91,Texas,TX
48093,48CS026,158,152,164,194,30,36,42,318.65938783341585,36,317.13404786374986,-0.4745526238074327,0.02069188306640545,0.5160836787115042,0.9684408918461118,193,186,200,220,20,27,34,194.8642837519125,32,232.74419957815115,-0.8888115947724686,-0.3769662141265086,0.1844629590075754,1.151415019650125,13622,13749,Comanche+Erath+Somervell,Comanche,48,93,Texas,TX
48143,48CS026,288,270,307,315,8,27,45,75.39076404159367,37,103.84021703540857,-0.7592774891571389,-0.26813124185149745,0.21584895278662394,1.327926602850816,356,334,379,462,83,106,128,244.16784657487267,79,182.5281301263834,0.10679829406960947,0.6044861448681057,1.0920316704519597,0.7405443338289487,42758,43281,Comanche+Erath+Somervell,Erath,48,143,Texas,TX
48425,48CS026,82,82,83,99,16,17,17,215.20322491296255,3,39.01593150536469,1.6367656023276007,1.760720322522561,1.887575101669607,0.1709661360143973,103,102,104,123,19,20,21,209.19015906160624,17,180.23748939779475,0.15696391305217935,0.29007738225048313,0.4203406266397357,0.8200352635323465,9227,9432,Comanche+Erath+Somervell,Somervell,48,425,Texas,TX
48099,48CS027,464,429,500,534,34,70,105,101.77832479728127,40,58.352277562333605,-0.0487112153476081,0.4373158776873201,0.9633656764048167,0.5652256758872497,585,542,628,705,77,120,163,142.83982938827583,130,154.6404015892275,-0.5954504812617125,-0.11153655040691697,0.39812647146488206,1.0736726862103851,82259,84066,Coryell,Coryell,48,99,Texas,TX
48105,48CS028,30,29,32,56,24,26,27,974.5199057520986,10,379.8670465337132,5.448661481989241,5.95696523263566,6.487528538232363,0.3751748804697592,37,35,38,55,17,18,20,601.222286416351,6,195.1854261548471,3.5461022644820814,4.079424021664567,4.545314680841358,0.3079833427205446,3159,3074,Crockett+Kinney+Terrell+Val Verde,Crockett,48,105,Texas,TX
48271,48CS028,31,29,32,45,13,14,16,534.9039804801464,4,149.71927635683093,3.3229846883730967,3.8314037805722396,4.343638345113621,0.26159432916505276,37,36,39,53,14,16,17,505.6821769636308,2,63.89776357827476,3.9070498308814305,4.41165084632241,4.935574878007727,0.11885058078026403,3206,3130,Crockett+Kinney+Terrell+Val Verde,Kinney,48,271,Texas,TX
48443,48CS028,9,9,9,12,3,3,3,420.7623420004934,3,484.5222072678331,-0.7620974053191839,-0.6400541520737708,-0.5127300653378938,0.8321267108732969,11,11,11,20,9,9,9,1199.3788585403315,4,550.2063273727648,6.363261005844403,6.493022231013477,6.611034381075565,0.4115444683980179,743,727,Crockett+Kinney+Terrell+Val Verde,Terrell,48,443,Texas,TX
48465,48CS028,328,308,349,498,149,170,190,425.7391363139211,162,406.7541271734354,-0.31598226661138346,0.19388166762645204,0.7070326744473759,0.949805396660866,406,381,430,503,73,97,122,204.70699531465073,99,208.12748333928982,-0.542551073660221,-0.026496134674609567,0.47119084643756365,1.0063739409056778,47793,47567,Crockett+Kinney+Terrell+Val Verde,Val Verde,48,465,Texas,TX
48107,48CS029,55,54,55,83,28,28,29,654.5851173409833,23,532.0994794679006,1.1050674024438802,1.2247080898012204,1.3464117553019022,0.7851318771610228,66,65,67,99,32,33,34,645.2190738072621,20,391.77277179236046,2.4143648708380705,2.5373715880477987,2.666749308101336,0.589302386971224,5187,5105,Crosby+Floyd+Hale+Swisher,Crosby,48,107,Texas,TX
48153,48CS029,50,50,51,93,42,43,43,945.028682099565,27,596.6850828729281,3.3577871364612677,3.4833746293203127,3.6003945710687626,0.6169659061736331,61,60,62,93,31,32,33,600.4358740386898,15,280.1643630930146,3.0691812256627693,3.1978176758803616,3.327166225046904,0.4525250440948961,5430,5354,Crosby+Floyd+Hale+Swisher,Floyd,48,153,Texas,TX
48189,48CS029,265,251,279,392,113,127,141,468.8119015271576,129,476.13188976377944,-0.6348987176354929,-0.08053421360916727,0.4405491260913084,1.0076804687682037,326,309,342,395,53,69,86,215.23368634357112,76,235.6443011286122,-0.7253773986797389,-0.2181218199161783,0.2988882917036661,1.0792822488868345,32512,32252,Crosby+Floyd+Hale+Swisher,Hale,48,189,Texas,TX
48437,48CS029,69,69,70,99,29,30,30,504.46664019107345,12,204.92386509178883,2.8687317894583364,2.995640893052042,3.1111414615587587,0.3929179721835633,85,84,86,96,10,11,12,157.75290910253136,13,185.68775889158692,-0.4140018438498358,-0.27960056653670595,-0.14969933521236115,1.0793504253627366,7027,7001,Crosby+Floyd+Hale+Swisher,Swisher,48,437,Texas,TX
48113,48CS030,13906,12784,15028,17173,2145,3267,4389,150.0886429847665,2301,105.71383832122811,-0.05736858978832323,0.449257214141528,0.9301302067440511,0.7041271532156845,17124,15787,18461,20576,2115,3452,4789,133.31263324689357,3389,130.86548850399393,-0.5218815624595906,0.028843615826339368,0.5572565718509457,0.9813593081473592,2611957,2589682,Dallas,Dallas,48,113,Texas,TX
48121,48CS031,3553,3160,3947,4109,162,556,949,73.00689639750706,405,53.22381930184805,-0.3176060758846121,0.2177091720565212,0.7161595598737512,0.727714612868149,4571,4087,5056,5340,284,769,1253,81.9660488584603,693,73.91203720985793,-0.44613664685628135,0.08771093929808826,0.6265372049250542,0.9005678328632841,913125,937601,Denton,Denton,48,121,Texas,TX
48127,48CS032,67,66,68,91,23,24,25,326.5379830133523,13,177.717019822283,1.3666957249799627,1.4867448069946247,1.6085705754417967,0.5223767419326212,79,78,81,156,75,77,78,901.4892504358038,35,412.4440254536885,4.762872173121897,4.892029508903899,5.008653881604857,0.45161070174319684,8778,8486,Dimmit+La Salle+Maverick,Dimmit,48,127,Texas,TX
48283,48CS032,44,43,45,68,23,24,25,422.9262540886294,19,336.43204957945994,0.7467510369391918,0.8656197227733945,0.9866891649220182,0.7635195134515763,53,52,54,86,32,33,34,491.4426122409608,25,375.03750375037504,1.035881729836248,1.168885661041757,1.2908816768360347,0.7405308790732774,6777,6666,Dimmit+La Salle+Maverick,La Salle,48,283,Texas,TX
48323,48CS032,344,338,350,611,261,267,273,552.6544744422965,216,447.35161629933896,0.932188848618109,1.0510479165872284,1.182828621852633,0.8064377401191332,423,416,431,614,183,191,198,328.8007511814193,201,346.40241275312366,-0.30468255911963815,-0.17277515661687112,-0.04238075731009122,1.0480396565956847,57941,58025,Dimmit+La Salle+Maverick,Maverick,48,323,Texas,TX
48047,48CS033,67,67,68,101,33,34,34,574.3760806064729,28,477.6119402985074,0.8510742293769882,0.9638438938223646,1.089605269841578,0.807549486534901,82,81,83,97,14,15,16,211.48541663093874,20,285.7551078725532,-0.875474644623824,-0.7454309070104718,-0.626178173584211,1.2656734425534855,7035,6999,Duval and Nearby Counties,Brooks,48,47,Texas,TX
48131,48CS033,98,97,99,123,24,25,26,302.3617006335597,25,300.0900270081024,-0.11029366406390541,0.0198153158711186,0.14637051681670488,0.95459017064557,117,116,118,172,54,55,56,561.1382510005349,31,317.4928308070463,2.3081152458869982,2.4372023910201324,2.5574043243802342,0.5556597285334172,9997,9764,Duval and Nearby Counties,Duval,48,131,Texas,TX
48247,48CS033,40,39,40,54,14,14,15,346.16508427709266,12,294.9610815239656,0.40009966747223663,0.5140081007387802,0.6333730678868388,0.7955898063894309,48,48,49,69,20,21,21,430.59917507756893,4,83.21198252548366,3.351606327195874,3.4774318274537057,3.6016764270024635,0.18434112178680245,4882,4807,Duval and Nearby Counties,Jim Hogg,48,247,Texas,TX
48249,48CS033,330,313,346,429,83,99,116,305.05060090138136,68,208.83986384459857,0.4227025674458553,0.9689419048405914,1.4854282550473157,0.6777835276134985,403,383,423,594,171,191,211,492.0389747567492,109,280.6240667318882,1.610002385512854,2.1067878634210984,2.6526045980178385,0.5673602974616876,39073,38842,Duval and Nearby Counties,Jim Wells,48,249,Texas,TX
48505,48CS033,82,81,84,115,31,33,34,281.17648081227367,22,189.43742824339836,0.7932256830394551,0.9197252876586672,1.033069734508232,0.6537120360010712,101,100,103,141,38,40,41,284.9450349934457,23,165.42002301495972,1.0628452839506422,1.1954377044440665,1.3248119031855494,0.5662408532878818,13936,13904,Duval and Nearby Counties,Zapata,48,505,Texas,TX
48011,48CS034,24,24,24,34,10,10,10,644.1946595849854,7,454.79155387114236,1.7794145759104656,1.8930401897600713,2.0177929697192725,0.6413058030545553,29,29,29,31,2,2,2,99.79828638251018,4,217.3913043478261,-1.301632789998643,-1.1784783807713188,-1.0377060014750017,1.4102937846770998,1847,1840,Eastern Central Panhandle,Armstrong,48,11,Texas,TX
48023,48CS034,51,51,52,57,5,6,6,191.26090599266735,6,207.25388601036266,-0.2885882027545597,-0.16073451150483653,-0.03988678004452599,0.9178517724838342,63,62,63,81,18,18,19,530.3809719268269,17,489.2086330935252,0.2830856448938456,0.41328290257707717,0.5419914069931507,0.8749024006409591,3474,3475,Eastern Central Panhandle,Baylor,48,23,Texas,TX
48045,48CS034,15,15,15,22,7,7,7,578.2860854285806,3,250.5219206680584,3.165122157089314,3.2725492672582215,3.3988171412923336,0.37855004836268413,18,18,18,16,-2,-2,-2,-136.6806076965785,5,355.6187766714083,-5.045186408306532,-4.92671023423031,-4.790791786460337,-5.424585895401107,1437,1406,Eastern Central Panhandle,Briscoe,48,45,Texas,TX
48075,48CS034,61,61,62,72,10,11,11,190.62850140740014,13,231.4196706720071,-0.5296362358369006,-0.40892869941092586,-0.28052680177388173,1.1102991629452605,74,73,75,84,9,10,11,144.67364489097284,13,193.36605681987209,-0.6145169281281273,-0.48207559057371446,-0.3617595010768196,1.2119619737629983,6741,6723,Eastern Central Panhandle,Childress,48,75,Texas,TX
48101,48CS034,21,21,22,27,5,6,6,490.3380271136066,6,523.2558139534883,-0.8152247326863491,-0.33607822931102505,0.16373321321538264,0.9059964219063779,26,26,27,21,-6,-5,-5,-378.0438589217558,8,579.7101449275362,-10.071910007786565,-9.563068864648733,-9.058693616406453,-1.897080871331775,1376,1380,Eastern Central Panhandle,Cottle,48,101,Texas,TX
48125,48CS034,19,19,19,38,19,19,19,1237.4153863326642,7,461.53846153846155,7.645656212717337,7.758890099794237,7.880875466094187,0.3541172022098704,22,22,23,30,7,8,8,437.0313422796771,4,229.48938611589213,1.9476017191708317,2.075955610345623,2.207300847951,0.4641740976263463,1820,1743,Eastern Central Panhandle,Dickens,48,125,Texas,TX
48129,48CS034,41,40,41,47,6,6,7,231.10124004307315,5,183.5985312117503,0.3587381645101136,0.4719541889533654,0.6000880789537071,0.6855271544596999,49,49,50,64,14,15,15,444.4708863800705,12,367.1970624235006,0.6561478636783158,0.7683205879623798,0.8942790385844761,0.772931497515192,3268,3268,Eastern Central Panhandle,Donley,48,129,Texas,TX
48155,48CS034,17,16,17,27,10,10,11,1099.8732508619098,4,437.956204379562,6.1315309157561835,6.624229677104214,7.119036488320152,0.3621381315350495,21,20,21,25,4,4,5,413.0116574968797,3,277.5208140610546,0.8341036354929512,1.3366161714776732,1.9045627000932617,0.54898240444964,1096,1081,Eastern Central Panhandle,Foard,48,155,Texas,TX
48191,48CS034,35,34,35,47,12,12,13,529.3368524265097,7,296.5054712319096,2.2067233003345086,2.326175907225867,2.4400591296313516,0.5186429598776764,42,42,42,52,10,10,10,351.9127180844093,5,176.11835153222964,1.638465343733553,1.7637013180033498,1.8866782123074546,0.45492585252518175,2833,2839,Eastern Central Panhandle,Hall,48,191,Texas,TX
48197,48CS034,37,37,37,68,31,31,31,1029.6845910719055,10,332.22591362126246,6.853633621407633,6.976207389243661,7.104901592049215,0.31256342897267203,44,44,45,46,1,2,2,49.67771394426149,4,112.5809175344779,-0.7509025408462117,-0.6336849764371417,-0.5000425376947825,1.446628882438381,3612,3553,Eastern Central Panhandle,Hardeman,48,197,Texas,TX
48207,48CS034,59,58,59,71,12,12,13,267.59635347897347,15,329.7911322828874,-0.7419911992162694,-0.619011761727431,-0.5050443737240664,1.1388506321401064,71,70,72,111,39,40,41,740.7866560666233,20,369.48087936449286,3.587848957103375,3.7156001492534267,3.83804934218555,0.4866324298722886,5458,5413,Eastern Central Panhandle,Haskell,48,207,Texas,TX
48269,48CS034,4,4,4,4,-0,-0,-0,-75.11296402756354,4,1791.044776119403,-19.176954139633203,-18.664401304661403,-18.145942155742055,4.806261326153113,5,5,5,8,3,3,3,1178.6015456213543,8,3076.923076923077,-19.45433736365053,-18.972854823280297,-18.48295579622104,1.9683276309303388,268,260,Eastern Central Panhandle,King,48,269,Texas,TX
48275,48CS034,41,40,41,66,25,25,26,895.9249207209756,12,423.03172737955344,4.609612407746141,4.729686383239295,4.855286000948211,0.4542975941756098,49,48,49,71,22,22,23,668.9303110377571,10,298.32935560859187,3.5808317182064466,3.7092301182914516,3.836766564137534,0.4269391057139534,3404,3352,Eastern Central Panhandle,Knox,48,275,Texas,TX
48345,48CS034,17,16,17,18,1,1,2,159.63440928773235,5,558.1395348837209,-4.471666620394125,-3.9774528756085274,-3.482473149140865,2.057563846574043,20,20,21,31,10,11,11,1011.3801540568871,2,187.79342723004694,7.677938952288868,8.240755172268926,8.72671564180127,0.1699062313912385,1075,1065,Eastern Central Panhandle,Motley,48,345,Texas,TX
48433,48CS034,19,19,20,25,5,6,6,534.5581613139188,6,573.7051792828685,-0.8673842648898591,-0.3824513607166837,0.11042653516323545,0.9103892569951443,23,23,24,24,0,1,1,65.47659839691556,6,491.4004914004914,-4.790334711401503,-4.255596248251173,-3.739322324231217,3.3343164631623394,1255,1221,Eastern Central Panhandle,Stonewall,48,433,Texas,TX
48447,48CS034,18,18,18,15,-3,-3,-3,-260.93207901996493,6,495.5264969029594,-7.683727327901704,-7.565986086127254,-7.447702627520326,-2.7784819298252463,23,22,23,23,0,0,1,27.147481773876603,8,537.9959650302623,-5.2378984446984225,-5.109646454071344,-4.981064119356155,5.699292284914894,1453,1487,Eastern Central Panhandle,Throckmorton,48,447,Texas,TX
48487,48CS034,151,146,157,182,25,31,36,290.0948572902643,38,355.91632844208556,-1.1819945225049235,-0.6634862719008209,-0.15679707617997665,1.1885228379250572,185,178,191,198,7,13,20,104.0391257849927,37,290.241606526514,-2.3775233167304886,-1.8665393938248056,-1.3363833428394225,2.5941414356301538,12812,12748,Eastern Central Panhandle,Wilbarger,48,487,Texas,TX
48135,48CS035,1070,999,1141,1393,252,323,394,234.49334584107885,268,194.76862141849213,-0.12594402750507228,0.39975440456620975,0.8801348563350848,0.828027137272186,1295,1212,1379,1614,235,319,402,197.1253193309787,317,196.0069004322045,-0.48066555782569526,-0.017616319706723133,0.4877955774233594,0.9912172284403551,165119,161729,Ector,Ector,48,135,Texas,TX
48139,48CS036,1211,1127,1294,1420,126,209,293,129.596650490621,184,113.95482062953845,-0.36077058488889113,0.15483755026137516,0.6558379087026817,0.8751216957686296,1545,1441,1649,1822,173,277,381,137.30382047089608,283,140.48011436967616,-0.5717747848347233,-0.03766707901414152,0.49080773601241695,1.019447703351824,193761,201452,Ellis,Ellis,48,139,Texas,TX
48141,48CS037,4833,4462,5205,7370,2165,2537,2908,353.11770267374715,2091,291.05132023996765,0.11236025486598587,0.6258842021158051,1.1577382011414585,0.8239083915815472,6026,5578,6474,7301,827,1275,1723,146.92922045831816,1193,137.49356039171258,-0.4839464086937289,0.11047424578689621,0.6097895582486329,0.9350474704685262,862116,867677,El Paso,El Paso,48,141,Texas,TX
48145,48CS038,157,150,165,168,3,11,18,74.15612871654913,22,154.89321755456464,-1.3003548223963297,-0.8060011685348362,-0.23658667497392372,1.9076287737295472,195,186,204,245,41,50,59,291.75692284366346,38,220.13671648708146,0.19416730888570774,0.7081034240917637,1.2126406967533747,0.7398310222880216,17044,17262,Falls+Lee+Milam,Falls,48,145,Texas,TX
48287,48CS038,163,155,170,196,26,33,41,227.91937166835623,29,198.9594648676462,-0.27122218100187445,0.29704685225182775,0.8231198707410882,0.8474292040964838,200,191,210,209,-1,9,18,48.45462973669616,27,152.74949083503054,-1.5626200065462368,-1.0508462027225616,-0.5463878638393697,2.8228385425821414,17491,17676,Falls+Lee+Milam,Lee,48,287,Texas,TX
48331,48CS038,249,238,259,256,-3,7,18,34.84231883699014,19,92.0728506239147,-1.0687851525766974,-0.5766483968599863,-0.06161227924867105,2.3199015141203922,306,294,319,415,96,109,121,433.17141175339225,74,295.40918163672654,0.8489535613400288,1.3683027973601503,1.9069148889240934,0.6757408394760552,24763,25050,Falls+Lee+Milam,Milam,48,331,Texas,TX
48147,48CS039,395,380,411,427,16,32,47,106.19704183026727,65,217.9197049702456,-1.649640252801762,-1.126103383942121,-0.5773282500751752,1.989232276389134,492,473,511,597,86,105,124,288.37215782616425,103,282.6021346064148,-0.44298705910519076,0.057009968078627064,0.5781606789690973,0.970754829248099,35793,36447,Fannin+Lamar+Red River,Fannin,48,147,Texas,TX
48277,48CS039,535,514,557,675,118,140,161,334.8711274845531,97,232.63250459669038,0.4725853072848799,1.0486825268841031,1.5192582679616207,0.689752773583005,656,630,682,824,142,168,194,335.8653179771215,126,251.52210799480986,0.3350051596033697,0.8444095743754773,1.337608632797359,0.7444532426657791,50036,50095,Fannin+Lamar+Red River,Lamar,48,277,Texas,TX
48387,48CS039,156,151,161,213,52,57,62,584.9413306699884,28,288.90799656061904,2.415079138090736,2.9450081145166,3.4853255168288184,0.4853480027933881,190,184,196,231,35,41,47,356.3105353480809,29,250.99532629392417,0.5016772340439916,1.0417142782929603,1.5893539287215868,0.6877233443881531,11630,11554,Fannin+Lamar+Red River,Red River,48,387,Texas,TX
48157,48CS040,3118,2761,3476,3864,388,746,1103,107.88168579525427,429,62.06687018041349,-0.028834644165215303,0.4598088242975148,0.9794895523526849,0.5745529886305797,4031,3590,4472,4860,388,829,1270,97.01451376938918,640,74.92680002856584,-0.28062141843665195,0.23270088133664263,0.6983198276687237,0.7713947895240201,829428,854167,Fort Bend,Fort Bend,48,157,Texas,TX
48161,48CS041,187,179,196,245,49,58,66,354.3071987638693,31,190.53472649047328,1.1471026071974115,1.6141963466156957,2.2108313224546103,0.5285972723890892,232,222,242,256,14,24,34,120.3219730422375,46,233.1947683260671,-1.6020130957690597,-1.1237843995273342,-0.6225354501953092,1.8597345807708165,19524,19726,Freestone+Leon+Limestone+Navarro,Freestone,48,161,Texas,TX
48289,48CS041,172,165,179,217,38,45,52,338.34480326414024,22,165.0206275784473,1.1996693481921612,1.7221274546243415,2.2574575041119527,0.4771509608819063,211,202,219,274,55,63,72,397.9988754861518,38,238.61852433281007,1.0778328789685347,1.591980151719382,2.1054420614972367,0.5902333076782983,15998,15925,Freestone+Leon+Limestone+Navarro,Leon,48,289,Texas,TX
48293,48CS041,226,217,236,297,61,71,80,379.7613307885206,28,150.72671810514984,1.743320154627131,2.289725661479873,2.8500452487024157,0.3913511586840073,276,265,288,400,112,124,135,559.9272730594744,78,352.669891938328,1.5732710853309781,2.0601829992676053,2.5604052205163663,0.624804173042192,22292,22117,Freestone+Leon+Limestone+Navarro,Limestone,48,293,Texas,TX
48349,48CS041,512,490,535,527,-8,15,37,33.48232719014141,74,169.27505289845405,-1.87719167965993,-1.366056769027808,-0.8409765153797597,4.73234183144788,638,610,666,685,19,47,75,87.88048150930666,136,254.3339629345651,-2.1820769593482856,-1.6558038213208186,-1.1650556187229066,2.8337861559799125,52459,53473,Freestone+Leon+Limestone+Navarro,Navarro,48,349,Texas,TX
48163,48CS042,129,121,137,157,20,28,36,177.7308619560613,21,135.18588058580548,-0.08081605871468689,0.4385636059334949,0.9124305018109446,0.7340345309858526,159,150,169,222,53,63,72,341.54945693406006,57,309.34549006838165,-0.16929052100527678,0.32123762449833515,0.8316879544616249,0.891545758722798,18641,18426,Frio+Medina+Uvalde+Zavala,Frio,48,163,Texas,TX
48325,48CS042,386,364,408,447,39,61,83,142.7929392589585,57,133.77403140951674,-0.4390906685716936,0.07866402586435585,0.539735748593714,0.9216905590196917,483,456,510,587,77,104,131,200.70722714970046,120,231.5440126577394,-0.8219582243917598,-0.29667066610162923,0.22475911727611025,1.1426555181067322,51131,51826,Frio+Medina+Uvalde+Zavala,Medina,48,325,Texas,TX
48463,48CS042,202,192,213,281,68,79,89,379.5330181261288,40,192.86403085824492,1.343506687748481,1.8466756138898572,2.356641838229146,0.5017866870220583,248,236,261,350,89,102,114,410.9967385289636,72,291.48617464879965,0.687117212261281,1.2016687678100473,1.699077833150272,0.7022999047124289,24888,24701,Frio+Medina+Uvalde+Zavala,Uvalde,48,463,Texas,TX
48507,48CS042,79,78,80,140,60,61,62,735.8961911186101,27,325.497287522604,3.988328463474332,4.105725576248069,4.229323199016963,0.4351849336398511,93,92,94,151,57,58,59,604.8712382107364,26,272.22280389488014,3.205435321197745,3.3324893490027914,3.4507373523550093,0.4423931621710024,9954,9551,Frio+Medina+Uvalde+Zavala,Zavala,48,507,Texas,TX
48003,48CS043,117,116,119,128,9,11,12,68.141643081370745,32,206.1744966442953,-1.4918080024164782,-1.3819632098581893,-1.2524919647423367,2.7643039906484805,143,141,146,158,12,15,17,78.74750082266414,35,189.54779312212293,-1.228551124639794,-1.10481792026541,-0.9780584664900538,2.2521470322175507,18625,18465,Gaines and Nearby Counties,Andrews,48,3,Texas,TX
48115,48CS043,124,119,129,169,40,45,50,431.74908092292,52,498.56184084372006,-1.1755219722638623,-0.6735033464292657,-0.17516674029857202,1.1296629492330739,151,145,157,166,9,15,21,120.31468445697882,31,249.65772730933398,-1.8021420336025722,-1.29708421100164,-0.7664971760847414,1.9448571064705698,12516,12417,Gaines and Nearby Counties,Dawson,48,115,Texas,TX
48165,48CS043,112,110,114,147,33,35,37,192.83470063563936,33,182.50530002765234,-0.016122594543350785,0.102714946599638,0.21763541023556018,0.9200471297300252,140,137,142,176,34,36,39,166.23095359783647,40,182.92404079206108,-0.2825158813473019,-0.1718184813408912,-0.046977201792224386,1.070958421927131,21698,21867,Gaines and Nearby Counties,Gaines,48,165,Texas,TX
48305,48CS043,50,49,50,82,32,32,33,680.4976332706357,16,338.86339569361104,3.300547556296251,3.418399216350174,3.5309553209271205,0.4829338727643129,61,61,62,85,23,24,24,416.8465699056256,14,246.65257223396756,1.5900857593022062,1.6998913091911843,1.8218610506863995,0.567716141002702,5666,5676,Gaines and Nearby Counties,Lynn,48,305,Texas,TX
48317,48CS043,41,40,41,56,15,15,16,346.2493092338826,17,383.60285821737494,-0.494789369797236,-0.37504391249898816,-0.2620355519922467,1.0400979019855499,49,48,50,53,3,4,5,76.01795032042976,2,38.336208548974504,0.24612909651583634,0.3737725671513097,0.4976665680569108,0.40275026328301755,5318,5217,Gaines and Nearby Counties,Martin,48,317,Texas,TX
48445,48CS043,123,118,129,155,26,32,37,319.1831330963135,44,444.81887110362254,-1.7670423145186294,-1.2554130058839348,-0.7360042688870999,1.3508314479359016,150,144,156,148,-8,-2,4,-17.724731482903852,26,221.08843537414967,-2.8900302396174573,-2.406745903144213,-1.8992892218239423,-23.975764064455333,11870,11760,Gaines and Nearby Counties,Terry,48,445,Texas,TX
48501,48CS043,50,49,50,81,31,31,32,481.35252388756186,22,337.9848930994751,1.320848084315257,1.4353086298945614,1.5519643325614971,0.680439630091752,60,59,61,79,18,19,20,253.78898035779736,13,170.69327731092437,0.713242518836165,0.8362240602036518,0.9586931909214882,0.6394941111535503,7811,7616,Gaines and Nearby Counties,Yoakum,48,501,Texas,TX
48167,48CS044,2504,2353,2655,2863,208,359,510,123.08352844326866,220,75.3452610970156,-0.02312750491418953,0.47555617548445506,0.9739430547405938,0.6104488266913705,3110,2927,3293,3693,400,583,766,164.46884884658027,474,133.69587291558545,-0.20443693909011676,0.31769680640296516,0.841547853242444,0.8115031038217373,350387,354536,Galveston,Galveston,48,167,Texas,TX
48181,48CS045,1290,1232,1349,1533,184,243,301,213.5333591564664,192,168.94096598449906,-0.03969656974452173,0.44838765733851577,0.9802415606614014,0.787922192722489,1605,1534,1677,1971,294,366,437,263.44264222500004,339,244.14484487079767,-0.31865441224054525,0.18505812536674388,0.6961996725455015,0.9242210254516533,136379,138852,Grayson,Grayson,48,181,Texas,TX
48183,48CS046,1128,1074,1181,1404,223,276,330,267.16639015567756,175,169.12842485060324,0.5041836718878407,0.9776168478734801,1.484043591668948,0.630763564524077,1384,1320,1448,1828,380,444,508,357.30306248548686,325,261.6810389945007,0.43728306179589066,0.9535464454900716,1.491570338981567,0.7307316991969083,124166,124197,Gregg,Gregg,48,183,Texas,TX
48187,48CS047,1041,967,1116,1169,53,128,202,88.71847086766094,119,82.56864819858107,-0.4410093791267658,0.049644629996374555,0.5671069803464817,0.9234593569569542,1311,1220,1402,1617,215,306,397,173.46617671146137,249,141.05570850752864,-0.19518797416973419,0.332224368585781,0.8237224588338196,0.8105128316097832,172947,176526,Guadalupe,Guadalupe,48,187,Texas,TX
48199,48CS048,504,480,528,574,46,70,94,148.56003234280348,54,114.54632232062363,-0.20633254629326248,0.34563837075438736,0.8461359402300015,0.7601895677985342,623,594,653,806,153,183,212,321.42024730726774,162,284.8501899001266,-0.15346879196925278,0.3572508004206909,0.925965072025776,0.8814018190880724,56571,56872,Hardin,Hardin,48,199,Texas,TX
48201,48CS049,22991,20958,25025,28388,3363,5397,7430,136.94910857481275,3653,92.7032658043461,-0.05316744968526567,0.43800491548303805,0.9375025425223448,0.6767922158227888,28606,26165,31047,36243,5196,7637,10078,161.50573568142045,6096,128.91544174792082,-0.17754200594167377,0.3174766684674072,0.8334844426296709,0.798105177119285,4728636,4728681,Harris,Harris,48,201,Texas,TX
48203,48CS050,585,556,615,669,54,84,113,146.66630616091462,84,147.19196285155223,-0.5576768839718401,-0.02362358172615791,0.5130668913649229,0.9917353441400987,721,685,756,951,195,230,266,333.5819410656217,159,230.1146231330323,0.5003584188510749,1.050184941153483,1.5371923156951697,0.6868494482810165,68482,69096,Harrison+Upshur,Harrison,48,203,Texas,TX
48459,48CS050,403,385,421,474,53,71,89,207.33345132828978,49,142.83979108465928,0.1839435005486977,0.6551198888823412,1.1524987784958478,0.679385383120838,498,476,519,659,140,161,183,387.52294045909713,137,328.87629930143794,0.060477646476186656,0.5966958756423636,1.127338056417524,0.8434380115695541,41165,41657,Harrison+Upshur,Upshur,48,459,Texas,TX
48209,48CS051,1093,988,1198,1140,-58,47,152,23.200972147401693,102,50.35772912972463,-0.8153766985315614,-0.26892202819186706,0.2099718019282142,2.12527617848835,1415,1284,1546,1649,103,234,365,92.20068722650795,238,93.80900014583753,-0.5401868419451836,-0.006524575580052272,0.5358867895629561,1.013112581881109,243061,253707,Hays,Hays,48,209,Texas,TX
48213,48CS052,953,917,988,1130,142,177,213,257.39614982246263,99,143.90406395736176,0.6044760839841093,1.1520507554642863,1.6617492573751993,0.5559367052669001,1175,1132,1218,1570,352,395,438,473.0962291115283,288,345.0134770889488,0.7740111973666803,1.2729965319882242,1.792300789337381,0.727425050719716,82555,83475,Henderson,Henderson,48,213,Texas,TX
48215,48CS053,3904,3529,4280,6443,2163,2539,2914,349.2179076978666,2012,276.77725987761454,0.2073110499074765,0.7408846721607272,1.2681646681058232,0.7922511106705173,4917,4464,5371,6410,1039,1493,1946,169.7649538081507,1202,136.72032730982852,-0.15591182645760013,0.3249242916678804,0.8537903103047808,0.8048114863578171,872326,879167,Hidalgo,Hidalgo,48,215,Texas,TX
48221,48CS054,651,624,678,767,89,116,143,223.97362987540586,74,142.85254657186061,0.29229930013718064,0.817746941597186,1.3179119782701492,0.6323593318411557,814,781,847,991,144,177,210,276.4143319117523,128,200.34120611666745,0.2594206338038266,0.752999428587036,1.2474262012731028,0.7207049723360981,62162,63891,Hood,Hood,48,221,Texas,TX
48063,48CS055,136,131,142,173,31,37,42,349.2820118515916,23,219.7627199617804,0.7935875320526005,1.2955884928592374,1.8255003057403223,0.6124306395801876,168,162,175,232,57,64,70,507.41683865141067,41,325.6035578144854,1.3162334404684715,1.8247199728901682,2.3857593349000497,0.6318002478743096,12559,12592,Hopkins and Nearby Counties,Camp,48,63,Texas,TX
48119,48CS055,59,59,60,79,19,20,20,449.0992000547884,1,22.800684020520617,4.136694706649085,4.264440204560881,4.3923436365859665,0.048316782414979206,74,73,75,91,16,17,18,315.68401645140904,17,316.6325200223505,-0.13338064479790768,-0.015096927616511088,0.1244601960622199,0.9471240244100001,5263,5369,Hopkins and Nearby Counties,Delta,48,119,Texas,TX
48159,48CS055,100,99,102,137,35,37,38,419.9583758522204,14,161.0429447852761,2.4632606744935583,2.589905038844323,2.7085256806559044,0.3732499097480989,123,122,125,128,3,5,6,44.432002105729296,23,220.09569377990428,-1.8866167873733817,-1.7501192997400354,-1.6305752656930075,4.075742015999985,10432,10450,Hopkins and Nearby Counties,Franklin,48,159,Texas,TX
48223,48CS055,357,341,373,448,75,91,107,296.816913778527,87,283.103289313122,-0.3889731679641948,0.12331277470842167,0.6463322957370151,0.9434544267864413,442,423,461,524,63,82,101,221.5368508627517,67,180.349932705249,-0.12395109719571452,0.4178805534253022,0.9021967898882436,0.8043126514920274,36877,37150,Hopkins and Nearby Counties,Hopkins,48,223,Texas,TX
48449,48CS055,250,236,263,288,25,38,52,145.4709134630968,57,217.3429506529821,-1.2514195599196867,-0.7257875497083843,-0.25315094787374726,1.4559030225505332,307,291,323,358,35,51,67,164.35233032092137,60,192.3385157877865,-0.8495704711702504,-0.27046889219873,0.20112982135113036,1.1478923575178472,31471,31195,Hopkins and Nearby Counties,Titus,48,449,Texas,TX
48499,48CS055,550,531,570,644,74,94,113,248.8941343174569,77,204.4745402642236,-0.019236436315014455,0.4460894270346458,0.9967817912991145,0.8128595767485943,681,658,705,912,207,231,254,503.96800598438716,155,338.8052197862248,1.118684752186791,1.651576997742979,2.176937193200197,0.6693720148305032,45189,45749,Hopkins and Nearby Counties,Wood,48,499,Texas,TX
48231,48CS056,863,819,906,981,75,118,162,141.66963029449278,97,116.03217799575346,-0.2524169877514316,0.2744770169339292,0.762634052181492,0.8121758102861736,1080,1027,1133,1303,170,223,276,216.56754859133508,244,237.04739976489563,-0.744652648383383,-0.2108862333475805,0.3504644764241413,1.089677439745592,100317,102933,Hunt,Hunt,48,231,Texas,TX
48237,48CS057,81,80,81,97,16,16,17,229.75549941042817,12,167.8126092530008,0.49331467893634023,0.618929233912367,0.7405403556401342,0.6884905614668525,100,99,101,108,7,8,9,93.48829277814866,10,115.2073732718894,-0.33999408215752985,-0.21650368282176288,-0.101696285523841,1.0971187254688624,8581,8680,Jack+Palo Pinto+Young,Jack,48,237,Texas,TX
48363,48CS057,283,270,295,389,94,106,119,446.7926165995693,49,205.9256146249212,1.916638503617665,2.406557252912591,2.9076932603036685,0.45660269484551524,346,331,361,457,96,111,126,387.8295277905217,83,289.7235409103602,0.48893153501362646,0.9706223958732165,1.4719361945400191,0.7403746624959486,28554,28648,Jack+Palo Pinto+Young,Palo Pinto,48,363,Texas,TX
48503,48CS057,212,204,220,272,52,60,68,403.8858560115919,30,201.47750167897917,1.5269565434070995,2.0252130590577555,2.543936964966554,0.4906883385751773,259,249,268,323,55,64,74,357.7433666977654,39,217.18549869131814,0.8752609569686446,1.401563411509407,1.9158768747928028,0.5977929818067268,17868,17957,Jack+Palo Pinto+Young,Young,48,503,Texas,TX
48239,48CS058,147,141,153,158,5,11,17,87.9069753871749,23,184.270263052477,-1.4992984247310635,-0.9614041592730854,-0.4481084061593823,1.9211083260171045,181,173,189,171,-18,-10,-2,-65.92853125549286,28,185.3936304045554,-3.008447484702974,-2.5280714859634696,-1.982310807219129,-3.1259817272896835,14978,15103,Jackson+Matagorda+Wharton,Jackson,48,239,Texas,TX
48321,48CS058,340,325,356,408,52,68,83,223.64083438156555,67,221.28643382049373,-0.4992149895107048,0.018099676108093214,0.4886649291415552,0.9750722966753093,416,398,435,468,33,52,70,141.9782403541878,95,261.4702887182451,-1.7224296168251947,-1.1891821472556297,-0.6996716203329495,1.806600418008452,36333,36333,Jackson+Matagorda+Wharton,Matagorda,48,321,Texas,TX
48481,48CS058,367,349,385,465,80,98,116,282.47701787202357,77,222.19550318624505,0.037936780651302675,0.5976646732327048,1.1576892769158171,0.7786424911865654,451,429,472,569,97,118,140,283.68019145214487,116,278.20414428242515,-0.4631392567600278,0.07190366202702611,0.5884681754577415,0.9724748323461456,41585,41696,Jackson+Matagorda+Wharton,Wharton,48,481,Texas,TX
48241,48CS059,348,333,362,447,85,99,114,357.84675820851135,53,190.97378614539232,1.1859426827746389,1.6598058273977643,2.1975552436338437,0.5283545898315787,422,405,440,606,166,184,201,556.7005781873237,122,370.10071593253247,1.3340553435431526,1.8606695242474962,2.3589018594363957,0.6612079843241518,33303,32964,Jasper+Newton,Jasper,48,241,Texas,TX
48351,48CS059,128,123,133,174,41,46,51,447.07607353350977,19,184.00451940924862,2.1261083414755966,2.6339078823313176,3.1459262132408377,0.4028468104782454,155,149,162,232,70,77,83,627.3215351748183,45,367.9476696647588,2.091500760806289,2.5931706183354013,3.1057207272967142,0.5789909374750914,12391,12230,Jasper+Newton,Newton,48,351,Texas,TX
48245,48CS060,2130,2021,2240,2570,330,440,549,206.82983624644024,271,127.49841215077119,0.2852006157753,0.7947555279231796,1.2893061967306383,0.615042071544312,2598,2467,2729,3184,455,586,717,230.64780973222327,474,186.5877277236297,-0.10928696014126245,0.4306110237611026,0.9949921827949839,0.8075941520700823,255062,254036,Jefferson,Jefferson,48,245,Texas,TX
48251,48CS061,1325,1247,1403,1556,153,231,309,153.4575096965302,175,116.19928731103782,-0.1354066291910319,0.3751906224043454,0.8580029226001846,0.7539459651692285,1677,1581,1773,2034,261,357,453,191.65291402561206,388,208.23829330470952,-0.6957335358669419,-0.1553108431120055,0.33236883396754097,1.0835044235322409,180724,186325,Johnson,Johnson,48,251,Texas,TX
48257,48CS062,999,936,1062,1078,16,79,142,64.66644168606312,132,108.06827950386835,-0.9696485634179252,-0.4389531292533019,0.10415851659135816,1.650271775060047,1305,1224,1385,1469,84,164,245,105.20276727538685,261,167.09774898204822,-1.1588652300759714,-0.616706927759394,-0.08615731578048484,1.5787323401723825,146574,156196,Kaufman,Kaufman,48,257,Texas,TX
48261,48CS063,3,3,4,5,1,2,2,558.5021811265052,5,1709.4017094017092,-12.006484710587447,-11.513291196240413,-10.985175523928444,1.8985283096045946,4,4,4,5,1,1,1,278.33161943535816,5,1466.275659824047,-12.38370558858589,-11.875707777480565,-11.34795148421549,2.565272298968155,351,341,Kenedy+Kleberg+Willacy,Kenedy,48,261,Texas,TX
48273,48CS063,243,230,257,295,38,52,65,200.47192864572156,62,241.10441376628424,-0.9291525964481433,-0.42771074958646615,0.14307118753465745,1.1797982808972467,299,283,315,335,20,36,52,116.33621432811938,69,224.88755622188904,-1.6026330993203874,-1.0795273301532857,-0.542026719552609,1.8804022074940618,30858,30682,Kenedy+Kleberg+Willacy,Kleberg,48,273,Texas,TX
48489,48CS063,149,140,158,222,64,73,82,430.64228072029516,64,378.0271707028943,0.021512831186697237,0.5495999707119281,0.9872551156008227,0.8659445089624821,185,175,196,228,32,43,53,211.08588211742344,46,226.72384050470697,-0.6482872466956837,-0.1488394407897932,0.3847699619948074,1.0495761685038827,20316,20289,Kenedy+Kleberg+Willacy,Willacy,48,489,Texas,TX
48089,48CS064,212,203,221,260,39,48,57,277.9559937800229,16,92.73570324574962,1.3238008747082624,1.841781187519817,2.382174601511134,0.3268195866112972,258,247,269,343,74,85,96,411.9040245255173,41,198.82643906697058,1.6075278481753892,2.1360583371676296,2.6167336644703036,0.4770840868375599,20704,20621,Lavaca and Nearby Counties,Colorado,48,89,Texas,TX
48123,48CS064,220,211,228,259,31,39,48,237.0219328202137,50,302.05396697543296,-1.1517878230561411,-0.6517313565279379,-0.11561533062806292,1.2426981970294444,268,258,279,289,10,21,31,104.12770717342308,38,190.93558436338054,-1.3854115272010827,-0.8587016394144228,-0.369439136801163,1.7492580157131856,19864,19902,Lavaca and Nearby Counties,DeWitt,48,123,Texas,TX
48149,48CS064,260,249,271,323,52,63,74,307.1429003108848,39,190.23616926141216,0.6602248173750438,1.1684374052147732,1.6854131612044219,0.609690761818735,318,305,331,391,60,73,86,295.9684699569303,52,210.9276761448911,0.36127213932643654,0.8622539548215633,1.3891835936845265,0.7030342032949484,24601,24653,Lavaca and Nearby Counties,Fayette,48,149,Texas,TX
48177,48CS064,170,162,179,222,43,52,60,312.1311713388532,24,145.21252458024506,1.1365083721437634,1.668926324371676,2.1650228411280557,0.45638239938156405,207,197,217,272,55,65,75,330.4012785690291,63,320.72494018225325,-0.44706358207435437,0.07681821064969675,0.603600080866103,0.9559834397758871,19833,19643,Lavaca and Nearby Counties,Gonzales,48,177,Texas,TX
48285,48CS064,221,212,230,274,44,53,62,311.3665461363248,48,283.28333251364774,-0.2552630001243259,0.2902870859879893,0.8121397413637687,0.8928826119087568,272,261,282,296,14,24,35,118.95274195844658,38,185.23934873744759,-1.1653455945321256,-0.6763042037107608,-0.13325157853566036,1.495947233764531,20333,20514,Lavaca and Nearby Counties,Lavaca,48,285,Texas,TX
48303,48CS065,2220,2086,2354,3014,660,794,928,305.5701430799529,616,237.16175894971218,0.14470801352134474,0.684991239401139,1.176705529209225,0.7751520512088207,2756,2594,2918,3349,431,593,755,188.8545317855167,519,165.28188682489994,-0.31271189596430093,0.2346997828695928,0.7637829325496203,0.8737076225007833,311686,314009,Lubbock,Lubbock,48,303,Texas,TX
48309,48CS066,1922,1809,2034,2338,304,416,529,191.68741309591476,304,139.94920703122003,0.0022439353224759204,0.5192514399861717,1.0372909833469315,0.7283415536620452,2382,2246,2518,2940,422,558,694,212.3154976575898,462,175.79239754956052,-0.14338281036915115,0.3833081979568597,0.9032113385779253,0.8264960177220237,260666,262810,McLennan,McLennan,48,309,Texas,TX
48313,48CS067,129,123,135,140,5,11,17,99.38866459116949,21,185.1579720793534,-1.3801584506546483,-0.8598699845057121,-0.29053847495115204,1.711166356862252,159,152,166,177,11,18,25,131.18166379941187,30,219.33031144904226,-1.3991697361147164,-0.8714026871156108,-0.40062048832873215,1.5836961250551018,13610,13678,Madison+Trinity+Walker,Madison,48,313,Texas,TX
48455,48CS067,194,188,200,216,16,22,28,191.1896464711305,12,104.36295115234091,0.35343830990109687,0.8620608007956266,1.3782107351630812,0.5221108994991331,237,230,244,326,82,89,96,644.3976357781459,48,347.9017177647314,2.4453591270426247,2.9713829409934904,3.4463632969783062,0.5338817971726931,13798,13797,Madison+Trinity+Walker,Trinity,48,455,Texas,TX
48471,48CS067,490,458,523,579,56,89,121,139.9830735397464,93,146.86916010844104,-0.5740898571094522,-0.06596400900565914,0.45156937280549486,1.03748771985787,618,578,658,712,54,94,134,120.77283738381784,105,135.01697356239072,-0.6644462521513825,-0.12275122302819136,0.3741110481063679,1.106164155652245,75986,77768,Madison+Trinity+Walker,Walker,48,471,Texas,TX
48031,48CS068,111,109,112,111,-1,0,2,4.059536467585377,7,72.57646448937273,-0.8087185307645837,-0.689006037386792,-0.5714143496430958,5.030389689728437,139,138,141,157,16,18,19,150.30679476413218,22,186.0779835913051,-0.49161720514632806,-0.3567404203012188,-0.23179417752602774,1.172034884643579,11574,11823,Menard and Nearby Counties,Blanco,48,31,Texas,TX
48081,48CS068,45,44,46,55,9,10,11,363.1684273560288,10,364.0776699029126,-0.5049353155612785,-0.02524592654016407,0.5097064289697008,0.9111595611908745,55,53,57,69,12,14,16,415.8742733069305,7,211.09770808202654,1.5069887837151787,2.0366306448142377,2.522322926751155,0.47328025648378585,3296,3316,Menard and Nearby Counties,Coke,48,81,Texas,TX
48095,48CS068,29,29,29,28,-1,-1,-1,-32.48643320092363,4,148.23965410747377,-1.9388963778314214,-1.8094742892961,-1.6887457482289379,32.412876746517945,37,36,37,34,-3,-3,-2,-81.28047623247095,7,209.7064110245656,-3.0385216507991357,-2.908656434522196,-2.780948994058779,-4.0860587084503415,3238,3338,Menard and Nearby Counties,Concho,48,95,Texas,TX
48137,48CS068,20,19,21,28,7,8,9,648.6344115502905,8,644.2953020134227,-0.4230674789982579,0.05159211082137388,0.5489892281423805,0.8835993415267711,24,23,25,31,6,7,8,496.3974356391828,0,0,4.465798858633301,4.978479302522764,5.484718310649112,0,1490,1434,Menard and Nearby Counties,Edwards,48,137,Texas,TX
48171,48CS068,306,295,318,329,11,23,34,100.68154039481428,25,111.86099407136732,-0.6586825516571861,-0.11596215950652751,0.3990920949081721,1.0637625544799731,380,366,394,417,23,37,51,136.11971134148547,58,213.1177659379019,-1.2797537343605314,-0.7639593971096241,-0.25187213669918096,1.5245112719551843,26819,27215,Menard and Nearby Counties,Gillespie,48,171,Texas,TX
48173,48CS068,12,12,12,6,-6,-6,-6,-610.4750534289585,6,618.5567010309279,-12.41032228646651,-12.290050600927959,-12.16797963332286,-1.2191137485427301,14,14,15,12,-3,-2,-2,-212.23163662289832,2,174.82517482517483,-4.005757151965335,-3.873939133308111,-3.760589611602663,-1.4006289579293885,1164,1144,Menard and Nearby Counties,Glasscock,48,173,Texas,TX
48235,48CS068,12,11,12,14,2,2,3,184.1776922990634,2,156.76028739386024,0.15678110539219825,0.27456909451344685,0.3941482281822339,0.59705050050859,15,14,15,24,9,9,10,610.0312109818263,5,322.99741602067184,2.740889842228117,2.871954121270081,2.987743898859567,0.47877663854357355,1531,1548,Menard and Nearby Counties,Irion,48,235,Texas,TX
48267,48CS068,50,49,50,51,1,1,2,38.02461646351298,4,111.42061281337047,-0.8665494448308636,-0.7363705642119984,-0.6152557095186836,1.6912720456797026,62,61,62,63,1,1,2,30.177394905732353,1,22.967386311437757,-0.057829537795502955,0.07571541526361117,0.20152376764691077,0.4321663535989384,4308,4354,Menard and Nearby Counties,Kimble,48,267,Texas,TX
48307,48CS068,87,87,88,109,21,22,22,341.42977596324806,12,188.77818563188254,1.4048567608867273,1.527389713384978,1.6474118642701223,0.5285516380420019,106,105,107,166,59,60,61,794.9777631728023,28,371.45131334571505,4.10603949335741,4.236127754514382,4.368071410802768,0.459578255827096,7628,7538,Menard and Nearby Counties,McCulloch,48,307,Texas,TX
48319,48CS068,41,41,42,39,-3,-2,-2,-65.8677803863265,6,179.5959092042903,-2.5787154165925004,-2.451451142979301,-2.329605004222613,-4.997781138967722,50,49,50,67,17,17,18,432.6016178721315,6,152.05271160669034,2.6793981483834375,2.806529265146202,2.9361337339887243,0.3320336091452871,4009,3946,Menard and Nearby Counties,Mason,48,319,Texas,TX
48327,48CS068,27,26,28,33,5,6,7,355.36353518648934,6,361.6273229532898,-0.5568423288024674,-0.055589749737624566,0.4471325890668537,0.8700603547043992,33,32,34,38,4,5,6,253.9783352661631,6,303.030303030303,-1.0290562811360862,-0.49137592047210615,0.03833713797445902,0.9952277109070167,1991,1980,Menard and Nearby Counties,Menard,48,327,Texas,TX
48383,48CS068,23,22,23,28,5,5,6,191.08425647389657,7,244.82658117167009,-0.6537758135004268,-0.5348284884708809,-0.4173152742512172,1.0830184101129101,27,26,27,32,5,5,6,164.1415760189402,5,152.85845307245492,-0.02235107866528992,0.10894808004300653,0.24204092316517486,0.7850438530222366,3431,3271,Menard and Nearby Counties,Reagan,48,383,Texas,TX
48385,48CS068,36,35,36,64,28,28,29,1187.2911757570719,12,504.2016806722689,6.715189832160998,6.832178211509351,6.949696421159228,0.41015082294934163,43,43,44,63,19,20,20,701.5036204551735,11,390.9026297085999,2.9807677871601257,3.1101955978043874,3.2306978894701657,0.5303681094022004,2856,2814,Menard and Nearby Counties,Real,48,385,Texas,TX
48399,48CS068,127,123,132,137,5,10,14,115.76038824347671,20,240.64975433670915,-1.7916887174215799,-1.2549387700807553,-0.752356821242582,1.8831233942293166,155,150,160,190,30,35,40,350.803416521881,36,362.1730382293763,-0.6167135395368352,-0.1176709018075085,0.4199816282735783,1.0036281267662608,9973,9940,Menard and Nearby Counties,Runnels,48,399,Texas,TX
48411,48CS068,58,57,59,83,24,25,26,517.5194135858363,15,311.3648157758173,1.9514070051457053,2.062114515095064,2.177273095091963,0.5784471126543616,72,71,73,90,17,18,19,311.22106317668204,14,240.8394976776191,0.5710512463645908,0.7040594054716518,0.8327715624014259,0.7333190705320974,5781,5813,Menard and Nearby Counties,San Saba,48,411,Texas,TX
48413,48CS068,21,21,21,25,4,4,4,193.53103649953687,8,385.07821901323706,-2.0360306832967794,-1.9187118913148449,-1.793212319313471,1.5934327360448155,25,25,26,33,7,8,8,318.67778712704785,2,82.27067050596463,2.233757985360019,2.3586200518954583,2.4964288272202655,0.22864833267273493,2493,2431,Menard and Nearby Counties,Schleicher,48,413,Texas,TX
48431,48CS068,13,13,13,13,0,0,0,18.729695959850435,7,613.1386861313869,-6.053991284792628,-5.941468265816726,-5.820891056713011,5.7668668503036296,16,16,16,16,-0,0,0,7.854579682984977,3,217.23388848660392,-2.2147023220727626,-2.095599275685021,-1.9628692347004453,2.7064289300922377,1370,1381,Menard and Nearby Counties,Sterling,48,431,Texas,TX
48435,48CS068,25,25,25,38,13,13,13,459.8751293849032,3,105.32475131655937,3.4241649144068447,3.543595006676901,3.671370375799745,0.21278441986084726,30,30,30,47,17,17,17,512.1584804009996,4,120.30075187969925,3.7896376396195675,3.91433112207867,4.053618596497551,0.22186145733282908,3418,3325,Menard and Nearby Counties,Sutton,48,435,Texas,TX
48329,48CS069,967,894,1041,1106,65,139,212,97.41614253277918,200,140.4379322855103,-0.9367459302072899,-0.4270151527668899,0.10617274675955127,1.4313118572739285,1182,1095,1269,1403,134,221,308,131.50306009321994,233,138.44572392853112,-0.579165723315631,-0.05631211746297723,0.4630315078789992,1.04805911014135,170894,168297,Midland,Midland,48,329,Texas,TX
48339,48CS070,3578,3308,3847,4026,179,448,718,86.06556816934008,290,55.68873199317653,-0.21480040098006953,0.3174455402372014,0.8200413348210498,0.6456095822726765,4558,4224,4891,5408,517,850,1184,131.7726350077477,850,131.70249491008593,-0.5356679227923168,0.005566688049177428,0.535535678898493,0.9982938805455001,624902,645394,Montgomery,Montgomery,48,339,Texas,TX
48347,48CS071,492,465,520,635,115,143,170,264.71975638691174,103,191.1507709438456,0.19758603927617574,0.731005383614735,1.2292352532743602,0.7170602964014325,606,573,640,792,152,186,219,287.39287470713316,128,197.95242955677213,0.41822812663943165,0.8810552399723184,1.426510766673096,0.6851002133519499,64661,64662,Nacogdoches,Nacogdoches,48,347,Texas,TX
48087,48CS072,30,29,31,43,12,13,14,587.2414887460654,4,179.4392523364486,3.574414310235726,4.072103221753714,4.572084068545153,0.28387736556925697,36,35,37,42,5,6,7,225.9993513491761,8,305.57677616501144,-1.3226697531386626,-0.800503682262604,-0.27699264610621877,1.1566271161120525,2675,2618,Northeast Panhandle,Collingsworth,48,87,Texas,TX
48179,48CS072,218,209,227,245,18,27,36,151.81062301548184,41,231.40962325384504,-1.311141980175753,-0.777912051716463,-0.2826175619456124,1.4696895985038223,265,255,276,349,73,84,94,396.8809327211845,63,299.25897776933306,0.45722542790673876,0.9718881437756656,1.4947801761549355,0.7451091218510447,21261,21052,Northeast Panhandle,Gray,48,179,Texas,TX
48195,48CS072,41,41,42,50,8,9,9,200.92678566887,19,433.2129963898917,-2.446257651835063,-2.3284826549938904,-2.2060403724246855,1.936342448208697,50,49,50,62,12,12,13,237.0489103347919,10,193.31142470520007,0.3145932512301196,0.43627548705504005,0.5606354946912875,0.7540033734683547,5263,5173,Northeast Panhandle,Hansford,48,195,Texas,TX
48211,48CS072,26,26,27,20,-7,-6,-6,-219.77085115906704,4,140.14598540145985,-3.711868607932109,-3.595666697105637,-3.480436561123118,-0.7586352064649002,31,31,31,24,-7,-7,-7,-211.99838789890052,6,182.64840182648402,-4.076155239036721,-3.9484791597137305,-3.824643447941372,-1.0060114140824765,3425,3285,Northeast Panhandle,Hemphill,48,211,Texas,TX
48295,48CS072,22,22,22,34,12,12,12,466.0541716679742,2,78.53403141361257,3.7477051523715046,3.8763591138384808,3.9991073335193676,0.1554140878628277,26,26,27,40,13,14,14,466.63067493655456,2,67.86562606040042,3.864300003758085,3.986388237832544,4.112828007970597,0.13557845846101294,3056,2947,Northeast Panhandle,Lipscomb,48,295,Texas,TX
48357,48CS072,63,62,64,93,29,30,31,362.3225411588258,20,241.93548387096772,1.0740624238757794,1.1999989596583418,1.3313145006833214,0.6461618670588001,77,76,78,90,12,13,14,134.95233323724028,24,244.69820554649263,-1.2297555799785833,-1.0938092722019508,-0.9732729700311757,1.6858520322873765,9920,9808,Northeast Panhandle,Ochiltree,48,357,Texas,TX
48393,48CS072,9,9,10,12,2,3,3,402.71851434537615,1,145.98540145985402,2.092155049270269,2.570856923016468,3.072663947702488,0.26605496562862785,11,11,11,1,-10,-10,-10,-1253.2832782964865,1,124.84394506866417,-14.296000536460541,-13.777876418155744,-13.241576717557733,-0.11063416649219122,822,801,Northeast Panhandle,Roberts,48,393,Texas,TX
48483,48CS072,52,51,52,62,10,10,11,242.42285699754905,11,265.0070267014656,-0.3445894900233371,-0.22579098800536684,-0.10680873576016581,0.9943441024183424,63,62,64,92,28,29,30,586.4380585355648,5,101.31712259371835,4.732195563429417,4.851539145617882,4.974761280411392,0.16699666215361633,4981,4935,Northeast Panhandle,Wheeler,48,483,Texas,TX
48065,48CS073,49,49,50,80,30,31,31,633.2327312231457,12,247.84853700516348,3.732496166042135,3.852103641749828,3.976927517625507,0.3790389194461691,60,59,60,85,25,25,26,439.1721417771871,13,225.89052997393568,2.008766645921603,2.1354262344326274,2.259466194890236,0.4947790014082791,5810,5755,Northwest Panhandle,Carson,48,65,Texas,TX
48111,48CS073,37,36,38,68,30,31,32,517.8284068775463,14,235.22822738728647,2.7121841358001735,2.8215568716877875,2.943172403510103,0.4399828689410565,46,45,47,79,32,33,34,464.6836995317126,2,27.917364600781685,4.229779920077926,4.370622697266938,4.49415108607659,0.058326144237211414,7142,7164,Northwest Panhandle,Dallam,48,111,Texas,TX
48205,48CS073,37,36,37,48,11,11,12,256.0421942882616,11,245.0343419342862,-0.014461105874350672,0.10956082167354814,0.22927660280490972,0.8804112690805491,45,44,45,46,1,1,2,23.969875959712,4,74.1839762611276,-0.6270948058259559,-0.5027161266688717,-0.37755469364869076,1.7448537738382608,5387,5392,Northwest Panhandle,Hartley,48,205,Texas,TX
48233,48CS073,209,200,218,274,56,65,74,379.1554497423703,56,326.4195851751105,-0.009890981033904964,0.5351928612234854,1.0264608694420114,0.8478774980053193,255,244,265,348,83,93,104,454.44993640035653,64,312.1798936637237,0.927750878526168,1.4155287810921533,1.953142107076485,0.6796451891711844,20587,20501,Northwest Panhandle,Hutchinson,48,233,Texas,TX
48341,48CS073,145,136,154,175,21,30,39,171.1014722045444,63,356.48606592162963,-2.384141190574429,-1.8384317217342407,-1.3422936269171932,2.0167804020279325,178,167,189,190,1,12,23,56.53808270912221,35,165.555082541034,-1.6392656241054475,-1.0877962218263608,-0.5953818610174264,2.7021359707812707,21207,21141,Northwest Panhandle,Moore,48,341,Texas,TX
48359,48CS073,12,12,12,17,5,5,5,325.6037845436723,2,132.7433628318584,1.8055170480867346,1.9267668189526423,2.046084076715328,0.3386522228040146,14,14,14,19,5,5,5,284.04499934196645,1,58.03830528148578,2.1292330449968593,2.2643504231797387,2.38878014249665,0.16966132078667615,1808,1723,Northwest Panhandle,Oldham,48,359,Texas,TX
48421,48CS073,21,20,21,27,6,6,7,267.5951030831976,12,511.3636363636363,-2.556165252941011,-2.4380340781214485,-2.315951360808718,1.6484501283732462,25,25,26,33,7,8,8,280.84452586815496,7,250.44722719141325,0.18071283337705846,0.3003910958200234,0.4312552179166997,0.79099580117622,2816,2795,Northwest Panhandle,Sherman,48,421,Texas,TX
48355,48CS074,2465,2313,2617,3260,643,795,947,269.20270985335287,510,172.66722905775043,0.40800316535697645,0.9592995374838137,1.4983861089086368,0.6405966221999271,3029,2846,3211,4057,846,1028,1211,291.24822204606255,621,175.88032207906966,0.5833213373940435,1.1633543371879078,1.6730106967631908,0.60329795017175,354439,353081,Nueces,Nueces,48,355,Texas,TX
48361,48CS075,840,804,877,977,100,137,173,194.14998407809992,75,106.54670297146916,0.3537956065268601,0.879638760381028,1.398792954989712,0.5447991634496251,1029,985,1073,1237,164,208,252,245.51316527486196,234,276.15181268882174,-0.7950648492841831,-0.29793091968740826,0.2003512175540961,1.119413503795339,84470,84736,Orange,Orange,48,361,Texas,TX
48365,48CS076,227,218,237,333,96,106,115,561.0503813457985,45,238.76901308807925,2.7117542513288915,3.221217489527957,3.7111481201269054,0.42158794391388416,278,267,290,369,79,91,102,400.38673545453196,74,326.69639309522756,0.21759022874806205,0.7323086798209564,1.2455125519256438,0.8070532136602472,22616,22651,Panola+Sabine+San Augustine+Shelby,Panola,48,365,Texas,TX
48403,48CS076,142,138,146,156,10,14,18,166.37596475392286,16,192.2691768475866,-0.7663303804493975,-0.254635797743728,0.2501847411522283,1.0777855914041627,174,169,179,258,79,84,89,840.8490310605965,52,519.1693290734825,2.7233617483098422,3.2113984882162354,3.732242595114606,0.6101894196919246,9986,10016,Panola+Sabine+San Augustine+Shelby,Sabine,48,403,Texas,TX
48405,48CS076,104,103,105,149,44,45,46,676.913566046523,28,421.9515258068567,2.420036561223843,2.547769729718725,2.6659429168479045,0.6097712880158477,127,126,128,190,62,63,64,799.6957237613522,13,164.09997475385003,6.230062588784914,6.358852029420124,6.472773974739925,0.20201425229589617,7963,7922,Panola+Sabine+San Augustine+Shelby,San Augustine,48,405,Texas,TX
48419,48CS076,237,227,247,295,48,58,68,287.85599549486136,44,218.84196128818334,0.21734504028236312,0.6832075290773916,1.2323077191938756,0.7473353245946831,288,276,301,386,85,98,110,407.9887068489359,75,313.3224714876551,0.455706481334416,0.9596338933933429,1.4758862915914992,0.760184520740078,24127,23937,Panola+Sabine+San Augustine+Shelby,Shelby,48,419,Texas,TX
48367,48CS077,1100,1036,1165,1222,57,122,186,97.93845268056977,109,87.62116573664078,-0.38729422505132227,0.10694728968622257,0.6612215412316468,0.8873719876722004,1406,1325,1486,1615,129,209,290,134.3109191263747,287,184.3347570570667,-1.0194227457163059,-0.49613014700054,0.02499854876653911,1.3659161573097636,149279,155695,Parker,Parker,48,367,Texas,TX
48373,48CS078,580,558,602,719,117,139,161,328.4379120869926,66,156.03144269981675,1.2159986249093289,1.721601045833864,2.2105379934452225,0.4716762020067104,719,692,745,963,218,244,271,472.5923226863479,163,315.3048591767255,1.1021224657961775,1.5529684834339417,2.0614193930132076,0.6644617755855878,50759,51696,Polk+San Jacinto+Tyler,Polk,48,373,Texas,TX
48407,48CS078,268,256,280,323,43,55,67,238.70478031408172,24,103.87362042847867,0.8568437147774889,1.3570414461177294,1.8347632544666597,0.42740568345029073,329,314,343,484,141,155,170,558.7557144550898,79,283.9683680805176,2.292319233042381,2.7395297536910395,3.236281982085762,0.5049670871432703,27726,27820,Polk+San Jacinto+Tyler,San Jacinto,48,407,Texas,TX
48457,48CS078,218,209,226,272,46,54,63,324.56946361924463,17,101.60374539296743,1.7162055438978316,2.2232697405705832,2.7018055851073277,0.307381417094571,266,255,276,410,134,144,155,720.2026869824005,60,299.4609702535436,3.675123758748656,4.195015493826571,4.69963564224376,0.4129392863609062,20078,20036,Polk+San Jacinto+Tyler,Tyler,48,457,Texas,TX
48375,48CS079,1049,998,1099,1402,303,353,404,360.0460088083502,299,304.5685279187817,0.05401838825096455,0.5511416508186444,1.070412967567432,0.8435291091389975,1278,1218,1338,1581,243,303,363,259.52276607887484,269,230.33977257158514,-0.21903575942430745,0.3094255920709007,0.7878556278865673,0.8846325176776494,117806,116784,Potter,Potter,48,375,Texas,TX
48379,48CS080,147,142,152,170,18,23,28,226.2500956764441,20,195.74259848299485,-0.17487626747495508,0.3120185800923559,0.8082512363356548,0.8292869821060226,181,175,188,205,17,24,30,189.51352344307503,32,256.73940949935815,-1.1516691982831073,-0.6508080770614441,-0.15203382651692457,1.2997053230706945,12261,12464,Rains+Van Zandt,Rains,48,379,Texas,TX
48467,48CS080,590,564,615,698,83,108,134,218.41339798958793,71,143.37400084139674,0.22359565441939988,0.737484455865899,1.2363403647105613,0.6504205966090528,735,703,766,986,220,251,283,411.4093281320246,174,285.04029880086495,0.7665234827243481,1.2784660748899874,1.7778410630939037,0.6900908616351001,59425,61044,Rains+Van Zandt,Van Zandt,48,467,Texas,TX
48381,48CS081,955,894,1016,1200,184,245,306,208.31368278127306,206,175.3191489361702,-0.19676897258771323,0.3161809373599875,0.8623581475116175,0.8381868922786228,1195,1121,1269,1480,211,285,359,198.79756545154748,218,151.9470833827045,-0.013336245257575435,0.47185362651250395,1.0074472298009791,0.761660244997639,141000,143471,Randall,Randall,48,381,Texas,TX
48397,48CS082,583,536,630,632,2,49,96,53.90501070187226,54,59.32273214138584,-0.5243572702914098,-0.0494137171554298,0.4399183536212428,1.078524931291092,762,702,821,877,56,115,175,99.913484102978515,168,145.68410829185382,-0.9503402466497217,-0.45702274454831426,0.1005936597307451,1.44555632700812,109233,115318,Rockwall,Rockwall,48,397,Texas,TX
48401,48CS083,450,428,473,577,104,127,149,288.64644418090853,76,173.40381032056888,0.6458981488607336,1.1547434136338592,1.6390134079768934,0.5960367054820837,554,527,581,767,186,213,240,404.20344185845966,151,286.7070461579357,0.6486792133970646,1.1909601249151005,1.6935062428051897,0.7059973365345399,52594,52667,Rusk,Rusk,48,401,Texas,TX
48409,48CS084,557,527,586,661,75,104,134,182.524841113053,98,171.52858809801634,-0.4149834563771322,0.10294685123640601,0.6293260475216812,0.9308287312852106,692,656,728,883,155,191,227,275.001107673867,195,280.3174055545972,-0.535590210854436,-0.061926646675781925,0.47709704927111946,1.014031225246355,68560,69564,San Patricio,San Patricio,48,409,Texas,TX
48033,48CS085,8,8,8,7,-1,-1,-1,-244.34884093752217,7,1310.4524180967237,-15.665883397545038,-15.546317621095804,-15.433452068091931,-22.9335211295904,10,10,10,3,-7,-7,-7,-1100.4078130624605,3,483.8709677419355,-15.968649394072807,-15.842346344272277,-15.706675400566139,-0.515240076610313,641,620,Scurry and Nearby Counties,Borden,48,33,Texas,TX
48151,48CS085,38,36,40,59,19,21,23,682.1926608816976,12,389.29440389294405,2.4594359071372707,2.933133929968802,3.428492774135003,0.5447466528327105,47,45,49,66,17,19,21,523.3875339408249,13,351.16153430578066,1.1833026625945882,1.7246285899408604,2.230799926928945,0.6380115553148645,3699,3702,Scurry and Nearby Counties,Fisher,48,151,Texas,TX
48169,48CS085,38,38,39,53,14,15,15,303.2603886224451,15,306.85305148312307,-0.16003969510668345,-0.03580898600508546,0.0808851295546743,0.9479045161051644,47,46,47,64,17,17,18,295.596343586748,11,187.93780967025455,0.9482677106937044,1.0779161128178365,1.2133897451122129,0.6010517096768867,5866,5853,Scurry and Nearby Counties,Garza,48,169,Texas,TX
48227,48CS085,311,296,326,414,88,103,118,351.837454333358,85,291.3453299057412,0.10259260271224947,0.6115006934333639,1.1028518798028872,0.8200787913618469,375,358,393,459,66,84,101,244.32483288390674,70,204.5228773447087,-0.11489493910692607,0.40289849249797494,0.9162619382609455,0.8272020203474119,35010,34226,Scurry and Nearby Counties,Howard,48,227,Texas,TX
48263,48CS085,12,11,12,16,4,4,5,706.0963985761765,7,1108.179419525066,-4.140505644636716,-4.0208147952442586,-3.8958281650663436,1.2820100547822857,14,14,14,20,6,6,6,807.0545309864983,3,400,3.9483570684987948,4.075588016586992,4.21150273918286,0.4253564036466102,758,750,Scurry and Nearby Counties,Kent,48,263,Texas,TX
48335,48CS085,84,83,85,76,-9,-8,-7,-105.32517358227591,16,216.36240703177822,-3.327140756263757,-3.2157194621060574,-3.0969324016362085,-2.35682418766691,105,103,106,109,3,4,6,48.6240361910526,27,298.07904614705234,-2.6339243921919326,-2.4969959744847805,-2.3605257325991085,4.995961414499699,8874,9058,Scurry and Nearby Counties,Mitchell,48,335,Texas,TX
48353,48CS085,162,156,168,202,34,40,46,325.6372781668387,32,260.79869600651995,0.13170161067674307,0.6375007882138034,1.1735644531282696,0.7813321384743996,197,189,204,214,10,17,25,117.30896323906774,51,348.956551488197,-2.8396856347013575,-2.3053621806814757,-1.7542211158412402,2.8107373508443083,14724,14615,Scurry and Nearby Counties,Nolan,48,353,Texas,TX
48415,48CS085,150,143,157,201,44,51,58,364.11051224194426,38,270.1421800947867,0.4414118210954555,0.9304844323900417,1.4588692339624376,0.7277154560502513,183,175,192,223,31,40,48,234.88532119604338,55,326.603325415677,-1.4112047051133243,-0.9273720987039693,-0.40570625542712274,1.3561933919634082,16880,16840,Scurry and Nearby Counties,Scurry,48,415,Texas,TX
48423,48CS086,1862,1762,1963,2318,355,456,556,233.4420602069408,286,146.5282788477549,0.33136560490914985,0.8753337082146847,1.4199743293111213,0.6263112846904031,2310,2187,2432,2978,546,668,791,282.32920633017267,531,224.30522407289288,0.07563105444511538,0.5573834043111732,1.125779239975278,0.7932941949062091,234221,236731,Smith,Smith,48,423,Texas,TX
48427,48CS087,380,373,386,641,255,261,268,477.9965960496011,210,383.95319427726906,0.8206273766775195,0.9368440277153465,1.0635675969232923,0.8001943179555309,471,462,479,632,153,161,170,244.12307882051752,126,190.85703898936654,0.40269377890888264,0.5342300389503574,0.6527351669896344,0.7769855682050507,65633,66018,Starr,Starr,48,427,Texas,TX
48439,48CS088,11529,10620,12439,13952,1513,2423,3332,137.5275127799481,1732,98.31705832182658,-0.16826018836491408,0.3774508343146708,0.921588496754831,0.7145951548821609,14368,13271,15465,17744,2279,3376,4473,158.90056740229014,2929,137.8507982780181,-0.2845887643827857,0.2027249444589667,0.7507140036391777,0.8672717986452737,2113977,2124761,Tarrant,Tarrant,48,439,Texas,TX
48441,48CS089,1235,1174,1297,1390,93,155,216,130.05481073788266,218,183.4334878307027,-1.0492380263330214,-0.5452803518509614,-0.01656326228374202,1.4013655056945138,1521,1447,1595,1838,243,317,391,220.9808487400718,391,272.78942888637727,-1.0218598721127188,-0.5154757199468821,-0.009464806739379349,1.2305632002260838,142613,143334,Taylor,Taylor,48,441,Texas,TX
48451,48CS090,928,876,979,1222,243,294,346,294.4069177817015,190,190.10455750662865,0.5591881171627384,1.0414405067507568,1.5238262222531278,0.6435333498486064,1139,1077,1201,1459,258,320,382,267.91231279057286,211,176.5513086551978,0.4100931532168665,0.9156685794185313,1.4245087420104987,0.6569374269799818,119934,119512,Tom Green,Tom Green,48,451,Texas,TX
48453,48CS091,5142,4585,5699,5943,244,801,1358,74.31904544691795,586,54.35332910276041,-0.319566050697687,0.18907326372539085,0.7157739952260819,0.7304396634480643,6490,5817,7163,7406,243,916,1589,70.23386124101913,874,67.0330732286472,-0.4883842060609665,0.03353469300450349,0.5468179207677459,0.9533855941400834,1293757,1303834,Travis,Travis,48,453,Texas,TX
48469,48CS092,705,666,744,906,162,201,240,264.1858226899352,129,169.51008519305316,0.41033896038589607,0.9446320719743451,1.4618968478921597,0.6384564149870414,864,817,911,1119,208,255,302,280.32098556834507,231,253.8349962639005,-0.2352823865576276,0.2676583429642098,0.735235713043994,0.901979752876391,91322,91004,Victoria,Victoria,48,469,Texas,TX
48479,48CS093,1176,1061,1291,1897,606,721,836,322.1295398358951,526,234.95866261171886,0.3430441020911643,0.8702251850952741,1.3908237485672692,0.7283818250196707,1467,1329,1605,1980,375,513,651,191.56590014570122,423,157.92951788561123,-0.1654461403168889,0.34352542588763907,0.8179101665388764,0.8228098888854282,268643,267841,Webb,Webb,48,479,Texas,TX
48017,48CS094,49,49,50,59,9,10,10,170.42620953394157,14,245.0408401400233,-0.8703298374596171,-0.7475484057644456,-0.6217807625497886,1.303900275918402,60,60,61,82,21,22,22,314.73092445364756,19,277.85902310617143,0.23385637210822782,0.3641120630855078,0.49130844455879796,0.8436457700880069,6856,6838,Western Central Panhandle,Bailey,48,17,Texas,TX
48069,48CS094,51,51,52,75,23,24,24,387.1270521542985,24,391.1980440097799,-0.15413724663539186,-0.04003732812970876,0.07285684073382005,0.9696873844971737,63,62,64,96,32,33,34,445.6298585230341,19,257.8368842448093,1.757386139131721,1.8768152312186206,2.008182508489077,0.5614912026100132,7362,7369,Western Central Panhandle,Castro,48,69,Texas,TX
48079,48CS094,21,21,22,34,12,13,13,582.7973308267638,10,462.78441959120704,1.0731661732011017,1.2025541357206282,1.324734724751474,0.7356576737039956,26,25,26,46,20,20,21,809.3415021426233,10,396.51070578905626,4.007288861106213,4.127240631141369,4.270340141162056,0.4670367192000306,2593,2522,Western Central Panhandle,Cochran,48,79,Texas,TX
48117,48CS094,138,130,146,173,27,35,43,229.34016757511085,60,389.3365057048613,-2.1159724304594034,-1.5980888821709978,-1.1071600101258467,1.6509264136206891,169,160,179,216,37,47,56,255.68010388380722,41,223.38454832734007,-0.18522555557508305,0.3141760863224791,0.8689704840654027,0.8554582970073327,18493,18354,Western Central Panhandle,Deaf Smith,48,117,Texas,TX
48219,48CS094,177,167,186,285,99,108,118,599.7217839760464,91,503.10988251554943,0.46763307106439655,0.9740363274465969,1.4403310858097793,0.8312424565319826,215,204,227,294,67,79,90,367.1456615363496,58,271.2561968010476,0.4737177239592182,0.9533160504076451,1.4606030892226203,0.7295314357283267,21705,21382,Western Central Panhandle,Hockley,48,219,Texas,TX
48279,48CS094,140,134,146,194,48,54,60,499.3944310944324,67,620.2267993520019,-1.6836988644377964,-1.2124473158054705,-0.6572332118369136,1.2193549835779172,171,164,178,174,-4,3,10,24.04472562004987,28,216.86933622492447,-2.4341336973632477,-1.938960953098368,-1.3993323634184323,6.821923036960488,12963,12911,Western Central Panhandle,Lamb,48,279,Texas,TX
48369,48CS094,67,66,68,105,37,38,39,466.81265591243226,36,440.6364749082007,0.1345064759734218,0.2591999206517025,0.3736413180218151,0.9198082080055214,82,81,84,103,19,21,22,209.0316460005485,10,101.84336490477645,0.9538937202877037,1.0685596280133207,1.1885793688646904,0.4645800171479081,9804,9819,Western Central Panhandle,Parmer,48,369,Texas,TX
48043,48CS095,77,76,78,81,3,4,5,56.306637295351976,12,151.70670037926675,-1.0809992753126536,-0.9516725651013125,-0.8353857008018853,2.2002785145296393,95,93,96,109,13,14,16,152.57155460750752,14,147.88211682687228,-0.08207086749713279,0.04702315729839904,0.17471765115882554,0.9065038956222105,9492,9467,"West Texas, excluding El Paso",Brewster,48,43,Texas,TX
48103,48CS095,32,32,33,39,6,7,7,170.00293163306276,4,102.49839846252402,0.5489652373811512,0.67050218322156,0.7936839211103628,0.5239466950703464,40,40,41,48,7,8,8,167.3427799927663,10,213.76656690893546,-0.5818993484263897,-0.46245595667052763,-0.33572076543541046,1.1327215185962045,4683,4678,"West Texas, excluding El Paso",Crane,48,103,Texas,TX
48109,48CS095,18,17,18,27,9,9,10,517.5967681752384,2,109.78956999085086,3.95873586438128,4.0781259435219,4.196305925457709,0.19177500415996845,22,22,22,31,9,9,9,418.0040392666006,5,227.99817601459188,1.777718198463814,1.9023224404439978,2.0181751864634703,0.49179544634860806,2186,2193,"West Texas, excluding El Paso",Culberson,48,109,Texas,TX
48229,48CS095,18,17,18,35,17,17,18,603.8681904574951,6,208.69565217391303,3.8244243375649374,3.9536809511252198,4.073894612761803,0.3267758412745182,21,21,21,39,18,18,18,551.4806962357213,5,152.71838729383018,3.8499933794360324,3.98917272355503,4.109379112366673,0.26239173855285,3450,3274,"West Texas, excluding El Paso",Hudspeth,48,229,Texas,TX
48243,48CS095,16,16,16,19,3,3,3,195.9070998618492,5,297.3240832507433,-1.1312032149513889,-1.014057182486758,-0.8868777750261053,1.1642787010872218,19,19,19,28,9,9,9,469.1202614216192,3,153.60983102918587,3.0357571361464126,3.1534303761252818,3.284123040841704,0.2952198385878969,2018,1953,"West Texas, excluding El Paso",Jeff Davis,48,243,Texas,TX
48301,48CS095,1,1,1,7,6,6,6,9363.374113751226,7,10500,-11.830883972781182,-11.382313319441645,-10.882107244183333,0.9665505293340442,1,1,1,5,4,4,4,7362.938580438852,5,8620.689655172415,-13.096669615735772,-12.569073835055924,-12.041927838669176,0.9486758083623417,80,58,"West Texas, excluding El Paso",Loving,48,301,Texas,TX
48371,48CS095,106,104,107,164,57,58,60,459.68021282178296,28,220.38567493112947,2.274124414434474,2.3928896049776833,2.5126208387757,0.47136165628158755,130,128,132,176,44,46,48,303.2458921810575,33,218.1818181818182,0.7218869318324634,0.8508380862393348,0.9746118288604564,0.7041360775095674,15246,15125,"West Texas, excluding El Paso",Pecos,48,371,Texas,TX
48377,48CS095,37,36,38,55,17,18,19,351.4781556998786,20,388.34951456310677,-0.48866291111649246,-0.3721707399707614,-0.24933856825876957,1.047058745523293,46,45,46,70,24,24,25,396.96779069214665,14,228.23606129768504,1.5587098036112899,1.6883507735518333,1.809935648159139,0.5522681513100184,6180,6134,"West Texas, excluding El Paso",Presidio,48,377,Texas,TX
48389,48CS095,97,96,99,128,29,31,32,245.96792227777442,28,225.76093529530337,0.08347238093512695,0.19995765097823637,0.3188922436741303,0.8887147696200375,118,116,120,158,38,40,42,273.2246522239432,32,220.35532295827022,0.4028621050225116,0.5271895556440318,0.6482629722000688,0.7866721223159446,14883,14522,"West Texas, excluding El Paso",Reeves,48,389,Texas,TX
48461,48CS095,25,25,25,34,9,9,9,317.2850643489207,5,179.42583732057415,1.262552615204126,1.376926809050888,1.4944911838365498,0.5080434905271413,31,30,31,32,1,1,2,45.54074592873366,5,152.90519877675843,-1.1960641201839128,-1.0762461438806183,-0.9526061892799457,2.0086916958481975,3344,3270,"West Texas, excluding El Paso",Upton,48,461,Texas,TX
48475,48CS095,101,100,102,115,13,14,15,145.17932898200053,13,133.8366506520247,-0.007735505490117062,0.1160718846084996,0.24123718436261993,0.8608272647087518,121,119,122,122,-0,1,3,12.479344868907328,24,213.12494449871235,-2.132659019833538,-2.001183581540133,-1.8806505082155658,9.977969368336067,11656,11261,"West Texas, excluding El Paso",Ward,48,475,Texas,TX
48495,48CS095,61,61,62,75,13,14,14,212.12056128480887,15,232.37800154918668,-0.3134469713403018,-0.20248966221095854,-0.08387257592954735,1.0209372288462457,73,72,74,88,14,15,16,198.42950896656595,17,227.7599142550911,-0.42065697874509766,-0.28984343023451914,-0.1616554222496325,1.0752158691635612,7746,7464,"West Texas, excluding El Paso",Winkler,48,495,Texas,TX
48491,48CS096,2781,2515,3046,3106,60,325,591,63.519620878573335,256,49.972427322815044,-0.380937364315183,0.14408784586502757,0.6922850441031869,0.7843139613916571,3594,3264,3924,4068,144,474,804,74.13309796150854,564,88.26594968840868,-0.6196698184622771,-0.1384076405014317,0.34597106360206076,1.1881333620910028,614739,638978,Williamson,Williamson,48,491,Texas,TX
48497,48CS097,552,523,582,665,83,113,142,194.89077202648633,78,135.04544798730342,0.0647609437804886,0.6119700833683349,1.1318253276844354,0.686827327934203,698,661,734,833,99,135,172,189.94148207114927,153,214.58926492657682,-0.7724900900491741,-0.23163461473023123,0.26574493241156105,1.1214840049693193,69310,71299,Wise,Wise,48,497,Texas,TX
49001,49CS001,55,54,55,43,-12,-12,-11,-197.60783699243126,5,85.19096975720574,-2.9506368483137724,-2.827410142494975,-2.7019191715574435,-0.4717900989474017,69,68,69,90,21,21,22,296.93054687484874,13,179.95570321151718,1.040628838685067,1.1651126625713952,1.2996825304003188,0.5790578119331858,7043,7224,Beaver+Iron+Millard,Beaver,49,1,Utah,UT
49021,49CS001,307,282,332,337,5,30,55,62.376206685683876,16,33.33680591728305,-0.23730407055249014,0.2740066206643439,0.7762590209366921,0.5171723791725232,393,362,424,447,23,54,85,89.55061706210469,65,108.1548777849881,-0.7314121154038934,-0.18208601296020527,0.32679498266479823,1.1857197311916179,57594,60099,Beaver+Iron+Millard,Iron,49,21,Utah,UT
49027,49CS001,90,88,91,111,20,21,23,196.17308596056415,7,64.40236141991873,1.1899111112365846,1.3162932218426953,1.4421044466087436,0.313586638344522,111,109,112,154,42,43,45,329.48498589153047,31,235.88494901841426,0.8188376088702641,0.9370285849350142,1.0497192945743352,0.6997597839308275,13043,13142,Beaver+Iron+Millard,Millard,49,27,Utah,UT
49003,49CS002,357,332,382,417,35,60,85,124.40335062300493,29,60.19823902852496,0.0803097836591588,0.6326055839487933,1.1478025411381436,0.4759538476615265,452,421,483,511,28,59,90,99.30040815577097,77,129.56855354378408,-0.8266888747914876,-0.29774314983895295,0.22241387614792127,1.283071446501183,57809,59428,Box Elder+Cache+Rich,Box Elder,49,3,Utah,UT
49005,49CS002,525,468,582,529,-53,4,61,3.5953296925750067,31,27.934009656757098,-0.7835355981755989,-0.2498562628754512,0.26423462313421375,6.212490725238089,675,604,745,732,-13,57,128,41.84001205987287,60,43.843624406284256,-0.5355984684655629,-0.01444788410277896,0.502228048634812,1.0299004738674435,133171,136850,Box Elder+Cache+Rich,Cache,49,5,Utah,UT
49033,49CS002,15,15,15,11,-4,-4,-4,-192.60948854424592,5,239.23444976076553,-4.437768384405071,-4.3238182413142665,-4.194087232260116,-1.6525984756247178,19,19,19,20,1,1,1,39.06660110386055,2,77.42934572202864,-0.5022710711077646,-0.38353524316950477,-0.26234977534885234,0.9954754116909277,2508,2583,Box Elder+Cache+Rich,Rich,49,33,Utah,UT
49007,49CS003,191,182,199,220,21,29,38,172.70292905364815,6,35.19577650681918,0.8642850521008125,1.3762077407055175,1.8957888678607266,0.19709914840764062,233,222,243,292,49,59,70,291.8453783417838,30,147.15981555969785,0.8962351014049602,1.4331255784335266,1.8947944716494578,0.4959038439295483,20457,20386,Carbon+Daggett+Duchesne+Uintah,Carbon,49,7,Utah,UT
49009,49CS003,10,10,10,3,-7,-7,-7,-852.1464746835316,3,376.56903765690373,-12.406430039966747,-12.284613405592529,-12.162608368329902,-0.5182450846720585,12,12,12,5,-7,-7,-7,-741.1598313035541,5,514.40329218107,-12.691192140405384,-12.551697299794398,-12.432178597359233,-0.8059221012495476,956,972,Carbon+Daggett+Duchesne+Uintah,Daggett,49,9,Utah,UT
49013,49CS003,135,127,144,137,-7,2,10,9.757783478767175,1,6.108113610913163,-0.5274494650561309,0.02624363025281649,0.5413844769418644,0.38498381631922124,168,158,178,194,16,26,36,131.74527297882466,16,80.97165991902834,-0.021427408462535828,0.5224602589618188,1.0348391228037583,0.5918721320613168,19646,19760,Carbon+Daggett+Duchesne+Uintah,Duchesne,49,13,Utah,UT
49047,49CS003,213,198,228,254,26,41,56,137.51995755310662,15,50.4116955133591,0.35330695582438965,0.8748015155118459,1.3856102200477387,0.35783242262901177,267,248,285,340,55,73,92,202.8680749899476,43,119.05091503087019,0.3118773654994413,0.8416873803315653,1.3790538565488322,0.5789380713546134,35706,36119,Carbon+Daggett+Duchesne+Uintah,Uintah,49,47,Utah,UT
49011,49CS004,1636,1480,1792,1840,48,204,360,67.53623310150091,92,30.438966288293404,-0.15796848024049961,0.38455338945472956,0.9039779941504439,0.44850848395890663,2061,1872,2250,2338,88,277,466,75.57231656892333,212,57.807881504750064,-0.33587952784792485,0.18188072898102078,0.7097140775962484,0.762184522659536,362693,366732,Davis,Davis,49,11,Utah,UT
49023,49CS005,67,66,68,72,4,5,6,49.712919808764504,7,70.68327162571525,-0.3250113696885935,-0.20951522330146102,-0.08864244756120362,1.1817864108084435,84,83,86,85,-1,1,2,5.464154638534581,3,24.779053440158588,-0.3236203906857512,-0.191234146360526,-0.06555297283495487,1.8055482307860968,11884,12107,Juab+Sanpete+Tooele,Juab,49,23,Utah,UT
49039,49CS005,161,149,174,208,34,47,59,193.07725325825314,14,58.06719203649938,0.8573636919804187,1.3610890532432627,1.8587411548878727,0.2944211868869764,201,186,216,282,66,81,96,278.17941122988276,32,110.27258003377099,1.1285000842855342,1.6632530863997428,2.205311376183727,0.3915576099997728,28932,29019,Juab+Sanpete+Tooele,Sanpete,49,39,Utah,UT
49045,49CS005,351,319,382,352,-30,1,33,2.2956834922800367,20,32.67084127416281,-0.7971096518232725,-0.29827984920821177,0.2028091106513661,8.314829680462639,451,412,490,526,36,75,114,98.48421975984577,64,84.0446487196323,-0.36570799865926235,0.16144377826874132,0.6522424471120889,0.8421525417442827,73460,76150,Juab+Sanpete+Tooele,Tooele,49,45,Utah,UT
49029,49CS006,59,57,60,72,12,13,15,129.30825495433595,8,77.5506906858389,0.3879814197332052,0.5213741083874157,0.6320565297127385,0.5579102441272501,74,72,75,65,-10,-9,-7,-69.08995743349405,2,15.850372483753368,-0.9855559687338697,-0.8491967781934402,-0.7307046647837533,-0.25914218552534474,12379,12618,Morgan+Summit+Wasatch,Morgan,49,29,Utah,UT
49043,49CS006,143,124,161,147,-14,4,23,12.33613754496333,5,14.129282938890851,-0.4870936634136339,-0.015509640247648246,0.47503473638824517,0.9318881682178886,181,159,203,207,4,26,48,59.87846060810252,13,30.232558139534884,-0.24426118661729887,0.2974517667388214,0.8216680488929192,0.4860224057121151,42465,43000,Morgan+Summit+Wasatch,Summit,49,43,Utah,UT
49051,49CS006,138,135,142,166,24,28,31,95.58121196225126,16,54.80859809882676,0.2801849423885614,0.40437533622221056,0.517716637226664,0.5535844622946905,175,171,180,173,-7,-2,2,-6.862979567779383,12,33.326853111894906,-0.5270238459863337,-0.4022196246278847,-0.2716639969437505,-8.156867142933548,35031,36007,Morgan+Summit+Wasatch,Wasatch,49,51,Utah,UT
49035,49CS007,5972,5463,6482,6695,213,723,1232,73.3393356224531,576,58.46612694897663,-0.31970044631086053,0.15990628227567788,0.6738423757670297,0.7960982948213278,7437,6825,8050,7949,-101,512,1124,43.119378052912836,623,52.51206597470992,-0.58624914118333,-0.10128137447957739,0.4391732444663546,1.2154539074976605,1182223,1186394,Salt Lake,Salt Lake,49,35,Utah,UT
49049,49CS008,2406,2120,2691,2649,-42,243,529,44.12113916257448,223,40.45883585596291,-0.48142931541025574,0.028473584442268766,0.574006372762824,0.9132390478129271,3108,2756,3460,3248,-212,140,492,20.516507964912076,389,57.054771113565394,-0.8904794482184761,-0.38267480516128755,0.1845627507616165,2.7611807926546477,661413,681801,Utah (county),Utah (county),49,49,Utah,UT
49053,49CS009,1283,1204,1361,1478,117,195,274,128.5665631507574,111,73.06156479003027,0.061317599571420425,0.5380923604478414,1.0591996880192744,0.5653835693486562,1642,1543,1740,1889,149,247,346,130.34415381807878,249,131.14305126165937,-0.5189558471702305,-0.02255862589100757,0.49966251209961693,1.002080054945431,182312,189869,Washington,Washington,49,53,Utah,UT
49015,49CS010,84,83,85,96,11,12,13,143.11757004091538,7,84.99443488819185,0.46146836233697774,0.5840934818272536,0.7009090254935182,0.5474342152011054,104,103,106,127,21,23,24,227.67312616585943,20,201.0454362685967,0.1373027634460081,0.26397494418949996,0.38819650873366274,0.845704489202756,9883,9948,Wayne and Nearby Counties,Emery,49,15,Utah,UT
49017,49CS010,43,42,43,51,8,8,9,193.3018110389002,4,94.46959259988192,0.8695541779009958,0.9890137783193762,1.125842336659211,0.43550588697577086,53,53,54,61,7,8,8,153.13890288677575,3,58.559437829396835,0.8226119352207623,0.9502391552423969,1.074007834971714,0.3391629415345591,5081,5123,Wayne and Nearby Counties,Garfield,49,17,Utah,UT
49019,49CS010,76,75,77,61,-16,-15,-14,-186.6053331017762,4,49.52027236149799,-2.4712730606836364,-2.3646571564250363,-2.2436366075150787,-0.28423129308058315,93,92,95,85,-10,-8,-7,-87.79046586200093,7,72.41878750258638,-1.7268925007511842,-1.603568545614926,-1.4750035958187315,-0.9351004949487365,9693,9666,Wayne and Nearby Counties,Grand,49,19,Utah,UT
49025,49CS010,67,67,68,57,-11,-10,-10,-160.58700973972188,4,62.05559146735617,-2.3473058514832608,-2.224710029725214,-2.11794535950598,-0.4277539143279082,85,84,86,109,23,24,25,300.2758339897042,13,163.62492133417243,1.2422266001791957,1.3709247862102916,1.493202032349413,0.5229932996318323,7735,7945,Wayne and Nearby Counties,Kane,49,25,Utah,UT
49031,49CS010,15,15,16,15,-1,-0,0,-25.09576464985206,1,82.930200414651,-1.6051029210997458,-1.1041657543013546,-0.5833770319780507,1.4339242584108802,19,18,20,23,3,4,5,255.59599092605168,2,135.13513513513513,0.704646953477561,1.2001319719479557,1.706520766194661,0.4181632847622061,1447,1480,Wayne and Nearby Counties,Piute,49,31,Utah,UT
49037,49CS010,99,97,100,147,47,48,50,397.38184333414625,43,352.8446389496717,0.31378996609233717,0.4471134273669026,0.5754260857485326,0.8699592827158626,121,119,122,160,38,39,41,271.46720462524513,27,186.28397957775633,0.7329159106504758,0.8483679955651651,0.9781721098353305,0.6692037479770635,14624,14494,Wayne and Nearby Counties,San Juan,49,37,Utah,UT
49041,49CS010,182,172,191,198,7,16,26,90.52612043958476,2,11.112654535352132,0.25139300226933087,0.7990629463087447,1.3215926052250409,0.11565748792338856,227,216,238,230,-8,3,14,13.764599381453998,14,64.0614990390775,-1.0052982994738904,-0.5081093543885875,0.006800672841608648,3.4929132729497554,21597,21854,Wayne and Nearby Counties,Sevier,49,41,Utah,UT
49055,49CS010,21,20,21,33,12,12,13,588.5637008355096,2,94.749309119621,4.822304574993269,4.937710956077518,5.061580067103592,0.14899134218869647,26,25,26,33,7,7,8,294.1255792066137,1,39.23107100823852,2.4289452750185623,2.5486260061043198,2.6770152569941925,0.11768498088444806,2533,2549,Wayne and Nearby Counties,Wayne,49,55,Utah,UT
49057,49CS011,1592,1479,1705,1773,68,181,294,82.63485258867105,110,50.22639929987443,-0.2151160896283723,0.323512267162897,0.8209225835268772,0.6044712848417864,1987,1850,2125,2141,16,154,291,57.66886819227862,213,79.94055125202667,-0.7161627953312824,-0.22166443762913654,0.26937633177704595,1.3772363885099617,262810,266448,Weber,Weber,49,57,Utah,UT
50001,50CS001,272,256,288,287,-1,15,31,48.860985622906334,3,9.665726943213853,-0.11365954207257557,0.3921684990415855,0.8987789239056714,0.18558352059172367,334,315,353,370,17,36,55,96.0964978042026,7,18.784382128002147,0.28839244029692007,0.7744643358432421,1.2763331044357666,0.19016385652667955,37245,37265,Addison+Chittenden,Addison,50,1,Vermont,VT
50007,50CS001,1011,938,1083,1048,-35,37,110,26.77765391334006,62,44.36176302232399,-0.6931442443585932,-0.18325155334395266,0.3488789142254213,1.6135559894083071,1254,1167,1342,1318,-24,64,151,37.63767371980447,42,24.884317547591255,-0.3776790534483406,0.13816370556685426,0.6433375829083151,0.6509080577684833,167712,168781,Addison+Chittenden,Chittenden,50,7,Vermont,VT
50003,50CS002,407,391,423,399,-24,-8,8,-24.90208219995693,2,6.48263194857112,-0.799666784825284,-0.33281986529564844,0.18628424175115635,-0.29927989993669724,498,479,518,547,29,49,68,130.15977441555762,25,67.01334905913258,0.06989368987610678,0.6435170630278637,1.1466225291597891,0.5044654734501482,37022,37306,Bennington+Windham,Bennington,50,3,Vermont,VT
50025,50CS002,414,394,434,390,-44,-24,-4,-63.69691962098741,6,15.879317189360858,-1.3285126480357934,-0.7979769709205954,-0.2858619420731991,-0.26010191311055164,512,488,536,536,0,24,48,51.741440505217355,24,52.11273722152256,-0.512624006469384,-0.00605532706138819,0.5037013472137144,0.9666115063126052,45342,46054,Bennington+Windham,Windham,50,25,Vermont,VT
50005,50CS003,271,258,284,268,-16,-3,10,-13.727045979148386,2,7.957559681697612,-0.7215136200471267,-0.19866464446325602,0.29326943461033605,-0.8163051325028425,336,320,351,387,36,51,67,169.50002270458936,14,46.09660531428007,0.7113073102987214,1.2370540342613705,1.7345287045378406,0.266774128897643,30160,30371,Caledonia+Essex+Orange,Caledonia,50,5,Vermont,VT
50009,50CS003,61,61,62,68,6,7,7,138.31813806383354,5,100.90817356205852,0.26173150764569764,0.3732279413665421,0.49582275480354954,0.6366455408394244,75,74,76,87,11,12,13,206.2348049937297,6,101.30001688333614,0.9174418551631405,1.0483267509916578,1.1767732201072663,0.45401963446504773,5946,5923,Caledonia+Essex+Orange,Essex,50,9,Vermont,VT
50017,50CS003,241,229,254,240,-14,-1,11,-5.856359822275505,7,28.744482086028125,-0.8704530741300537,-0.35383712823827235,0.15454484675493016,-16.425369166166973,300,284,315,295,-20,-5,11,-15.79410783142174,3,10.169491525423728,-0.7923537261424795,-0.24219489304756123,0.26444688836019975,-0.8198374851399673,29223,29500,Caledonia+Essex+Orange,Orange,50,17,Vermont,VT
50011,50CS004,380,359,402,404,2,24,45,56.6973990061736,25,60.070883642698384,-0.5383560432709124,-0.03522019746193513,0.48474577534430985,1.0164237807423508,470,444,496,481,-15,11,37,21.010740089772444,24,47.735545080255385,-0.7691833071157214,-0.2818340884949933,0.25106575770470246,2.075483646106633,49941,50277,Franklin+Grand Isle,Franklin,50,11,Vermont,VT
50013,50CS004,53,52,54,57,3,4,5,62.17059262405159,4,65.9069064945764,-0.1531667646276601,-0.036213413629382345,0.08167788491457165,0.8380057594462438,66,65,67,95,28,29,30,388.1569455857015,5,67.56756756756756,3.081235558227443,3.2061684818209657,3.331364140916106,0.1682164222858071,7283,7400,Franklin+Grand Isle,Grand Isle,50,13,Vermont,VT
50015,50CS005,181,170,192,214,22,33,44,153.14571822308582,5,23.198267862666256,0.798607875476669,1.2900997873134274,1.8134453429617983,0.1470241987496483,223,210,237,246,9,23,36,86.54362682203853,6,22.99291051925656,0.11703349076995222,0.6468240281802932,1.1108404375642857,0.2544145221400487,25864,26095,Lamoille+Orleans,Lamoille,50,15,Vermont,VT
50019,50CS005,275,263,287,277,-10,2,14,7.841180546575073,4,17.573405579556272,-0.5872468299656483,-0.09287393812076089,0.39550889116608934,1.4363774326337828,337,323,351,428,77,91,105,329.9683243386861,24,87.21564067156044,1.8837266010918958,2.420002652854888,2.937269287241439,0.2614359619905997,27314,27518,Lamoille+Orleans,Orleans,50,19,Vermont,VT
50021,50CS006,612,586,638,650,12,38,64,75.0836816855089,2,3.9914184503317864,0.23454743580255136,0.6963527430142735,1.1975878351902176,0.05178321212939179,754,722,785,803,18,49,81,81.39036268770661,34,56.132472635419596,-0.25682582715945373,0.24539830495853257,0.7508781337190992,0.6759583559851712,60129,60571,Rutland,Rutland,50,21,Vermont,VT
50023,50CS007,472,446,498,536,38,64,90,129.03043268793462,2,4.027994562207342,0.6977504126713421,1.2421369908608515,1.745779840506275,0.030737625118130014,582,551,613,610,-3,28,59,46.091073476803615,20,33.36837012196139,-0.3855315455020084,0.13901623125533152,0.6030100404266332,0.6986751478409268,59583,59937,Washington,Washington,50,23,Vermont,VT
50027,50CS008,522,497,547,554,7,32,57,67.07238641190868,6,12.551644788452485,-0.029216955383341233,0.5417579288662068,1.0651885590964438,0.181475701344502,645,615,675,675,0,30,60,52.25463192488372,27,46.45241208450898,-0.43943717146276406,0.06706337590250529,0.5718333664686035,0.8606268313810912,57363,58124,Windsor,Windsor,50,27,Vermont,VT
51001,51CS001,375,361,390,423,33,48,62,172.5492758860409,32,115.70447149572135,0.020951589236743003,0.5555257233343066,1.1048493439208178,0.6567958721453618,459,441,476,555,79,96,114,289.86757474159396,50,150.32620787108024,0.8536166361337523,1.4027265001182432,1.8815445146893814,0.5132792842938066,33188,33261,Accomack+Northampton+Virginia Beach (city),Accomack,51,1,Virginia,VA
51131,51CS001,162,157,167,194,27,32,37,315.6646826577737,23,227.08573309198616,0.36817220233370146,0.8812319729703012,1.4372968103846708,0.6975706376877463,196,190,203,213,10,17,23,138.2850370884091,20,165.20733520568314,-0.8060629335169407,-0.266878261402194,0.20237600545422027,1.1273457294932165,12154,12106,Accomack+Northampton+Virginia Beach (city),Northampton,51,131,Virginia,VA
51810,51CS001,2761,2564,2958,3056,98,295,492,77.37568846466702,163,42.712925900934835,-0.16007073194422508,0.33960669410597116,0.8532903226587993,0.5501568036006961,3421,3184,3657,4058,401,637,874,139.19914871268728,403,88.00663871418588,-0.009261526178871627,0.5072810779643026,1.034706262743969,0.6312451548380783,457941,457920,Accomack+Northampton+Virginia Beach (city),Virginia Beach (city),51,810,Virginia,VA
51003,51CS002,746,697,794,852,58,106,155,113.58564911232698,46,49.19040787046526,0.14674870326334147,0.6540195112300196,1.174206594550981,0.4290297447113303,925,866,983,1023,40,98,157,86.5679797134438,73,64.38354956210367,-0.30409585258770966,0.21489857623868988,0.7285259936136781,0.7362331527884517,112217,113383,Albemarle+Charlottesville (city),Albemarle,51,3,Virginia,VA
51540,51CS002,242,222,262,259,-3,17,37,44.106509954645084,26,67.1400903808909,-0.7447747640112353,-0.2418248380025415,0.2521211572397873,1.4380335327767255,295,272,319,329,10,34,57,73.34050848777906,23,50.23808483683544,-0.30466852082606305,0.23224538371606127,0.7707411744156055,0.6651868361961419,46470,45782,Albemarle+Charlottesville (city),Charlottesville (city),51,540,Virginia,VA
51510,51CS003,629,560,697,705,8,76,145,57.81185891297116,87,65.81228369885207,-0.5741902188296406,-0.08694287480079625,0.42049306644471157,1.1236839560093057,774,693,854,798,-56,24,105,15.709587194985325,58,37.336011226552344,-0.7460017666702429,-0.22283078566119283,0.30303712407433064,2.2830856714312384,158633,155346,Alexandria (city),Alexandria (city),51,510,Virginia,VA
51005,51CS004,182,175,188,211,23,29,36,234.01491909960947,25,198.62288135593218,-0.19363026918280624,0.3611634812021142,0.8786084277410702,0.8208919545938449,220,213,228,318,90,98,105,649.700308067799,49,326.40554223288035,2.747000662393519,3.2303404572519607,3.6984676790576296,0.4972952706620802,15104,15012,Alleghany and Nearby Counties and Independent Cities,Alleghany,51,5,Virginia,VA
51017,51CS004,55,55,56,65,9,10,10,273.32027220003124,1,28.680688336520078,2.320926237500781,2.445388273662524,2.564694061719354,0.09496886462070983,67,67,68,77,9,10,10,238.25955307208426,12,290.838584585555,-0.6546798866983189,-0.5260155899761733,-0.4003567711770249,1.1079729664745535,4184,4126,Alleghany and Nearby Counties and Independent Cities,Bath,51,17,Virginia,VA
51023,51CS004,308,293,322,321,-1,13,28,48.075987430792054,20,71.3775874375446,-0.7504174532767716,-0.23634540526609965,0.26175464778425434,1.3820848393369356,380,363,398,484,86,104,121,306.2326918087813,56,165.5384433474238,0.9077643435572484,1.3934797603045723,1.9364876893054204,0.5353961007404019,33624,33829,Alleghany and Nearby Counties and Independent Cities,Botetourt,51,23,Virginia,VA
51091,51CS004,25,25,26,25,-1,-0,-0,-17.414518470508966,3,161.72506738544473,-1.9126540819970472,-1.789008267846247,-1.6736577942758548,4.431571992464986,31,31,31,33,2,2,2,82.7416669018507,7,314.3242029636282,-2.4496760872408245,-2.3130939543253306,-2.1909251401120056,2.4624849893285394,2226,2227,Alleghany and Nearby Counties and Independent Cities,Highland,51,91,Virginia,VA
51580,51CS004,97,96,97,88,-9,-9,-8,-186.97756945242017,4,84.12197686645636,-2.8361671836553968,-2.7094842727284445,-2.5901219433004385,-0.5069205151517218,119,118,120,117,-3,-2,-1,-34.22515331303867,25,437.2158097236796,-4.831949916427808,-4.718335231101304,-4.586553951519549,-26.12345849574547,5706,5718,Alleghany and Nearby Counties and Independent Cities,Covington (city),51,580,Virginia,VA
51007,51CS005,144,138,150,156,6,12,18,110.45106885183802,3,27.22940776038121,0.3298617387662287,0.8394404187377796,1.3204633437082216,0.2278086555785439,177,170,184,224,40,47,54,353.7036852795803,29,218.6204297022239,0.8386576267364813,1.3526290266672454,1.904721671909801,0.605190524815058,13221,13265,Amelia+Brunswick+Lunenburg+Nottoway,Amelia,51,7,Virginia,VA
51025,51CS005,180,173,187,193,6,13,20,96.85739280451456,13,98.27390701776488,-0.5410115906034756,-0.02313726161602789,0.5200972186083292,0.9411683771767995,222,214,230,275,45,53,61,332.9236309965179,27,169.59798994974872,1.053575355857614,1.634752991262877,2.1424219149151074,0.4999866479987313,15874,15920,Amelia+Brunswick+Lunenburg+Nottoway,Brunswick,51,25,Virginia,VA
51111,51CS005,134,129,139,136,-3,2,7,17.798043287665244,2,20.04008016032064,-0.5497781427167904,-0.021920504028133312,0.47391406645524253,0.7203975879768564,164,158,170,177,7,13,19,106.31722634673088,18,150.9180850171879,-0.9685941332809375,-0.4405888865039279,0.11114015511497989,1.3157456552782913,11976,11927,Amelia+Brunswick+Lunenburg+Nottoway,Lunenburg,51,111,Virginia,VA
51135,51CS005,180,173,186,184,-2,4,11,32.56221539872096,21,162.03703703703704,-1.826305823962264,-1.2998123128753574,-0.7561229456973536,4.022939863877027,221,213,229,262,33,41,49,264.1574557244526,29,185.93319228056677,0.2585618793668428,0.7762811028909564,1.2995102626214006,0.6871933961327793,15552,15597,Amelia+Brunswick+Lunenburg+Nottoway,Nottoway,51,135,Virginia,VA
51009,51CS006,294,280,307,324,17,30,44,116.28263356962647,18,68.95671050951347,-0.03577975441568347,0.47332479502907054,1.00495492687569,0.5740959588641067,360,344,376,478,102,118,134,376.8794250563346,49,156.69470116081993,1.7045095839076567,2.222372355841805,2.775580329591762,0.4122706381410036,31324,31271,Amherst+Lynchburg (city)+Nelson,Amherst,51,9,Virginia,VA
51125,51CS006,166,159,172,186,14,20,27,165.33258541867806,4,32.52473234855671,0.8590166029416744,1.3329975640056493,1.8383121495980275,0.18750158969056396,203,195,211,206,-5,3,11,20.092878837989122,24,162.35962657285887,-1.9903044946143282,-1.4326289208881826,-0.8768193839452689,6.045143088604479,14758,14782,Amherst+Lynchburg (city)+Nelson,Nelson,51,125,Virginia,VA
51680,51CS006,674,640,708,779,71,105,139,158.3227611695584,56,84.73507679116335,0.18747982680822803,0.7238006594842923,1.2646419980552772,0.5301379940066229,828,787,869,976,107,148,189,187.1824023713475,116,146.8558913266404,-0.12832113843716686,0.4229130753681836,0.920603944453375,0.7792896634237436,79306,78989,Amherst+Lynchburg (city)+Nelson,Lynchburg (city),51,680,Virginia,VA
51011,51CS007,165,158,172,156,-16,-9,-2,-69.51389926652293,3,22.32973576479345,-1.4644952143441374,-0.9183079651605195,-0.4248604966675667,-0.35974706760175823,204,196,213,201,-12,-3,5,-20.867781096642283,24,147.04981312419582,-2.189158231058325,-1.6796377154120545,-1.1906169365542432,-9.975764906733591,16122,16321,Appomattox+Campbell,Appomattox,51,11,Virginia,VA
51031,51CS007,492,468,516,603,87,111,135,240.44475353473473,46,99.3091537132988,0.8854645838910532,1.4055376761472491,1.912914002775194,0.4093473220952537,602,573,631,767,136,165,194,297.1903909366883,105,189.14488498189613,0.5813256386904393,1.082454513968843,1.565337090942519,0.6326089995046367,55584,55513,Appomattox+Campbell,Campbell,51,31,Virginia,VA
51013,51CS008,779,677,882,986,104,207,309,104.21039411495155,152,76.60421575174186,-0.23362548935872574,0.2607890725264635,0.7999026796642312,0.7315540008825125,965,844,1086,1017,-69,52,173,22.21523777833189,75,32.07719055134275,-0.6279287921868275,-0.09222692218394093,0.39040363668670847,1.416653470961079,238107,233811,Arlington,Arlington,51,13,Virginia,VA
51015,51CS009,602,568,635,715,80,113,147,175.85002597430363,50,77.60560829862638,0.46124732430600623,0.9788926450926208,1.518508283973426,0.4374558791239694,733,693,773,967,194,234,274,301.6031252728901,97,125.07091649904586,1.2390118626717683,1.7793727503760672,2.2800726653865384,0.41292177859906376,77314,77556,Augusta+Rockbridge and Independent Cities,Augusta,51,15,Virginia,VA
51163,51CS009,220,210,230,271,41,51,61,271.3997667692503,21,111.32217166585677,1.0949941734697901,1.6147477730048059,2.0945356694490993,0.40231962678956606,267,255,278,347,69,80,92,354.923199018862,63,278.3177239795017,0.2668664783348468,0.7723208497743129,1.2770831050949352,0.7745227233531758,22637,22636,Augusta+Rockbridge and Independent Cities,Rockbridge,51,163,Virginia,VA
51530,51CS009,69,68,69,89,20,20,21,370.62199124307284,10,181.87329493785998,1.7623709157029332,1.8882156666598469,2.0186098614197316,0.467769894490131,84,83,85,112,27,28,29,424.3580586891586,17,257.419745608722,1.5446860782934062,1.6674189269966881,1.792193027259735,0.585709927821216,6598,6604,Augusta+Rockbridge and Independent Cities,Buena Vista (city),51,530,Virginia,VA
51678,51CS009,74,73,75,67,-8,-7,-6,-112.5729121626074,1,16.397922929762228,-1.401339515169952,-1.2915985610584995,-1.1750911657332996,-0.17050090736232804,92,91,93,72,-21,-20,-19,-265.87312535761896,14,188.2985877605918,-4.662170824316698,-4.542546015596204,-4.412439930115691,-0.7459637948990907,7318,7435,Augusta+Rockbridge and Independent Cities,Lexington (city),51,678,Virginia,VA
51790,51CS009,330,319,341,345,4,15,26,70.95271124187184,36,168.37510231126006,-1.4747965561094103,-0.9683452931108881,-0.46677348766714943,2.226306403843439,399,385,412,423,11,24,38,95.09839077382314,43,167.4389626572174,-1.2321885682737954,-0.6932331254310896,-0.1834074144809792,1.691433865009866,25657,25681,Augusta+Rockbridge and Independent Cities,Staunton (city),51,790,Virginia,VA
51820,51CS009,236,227,246,225,-21,-11,-2,-60.04957105902804,15,80.61987727863125,-1.9077211258610367,-1.4048358773631875,-0.8809368805557932,-1.4745314346837144,289,277,300,317,17,28,40,126.49545140466839,28,124.38916037316748,-0.5134401339705463,0.028223096739195076,0.5425345501498526,0.9499857568082009,22327,22510,Augusta+Rockbridge and Independent Cities,Waynesboro (city),51,820,Virginia,VA
51019,51CS010,704,670,738,817,79,113,147,170.77977106885754,42,63.34921253409419,0.5457096623163721,1.0683374494871631,1.6036762557176365,0.36769351922385896,869,827,910,1067,157,198,240,247.8827642498508,126,157.42128935532233,0.35540164146884246,0.8858534558723162,1.4038465725786884,0.63187868747871,79559,80040,Bedford (county)+Bedford (city),Bedford (county),51,19,Virginia,VA
51021,51CS011,69,69,70,80,10,11,11,203.99193400309952,6,115.27377521613832,0.7634057374856236,0.8856299277520416,0.9949992206139338,0.5164497791193673,84,83,85,98,13,14,15,223.55499547833656,7,113.1953428201811,0.976556352131211,1.1071477180974558,1.2223609021854103,0.47218681636846094,6246,6184,Bland+Smyth+Wythe,Bland,51,21,Virginia,VA
51173,51CS011,376,363,388,441,53,65,78,263.41923571579645,46,185.4215653342291,0.24030715587739582,0.7902845249158951,1.309626182317892,0.693293956819723,456,440,471,604,133,148,164,503.04265397203955,77,260.8931354611371,1.9286782855903906,2.417148768462758,2.999882034825708,0.5151604050266276,29770,29514,Bland+Smyth+Wythe,Smyth,51,173,Virginia,VA
51197,51CS011,344,332,356,398,42,54,66,228.33139668571926,39,165.2892561983471,0.13185629297897886,0.6365986452675312,1.1689586554836962,0.710708830662727,419,405,434,505,71,86,100,304.1486234665817,75,266.0329171396141,-0.12161197230814257,0.38851315942876635,0.9182874496311308,0.8645973669495495,28314,28192,Bland+Smyth+Wythe,Wythe,51,197,Virginia,VA
51191,51CS012,540,517,563,687,124,147,170,328.39883955329435,65,144.92753623188403,1.339369198560294,1.853952667145756,2.344249428606336,0.4383395226994356,651,624,679,888,209,237,264,441.08032674768424,111,206.83872169943166,1.7923489912978439,2.3368475140620095,2.855233982240107,0.4669638684306751,53820,53665,Bristol (city)+Washington,Washington,51,191,Virginia,VA
51520,51CS012,232,225,240,249,9,17,24,117.22738683481745,20,139.49433304272014,-0.7522874184808402,-0.22322657589173023,0.30867578939318147,1.1231237565744852,278,269,287,306,19,28,37,162.35757120059637,38,222.43034418169046,-1.1034948028444544,-0.6068993694886601,-0.07119857178666897,1.3223293509258705,17205,17084,Bristol (city)+Washington,Bristol (city),51,520,Virginia,VA
51027,51CS013,254,246,263,333,70,79,87,464.64815435240143,29,171.4877051199921,2.3915757295358495,2.9207326969047847,3.406383429628347,0.364432059481819,306,295,316,395,79,89,100,449.3633643280523,64,322.0287813223307,0.7927867814681784,1.2598108021577774,1.7486405079205147,0.7086977980391664,20293,19874,Buchanan+Dickenson+Russell+Tazewell,Buchanan,51,27,Virginia,VA
51051,51CS013,179,173,185,195,10,16,22,140.30506727237682,16,136.6061899679829,-0.5026697278389242,0.046881480727909035,0.5410221475071488,0.9177874139380418,215,208,222,230,8,15,22,107.51192232556188,24,173.59855334538878,-1.186087687712361,-0.6603418453158965,-0.14029570568725686,1.5129047692849749,14055,13825,Buchanan+Dickenson+Russell+Tazewell,Dickenson,51,51,Virginia,VA
51167,51CS013,296,285,307,341,34,45,56,209.47830179590608,23,106.74917810868303,0.492021770160167,1.0080034287597281,1.5309680053790993,0.4985493754943244,360,346,373,463,90,103,117,404.45344944822716,59,230.6850172036284,1.2585187226495105,1.7449409978927797,2.2610584587899094,0.5649013525172337,25855,25576,Buchanan+Dickenson+Russell+Tazewell,Russell,51,167,Virginia,VA
51185,51CS013,511,493,528,609,81,98,116,292.25356625467657,31,92.17960154623847,1.4932938322253746,2.0009691050913796,2.503498754191423,0.3122328573082656,619,599,640,790,150,171,191,426.6163967690023,94,235.08227879757916,1.4170892459794093,1.9245609171166154,2.3963906533601538,0.5478275848945441,40356,39986,Buchanan+Dickenson+Russell+Tazewell,Tazewell,51,185,Virginia,VA
51035,51CS014,303,290,315,394,79,91,104,374.8249785200999,49,201.01189662245318,1.1974639980649089,1.7464364137015989,2.2570020428280966,0.5304762066877489,369,354,384,530,146,161,176,552.6758016065735,70,240.88093599449414,2.5573803120981533,3.1242603445028494,3.6138631804418817,0.433147978317782,29252,29060,Carroll+Galax (city)+Grayson,Carroll,51,35,Virginia,VA
51077,51CS014,171,165,178,214,36,43,49,335.2832612859077,29,226.76919066857815,0.5876340434650209,1.0856195851276647,1.626256811845088,0.6609364078125668,210,202,218,282,64,72,80,470.43421282275,41,267.1009771986971,1.547311549831017,2.0265155732877913,2.558738963921404,0.5600201479644674,15346,15350,Carroll+Galax (city)+Grayson,Grayson,51,77,Virginia,VA
51640,51CS014,140,139,141,123,-18,-17,-16,-307.07474232165333,19,343.684051854085,-6.619327027184583,-6.5080959157813325,-6.390208386723496,-1.1892753399688607,172,171,173,173,0,1,2,19.74846282225557,24,360.0900225056264,-3.5385404836356282,-3.404173549196854,-3.290061947553482,10.361642714116696,6634,6665,Carroll+Galax (city)+Grayson,Galax (city),51,640,Virginia,VA
51036,51CS015,71,70,72,89,17,18,19,320.30442900175234,2,35.53976010661928,2.727839524548244,2.8499336669652897,2.9668335088701845,0.1051241077914351,86,85,86,115,29,29,30,445.3007919696873,14,211.672210462655,2.2147422417475933,2.3358116627448697,2.4605905791858884,0.45973698397224266,6753,6614,Charles City+Goochland+Henrico+New Kent,Charles City,51,36,Virginia,VA
51075,51CS015,191,180,201,207,6,16,27,79.09238364927698,12,58.13718761354919,-0.30232166169654245,0.19479885845585934,0.7189747965669785,0.6926276161348229,240,227,253,277,24,37,50,145.6281973155656,33,129.96219281663517,-0.36708123327074965,0.1608687884235857,0.6560111590497061,0.86892613052533485,24769,25392,Charles City+Goochland+Henrico+New Kent,Goochland,51,75,Virginia,VA
51087,51CS015,2453,2310,2597,2929,332,476,619,170.93783475886386,275,98.81422924901186,0.2163367995814554,0.7122438097056443,1.2185782006748302,0.5768585404092537,3021,2849,3194,3588,394,567,739,169.8353346627623,364,109.09243485922879,0.0949724348771039,0.601304920881576,1.094385119079269,0.6412108605117876,333960,333662,Charles City+Goochland+Henrico+New Kent,Henrico,51,87,Virginia,VA
51127,51CS015,170,160,180,178,-2,8,18,42.269672520636355,12,62.18690620141647,-0.6935898290617674,-0.2062684727407612,0.2946454891302105,1.3105246983017824,215,202,227,245,18,30,43,127.13706846600972,20,84.10782623323101,-0.06836080499310408,0.4196952303457802,0.9233193768522915,0.640370420773326,23156,23779,Charles City+Goochland+Henrico+New Kent,New Kent,51,127,Virginia,VA
51550,51CS016,1615,1508,1723,1810,87,195,302,93.67977778155769,138,66.44704900469863,-0.24396016613382626,0.28359839063106845,0.8169431678913954,0.7056727597543699,2007,1878,2137,2391,254,384,513,152.7666585895222,237,94.40839398176364,0.06961172076530887,0.6050549358519659,1.0959345795551156,0.6163835741416208,249221,251037,Chesapeake (city),Chesapeake (city),51,550,Virginia,VA
51041,51CS017,2286,2129,2443,2583,140,297,454,97.85787654308001,185,60.93510685602296,-0.10373542518052678,0.36958918483951925,0.8755890738636436,0.6206009786739303,2851,2660,3042,3334,292,483,674,130.46284860884217,362,97.85344149472483,-0.19259918394496225,0.3401887738361751,0.8622832186694398,0.7484974738647165,364322,369941,Chesterfield+Colonial Heights (city)+Powhatan,Chesterfield,51,41,Virginia,VA
51145,51CS017,195,182,208,245,37,50,63,196.83060889403623,10,39.468490988027895,1.0258406518022587,1.5691696223541256,2.096242973415636,0.19657829809477706,245,229,261,315,54,70,86,226.85268526630205,30,96.67128540585827,0.7879729860193798,1.308418888633084,1.7753679820052564,0.4201728114211051,30404,31033,Chesterfield+Colonial Heights (city)+Powhatan,Powhatan,51,145,Virginia,VA
51570,51CS017,229,221,236,229,-7,0,8,3.153171597471622,13,86.4792948611342,-1.341672656781251,-0.8192977737146092,-0.32645175036662394,8.819535556582485,280,271,290,320,30,40,49,218.2890371661212,38,208.09375171129727,-0.3946559217111901,0.10584600016613828,0.5708895455175637,0.9299648130309579,18039,18261,Chesterfield+Colonial Heights (city)+Powhatan,Colonial Heights (city),51,570,Virginia,VA
51043,51CS018,145,139,152,153,1,8,14,61.71189123590922,10,81.26227398930045,-0.7180311105450616,-0.19304166216422247,0.3415943582626144,1.1635805141629654,179,171,187,185,-2,6,14,40.011433226144014,19,127.79982511602879,-1.4037821910118666,-0.8967652166089566,-0.3486682422203506,2.734403196052893,14767,14867,Clarke+Warren,Clarke,51,43,Virginia,VA
51187,51CS018,340,323,358,351,-7,11,28,32.284809871604224,29,85.46798634476998,-1.0784748265682118,-0.5293283508201542,-0.0048092246474251985,2.4258637165147685,419,398,440,532,92,113,134,275.40904070906026,77,188.24564834734988,0.3400078000341068,0.8722003631244527,1.366523704500592,0.6774989420204498,40717,40904,Clarke+Warren,Warren,51,187,Virginia,VA
51045,51CS019,45,45,46,55,9,10,10,236.17495972761222,7,170.94017094017096,0.5425617837472743,0.649929199765628,0.7767522376882048,0.6559610941833287,55,54,56,72,16,17,18,346.92951046689564,7,143.82576535853707,1.899673332870476,2.0315544361618643,2.157664183986509,0.3913881353477099,4914,4867,Craig+Franklin (county)+Roanoke (county)+Salem (city),Craig,51,45,Virginia,VA
51067,51CS019,503,480,527,618,91,115,138,251.20027561218473,41,89.83347940403155,1.111545965606183,1.600823610759126,2.1328246146038987,0.35452466841145697,618,590,646,796,150,178,206,324.3777161730077,88,160.37907782030254,1.1445431585233439,1.6561739056268052,2.1693451348314174,0.49165842026139306,54768,54870,Craig+Franklin (county)+Roanoke (county)+Salem (city),Franklin (county),51,67,Virginia,VA
51161,51CS019,888,846,929,1003,74,115,157,143.5120882971663,92,114.44565386409577,-0.21140017529770783,0.26762766968377016,0.7534701213584709,0.790610435610052,1086,1036,1136,1352,216,266,316,274.9559048448424,113,116.94574959120735,1.1164173759020901,1.5912210768567825,2.121290315579555,0.4237305730940481,96465,96626,Craig+Franklin (county)+Roanoke (county)+Salem (city),Roanoke (county),51,161,Virginia,VA
51775,51CS019,301,291,312,348,36,47,57,220.1592632662806,25,118.34319526627219,0.5101880380738029,0.9952633724557063,1.5475164095273373,0.526220024463943,367,354,381,395,14,28,41,108.49736418733706,51,201.00106412328066,-1.4081570010451843,-0.9246615462373168,-0.4311910925633217,1.7876523979009458,25350,25373,Craig+Franklin (county)+Roanoke (county)+Salem (city),Salem (city),51,775,Virginia,VA
51047,51CS020,389,366,412,406,-6,17,40,38.50517772383567,33,74.98721808782594,-0.9160125664256722,-0.35744915297148644,0.1288730673489964,1.8389353344710873,484,457,512,557,45,73,100,135.6610736647703,56,104.73554275454477,-0.2024694388829593,0.30665114256560744,0.8265958362792314,0.761539400508084,52809,53468,Culpeper+Madison+Rappahannock,Culpeper,51,47,Virginia,VA
51113,51CS020,133,131,134,121,-13,-12,-10,-103.18888204321014,7,61.059824089554404,-1.7639181639684516,-1.6402011417515432,-1.522836982025501,-0.6463679181027898,165,163,167,177,10,12,14,84.69599681061318,27,193.86802613628205,-1.210160827739385,-1.0906085478701097,-0.968901958199224,2.1100984545392483,13757,13927,Culpeper+Madison+Rappahannock,Madison,51,113,Virginia,VA
51157,51CS020,59,58,59,63,4,4,5,73.51908942962694,7,114.58191242668121,-0.5220470417258452,-0.408157468896199,-0.28075226370665646,1.2747196119518764,73,72,74,96,22,23,24,315.8879756834978,1,13.526308670363857,2.899256429461521,3.0168301742425196,3.1466360685120396,0.04106169438552245,7331,7393,Culpeper+Madison+Rappahannock,Rappahannock,51,157,Virginia,VA
51143,51CS021,615,589,641,694,53,79,105,157.14239189625383,55,109.45273631840796,-0.02941989738855698,0.4717354876705888,0.9913650960259266,0.687809067624704,754,723,785,895,110,141,172,235.02017770523233,105,174.93585685248743,0.08242658895261455,0.5983773934525418,1.1302892668606537,0.7391044856173974,60300,60022,Danville (city)+Pittsylvania,Pittsylvania,51,143,Virginia,VA
51590,51CS021,612,594,630,669,39,57,75,163.36340958337271,69,196.74468337887606,-0.8061981210476383,-0.30312677861908605,0.18396900190350782,1.1836774156958414,748,726,770,890,120,142,164,336.3340533077098,109,257.9820595962226,0.26526792588706904,0.7936119916425745,1.3227993340132695,0.7616811444967723,42085,42251,Danville (city)+Pittsylvania,Danville (city),51,590,Virginia,VA
51053,51CS022,229,217,241,277,36,48,60,204.66766988501251,18,77.05204580316057,0.7864085110614465,1.276955986741592,1.7903396525401736,0.36876122651374194,283,269,298,371,73,88,102,314.20505546867594,42,150.48369759942673,1.1058268477656992,1.64501238691294,2.1568893697025397,0.47353486378280973,28033,27910,Dinwiddie+Petersburg (city),Dinwiddie,51,53,Virginia,VA
51730,51CS022,489,475,503,522,19,33,47,120.52009633559065,38,138.11903680145386,-0.7221595139980578,-0.1629974257811392,0.35636113762502303,1.1124743311605592,602,584,619,668,49,66,84,198.65663893369702,73,218.3732687187771,-0.7253983758686035,-0.1945296065345679,0.29145710260650803,1.0829426064307912,33015,33429,Dinwiddie+Petersburg (city),Petersburg (city),51,730,Virginia,VA
51059,51CS023,4547,4053,5040,5343,303,796,1290,83.2428373928485,688,71.90842128092102,-0.4013376892566727,0.11883708120203296,0.6351989154078735,0.8627558834379109,5720,5131,6309,6034,-275,314,903,27.52422614323098,423,37.0728731739638,-0.5827680297488189,-0.10359906994101074,0.3995743951048491,1.3426426638956872,1148127,1140996,Fairfax (county)+Fairfax (city)+Falls Church (city),Fairfax (county),51,59,Virginia,VA
51600,51CS023,217,207,227,217,-10,0,10,0.2268655101503294,15,74.92819381426132,-1.2998049028954601,-0.730810708877001,-0.25868846777525295,14.34834708111854,269,256,281,233,-48,-36,-23,-146.52080406072,19,78.33436404864976,-2.8030358067077574,-2.247710620798299,-1.7651494186728773,-0.5501088183655939,24023,24255,Fairfax (county)+Fairfax (city)+Falls Church (city),Fairfax (city),51,600,Virginia,VA
51610,51CS023,83,82,85,84,-1,1,2,5.417524400758995,10,82.06811653672547,-0.8890447236964636,-0.7667839474924156,-0.6433217582996275,6.02364153444611,102,101,104,99,-5,-3,-2,-23.831672826287505,3,20.666850372003307,-0.5770939306215095,-0.442944424909253,-0.31083929123031,-1.219806918590147,14622,14516,Fairfax (county)+Fairfax (city)+Falls Church (city),Falls Church (city),51,610,Virginia,VA
51061,51CS024,494,463,526,524,-2,30,61,49.13723135199595,23,37.917296331913725,-0.43150923009068276,0.09791486741476528,0.581089243000952,0.7466120308019931,615,577,653,708,55,93,131,125.82303853350635,58,78.71130592913268,-0.03848982830643265,0.46980875466287436,1.0015314786877165,0.6188962530532289,72790,73687,Fauquier,Fauquier,51,61,Virginia,VA
51063,51CS025,147,140,153,198,45,51,58,397.25598579626546,12,92.71779022599961,2.5518032215839557,3.062022830486892,3.5805714510594093,0.22894272587093825,180,172,188,213,25,33,41,212.38577684496175,15,96.44441586832123,0.6552154100180894,1.1752566686391432,1.6961156088793945,0.44075697530555413,15531,15553,Floyd+Giles+Montgomery,Floyd,51,63,Virginia,VA
51071,51CS025,198,191,205,244,39,46,53,328.04158373208855,13,93.27354260089685,1.8525870429962668,2.353080059567762,2.8438281593076282,0.2782486855400976,240,231,248,300,52,60,69,362.2572332950498,31,186.85955394816153,1.2711265960478968,1.7559734818767079,2.2767215984415556,0.5073776391006274,16725,16590,Floyd+Giles+Montgomery,Giles,51,71,Virginia,VA
51121,51CS025,554,511,597,604,7,50,93,60.46800300950641,54,65.25219773027078,-0.567394303941346,-0.026335355958654865,0.48120966628119277,1.0579771520352672,683,632,734,799,65,116,167,117.46438483512557,74,75.03244646333549,-0.0724157282739588,0.4455171328734628,0.9471004195764463,0.6333009770461379,99307,98624,Floyd+Giles+Montgomery,Montgomery,51,121,Virginia,VA
51069,51CS026,661,621,700,762,62,101,141,132.32712488299197,53,69.40503732157667,0.11850736889927714,0.6414260536251583,1.1395705667837848,0.5193562941136968,830,782,879,1026,147,196,244,209.30719664070895,132,141.27921911122527,0.15500178905021042,0.6709045143716292,1.1768265196286258,0.6715510133209832,91636,93432,Frederick+Winchester (city),Frederick,51,69,Virginia,VA
51840,51CS026,221,209,233,269,36,48,60,203.89304396653034,25,107.04727921498662,0.4629557312343102,0.9714012184890507,1.5537726877707834,0.5142179059429054,274,259,288,325,37,51,66,182.87978101400947,41,145.81925525482805,-0.13105660481382667,0.38870551202389514,0.892753715560844,0.7821396237948022,28025,28117,Frederick+Winchester (city),Winchester (city),51,840,Virginia,VA
51177,51CS027,849,788,909,982,73,133,194,114.13232102786787,71,60.76122692036142,0.06440111436320718,0.5192025432367102,1.0354512112947358,0.5284131146968258,1070,996,1144,1227,83,157,231,109.5823292706889,115,80.3022156428716,-0.21549682918414453,0.2867894850071873,0.8104218538845481,0.7281626033341708,140221,143209,Fredericksburg (city)+Spotsylvania,Spotsylvania,51,177,Virginia,VA
51630,51CS027,174,162,187,202,15,28,40,117.12608677291993,1,4.252755431123081,0.6155818687216909,1.1360178930797278,1.5892485147599293,0.03503704067282186,217,202,232,257,25,40,55,141.41169180839432,11,38.85141101260905,0.5194699318241943,1.043585307882546,1.5415518046916057,0.2680449551143605,28217,28313,Fredericksburg (city)+Spotsylvania,Fredericksburg (city),51,630,Virginia,VA
51079,51CS028,149,140,158,154,-4,5,14,29.870585625817036,5,29.22552362396493,-0.5547448217429509,0.003402863532130417,0.50606148786093,0.8182824785708155,187,176,198,236,38,49,60,234.69022642690027,37,176.9234447472864,0.10621130730781955,0.5742831610121552,1.102079320074091,0.7388065754084034,20530,20913,Greene+Louisa+Orange,Greene,51,79,Virginia,VA
51109,51CS028,314,297,330,341,11,27,44,86.76650879943836,14,44.4091990483743,-0.13703468752406198,0.4309922930114873,0.9776706586061777,0.49377243798446346,394,374,414,492,78,98,118,252.31538308490417,41,105.97327405722557,0.9791142384132306,1.4493123278320434,1.9779614775951886,0.41574434560276713,37830,38689,Greene+Louisa+Orange,Louisa,51,109,Virginia,VA
51137,51CS028,352,336,367,379,12,27,43,89.97248465329618,12,39.38946331856228,-0.04233664377261722,0.5155104447016503,1.0061938374765385,0.42238473745407495,438,418,457,472,15,34,54,93.03213344721213,52,140.26758739749675,-0.938564215308516,-0.44321186210069347,0.06732218033408749,1.4652480149397724,36558,37072,Greene+Louisa+Orange,Orange,51,137,Virginia,VA
51083,51CS029,403,388,418,494,76,91,106,322.2661282116794,64,226.52194431335536,0.46468849684956676,0.9556001242784713,1.4825102163433899,0.6952673326823217,492,475,510,613,103,121,138,357.8846185249565,70,207.33368876251407,1.0168113779107038,1.5042098645465483,2.0270737041666007,0.5745758167669734,33904,33762,Halifax+Mecklenburg,Halifax,51,83,Virginia,VA
51117,51CS029,393,380,406,443,37,50,63,198.66687393891772,51,201.66738063070486,-0.545561776685951,-0.019752458958838048,0.47617866705784806,0.9952929112385945,480,464,495,557,62,77,93,255.55628824764608,49,161.96205460434985,0.405226087947412,0.939971777020724,1.4797622990715895,0.6256703655235751,30347,30254,Halifax+Mecklenburg,Mecklenburg,51,117,Virginia,VA
51650,51CS030,1105,1047,1164,1250,86,145,203,126.71461778272928,73,63.992519595882854,0.10625968579038146,0.6221638028845484,1.1802369320042396,0.5015432548100763,1362,1291,1433,1624,191,262,333,190.03095377541933,179,130.0342883710118,0.09718016013657839,0.5982792811641042,1.1245811842565634,0.6816736168230016,136891,137656,Hampton (city)+Poquoson (city),Hampton (city),51,650,Virginia,VA
51735,51CS030,107,105,108,110,2,3,5,32.54856779704749,4,38.60382821296445,-0.1806746569121465,-0.05947897695714738,0.06643304976661799,0.9147929591605446,132,131,134,137,3,5,6,38.357016910199704,12,95.56422712431313,-0.6907111713276027,-0.5746679101786526,-0.4491348215697452,2.063099693194044,12434,12557,Hampton (city)+Poquoson (city),Poquoson (city),51,735,Virginia,VA
51085,51CS031,842,794,889,955,66,113,161,123.68540682374595,75,81.90455389319645,-0.054125806560348426,0.42076583191678807,0.9174808681842316,0.6564050024930677,1048,991,1106,1252,146,204,261,182.86628022700125,103,92.47288659053365,0.37038287218693583,0.9139902497984472,1.390417512245089,0.5032152583062411,109884,111384,Hanover,Hanover,51,85,Virginia,VA
51165,51CS032,641,605,677,788,111,147,183,211.08126876453113,76,109.1065703210987,0.48485557364890364,1.0331250867158348,1.5425432002819282,0.5134018979321132,792,749,836,1018,182,226,269,267.9831742577162,145,172.00270459425155,0.45431116705564534,0.984141230401379,1.4898313553989015,0.6390128473660445,83588,84301,Harrisonburg (city)+Rockingham,Rockingham,51,165,Virginia,VA
51660,51CS032,261,239,283,292,9,31,53,72.01137739455709,37,85.55242976607961,-0.6857151856720691,-0.13855596911792173,0.37482944332600426,1.1510801918966627,322,295,348,368,20,46,73,89.91477246862081,40,77.72121400536277,-0.40602445962817063,0.12091337158875896,0.6409117865551656,0.8461035602899724,51898,51466,Harrisonburg (city)+Rockingham,Harrisonburg (city),51,660,Virginia,VA
51089,51CS033,575,553,597,732,135,157,179,370.8600020712466,76,179.8178161599432,1.4322458844703028,1.9067123756886009,2.4284073665674373,0.4817933467890533,697,671,723,979,256,282,308,559.7249039847111,148,294.0825815681755,2.1191976231583016,2.652264375209349,3.1753999262632413,0.5235469574346386,50718,50326,Henry+Martinsville (city)+Patrick,Henry,51,89,Virginia,VA
51141,51CS033,221,214,229,273,44,52,59,353.4759745727673,32,218.56679378450679,0.8689494270532376,1.3545737074386957,1.8714139255364786,0.606614045898108,270,261,279,362,83,92,101,521.8361168231188,47,267.10616049102066,2.043613198849839,2.5561334418015935,3.0737117328336914,0.5063439340439931,17569,17596,Henry+Martinsville (city)+Patrick,Patrick,51,141,Virginia,VA
51690,51CS033,277,271,282,261,-21,-16,-10,-141.43492972400114,31,279.93076980961695,-4.715048589877168,-4.236950815557818,-3.71895099070587,-2.1142024159841353,339,332,346,295,-51,-44,-37,-326.0814550042558,57,422.1284159075761,-7.922344132942601,-7.464945934014792,-6.997435537388962,-1.324633239226958,13289,13503,Henry+Martinsville (city)+Patrick,Martinsville (city),51,690,Virginia,VA
51149,51CS034,231,213,250,243,-7,12,30,33.02831803017671,12,33.99995277784336,-0.5058105537951879,-0.0047910099109985844,0.5002466321936423,0.9480867504983542,289,267,311,364,53,75,97,174.15092145077261,48,111.88550383440946,0.11497207438128211,0.6237729239171512,1.1336437880062769,0.6339773268766602,42353,42901,Hopewell (city)+Prince George,Prince George,51,149,Virginia,VA
51670,51CS034,269,259,279,273,-6,4,14,20.53212642096133,19,99.47643979057592,-1.2803489528549685,-0.7843383693345848,-0.3171270467211698,3.860504806696014,330,319,342,426,84,96,107,413.31195646953654,62,268.22409690677046,0.9349882104655421,1.4533701197211082,1.963060786681616,0.6422404080935362,22920,23115,Hopewell (city)+Prince George,Hopewell (city),51,670,Virginia,VA
51095,51CS035,682,649,716,762,46,80,113,122.16022461877478,35,53.61519607843137,0.17742570542363925,0.7055840393909265,1.1744564095604795,0.4334569593017552,846,805,887,956,69,110,151,137.8534685436864,56,70.29171059898579,0.17108005141353452,0.6725928824140998,1.1881857056702496,0.5053006885021021,78336,79668,James City +Williamsburg (city),James City,51,95,Virginia,VA
51830,51CS035,69,68,71,84,13,15,16,114.04167453745079,4,31.172879594752562,0.7054747830971929,0.8322703961709088,0.9469843332645836,0.25586167032871,88,86,89,84,-5,-4,-2,-22.594644964087117,3,19.26906031215878,-0.5441922542078526,-0.41552363441773676,-0.2827453188553525,-1.191535203106241,15398,15569,James City +Williamsburg (city),Williamsburg (city),51,830,Virginia,VA
51033,51CS036,250,236,263,278,15,28,42,109.69900152730317,23,89.24529522084977,-0.33086601908408614,0.18557968623463272,0.7143661413299237,0.7857536438872211,311,294,327,377,50,66,83,212.29891589963484,38,121.52222577550367,0.38806792082943825,0.8967450917665347,1.4030437260722433,0.56391643285246,30926,31270,King and Queen and Nearby Counties,Caroline,51,33,Virginia,VA
51057,51CS036,111,110,112,132,20,21,22,233.19321529580446,5,56.396277845662176,1.6435484460385488,1.767708583170577,1.8926613940239365,0.23068559681232698,136,135,137,183,46,47,48,443.80322918875504,18,170.19667170953102,2.614955114898666,2.7336446581683327,2.8721347774266435,0.3754957363630364,10639,10576,King and Queen and Nearby Counties,Essex,51,57,Virginia,VA
51073,51CS036,362,345,378,417,39,55,72,172.66619459242455,13,40.46272760284277,0.7958014297008784,1.3208647309597847,1.8313554343170089,0.23019128493640575,448,428,468,497,29,49,69,126.04759806611769,56,143.54189629097993,-0.6883336831960292,-0.17811520132568873,0.32085213489702247,1.1160947969500559,38554,39013,King and Queen and Nearby Counties,Gloucester,51,73,Virginia,VA
51097,51CS036,74,74,75,93,18,19,19,337.7255263730078,5,90.10361916203634,2.3549683928063687,2.473790779116063,2.58809551583635,0.2532805872444437,91,90,92,102,10,11,12,163.17176088574018,5,75.1653638003608,0.7470012276547222,0.8815662188385882,1.0042660900788616,0.42179194729226194,6659,6652,King and Queen and Nearby Counties,King and Queen,51,97,Virginia,VA
51101,51CS036,148,141,156,152,-4,4,11,24.27902501822855,7,47.11160964666293,-0.7195483324071842,-0.23620712844276737,0.31971903113966404,1.5192757676911877,185,176,194,221,27,36,45,197.86892385147414,17,93.75689388925656,0.5322084353532368,1.0414066560262116,1.5737502430622357,0.460984529935747,17830,18132,King and Queen and Nearby Counties,King William,51,101,Virginia,VA
51115,51CS036,122,118,126,119,-7,-3,1,-43.14739507904685,10,140.12143858010273,-2.3544933300620645,-1.8303748905796384,-1.3287098109497133,-4.809343757397589,149,144,153,178,25,29,34,344.9244294818828,15,175.58234812126886,1.1591129861773497,1.70807439656178,2.202276508979254,0.49233768282263635,8564,8543,King and Queen and Nearby Counties,Mathews,51,115,Virginia,VA
51119,51CS036,141,137,146,162,16,21,25,233.6611269959196,4,45.155221072436504,1.3615272723056395,1.9008562298472014,2.3804656895951193,0.18434469711861035,174,169,180,212,32,38,43,351.723318354716,24,223.0897936419409,0.786611331185656,1.286943529272422,1.7985780423241704,0.6179452125717977,10630,10758,King and Queen and Nearby Counties,Middlesex,51,119,Virginia,VA
51105,51CS037,244,234,254,315,61,71,81,382.40864118570704,33,177.69002961500493,1.5457250903638589,2.055624352147733,2.539215882918264,0.45820822883264567,296,285,308,412,104,116,127,525.5987449212547,53,240.9309937267024,2.337066721775656,2.835550972611886,3.3669133775639337,0.45446277853733547,22286,21998,Lee+Norton (city)+Scott+Wise,Lee,51,105,Virginia,VA
51169,51CS037,277,267,286,302,16,25,35,140.64675993503297,37,206.14727458445535,-1.20601269004749,-0.6666282959871155,-0.17029332541152567,1.4098595281925166,337,326,348,392,44,55,66,258.0466740081653,56,261.2183972385484,-0.5438547178330158,-0.0067724535785643565,0.480437427266269,0.9943173701594815,21538,21438,Lee+Norton (city)+Scott+Wise,Scott,51,169,Virginia,VA
51195,51CS037,414,398,429,490,61,76,92,253.07738615154733,43,142.6005250794528,0.5721253636749182,1.1004912983380484,1.6069679410264992,0.5561780091750288,501,483,520,659,139,158,176,442.1456233969223,73,204.4760650962158,1.8517637927905652,2.3757781005111047,2.8875519229275532,0.45955185419694955,36185,35701,Lee+Norton (city)+Scott+Wise,Wise,51,195,Virginia,VA
51720,51CS037,43,43,43,58,15,15,15,482.8467434043169,3,96.72219236969372,3.7326740689105957,3.863884519913932,3.9880926841010718,0.18777818761949627,52,52,53,95,42,43,43,1170.8059465704748,13,354.4165757906216,8.047171434808305,8.167033604141816,8.296281544618534,0.2958232345221657,3722,3668,Lee+Norton (city)+Scott+Wise,Norton (city),51,720,Virginia,VA
51107,51CS038,1324,1142,1505,1543,38,219,401,62.379577780978835,162,46.06733318957039,-0.3536140644436397,0.17329705723835345,0.6648579550573188,0.7351489584451802,1697,1477,1918,1753,-165,56,276,13.062605582589361,130,30.454664717568125,-0.71894394128806,-0.16279864793484397,0.3346574216765627,2.2903630403466995,421991,426864,Loudoun,Loudoun,51,107,Virginia,VA
51683,51CS039,222,204,241,251,10,29,47,80.79865906245934,45,127.17852096090438,-0.997932369769605,-0.4573500551577893,0.05199381646239878,1.5208221404061548,278,256,300,288,-12,10,32,22.49963393766324,27,63.21556507691228,-0.88589865446473,-0.42314820830267613,0.11359442973759905,2.544812582367904,42460,42711,Manassas (city)+Manassas Park (city),Manassas (city),51,683,Virginia,VA
51685,51CS039,37,36,39,33,-6,-4,-3,-30.957713264004028,8,55.61670818608423,-0.9910157064945779,-0.8650195429302194,-0.7490181240930104,-2.3168198614589226,47,44,49,49,0,2,5,13.782395073566015,5,29.37375161555634,-0.27583436145915213,-0.1570599098377466,-0.029132598245730223,1.4943040315773157,17261,17022,Manassas (city)+Manassas Park (city),Manassas Park (city),51,685,Virginia,VA
51700,51CS040,1376,1297,1456,1599,143,223,302,144.43425622458813,94,61.013868755273805,0.2821012754738617,0.8237108403772059,1.3244754959817662,0.4205435908955089,1690,1594,1785,1974,189,284,380,153.8661031334521,201,108.7774175916355,-0.06501444338837994,0.4355415015415687,0.934032715887077,0.7044837170335232,184876,184781,Newport News (city),Newport News (city),51,700,Virginia,VA
51710,51CS041,1663,1561,1765,1896,131,233,335,117.37779722879816,123,61.963694984131244,0.07265641399646981,0.5590381973718861,1.072207796973698,0.5256436311882048,2030,1909,2152,2450,298,420,541,178.20829699994746,216,91.73766425713728,0.36393770930410724,0.8717697641736151,1.3650029076061532,0.5135538222998924,238204,235454,Norfolk (city),Norfolk (city),51,710,Virginia,VA
51139,51CS042,252,242,262,319,57,67,77,339.20738102905574,36,181.97135636057288,1.0564464583414181,1.5678628171311273,2.0833055253767747,0.528583700403617,309,297,321,358,37,49,61,205.1309792794798,53,222.78268179907525,-0.7577800675319227,-0.18501595914205624,0.38351519857992855,1.0642429243166909,23740,23790,Page+Shenandoah,Page,51,139,Virginia,VA
51171,51CS042,431,412,450,544,94,113,132,305.806395081058,62,168.30675262979304,0.8152240381427585,1.3725456909104836,1.9257475450085761,0.5455276679768352,534,511,557,639,82,105,128,234.9045954888709,103,230.5282005371531,-0.4907745090242579,0.06312617499480704,0.5632753039510954,0.9721073771591371,44205,44680,Page+Shenandoah,Shenandoah,51,171,Virginia,VA
51740,51CS043,914,872,956,1065,109,151,193,186.08484198481705,85,104.61967670468532,0.3526141320029951,0.810920931384456,1.337293945567498,0.5585207117717412,1116,1066,1167,1345,178,229,279,233.82193200048584,151,154.29260417305295,0.312031437369789,0.8123566662290189,1.3198499189555557,0.6570011443770448,97496,97866,Portsmouth (city),Portsmouth (city),51,740,Virginia,VA
51029,51CS044,146,139,153,174,21,28,35,197.36562084140718,23,163.51679601872146,-0.1822861030852528,0.3612481227115889,0.8805622784368342,0.7996907134318159,181,173,190,223,33,42,50,246.48316452644016,21,124.05482041587901,0.7222468788932772,1.2336462367391896,1.716507872326941,0.49151930150084605,16879,16928,Prince Edward and Nearby Counties,Buckingham,51,29,Virginia,VA
51037,51CS044,144,140,149,161,12,17,21,171.64940616165853,13,135.06493506493504,-0.16835002058925347,0.3589589724514184,0.8860820789332693,0.7419559697901124,176,170,182,236,54,60,66,525.7640109025546,32,279.3296089385475,1.9303574462358353,2.4655619839258565,2.957302214150905,0.5226066140519898,11550,11456,Prince Edward and Nearby Counties,Charlotte,51,37,Virginia,VA
51049,51CS044,83,82,84,102,18,19,20,232.5569373193516,8,98.9282769991756,1.216191013449557,1.336420777240878,1.457071283707528,0.4039158769545491,102,101,103,130,27,28,29,287.53785301783626,13,134.33915469670353,1.4007736536277602,1.52839099035637,1.657632454162435,0.45099680297116607,9704,9677,Prince Edward and Nearby Counties,Cumberland,51,49,Virginia,VA
51065,51CS044,209,197,221,223,2,14,26,61.548870138527576,14,61.48440931049626,-0.5202659293199413,0.015405232099389163,0.4882282179289339,0.9324209451076875,262,248,276,290,14,28,42,100.96517732893756,19,68.69621809241448,-0.22344016071989212,0.3401384133683437,0.8398323049750666,0.6568723826300841,27324,27658,Prince Edward and Nearby Counties,Fluvanna,51,65,Virginia,VA
51147,51CS044,199,190,209,222,13,23,32,122.94423765194182,17,92.71462982320593,-0.20322248072419052,0.3075570943870194,0.8116771339497446,0.7220875821153253,246,234,257,273,16,27,39,124.60363845230148,25,114.05109489051094,-0.4163941935205594,0.1252132792267783,0.609391846058904,0.8829829479907838,22003,21920,Prince Edward and Nearby Counties,Prince Edward,51,147,Virginia,VA
51153,51CS045,1768,1561,1975,2300,325,532,739,132.58224359454206,324,80.77786088257292,0.013404726402085856,0.5293701243334014,1.030610868252597,0.6081225132866864,2242,1992,2492,2644,152,402,652,83.0986081085675,274,56.585966267329454,-0.25206004108594066,0.26432746688760667,0.783909776181493,0.6792615151753456,481320,484219,Prince William,Prince William,51,153,Virginia,VA
51155,51CS046,385,370,399,452,53,67,82,238.16175754961074,47,166.88365487039886,0.18051359126236635,0.7158810703817223,1.2706027477625998,0.6904221878892022,471,454,489,580,91,109,126,322.1270149929631,60,177.7303830089754,0.9360936942292317,1.4359664086555115,1.9441528383486248,0.5467126854597364,33796,33759,Pulaski+Radford (city),Pulaski,51,155,Virginia,VA
51750,51CS046,102,100,103,103,-0,1,3,10.58318639691789,3,21.916473882868623,-0.23525590050253165,-0.11286076889822273,0.009429005137018458,1.2251589670957577,126,123,128,140,12,14,17,87.74582584826186,16,97.3295212604173,-0.21601864337351084,-0.09682870164679835,0.03839041555435947,1.0373083298709302,16426,16439,Pulaski+Radford (city),Radford (city),51,750,Virginia,VA
51760,51CS047,1575,1477,1673,1732,59,157,255,82.89533043421822,138,72.85557789519532,-0.4063183866082743,0.1094398605487776,0.6272712799271482,0.8733244143424653,1941,1824,2058,2299,241,358,475,157.88652969058634,224,98.84649668599468,0.06265769131383943,0.5928720856564027,1.142382729584517,0.6243154471824621,227299,226614,Richmond (city),Richmond (city),51,760,Virginia,VA
51770,51CS048,1042,1000,1085,1284,199,242,284,290.83939774635235,107,128.819953046933,1.1009144913646676,1.6245943411312793,2.0800515691312382,0.4410987792017296,1269,1218,1320,1468,148,199,250,201.36632066425813,117,118.1674948491092,0.29594436483647624,0.8304787965177349,1.3429834515772028,0.583899870120417,99674,99012,Roanoke (city),Roanoke (city),51,770,Virginia,VA
51081,51CS049,128,126,129,138,9,10,12,110.54184417503853,21,221.4022140221402,-1.2180361821769687,-1.1136778192428671,-0.98217699151981,1.8284888085405668,157,156,159,161,2,4,5,31.932613209031555,16,139.9702563205319,-1.2003623678422,-1.0761967097532057,-0.9544523173998931,3.4406996372876644,11382,11431,Southampton and Nearby Counties and Independent Cities,Greensville,51,81,Virginia,VA
51093,51CS049,314,297,330,352,22,38,55,119.17411800142716,27,84.07068164716262,-0.177011441949782,0.3444147554842806,0.8110000882954219,0.687481902274621,390,370,411,476,65,86,106,218.5849285487643,55,140.34908645503725,0.2649468061199545,0.7968217806163479,1.2660642063695833,0.634671076028161,38539,39188,Southampton and Nearby Counties and Independent Cities,Isle of Wight,51,93,Virginia,VA
51175,51CS049,159,151,167,194,27,35,43,234.53430399249527,33,220.82194836335248,-0.35783383072499814,0.14834765099868782,0.6701445897651338,0.9154156677738524,195,186,204,258,54,63,72,348.8954058321291,29,161.1290143349261,1.372648327363136,1.8777593770121848,2.3668491412085984,0.4545868152360922,17933,17998,Southampton and Nearby Counties and Independent Cities,Southampton,51,175,Virginia,VA
51181,51CS049,69,68,69,74,5,5,6,95.46228521496961,6,110.3617412630288,-0.2628558553518769,-0.14762718466630934,-0.03303714282401075,0.9693106178338009,85,84,86,101,15,16,17,249.3537852884477,3,45.92774035517453,1.9051097537512949,2.0351408268405042,2.1641802777661607,0.173532888198828,6524,6532,Southampton and Nearby Counties and Independent Cities,Surry,51,181,Virginia,VA
51183,51CS049,127,123,132,125,-7,-2,2,-26.536963287035604,17,188.62690707350905,-2.6262922051387223,-2.1447298072410255,-1.5888906250140291,-12.215769438678212,155,149,160,176,16,21,27,197.36567868945372,20,185.80453363062057,-0.3730757149517695,0.13025773954295128,0.628320047751232,0.8991010118828582,10815,10764,Southampton and Nearby Counties and Independent Cities,Sussex,51,183,Virginia,VA
51595,51CS049,51,50,51,110,59,59,60,1251.129189743133,21,444.7582068478644,7.939774754896932,8.063708208113322,8.183139754737066,0.34956799275224554,63,62,64,95,31,32,33,567.1275094622383,7,123.36975678533663,4.320300968738322,4.441073737792579,4.5547550805631065,0.21097799978282136,5666,5674,Southampton and Nearby Counties and Independent Cities,Emporia (city),51,595,Virginia,VA
51620,51CS049,118,117,119,132,13,14,15,206.1234645350876,20,295.1666461689829,-1.0061113891850735,-0.8876177090315926,-0.7571387162991734,1.3363104175491036,146,145,147,180,33,34,35,412.8689730291767,18,219.2448233861145,1.8059415844886721,1.9389858020865862,2.064621885532246,0.5158104102782209,8131,8210,Southampton and Nearby Counties and Independent Cities,Franklin (city),51,620,Virginia,VA
51179,51CS050,719,651,787,751,-36,32,100,24.49299700630841,36,27.44826446911117,-0.5277466182778348,-0.04417713734944707,0.5128273359387896,1.0868254486233653,915,832,998,1028,30,113,196,70.52836474480287,87,54.239401496259354,-0.36427620705301816,0.15723371458461258,0.6780428797231476,0.762305336122273,157387,160400,Stafford,Stafford,51,179,Virginia,VA
51800,51CS051,685,644,725,838,113,153,194,194.6886063250759,83,105.40686414579166,0.36267129802407444,0.8870282218743155,1.4247560119226745,0.5379038279833388,855,805,905,1062,157,207,257,215.71062609801118,140,145.87284056098525,0.20836747376986287,0.690024910340733,1.2429373265682548,0.672992422758851,94491,95974,Suffolk (city),Suffolk (city),51,800,Virginia,VA
51099,51CS052,170,158,181,196,15,26,38,117.74356193313817,16,71.36750548265992,-0.08605668504440835,0.4565566286587744,1.0292154171130272,0.5840028752209497,216,202,230,201,-29,-15,-1,-54.93075620556498,17,62.06871371718573,-1.7285869751219693,-1.1782734688408965,-0.62661381163624,-1.2103964668762868,26903,27389,Westmoreland and Nearby Counties,King George,51,99,Virginia,VA
51103,51CS052,189,185,194,196,2,7,11,74.08922924610766,5,55.20287054926856,-0.32920159187552617,0.1841215367799257,0.7202771746841745,0.6484552809131195,231,226,237,241,4,10,15,87.00247227006803,17,155.60640732265446,-1.188997495634323,-0.6879324258245061,-0.17219397416172327,1.6182739152754455,10869,10925,Westmoreland and Nearby Counties,Lancaster,51,103,Virginia,VA
51133,51CS052,154,149,160,177,17,23,28,227.46040207034426,12,121.08980827447022,0.5423452223052002,1.0602201648875809,1.5615345523996023,0.5097418929979887,191,185,197,245,48,54,60,449.1000997727103,28,233.3138905091242,1.6387522428605041,2.153767365029355,2.6449033527693144,0.510050704202463,11892,12001,Westmoreland and Nearby Counties,Northumberland,51,133,Virginia,VA
51159,51CS052,106,105,107,106,-1,-0,1,-0.9158841828998884,5,67.03161657915317,-0.7903690620501891,-0.674726074039815,-0.553427919488503,5.366634100351677,131,130,132,132,-0,1,2,11.256091853177834,10,111.07408641563923,-1.1335073615897768,-0.9976506494933928,-0.877619010070418,4.966757616579553,8951,9003,Westmoreland and Nearby Counties,Richmond (county),51,159,Virginia,VA
51193,51CS052,214,206,221,230,9,16,24,107.01845493491291,16,104.05376110990677,-0.48120099699157115,0.03939842516818293,0.5378497754252533,0.9165970532270105,265,256,275,257,-18,-8,1,-44.146565613115435,28,149.7566454511419,-2.434017414688523,-1.940963092483589,-1.4328018775003564,-3.859894980727151,18452,18697,Westmoreland and Nearby Counties,Westmoreland,51,193,Virginia,VA
51199,51CS053,401,371,431,453,22,52,82,89.66367480549688,21,35.997942974687156,0.02369950435677843,0.5233320869256811,1.081406604697977,0.39394599483665316,504,467,540,628,88,124,161,175.28940206426557,63,88.97802384046099,0.32973043398820656,0.8729348604389575,1.345630576503041,0.5035491895812625,70004,70804,York,York,51,199,Virginia,VA
53001,53CS001,110,108,112,110,-2,0,2,1.3203816494246012,18,105.30421216848674,-1.161721113127927,-1.0398950601977661,-0.9209058902368674,14.685518953937352,136,133,138,155,17,19,22,93.78627287429413,18,87.29812309035356,-0.06950946598216445,0.06669217930661275,0.19049484894151647,0.8850518458701987,20512,20619,Adams+Grant,Adams,53,1,Washington,WA
53025,53CS001,614,571,657,710,53,96,139,115.83494660490395,82,99.13658482525162,-0.3168460328733011,0.15546521381265918,0.6638409634940372,0.8470032181815813,763,712,815,912,97,149,200,148.36304710752952,120,119.80711055201127,-0.20115616229973643,0.28487787433147105,0.8007200708876093,0.8021287876997517,99257,100161,Adams+Grant,Grant,53,25,Washington,WA
53003,53CS002,217,208,227,266,39,49,58,260.47732640966535,22,118.0732590902992,0.9100673585542185,1.4094637751519068,1.9639136001438275,0.444144419565747,266,255,278,290,12,24,35,106.01462290206703,29,129.57419239533533,-0.7565597574333374,-0.2231371284739775,0.28650653289801237,1.1728007566098664,22359,22381,Asotin+Columbia+Garfield+Whitman,Asotin,53,3,Washington,WA
53013,53CS002,48,47,48,52,4,4,5,132.05799803433547,3,90.70294784580499,0.294647929629572,0.4118047888781877,0.5341899137007554,0.5588862813019057,59,59,60,74,14,15,15,371.4018273699727,1,24.826216484607745,3.335298656051087,3.465414652196743,3.5951025087806148,0.06265638404362718,3969,4028,Asotin+Columbia+Garfield+Whitman,Columbia,53,13,Washington,WA
53023,53CS002,24,23,25,24,-1,0,1,7.532182503656001,5,261.55187445510023,-3.060359614334402,-2.5383103673072873,-2.023865175876105,4.370666726859662,30,28,31,32,1,2,4,100.8211099231112,5,213.85799828913602,-1.6474445051693847,-1.1226984785614726,-0.5659549714607641,1.4893374386015845,2294,2338,Asotin+Columbia+Garfield+Whitman,Garfield,53,23,Washington,WA
53075,53CS002,230,209,250,270,20,40,61,100.0655850031615,25,62.3208276205908,-0.12008446042387627,0.38627971754578294,0.9150707127049609,0.6076617480095332,285,261,310,396,86,111,135,231.32689089844803,44,91.9348098620978,0.8647143367774096,1.3841843946447865,1.8761448453717329,0.39386624934421677,48138,47860,Asotin+Columbia+Garfield+Whitman,Whitman,53,75,Washington,WA
53005,53CS003,1299,1210,1388,1520,132,221,310,128.2664739813256,149,86.34552698297719,-0.07691172846109734,0.42385156744244995,0.9382584818377204,0.6701453230826799,1618,1510,1726,1904,178,286,394,136.54022137724021,227,108.29274343206897,-0.21144679607914207,0.29711478171698985,0.8297971241206812,0.790358281187567,207075,209617,Benton,Benton,53,5,Washington,WA
53007,53CS004,616,582,650,653,3,37,71,55.61739955572842,40,60.819543346595374,-0.571186069181328,-0.06423447689086569,0.4920800993968519,1.0644345691989932,763,722,804,832,28,69,110,86.75773510183764,73,91.73274356300028,-0.5595438350816401,-0.07253296485161632,0.45699242959051284,1.0422476064298776,78922,79579,Chelan+Kittitas,Chelan,53,7,Washington,WA
53037,53CS004,268,249,288,302,14,34,53,89.24578754000883,29,77.0593445527015,-0.3434306487980919,0.11161355447490122,0.6491145057716569,0.8384855690827409,335,312,359,384,25,49,72,107.45690315157046,30,66.12881893929374,-0.12171302808738804,0.41538631697869915,0.9289812238503109,0.6030284246232844,45160,45366,Chelan+Kittitas,Kittitas,53,37,Washington,WA
53009,53CS005,895,861,928,917,-11,22,56,34.52815530717079,6,9.301965040114725,-0.26343415923584923,0.25286994040149907,0.762406395017908,0.2578258373032843,1105,1065,1145,1255,110,150,190,191.98273348470633,75,96.06270973691626,0.4743950541249077,0.9352278615510621,1.4867087705865791,0.497055445723761,77403,78074,Clallam+Jefferson,Clallam,53,9,Washington,WA
53031,53CS005,347,333,361,350,-11,3,17,10.058972902486495,3,10.907768755302389,-0.5095580291068985,-0.002685260801711007,0.47019769961606206,0.7964842447826027,432,415,449,448,-1,16,33,47.454920270610025,18,53.6928767450185,-0.5621671343023342,-0.06734340155787905,0.4599579668477395,1.0645352323647514,33004,33524,Clallam+Jefferson,Jefferson,53,31,Washington,WA
53011,53CS006,3225,3008,3442,3577,135,352,569,83.99240971603244,137,32.659029009720236,0.017380120480914307,0.49685204241605324,1.037715750585225,0.3877326376419608,4033,3769,4296,4646,350,613,877,120.14655411853846,409,80.12192637402246,-0.08840457328736791,0.38850867401901323,0.9358584188217545,0.6657827353725557,503383,510472,Clark,Clark,53,11,Washington,WA
53015,53CS007,1055,1007,1103,1084,-19,29,77,31.2641845698648,25,27.049446387997257,-0.4539631419892247,0.04107043620056525,0.5580907278558451,0.8362490125496104,1300,1242,1358,1588,230,288,346,258.4649464599244,229,205.49912057144908,0.043483086271568154,0.5173669309071085,1.0730233510508647,0.792324492490099,110908,111436,Cowlitz+Klickitat+Skamania+Wahkiakum,Cowlitz,53,15,Washington,WA
53039,53CS007,183,173,193,177,-16,-6,4,-30.62393345415736,5,26.353933324548688,-1.087236222500943,-0.5600376185138648,-0.05991063471688707,-1.0394738587529302,228,216,240,296,56,68,80,295.38109934679824,26,112.70536217434653,1.3443680918099625,1.8312853321801368,2.3269767304722633,0.3760406247689649,22767,23069,Cowlitz+Klickitat+Skamania+Wahkiakum,Klickitat,53,39,Washington,WA
53059,53CS007,82,81,83,86,3,4,5,37.27219511361005,7,69.66907190843493,-0.4410467966459237,-0.32296573105404214,-0.2085176969434681,1.47526078164627,102,101,104,105,1,3,4,22.349286550277295,2,16.46090534979424,-0.06396529508533619,0.06449945060481896,0.1943650360007295,0.5382944971696486,12057,12150,Cowlitz+Klickitat+Skamania+Wahkiakum,Skamania,53,59,Washington,WA
53069,53CS007,43,43,44,41,-3,-2,-2,-64.74332426320197,2,53.884149079479116,-1.3083913545963382,-1.186812680197853,-1.0705233117769488,-1.4254594616228895,55,54,55,68,13,13,14,293.3510533996224,2,43.84042086804033,2.3727510616063565,2.4907712217028326,2.616823034113504,0.13905619032622446,4454,4562,Cowlitz+Klickitat+Skamania+Wahkiakum,Wahkiakum,53,69,Washington,WA
53017,53CS008,267,249,286,283,-3,16,34,44.12810265600867,13,36.1881785283474,-0.4463238989174152,0.07284566338685576,0.6250974895812522,0.7714087248767927,333,311,356,387,31,54,76,122.9209642647803,42,96.3435335137863,-0.2677922073132976,0.2467960037453901,0.7715690760094724,0.7694257304148365,43108,43594,Douglas+Okanogan,Douglas,53,17,Washington,WA
53047,53CS008,385,366,403,413,10,28,47,80.88102784215147,33,93.80996375524128,-0.6588582460947529,-0.12613407754650777,0.41999636018951614,1.1204701085989819,474,452,496,563,67,89,111,208.37940612412513,76,178.57562442726567,-0.26580779352964506,0.314803310009663,0.8538364397247264,0.8474180206036152,42213,42559,Douglas+Okanogan,Okanogan,53,47,Washington,WA
53019,53CS009,67,67,68,85,17,18,18,292.40161747057886,6,99.15989533122158,1.8096907831890539,1.9359927536951258,2.0581340780991964,0.3209803246329005,83,82,83,133,50,50,51,695.0488136234719,12,165.31202644992422,5.168395633827578,5.298745439442195,5.420570513405868,0.23321986301637018,7261,7259,Ferry+Lincoln+Pend Oreille+Stevens,Ferry,53,19,Washington,WA
53043,53CS009,100,99,101,102,1,2,3,18.0907722650693,9,98.5851209493382,-0.9213661025714677,-0.8039691459645032,-0.6712226764691953,3.394258063881585,126,124,127,144,17,18,20,163.55895306852582,20,178.79492222420882,-0.27473981348734555,-0.15307648319580913,-0.025759268671517954,1.036500118982997,10955,11186,Ferry+Lincoln+Pend Oreille+Stevens,Lincoln,53,43,Washington,WA
53051,53CS009,141,135,146,144,-2,3,9,29.609794129872583,5,44.24778761061946,-0.6572181305241679,-0.15136543914480652,0.3605805279357826,1.1505078923586718,175,168,182,236,54,61,68,442.9728304559935,23,166.3412164605482,2.2410080193437567,2.7738189707016265,3.2559009213070707,0.36947878256505534,13560,13827,Ferry+Lincoln+Pend Oreille+Stevens,Pend Oreille,53,51,Washington,WA
53065,53CS009,408,388,428,432,4,24,44,61.9103642182561,21,54.13999054698577,-0.4445338522463928,0.07651884103503585,0.6026917330667309,0.8395299156051185,506,481,530,631,101,125,150,265.0360604536644,101,213.52614109638276,-0.022921325598418835,0.5234105015533751,1.061416502214732,0.7992738038463321,46546,47301,Ferry+Lincoln+Pend Oreille+Stevens,Stevens,53,65,Washington,WA
53021,53CS010,366,324,408,454,46,88,130,109.1152543163937,69,85.39427817082982,-0.24839997835369576,0.23338641590929837,0.8052884275778893,0.773829368221861,466,416,517,554,37,88,138,89.55015983698009,95,96.84588252084735,-0.5751329025297205,-0.08090486570068114,0.443033112098144,1.069298009730607,96962,98094,Franklin,Franklin,53,21,Washington,WA
53027,53CS011,756,723,788,800,12,44,77,70.39466990654749,28,44.323083620246145,-0.27248382060853044,0.2617020473997435,0.7827653516788129,0.6157896446392797,935,895,974,1133,159,198,238,258.6468991920095,116,151.2563403789232,0.5606242192214946,1.0924887251724646,1.602172324448306,0.5818651878886772,75807,76691,Grays Harbor+Pacific,Grays Harbor,53,27,Washington,WA
53049,53CS011,298,288,308,268,-40,-30,-20,-153.90706164440283,4,20.529489756640007,-2.2164839139377004,-1.7504013462193952,-1.2236126794093185,-0.13799047315312116,370,357,382,413,31,43,56,180.91347262859824,30,125.6386632046235,0.03892184245448021,0.5388342884355806,1.066889002306355,0.6787557746877968,23381,23878,Grays Harbor+Pacific,Pacific,53,49,Washington,WA
53029,53CS012,689,651,726,704,-22,15,53,21.2705644295313,30,41.49186298464801,-0.7383525119147826,-0.19822323635206607,0.2908881308586402,1.8315770736087857,851,806,896,907,11,56,101,63.88296650168637,41,46.9316972104257,-0.35510404991501765,0.1631810362118007,0.6201365757735628,0.7217191910341784,86764,87361,Island,Island,53,29,Washington,WA
53033,53CS013,11600,10625,12576,12136,-440,536,1511,28.35390346774233,973,51.50150984642175,-0.7219305527158376,-0.22116239650321312,0.262382640211905,1.8129971702034648,14326,13162,15491,15083,-408,757,1921,33.55270599256657,734,32.54613658735578,-0.4891589914648764,0.010034323085097384,0.5512129267277225,0.9687201616947794,2267118,2255260,King,King,53,33,Washington,WA
53035,53CS014,1972,1854,2091,2012,-79,40,158,17.357633082516365,41,17.88895756826528,-0.5405652524680268,0.0015557356886349086,0.4905691748225749,1.0053393682792797,2423,2281,2565,2649,84,226,368,82.4093193131754,192,69.94280718370915,-0.33357540048949086,0.11231466005589272,0.6337942722951386,0.8449892617383803,275030,274510,Kitsap,Kitsap,53,35,Washington,WA
53041,53CS015,816,781,852,863,11,47,82,68.11069079201397,31,45.14508319073797,-0.32116326403637047,0.23739807348067152,0.7076802951075193,0.6489440928144367,1016,973,1060,1132,72,116,159,137.36114615292556,145,172.3789483695329,-0.8486123629761513,-0.3470982546578971,0.15944524677656263,1.2441644898291513,82401,84117,Lewis,Lewis,53,41,Washington,WA
53045,53CS016,604,576,633,623,-10,19,47,33.63421577007899,13,23.520188161505292,-0.41761738642060336,0.10101493906799795,0.6318508175068526,0.663597388322157,751,716,786,875,89,124,159,184.31762287146051,75,111.30238632316278,0.23877744316656643,0.7266700563243976,1.2435175021945923,0.5990387249747711,66326,67384,Mason,Mason,53,45,Washington,WA
53053,53CS017,6022,5625,6418,6198,-220,176,573,22.961035808403132,304,39.62491025196794,-0.689869051165367,-0.1847837179252916,0.39213946757628,1.7160043572094787,7454,6976,7932,8226,294,772,1250,83.41344664399818,627,67.76268577999498,-0.3902350441829604,0.13100300784836774,0.7015519097594145,0.8113200632020018,920633,925288,Pierce,Pierce,53,53,Washington,WA
53055,53CS018,131,130,133,124,-9,-7,-6,-49.27643082847045,7,47.11953777977225,-1.0788127507484315,-0.9629135630075809,-0.8423015779281144,-1.1075205582054601,167,164,169,159,-10,-8,-5,-41.21062392951219,7,37.94243590438506,-0.9221161479402608,-0.7926911644733033,-0.6706123875101883,-1.0601325333347762,17827,18449,San Juan+Skagit,San Juan,53,55,Washington,WA
53057,53CS018,1063,1007,1119,1128,9,65,121,59.87367437561861,43,39.74060781565287,-0.36504598424764684,0.19740165692145373,0.7502785830546524,0.6536512683210278,1305,1237,1372,1535,163,230,298,176.27054254228653,96,73.52209109080744,0.504651136861691,1.0297779365226467,1.5342200542028201,0.41529364618520065,129842,130573,San Juan+Skagit,Skagit,53,57,Washington,WA
53061,53CS019,4825,4468,5182,5226,44,401,758,58.065057716274566,366,52.99477171343729,-0.44424203557916764,0.06681747462541772,0.5680082046030427,0.910408972600783,5994,5564,6424,6384,-40,390,820,46.81845738816822,348,41.78042227040577,-0.4309968710397438,0.0352705782988336,0.5680038251397069,0.8901095681328818,828761,832926,Snohomish,Snohomish,53,61,Washington,WA
53063,53CS020,4176,3944,4408,4498,90,322,554,71.80854824278254,289,64.3935806952947,-0.4467957233587377,0.07214410781688227,0.5980145479149143,0.8939658734058079,5174,4893,5456,5866,410,692,973,126.87188895347828,641,117.5583802986093,-0.4440369106873787,0.08264487751353448,0.6054086838786147,0.9252537437740613,538563,545261,Spokane,Spokane,53,63,Washington,WA
53067,53CS021,2063,1935,2190,2101,-89,38,166,15.636698466209355,57,23.180311646412132,-0.5912863430565979,-0.0630691428555236,0.4521453386470471,1.4448529691071534,2560,2406,2714,2910,196,350,504,117.59549479503876,201,67.52920386092343,0.005917371285745912,0.49927399169147496,0.9902111953696724,0.5726139852573177,295078,297649,Thurston,Thurston,53,67,Washington,WA
53071,53CS022,508,481,535,541,6,33,60,62.98603718682418,37,71.19377856169325,-0.5940879158642631,-0.07750116492348318,0.4591886313939277,1.096804290233324,624,591,656,711,55,87,120,139.1866807502189,63,100.53298439345099,-0.09665951379885633,0.3759646849056035,0.8872393149638402,0.7141017208852473,62365,62666,Walla Walla,Walla Walla,53,71,Washington,WA
53073,53CS023,1489,1391,1587,1570,-17,81,179,42.51316185965414,56,29.517312870339047,-0.4169805762155767,0.13831536142901413,0.5930174485492079,0.6858070818188429,1845,1727,1963,2082,119,237,355,103.87510016266192,129,56.428471444568864,0.01106022101126471,0.48521584398496775,0.9834650061370024,0.5409558310062867,227663,228608,Whatcom,Whatcom,53,73,Washington,WA
53077,53CS024,1765,1655,1875,2127,252,362,472,169.97017068675225,303,142.16730855701746,-0.2070576919476444,0.2646287436758676,0.7510569749084683,0.8341224729150863,2176,2043,2308,2537,229,361,494,141.07856680108563,308,120.26176456807285,-0.2699551101888999,0.20412388942630658,0.7256360280524154,0.8500925400706768,255755,256108,Yakima,Yakima,53,77,Washington,WA
54001,54CS001,155,149,162,211,49,56,62,428.3876179564918,12,92.34913102032964,2.841441006837367,3.3500414530683145,3.91327591933907,0.2117694356033506,189,181,197,266,69,77,85,495.9456447450047,35,226.33212622866012,2.191053495271065,2.702167966040157,3.2068232204288396,0.4504908351659628,15593,15464,Barbour+Pocahontas+Randolph+Tucker,Barbour,54,1,West Virginia,WV
54075,54CS001,84,83,85,99,14,15,16,228.95460598712663,3,45.51776457200658,1.719496081296911,1.8337068803153702,1.9479935421889667,0.18645102085127158,102,101,103,136,33,34,35,428.0923349999608,14,178.52588625350674,2.3714495098064594,2.4971421070785618,2.621653101762447,0.4049636872292041,7909,7842,Barbour+Pocahontas+Randolph+Tucker,Pocahontas,54,75,West Virginia,WV
54083,54CS001,300,288,312,323,11,23,35,97.54465895415751,4,17.163698777086463,0.29034358194010196,0.7957748285283007,1.3144577432812248,0.16854323569589738,366,351,380,472,92,106,121,382.3001516027439,55,197.7492539459965,1.3674910844276673,1.8432707525254155,2.4208263287023395,0.5124423749492979,27966,27813,Barbour+Pocahontas+Randolph+Tucker,Randolph,54,83,West Virginia,WV
54093,54CS001,76,76,77,101,24,25,25,438.2422575307976,4,70.96392667060911,3.5553951437540605,3.6737003111714026,3.796799939812109,0.15562836650608702,93,92,94,115,21,22,23,332.90124193463663,24,359.0664272890485,-0.38906905829553634,-0.2629930095111372,-0.14101593780595825,1.0322083848410677,6764,6684,Barbour+Pocahontas+Randolph+Tucker,Tucker,54,93,West Virginia,WV
54003,54CS002,958,905,1011,1158,147,200,253,196.04955377769954,65,63.63814372429997,0.8336195772026834,1.3103262120137986,1.8331878800765777,0.32298936820458696,1204,1139,1269,1515,246,311,376,247.73562910876024,186,148.1233724347182,0.47985486521724635,0.9778472107666064,1.5641084198173436,0.595993182384051,122568,125571,Berkeley+Morgan,Berkeley,54,3,West Virginia,WV
54065,54CS002,186,179,194,203,9,17,24,115.59779397746966,4,27.94271742926999,0.3417044919756265,0.8741422480420808,1.419924396587291,0.22794848823508018,229,220,237,281,44,52,61,305.08376881881077,48,279.16715133185994,-0.24823510617030314,0.25114786339769846,0.7575203704309534,0.8979330163816812,17178,17194,Berkeley+Morgan,Morgan,54,65,West Virginia,WV
54005,54CS003,273,263,282,298,16,25,35,139.87583757420455,14,77.70942226744994,0.07468207003355443,0.6041458512262498,1.126512521721011,0.5343552695475715,331,320,342,396,54,65,76,304.56722577643984,35,163.77333770062233,0.8565320827832142,1.4218527193887027,1.9057490132767092,0.52958839232677,21619,21371,Boone+Lincoln+Logan,Boone,54,5,West Virginia,WV
54043,54CS003,242,233,251,271,20,29,38,170.87973819734154,11,64.92228998622859,0.5354848487787432,1.0748124899992793,1.5627504841306996,0.36724540083598106,295,285,306,378,72,83,93,410.7970921504881,46,228.20856278216004,1.3145411752441187,1.8385651997364492,2.379326633253111,0.5488973913201096,20332,20157,Boone+Lincoln+Logan,Lincoln,54,43,West Virginia,WV
54045,54CS003,467,453,481,518,37,51,65,190.16671008912914,56,207.76651001731386,-0.6524854831808162,-0.17829436768257323,0.3494865729221898,1.0716417941232317,565,548,581,700,119,135,152,422.1807987724309,77,240.69269482041824,1.2837351365273826,1.819174599778116,2.3504211151937318,0.5659273820815229,32344,31991,Boone+Lincoln+Logan,Logan,54,45,West Virginia,WV
54007,54CS004,138,132,143,153,10,15,21,145.349920173252,4,38.12246842983083,0.5468181528731798,1.0711731395044055,1.5988757578969368,0.24614111688376075,165,158,171,209,38,44,51,360.601275545172,22,179.3429526371566,1.3193118915106734,1.8027230668590821,2.3667800973313815,0.4863495124913784,12591,12267,Braxton+Gilmer+Lewis+Upshur,Braxton,54,7,West Virginia,WV
54021,54CS004,69,68,70,80,10,11,12,177.07634220970073,1,16.103059581320448,1.4836575956258442,1.6089375660708019,1.7318648316831544,0.08335805697721602,84,83,85,90,5,6,7,82.28931262697765,13,176.2233970448692,-1.0670556337096198,-0.9438881407392499,-0.8160286527317525,1.8386298007160322,7452,7377,Braxton+Gilmer+Lewis+Upshur,Gilmer,54,21,West Virginia,WV
54041,54CS004,209,202,217,214,-3,5,12,32.94204767351364,5,35.64638783269962,-0.5451673374590619,-0.037419893752882225,0.45102289616017177,0.8895734697855469,255,246,264,344,80,89,98,527.1787233281274,59,348.9266071322964,1.2405565730527568,1.7886398184051795,2.2883964270301167,0.654532664071158,16832,16909,Braxton+Gilmer+Lewis+Upshur,Lewis,54,41,West Virginia,WV
54097,54CS004,224,213,234,255,21,31,42,157.67537565855605,8,40.23301621893466,0.6682989138016201,1.1591503895497255,1.6837212379764668,0.24727659993896164,273,260,285,345,60,72,85,303.65356101975294,61,256.4102564102564,-0.027942538529266894,0.4809518503932133,0.9543444587444315,0.8328875090554888,23861,23790,Braxton+Gilmer+Lewis+Upshur,Upshur,54,97,West Virginia,WV
54009,54CS005,275,266,285,350,65,75,84,400.76635293920674,37,198.61328561842987,1.5265955032655123,2.0243530797194085,2.5521067770596257,0.48903354285933626,333,321,344,427,83,94,106,424.8208514995632,57,256.89561925365064,1.1834720465988955,1.669339040602535,2.1832838739698213,0.598367084376927,22355,22188,Brooke+Hancock,Brooke,54,9,West Virginia,WV
54029,54CS005,362,350,374,452,78,90,102,373.1220110954254,63,261.1038198521793,0.5767756542864341,1.136178861013261,1.6439358879784787,0.6920938081153001,437,423,452,522,70,85,99,294.88411101695567,84,292.59117349959945,-0.48560751081821074,0.04449059560595649,0.5391817511577357,0.9806407571707416,28954,28709,Brooke+Hancock,Hancock,54,29,West Virginia,WV
54011,54CS006,1100,1059,1140,1171,31,71,112,91.42712319149041,95,121.61945911345815,-0.7989738133772181,-0.31337887446491003,0.2377586375303676,1.3118645710685084,1341,1293,1389,1559,170,218,266,233.0933476333692,154,164.66537643146606,0.18131622960917632,0.6730052629103987,1.2134947855768725,0.7032095394126054,93735,93523,Cabell,Cabell,54,11,West Virginia,WV
54015,54CS007,96,95,96,112,16,16,17,245.07610409054814,6,89.25251022685013,1.4387518502282373,1.5601172982738716,1.6818414460454134,0.3433429024829183,115,114,116,155,39,40,41,504.82852619539,20,252.87646984448097,2.3994831283417732,2.5186618117799813,2.6354904303143685,0.4886762935201013,8067,7909,Clay+Fayette+Nicholas+Webster,Clay,54,15,West Virginia,WV
54019,54CS007,518,500,535,574,39,56,74,165.8113485676776,39,115.19999999999999,-0.004171842720544001,0.5089668065556398,1.0427912864567126,0.6826052029868441,627,607,648,787,139,160,180,399.16772663511136,82,205.05126281570395,1.4130447765327119,1.9503959974256477,2.4666102349134342,0.5104989275385923,40625,39990,Clay+Fayette+Nicholas+Webster,Fayette,54,19,West Virginia,WV
54067,54CS007,284,274,295,291,-4,7,17,33.52660127244909,4,19.587039908593816,-0.4076452324406673,0.15062397050074625,0.6791001116109339,0.5097690381993577,347,334,359,427,68,80,93,329.1598791705672,70,287.6751736325155,-0.06052891305831908,0.427634942617011,0.9540243222857103,0.8631907584621027,24506,24333,Clay+Fayette+Nicholas+Webster,Nicholas,54,67,West Virginia,WV
54101,54CS007,105,104,106,103,-3,-2,-1,-26.720043104551333,8,115.67658754066755,-1.5418247996993948,-1.4241840022616692,-1.2963365699787393,-9.434923027418565,128,127,129,151,22,23,24,276.4706530340205,26,314.7318726546423,-0.5146628822701633,-0.38354246173958373,-0.2596530700353658,1.0906387659255732,8299,8261,Clay+Fayette+Nicholas+Webster,Webster,54,101,West Virginia,WV
54025,54CS008,408,394,422,472,50,64,78,231.48985137571935,41,148.65395655195334,0.31197649606222666,0.8249966190363638,1.3302421024392836,0.6322591241875167,495,478,512,641,129,146,163,447.03375931901456,78,238.92666789193163,1.5324018543471762,2.0670936017716985,2.581966304604543,0.5308338190243815,33097,32646,Greenbrier+Monroe+Summers,Greenbrier,54,25,West Virginia,WV
54063,54CS008,148,142,153,183,30,35,41,339.69110915727384,16,153.95718065912914,1.326771006411435,1.8604085207800818,2.3517148198000886,0.4407422278599887,180,174,186,227,41,47,53,381.37450559964867,18,145.96172559195588,1.8657423095117998,2.3494592354963375,2.8704517980214943,0.3747571571236769,12471,12332,Greenbrier+Monroe+Summers,Monroe,54,63,West Virginia,WV
54089,54CS008,163,158,168,187,19,24,29,242.74702703128827,10,99.95835068721365,0.9056973331396987,1.442367133047777,1.9368669534719978,0.39549425790573034,198,192,204,255,51,57,63,478.07987764603865,23,193.1312452766815,2.3581998460697013,2.8631782724483985,3.3699568373143145,0.39699983682167317,12005,11909,Greenbrier+Monroe+Summers,Summers,54,89,West Virginia,WV
54023,54CS009,129,125,134,143,9,14,18,148.93737372224894,22,239.23878568192112,-1.3986059325877875,-0.9061979487363989,-0.40898809639443406,1.4970026612735436,158,152,164,176,12,18,24,164.0576941883273,27,245.92403679752255,-1.3262978968477641,-0.8127069882926647,-0.28765103494625666,1.420163590863181,11035,10979,Hardy and Nearby Counties,Grant,54,23,West Virginia,WV
54027,54CS009,238,228,247,268,21,30,40,158.25496697578544,23,119.41331718080735,-0.1589560524296488,0.36929055904516556,0.9314484635620469,0.7305941774872707,294,282,306,349,43,55,67,237.7985422026478,46,197.69640708268867,-0.11626439463794291,0.3898292346786135,0.8928140870676026,0.8166023813644162,23113,23268,Hardy and Nearby Counties,Hampshire,54,27,West Virginia,WV
54031,54CS009,150,144,157,171,14,21,27,173.98656377964267,9,76.21198221720415,0.45109252052016163,0.9584624437909458,1.4630980995065506,0.4177039009809329,184,177,192,207,15,23,30,159.8577248990917,36,254.0220152413209,-1.4411036323901494,-0.9522630987981214,-0.43237382178838957,1.5218746157921124,14171,14172,Hardy and Nearby Counties,Hardy,54,31,West Virginia,WV
54057,54CS009,287,276,299,353,54,66,77,294.2923109129783,70,312.51162617656905,-0.6807258724228207,-0.18002815885782472,0.3217825951605096,1.0460403417684867,352,338,366,429,63,77,91,286.5730355508684,69,256.88756515264333,-0.18076579556076755,0.2973719867035297,0.7970062397326235,0.8849158322715763,26879,26860,Hardy and Nearby Counties,Mineral,54,57,West Virginia,WV
54071,54CS009,73,73,74,100,26,27,27,508.4875583444706,0,0,4.959056877078516,5.085042383257275,5.213451463637796,0,89,88,89,114,25,25,26,413.55110218829725,10,162.83992835043153,2.3785075820974217,2.5079509618158604,2.6260941831523383,0.37884279398263,6255,6141,Hardy and Nearby Counties,Pendleton,54,71,West Virginia,WV
54033,54CS010,715,686,743,724,-19,9,38,17.144695868437335,27,49.138558602281,-0.8903322660371996,-0.3168737140518659,0.15798768337945898,2.591061689955759,865,831,898,1082,184,217,251,333.3106847006857,149,228.36298986926604,0.5716105261798388,1.0477704691158625,1.5749174970938415,0.6819995344615352,65936,65247,Harrison+Taylor,Harrison,54,33,West Virginia,WV
54091,54CS010,172,165,179,209,30,37,44,264.95072148765973,10,71.94244604316546,1.4191002807687816,1.930653637876657,2.443997170073095,0.264353396192716,208,200,217,257,40,49,57,294.0851521526816,35,211.8387604406246,0.2880797121806892,0.8078187451028751,1.3341722573600607,0.7058052646956339,16680,16522,Harrison+Taylor,Taylor,54,91,West Virginia,WV
54013,54CS011,70,69,71,86,15,16,17,301.2203089312166,3,56.91699604743082,2.3242883713046054,2.4413267610705986,2.5681708538409187,0.1777586014440827,84,83,85,125,40,41,42,660.3888889086567,5,80.9192425958893,5.672418182744445,5.7946107035196155,5.930728261873271,0.11960168969196815,6325,6179,Jackson and Nearby Counties,Calhoun,54,13,West Virginia,WV
54035,54CS011,305,293,317,347,30,42,54,179.7439876658822,28,120.55974165769643,0.07355190064585201,0.5877951321740774,1.1145645708618774,0.6550390814168655,375,360,389,452,63,77,92,278.88025536827917,62,223.52008075564208,0.026704725312271957,0.5584620371946764,1.037476867351881,0.7912623680504904,27870,27738,Jackson and Nearby Counties,Jackson,54,35,West Virginia,WV
54053,54CS011,297,286,308,332,24,35,46,163.99573726308537,22,103.47665895817818,0.1254486604588264,0.603931687914198,1.1389710684623868,0.6133795869234228,362,349,375,483,108,121,134,482.07983892647866,54,214.40482807909157,2.135892073716628,2.6795252973374093,3.1750402618804183,0.4411165442136738,25513,25186,Jackson and Nearby Counties,Mason,54,53,West Virginia,WV
54087,54CS011,180,174,186,170,-16,-10,-4,-89.27359749872296,5,43.10035198620788,-1.858681433286654,-1.3244346519371766,-0.8188962300624647,-0.5343889292278236,221,213,228,228,0,7,15,52.78485262059381,22,158.15959741193387,-1.586764054793233,-1.0386523415212416,-0.5264222030369093,2.637139336883366,13921,13910,Jackson and Nearby Counties,Roane,54,87,West Virginia,WV
54105,54CS011,48,48,49,53,4,5,5,110.15493343832296,7,159.7565614302016,-0.6149519540372648,-0.4932996462030367,-0.3777634226636757,1.201382207360073,57,57,58,86,28,29,29,564.4751952167167,13,255.90551181102362,2.9530663010506393,3.082250589271558,3.2088969094355075,0.43807417324809506,5258,5080,Jackson and Nearby Counties,Wirt,54,105,West Virginia,WV
54037,54CS012,430,405,455,505,50,75,100,155.69501655223004,36,74.81555886529735,0.31329919280042473,0.8261609996929365,1.3195340088667011,0.47419679824749283,534,504,564,604,40,70,100,119.50147265336899,66,113.25222643581516,-0.4536599992076945,0.06974583249620055,0.5844889935434541,0.9342900604593868,57742,58277,Jefferson,Jefferson,54,37,West Virginia,WV
54039,54CS013,2135,2058,2213,2484,271,349,426,233.00867903004453,189,126.28906162995301,0.5305200843072728,1.0560135805863868,1.5641515096404859,0.5404431292711486,2589,2497,2681,3092,411,503,595,282.3822012757456,303,169.97834599288672,0.6284263672135322,1.1051495003926814,1.6170230713601221,0.6007508024715537,179588,178258,Kanawha,Kanawha,54,39,West Virginia,WV
54047,54CS014,285,277,293,309,16,24,32,153.13253041917028,5,32.14400514304082,0.7423927954011329,1.1882087531677317,1.749976548389613,0.20145234971018638,342,333,352,420,68,78,87,421.6381373992421,60,325.3090435914118,0.47462387681966334,0.9803137009992067,1.4761424294215704,0.7617409217156046,18666,18444,McDowell+Mercer,McDowell,54,47,West Virginia,WV
54055,54CS014,754,729,780,884,104,130,155,262.562520771581,50,101.12757243262374,1.0937345957360525,1.5979797293865903,2.164288925337415,0.38221193502726375,919,888,949,1150,201,231,262,390.8501973280182,149,251.9019442096365,0.8736393383262399,1.3901408034666984,1.9286186897112425,0.6417216629883022,59331,59150,McDowell+Mercer,Mercer,54,55,West Virginia,WV
54049,54CS015,602,578,626,608,-18,6,30,12.743356727744935,18,38.4827807372303,-0.758866602572457,-0.2587459537982826,0.2503436763960101,2.5859843700837795,734,705,763,868,105,134,163,239.214479451084,118,210.6240182778809,-0.21411951266117785,0.3007869616790815,0.8266222595485553,0.8739606536118462,56129,56024,Marion,Marion,54,49,West Virginia,WV
54051,54CS016,331,318,344,398,54,67,80,263.3707061808321,58,228.75172549792939,-0.13817799879735002,0.3520066458468807,0.8394745529748762,0.8557394122313003,402,386,417,501,84,99,115,328.56824350569207,76,251.9643271557869,0.24007807124515362,0.7696244660287768,1.2951325188282767,0.75919495507039,30426,30163,Marshall+Ohio,Marshall,54,51,West Virginia,WV
54069,54CS016,499,481,517,600,83,101,119,288.23177219106304,47,133.9031339031339,1.0151070262119157,1.5433411521032065,2.079120718961943,0.4600205351408136,605,583,627,715,88,110,132,262.901625734514,73,174.44500203120893,0.37744122064643626,0.9038465588805629,1.397826571996431,0.6575602479791474,42120,41847,Marshall+Ohio,Ohio,54,69,West Virginia,WV
54059,54CS017,294,284,304,337,33,43,53,218.52381481970008,25,128.21060729090985,0.3758090216820662,0.9031251788869497,1.4112864749714698,0.5732587690619331,356,344,368,488,120,132,144,573.3015224422065,89,385.76567985783015,1.3977516582612508,1.8895966851667658,2.352562000373749,0.6678352821488924,23399,23071,Mingo+Wayne,Mingo,54,59,West Virginia,WV
54099,54CS017,438,421,455,527,72,89,106,274.92511832036587,29,89.4578545538675,1.3630330439531586,1.8666326280004633,2.4211699365037247,0.3217794171632324,534,514,553,704,151,170,190,442.15158094948634,88,228.2986561510922,1.6078730848175953,2.1497056385758118,2.661368010429315,0.5133238202667807,38901,38546,Mingo+Wayne,Wayne,54,99,West Virginia,WV
54061,54CS018,606,560,652,671,19,65,111,73.48315536305479,33,37.35214774849553,-0.1434261885637905,0.3768783691444487,0.8624521839895355,0.5005981158119823,749,694,804,827,23,78,133,73.12094525108519,99,93.11687578773115,-0.7054534512483465,-0.19347309240911253,0.30295667164442397,1.2572909129739078,106018,106318,Monongalia+Preston,Monongalia,54,61,West Virginia,WV
54077,54CS018,320,305,335,343,8,23,38,81.1964415463287,36,126.71222831666323,-0.9615170179927005,-0.4536485360973744,0.04660559398733475,1.4957256100606107,392,375,410,481,71,89,106,257.8475123043192,78,227.19990678978183,-0.251234187530183,0.31613313630016493,0.804414053119783,0.8712978134995362,34093,34331,Monongalia+Preston,Preston,54,77,West Virginia,WV
54079,54CS019,528,504,553,595,42,67,91,139.56655969432802,54,113.1798651622594,-0.24844944224068188,0.2728581415539482,0.7980628345109567,0.7989402886844995,648,619,678,733,55,85,114,147.61099572759747,62,108.24022346368714,-0.10219347527570595,0.389375904846951,0.8913455815308491,0.7247090140680512,57254,57280,Putnam,Putnam,54,79,West Virginia,WV
54081,54CS020,900,868,932,1019,87,119,151,192.285328643789,28,45.29034345177117,0.9967832748393792,1.4753004606345856,1.9876797062550038,0.23357235633700962,1093,1055,1131,1351,220,258,296,349.57241277503744,140,189.56062555006432,1.0900474609614204,1.595960370472963,2.070299885267973,0.5401720025502278,74188,73855,Raleigh+Wyoming,Raleigh,54,81,West Virginia,WV
54109,54CS020,270,261,280,319,39,49,58,275.3755199143259,23,130.3793282630261,0.9249274442448449,1.4663616098800685,1.9474194373491054,0.46391042615542954,328,317,339,408,69,80,91,380.66004627606793,58,274.99881466028165,0.5652679593984077,1.073743038640734,1.5705282329671464,0.7135386923501033,21169,21091,Raleigh+Wyoming,Wyoming,54,109,West Virginia,WV
54017,54CS021,64,63,65,78,13,14,15,213.66527295477871,2,30.464584920030468,1.7177962176838415,1.8289853767282178,1.9636724671378067,0.13309265594338862,77,76,78,94,16,17,18,214.64739166393733,12,154.99870834409714,0.4784746397491767,0.5949734751103148,0.7221019621286359,0.6811215391205159,7878,7742,Tyler and Nearby Counties,Doddridge,54,17,West Virginia,WV
54073,54CS021,83,82,84,88,4,5,6,74.76384467473416,7,110.38107752956635,-0.4804117861722167,-0.355854777273037,-0.2436752005022337,1.2192416219439124,102,101,103,123,20,21,22,274.2782270909725,19,249.73711882229233,0.11655534441018227,0.24350317066850502,0.375969761312149,0.8688857162691831,7610,7608,Tyler and Nearby Counties,Pleasants,54,73,West Virginia,WV
54085,54CS021,90,89,91,113,22,23,24,320.0741414837243,5,69.81615080288573,2.3801269932587634,2.5043210864261005,2.624474949924919,0.2090070055910667,108,107,109,146,37,38,39,453.7307000898166,16,190.72595064966026,2.508051452024457,2.6329523440929554,2.753646741606007,0.40958984552158434,8594,8389,Tyler and Nearby Counties,Ritchie,54,85,West Virginia,WV
54095,54CS021,92,91,93,86,-7,-6,-5,-88.34182548402268,9,129.87012987012986,-2.3103294867039805,-2.1801636185789155,-2.066501947197857,-1.7570957607199233,111,110,112,142,30,31,32,378.3237945543311,21,256.94359476324485,1.0856741747969962,1.2122268807048486,1.3374498424395247,0.6578864157964995,8316,8173,Tyler and Nearby Counties,Tyler,54,95,West Virginia,WV
54103,54CS021,178,172,184,195,11,17,23,140.94736694526978,14,116.11030478955006,-0.24863119543403342,0.25352948826400257,0.7635575888959815,0.7780056137209924,214,207,222,317,95,103,110,721.843150318699,49,345.0461235124287,3.2136029082174224,3.774310793533083,4.274200871814471,0.473389035433518,14469,14201,Tyler and Nearby Counties,Wetzel,54,103,West Virginia,WV
54107,54CS022,928,892,964,1004,40,76,112,108.80477521979316,74,105.828933725822,-0.5114412483059847,0.03225969357804651,0.53124553259497,0.9600311481932059,1132,1088,1175,1338,163,206,250,246.68900498544437,167,199.57455962140588,-0.07248180348659797,0.4794415753569191,0.9954159579715688,0.8051125103690113,83909,83678,Wood,Wood,54,107,West Virginia,WV
55001,55CS001,229,221,238,241,3,12,20,67.17022656770897,16,93.04579597770777,-0.7654598055651449,-0.2661950618223439,0.25534997083174604,1.2748516177882458,282,271,292,322,30,40,51,194.2438082321832,30,143.91250119927082,-0.027933253429683058,0.5019225971150023,1.0300349859917812,0.7230298258737292,20635,20846,Adams+Juneau+Monroe+Vernon,Adams,55,1,Wisconsin,WI
55057,55CS001,254,243,266,257,-9,3,14,11.574795300008404,18,80.7386087541584,-1.1809399154782296,-0.6810902600654987,-0.17240552611551724,5.027224999111686,311,297,324,382,58,71,85,266.5817801239662,37,138.0803104941036,0.7707067764222002,1.2560650062265308,1.785847552462614,0.5108151029792504,26753,26796,Adams+Juneau+Monroe+Vernon,Juneau,55,57,Wisconsin,WI
55081,55CS001,362,342,381,419,38,57,77,148.92163107139916,27,69.93459819983164,0.2690961187361393,0.7868540330689011,1.305409827879701,0.46157855404738457,441,417,465,547,82,106,130,228.87947390216394,41,88.73306496991732,0.8967234994578293,1.396724678824004,1.9279690364787438,0.38405317647947407,46329,46206,Adams+Juneau+Monroe+Vernon,Monroe,55,81,Wisconsin,WI
55123,55CS001,253,240,266,318,52,65,78,253.80203166468385,22,85.87320690888981,1.12553807122112,1.6803880717513906,2.208786437004532,0.3332224333957313,311,295,327,355,28,44,60,143.84958211182408,33,106.85490399248776,-0.17768595456043865,0.3668135869317343,0.888514154940569,0.7264711443180137,30743,30883,Adams+Juneau+Monroe+Vernon,Vernon,55,123,Wisconsin,WI
55003,55CS002,166,159,173,163,-10,-3,4,-23.707653428154032,11,82.9041577691245,-1.5793654849502758,-1.0571649613818404,-0.5479600121191417,-5.126746019578771,205,196,213,206,-7,1,10,8.180904951043047,18,111.88463451019393,-1.5854069004518387,-1.0377344890520317,-0.4966970794798467,7.771537559490117,15922,16088,Ashland+Bayfield+Douglas+Price,Ashland,55,3,Wisconsin,WI
55007,55CS002,150,148,152,163,11,13,15,97.69672750556843,17,126.83412086545634,-0.40667256844017524,-0.2919566695887053,-0.17155757542411215,1.206134139125912,186,184,188,190,2,4,6,22.433587014828593,13,79.72036548721408,-0.6968744127416313,-0.5725177331008083,-0.4402045483856289,2.790750573165753,16084,16307,Ashland+Bayfield+Douglas+Price,Bayfield,55,7,Wisconsin,WI
55031,55CS002,363,344,382,466,84,103,122,281.188895303186,53,144.03804778620767,0.8981286517292111,1.3464453005995836,1.8993848112927822,0.5073430863140233,445,422,468,498,30,53,76,119.4879897611356,36,81.42217397204506,-0.1554877769433861,0.3938584145532832,0.8940473000781373,0.6687668448145572,44155,44214,Ashland+Bayfield+Douglas+Price,Douglas,55,31,Wisconsin,WI
55099,55CS002,169,163,175,177,2,8,14,68.76771520886196,3,25.86021119172473,-0.0677928095183293,0.43904194580120587,0.9391381586406118,0.3341639896940681,207,200,214,213,-1,6,13,41.35416227340357,18,128.15948736205056,-1.346086838057469,-0.8738452869060949,-0.3592924220543351,2.6438736978357205,13921,14045,Ashland+Bayfield+Douglas+Price,Price,55,99,Wisconsin,WI
55005,55CS003,459,439,479,503,24,44,64,114.11374470342291,55,142.10662302988544,-0.8357134172581304,-0.2778246365361072,0.23204120183120236,1.2177349233753407,565,541,589,618,29,53,77,112.9185734497907,51,109.18900402500643,-0.4716212181578786,0.0457853297556146,0.5501964720644235,0.9489783239340376,46444,46708,Barron+Sawyer+Washburn,Barron,55,5,Wisconsin,WI
55113,55CS003,199,191,207,217,10,18,26,121.59986704764785,16,107.27455581629232,-0.3706708685673107,0.15942761097109184,0.6594084836041458,0.8360933047598345,247,238,257,278,21,31,40,169.02108841776547,34,186.11780162031968,-0.7030560201556003,-0.1670861485072142,0.31408945742875777,1.0666073572022206,17898,18268,Barron+Sawyer+Washburn,Sawyer,55,113,Wisconsin,WI
55129,55CS003,184,177,191,203,12,19,26,140.68279901033978,13,94.59131700218288,-0.09170930348326155,0.46354513381963336,0.9802378661890865,0.6393073917403543,227,219,236,278,42,51,59,302.8346177520985,25,149.441090322195,1.0258855787973105,1.54439852739454,2.0864877034288924,0.48392213981934495,16492,16729,Barron+Sawyer+Washburn,Washburn,55,129,Wisconsin,WI
55009,55CS004,1802,1687,1918,2060,142,258,373,115.42764048128794,216,96.6720497682034,-0.31130854180820294,0.19182980423229054,0.6794879592577752,0.8342773335653408,2232,2093,2371,2375,4,143,282,53.15137532443259,196,72.73617919819496,-0.6961687354430017,-0.17297754107312152,0.35591877492244256,1.3589837678727141,268123,269467,Brown,Brown,55,9,Wisconsin,WI
55011,55CS005,113,112,114,109,-5,-4,-3,-36.49504028141564,11,99.45001130113764,-1.4799268996499984,-1.3560767328291576,-1.2350277233766553,-3.6224061993664733,139,137,141,143,2,4,6,29.848785915140216,5,37.579857196542655,-0.20025760901282863,-0.07759478309153915,0.04205848503273772,1.00575675736506,13273,13305,Buffalo+Jackson+Pepin+Trempealeau,Buffalo,55,11,Wisconsin,WI
55053,55CS005,183,174,193,224,31,41,50,231.29395817449262,18,102.65183917878528,0.7417729253496568,1.2801157390447322,1.776543822144848,0.4331359016822294,225,214,236,236,0,11,22,51.862024913038915,15,71.02945354673737,-0.6778737827913996,-0.18195305817407115,0.33756921188805017,1.2549967254186085,21042,21118,Buffalo+Jackson+Pepin+Trempealeau,Jackson,55,53,Wisconsin,WI
55091,55CS005,60,59,60,61,1,1,2,23.030285132502065,3,49.126637554585145,-0.3820176328333512,-0.2635376241650717,-0.13899658912187188,1.2466844709985723,73,73,74,81,7,8,8,102.27137128748284,10,135.8695652173913,-0.4654530414715945,-0.33512761683273523,-0.2093497731765605,1.172721614290177,7328,7360,Buffalo+Jackson+Pepin+Trempealeau,Pepin,55,91,Wisconsin,WI
55121,55CS005,260,247,273,269,-4,9,22,35.50691678202306,33,129.42445337778213,-1.4627713334066454,-0.9239208346441588,-0.40282117712551246,3.282479402981445,319,303,335,303,-32,-16,-0,-52.01868763568637,16,52.06299622543278,-1.56606305793737,-1.0352066217028337,-0.5390676032867473,-1.0676358605079015,30597,30732,Buffalo+Jackson+Pepin+Trempealeau,Trempealeau,55,121,Wisconsin,WI
55013,55CS006,178,171,185,170,-15,-8,-1,-55.56824558533397,27,197.2002434570907,-3.0255026111181507,-2.5235186538891785,-1.955900889414044,-4.085821031561587,220,212,229,230,1,10,18,58.03865732415303,23,137.5515818431912,-1.2935333899452446,-0.7980484441432613,-0.2795375420738939,2.148600199486191,16430,16721,Burnett+Polk,Burnett,55,13,Wisconsin,WI
55095,55CS006,407,388,426,423,-3,16,35,43.15818555945311,29,77.5729475490961,-0.8552745650819202,-0.341112638894763,0.18333594731728645,1.6925087442235769,505,481,528,580,52,75,99,165.9797911934849,83,182.944301174811,-0.6742212499175954,-0.1620351948754205,0.3732237897685271,1.0877632063264933,44861,45369,Burnett+Polk,Polk,55,95,Wisconsin,WI
55015,55CS007,323,300,345,353,8,30,53,69.12287231419262,34,78.25386474356515,-0.575755625605797,-0.09947162923991981,0.42760747732232773,1.0956172227279877,401,374,428,404,-24,3,30,5.6160007750603125,57,108.50942318675044,-1.5384757217388552,-1.018707219045544,-0.502335899910929,14.430068469657595,52138,52530,Calumet+Winnebago,Calumet,55,15,Wisconsin,WI
55139,55CS007,1306,1233,1380,1525,145,219,292,152.8071736096359,172,120.23347663486071,-0.17264547482364218,0.34449861184262404,0.8139123680648266,0.7832483141771303,1605,1517,1694,1730,36,125,213,72.57687993486616,137,79.82473517998439,-0.5851434928782709,-0.07918229171508187,0.45464249461105133,1.0911049022570938,171666,171626,Calumet+Winnebago,Winnebago,55,139,Wisconsin,WI
55017,55CS008,535,507,564,584,20,49,77,88.2546862809533,56,101.65030479964905,-0.6540293404942247,-0.11900345427340263,0.3972024775744299,1.1285716795911636,662,628,697,674,-23,12,46,17.400358984330673,64,95.83707696915245,-1.2815651699415938,-0.7813105657454853,-0.27927228792115755,5.0713315549810165,66109,66780,Chippewa+Rusk,Chippewa,55,17,Wisconsin,WI
55107,55CS008,160,154,166,163,-3,3,9,27.107139581539897,17,144.14923685698133,-1.6464494527669662,-1.1610636937128247,-0.6563757717004851,4.0506712013812685,194,187,202,234,32,40,47,279.66781067732666,28,198.1599433828733,0.30268472736302443,0.811131526121708,1.295340071083962,0.6910668952938265,14152,14130,Chippewa+Rusk,Rusk,55,107,Wisconsin,WI
55019,55CS009,290,275,305,332,27,42,57,145.68420357208174,52,180.01904047543488,-0.8971999678506395,-0.3247608807619973,0.19116406858199825,1.2069979073012609,355,338,373,389,16,34,51,96.65354273980431,45,129.57470701719024,-0.8192739906692484,-0.33178627440830377,0.17234674170021888,1.3018268531735337,34663,34729,Clark+Taylor,Clark,55,19,Wisconsin,WI
55119,55CS009,162,153,170,175,5,13,22,80.33456153464552,24,144.25966740132236,-1.1766600568651127,-0.6193401889200204,-0.08665299356740411,1.670728251058563,198,187,208,226,18,28,39,142.1612674864587,29,145.58963803403785,-0.5315108936900673,-0.024086226868682063,0.4899359487157289,0.9891836900792333,19964,19919,Clark+Taylor,Taylor,55,119,Wisconsin,WI
55021,55CS010,484,459,509,528,19,44,69,91.18256960875247,40,82.23966007607169,-0.48746864637913945,0.10629728911223954,0.5556688204169052,0.8820348479903155,595,564,625,631,6,36,67,62.31170824197004,50,85.48323673727582,-0.7239020772923295,-0.23024956279194572,0.268541862637878,1.3352296703846995,58366,58491,Columbia,Columbia,55,21,Wisconsin,WI
55023,55CS011,155,148,162,165,3,10,17,74.72759705881418,11,82.03853325046613,-0.5582831360155089,-0.07108575927200068,0.4551283798569267,0.998210000241484,190,182,199,197,-2,7,15,42.29328009064938,11,68.42072525968774,-0.7718670988157895,-0.27505697565152726,0.27045335640142265,1.4103485095989576,16090,16077,Crawford+Grant+Richland,Crawford,55,23,Wisconsin,WI
55043,55CS011,436,413,458,503,45,67,90,155.61528972404724,51,117.94179996145692,-0.14420002616462535,0.35565460353264755,0.9404318427353683,0.746808001314653,539,512,565,578,13,39,66,75.67004603260771,35,67.1991398510099,-0.41077610235538237,0.09477376082721979,0.5906386073214508,0.8660796657765927,51890,52084,Crawford+Grant+Richland,Grant,55,43,Wisconsin,WI
55103,55CS011,167,160,174,191,17,24,31,166.46025090557842,11,76.41984600243154,0.40622580979990275,0.8952100793755007,1.5084310386030975,0.4406951357766156,205,196,213,227,14,22,31,130.36529800754735,24,139.3647291098078,-0.5967460040481253,-0.07556873403666532,0.40588208153149985,1.0234450812046718,17273,17221,Crawford+Grant+Richland,Richland,55,103,Wisconsin,WI
55025,55CS012,2977,2735,3218,3366,148,389,631,83.3934217170788,216,46.2577944026641,-0.11827969520325729,0.3758160538757488,0.8900031700874346,0.5532727464864896,3713,3422,4004,3768,-236,55,346,9.816676176313383,147,26.07719203634486,-0.6944342755700642,-0.16733173718646566,0.3298522801207601,2.6092659659299433,560338,563711,Dane,Dane,55,25,Wisconsin,WI
55027,55CS013,818,780,856,1019,163,201,239,270.9974176819858,126,169.8323018342338,0.5058139090265258,1.0247700862978175,1.4975180683491516,0.6235918377925109,1005,959,1051,1111,60,106,152,118.36734482228816,112,125.4115065057219,-0.595049287097718,-0.08310380535520745,0.42169905041379646,1.0495820600284274,89029,89306,Dodge,Dodge,55,27,Wisconsin,WI
55029,55CS014,311,298,324,325,1,14,27,55.74839118028004,25,100.71507704703393,-0.9754058633031019,-0.43007141424689316,0.048854188487268364,1.6848467924856199,384,368,400,381,-19,-3,13,-9.819106844787193,22,72.53544345532477,-1.3514974600970115,-0.831105824536337,-0.31040302974124,-11.121586151018732,29787,30330,Door+Kewaunee+Manitowoc,Door,55,29,Wisconsin,WI
55061,55CS014,163,154,172,191,19,28,37,162.90415026925052,26,151.99493350221658,-0.38849492417211756,0.11068265465900275,0.6187674545946936,0.9007101339231994,200,189,210,206,-4,6,17,30.62259572691342,15,73.02112744620777,-0.942902769579284,-0.4340701005013565,0.12792311194779274,2.0574738548206755,20527,20542,Door+Kewaunee+Manitowoc,Kewaunee,55,61,Wisconsin,WI
55071,55CS014,763,728,798,844,46,81,116,120.50803838580848,56,83.04806159397901,-0.14657406148242327,0.3664315465455489,0.886121850819399,0.6807718168817916,935,893,977,949,-28,14,56,17.17705025555745,71,87.15078312957235,-1.1790970886839693,-0.7118442478685005,-0.20767467204116777,4.7352908071534605,80917,81468,Door+Kewaunee+Manitowoc,Manitowoc,55,71,Wisconsin,WI
55033,55CS015,302,283,322,306,-16,4,23,9.956631923156094,23,60.73542679840679,-1.0247305459267928,-0.5085906599815428,0.026700028613615753,4.821304089366152,373,349,396,414,18,41,65,91.1313838319557,33,72.47809184950913,-0.36882961574206474,0.19067313872207736,0.6852779209203992,0.7765979434908669,45443,45531,Dunn+Eau Claire,Dunn,55,33,Wisconsin,WI
55035,55CS015,758,712,803,846,43,88,134,100.43676499550496,81,91.9696840671038,-0.36448761926934453,0.08717633929575704,0.6070818486592925,0.9054612406721122,935,880,990,998,8,63,118,58.84760392799889,68,63.93380970289583,-0.5518345812499594,-0.05201980571025038,0.4146807273580406,1.0693452879147758,105687,106360,Dunn+Eau Claire,Eau Claire,55,35,Wisconsin,WI
55037,55CS016,59,58,59,63,4,4,5,112.51830259856949,13,344.90382489498126,-2.44323730691865,-2.323155074045912,-2.1998880428626175,2.4804415488375895,73,72,74,67,-7,-6,-5,-132.2925116277892,8,174.3679163034002,-3.1924613033474474,-3.0689368401349344,-2.945731403092017,-1.5780398604907302,4523,4588,Florence+Forest+Marinette+Oconto,Florence,55,37,Wisconsin,WI
55041,55CS016,107,106,108,99,-9,-8,-7,-101.6402107718455,21,275.34965034965035,-3.8943241150958725,-3.765868058251061,-3.6481271680622758,-3.110300094663319,132,131,133,152,19,20,21,213.1226247717112,15,162.26741670272608,0.3823786781295532,0.5116367966705329,0.6362844973680435,0.7246007358367932,9152,9244,Florence+Forest+Marinette+Oconto,Forest,55,41,Wisconsin,WI
55075,55CS016,475,457,492,538,46,63,81,182.95470309849262,63,181.58236057068743,-0.476375814690448,0.010901011715988269,0.4985015046374212,0.9771057266782327,583,561,604,615,11,32,54,76.89272993634974,44,105.07713617041601,-0.7877431448664736,-0.27582605693463746,0.23127863496767553,1.3253785824350524,41634,41874,Florence+Forest+Marinette+Oconto,Marinette,55,75,Wisconsin,WI
55083,55CS016,332,315,348,396,48,64,81,198.77519235991988,49,151.03256960854822,-0.03842137413236408,0.47113737914138265,1.0093824767080066,0.7482138504439839,412,391,432,414,-18,2,23,5.812102217194584,34,86.49198677181379,-1.3246615651299318,-0.8137544961030856,-0.25442317783749535,10.350903603640283,38932,39310,Florence+Forest+Marinette+Oconto,Oconto,55,83,Wisconsin,WI
55039,55CS017,836,792,881,999,118,163,207,187.82013350319616,108,124.66333205078875,0.131635504459453,0.6354733434548808,1.1597298254788617,0.6596836210222485,1033,979,1087,1182,95,149,203,142.86874225795825,106,101.61042944785277,-0.10637606834258578,0.40712071645651005,0.9039227240045807,0.7064751086561644,103960,104320,Fond du Lac,Fond du Lac,55,39,Wisconsin,WI
55045,55CS018,296,280,312,340,28,44,60,141.6292171937095,14,45.44102134105109,0.4417578210400316,0.9631790491216752,1.4632894527036409,0.31365673822821577,362,343,381,397,16,35,54,93.84035256584886,29,78.40168698802347,-0.3524660125473795,0.1609841673404702,0.6928928747168055,0.8120836248827425,36971,36989,Green+Iowa+Lafayette,Green,55,45,Wisconsin,WI
55049,55CS018,178,168,188,197,9,19,29,97.8538913162337,3,15.202702702702702,0.34021972254095895,0.8281846660708461,1.3198420551561645,0.14771169071618595,218,206,230,212,-18,-6,6,-25.191434086777157,12,50.539083557951486,-1.2665054517049847,-0.7534173355495598,-0.26298310581712586,-2.4089351695441814,23680,23744,Green+Iowa+Lafayette,Iowa,55,49,Wisconsin,WI
55065,55CS018,121,120,123,142,19,21,22,148.2326776218009,3,21.643720315036372,1.1421305341342958,1.2676127577735903,1.3830286775865115,0.139235143545008,150,148,152,165,13,15,17,87.61270004411243,14,83.5421888053467,-0.08874233202767459,0.0392928623430664,0.16010295428911192,0.8927355148516076,16633,16758,Green+Iowa+Lafayette,Lafayette,55,65,Wisconsin,WI
55047,55CS019,203,195,212,221,9,18,26,110.98399233454441,19,119.94949494949495,-0.5977844319252431,-0.10929147402324874,0.4001525468392476,1.0226124155421417,251,241,260,286,26,35,45,184.58458096443556,31,161.50039072675176,-0.2949803803825665,0.22990999272589138,0.7237032453396968,0.8509234229576175,19008,19195,Green Lake+Marquette+Waushara,Green Lake,55,47,Wisconsin,WI
55077,55CS019,173,166,180,210,30,37,44,285.3273814876227,24,184.62721969357008,0.4836445762590652,1.017902768167704,1.4951123494296892,0.6300836285037383,213,205,221,250,29,37,45,234.69527400698615,25,158.609313538891,0.24263528392662376,0.7506249299003376,1.302563906135038,0.6580216815367319,15599,15762,Green Lake+Marquette+Waushara,Marquette,55,77,Wisconsin,WI
55137,55CS019,246,235,257,289,32,43,54,210.36100660628568,25,122.31917149147843,0.3542307170498112,0.8620050209563492,1.4055487812171772,0.5682556431970307,304,291,316,331,15,27,40,110.83687417116458,41,165.44265999515778,-1.070231998033253,-0.5495878467398346,-0.01957460463332821,1.4402341052686818,24526,24782,Green Lake+Marquette+Waushara,Waushara,55,137,Wisconsin,WI
55051,55CS020,79,79,80,93,13,14,14,269.7682583167805,19,375.67968363816107,-1.1778131474165197,-1.0615164502928378,-0.9399911496294516,1.2975013835788822,99,98,100,109,9,10,11,164.91971316527818,5,81.02414519526819,0.7099677219173611,0.8417700181647197,0.9747619171242935,0.44733940640613196,6069,6171,Iron+Oneida+Vilas,Iron,55,51,Wisconsin,WI
55085,55CS020,424,408,441,499,58,75,91,238.1869150567279,46,146.97659557472642,0.40993395103355146,0.9039859141618066,1.4244265094468465,0.6088961065513436,526,506,545,531,-14,5,25,13.813012567715717,45,117.80721503743652,-1.5548570406900681,-1.0617057713209854,-0.48336320688814033,7.169835594679249,37557,38198,Iron+Oneida+Vilas,Oneida,55,85,Wisconsin,WI
55125,55CS020,280,270,290,282,-8,2,12,12.301363483914338,29,151.38333043326952,-1.907115307509836,-1.3922557944629086,-0.8827665786132942,8.639872025228815,347,335,359,365,6,18,30,75.24556038950855,42,179.06629716478363,-1.577216595740885,-1.0457630809447882,-0.4948069406053164,2.252150056552271,22988,23455,Iron+Oneida+Vilas,Vilas,55,125,Wisconsin,WI
55055,55CS021,608,571,644,713,69,105,142,148.5096772288208,83,117.36563637863378,-0.19587057161236934,0.3071485237038785,0.8444292238767975,0.7828356684586396,751,707,795,892,97,141,185,165.98778655979459,85,100.08124242031768,0.14683155306702603,0.6487626400486544,1.168076025901329,0.5986965868043072,84863,84931,Jefferson,Jefferson,55,55,Wisconsin,WI
55059,55CS022,1250,1177,1323,1488,165,238,311,168.83019132491248,229,162.4708817651858,-0.45596728755210225,0.04978135068316654,0.5558391120988994,0.9583059861772593,1538,1451,1625,1708,83,170,257,100.54437020490796,180,106.64644334111458,-0.5719964269633966,-0.04963569116359366,0.4776232545723519,1.0544766113552366,169138,168782,Kenosha,Kenosha,55,59,Wisconsin,WI
55063,55CS023,893,842,945,1004,59,111,162,110.15047609468522,68,67.7662065872739,-0.09768860232040105,0.43446264694583137,0.9707939010844295,0.6096987183224841,1101,1039,1163,1140,-23,39,101,32.19556798843751,68,56.43434527860308,-0.741335905348036,-0.24473667118082285,0.2855544823921784,1.7088120149571004,120414,120494,La Crosse,La Crosse,55,63,Wisconsin,WI
55067,55CS024,200,192,209,256,47,56,64,343.8976911266893,35,216.37216011539846,0.766325380499719,1.283268763957112,1.8017399912361358,0.618065336133988,246,236,256,306,50,60,70,307.6284897020649,18,92.34084030164675,1.6639852542576605,2.1493789501180305,2.625201247333374,0.295246426744472,19411,19493,Langlade+Lincoln+Menominee+Shawano,Langlade,55,67,Wisconsin,WI
55069,55CS024,294,281,306,372,66,78,91,332.47738687902245,68,288.56354763420325,-0.08888012757051235,0.427285193649001,0.931735411024507,0.8569812238077855,362,347,376,437,61,75,90,264.0902912164503,50,175.3340112915103,0.4116595767159767,0.892905398812922,1.3781040153319168,0.655216725161365,28278,28517,Langlade+Lincoln+Menominee+Shawano,Lincoln,55,69,Wisconsin,WI
55078,55CS024,41,39,43,59,16,18,20,493.1223183477471,14,390.5160390516039,0.5299558949772325,1.0244996864168767,1.5077215177251058,0.7495274585626813,51,48,53,65,12,14,17,335.56081739503594,5,116.71335200746965,1.714980092785867,2.207941336786749,2.6921424051387426,0.32519425409885394,4302,4284,Langlade+Lincoln+Menominee+Shawano,Menominee,55,78,Wisconsin,WI
55115,55CS024,407,389,424,477,53,70,88,206.4021408756264,63,185.1398344516824,-0.2890264932967404,0.21169646995255786,0.7558626651061616,0.8843941264831429,498,477,519,505,-14,7,28,16.27838224157487,39,95.45721558644996,-1.3296112563741584,-0.7955771674424573,-0.2909939899378144,5.097575537138328,40834,40856,Langlade+Lincoln+Menominee+Shawano,Shawano,55,115,Wisconsin,WI
55073,55CS025,1065,1006,1124,1209,85,144,203,125.69981996696916,156,136.05343295080417,-0.6204272275411336,-0.11099145360491952,0.4166583011413921,1.074909765093788,1309,1238,1381,1444,63,135,206,97.70509300655247,190,137.98813302056024,-0.9227469553877019,-0.4033726780577033,0.11849880754857967,1.4018718442231972,137593,137693,Marathon,Marathon,55,73,Wisconsin,WI
55079,55CS026,7061,6658,7464,8848,1384,1787,2190,228.50401670295804,898,114.83498332249916,0.6123351161271282,1.1445457777379302,1.627826187944831,0.5022701805014568,8623,8143,9103,9500,397,877,1357,94.39189801128377,274,29.47726270265618,0.1618227402556789,0.6425957156865687,1.1502966164359283,0.31193042472671323,938390,929530,Milwaukee,Milwaukee,55,79,Wisconsin,WI
55087,55CS027,1295,1213,1377,1498,121,203,285,127.72456655594448,164,103.31630644204468,-0.26611849045786545,0.2554538720817348,0.734610367110068,0.8049290908974455,1604,1505,1702,1674,-28,70,169,36.760670421557855,140,73.12958039291479,-0.8787628419072466,-0.36892925682468125,0.15025991780396689,1.961471239036996,190483,191441,Outagamie,Outagamie,55,87,Wisconsin,WI
55089,55CS028,703,664,742,781,39,78,117,102.50557259163442,85,111.62424215894417,-0.6084512223514115,-0.08537982807102455,0.3994859768379696,1.0751833315970705,872,824,920,906,-14,34,82,36.685950081751805,71,76.8714406357593,-0.9037848781118819,-0.41270744718948077,0.09892574799917558,2.035324214777144,91378,92362,Ozaukee,Ozaukee,55,89,Wisconsin,WI
55093,55CS029,247,229,265,287,22,40,58,113.72964022120343,25,70.89516967577275,-0.06841598727537948,0.42480062959177756,0.9370590296223946,0.6082005559569005,306,284,328,371,43,65,87,152.85274972751964,30,70.5401020480143,0.3030298415242239,0.8144126691666222,1.3423062508903503,0.45449899970951585,42316,42529,Pierce+St. Croix,Pierce,55,93,Wisconsin,WI
55109,55CS029,545,505,586,628,42,83,123,106.17660230102982,41,52.63495731433339,0.04072249146290168,0.5571727813834664,1.02871474517008,0.4898080246718436,680,632,729,812,83,132,180,138.62646064593898,90,94.87466003246821,-0.07155492962498818,0.4378643459639946,0.9639679383645108,0.6792256336725702,93474,94862,Pierce+St. Croix,St. Croix,55,109,Wisconsin,WI
55097,55CS030,455,425,486,520,34,65,95,110.27623865187934,45,76.62835249042146,-0.19903960705349302,0.3269681325553702,0.8413522247753317,0.6843094711199559,562,526,599,717,118,155,191,219.462996006057,76,107.87027180469804,0.5742224786587531,1.0893847708044764,1.5917223891182457,0.4883607760606513,70470,70455,Portage,Portage,55,97,Wisconsin,WI
55101,55CS031,1611,1526,1695,1934,239,323,408,196.84312432733375,267,162.47217334421887,-0.19192308527929008,0.3444196062790538,0.8910798839628946,0.8228454218037392,1977,1876,2079,2230,151,253,354,128.20477240688146,217,110.16626475441045,-0.3433945586584769,0.18380306983446354,0.6649773581340075,0.85590992836256,197203,196975,Racine,Racine,55,101,Wisconsin,WI
55105,55CS032,1326,1256,1397,1564,167,238,308,174.38286590685343,139,101.92857666642223,0.23155807421291874,0.7146501776437628,1.2317408993293781,0.5820626362793876,1636,1551,1720,1771,51,135,220,82.42563800245159,127,77.31033097344056,-0.46573719733565033,0.052248988428701904,0.5667336181664616,0.931064099716587,163644,164273,Rock,Rock,55,105,Wisconsin,WI
55111,55CS033,565,537,593,631,38,66,94,120.67744719881108,44,80.5774718818197,-0.09838951034518852,0.4321661249402153,0.93995932200925,0.65772828193946,692,658,726,753,27,61,95,92.60144647267424,67,101.97869101978691,-0.6139902248542172,-0.1083083551054223,0.4449070428516811,1.0834560248596556,65527,65700,Sauk,Sauk,55,111,Wisconsin,WI
55117,55CS034,986,935,1037,1137,100,151,202,154.1797897033155,127,129.67674412668157,-0.26107668200822187,0.23775767232209852,0.7783853351275108,0.8355413672013033,1211,1150,1272,1251,-21,40,101,34.16531692459611,102,86.60581617490979,-1.0223767178497676,-0.5247542438980347,0.029577197228755906,2.47343470455752,117523,117775,Sheboygan,Sheboygan,55,117,Wisconsin,WI
55127,55CS035,835,790,881,998,117,163,208,184.00827755767222,116,131.13395069288092,-0.00460014275407687,0.52723439433525,1.0180888175414962,0.7083009683223943,1033,978,1088,1095,7,62,117,58.25198026778627,95,88.98880614491124,-0.8234516566373559,-0.3136179830911374,0.2057131767156822,1.5034761587030172,106151,106755,Walworth,Walworth,55,127,Wisconsin,WI
55131,55CS036,1017,958,1076,1188,112,171,230,149.85040768160098,117,102.6953882163625,-0.06122939944677797,0.47196079535561675,1.0229905013977363,0.6813285435585297,1258,1187,1329,1387,58,129,200,94.16022104176065,129,94.08504120778936,-0.4923124459160909,0.01124748171991943,0.5094383219762904,0.991521499120236,136715,137110,Washington,Washington,55,131,Wisconsin,WI
55133,55CS037,3024,2848,3199,3670,471,646,822,190.6397793415598,421,124.1472860597244,0.12326123653891574,0.6732393638375508,1.1986031070682373,0.6502082029216886,3739,3528,3950,4148,198,409,620,100.18210124103598,329,80.53421847538199,-0.3770930305248752,0.20614959520974796,0.7244711715685742,0.8019189044205931,406936,408522,Waukesha,Waukesha,55,133,Wisconsin,WI
55135,55CS038,621,599,643,716,73,95,117,220.5220161957021,118,274.55694729902666,-1.0470262103362578,-0.5287762018055894,-0.03658127430395025,1.232032590154377,756,729,783,759,-24,3,30,5.580516451724988,71,137.62090287065573,-1.8605118818019566,-1.3344379210316104,-0.8186992643948043,18.303477753643303,51574,51591,Waupaca,Waupaca,55,135,Wisconsin,WI
55141,55CS039,721,689,753,824,71,103,135,167.3561654092048,52,84.43843031123139,0.3229011777813825,0.8262333741606588,1.3530291413873987,0.49969487286770436,885,847,923,1051,128,166,204,224.43838719124852,122,164.7023881846287,0.0695385177933881,0.5874971445684525,1.1155836631105271,0.729454583356588,73900,74073,Wood,Wood,55,141,Wisconsin,WI
56003,56CS001,118,117,119,127,8,9,10,96.33202407144434,14,145.7700650759219,-0.6208264314411368,-0.4934264839967643,-0.3753246891779285,1.3656021019466313,146,145,147,190,43,44,45,379.04824121762033,32,275.67195037904895,0.9061836820799728,1.0322407655472623,1.1625762682917893,0.7111123778307386,11525,11608,Big Horn+Hot Springs+Park+Washakie,Big Horn,56,3,Wyoming,WY
56017,56CS001,63,63,64,80,16,17,17,435.96395118053806,2,52.298975811723686,3.721346716462394,3.8373381144224945,3.9582814120946774,0.1131734578313043,78,77,78,87,9,9,10,197.51957042474757,10,217.3440556400782,-0.33318220600259707,-0.20201644470965457,-0.07046064303718809,0.9912890047258476,4589,4601,Big Horn+Hot Springs+Park+Washakie,Hot Springs,56,17,Wyoming,WY
56029,56CS001,257,244,270,303,33,46,59,185.72976866371786,14,56.68972498734604,0.7530968671639934,1.291142249773297,1.8110283514981125,0.29871437098798403,322,307,338,440,102,118,133,391.7620029299309,103,342.8533386592104,-0.04296706803701945,0.5011519183852042,0.9947770855676322,0.8677839275416988,29635,30042,Big Horn+Hot Springs+Park+Washakie,Park,56,29,Wyoming,WY
56043,56CS001,72,71,73,87,14,15,16,230.6595065467227,21,327.82620007805383,-1.092919238234807,-0.9690359159385764,-0.8463597081365104,1.3311642913969248,89,88,90,113,23,24,25,310.0333840944091,18,233.82696804364772,0.6298351771025688,0.764672101998996,0.8869169921543059,0.7238692284758284,7687,7698,Big Horn+Hot Springs+Park+Washakie,Washakie,56,43,Wyoming,WY
56013,56CS002,362,345,379,486,107,124,141,380.2747831926924,64,195.7386074013661,1.3320842321937691,1.842810819401545,2.3464536659975814,0.5106226331192484,445,425,466,579,113,134,154,340.0989244141069,91,231.47559331518835,0.5458617043627191,1.0782789643214379,1.5450652863564567,0.6755598546057386,39236,39313,Fremont+Lincoln+Sublette+Teton,Fremont,56,13,Wyoming,WY
56023,56CS002,123,121,125,155,30,32,34,193.853082419569,10,60.72259892723409,1.2131470098491888,1.3279465543172013,1.4433787627187487,0.30372637217938403,155,152,157,172,15,17,20,86.60055820683915,15,74.69003634915101,-0.011998898564624836,0.11696326308541372,0.2476154065334088,0.8155724266175808,19762,20083,Fremont+Lincoln+Sublette+Teton,Lincoln,56,23,Wyoming,WY
56035,56CS002,47,46,48,67,19,20,21,265.385585436054,4,54.01147743895577,1.9947000659237473,2.1153586071444126,2.243235949983116,0.19366695361593203,57,56,59,78,19,21,22,236.1512994453059,16,183.88690955062637,0.3935103947654813,0.5200319874250124,0.650632794704427,0.7425446924044838,8887,8701,Fremont+Lincoln+Sublette+Teton,Sublette,56,35,Wyoming,WY
56039,56CS002,87,85,90,79,-11,-8,-6,-42.47468476616288,8,41.067761806981515,-0.9599798921321351,-0.8358984440904687,-0.7180676844415772,-1.099797162801721,110,107,113,89,-24,-21,-18,-88.37422221659283,5,21.23863732902897,-1.222943976098913,-1.0986924171420043,-0.9698180880677719,-0.25246074250383854,23376,23542,Fremont+Lincoln+Sublette+Teton,Teton,56,39,Wyoming,WY
56021,56CS003,744,700,787,821,34,77,121,92.2394495582732,63,75.15807054519425,-0.3563304564173229,0.1716741849404816,0.6706341205023224,0.8044109168516955,919,867,971,1259,288,340,392,337.30781675577566,173,171.56230786013208,1.1228092964959158,1.6576919200519977,2.154175318697526,0.507131416440824,100588,100838,Laramie,Laramie,56,21,Wyoming,WY
56025,56CS004,622,587,656,761,105,139,174,208.9206502398617,95,142.34519959543994,0.18032392695510172,0.6647104130329875,1.1556229796701734,0.6764844693222771,761,720,802,934,132,173,214,217.06847756174068,131,164.46335982323328,-0.001558667469147233,0.5370587828314328,1.0619636708304538,0.753299764499998,80087,79653,Natrona,Natrona,56,25,Wyoming,WY
56005,56CS005,218,198,238,276,38,58,78,147.53525835381822,39,99.70174691095013,-0.017632802707703635,0.47580118104388636,0.9860381459573344,0.6642721616707117,270,246,294,367,73,97,121,208.26121352521469,86,184.92635200516074,-0.2517805922609398,0.237452632069511,0.7424233981001276,0.8788794076221873,46940,46505,Northeast Wyoming,Campbell,56,5,Wyoming,WY
56011,56CS005,53,52,53,99,46,46,47,766.078500657165,10,165.51724137931032,5.891332018002129,6.005249937197357,6.127131916175105,0.21148843494083705,65,64,66,82,16,17,18,229.79769221466856,13,178.20424948594928,0.3849843189196706,0.5168245706762132,0.640504941732401,0.7318278017261932,7250,7295,Northeast Wyoming,Crook,56,11,Wyoming,WY
56019,56CS005,83,82,83,84,1,1,2,19.87319314286206,6,84.81564377429615,-0.7716718423075675,-0.6491521435384744,-0.5285680321892998,2.493907793804101,103,102,104,110,6,7,8,85.95731793879924,0,0,0.7345997404785877,0.8545713740335348,0.996317462183877,0,8489,8599,Northeast Wyoming,Johnson,56,19,Wyoming,WY
56033,56CS005,286,272,299,300,1,14,28,56.06385411825017,18,69.6639360123847,-0.6226910830382466,-0.14887646785304617,0.4250707807934181,1.1623427672199973,355,339,372,384,12,29,45,90.56626322363374,43,136.28728091027224,-0.9378185306140836,-0.46337337507572285,0.054361369737732826,1.4539522317219369,31006,31551,Northeast Wyoming,Sheridan,56,33,Wyoming,WY
56045,56CS005,55,54,56,68,12,13,14,230.8243370498792,7,123.29370321444296,0.9547951060073028,1.077071475709943,1.2043057949122011,0.49627609533190437,67,66,68,106,38,39,40,579.4774465539925,11,162.86644951140065,4.029910185064218,4.169834469394453,4.29523814261112,0.2740551486948236,6813,6754,Northeast Wyoming,Weston,56,45,Wyoming,WY
56001,56CS006,172,156,188,213,25,41,57,131.71061724158795,10,32.0958596341072,0.47632558302125605,1.0035390168572942,1.513601366429153,0.23788772082814413,218,199,237,267,30,49,68,130.25845015637375,34,90.59177746396313,-0.10018847419725961,0.40849735396348597,0.9000513255685803,0.6815361971980491,37388,37531,"Southeast Wyoming, excluding Laramie",Albany,56,1,Wyoming,WY
56007,56CS006,108,107,110,137,27,29,30,237.1481550451052,17,140.08102726086656,0.8512320534154154,0.9713392972848132,1.0952299671423935,0.5708547453727572,133,131,135,162,27,29,31,196.67271591786553,31,211.93682915156901,-0.28104723942570037,-0.15044528842478835,-0.021355662862663896,1.0414105777409866,14563,14627,"Southeast Wyoming, excluding Laramie",Carbon,56,7,Wyoming,WY
56009,56CS006,103,101,104,127,23,24,26,212.8875402189004,4,34.93704054152413,1.6632152716895605,1.77822785074731,1.9027047386819476,0.15764261677178992,125,124,127,163,36,38,39,275.9997505546271,36,263.1578947368421,-3.1229130593744695e-4,0.12843049503430934,0.2594196491589451,0.9288700743322564,13739,13680,"Southeast Wyoming, excluding Laramie",Converse,56,9,Wyoming,WY
56015,56CS006,135,129,140,160,20,25,31,241.2804862795025,19,180.7802093244529,0.14610419835286892,0.6136290023837749,1.123445173092766,0.7208279293875474,165,158,171,188,17,23,30,186.67487725459068,31,247.36674114267475,-1.1515066696133867,-0.5963620078769983,-0.10003759176953919,1.2707993149663412,12612,12532,"Southeast Wyoming, excluding Laramie",Goshen,56,15,Wyoming,WY
56027,56CS006,24,23,25,33,8,9,10,458.29659616744505,6,297.029702970297,1.1252551764139864,1.6301734004995518,2.1203615413800243,0.5849326472566162,29,28,31,36,5,7,8,276.274446104898,8,328.1378178835111,-1.015115211669909,-0.5139255309901408,0.04340503425289922,1.0341835145845137,2424,2438,"Southeast Wyoming, excluding Laramie",Niobrara,56,27,Wyoming,WY
56031,56CS006,84,83,85,96,11,12,13,164.24769699390868,6,83.63340689975605,0.6906636018703368,0.8048325766319633,0.922324179069158,0.46935857001002057,104,103,105,171,66,67,68,771.4331604318782,25,287.75322283609574,4.71717275586446,4.835524783012083,4.967356631514093,0.36752754222685524,8609,8688,"Southeast Wyoming, excluding Laramie",Platte,56,31,Wyoming,WY
56037,56CS007,253,235,271,357,86,104,122,295.4585447279476,22,62.54145740547712,1.8219464900826574,2.3347986566637626,2.852160782498819,0.2096586551476405,311,289,332,414,82,103,125,247.3777807708895,82,196.6757009569952,-0.0046543489917731115,0.505420373012305,1.0687517413097272,0.7874074865078896,42212,41693,Sweetwater+Uinta,Sweetwater,56,37,Wyoming,WY
56041,56CS007,139,130,148,154,6,15,24,87.01079917407222,2,11.750305997552019,0.23983822050173811,0.7442314544228965,1.2553753977797266,0.12650250896590137,174,163,184,186,2,12,23,60.61954665710058,23,111.61255883922938,-1.0544380216454585,-0.4989333948297145,-6.967670103795101e-4,1.704730332765402,20425,20607,Sweetwater+Uinta,Uinta,56,41,Wyoming,WY
