FIPSCode,csCode,expDeathsMed2020,expDeathsLow2020,expDeathsUp2020,deaths2020,excDeathsLow2020,excDeathsMed2020,excDeathsUp2020,excCDR2020,COVIDDeaths2020,COVIDCDR2020,nonCovidExcCDRLow2020,nonCovidExcCDRMed2020,nonCovidExcCDRUp2020,COVIDExcRatio2020,expDeathsMed2021,expDeathsLow2021,expDeathsUp2021,deaths2021,excDeathsLow2021,excDeathsMed2021,excDeathsUp2021,excCDR2021,COVIDDeaths2021,COVIDCDR2021,nonCovidExcCDRLow2021,nonCovidExcCDRMed2021,nonCovidExcCDRUp2021,COVIDExcRatio2021,pop2020,pop2021,csName,countyName,stateFIPS,countyFIPS,state,stateStr
01001,01CS001,475,450,500,565,65,90,115,616.8903069047207,55,376.4158368408445,0.6968345235348338,2.4231174014886574,4.154425043087672,0.6034875400538314,587,557,618,707,89,120,150,202.7026152061186,107,181.16248751333322,-0.29274781755777374,0.1937276003820094,0.7483385037758842,0.8863320877705031,58446,59063,Autauga,Autauga,1,1,Alabama,AL
01003,01CS002,2020,1920,2121,2277,156,257,357,441.54247201760154,165,284.0114465219356,-0.16298346764495314,1.5705877669667037,3.384197901646485,0.6407278832792175,2535,2412,2658,3096,438,561,684,235.4008359759474,435,182.46873912003926,0.04467115696841318,0.5174057508808239,1.0694514403560387,0.7737617828514607,232385,238397,Baldwin,Baldwin,1,3,Alabama,AL
01005,01CS003,257,246,268,324,56,67,78,1070.214435479734,38,606.0364419281528,2.996047931331223,4.6528841218248775,6.334450510471843,0.5579609821189985,314,301,327,373,46,59,72,236.309324540613,52,208.0332853256521,-0.2170383548770643,0.288283624191025,0.8067973698794053,0.8656873036233724,25081,24996,Barbour+Bullock+Henry,Barbour,1,5,Alabama,AL
01011,01CS003,103,102,104,132,28,29,30,1124.6104757293933,20,777.7561734396267,3.071657953167986,3.4636541682113284,3.870631663101308,0.668463532664155,127,126,128,141,13,14,15,135.72147298886685,13,125.99340957549913,-0.030548744123916557,0.10300649016895853,0.22122063775768386,0.8664505402263935,10286,10318,Barbour+Bullock+Henry,Bullock,1,11,Alabama,AL
01067,01CS003,193,185,200,228,28,35,43,825.0638176647201,24,558.4317375370833,0.922819288812811,2.632857465373134,4.30990093413711,0.6582704233269768,239,230,248,271,23,32,41,184.7445029065855,37,212.44832338079928,-0.8056075742944934,-0.29282665445844125,0.20077106777291268,1.1152942137627964,17191,17416,Barbour+Bullock+Henry,Henry,1,67,Alabama,AL
01007,01CS004,220,210,229,252,23,32,42,578.3856068126292,40,718.6812199613709,-3.166974961715678,-1.3064738195850945,0.2538131461675966,1.2051279310194052,273,261,284,339,55,66,78,295.91371043720045,46,204.99108734402853,0.43380169789437667,0.9083228192977976,1.4061322032195975,0.6824618341440167,22263,22440,Bibb+Chilton+Coosa+Perry,Bibb,1,7,Alabama,AL
01021,01CS004,445,425,464,529,65,84,104,749.4158105877926,76,676.3671961909847,-0.9615046607214232,0.7561479169540485,2.635206456328921,0.8919339037007686,550,527,574,653,79,103,126,227.22065350479593,107,236.5268137406605,-0.615726382913919,-0.09526486806098494,0.4248190893953853,1.0309270480496493,44946,45238,Bibb+Chilton+Coosa+Perry,Chilton,1,21,Alabama,AL
01037,01CS004,130,126,135,144,9,14,18,530.2195906059032,19,728.4577782037765,-3.622003357115518,-1.9785922419074016,-0.32259543511312105,1.2812340870913568,160,154,165,184,19,24,30,232.79790284215306,21,201.1494252873563,-0.16289213898811086,0.33033205151147244,0.8469367774145115,0.829905000494866,10433,10440,Bibb+Chilton+Coosa+Perry,Coosa,1,37,Alabama,AL
01105,01CS004,97,96,98,141,43,44,45,2057.7875841125956,23,1080.7001057206626,9.377706202474801,9.764506637843153,10.148063624507497,0.5134517177478094,117,116,118,160,42,43,44,512.4148504894005,21,250.92603656350818,2.4959566208200865,2.6126821673513554,2.7450868135207713,0.47853433042376026,8513,8369,Bibb+Chilton+Coosa+Perry,Perry,1,105,Alabama,AL
01009,01CS005,597,572,622,731,109,134,159,909.5792818401414,92,624.8302091822874,1.1986039547779854,2.8324211531069983,4.664411010935913,0.6818529476026042,733,703,764,841,77,108,138,182.65199217040202,98,165.9694819381171,-0.3928907323295479,0.16839578830460905,0.6858139573749898,0.9003172273706371,58896,59047,Blount,Blount,1,9,Alabama,AL
01013,01CS006,215,206,223,256,33,41,50,869.0765826509067,52,1089.2903901544908,-3.856544706228468,-2.2037331017461255,-0.5124576636762248,1.2238881300841618,260,250,270,308,38,48,58,254.82076588035727,47,248.5851800920294,-0.4285029824220999,0.0729302367806285,0.5649578328170453,0.9556932048318487,19095,18907,Butler+Crenshaw+Pike,Butler,1,13,Alabama,AL
01041,01CS006,155,150,161,209,48,54,59,1624.9289129250028,29,875.8021895054738,5.7939884019468515,7.487520274383352,9.21640213328489,0.5291443722091864,188,181,195,241,46,53,60,406.20290578070524,30,229.1125706430426,1.2485740082870196,1.7611876208837158,2.2387768715580587,0.5536259795238084,13245,13094,Butler+Crenshaw+Pike,Crenshaw,1,41,Alabama,AL
01109,01CS006,268,254,282,359,77,91,105,1101.1892949500386,45,545.6198848135798,3.885843206975489,5.581008748649994,7.321883413406508,0.4900861715303467,330,313,347,457,110,127,144,385.89638318693756,74,224.31039709002727,1.122449503671985,1.6191734142187755,2.1363312136752417,0.576740746451049,32990,32990,Butler+Crenshaw+Pike,Pike,1,109,Alabama,AL
01015,01CS007,1265,1215,1315,1535,220,270,320,932.9655217859533,175,603.8907820385627,1.5114794367760311,3.3000144630972894,5.074426601667798,0.6448956143832533,1544,1484,1604,1865,261,321,381,276.5427428810828,302,260.3111666594837,-0.33673588407185845,0.1507641019386315,0.6990355855513234,0.9383805187753727,115915,116015,Calhoun,Calhoun,1,15,Alabama,AL
01017,01CS008,374,359,389,516,127,142,157,1648.283744794741,73,847.4822231896677,6.109971637026189,8.0271855041078215,9.648685932854244,0.5105643418440676,455,437,473,576,103,121,139,350.04398640381856,77,222.79447932640838,0.7847241755323546,1.2728677393728407,1.793286291015184,0.6312577412979659,34455,34561,Chambers+Cleburne+Randolph,Chambers,1,17,Alabama,AL
01029,01CS008,169,162,175,189,14,20,27,542.8494161376871,25,665.335994677312,-2.8046189138496453,-1.1904999690023481,0.4148379218297973,1.168357141743405,206,198,213,262,49,56,64,373.32853561109096,41,271.6491088584112,0.4935249983684936,1.0205741390837513,1.5567651066430501,0.7149523902035441,15030,15093,Chambers+Cleburne+Randolph,Cleburne,1,29,Alabama,AL
01111,01CS008,250,241,260,306,46,56,65,1005.5467446639703,54,977.7737540174732,-1.4351887850392169,0.2802079406869416,2.001675725891154,0.9551802396264388,304,292,315,356,41,52,64,238.56824218195828,55,250.1591922132266,-0.6565245818590235,-0.1153705793786812,0.3781159189885985,1.0289679986428146,22091,21986,Chambers+Cleburne+Randolph,Randolph,1,111,Alabama,AL
01019,01CS009,291,281,302,398,96,107,117,1695.5439875880647,34,540.7339668402847,9.781641583056727,11.521606513095897,13.198582244771139,0.31595116512763194,354,342,367,469,102,115,127,458.30502340132847,64,256.10244097639054,1.4640743113872916,2.029796492849003,2.5757647814576723,0.5539666266026811,25151,24990,Cherokee+Etowah,Cherokee,1,19,Alabama,AL
01055,01CS009,1201,1156,1245,1446,201,245,290,950.3106683886344,222,860.1900555055068,-0.8885375941659193,0.9348847482424554,2.6303991684993266,0.9014915308664233,1464,1411,1518,1820,302,356,409,344.7187777342136,287,278.1115547114229,0.17306658804322414,0.6758923149996235,1.1761867183040229,0.8045165280467081,103233,103196,Cherokee+Etowah,Etowah,1,55,Alabama,AL
01023,01CS010,154,149,160,160,0,6,11,175.54620692538634,31,983.8146620120597,-9.803354934621137,-8.069318696654125,-6.411668253930616,4.7462581639676165,188,182,195,210,15,22,28,174.50777979234692,23,183.32536266539137,-0.6079494261683678,-0.08795767790155135,0.39850695040265033,1.0046411778573652,12604,12546,Choctaw+Clarke+Washington,Choctaw,1,23,Alabama,AL
01025,01CS010,251,242,261,371,110,120,129,2073.237094161368,43,745.6862915113154,11.593385880152175,13.244103642582838,15.09823145766332,0.35668894665483525,305,294,317,389,72,84,95,367.06232745270097,53,232.5173291216987,0.8647951202087768,1.373359419656426,1.8648525388676112,0.6259730121580123,23066,22794,Choctaw+Clarke+Washington,Clarke,1,25,Alabama,AL
01129,01CS010,165,158,172,188,16,23,30,595.2834687808431,24,622.4066390041494,-1.9647585330926856,-0.24618855647648485,1.446435494937477,1.0019148866080985,200,192,208,243,35,43,51,283.8092950726729,32,210.95655613422107,0.20863911376451413,0.7094950089712353,1.1968966200778715,0.7264302008203245,15424,15169,Choctaw+Clarke+Washington,Washington,1,129,Alabama,AL
01027,01CS011,163,157,169,218,49,55,61,1560.8857536197493,40,1138.2229494202177,2.471860150950228,4.191365226902169,5.996629233692999,0.7161601663717377,200,193,207,235,28,35,42,246.5838782667274,24,169.13319238900633,0.2121712656446746,0.7890440510086132,1.3039627287071185,0.6668472280376192,14057,14190,Clay+Talladega,Clay,1,27,Alabama,AL
01121,01CS011,872,837,907,1038,131,166,201,812.0695483430694,130,636.1400976230381,0.16056054867741587,1.737393634053383,3.4338072430781477,0.7786645775159704,1062,1020,1104,1366,262,304,346,372.9506533877608,203,248.7653640184797,0.7757895626237339,1.2336527283136407,1.7653743442595908,0.6648349934571338,81743,81603,Clay+Talladega,Talladega,1,121,Alabama,AL
01031,01CS012,477,454,500,616,116,139,162,1041.6980765990625,70,523.4329725384629,3.4878727630810715,5.173746687309065,6.938251879817403,0.4988992570851223,592,564,620,716,96,124,152,229.29941314993573,128,236.6645095682722,-0.6201859191354492,-0.08127341340624422,0.46336651557137293,1.0238641323929891,53493,54085,Coffee+Geneva,Coffee,1,31,Alabama,AL
01061,01CS012,315,304,327,402,75,87,98,1303.8169785284827,54,811.298076923077,2.989708730444116,4.928359742456956,6.477920643460419,0.6151598763395266,386,372,400,528,128,142,156,531.5622978057439,81,303.40487695246657,1.7413759711637113,2.2889181684603317,2.786823755303678,0.5667855813211868,26624,26697,Coffee+Geneva,Geneva,1,61,Alabama,AL
01033,01CS013,649,624,674,675,1,26,51,182.5190508679266,83,582.7628576443742,-5.698906093884678,-3.960194616898298,-2.328212407244118,3.0746120378190223,797,768,827,884,57,87,116,151.0597340505474,117,203.6943540103414,-1.0649005748907208,-0.5315596064274897,-0.047113397275252024,1.3330720262821305,56970,57439,Colbert,Colbert,1,33,Alabama,AL
01035,01CS014,148,143,153,183,30,35,40,1194.8182265113846,27,930.8739872435787,0.8855680061076338,2.6761232062352494,4.314014412636895,0.7572421235809194,179,173,185,224,39,45,51,394.56544652303677,35,308.07147258163894,0.33950135217951,0.8777803934721846,1.3750746745075544,0.763748892240505,11602,11361,Conecuh+Marengo+Monroe+Wilcox,Conecuh,1,35,Alabama,AL
01091,01CS014,237,229,246,281,35,44,52,910.4791305748506,35,729.6987386636089,0.22938753674469203,1.8178372671107152,3.394836791529475,0.7835037713685229,290,280,299,350,51,60,70,317.43179570395284,60,315.20882584712376,-0.5032598716532763,0.0324295202519877,0.5459816945369719,0.9768305192688969,19186,19035,Conecuh+Marengo+Monroe+Wilcox,Marengo,1,91,Alabama,AL
01099,01CS014,219,210,227,283,56,64,73,1294.5621018718662,30,604.351329572925,5.32840752083343,6.877917982125,8.627356300947019,0.4596851331673997,268,258,278,374,96,106,116,538.5013772664081,52,264.50989368736964,2.207190869321057,2.749693295819739,3.2521314617548556,0.4865998552434638,19856,19659,Conecuh+Marengo+Monroe+Wilcox,Monroe,1,99,Alabama,AL
01131,01CS014,139,135,144,150,6,11,15,402.8961861571038,22,838.654340989231,-6.0267872736689085,-4.39989326131692,-2.571345772566457,1.9016379164886252,171,165,176,182,6,11,17,108.84617760185972,25,239.09716908951796,-1.816552651887053,-1.3071927704765067,-0.7821249317626685,2.0192301251657936,10493,10456,Conecuh+Marengo+Monroe+Wilcox,Wilcox,1,131,Alabama,AL
01039,01CS015,463,447,479,591,112,128,144,1368.2446456441903,90,962.1038003100113,2.318509287195764,4.110961183402015,5.79091358846303,0.6977152788840525,566,546,585,723,138,157,177,419.3981602137364,126,335.85670114084655,0.32124381040924005,0.8416464204902625,1.3581312484130494,0.7957488630893562,37418,37516,Convington+Escambia,Covington,1,39,Alabama,AL
01053,01CS015,407,391,423,515,92,108,124,1176.1831004204294,58,632.9286591188105,3.7404884059153236,5.411470134150683,7.289952292890285,0.533174097568574,498,479,517,658,141,160,179,436.38558403258037,108,294.3260478552352,0.8892291647299837,1.4329543076019051,1.9599146852546978,0.670277367245889,36655,36694,Convington+Escambia,Escambia,1,53,Alabama,AL
01043,01CS016,945,907,982,1043,61,98,136,449.6978464012036,121,552.8016995225804,-2.8418640979776426,-0.982839308561649,0.6079256982658974,1.2169106761988944,1174,1128,1220,1308,88,134,180,149.79390803307982,187,209.44402132520943,-1.1333879209275246,-0.5989061790253136,-0.10133905725917769,1.3878375705085304,87554,89284,Cullman,Cullman,1,43,Alabama,AL
01045,01CS017,454,433,475,555,80,101,122,821.5732245627757,86,698.6331972623327,-0.6043997499626349,1.1852664153789971,2.9276327861285223,0.8420342724697651,557,532,583,736,153,179,204,362.16709690524675,96,194.635362812481,1.1731528997204064,1.661564049161883,2.1855338996482248,0.5344268978215955,49239,49323,Dale,Dale,1,45,Alabama,AL
01047,01CS018,436,419,452,560,108,124,141,1309.5947757538931,100,1053.0749789385004,0.8675387170565144,2.557701709860691,4.283177032529336,0.797708216803946,527,508,547,678,131,151,170,399.86372398125866,101,267.89029759694444,0.7732448065844303,1.316748639575584,1.8432822410680982,0.6655393299553857,37984,37702,Dallas+Lowndes,Dallas,1,47,Alabama,AL
01085,01CS018,134,129,138,156,18,22,27,873.9034566249218,39,1532.5670498084291,-8.331012244137826,-6.6181103385684334,-4.786180952805903,1.6782380309326392,160,155,165,184,19,24,29,240.88596031155672,33,329.5715569759313,-1.4038373172730094,-0.9145378743667226,-0.40169389013110773,1.3136989111698305,10179,10013,Dallas+Lowndes,Lowndes,1,85,Alabama,AL
01049,01CS019,701,670,731,868,137,167,198,934.7270863103023,123,686.8534573020061,0.8393513806845335,2.4605946707013953,4.362594901767506,0.730453293462556,859,822,896,1119,223,260,297,361.88526231757595,172,239.6010364137854,0.7010609726785005,1.2095998454132906,1.73267596340872,0.6595523100461835,71631,71786,DeKalb,DeKalb,1,49,Alabama,AL
01051,01CS020,728,691,766,850,84,122,159,557.3084316718674,93,426.18518433654884,-0.25191091400472965,1.3139163717325226,2.9456230744825485,0.7584836431126196,909,863,955,1087,132,178,224,200.16757907404528,157,176.14522444491814,-0.26602890751168146,0.24233975884046877,0.7623819334071977,0.8750839172511821,87286,89131,Elmore,Elmore,1,51,Alabama,AL
01057,01CS021,193,186,200,236,36,43,50,1047.0758098334377,41,1006.999877195137,-1.2652915630268977,0.37262149855173565,2.0492043085959066,0.9396839430005702,233,225,242,316,74,83,91,510.54514222416447,51,315.3793828458351,1.4366528287432234,1.965453979860936,2.4316100340197404,0.6103380133424046,16286,16171,Fayette+Lamar+Marion,Fayette,1,57,Alabama,AL
01075,01CS021,168,162,174,220,46,52,58,1494.171029684567,45,1295.1503813498346,0.2920605276591417,1.9092051303258357,3.761911483865279,0.8504209288325577,202,195,209,242,33,40,47,293.3072165306923,34,247.7050852396911,-0.06963846764460188,0.45667147361033084,0.9488772806800271,0.8240556674376812,13898,13726,Fayette+Lamar+Marion,Lamar,1,75,Alabama,AL
01093,01CS021,346,333,359,444,85,98,111,1334.2075509061196,61,831.0343653145329,3.334163389105335,5.104471017852205,6.7573782266922064,0.6165716066635195,420,405,435,510,75,90,105,308.90209885425105,72,246.13701627239163,0.13822467759484197,0.6476756663668131,1.1492517725765246,0.7880907063725917,29361,29252,Fayette+Lamar+Marion,Marion,1,93,Alabama,AL
01059,01CS022,320,306,334,385,51,65,79,810.5111710022012,49,612.7297736651244,0.22802470070981554,1.9996009700650705,3.540393415544514,0.7444932755865179,391,375,408,491,83,100,116,310.883605397552,57,178.01374141161773,0.8325652829456883,1.3326720471046196,1.8474988775461982,0.5669107308131409,31988,32020,Franklin+Lawrence,Franklin,1,59,Alabama,AL
01079,01CS022,349,335,363,461,98,112,126,1354.9600486370118,59,714.3938247313455,4.72034954221649,6.363528200773361,8.171136679167375,0.5225735705973462,427,410,444,583,139,156,173,472.0652936383334,96,290.1529347760382,1.2953484196214526,1.8131135324019085,2.311329120064035,0.6107354969104112,33035,33086,Franklin+Lawrence,Lawrence,1,79,Alabama,AL
01063,01CS023,86,85,87,133,46,47,48,2432.1015274154697,21,1083.1721470019343,13.076880876324319,13.48840973877556,13.907353824590572,0.4361156203531146,104,103,105,137,32,33,34,433.521810061593,23,301.0471204188481,1.2015372605047068,1.322774797904274,1.4412434063433324,0.6740703765055885,7755,7640,Greene+Hale+Pickens+Sumter,Greene,1,63,Alabama,AL
01065,01CS023,169,163,176,216,40,47,53,1266.297622118723,37,1002.031144211239,0.7113451809048994,2.6424939199273334,4.356145506542389,0.7747386667240116,208,200,215,262,47,54,62,369.00590517546283,40,271.00271002710025,0.45494295780227384,0.9734542173282581,1.4889868521029117,0.7211719846187257,14770,14760,Greene+Hale+Pickens+Sumter,Hale,1,65,Alabama,AL
01107,01CS023,208,200,216,277,61,69,77,1437.9189384584631,37,772.3216615352502,4.902976800128505,6.619652713150213,8.41167723426338,0.5294253042759259,252,243,262,340,78,88,97,465.704041481175,48,254.7905939805722,1.5517842617376418,2.0936441334822127,2.5903681342443092,0.5409426877231389,19163,18839,Greene+Hale+Pickens+Sumter,Pickens,1,107,Alabama,AL
01119,01CS023,143,138,148,171,23,28,33,912.1548539972022,27,878.6917256529167,-1.3636859266498313,0.3423882243097773,1.9709380571005186,0.9301287850505886,174,168,180,163,-17,-11,-5,-90.54176527618824,14,114.91422473939095,-2.586162087626554,-2.0468156945899865,-1.4939322358303748,-1.395714700364708,12291,12183,Greene+Hale+Pickens+Sumter,Sumter,1,119,Alabama,AL
01069,01CS024,983,937,1029,1210,181,227,273,848.8181700073858,171,638.7807133051299,0.3753996686311134,2.1199416375785907,3.7076958918169907,0.7492556668589027,1208,1152,1263,1602,339,394,450,367.0935114202871,244,227.14789748554725,0.8720667101438074,1.4154972707706912,1.8895797548410802,0.6172087216173497,107079,107419,Houston,Houston,1,69,Alabama,AL
01071,01CS025,613,591,636,747,111,134,156,1020.9820483148796,69,526.4965090992332,3.2827308853723247,4.955049504999113,6.720594350874569,0.5118512011537595,751,724,779,985,206,234,261,443.1372270109263,159,301.50182038834953,0.8909043075178144,1.4248532302670702,1.9623436812933457,0.6774812327271432,52422,52736,Jackson,Jackson,1,71,Alabama,AL
01073,01CS026,6243,5954,6532,7235,703,992,1281,591.6581461368183,747,445.5664793239557,-0.44603870779222315,1.416611502755006,3.1194178263727963,0.7523225041568113,7614,7269,7959,9012,1053,1398,1743,209.09722600861704,1033,154.4961675079454,0.05899506863606821,0.5325725317957266,1.067296405395888,0.7383442774130914,670607,668625,Jefferson,Jefferson,1,73,Alabama,AL
01077,01CS027,962,922,1002,1121,119,159,199,680.5711553806292,130,555.7336753232875,-0.3788985393829585,1.2207401323103673,2.8677802530290664,0.8114724348778899,1180,1131,1228,1306,78,126,175,134.22347532734545,174,185.1457756969568,-1.0496456439286281,-0.5124577495392211,0.004737531471684002,1.368535397394988,93570,93980,Lauderdale,Lauderdale,1,77,Alabama,AL
01081,01CS028,1013,938,1088,1123,35,110,185,254.02550004639306,130,299.75327999262146,-2.1411979397259944,-0.4035757792618683,1.3642054338113816,1.169397909717234,1277,1186,1369,1442,73,165,256,93.05482527924468,189,106.87868985953085,-0.6853189684972029,-0.13035069368467897,0.3864245550169857,1.1416184939994507,173476,176836,Lee,Lee,1,81,Alabama,AL
01083,01CS029,768,723,813,925,112,157,202,605.3129047651576,91,350.34023426596985,0.7409550355379417,2.514648895224834,4.419965221422025,0.5751175806087722,971,916,1026,1149,123,178,233,166.0996488918772,122,113.964372121699,0.031396097558802884,0.5196038392730127,1.0706624894321783,0.682283368152951,103899,107051,Limestone,Limestone,1,83,Alabama,AL
01087,01CS030,221,213,229,289,60,68,76,1415.8527529715802,38,791.2545549193128,4.58016109050128,6.2986048936929295,7.932086332797817,0.5507539436859453,268,258,278,246,-32,-22,-12,-115.24164425768627,30,158.06111696522655,-3.25084312712265,-2.740655349079105,-2.2313448565908485,-1.4372728095608596,19210,18980,Macon+Tallapoosa,Macon,1,87,Alabama,AL
01123,01CS030,481,464,499,534,35,53,70,511.26069499090755,79,769.2869489008447,-4.262848396428014,-2.558496963780041,-0.8685449826829785,1.4765626816576776,591,570,613,729,116,138,159,335.0273904823289,99,241.15168197208487,0.4165743911942401,0.9391887461607997,1.4912998438412441,0.7146012802791333,41077,41053,Macon+Tallapoosa,Tallapoosa,1,123,Alabama,AL
01089,01CS031,2949,2781,3116,3158,42,209,377,215.9958674464442,217,223.84403125564123,-1.8201280793703278,-0.0749535414538159,1.625978853745281,1.0314090491905572,3677,3474,3881,4090,209,413,616,104.598592308876,466,118.15206119566842,-0.637861541478339,-0.1414791464152107,0.36345668007735693,1.1268445642370744,387770,394407,Madison,Madison,1,89,Alabama,AL
01095,01CS032,988,946,1030,1227,197,239,281,978.999173662713,147,602.7801697625785,2.1364505056067418,3.7671868212917983,5.451203445162825,0.6131424494293509,1213,1163,1264,1424,160,211,261,214.58890458907624,152,154.8839389431209,0.10936269970053898,0.6124246283149477,1.0734618422597226,0.718359368275776,97548,98138,Marshall,Marshall,1,95,Alabama,AL
01097,01CS033,3742,3564,3921,4423,502,681,859,657.4621309608663,473,456.9827544563064,0.3211475341255116,1.950634541701286,3.708501335480395,0.6940509342648129,4582,4369,4796,5832,1036,1250,1463,302.39805708713004,844,204.23719585233943,0.4771190612546212,0.9829422613150929,1.4703090751200572,0.6748518568789492,414020,413245,Mobile,Mobile,1,97,Alabama,AL
01101,01CS034,1812,1713,1910,2377,467,565,664,992.0609190829672,337,591.238442779698,2.1985131358801255,3.9439762164637617,5.695656731017114,0.5949178096428036,2217,2099,2334,2780,446,563,681,247.59622282982153,384,168.73039168299778,0.2528635713287721,0.7925300080111539,1.2909426832724724,0.6802667631184409,227996,227582,Montgomery,Montgomery,1,101,Alabama,AL
01103,01CS035,1203,1150,1256,1492,236,289,342,941.7646533348772,169,550.354148009444,2.2522107803510094,3.888390064968161,5.711504407204303,0.5823722851116303,1481,1417,1545,1693,148,212,276,171.35279859060367,214,173.11114706358194,-0.5393530915414377,0.010359604099307092,0.4644019936336914,1.0055146860090292,122830,123620,Morgan,Morgan,1,103,Alabama,AL
01113,01CS036,546,521,572,637,65,91,116,615.9003191642685,70,474.50388923723494,-0.22008719012879535,1.3372718028383257,3.1992722560523146,0.7620361860128801,664,634,695,854,159,190,220,322.78302681724756,124,210.898700591877,0.5972868065607108,1.1142289714645746,1.658029098242274,0.6499513559063345,59009,58796,Russell,Russell,1,113,Alabama,AL
01115,01CS037,835,795,874,1035,161,200,240,877.6808949165621,136,596.1839841309852,1.2113899966087076,2.7821105983082632,4.4292818711981505,0.6758960553114453,1035,987,1083,1312,229,277,325,299.0754295729017,219,236.64930518035055,0.13607089128051975,0.6397238584189529,1.120211139646965,0.7884209857740831,91247,92542,St. Clair,St. Clair,1,115,Alabama,AL
01117,01CS038,1347,1251,1444,1592,148,245,341,438.1102828604323,148,265.19257819149414,0.05486493236690101,1.675909633440818,3.4602754909749924,0.6028445041715498,1692,1575,1809,1935,126,243,360,107.2171061930564,225,99.36582522213783,-0.4470415269856811,0.07592392634269392,0.5725211480887423,0.9229704205098154,223234,226436,Shelby,Shelby,1,117,Alabama,AL
01125,01CS039,1620,1523,1717,1887,170,267,364,474.8496578497836,252,448.6320727424861,-1.338534683123395,0.2634255868986912,2.043793791970559,0.9412586819788755,2003,1886,2120,2344,224,341,458,150.09209944634603,362,159.4516975879627,-0.5879357331872302,-0.08699215533003563,0.448944526859324,1.0592504573379244,224683,227028,Tuscaloosa,Tuscaloosa,1,125,Alabama,AL
01127,01CS040,877,849,905,1111,206,234,262,1441.9711484202169,165,1017.5135668475581,2.5117081994353065,4.266287685942006,5.981442639942072,0.702635825453851,1065,1032,1099,1294,195,229,262,352.87997945730547,201,309.9030203980943,-0.08657317418376358,0.4408278516729004,0.9467964120201466,0.874390438317995,64864,64859,Walker+Winston,Walker,1,127,Alabama,AL
01133,01CS040,264,254,274,327,53,63,73,1072.2007050500893,37,628.7704987679497,2.7607877391660494,4.398896268152097,6.0572950429622425,0.5772802721938758,323,311,335,424,89,101,113,427.14737200315494,71,300.47822590884084,0.7911107355973184,1.2643009367880684,1.7807608271010058,0.696552001162435,23538,23629,Walker+Winston,Winston,1,133,Alabama,AL
02020,02CS001,1470,1345,1595,1748,153,278,403,383.3506744590533,117,161.3203449773531,0.3994689736718172,2.255922394367198,3.859034307982241,0.4193085090096149,1823,1674,1972,2370,398,547,696,189.7310287547782,278,96.36449349712987,0.4591889470122223,0.9322304286745303,1.4609266892716355,0.5069743159723356,290106,288488,Anchorage,Anchorage,2,20,Alaska,AK
02090,02CS002,396,355,437,473,36,77,118,323.56400760250034,19,79.5137108839623,0.9001714021626941,2.452800360608155,4.131458624072124,0.24260554723250496,495,446,545,684,139,189,238,197.40845540644264,90,94.19349436932222,0.517156613135226,1.003489165759522,1.5968958694546047,0.4746339005724008,95581,95548,Fairbanks North Star,Fairbanks North Star,2,90,Alaska,AK
02122,02CS003,392,366,417,393,-24,1,27,9.07092461958633,18,122.0607930560971,-2.8515135662693223,-1.2219321332955397,0.6607057839410335,7.699986038295857,488,457,519,589,70,101,132,169.37111903601922,66,110.66398390342052,0.038719779283593526,0.5884751975376729,1.0798202740320995,0.646976775500922,58987,59640,Kenai Peninsula,Kenai Peninsula,2,122,Alaska,AK
02170,02CS004,535,488,581,639,58,104,151,386.34731954214675,33,122.26863902036885,0.9218249697922464,2.624214005306644,4.318829581292128,0.31346718972679205,679,622,736,991,255,312,369,282.98768049936336,165,149.7060317921173,0.8607228389906805,1.3327918126712992,1.8541627051985663,0.5273288968804029,107959,110216,Matanuska-Susitna,Matanuska-Susitna,2,170,Alaska,AK
02140,02CS005,48,47,49,52,3,4,5,215.64794707992704,4,206.61157024793388,-0.3249335030888361,0.09556946200695257,0.4746126833306176,0.7729551860918993,58,57,59,69,10,11,12,148.48331617589199,7,92.1901751613328,0.4452883069225084,0.5657475470580638,0.681882169382536,0.5702955130873446,7744,7593,Northern Alaska,Northern Alaska,2,140,Alaska,AK
02180,02CS005,63,62,64,66,2,3,4,101.90952051984188,8,319.4888178913738,-2.584988921559388,-2.179269707902538,-1.7859794828619688,2.252369947575741,77,76,78,94,16,17,18,170.84666618969067,2,20.224491859642026,1.3754441136441928,1.507101865418543,1.6290738522794963,0.1117628948072204,10016,9889,Northern Alaska,Nome,2,180,Alaska,AK
02185,02CS005,55,54,56,45,-11,-10,-9,-361.52410170159845,8,297.3148750348416,-6.986452016128752,-6.584515468898625,-6.17168367814019,-0.9166207646677272,69,67,70,59,-11,-10,-8,-90.03310225781905,6,54.66970387243736,-1.5711371203238853,-1.4465460021004215,-1.3223462382465097,-0.6755894792228626,10763,10975,Northern Alaska,North Slope,2,185,Alaska,AK
02240,02CS005,91,90,92,108,16,17,18,489.08544127883766,6,173.57344326318074,2.7738198591578627,3.1496431303924033,3.586319921079488,0.3350745858089746,112,110,114,146,32,34,36,245.66723338858247,10,72.33796296296296,1.611697356499619,1.7313609765586118,1.8562930304057614,0.28603269450147334,13827,13824,Northern Alaska,Southeast Fairbanks,2,240,Alaska,AK
02261,02CS005,53,52,54,3,-51,-50,-49,-2090.1034029738407,3,124.55885405854266,-22.5434172426463,-22.14256049148892,-21.76825415090551,-0.06080242115228873,65,64,67,4,-63,-61,-60,-640.9007035803633,4,41.71881518564873,-6.946190569947064,-6.827872193969086,-6.7030431236503505,-0.06617087098366915,9634,9588,Northern Alaska,Valdez-Cordova,2,261,Alaska,AK
02100,02CS006,10,10,10,19,9,9,9,1672.9614041922152,7,1300.5109150023225,3.3293881558909018,3.7416186821474287,4.132408538343856,0.699670122464755,12,12,12,21,9,9,9,441.44368878119957,5,241.196333815726,1.8871677802098004,1.999069911244364,2.12540434696234,0.49255611428746926,2153,2073,Southeast Alaska,Haines,2,100,Alaska,AK
02110,02CS006,166,152,180,171,-9,5,19,59.43721333824747,4,49.76826650906716,-1.5833953680317177,0.11582488421184352,1.7436664716409447,0.6923868259802357,205,188,221,218,-3,13,30,41.95610833175011,13,40.61865333541634,-0.48242805357456037,0.014956076171919977,0.5143379370496974,0.9010225063715359,32149,32005,Southeast Alaska,Juneau,2,110,Alaska,AK
02195,02CS006,192,181,203,231,28,39,50,616.0871217583627,8,126.77283891926155,3.1477561789965054,4.879462234117445,6.576290232395157,0.20061097165468686,233,220,246,348,102,115,128,461.7180073428608,16,64.17455478902615,3.4414430484341874,3.972894640003049,4.493777567144077,0.13779379472513953,25242,24932,Southeast Alaska,Petersburg,2,195,Alaska,AK
02220,02CS006,51,50,52,56,4,5,6,233.9067997738043,3,142.2475106685633,0.5243931405317229,0.9043855931488004,1.3109736349111853,0.505638338797453,62,61,64,76,12,14,15,160.5440681646626,1,11.890606420927467,1.3574149959705966,1.4833754792378888,1.6041769983886232,0.06895716566000429,8436,8410,Southeast Alaska,Sitka,2,220,Alaska,AK
02232,02CS006,32,30,34,20,-14,-12,-10,-1167.8198847982437,2,189.7083234526915,-15.282058250507793,-13.655814567725969,-11.75546842185074,-0.17680744069769264,39,37,41,44,3,5,7,117.25427556945013,6,143.36917562724014,-0.7709214751481863,-0.24410660107652124,0.24862064665178163,1.0157283103671055,4217,4185,Southeast Alaska,Southeast Alaska,2,232,Alaska,AK
02010,02CS007,35,34,36,18,-18,-17,-16,-788.3266931916277,7,322.9527104959631,-11.505129332412212,-11.109818343830169,-10.699329688855713,-0.43513447099838143,43,42,44,28,-16,-15,-14,-172.42801944298998,7,82.53743662303974,-2.672558149255268,-2.547853373340361,-2.4290464830318013,-0.51381349677809,8670,8481,Southwest Alaska,Southwest Alaska,2,10,Alaska,AK
02050,02CS007,108,106,110,115,5,7,9,153.0157794041327,15,322.30339492909326,-2.1033624242243154,-1.7038216187611541,-1.3042219187693194,1.8469825733751408,133,130,135,146,11,13,16,71.04488103748577,22,118.47065158858373,-0.5953200155262954,-0.47374679876195935,-0.355197622699395,1.5500561308140561,18616,18570,Southwest Alaska,Bethel,2,50,Alaska,AK
02060,02CS007,7,7,7,5,-2,-2,-2,-1146.562465873529,5,2400.9603841536614,-35.883306547828035,-35.48228300075387,-35.09094818197232,-3.60304182723741,9,9,9,15,6,6,6,703.1588379684333,4,477.89725209080046,2.1333277245919993,2.2499214256876763,2.3762267743885186,0.5809360484865159,833,837,Southwest Alaska,Bristol Bay,2,60,Alaska,AK
02070,02CS007,44,43,45,53,8,9,10,570.3618786442252,3,190.05384859043394,3.4024089213723925,3.786827720399439,4.191233097555114,0.2999051623581022,53,52,54,65,11,12,13,190.0410105102935,11,177.33354828308885,0.00476796556882195,0.12825810223746342,0.2598751338490294,0.8601650157394138,6314,6203,Southwest Alaska,Dillingham,2,70,Alaska,AK
02150,02CS007,54,53,55,66,11,12,13,368.11573396018076,1,30.707815138952864,2.9446106590165644,3.374899923981877,3.7641265688993073,0.07699599286029113,66,64,68,104,36,38,40,296.4825504794114,6,46.798221667576634,2.367597183850395,2.498159581603243,2.620018877185164,0.1537987215436858,13026,12821,Southwest Alaska,Kodiak Island,2,150,Alaska,AK
02158,02CS007,53,52,54,52,-2,-1,-0,-60.34582993155905,4,191.36466929793087,-2.912223517622374,-2.5256144521601556,-2.0771775570167956,-15.303465220216207,66,65,67,84,17,18,19,219.72121584452566,10,119.61722488038276,0.8678712944546828,0.9944721456997215,1.1295079367109084,0.5162970814392943,8361,8360,Southwest Alaska,Southwest Alaska,2,158,Alaska,AK
04001,04CS001,564,557,571,1042,471,478,485,2863.1045161104585,300,1797.8336104993484,10.238594070847377,10.653472436827547,11.066678496243942,0.6266199524673407,682,674,690,1194,504,512,520,779.8710753304491,270,411.1904725644579,3.561918369945765,3.687686565308532,3.815502257990764,0.5262268087319549,66747,65663,Apache,Apache,4,1,Arizona,AZ
04003,04CS002,1150,1096,1204,1387,183,237,291,753.2197791343706,171,543.9969459820577,0.34727837724983845,2.0194837598603828,3.8056149276502578,0.7191911586410206,1417,1352,1482,1833,351,416,481,330.26095903445196,311,246.91358024691357,0.321844768786823,0.8364726586541326,1.3367301253743222,0.7458387874255558,125736,125955,Cochise+Graham+Greenee,Cochise,4,3,Arizona,AZ
04009,04CS002,256,240,273,322,49,66,82,678.0548060914682,50,516.795865633075,-0.027153357793515215,1.6222080809131358,3.296500649055329,0.7507304326785392,320,300,340,489,149,169,189,432.75075841009743,88,225.72205407069205,1.5709892717631722,2.058576511215067,2.5842421074872926,0.5185248583507244,38700,38986,Cochise+Graham+Greenee,Graham,4,9,Arizona,AZ
04011,04CS002,56,55,57,62,5,6,7,264.4651768980565,5,210.48200378867608,0.12608335048268418,0.5358318020561706,0.980632332000567,0.6865896417880715,68,67,69,96,27,28,29,294.88336917265,25,265.36461097548033,0.1749410391545824,0.2950207113807888,0.4258330963243465,0.8686297496866247,9502,9421,Cochise+Graham+Greenee,Greenlee,4,11,Arizona,AZ
04005,04CS003,747,685,810,1027,217,280,342,772.3120713227856,207,571.2629879538022,0.29384890392632607,1.988194849945505,3.7861818351205585,0.7370452530643131,929,854,1004,1194,190,265,340,182.86666156523026,184,126.84319010623118,0.03787430239587376,0.5619717829192064,1.0869740936362202,0.6910325548373516,144942,145061,Coconino,Coconino,4,5,Arizona,AZ
04007,04CS004,659,636,682,834,152,175,198,1308.8416798085339,118,883.1013321359079,2.486992579769319,4.311966420852944,5.8105299229218,0.6708836622529601,804,776,831,1054,223,250,278,467.27638909587046,157,293.194890565474,1.2284429009987567,1.7387165623358318,2.2597854327415634,0.6249573057802864,53448,53548,Gila,Gila,4,7,Arizona,AZ
04025,04CS005,2665,2563,2768,3143,375,478,580,804.6057342563788,252,424.49075848244553,2.076559258161185,3.755243444300223,5.586083367120448,0.5264739013564554,3304,3179,3428,4118,690,814,939,337.2092326440353,595,246.37987221373348,0.39468310660531636,0.9120350240632396,1.4505481557092978,0.729747799396492,237461,241497,La Paz+Yavapai,Yavapai,4,25,Arizona,AZ
04013,04CS006,27383,25469,29296,34979,5683,7596,9510,682.4573699179944,4403,395.57331627537576,1.1805420828237885,2.8480439722912525,4.5792743149738655,0.5795545121292061,34149,31832,36466,44161,7695,10012,12329,223.08415397089297,6755,150.50932533944254,0.2051551201954656,0.7490671943994841,1.2305017301230585,0.6746077281105719,4452272,4488094,Maricopa,Maricopa,4,13,Arizona,AZ
04015,04CS007,2859,2767,2951,3445,494,586,678,1093.0287634265078,326,608.1664062682182,3.285096393688986,4.828580477163085,6.495496842963062,0.5554567264994196,3529,3417,3641,4621,980,1092,1204,502.9444204459216,767,353.1892947265661,0.9794586831385901,1.4976255123132935,2.02543850123037,0.7016008254503172,214415,217164,Mohave,Mohave,4,15,Arizona,AZ
04017,04CS008,901,890,912,1519,607,618,629,2297.6990157110868,365,1357.381926366679,8.991266240508955,9.410648114988314,9.777814677779206,0.5898024621610566,1113,1100,1127,1845,718,732,745,677.7677205437312,366,339.0427138238646,3.2590724672294624,3.3906317970381834,3.5193935375536842,0.4995516101153319,107560,107951,Navajo,Navajo,4,17,Arizona,AZ
04019,04CS009,8313,7863,8763,10505,1742,2192,2642,837.7022727476607,1182,451.6609142312355,2.2559599015303666,3.8443968008809613,5.756448847244938,0.5389205674100641,10256,9713,10799,12824,2025,2568,3111,244.3114806253039,1745,166.01781766010967,0.2835446201949397,0.7886641153044017,1.3139691547460133,0.6792689077422881,1046803,1051092,Pima+Santa Cruz,Pima,4,19,Arizona,AZ
04023,04CS009,264,243,284,413,129,149,170,1256.246663226943,103,866.6021622985992,2.1828095325273025,3.9009968991267256,5.489135650447011,0.68524502463939585,329,304,354,427,73,98,123,204.8837314502632,79,165.10271897009343,-0.07164354381870314,0.38434765852826785,0.9223103664757758,0.7976992603511586,47542,47849,Pima+Santa Cruz,Santa Cruz,4,23,Arizona,AZ
04021,04CS010,2671,2485,2858,3650,792,979,1165,897.0484069935284,389,356.6034665707168,3.7372158867095644,5.377445246002522,7.0039207433469945,0.3971239600260413,3386,3155,3616,4938,1322,1552,1783,347.58965346743844,880,197.0249236528421,1.0212733126772973,1.4966630068603048,2.0359091797966347,0.5664670805487196,436339,446644,Pinal,Pinal,4,21,Arizona,AZ
04027,04CS011,1530,1434,1626,2445,819,915,1011,1638.7351043928472,576,1031.4816804555712,4.416422967833688,6.075386020447966,7.841101628727273,0.6287506332963693,1895,1779,2010,2633,623,738,854,331.0557404559687,468,209.81748568712987,0.7018651331548142,1.1909723859973012,1.7094684198687582,0.6329258240755644,223368,223051,Yuma,Yuma,4,27,Arizona,AZ
05001,05CS001,205,197,212,259,47,54,62,1267.9992261944267,22,513.8686131386861,5.775847628529322,7.523727713706333,9.279846102050149,0.3979291990832768,247,239,256,336,80,89,97,529.0820864026956,30,178.80557873405652,3.0135503193375723,3.4970714846853905,4.031326599312083,0.3341896294384417,17125,16778,Arkansas (county)+Monroe+Phillips+Prairie,Arkansas (county),5,1,Arkansas,AR
05095,05CS001,98,97,99,116,17,18,19,1056.1352737706818,11,651.8518518518518,3.657720371673167,4.041381595471465,4.457829099400935,0.5844137052394481,119,119,120,136,16,17,17,247.489149533149,20,298.7303958177745,-0.6478001993517624,-0.5112032994154596,-0.38819027445916976,1.138342893769696,6750,6695,Arkansas (county)+Monroe+Phillips+Prairie,Monroe,5,95,Arkansas,AR
05107,05CS001,197,190,204,266,62,69,76,1661.654849695804,38,916.6566156072851,5.757827605601753,7.420258013066711,9.150749718319156,0.5437589920485332,235,227,243,311,68,76,84,474.7888217238418,52,325.30497341257427,0.9569732994741683,1.492633672980932,1.9632071630078878,0.6762468903122782,16582,15985,Arkansas (county)+Monroe+Phillips+Prairie,Phillips,5,107,Arkansas,AR
05117,05CS001,93,93,94,127,33,34,34,1636.1713947376934,14,681.7628439250061,9.14023712678696,9.530646104044926,9.926382878700503,0.4046385498425678,114,113,115,145,30,31,32,380.846184585931,20,245.36866642129797,1.233852454891545,1.3569237028329157,1.4830109421595314,0.6241657146398661,8214,8151,Arkansas (county)+Monroe+Phillips+Prairie,Prairie,5,117,Arkansas,AR
05005,05CS002,581,563,599,708,109,127,145,1214.5285021623192,75,718.5112447009795,3.2949133696053323,4.966259802841218,6.649605324203291,0.5869668868635485,711,689,732,928,196,217,239,516.5279644167106,125,297.10265490932426,1.6989117022919038,2.184538169587173,2.7135658541936802,0.5725571687178318,41753,42073,Baxter+Marion,Baxter,5,5,Arkansas,AR
05089,05CS002,224,217,231,268,37,44,51,1047.7683450697773,23,546.253414083838,3.2453273158325597,4.963729034255081,6.662703413984184,0.5097937342130018,273,265,282,305,23,32,40,186.2045210266762,43,253.52278757148753,-1.1798575324252722,-0.6775551813747449,-0.1515951505033929,1.3197410719897433,16842,16961,Baxter+Marion,Marion,5,89,Arkansas,AR
05007,05CS003,1706,1583,1830,1959,129,253,376,353.3201136009569,282,394.1754290326977,-2.136903304058458,-0.3292895849818204,1.2361552349053535,1.1112363665739555,2150,1999,2301,2520,219,370,521,126.47457814055554,372,127.12646349215028,-0.5572764063024849,-0.01835218103588867,0.49284007086196857,1.0024456438763074,286167,292622,Benton,Benton,5,7,Arkansas,AR
05009,05CS004,385,369,401,478,77,93,109,995.1308212972149,63,673.0769230769231,1.5213139820300179,3.177127445677234,4.89444483258367,0.6691858868771638,473,454,493,582,89,109,128,287.6538762256519,68,180.08474576271186,0.5380095001044348,1.0558503192658693,1.5666895226556423,0.6203354895572113,37440,37760,Boone+Carroll+Madison,Boone,5,9,Arkansas,AR
05015,05CS004,280,268,292,314,22,34,46,485.1657958764879,38,538.0911922967997,-2.221908269917592,-0.4844853744154109,1.0319091195136096,1.0776348415006867,343,329,358,394,36,51,65,178.76278367223057,40,140.8401112636879,-0.09939464003161064,0.38573578515104207,0.8987391892750108,0.7726420105902637,28248,28401,Boone+Carroll+Madison,Carroll,5,15,Arkansas,AR
05087,05CS004,169,162,176,154,-22,-15,-8,-364.0052936979219,10,241.12363614443305,-7.779730719240037,-6.045956325970974,-4.319125571146987,-0.7094105666899645,210,201,219,260,41,50,59,296.16824450533454,32,189.3491124260355,0.5772768527153769,1.0811794673565918,1.5886660865875872,0.6268065578489356,16589,16900,Boone+Carroll+Madison,Madison,5,87,Arkansas,AR
05011,05CS005,132,128,137,167,30,35,39,1310.6002362553481,27,1025.4462590201292,1.0526601554543438,2.8314521590171795,4.5588913806211,0.7603897924894973,160,155,166,165,-1,5,10,45.502551771981345,18,172.7281450916419,-1.743579609663507,-1.275797459565207,-0.7964843827971204,3.134894008415737,10532,10421,Bradley+Calhoun+Cleveland+Union,Bradley,5,11,Arkansas,AR
05013,05CS005,59,59,60,69,9,10,10,806.3648152383919,4,334.2385627741801,4.34377292324383,4.719265703601686,5.144699452403521,0.3755808266041666,72,72,73,89,16,17,17,356.34284940949215,5,105.50749103186325,2.3819371688447672,2.5067658450870334,2.6442610539755504,0.2795312519535756,4787,4739,Bradley+Calhoun+Cleveland+Union,Calhoun,5,13,Arkansas,AR
05025,05CS005,87,86,87,110,23,23,24,1229.4483065573768,20,1052.90866017373,1.362254392863805,1.7656237772676318,2.1826416393811234,0.8212415579925513,105,104,106,135,29,30,31,394.8691079772736,11,146.31550944400107,2.36392202424405,2.4870453968632877,2.612139490478348,0.3584666285727832,7598,7518,Bradley+Calhoun+Cleveland+Union,Cleveland,5,25,Arkansas,AR
05139,05CS005,439,422,456,539,83,100,117,1029.4238700929961,70,721.129082105697,1.4270671944700097,3.058397536169072,4.754545092263815,0.6935762695009516,531,511,551,617,66,86,106,223.45791813281838,70,182.17306441119064,-0.12993224772675283,0.3943376944600405,0.9519317648907974,0.8058601687059327,38828,38425,Bradley+Calhoun+Cleveland+Union,Union,5,139,Arkansas,AR
05019,05CS006,202,193,211,243,32,41,50,760.6258395489499,18,334.82142857142856,2.5542288122979153,4.326646996603782,5.89994580067886,0.4296840531322767,247,236,258,291,33,44,55,207.38154896487944,35,164.11122051859147,-0.08383297799205662,0.42278737498962626,0.9585344557615529,0.7738524037600483,21504,21327,Clark+Dallas+Ouachita,Clark,5,19,Arkansas,AR
05039,05CS006,83,82,83,105,22,22,23,1366.11054713245,14,860.8762490392005,4.647280301112365,5.056357889002952,5.4522373512897495,0.6030227088891988,99,98,99,120,21,21,22,337.61616207454443,5,79.01390644753477,2.4623211043081765,2.586458385774033,2.7150254627470694,0.2235700941648274,6505,6328,Clark+Dallas+Ouachita,Dallas,5,39,Arkansas,AR
05103,05CS006,280,271,290,341,51,61,70,1071.0564065641536,38,670.3122243781971,2.3706286762154134,3.995936834577285,5.615826792162004,0.6157018121145087,338,327,350,393,43,55,66,245.70841912449868,46,205.8349740468946,-0.15981659514360644,0.38830035668998164,0.9164204329412734,0.8227373481236558,22676,22348,Clark+Dallas+Ouachita,Ouachita,5,103,Arkansas,AR
05021,05CS007,198,192,204,216,12,18,24,489.46865671279807,27,745.3416149068323,-4.1558688045851655,-2.503728178999067,-0.7055786824006736,1.4414605193626586,239,232,246,280,34,41,48,285.45113102950705,41,285.2570792458081,-0.5050132629249082,-0.008867665859834022,0.5652864020125955,0.9755426447324376,14490,14373,Clay+Greene,Clay,5,21,Arkansas,AR
05055,05CS007,432,412,452,495,43,63,83,548.9190643925351,56,489.1150075332445,-1.1559550476475982,0.588276788785785,2.2180432791672886,0.8770952162909746,532,509,556,612,56,80,103,171.9299745461334,73,157.858316754606,-0.33936978950841296,0.13087118771231937,0.6892661142166409,0.9067501000673381,45797,46244,Clay+Greene,Greene,5,55,Arkansas,AR
05027,05CS008,235,226,245,319,74,84,93,1462.456625336783,30,525.3020486779898,7.596653852311548,9.399149561474191,11.048157936261834,0.3549418043935525,285,274,297,306,9,21,32,91.58426059518334,24,105.81077506392734,-0.6830629459419849,-0.16256249382616278,0.3677921181103529,1.1022754553755916,22844,22682,Columbia+Lafayette+Miller,Columbia,5,27,Arkansas,AR
05073,05CS008,77,76,77,105,28,28,29,1799.949516312223,5,315.80609505763465,14.449803689091262,14.837100674509054,15.241810027448649,0.1695047369273826,92,91,92,105,13,13,14,216.38477698226436,13,210.28793270786153,-0.057947037985326404,0.06011422704758773,0.20218238590987067,0.9042278759004573,6333,6182,Columbia+Lafayette+Miller,Lafayette,5,73,Arkansas,AR
05091,05CS008,415,396,433,503,70,88,107,827.9060536855528,61,571.495491275325,0.7585831182080569,2.54021168776369,4.305477277248412,0.6825661888731155,505,483,527,656,129,151,173,353.98764260888373,102,239.2288388019795,0.6533804706781251,1.153062613400366,1.6620991322085632,0.6713630876302099,42695,42637,Columbia+Lafayette+Miller,Miller,5,91,Arkansas,AR
05029,05CS009,234,225,243,229,-14,-5,4,-100.92146398342041,11,211.8440057775638,-4.608115210008361,-3.178428485685611,-1.4024198546250954,-2.594127309632951,287,276,298,301,3,14,25,66.43519889513644,27,129.48398235181278,-1.1753126286449296,-0.6208098947102253,-0.12775964719584718,1.8178063005775507,20770,20852,Conway+Pope,Conway,5,29,Arkansas,AR
05115,05CS009,515,488,543,642,99,127,154,798.5379247611482,56,352.70591569698786,2.7421857779329213,4.414494990631246,6.147670931054191,0.43823314124643353,636,603,668,753,85,117,150,184.3478494790222,93,145.94187433306132,-0.11895058944679371,0.36444317487000877,0.9031131692343692,0.7849835277741517,63509,63724,Conway+Pope,Pope,5,115,Arkansas,AR
05031,05CS010,834,786,882,1005,123,171,219,613.8563371886481,99,355.07415311227874,0.9028953309289953,2.6518010664381393,4.245251554650545,0.57507200641783,1030,973,1088,1190,102,160,217,142.34307249905598,104,92.7544504298812,7.436204872573055e-4,0.5065796703783876,1.0166134601058188,0.6475685960122087,111526,112124,Craighead,Craighead,5,31,Arkansas,AR
05033,05CS011,521,495,547,663,116,142,168,934.827180188237,56,369.5393955391316,3.953983070738231,5.698236139110126,7.291063873873184,0.3925314969891423,637,606,668,874,206,237,268,392.86934814691756,123,203.8516357850774,1.3700843871862671,1.8938318213823586,2.379191463914136,0.5166992421152086,60616,60338,Crawford,Crawford,5,33,Arkansas,AR
05035,05CS012,435,414,456,555,99,120,141,999.9823400693074,68,566.7847468222546,2.6524066974078226,4.346680329425742,5.996760049707227,0.5621094521141192,531,506,555,687,132,156,181,328.4331055009015,87,182.75775144945803,0.9175110620068189,1.4683631554407188,1.9662302475258855,0.5529170342582632,47990,47604,Crittenden,Crittenden,5,35,Arkansas,AR
05037,05CS013,200,193,208,223,15,23,30,540.8497903720952,29,694.9853214307112,-3.2089697104637875,-1.5061494211679634,0.1069193022490003,1.2304658440948433,245,236,254,266,12,21,30,125.65488645445676,29,173.7255136883724,-1.0070004483745674,-0.4608136343572588,0.023408013476210195,1.3196472146823512,16691,16693,Cross+Lee+St. Francis,Cross,5,37,Arkansas,AR
05077,05CS013,93,93,94,144,50,51,51,2355.451230811732,17,791.5260155977185,15.198932115632712,15.630288371942413,16.056902671868393,0.3295263106344774,115,114,116,155,39,40,41,465.21908862569035,27,313.73460376481523,1.3950430412132588,1.5167609368314638,1.6347455746832118,0.6579467639002669,8591,8606,Cross+Lee+St. Francis,Lee,5,77,Arkansas,AR
05123,05CS013,211,201,221,271,50,60,70,1033.6363051050512,32,549.4505494505495,2.9545802553882585,4.804014504380658,6.559279531889475,0.522884545326457,255,244,267,337,70,82,93,358.45458639277786,46,201.89606741573036,1.1134412033682213,1.562063462347431,2.100756051043882,0.5564272043910784,23296,22784,Cross+Lee+St. Francis,St. Francis,5,123,Arkansas,AR
05045,05CS014,852,799,906,954,48,102,155,327.1240334965859,70,225.56814977725145,-0.7937878967351744,1.0191087781246435,2.748587906163648,0.6828230168211072,1060,996,1125,1189,64,129,193,103.16911329096847,117,93.67794004611838,-0.3858321201192728,0.0837490556182399,0.6276350675147233,0.9010112414010251,124131,124896,Faulkner,Faulkner,5,45,Arkansas,AR
05047,05CS015,190,182,197,242,45,52,60,1218.7278430484428,22,511.122727536737,5.454050689630623,7.029610575173743,8.759355103648696,0.4115450109512299,231,222,240,275,35,44,53,256.0891868633336,31,180.58953745776535,0.24586260151818343,0.7554046440295391,1.2831626828264937,0.6894976415000567,17217,17166,Franklin+Johnson+Logan,Franklin,5,47,Arkansas,AR
05071,05CS015,229,218,240,272,32,43,54,666.4673290404858,20,309.59752321981426,1.9224256903237316,3.4919598146819046,5.292120936633107,0.45399045682480044,281,267,294,354,60,73,87,283.49604814104066,46,178.13577043720716,0.5484682485743774,1.0462105057144766,1.5728368749200343,0.6198860703695818,25840,25823,Franklin+Johnson+Logan,Johnson,5,71,Arkansas,AR
05083,05CS015,240,231,249,285,36,45,54,854.8532191148223,12,226.76808239240324,4.657137882055517,6.316136041451695,8.055283438498524,0.2595341198641344,293,282,304,375,71,82,93,386.35888179680495,37,174.54476837437494,1.5956304414579832,2.1223821471583784,2.643141470894497,0.4463189531496056,21167,21198,Franklin+Johnson+Logan,Logan,5,83,Arkansas,AR
05051,05CS016,1217,1174,1260,1365,105,148,191,590.4497094662298,137,547.5674217368279,-1.3273102108644619,0.42505835798404307,2.209002365493786,0.9211381913660526,1487,1435,1539,1705,166,218,270,217.48144404810355,229,228.30139772296775,-0.6099965808542757,-0.11623132096910987,0.3662568958721738,1.044960987618593,100079,100306,Garland,Garland,5,51,Arkansas,AR
05053,05CS017,177,169,184,201,17,24,32,540.280275496245,14,310.5590062111801,0.5870489206576743,2.303812627794054,4.001272553480162,0.5521411580306015,217,208,226,306,80,89,98,492.5728668268057,39,215.7915122005201,2.2545382492988635,2.7632121952131437,3.2597059802115504,0.4332240924048976,18032,18073,Grant+Hot Spring,Grant,5,53,Arkansas,AR
05059,05CS017,361,346,375,441,66,80,95,970.5472577863512,51,615.2918111898658,1.9178645536071621,3.5272828509936076,5.2771460001429515,0.6261799514786295,441,424,458,526,68,85,102,256.96535025949385,53,159.97102411638645,0.450058308778028,0.9793561613020401,1.491894855340247,0.6153118125163307,33155,33131,Grant+Hot Spring,Hot Spring,5,59,Arkansas,AR
05057,05CS018,192,183,200,226,26,34,43,676.7658044281085,20,396.19651347068145,1.1409526783041628,2.8201441046150695,4.586008437151568,0.5687774540904761,231,221,242,280,38,49,59,246.02003378334766,29,146.92471375012667,0.49725740999195744,0.9928821162999545,1.4862108801124119,0.5851559935709966,20192,19738,Hempstead+Howard+Nevada+Pike,Hempstead,5,57,Arkansas,AR
05061,05CS018,154,149,160,171,11,17,22,528.8465619648655,18,561.7539205742373,-1.9749985856615102,-0.4069133206307295,1.375656819576317,1.0030332862366556,187,181,194,164,-30,-23,-17,-181.6306018813758,14,110.18416496143554,-3.462402517622475,-2.9051304919736367,-2.3810646587060584,-0.634115860650499,12817,12706,Hempstead+Howard+Nevada+Pike,Howard,5,61,Arkansas,AR
05099,05CS018,99,98,100,118,18,19,20,928.7118105466548,22,1065.117404986686,-1.750982535558512,-1.3702549586803694,-0.9742318126297377,1.0900509714247277,120,119,121,115,-6,-5,-4,-64.83607789407164,18,219.48542860626753,-2.9681349165163087,-2.845120930308061,-2.718462922966344,-4.16936251847372,8262,8201,Hempstead+Howard+Nevada+Pike,Nevada,5,99,Arkansas,AR
05109,05CS018,127,122,131,129,-2,2,7,96.96817314595816,18,703.6059806508356,-7.864801145662208,-6.031316653182654,-4.420586628045005,5.171390972948116,153,148,158,177,19,24,29,240.52394756799524,27,267.85714285714283,-0.7948875601034614,-0.27306623164581284,0.24627038433615647,1.0695266002382111,10233,10080,Hempstead+Howard+Nevada+Pike,Pike,5,109,Arkansas,AR
05063,05CS019,351,335,368,452,84,101,117,1063.783638390753,72,760.6169448552715,1.378359178507762,2.9819512707281595,4.680161239375222,0.7079802009331939,427,407,446,545,99,118,138,313.8128307738025,76,201.33517007523577,0.609583729181549,1.1088560526387645,1.5960535281070223,0.6362065089388292,37864,37748,Independence+Jackson+Woodruff,Independence,5,63,Arkansas,AR
05067,05CS019,188,181,195,239,44,51,58,1218.9690493054793,22,525.3417706405587,5.164887754346076,6.928068553224925,8.678715591515552,0.42269181537341854,229,220,238,254,16,25,34,148.8082505755298,22,130.95238095238093,-0.3196420783710885,0.17761540714271115,0.6820723798153019,0.8461608075614757,16751,16800,Independence+Jackson+Woodruff,Jackson,5,67,Arkansas,AR
05147,05CS019,83,82,83,95,12,12,13,782.3077997303603,6,385.54216867469876,3.542126231992525,3.969445122166817,4.387538068128352,0.45541954495927406,100,99,101,105,4,5,6,84.31942127704815,16,261.0966057441253,-1.895025116782632,-1.7675588708131067,-1.6460734896826794,2.5944147515068314,6225,6128,Independence+Jackson+Woodruff,Woodruff,5,147,Arkansas,AR
05069,05CS020,684,655,713,901,188,217,246,1300.0604592540712,132,790.8927501497903,3.3586454951096445,5.072527551868517,6.648724679388469,0.6055598913033118,826,792,860,999,139,173,207,261.9845712724706,102,154.54545454545453,0.6138766548461393,1.0711008610567994,1.5419740283286696,0.5865108809621651,66760,66000,Jefferson,Jefferson,5,69,Arkansas,AR
05081,05CS021,148,142,153,192,39,44,50,1480.0789452767672,28,931.3154831199068,3.8234114221547646,5.46101300416451,7.2517075736460095,0.6154039094502677,179,173,185,200,15,21,27,173.06684425595515,35,292.9360562437228,-1.7433891834743758,-1.2077751183440384,-0.6972319210669237,1.6145381092013116,12026,11948,Little River+Polk+Sevier,Little River,5,81,Arkansas,AR
05113,05CS021,227,219,236,258,22,31,39,635.0729485029235,51,1056.3927295323908,-5.855877376762108,-4.224845873134982,-2.438503214220541,1.6108789657831037,279,269,289,374,85,95,105,493.25045848001906,72,372.5165562913907,0.6648344066824227,1.2108953689546889,1.7489824199492998,0.7473884331792653,19311,19328,Little River+Polk+Sevier,Polk,5,113,Arkansas,AR
05133,05CS021,135,129,142,175,33,40,46,991.9144631051223,29,727.1359618880462,0.9246090545618704,2.6783565846775477,4.385085484601137,0.7149896343521035,166,157,174,229,55,63,72,401.59178509456774,35,221.77163857559245,1.299583753565073,1.792736012148213,2.300204155715309,0.5436537198431123,15953,15782,Little River+Polk+Sevier,Sevier,5,133,Arkansas,AR
05085,05CS022,598,566,630,674,44,76,108,412.2984616997592,75,405.1043143609479,-1.6746732430050697,0.07305848598048902,1.773775935697586,0.9698454808642503,738,699,776,836,60,98,137,131.682172712538,85,113.90590032563686,-0.31584396238163936,0.1730017375045659,0.6938077367767537,0.8562921395950983,74055,74623,Lonoke,Lonoke,5,85,Arkansas,AR
05093,05CS023,426,409,444,571,127,145,162,1430.9639067232629,82,810.9578203036147,4.51164787323821,6.209583380259025,8.036853239076736,0.5628315048156686,514,493,535,594,59,80,101,200.9931695235432,61,153.3279710436356,-0.03499005435890063,0.47615036719797615,0.982657870907507,0.7534294388454235,40446,39784,Mississippi+Poinsett,Mississippi,5,93,Arkansas,AR
05111,05CS023,283,273,293,352,59,69,79,1201.006846516398,49,853.7329035630281,1.7102454348808205,3.4359419713139068,5.15189993600174,0.7006827857878325,342,331,354,423,69,81,92,355.3962018336219,40,176.2580417731559,1.286110610134153,1.7880965985621788,2.2899477755923856,0.4898742139984851,22958,22694,Mississippi+Poinsett,Poinsett,5,111,Arkansas,AR
05097,05CS024,125,121,129,135,6,10,14,472.8326465204728,21,981.1937857726901,-6.635514466440635,-5.113786765239503,-3.1802346224174998,1.8885230530798527,153,148,157,173,16,20,25,236.53617009680823,34,395.855163581325,-2.1255540779473274,-1.6146563125604279,-1.083725482361639,1.5950391168736746,8561,8589,Montgomery+Perry+Scott+Yell,Montgomery,5,97,Arkansas,AR
05105,05CS024,105,104,107,111,4,6,7,218.84508481229142,3,119.34361014420686,0.5893887716748253,0.9985718732110054,1.3771327222963363,0.46145196985863446,128,127,130,152,22,24,25,237.92318189721112,20,200.62192797672785,0.23959794856646158,0.37365545029359265,0.5005879814281512,0.8091085556394122,10055,9969,Montgomery+Perry+Scott+Yell,Perry,5,105,Arkansas,AR
05127,05CS024,126,122,130,141,11,15,19,605.4939126406181,14,567.3184074561848,-1.335214191904268,0.40565817329908294,2.1235035295722646,0.878179226743553,153,148,158,181,23,28,33,286.304440882299,19,193.4826883910387,0.41496511668465214,0.9198116107080312,1.4118756044749063,0.6525824245346281,9871,9820,Montgomery+Perry+Scott+Yell,Scott,5,127,Arkansas,AR
05149,05CS024,213,204,221,252,31,39,48,774.3615790100669,37,726.2377938073507,-1.1403066326731586,0.4650181268373262,2.255456719465117,0.9146691199253302,257,247,268,298,30,41,51,201.26801487273903,40,198.37333862328904,-0.5032778633241626,0.029812412873841704,0.5645224838339811,0.9619157702491159,20379,20164,Montgomery+Perry+Scott+Yell,Yell,5,149,Arkansas,AR
05119,05CS025,3240,3069,3412,3803,391,563,734,565.6580904240737,342,343.7557324032496,0.4615559034149826,2.211823140590109,3.9474496506727044,0.6066314483742823,3979,3773,4184,4725,541,746,952,187.48871934190421,479,120.35054924071115,0.18285690606721536,0.6744321389622772,1.1949436003291607,0.6410491450203497,397957,398004,Pulaski,Pulaski,5,119,Arkansas,AR
05125,05CS026,1024,970,1077,1101,24,77,131,250.20792394287758,98,316.9520852536425,-2.328999159292743,-0.6698544521886404,1.1760167529117487,1.250589578915856,1269,1205,1334,1581,247,312,376,249.54431855512155,165,131.99260841392882,0.6312168870955437,1.1855314273499746,1.6757824677718345,0.5272443680565945,123678,125007,Saline,Saline,5,125,Arkansas,AR
05131,05CS027,1111,1056,1165,1345,180,234,289,733.9205723593759,111,347.4178403755869,2.080583143933518,3.819596166937927,5.581992750081525,0.4713623529243107,1367,1301,1433,1711,278,344,410,267.9138161290338,217,169.12956727771544,0.45705050031006633,0.9841204320157181,1.52546500092203,0.6294523188540524,127800,128304,Sebastian,Sebastian,5,131,Arkansas,AR
05049,05CS028,164,159,169,183,14,19,24,633.6513411035378,35,1155.5922410235246,-6.987698190252513,-5.1794021699142405,-3.498696218157851,1.7333842128301844,200,194,206,255,49,55,61,453.36824479325236,43,354.522219473988,0.43356102412664244,0.9957405485348676,1.5144771953854193,0.7680075295524692,12115,12129,Sharp and Nearby Counties,Fulton,5,49,Arkansas,AR
05065,05CS028,175,169,181,191,10,16,22,476.6196648124583,10,293.75045898509217,0.20801766560579457,1.85415789182364,3.4985452010390046,0.5805405723952068,217,209,224,263,39,46,54,334.8029550828885,35,252.4888183523301,0.31014511783800053,0.818587510729584,1.3411232017610843,0.7382348726394388,13617,13862,Sharp and Nearby Counties,Izard,5,65,Arkansas,AR
05075,05CS028,201,194,208,230,22,29,36,718.2662378126063,32,788.0802856791034,-2.4488206089213036,-0.7177007614938723,1.0550075115471367,1.0608250360664768,245,237,254,251,-3,6,14,33.98484744122083,18,110.57869517139699,-1.3142742172103912,-0.7376724416029238,-0.2627976652782635,2.7556418655119415,16242,16278,Sharp and Nearby Counties,Lawrence,5,75,Arkansas,AR
05121,05CS028,222,214,230,258,28,36,44,780.8532062814658,44,948.83821230255,-3.4503147495680855,-1.6576575309288264,-0.041748433290571,1.1824741642281478,274,264,284,285,1,11,21,58.822914077392284,24,127.49681257968551,-1.1658772384409308,-0.6752693885513988,-0.20227489437872143,1.9879356581675585,18549,18824,Sharp and Nearby Counties,Randolph,5,121,Arkansas,AR
05135,05CS028,246,239,253,240,-13,-6,1,-139.09457915863942,26,600.5659178841601,-9.138868161659591,-7.411408113108175,-5.736867868588241,-5.177475838465273,303,294,313,347,34,44,53,247.73029805566617,42,239.01661734577738,-0.44547898931060664,0.09072126526714093,0.5874744721598804,0.9431596320177345,17317,17572,Sharp and Nearby Counties,Sharp,5,135,Arkansas,AR
05003,05CS029,211,203,219,248,29,37,45,771.7932867583861,21,441.0838059231254,1.6178464154260652,3.3235360872665054,5.075461674916271,0.5563639261032566,255,246,265,323,58,68,77,361.60441618729504,37,197.6918144902757,1.13368249827145,1.6410892394881411,2.1469021604699194,0.5387469536774155,19044,18716,Southeast Arkansas,Ashley,5,3,Arkansas,AR
05017,05CS029,134,129,138,149,11,15,20,610.5516038798734,25,986.4851533984413,-5.381198564136916,-3.782631318809942,-1.9252231490235607,1.517643760179456,162,156,167,171,4,9,15,92.84376458477564,13,129.5207731393843,-0.8619916919980329,-0.37463743665182075,0.1341735791066412,1.2598451261986678,10137,10037,Southeast Arkansas,Chicot,5,17,Arkansas,AR
05041,05CS029,143,138,147,151,4,8,13,296.4450302710238,13,459.56694653115335,-3.3186252006995876,-1.6139447967103584,-0.022172468966913998,1.3850874757960434,172,166,177,192,15,20,26,182.76997766264648,24,215.73033707865167,-0.8182921114383679,-0.3364333046953725,0.17194070207614034,1.1250091399098523,11315,11125,Southeast Arkansas,Desha,5,41,Arkansas,AR
05043,05CS029,171,164,179,238,59,67,74,1529.4177314176338,23,528.6748649580509,8.330863151451252,10.08004616700716,11.738251796070529,0.3405524611143999,208,199,217,223,6,15,24,85.98788464488783,24,140.03150708909504,-1.0100296592559384,-0.5542978573827733,-0.03978915682371662,1.525023389241581,17402,17139,Southeast Arkansas,Drew,5,43,Arkansas,AR
05079,05CS029,129,123,135,151,16,22,28,679.8546701164572,27,836.2369337979094,-3.260501298576817,-1.5724357115157592,0.07899546018394835,1.1764291870838026,160,153,167,176,9,16,23,123.8048104519973,28,215.15291224834792,-1.4451459664361463,-0.9100814818014907,-0.4136971035494142,1.6362826479163974,12915,13014,Southeast Arkansas,Lincoln,5,79,Arkansas,AR
05023,05CS030,320,309,331,368,37,48,59,777.0024572943355,38,614.0669817799863,-0.03310634255892977,1.6253638298054973,3.379706435215712,0.7742011001178688,394,381,407,457,50,63,76,251.30071460230766,61,244.35186668803075,-0.4367015703491401,0.06827418273605068,0.5924485045535344,0.9570922912108077,24753,24964,Van Buren and Nearby Counties,Cleburne,5,23,Arkansas,AR
05101,05CS030,78,77,78,124,46,46,47,2546.644940684665,17,934.8364036293648,15.71325587078298,16.116509581750975,16.53863075263183,0.3593264580121261,94,94,95,139,44,45,45,618.9057991203915,15,208.24656393169514,3.9829071505132365,4.100340889438828,4.2337458416044615,0.3290932613048928,7274,7203,Van Buren and Nearby Counties,Newton,5,101,Arkansas,AR
05129,05CS030,100,99,101,91,-10,-9,-8,-448.0067119017583,15,765.5014034192396,-12.528092789988886,-12.124712295636193,-11.757747032231483,-1.9283448844812485,123,122,124,158,34,35,36,446.92586902367185,15,190.54878048780486,2.446394623710742,2.5609653452673107,2.6937240264334217,0.41457073052712257,7838,7872,Van Buren and Nearby Counties,Searcy,5,129,Arkansas,AR
05137,05CS030,151,146,156,197,41,46,51,1482.693845010029,19,612.2613389188754,7.036328834421774,8.716976088815365,10.462150523295708,0.40415473840369626,186,179,192,243,51,57,64,460.86395462117804,25,200.57766367137356,2.102335407556445,2.610198283510167,3.0940418937692957,0.4277739359489245,12413,12464,Van Buren and Nearby Counties,Stone,5,137,Arkansas,AR
05141,05CS030,201,194,208,201,-7,0,7,2.237857176658163,13,327.682903774655,-4.9960729600574485,-3.300890181265528,-1.6054575231386157,11.939954276623661,244,236,252,323,71,79,87,505.1854790505981,35,222.8731533367295,2.3300708071638074,2.825204035411307,3.3080212036344796,0.43567925484053566,15869,15704,Van Buren and Nearby Counties,Van Buren,5,141,Arkansas,AR
05143,05CS031,1481,1375,1587,1646,59,165,271,269.0121090191539,217,352.910085178183,-2.579353869984886,-0.8690658445344509,0.799901624799973,1.3039910651216808,1854,1725,1983,2046,63,192,321,76.96564511378864,237,94.96638109968666,-0.6658464737627212,-0.19098130117522782,0.3234376652518759,1.227489530082647,245955,249562,Washington,Washington,5,143,Arkansas,AR
05145,05CS032,711,678,744,841,97,130,163,672.4827050942182,55,285.2882059262141,2.1691234019612704,3.802872814860062,5.5215635999449875,0.4209841154808119,873,833,912,1095,183,222,262,288.27643290326284,111,143.8774319822681,0.9458956937933629,1.4488097357814445,1.9848205877238752,0.4968613020421563,77115,77149,White,White,5,145,Arkansas,AR
06001,06CS001,8592,7872,9312,9396,84,804,1524,192.0033939245287,635,151.649215066051,-1.4243886656115328,0.4070350548106064,2.0636855180276497,0.7888445197072179,10539,9685,11392,11273,-119,734,1588,44.415987819887434,805,48.695828914917804,-0.5691560258208502,-0.03743777665417705,0.4588368966568813,1.0948669819736645,1674918,1653119,Alameda,Alameda,6,1,California,CA
06003,06CS002,18,18,19,19,0,1,1,169.3625004758036,4,1345.668629100084,-12.135618032147084,-11.772787851989673,-11.32731031785169,2.660582742857238,24,23,24,27,3,3,4,283.4236478220574,4,325.2032520325203,-0.5435977191983664,-0.41334605662394663,-0.28465833898655596,0.8916409151508271,1189,1230,Alpine and Nearby Counties,Alpine,6,3,California,CA
06005,06CS002,396,378,413,426,13,30,48,300.72851199595914,19,187.69139583127532,-0.6350434146455486,1.1336255317904667,2.895165264146402,0.6042728975696215,491,470,513,550,37,59,80,142.45775496766112,43,104.48559070807212,-0.1289157706262364,0.38330786080220647,0.903870456698512,0.7211490348457783,40492,41154,Alpine and Nearby Counties,Amador,6,5,California,CA
06009,06CS002,431,411,450,466,16,35,55,308.6689006489287,17,149.3323963457484,-0.1073080182940941,1.568910989160234,3.3317224278637947,0.4704076554003277,535,511,558,619,61,84,108,183.20029358906294,59,128.0076370658046,0.023600100256224454,0.5348324770056462,1.0576671250727694,0.6905523874907993,45536,46091,Alpine and Nearby Counties,Calaveras,6,9,California,CA
06027,06CS002,191,183,199,204,5,13,21,282.9237401195197,28,593.6290878253034,-4.763951044038893,-3.0924940602257203,-1.3839455941198195,1.9519260805875824,234,224,244,245,1,11,21,58.47322250507228,22,115.92370112762146,-1.1220393846790069,-0.5800908822398014,-0.03388588977472539,1.8186254775765627,18867,18978,Alpine and Nearby Counties,Inyo,6,27,California,CA
06051,06CS002,54,53,55,39,-16,-15,-14,-447.7912138228506,2,59.73715651135006,-5.486814969628969,-5.080474232859807,-4.656183485109787,-0.14293831304513802,68,66,69,64,-5,-4,-2,-27.92744371196306,4,30.209198701004453,-0.7078555873961591,-0.5805044131708169,-0.44548414951321497,-1.4826495776703958,13392,13241,Alpine and Nearby Counties,Mono,6,51,California,CA
06007,06CS003,1877,1786,1968,1992,24,115,206,217.93905753890976,132,250.0485416202956,-2.0726195822257667,-0.3102011542883696,1.4166234067659187,1.1374458194411317,2273,2165,2381,2569,188,296,404,141.89993804204994,293,140.4817613440221,-0.5305081304466084,0.007261195334186678,0.5342723700124075,0.9866719717789245,211159,208568,Butte,Butte,6,7,California,CA
06011,06CS004,148,139,157,155,-2,7,16,127.33969551485461,15,275.17886626307103,-3.1500651365630694,-1.5032257298605145,0.16338383957838043,1.8888626456923872,183,171,194,183,-11,0,12,1.0473352323919487,23,104.98448055504838,-1.5406392783505451,-1.0263163976552727,-0.5327625047970801,18.70754907295726,21804,21908,Colusa+Lake,Colusa,6,11,California,CA
06033,06CS004,777,747,806,719,-87,-58,-28,-339.80096849884336,39,230.4487842349396,-7.46544971475718,-5.726974225927885,-4.029263388312622,-0.6901895426183989,956,921,991,957,-34,1,36,1.4794883404607018,89,129.58648806057076,-1.806389334841272,-1.2809321176969695,-0.787923683712954,44.1443599643551,67694,68680,Colusa+Lake,Lake,6,33,California,CA
06013,06CS005,6794,6293,7294,7277,-17,483,984,166.17201778403086,422,145.10681426069883,-1.451385102089643,0.23541557665718943,2.0134713353602884,0.8714293227775489,8388,7788,8988,9112,124,724,1324,62.280281030461495,650,55.937171369118204,-0.4302018472152702,0.05985390505329823,0.5676567749925775,0.8969128694765401,1163281,1162018,Contra Costa,Contra Costa,6,13,California,CA
06015,06CS006,260,248,272,283,11,23,35,328.2955792042063,6,86.39930880552956,0.7535253168353553,2.341340895675983,4.076094583911228,0.25211687308541886,322,307,336,380,44,58,73,206.90206117477567,45,160.46785294012764,-0.07377606415886123,0.4460675696856469,0.9954012769600988,0.7624334467757279,27778,28043,Del Norte+Humboldt+Trinity,Del Norte,6,15,California,CA
06023,06CS006,1148,1089,1207,1200,-7,52,111,152.6557239788946,23,67.51203475402137,-0.902016590505337,0.8832669773537268,2.4462730849296332,0.43390698566887964,1411,1340,1481,1602,121,191,262,140.43324182496985,93,68.22383285894539,0.2000655251909632,0.735866851624659,1.260274443715807,0.48328514687177093,136272,136316,Del Norte+Humboldt+Trinity,Humboldt,6,23,California,CA
06105,06CS006,165,163,166,147,-19,-18,-16,-458.67538343767575,4,102.97335564422707,-6.028652322938973,-5.606298822658592,-5.230492797306519,-0.2378510829726666,209,207,211,198,-13,-11,-9,-68.18887041474781,19,118.27689243027889,-1.989322054938497,-1.8636676485733572,-1.7386772012697513,-1.9088072090856367,15538,16064,Del Norte+Humboldt+Trinity,Trinity,6,105,California,CA
06017,06CS007,1353,1270,1435,1514,79,161,244,337.04054319581,72,150.29981682209825,0.11989857377415197,1.8845613169451367,3.586642168853643,0.44319489633850484,1676,1576,1775,1903,128,227,327,117.8421257481409,159,82.4201457644339,-0.17164918965448525,0.3470212183365075,0.8654427389125847,0.696348458496317,191617,192914,El Dorado,El Dorado,6,17,California,CA
06019,06CS008,6034,5601,6468,7507,1039,1473,1906,584.4319894558229,937,371.8899610547466,0.37841336229875566,2.1349047327818216,3.892467916936494,0.6358953385905118,7503,6980,8026,9355,1329,1852,2375,182.80947536536334,1402,138.41336034467096,-0.06986734337092551,0.44130030973293227,0.9592832839319525,0.7567367650921274,1007825,1012908,Fresno,Fresno,6,19,California,CA
06021,06CS009,233,220,245,223,-22,-10,3,-137.18080850371535,22,305.3647026164203,-6.169246591219412,-4.360381039853071,-2.757993407217373,-2.4765874263580923,287,272,302,330,28,43,58,150.3444768872377,59,204.73315289055452,-1.0358216779895257,-0.5377490209374381,-0.014877080387471747,1.3310390927083093,28818,28818,Glenn+Tehama,Glenn,6,21,California,CA
06103,06CS009,612,584,640,679,39,67,95,407.8337611612312,44,268.5382972230699,-0.3345117872035444,1.4389872041777574,3.0357377191958097,0.648742101625862,751,717,785,941,156,190,224,289.9695152985942,129,196.90147294512704,0.42534195523225365,0.9184333164659996,1.4199717002206285,0.6754862906193491,65540,65515,Glenn+Tehama,Tehama,6,103,California,CA
06025,06CS010,969,951,987,1660,673,691,709,1538.8451675813656,529,1177.747474466368,3.2308415054458846,3.6054276110202887,4.016189029837189,0.7642393289368794,1196,1173,1218,1587,369,391,414,217.69036599040356,344,191.32582119934594,0.14116794307567493,0.26471075991892057,0.3884723670872511,0.8766499400157395,179665,179798,Imperial,Imperial,6,25,California,CA
06029,06CS011,5345,4954,5736,6535,799,1190,1581,523.5310157903593,678,298.29142368161126,0.5830089933454654,2.2729925245672913,3.964298440567237,0.5692899772825795,6672,6199,7145,8615,1470,1943,2416,211.97897649299625,1345,146.74530905980444,0.11285473090400933,0.6701866365649298,1.1453825866035816,0.6919073834699987,909178,916554,Kern,Kern,6,29,California,CA
06031,06CS012,749,683,814,920,106,171,237,448.6882358407815,113,295.95290943971924,-0.19160307727881692,1.4701492489959693,3.1545790243949434,0.6557680702689436,938,859,1017,1302,285,364,443,237.40755095097208,225,146.74806292556937,0.4141413867114466,0.9153446561868023,1.4288304430517145,0.61643370602483,152727,153324,Kings,Kings,6,31,California,CA
06035,06CS013,223,209,237,247,10,24,38,298.51330594729524,16,197.1050200184786,-0.7265974932474905,1.0466514642850058,2.670703019253802,0.6341199927462425,278,261,296,364,68,86,103,258.4699564894498,65,196.4042906783502,0.10483660837391387,0.5979926739548578,1.1683135957051318,0.7510922721797665,32470,33095,Lassen+Plumas+Sierra,Lassen,6,35,California,CA
06063,06CS013,203,194,211,232,21,29,38,597.0719770091735,7,142.27642276422765,2.8238333513445184,4.552137370974381,6.271943935780305,0.2304455337875594,249,239,260,278,18,29,39,143.36596056593152,30,150.79923595053785,-0.5745435370675039,-0.07128225130576996,0.4625967363176322,1.0162180200201485,19680,19894,Lassen+Plumas+Sierra,Plumas,6,63,California,CA
06091,06CS013,32,31,32,36,4,4,5,543.0505184003524,1,125.23481527864746,3.759441087889112,4.174257705567473,4.549633239778805,0.1873972223649038,40,39,40,37,-3,-3,-2,-85.81412706393859,3,91.6030534351145,-1.8920815386902883,-1.7757523331643257,-1.6493989720388054,-1.6570807662010616,3194,3275,Lassen+Plumas+Sierra,Sierra,6,91,California,CA
06037,06CS014,53793,49505,58081,69724,11643,15931,20219,638.7829629227338,11176,448.12401198499174,0.17324066445435315,1.917020179614629,3.620185388866387,0.7014837755590095,66022,60935,71108,82276,11168,16254,21341,164.97283607827458,13943,141.5127564468332,-0.299126213653763,0.2400486077475211,0.7245387491562201,0.8577415183557254,9975810,9852822,Los Angeles,Los Angeles,6,37,California,CA
06039,06CS015,949,882,1017,1137,120,188,255,478.2666894155524,170,433.32802294089527,-1.2940197325996954,0.45017718031380033,1.9770213035337627,0.9012352195677493,1188,1106,1270,1496,226,308,390,193.90056420848748,269,169.17919787676962,-0.27794323455133096,0.24725232834764127,0.780648256277353,0.8696840968722418,156925,159003,Madera,Madera,6,39,California,CA
06041,06CS016,1665,1552,1777,1754,-23,89,202,136.53002309640624,114,174.56550034453716,-2.097186044032606,-0.38722476725841354,1.3174318190389076,1.2644057464614553,2048,1914,2183,2166,-17,118,252,45.1693936259961,76,29.181945591030395,-0.3852971964552966,0.14391859787450126,0.6563994742795036,0.6406100750121599,261220,260435,Marin,Marin,6,41,California,CA
06043,06CS017,173,166,180,175,-5,2,9,45.189111206021344,5,116.78832116788323,-2.384480559441768,-0.672330765828193,1.010512546645223,1.7037755666682626,212,203,220,243,23,31,40,183.3311511528952,22,128.32477834811013,0.01799410415913727,0.5436212371186676,1.0956536707967097,0.6783780924456176,17125,17144,Mariposa+Tuolumne,Mariposa,6,43,California,CA
06109,06CS017,583,559,607,647,40,64,88,460.1452340649845,33,238.40485478977027,0.6083522873678334,2.208892332067689,4.022306029862834,0.5100991650919414,716,687,745,847,102,131,160,235.0047426818677,115,206.21514515753043,-0.22699799027666723,0.2814291167237479,0.8414470019245216,0.8708486418446073,55368,55767,Mariposa+Tuolumne,Tuolumne,6,109,California,CA
06045,06CS018,753,714,793,870,77,117,156,514.2606557549748,35,154.34820956076908,1.8782217883209977,3.6000948004892006,5.380229411911365,0.29758426290599466,928,881,975,1057,82,129,176,141.24949258443343,65,71.18451025056947,0.20537753771515505,0.7067968947110027,1.216242003710895,0.5000856428642041,90704,91312,Mendocino,Mendocino,6,45,California,CA
06047,06CS019,1566,1445,1687,1948,261,382,503,542.6243214115552,260,369.38770436197154,0.11543485791352101,1.7602960866605735,3.537729041226899,0.6789652968557184,1964,1817,2112,2342,230,378,525,132.112406894534,384,134.37379710956364,-0.5293308859148445,-0.015516782326411151,0.4551678588536637,1.0144302031135122,281547,285770,Merced,Merced,6,47,California,CA
06049,06CS020,94,93,95,101,6,7,8,336.39445548652714,2,92.07043388191967,2.048496562254663,2.4702925644578753,2.849564176318464,0.24075128192197814,114,113,116,141,25,27,28,306.04851196163065,12,138.55213023900242,1.5502740218438662,1.6721572047805269,1.8035060279693182,0.43625478490937813,8689,8661,Modoc+Siskiyou,Modoc,6,49,California,CA
06093,06CS020,492,473,511,542,31,50,69,457.09703426992377,14,127.46102196426538,1.571459486999291,3.31345702639886,4.999252263332908,0.27340334860235055,600,577,623,743,120,143,166,324.6765095230346,75,170.0873114865631,1.0420885428654993,1.5476669991600842,2.0712868459843703,0.5202332339143669,43935,44095,Modoc+Siskiyou,Siskiyou,6,93,California,CA
06053,06CS021,2246,2058,2434,2539,105,293,481,267.80475071881136,256,233.98708043991397,-1.391842696988487,0.3156099522620945,2.07433775804193,0.8707508104153188,2788,2562,3014,3157,143,369,595,84.4051069590536,367,83.88648124782856,-0.4772386648982334,0.023914538153448957,0.51147207468664,0.9911713726096234,437631,437496,Monterey,Monterey,6,53,California,CA
06055,06CS022,1032,973,1091,1043,-48,11,70,32.44295822019638,38,110.5679702048417,-2.468944289081703,-0.7560161966404072,0.8564275197387373,3.127573076716649,1259,1189,1329,1345,16,86,156,63.08443101476019,73,53.51474587826495,-0.4207376669707779,0.09829255666316872,0.622428138994208,0.8385589802628673,137472,136411,Napa,Napa,6,55,California,CA
06057,06CS023,910,866,954,988,34,78,122,304.94755083329284,63,247.15332332950834,-1.1275821004087905,0.558297797511677,2.2546164870603067,0.8001839856557141,1129,1075,1182,1207,25,78,132,75.9785353453392,67,64.86026002187825,-0.39660856294671426,0.09574823825704087,0.5857608576900352,0.8429256253778695,101961,103299,Nevada,Nevada,6,57,California,CA
06059,06CS024,17174,15806,18542,19959,1417,2785,4153,350.25134642621106,2459,309.26227302111135,-1.3315540795197665,0.3994423555768894,2.0909508819911404,0.8826554610231877,21266,19630,22903,25162,2259,3896,5532,122.88351144629932,3517,110.9398978293065,-0.3928969294646743,0.11503817055966,0.6358926129531433,0.9025737125232817,3180472,3170185,Orange,Orange,6,59,California,CA
06061,06CS025,2880,2706,3055,2988,-67,108,282,106.12850242225028,157,154.8976516233422,-2.1567243189649545,-0.5061599637135933,1.2186116130089566,1.4460858903183373,3588,3376,3800,3895,95,307,519,74.61404390369916,306,74.39047218501348,-0.4820667585343043,-0.001243214017463494,0.5773522778070616,0.9937657546834135,405429,411343,Placer,Placer,6,61,California,CA
06065,06CS026,14474,13429,15520,18545,3025,4071,5116,669.3350497307428,2657,436.87759945871244,0.6517489744830539,2.280375569837458,4.113606379865207,0.6525436028795237,18083,16817,19350,23082,3732,4999,6265,203.76098441167568,3945,160.81043568010585,-0.08086037619493588,0.4443897783737322,0.9480856653770262,0.7890532718305422,2432718,2453199,Riverside,Riverside,6,65,California,CA
06067,06CS027,10289,9608,10970,11312,342,1023,1704,258.8257197496407,948,239.77585510254022,-1.437886045618623,0.1492979890393939,1.968703784285982,0.925494466938014,12737,11917,13557,13886,329,1149,1969,72.3141119572049,1326,83.4733999357897,-0.6516552183359546,-0.1041750534722524,0.41659608760776945,1.1533128894703604,1581477,1588530,Sacramento,Sacramento,6,67,California,CA
06069,06CS028,321,293,349,352,3,31,59,190.57996643809537,32,198.4957742110568,-1.845221503598965,-0.12778261827023982,1.662514499814861,1.0087040810558159,411,376,445,475,30,64,99,96.99115212273716,60,90.41455071502841,-0.43229519744059114,0.04850050772663247,0.6077834630862051,0.9179322874024511,64485,66361,San Benito,San Benito,6,69,California,CA
06071,06CS029,12427,11488,13366,16663,3297,4236,5175,776.1416476167813,2747,503.30021665544456,1.049600825435295,2.753187219147906,4.472100699789005,0.6483113434323671,15478,14346,16610,19934,3324,4456,5588,203.2047079778768,3626,165.34699156028097,-0.09098578966838161,0.3788477251673702,0.8805894638123503,0.8135140994033518,2183190,2192964,San Bernardino,San Bernardino,6,71,California,CA
06073,06CS030,18345,16927,19764,20772,1008,2427,3845,294.03952795091533,1748,211.81909340700955,-0.7866656488053345,0.874297720291496,2.628862579681258,0.7200794978483493,22684,20986,24381,26447,2066,3763,5461,114.46229206394365,2869,87.26465310095203,-0.18901808847182971,0.2731104683082867,0.7673048477494315,0.7621852454301481,3300930,3287700,San Diego,San Diego,6,73,California,CA
06075,06CS031,4876,4505,5248,5343,95,467,838,215.60408345562453,222,102.58910406671065,-0.686620554868879,1.0916874111478883,2.926142077510509,0.4748040448295668,5759,5334,6184,6569,385,810,1235,98.41425727065848,342,41.545441845492256,0.05559620786157479,0.556749809971693,1.0727349796383225,0.42162817147993825,865589,823195,San Francisco,San Francisco,6,75,California,CA
06077,06CS032,4956,4620,5291,5976,685,1020,1356,524.1543323052592,793,407.3560384239996,-0.5987360060530564,1.1544695948548411,2.817489902093138,0.776407216058266,6177,5770,6584,7229,645,1052,1459,133.48990928378194,1092,138.5588107289183,-0.5521678835920443,-0.04132154812778572,0.45971745325428537,1.036986488866031,778680,788113,San Joaquin,San Joaquin,6,77,California,CA
06079,06CS033,2064,1943,2186,2068,-118,4,125,5.234441853096178,116,164.3059490084986,-3.4646494734514954,-1.6288635424180644,0.18674135104498402,24.704420403969834,2546,2400,2692,2671,-21,125,271,44.06554600217388,248,87.6250777319238,-0.9235186065623135,-0.42779156134028506,0.052730843411926964,1.9726992594554922,282400,283024,San Luis Obispo,San Luis Obispo,6,79,California,CA
06081,06CS034,4001,3674,4327,4151,-176,150,477,79.106801790875,248,130.4854532396434,-2.2401913480828,-0.5505768237910839,1.2513042546448887,1.6385861459601194,4847,4464,5230,5116,-114,269,652,36.287228292365235,357,48.147598689090586,-0.6443288261493333,-0.11593083157316689,0.3761716589096608,1.3219337879252335,760238,741470,San Mateo,San Mateo,6,81,California,CA
06083,06CS035,2738,2546,2931,2900,-31,162,354,144.63071983847274,177,158.19708944168494,-1.819467687961544,-0.19803851214018117,1.5832384332256944,1.0870822557017645,3380,3149,3611,3666,55,286,517,64.01168166531704,378,84.61846697305417,-0.7131439957168393,-0.19803531168241637,0.28220089970323603,1.3173154131759712,447543,446711,Santa Barbara,Santa Barbara,6,83,California,CA
06085,06CS036,8680,7852,9507,9579,72,899,1727,186.90177424933964,851,176.85808801027898,-1.7268399160394279,0.1204316897459166,1.7803776810621748,0.9452112014352413,10655,9678,11632,11365,-267,710,1687,37.520682365001264,1085,57.344177108415906,-0.7487533129592125,-0.20045298942583537,0.32508727117508585,1.526185343465778,1924707,1892084,Santa Clara,Santa Clara,6,85,California,CA
06087,06CS037,1478,1362,1594,1583,-11,105,221,155.50298864100884,122,180.4380058642352,-2.023272376695242,-0.26179628177734765,1.3846923872178525,1.1494185248322761,1819,1681,1957,2004,47,185,323,68.97195319002044,147,54.816996998116835,-0.4424587722728796,0.12629469896761705,0.6784458974487052,0.7904983676260844,270453,268165,Santa Cruz,Santa Cruz,6,87,California,CA
06089,06CS038,1926,1848,2004,2068,64,142,220,312.3215476837018,102,224.6807385828593,-0.8723081783724207,0.8994461285766115,2.4387291669533355,0.7143509692783934,2356,2262,2450,2782,332,426,520,233.8178668861325,346,190.00236130102195,-0.07584496573118549,0.434041373799144,0.9602694186205957,0.8107043905618189,181591,182103,Shasta,Shasta,6,89,California,CA
06095,06CS039,2950,2756,3145,3118,-27,168,362,148.45096442194443,171,151.24043691681774,-1.7174388053415286,-0.0016415918444952712,1.6601142648115081,1.0127566896372848,3642,3409,3875,4082,207,440,673,97.39003107677419,358,79.21352913973665,-0.3380283459204675,0.18424461304927092,0.6659168956596115,0.8115200886512604,452260,451943,Solano,Solano,6,95,California,CA
06097,06CS040,3429,3219,3639,3693,54,264,474,216.33817634093586,196,160.43612432162533,-1.2044190796166891,0.6139772432492733,2.3772981979151417,0.7388033785665068,4205,3954,4456,4558,102,353,604,72.52327068753956,232,47.71257287992678,-0.31308517126544405,0.24642598989398512,0.7587443942000772,0.6560329428191098,488668,486245,Sonoma,Sonoma,6,97,California,CA
06099,06CS041,3728,3491,3966,4541,575,813,1050,588.4696780667565,634,459.1624268979378,-0.4279123102118936,1.2808012187633697,3.015525788917906,0.7793061331175907,4597,4312,4883,5581,698,984,1269,177.86483839426705,860,155.52746416086603,-0.32073480694922224,0.22419656407146535,0.7375873529489579,0.8735256054497234,552310,552957,Stanislaus,Stanislaus,6,99,California,CA
06101,06CS042,736,693,778,799,21,63,106,255.1811878057494,62,250.34826674204032,-1.6354316353201825,0.1005566134009985,1.7474726368872018,0.9657787655410642,904,853,955,1013,58,109,160,109.75514754937313,146,147.29026270126306,-0.8933083212024583,-0.3757130866795838,0.11832661844114929,1.3297667355289275,99062,99124,Sutter,Sutter,6,101,California,CA
06107,06CS043,2700,2496,2904,3323,419,623,827,526.9353508945607,451,381.4622861939833,-0.26561387096389383,1.4337017810505202,3.0789850538878727,0.722766008510811,3364,3118,3610,4334,724,970,1216,203.55332090380074,783,164.29905365423755,-0.1596321375509371,0.4087025317844285,0.8970109665139377,0.8063236689135274,472917,476570,Tulare,Tulare,6,107,California,CA
06111,06CS044,4888,4525,5250,5547,297,659,1022,312.95433848085906,376,178.45679957189353,-0.3014099748712087,1.3185983795615186,3.003689883600625,0.569369215027429,6039,5606,6473,7127,654,1088,1521,129.44422832046666,818,97.35302133554539,-0.18783844037885528,0.31315021347143507,0.8289795638842149,0.7513938366125946,842781,840241,Ventura,Ventura,6,111,California,CA
06113,06CS045,1125,1032,1218,1253,35,128,221,235.55358608298923,110,202.87716709701218,-1.392649799599022,0.3255839169521768,2.0383840233207997,0.8545869471307324,1398,1286,1510,1542,32,144,256,66.51035313318098,131,60.40234416425749,-0.4591628289753982,0.06001287294626357,0.5578076133219768,0.9019119852866352,216880,216879,Yolo,Yolo,6,113,California,CA
06115,06CS046,587,552,622,561,-61,-26,9,-127.20834620457454,29,142.1673162242322,-4.403928846886537,-2.625421769798384,-1.0692881352827783,-1.162390129807599,733,690,776,810,34,77,120,92.01553656954675,85,102.15855006970818,-0.6326835595689505,-0.1125483838485227,0.3731938174760842,1.0959171573803566,81594,83204,Yuba,Yuba,6,115,California,CA
08005,08CS002,3365,3084,3647,4174,527,809,1090,493.70188523515463,492,300.3539231441928,0.12160687098024608,1.894673466285652,3.7079773973114327,0.6076196895536361,4177,3839,4516,4870,354,693,1031,105.74234059099635,392,59.853633436194045,-0.07818904029412911,0.47136274033601155,1.00564583699923,0.5652166520260282,655227,654931,Arapahoe,Arapahoe,8,5,Colorado,CO
08015,08CS005,156,148,165,182,17,26,34,519.797520490485,15,304.0745996351105,0.34944363056812283,2.164828642750185,3.9410189428982587,0.5630290005314309,194,183,204,167,-37,-27,-16,-133.53937300473277,12,59.9970001499925,-2.4536033787663216,-1.934496394346161,-1.4397465147205593,-0.4667587997641602,19732,20001,Central Colorado,Chaffee,8,15,Colorado,CO
08051,08CS005,66,64,67,70,3,4,6,105.2635737380213,5,117.24703951225231,-0.5227941094063169,-0.11378970438044046,0.27831581203412353,0.9109185259941631,81,79,83,89,6,8,10,47.30741360632157,7,40.62209842154132,-0.07071687156476057,0.06631140153626756,0.19931965408206997,0.7648590105697685,17058,17232,Central Colorado,Gunnison,8,51,Colorado,CO
08065,08CS005,32,31,33,31,-2,-1,-0,-56.076424537791944,6,319.78680879413724,-4.136076619845569,-3.74671176942227,-3.375926240641167,-115.08822913219949,39,38,40,58,18,19,20,261.5452622931252,4,54.00297016335898,1.9472729586545858,2.075927009193836,2.2034795861124534,0.19634159091297684,7505,7407,Central Colorado,Lake,8,65,Colorado,CO
08097,08CS005,50,48,52,60,8,10,12,230.9347707895786,6,137.7410468319559,0.5241092863453745,0.9339472489359052,1.3069293059382636,0.5425190922451122,61,59,63,72,9,11,13,64.39261629295258,8,46.11748429123191,0.05418305814342024,0.17953808439391886,0.3045779611308991,0.6573440410151941,17424,17347,Central Colorado,Pitkin,8,97,Colorado,CO
08109,08CS005,40,39,41,53,12,13,14,808.7240437212184,3,185.84481957565433,5.806811656785112,6.236699327777309,6.629579694653431,0.21344978583280538,49,48,50,68,18,19,20,298.45743416390775,2,30.96934035305048,2.5578818835721044,2.6746586783048767,2.7968564467258803,0.09864666103998558,6457,6458,Central Colorado,Saguache,8,109,Colorado,CO
08027,08CS006,38,37,38,46,8,8,9,677.7477200702899,6,499.3757802746567,1.41162502275951,1.7848184199645234,2.1650271843503166,0.6562297799556723,48,48,49,61,12,13,13,254.98713953385248,17,340.27221777421937,-0.9767619820138554,-0.8522495923437438,-0.722593321453457,1.237339335472235,4806,4996,Custer+Fremont,Custer,8,27,Colorado,CO
08043,08CS006,490,469,511,533,22,43,64,352.3944302247401,26,212.63545287262318,-0.39196157475610527,1.4406100415493042,3.1130695572809373,0.5897158684557707,606,581,632,754,122,148,173,297.7366154832723,137,276.42145191880877,-0.30412456895907064,0.2226479514204194,0.7129609656470266,0.9221601186375548,48910,49562,Custer+Fremont,Fremont,8,43,Colorado,CO
08029,08CS007,342,329,356,371,15,29,42,370.1763693218371,23,294.4376880240671,-0.9193949043514098,0.7119603729913727,2.4427451649710124,0.7688109550057239,422,406,439,506,67,84,100,264.78456425007954,93,294.32242546996645,-0.8265582372635456,-0.3045516901153658,0.21963661147710442,1.0984257165042683,31246,31598,Delta+Montrose,Delta,8,29,Colorado,CO
08085,08CS007,384,365,402,417,15,33,52,310.2450585532133,27,252.12438136147168,-1.128710420657526,0.5781660053387923,2.248718091983552,0.7889167523400334,474,451,496,614,118,140,163,325.46790311149397,114,264.41527114162454,0.056052355849562883,0.6225462058924135,1.0810862013489224,0.8066671364466697,42836,43114,Delta+Montrose,Montrose,8,85,Colorado,CO
08031,08CS008,3944,3635,4253,4938,685,994,1303,553.6576447477403,647,360.37742154689363,0.20792950457406428,1.9479284589218564,3.5577101901140136,0.650248827865789,4844,4476,5212,5239,27,395,763,55.480346497610405,408,57.274251012827754,-0.5613038781070565,-0.015320626321988873,0.5016443716325402,1.0297286031776196,718136,712362,Denver,Denver,8,31,Colorado,CO
08035,08CS009,1298,1143,1453,1611,158,313,468,347.8266811068774,166,184.53517423844502,-0.06929695075155068,1.613004833447557,3.3801588425401334,0.5288475175357508,1670,1480,1859,1995,136,325,515,88.5143770770767,165,44.87427045314854,-0.08399849145936222,0.43176559502769374,0.9823919813895682,0.5054186180455891,359823,367694,Douglas,Douglas,8,35,Colorado,CO
08037,08CS010,135,130,141,130,-11,-5,0,-39.0851762836406,13,93.52349777881693,-1.7302869265483973,-1.3306304771679525,-0.9309727121769779,-2.9325928533350254,170,163,177,188,11,18,25,31.956845880223455,16,28.716034315661005,-0.08715724155132426,0.029790621375525073,0.15759620359295975,0.8508051765262045,55601,55718,Eagle,Eagle,8,37,Colorado,CO
08039,08CS011,140,128,151,150,-1,10,22,154.9846600579051,13,197.1563981042654,-2.2205604095270606,-0.4640645692552516,1.2726811775046483,1.1587174614398819,178,164,192,210,18,32,46,118.4277880848439,25,92.61317329776988,-0.26477836202322774,0.2626943610363772,0.772092876147201,0.7583019554248583,26375,26994,East Central Colorado,Elbert,8,39,Colorado,CO
08063,08CS011,57,56,58,81,23,24,25,1366.7628342794187,5,283.0455703368242,10.44972165233038,10.823171871704586,11.237817301417772,0.19885566149141531,69,68,70,103,33,34,35,493.38128540998605,15,215.3007033156308,2.6551521007681225,2.7798637456642425,2.904051218967113,0.4240417641132471,7066,6967,East Central Colorado,Kit Carson,8,63,Colorado,CO
08073,08CS011,49,48,50,50,0,1,2,65.9666703325948,4,281.93832599118946,-2.536776150946642,-2.1545185862293166,-1.7389533289731605,2.0662201497545554,60,59,61,67,6,7,8,120.43629740878191,6,105.54089709762533,0.031179495033364167,0.1528700481687724,0.27461353655916204,0.7646425699484473,5675,5685,East Central Colorado,Lincoln,8,73,Colorado,CO
08121,08CS011,45,44,45,65,20,20,21,1676.6390070771242,14,1159.90057995029,4.744964746248229,5.143875234257826,5.5656085421689685,0.6592258024781198,55,54,56,67,11,12,13,246.04034410714485,14,288.421920065925,-0.5546393252891089,-0.4237149851856518,-0.2959257106280532,1.0816826216628397,4828,4854,East Central Colorado,Washington,8,121,Colorado,CO
08125,08CS011,84,83,85,101,16,17,18,694.0987576646133,12,480.91373609858726,1.7503906523456945,2.1445508824342188,2.5319474653324643,0.6550397385774489,102,101,103,103,-0,1,2,9.374205633665902,7,70.37297677691767,-0.734607535807798,-0.6130838672151354,-0.4897161370240633,3.6223405036674263,9981,9947,East Central Colorado,Yuma,8,125,Colorado,CO
08041,08CS012,4265,3950,4579,5200,621,935,1250,511.71752655248355,530,290.00257172091904,0.39716234322298827,2.2068449475158896,3.884364105880184,0.5661185926581662,5324,4944,5705,6487,782,1163,1543,157.7788559060157,828,112.34903098960771,-0.05645963648523486,0.4531902479013828,0.9252975158611384,0.7114546181407085,731028,736989,El Paso,El Paso,8,41,Colorado,CO
08045,08CS013,314,288,341,338,-3,24,50,152.92287533215818,36,233.9105292225724,-2.4056036606142337,-0.8105396339256931,0.8169079933912247,1.4672560340271912,394,362,426,423,-3,29,61,46.95426337332767,40,64.40705257225666,-0.7059629591282724,-0.1499232216135439,0.33242069423422993,1.326218380908378,61562,62105,Garfield,Garfield,8,45,Colorado,CO
08059,08CS014,10102,9311,10892,11827,935,1725,2516,375.54001330805954,1405,305.815889039983,-1.049763740369317,0.6616742074957588,2.4795876814877533,0.8138646491731543,12564,11611,13517,14167,650,1603,2556,86.85536484117819,1420,76.93866471321925,-0.41096390389561976,0.09136143319922482,0.601339006311102,0.8852728770261176,1837707,1845626,Jefferson,Jefferson,8,59,Colorado,CO
08067,08CS015,295,271,319,362,43,67,91,478.3655540660572,24,171.9752069076708,1.4638075328507152,3.084891542397134,4.70942582236564,0.3542001240473578,369,340,398,440,42,71,100,125.71143036622702,36,64.10142269546483,0.07787164283080357,0.6234980617273478,1.101346420248024,0.5027877035734952,55822,56161,La Plata+Montezuma,La Plata,8,67,Colorado,CO
08083,08CS015,230,219,242,251,9,21,32,316.98150632702146,16,246.47616113379033,-1.0114802643257124,0.6714190026371075,2.3543738984517812,0.741535334190811,284,271,298,371,73,87,100,331.32786590319085,47,179.87676527995714,0.9992326656929457,1.5043696800483526,1.9929588831092893,0.5366971955570214,25966,26129,La Plata+Montezuma,Montezuma,8,83,Colorado,CO
08069,08CS016,2055,1901,2210,2213,3,158,312,175.24903689560915,114,126.79839611151584,-1.2212075438163763,0.5771899376838803,2.241441517649733,0.7189694880615641,2557,2370,2744,2778,34,221,408,61.05461327400734,241,66.55289159887108,-0.537149697874284,-0.06119219095612214,0.4610330555790359,1.085146910080791,359626,362118,Larimer,Larimer,8,69,Colorado,CO
08075,08CS017,180,171,189,264,75,84,93,1550.5217344705045,55,1017.246959818745,3.705121601715608,5.347350138134895,6.905414516227736,0.6483338759940867,220,209,231,272,41,52,63,242.0101496795119,46,214.0729709605361,-0.24096978063395352,0.2659686565797302,0.8233482892278468,0.8678730951434638,21627,21488,Logan+Morgan+Phillips+Sedgwick,Logan,8,75,Colorado,CO
08087,08CS017,236,224,249,296,47,60,72,824.4997674153294,71,977.9277573086326,-3.2754866177912776,-1.5177195053063337,0.10843128666379859,1.1665976277849164,289,274,304,331,27,42,57,143.58841846372025,44,151.64047422111938,-0.5806982018036708,-0.09056501224074714,0.4202940117127571,1.031323751699432,29041,29016,Logan+Morgan+Phillips+Sedgwick,Morgan,8,87,Colorado,CO
08095,08CS017,45,45,46,67,21,22,22,1922.6766335857562,2,177.5410563692854,17.043416589512322,17.448952050066158,17.84725245734313,0.08826533440382324,55,55,56,71,15,16,16,345.0747158990237,1,22.1483942414175,3.110919509343206,3.234611469463856,3.356401059025676,0.060313181904447795,4506,4515,Logan+Morgan+Phillips+Sedgwick,Phillips,8,95,Colorado,CO
08115,08CS017,31,30,31,41,10,10,11,1768.5198660695198,5,844.9514152936206,8.826249065257823,9.235131029358877,9.611535539520958,0.4361016718667486,37,37,37,34,-3,-3,-3,-121.72791683965629,3,127.98634812286689,-2.607490060553051,-2.495336882463719,-2.3702551876882696,-1.6187320792300148,2367,2344,Logan+Morgan+Phillips+Sedgwick,Sedgwick,8,115,Colorado,CO
08077,08CS018,1336,1269,1403,1536,133,200,267,513.8331425892112,108,277.13270294196894,0.6930435717627508,2.411168639337514,3.9741897244213678,0.5366637097478603,1652,1571,1733,1998,265,346,427,220.19556551573305,319,203.01531842857233,-0.30622193493690464,0.16037667986143808,0.7010472446704233,0.9193202951319879,155882,157131,Mesa,Mesa,8,77,Colorado,CO
08049,08CS019,67,66,69,64,-5,-3,-2,-82.2444511682824,4,101.60020320040638,-2.256773549196226,-1.845760822466801,-1.413822101695663,-1.787338815122379,84,82,86,100,14,16,18,103.88409104663523,13,82.06552616627738,0.09655793465841199,0.21905782425929932,0.34615093595458507,0.7447177088686319,15748,15841,Northwest Colorado,Grand,8,49,Colorado,CO
08057,08CS019,11,11,11,11,-0,-0,0,-12.529094917661704,8,2322.2060957910016,-23.735527737724308,-23.335679219496722,-22.973585254814815,8.36087835149794,13,13,14,14,0,1,1,42.69670789107772,7,512.8205128205128,-4.833430600277207,-4.696450903193918,-4.574512401625019,4.422514213740079,1378,1365,Northwest Colorado,Jackson,8,57,Colorado,CO
08081,08CS019,87,86,88,139,51,52,53,1572.4673161658054,21,633.9622641509434,8.989841809407425,9.39977864727675,9.794699674711895,0.39556977040998076,106,105,108,157,49,51,52,383.76900390662587,32,242.4793513677351,1.2821565209104016,1.4154393288816045,1.531622553719698,0.619602734421738,13250,13197,Northwest Colorado,Moffat,8,81,Colorado,CO
08103,08CS019,46,45,46,56,10,10,11,639.6342318461907,3,184.9283402681461,4.117729798865256,4.538337201684869,4.935875291657362,0.2637022704590461,56,55,57,70,13,14,15,216.66525918203578,10,154.27337241592102,0.4970391789096999,0.6249098094599833,0.7501531993064161,0.6647061336430266,6489,6482,Northwest Colorado,Rio Blanco,8,103,Colorado,CO
08107,08CS019,105,103,108,115,7,10,12,157.7400129860272,21,336.36327233412084,-2.1889736077296917,-1.7671867977828932,-1.3867950232735375,1.935822263270531,130,127,134,132,-2,2,5,6.649035709980692,3,11.974135866528298,-0.1722522192029399,-0.058750834961725784,0.08325512753706546,1.1253448872137262,24973,25054,Northwest Colorado,Routt,8,107,Colorado,CO
08019,08CS020,53,52,54,57,3,4,5,154.28730710795915,4,169.54540637914593,-0.5751590197547691,-0.1576052153049726,0.25994972128194854,0.8620646379259074,66,65,67,68,1,2,3,23.767823829307748,1,10.59322033898305,-0.001052873967727611,0.1285610389109063,0.2615302448700539,0.30829157248832184,9437,9440,Park and Nearby Counties,Clear Creek,8,19,Colorado,CO
08047,08CS020,27,26,27,27,-0,0,1,24.345889070153873,6,408.3021435862538,-4.259452373046276,-3.849645252678416,-3.424774694501414,4.419033887025633,33,32,34,40,6,7,8,122.04717132276774,1,17.053206002728512,0.9082468291712632,1.0484969541305404,1.172395124703958,0.1225964036231465,5878,5864,Park and Nearby Counties,Gilpin,8,47,Colorado,CO
08093,08CS020,86,84,87,113,26,27,29,618.1840735838701,8,181.14916501556752,3.975621742963315,4.366957483651519,4.769261277568633,0.28267997713746523,106,104,108,118,10,12,14,68.67112490451606,10,56.573885494455766,-0.004347288040665034,0.12093056938253417,0.23811889198193503,0.7611330143108145,17665,17676,Park and Nearby Counties,Park,8,93,Colorado,CO
08117,08CS020,71,68,74,72,-2,1,4,14.62078099632546,6,77.54442649434571,-1.0312039636386976,-0.6341226204975745,-0.23821078404039267,2.8152057695841974,89,85,93,88,-5,-1,3,-2.9422154982557718,7,22.620778801098723,-0.3843712074604046,-0.2537920713454499,-0.1348067925345976,78.18484800136655,30950,30945,Park and Nearby Counties,Summit,8,117,Colorado,CO
08119,08CS020,150,139,161,183,22,33,44,528.6774807264142,3,48.29751267809708,3.0549789668929175,4.781742290732129,6.584784997413191,0.08865562159199297,186,173,199,288,89,102,115,409.10940826519374,42,168.69502349680684,1.8889945253598999,2.40765453863813,2.957548264922646,0.4083379919988172,24846,24897,Park and Nearby Counties,Teller,8,119,Colorado,CO
08101,08CS021,1560,1488,1633,1998,365,438,510,1038.6308918959014,262,621.6669929231992,2.396520155517828,4.199667722619546,5.931005638143503,0.5971804065849279,1924,1837,2012,2471,459,547,634,322.56926093258784,365,215.3976890483553,0.5249571955268334,1.0694053930225536,1.5770695034723943,0.6665369927521461,168579,169454,Pueblo,Pueblo,8,101,Colorado,CO
08009,08CS022,44,43,44,60,16,16,17,1867.0521777380357,2,228.05017103762827,15.949171786793347,16.38682764701897,16.785123016201297,0.1151142235930357,53,53,54,78,24,25,25,707.1830713248728,3,85.47008547008546,6.086902431133017,6.217424124953928,6.3396120411818435,0.11617943552862016,3508,3510,Southeast Colorado,Baca,8,9,Colorado,CO
08011,08CS022,54,53,55,67,12,13,14,918.5292162385963,5,354.6099290780142,5.246550908853035,5.62887964410073,6.048315981914267,0.35839051824062534,67,66,68,85,17,18,19,312.2602653200882,22,383.2085002612785,-0.8318322494073395,-0.7093954246047849,-0.5797055244382098,1.162369134156919,5640,5741,Southeast Colorado,Bent,8,11,Colorado,CO
08017,08CS022,15,15,16,23,7,8,8,1755.6434941402456,2,458.1901489117984,12.572721344592127,12.965978201062123,13.373127405191019,0.23085667611925725,18,18,19,24,5,6,6,331.3918486938202,7,409.1174751607247,-0.9034188818787721,-0.7828222780657227,-0.6536245807520185,1.0494572420470565,1746,1711,Southeast Colorado,Cheyenne,8,17,Colorado,CO
08021,08CS022,68,67,69,79,10,11,12,566.331711872337,4,211.02611448166712,3.161599814403902,3.548560430008671,3.96038530807964,0.34086597140611835,83,82,84,140,56,57,58,746.7407962781203,48,632.4110671936759,1.0116271855613457,1.1416274186847304,1.258516074734626,0.8322117771612094,7582,7590,Southeast Colorado,Conejos,8,21,Colorado,CO
08023,08CS022,33,32,33,35,2,2,3,259.9269270892075,8,895.8566629339306,-6.760411611292268,-6.36202477717846,-5.946203202061069,2.408806022311859,40,40,41,58,17,18,18,492.17228292365917,10,277.1618625277162,2.0217575642151213,2.1493902118751484,2.2677202002325907,0.5331179261713108,3572,3608,Southeast Colorado,Costilla,8,23,Colorado,CO
08025,08CS022,41,40,42,63,21,22,23,1482.93386200274,0,0,14.432900986895595,14.829218495345177,15.21058575728705,0,51,50,51,69,18,18,19,304.7430325664888,13,216.84737281067555,0.7490360011482713,0.8833563107051297,1.002491459653379,0.6746467061198239,5919,5995,Southeast Colorado,Crowley,8,25,Colorado,CO
08055,08CS022,91,91,92,113,21,22,22,1270.380819367075,10,585.6515373352855,6.446533957118326,6.835641500706203,7.232962431058631,0.440688748218172,112,112,113,139,26,27,27,384.6121123584888,7,101.39049826187717,2.7073271365458007,2.835105097598223,2.9515697305321287,0.25405010084815277,6830,6904,Southeast Colorado,Huerfano,8,55,Colorado,CO
08061,08CS022,18,18,18,17,-1,-1,-1,-286.2625414121767,3,829.3020041465101,-11.558524142320627,-11.151446892437573,-10.748873554457527,-84.37692695096487,22,22,22,20,-2,-2,-2,-141.37333848529903,3,206.61157024793388,-3.6033974555318764,-3.4785122745101007,-3.3437297216525335,-2.8497041121836353,1447,1452,Southeast Colorado,Kiowa,8,61,Colorado,CO
08071,08CS022,159,152,165,164,-1,5,12,146.9090565138276,5,137.46649254244278,-1.6508583096325191,0.09162308973325055,1.7802289800775708,0.7882146575649901,193,186,201,239,38,46,53,312.5806957155945,27,184.64063461669974,0.7529703752010148,1.2726335308778542,1.822960809689243,0.5780510777121618,14549,14623,Southeast Colorado,Las Animas,8,71,Colorado,CO
08089,08CS022,206,198,214,264,50,58,66,1249.3744925528667,36,774.2768039574147,3.0648398308156506,4.7769793929521125,6.412691431097868,0.60924357520857,250,240,259,313,54,63,73,341.16831063809144,62,333.243751679656,-0.42951360353122964,0.08558931392031414,0.5875884441923263,0.9616225111307285,18598,18605,Southeast Colorado,Otero,8,89,Colorado,CO
08099,08CS022,110,108,111,148,37,38,40,1280.5557364219942,18,599.750104123282,6.413081167848947,6.805517332211605,7.225295052631809,0.45647418431881964,133,132,135,181,46,48,49,396.2101008900761,22,183.40975406419344,1.9989136146498854,2.130155495439695,2.2538757611975,0.45337079702190386,12005,11995,Southeast Colorado,Prowers,8,99,Colorado,CO
08003,08CS023,135,128,142,140,-2,5,12,118.38056748784385,21,513.5102090720137,-5.709538055716553,-3.9689992001272585,-2.324453677974105,3.5951681100337294,167,159,176,187,11,20,28,118.57564951856247,26,157.38498789346247,-0.9230213080275513,-0.39713644584439034,0.1056015802422805,1.2628288045893445,16358,16520,Southwest Colorado,Alamosa,8,3,Colorado,CO
08007,08CS023,92,91,94,90,-4,-2,-1,-67.90051724902104,4,118.2033096926714,-2.282981083256069,-1.8804089419238137,-1.468815727020039,-3.082249432249265,116,114,118,136,18,20,22,144.07933177524222,11,80.07570794205431,0.5196986449191123,0.6403035410470128,0.7683989970330721,0.5290451102646992,13536,13737,Southwest Colorado,Archuleta,8,7,Colorado,CO
08033,08CS023,23,22,24,21,-3,-2,-1,-323.6886270784254,8,1390.6996957844417,-18.922495698374522,-17.17530979616573,-15.425746319517309,-9.280539759611141,29,28,30,47,17,18,19,762.9701757935959,7,293.13232830820766,4.211440695551972,4.677987671820981,5.2017424405777435,0.3642091123031534,2301,2388,Southwest Colorado,Dolores,8,33,Colorado,CO
08053,08CS023,9,9,9,2,-7,-7,-7,-3701.7524017637825,2,1010.1010101010102,-47.50583736202681,-47.123555662024515,-46.73010164488456,-0.315982235046551,11,11,11,2,-9,-9,-9,-1193.888787420049,2,255.4278416347382,-14.62604941208301,-14.491178261568226,-14.366181009565452,-0.23957406016205196,792,783,Southwest Colorado,Hinsdale,8,53,Colorado,CO
08079,08CS023,11,10,11,7,-4,-4,-3,-1643.5176170532466,7,3267.2112018669777,-49.49970205896544,-49.09799008963225,-48.701102226939526,-2.7764154672394765,14,14,14,7,-7,-7,-7,-745.5611999914277,7,764.1921397379913,-15.222455451257957,-15.098654176720936,-14.974835640141745,-1.200821926531599,857,916,Southwest Colorado,Mineral,8,79,Colorado,CO
08091,08CS023,26,25,26,24,-2,-2,-1,-142.1321164676011,5,407.6640847941296,-5.910469355647149,-5.509442378051412,-5.083778844699364,-6.727207873666879,33,32,33,32,-1,-1,-0,-16.177684954732907,8,159.64877270005988,-1.8755963420758208,-1.7548689659325138,-1.6307303930927604,42.25287983851195,4906,5011,Southwest Colorado,Ouray,8,91,Colorado,CO
08105,08CS023,114,113,115,142,27,28,29,978.9452421256782,6,208.95002611875327,7.290971297563888,7.697907385930193,8.065136387178484,0.2061118156155336,140,138,141,174,33,34,36,300.1337977598054,28,245.03369213266825,0.41927812541528425,0.548762974920698,0.6771466351273147,0.7932845275734172,11486,11427,Southwest Colorado,Rio Grande,8,105,Colorado,CO
08111,08CS023,7,7,7,3,-4,-4,-4,-2260.7980077518805,3,1680.672268907563,-41.101408137860396,-39.40820126973925,-37.7681439989185,-0.9882970984110406,9,8,9,5,-4,-4,-3,-519.4433694351814,5,684.931506849315,-12.520896377512573,-12.045967184648585,-11.547216671866796,-1.7908716142025605,714,730,Southwest Colorado,San Juan,8,111,Colorado,CO
08113,08CS023,24,23,25,24,-1,0,1,11.368926632046449,2,99.08347783007183,-1.2689157105356323,-0.8767428427492172,-0.45766303535570746,1.6267016119448388,30,29,31,31,-0,1,2,9.392208991785044,1,12.390038409119068,-0.15540398949199294,-0.023673962107482422,0.09570319952613729,0.5688135930640837,8074,8071,Southwest Colorado,San Miguel,8,113,Colorado,CO
09001,09CS001,5892,5481,6303,7546,1243,1654,2065,693.0103002308629,1629,682.5752655506903,-1.7669599273751706,0.1537597421078745,1.9656964245388011,0.9843472876912238,7307,6812,7802,7409,-393,102,597,10.61651360898721,517,53.89891399422229,-0.9256651621467138,-0.4162777039771146,0.07575429420412172,5.027524137148533,954620,959203,Fairfield,Fairfield,9,1,Connecticut,CT
09003,09CS002,6958,6573,7344,8610,1266,1652,2037,736.6232818068597,1731,772.0268492295342,-2.1534731537509715,-0.38747732636441057,1.3006549300565702,1.0474277897229831,8559,8096,9022,8844,-178,285,748,31.804849729182678,731,81.49286909525078,-0.9960313611469442,-0.5061503782915421,0.023815959987129216,2.5533282282737613,896860,897011,Hartford,Hartford,9,3,Connecticut,CT
09005,09CS003,1595,1516,1674,1890,216,295,374,640.1806768481889,249,540.616824256109,-0.7044694904928901,1.0145385919350012,2.567215115614925,0.8416210557160738,1966,1871,2062,2043,-19,77,172,41.45482719980233,143,77.30481884723919,-0.9023868332246263,-0.3731813279665106,0.16061101510502374,1.8407916440401784,184234,184982,Litchfield,Litchfield,9,5,Connecticut,CT
09007,09CS004,1350,1280,1421,1526,105,176,246,429.0727994073742,214,522.563000586052,-2.6160467047134692,-0.8196907562621146,0.7955611960697216,1.2109970336406068,1668,1583,1753,1696,-57,28,113,17.081709164955672,134,81.39118181210786,-1.150945173128945,-0.6545258093424153,-0.1195537346848772,4.6012037922641404,163808,164637,Middlesex,Middlesex,9,7,Connecticut,CT
09009,09CS005,6757,6386,7128,8319,1191,1562,1933,724.8599553304618,1488,690.401539484078,-1.3402384793576416,0.31969431487168304,2.105575634734818,0.9518526913325108,8314,7868,8760,8576,-184,262,708,30.301864677365966,717,83.01772318394389,-1.0325924121486416,-0.5188927203774253,-0.03598600033830893,2.729261613838991,862107,863671,New Haven,New Haven,9,9,Connecticut,CT
09011,09CS006,2135,2020,2250,2348,98,213,328,318.0544128669459,274,409.0361153511702,-2.531825451721697,-0.9176605934785396,0.9755722380684996,1.2800489481081392,2634,2495,2773,2954,181,320,459,119.12181215380846,243,90.42735297182239,-0.2346209273992552,0.29090052690558965,0.7970241405690187,0.7567526192548116,267947,268724,New London,New London,9,11,Connecticut,CT
09013,09CS007,925,861,990,1042,52,117,181,310.9589055847919,113,301.54642614113976,-1.6073696709243894,0.16386967242174963,1.8620485047108906,0.9614796741225365,1150,1073,1228,1280,52,130,207,86.28365467299777,87,57.923155280660986,-0.21388634666682196,0.28865443356929416,0.7840518097857216,0.6661705534658968,149894,150199,Tolland,Tolland,9,13,Connecticut,CT
09015,09CS008,927,877,977,1084,107,157,207,538.8245973017237,84,288.7788778877888,0.7430299569204846,2.5041711209381905,4.138313966802704,0.5325444950776808,1142,1082,1203,1242,39,100,160,85.49899267074203,147,126.29734002336932,-0.9266449913445111,-0.4086455688766655,0.09917471911014762,1.462483019369375,116352,116392,Windham,Windham,9,15,Connecticut,CT
10001,10CS001,1441,1363,1520,1740,220,299,377,655.7306731827109,191,418.99288150837435,0.6056966306665288,2.344125185547091,4.104227065965134,0.6368405113391317,1785,1690,1880,2234,354,449,544,244.10446737223023,250,135.96340952722804,0.5460517512583909,1.0674612018869412,1.6109727891879035,0.5557504297014246,182342,183873,Kent,Kent,10,1,Delaware,DE
10003,10CS002,4182,3937,4427,4893,466,711,956,499.4083434990043,499,350.63741877456084,-0.2702161051728475,1.497611555305045,3.143291193913002,0.7011191558677489,5169,4874,5465,5717,252,548,843,95.79140703568626,523,91.50331371464964,-0.4646804358634506,0.03509620151457489,0.5767213844775064,0.9534935825762355,569249,571564,New Castle,New Castle,10,3,Delaware,DE
10005,10CS003,2364,2261,2467,2784,317,420,523,701.7677882908978,318,531.610336310407,0.13971596247866871,1.6897754314159388,3.3075360891637433,0.7557299839160205,2970,2843,3097,3314,217,344,471,139.78373848293688,338,137.2471789207824,-0.46114290716834033,0.009506221806346667,0.505971548983086,0.9790097681518514,239273,246271,Sussex,Sussex,10,5,Delaware,DE
11001,11CS001,4163,3867,4459,5284,825,1121,1417,649.1874132954852,831,481.2829578920849,-0.05974158579428697,1.7067896902446944,3.3789655853693823,0.7407013176465145,5018,4671,5366,5828,462,810,1157,120.32169909550123,463,68.79919402412875,-0.002982063761545471,0.5009861712266803,1.0381310858907051,0.5710884571137013,690654,672973,District of Columbia,District of Columbia,11,1,District of Columbia,DC
12001,12CS001,1746,1626,1865,1931,66,185,305,267.1303796564153,133,191.78013056910393,-0.9453660551293309,0.7799079358079914,2.3795015487047793,0.7140725428550252,2165,2021,2309,2438,129,273,417,97.6961769153568,290,103.8841941989633,-0.6033623191393549,-0.06756256726191412,0.4673933241437021,1.0594547111285075,277401,279157,Alachua,Alachua,12,1,Florida,FL
12003,12CS002,223,210,235,257,22,34,47,482.9605651346303,36,505.369551484523,-1.7992243706819282,-0.22271346103316736,1.5011368114705868,1.016842991337317,275,261,290,368,78,93,107,323.19576924320404,80,279.17364600781684,-0.0854143626611684,0.43848154419178453,0.9316846148466985,0.8545640912649479,28494,28656,Baker+Bradford+Union,Baker,12,3,Florida,FL
12007,12CS002,281,268,293,294,1,13,26,188.32125718888946,20,281.88865398167724,-2.6231237917851513,-0.9473395725268955,0.8149821840224338,1.392622548863125,345,330,359,408,49,63,78,222.44091793584903,87,305.1132776881532,-1.3349679068934899,-0.8089784604516916,-0.3278669113107455,1.350369651906621,28380,28514,Baker+Bradford+Union,Bradford,12,7,Florida,FL
12125,12CS002,217,210,224,259,35,42,49,1059.0624294423847,58,1448.6418982204184,-5.561659943896346,-3.908151766696599,-2.138981761185765,1.3363374192743347,267,259,276,249,-27,-18,-10,-111.66315493743967,27,165.5933762649494,-3.27694186267195,-2.7882092357224146,-2.2239251784445613,-1.5691582606359429,16015,16305,Baker+Bradford+Union,Union,12,125,Florida,FL
12005,12CS003,1584,1508,1659,1811,152,227,303,520.2327077854409,179,409.449359234627,-0.5656012778579959,1.11780127874809,2.8647693154367,0.7836049413209272,1980,1887,2072,2549,477,569,662,319.03136561862226,420,235.3178471778667,0.3185212785450724,0.8079935724890653,1.3516339206971533,0.7363078790405777,174869,178482,Bay,Bay,12,5,Florida,FL
12009,12CS004,6515,6253,6777,7028,251,513,775,337.5981220263019,478,314.532141664487,-1.4884474181314256,0.18962999793889312,2.0101593157468804,0.9298638083536965,8050,7732,8368,9279,911,1229,1547,199.73850117145034,1073,174.36635785566756,-0.2763033496066614,0.2601179015216775,0.7476102435947095,0.8722635389403992,607887,615371,Brevard,Brevard,12,9,Florida,FL
12011,12CS005,12919,12084,13753,15293,1540,2374,3209,488.93540245267184,1736,357.48594303906293,-0.4317284763911065,1.4007643752488,3.263093463905314,0.7308438745925308,15845,14847,16843,18771,1928,2926,3924,151.42060979069745,2673,138.3168807137213,-0.38983235294849533,0.1414358425796046,0.6491282593985013,0.9131493337662898,1942454,1932519,Broward,Broward,12,11,Florida,FL
12015,12CS006,2341,2260,2422,2695,273,354,435,749.5373909861696,245,518.7216158707643,0.5116470641772124,2.307382171113283,3.98218895045127,0.690106334264676,2923,2823,3023,3342,319,419,519,216.26901839576,388,200.16611724162837,-0.32795943020819013,0.16550648859250072,0.6678945332133591,0.9233397141233577,188926,193839,Charlotte,Charlotte,12,15,Florida,FL
12017,12CS007,2327,2261,2394,2726,332,399,465,1034.7748451966481,204,529.296152873183,3.291536586558055,5.03446166459358,6.772113310881856,0.5102291772177548,2884,2802,2965,3563,598,679,761,431.1406127226112,478,303.4034504208295,0.7692878412877194,1.3006154708859339,1.7827945723975585,0.7026882193346564,154167,157546,Citrus,Citrus,12,17,Florida,FL
12019,12CS008,1600,1506,1694,1861,167,261,355,476.06102681501176,148,270.0729927007299,0.3317387818108753,2.074652300682416,3.698614639014417,0.565141227561432,1993,1879,2108,2768,660,775,889,349.2270534519435,476,214.568091561073,0.819822024213149,1.356639956997936,1.8690369028227491,0.613616521107881,219200,221841,Clay,Clay,12,19,Florida,FL
12021,12CS009,2963,2800,3126,3412,286,449,612,473.76017460155583,318,335.35902134222704,-0.21834562505156016,1.4147135157633468,3.125949944849696,0.7062944282141179,3700,3501,3898,4462,564,762,961,198.17491069751142,498,129.45757794749952,0.1375325528814927,0.6884218171160027,1.1999565900206404,0.6523933055223778,379295,384682,Collier,Collier,12,21,Florida,FL
12023,12CS010,688,657,718,813,95,125,156,714.6889893361617,96,546.8994787364344,-0.05173450387974332,1.6918880760755937,3.44061148965939,0.7591757555689945,845,808,881,1137,256,292,329,415.6103812462026,178,253.15375535107307,1.0987234642321773,1.6244154967195408,2.160494399363961,0.6070358993154907,70214,70313,Columbia,Columbia,12,23,Florida,FL
12027,12CS011,288,273,303,374,71,86,101,989.602908231111,55,634.7374495095211,1.8584261244502525,3.5716310590947735,5.282898233379491,0.6340123998199876,354,336,371,470,99,116,134,338.6457703959968,78,227.0081490104773,0.6234846613640533,1.117049953936254,1.6243192368762556,0.6646291142813214,34660,34360,DeSoto+Hardee,DeSoto,12,27,Florida,FL
12049,12CS011,182,171,193,217,24,35,46,543.1292753235296,21,328.8700963119568,0.4044842973843272,2.166332353393107,3.922589289263289,0.5885399521406626,225,212,238,352,114,127,140,500.9294117388552,74,291.23538903538116,1.5888681949470678,2.083265776434068,2.5735460444072396,0.576857921531153,25542,25409,DeSoto+Hardee,Hardee,12,49,Florida,FL
12029,12CS012,193,186,201,212,11,19,26,440.9959796965175,14,332.383665716999,-0.6445237134665439,1.0368002981433708,2.8105980895886047,0.7152070664768622,239,230,247,313,66,74,83,436.4469660127287,50,293.100416202591,0.942974360822314,1.45437140146327,1.9331961300736842,0.6626598898249351,16848,17059,Dixie+Gilchrist+Levy,Dixie,12,29,Florida,FL
12041,12CS012,173,166,181,191,10,18,25,391.4111306597116,13,287.81756794155086,-0.5073731398364864,0.9858955900456318,2.737745948632432,0.6959664157725757,215,205,224,301,77,86,96,471.22605970971784,42,229.5458271847844,1.9447230877037294,2.408230242472288,2.8963595216280376,0.48153964931135274,18067,18297,Dixie+Gilchrist+Levy,Gilchrist,12,41,Florida,FL
12075,12CS012,496,478,515,552,37,56,74,520.3070280602876,30,279.34261371572234,0.6913392619737576,2.391786699014174,4.046621946777845,0.5274412447256425,617,595,640,757,117,140,162,317.5066648251648,111,252.28992885878583,0.132916263155679,0.6581490347660329,1.1511432049264694,0.7889495471885793,42958,43997,Dixie+Gilchrist+Levy,Levy,12,75,Florida,FL
12031,12CS013,7557,7130,7985,8614,629,1057,1484,426.3637089078747,709,286.0549233522087,-0.1769274503962565,1.3854617272130065,3.0984573764362,0.6702833359892095,9358,8842,9874,11537,1663,2179,2695,217.9958211405863,1831,183.20699288384418,-0.1696936136303194,0.3411747640333212,0.8624225329313696,0.8400295926777656,991418,999416,Duval,Duval,12,31,Florida,FL
12033,12CS014,3012,2874,3151,3586,435,574,712,712.532653290005,327,406.2414589907322,1.4388438630249227,3.023283898659043,4.742846440551216,0.5691449956724821,3700,3533,3866,4583,717,883,1050,273.92957589430046,557,172.769428806278,0.4921146416329849,1.0134208034892236,1.5320285280703172,0.6299941056430515,321976,322395,Escambia,Escambia,12,33,Florida,FL
12035,12CS015,1225,1174,1275,1360,85,135,186,465.36465093328025,53,182.10868108646727,0.9877125465580917,2.8599113836507932,4.563352850453455,0.3884565342048794,1548,1486,1610,1844,234,296,358,246.13392065120206,221,183.84799680553706,0.11468502228309845,0.6279723256593264,1.1407723788128263,0.7444269119166996,116414,120208,Flagler,Flagler,12,35,Florida,FL
12039,12CS016,386,367,405,481,76,95,114,862.4084003730671,54,491.02068651966357,2.0847579491667934,3.7369029137058343,5.489365016318872,0.5634192899907191,473,450,495,664,169,191,214,437.59238488701897,96,219.61932650073206,1.6606510694370062,2.1961106662811845,2.711403488739533,0.4992708999300184,43990,43712,Gadsden+Leon,Gadsden,12,39,Florida,FL
12073,12CS016,1665,1539,1791,2057,266,392,518,535.5249060333518,158,215.9642702150416,1.4811211385551348,3.2213260258803555,4.889630639784537,0.4022491736410517,2073,1922,2224,2572,348,499,650,170.36221145328048,309,105.54972963556308,0.08784396787035396,0.6459184339833552,1.1876205794478516,0.6183209272396959,292641,292753,Gadsden+Leon,Leon,12,73,Florida,FL
12043,12CS017,100,99,101,129,28,29,30,937.7801738367403,16,514.5521788068821,3.8506978056062278,4.240314473893841,4.618842429025246,0.5304991503677114,121,119,122,167,45,46,48,379.18926527365414,16,130.86864060199576,2.356274471151388,2.486566243581807,2.6083069318271734,0.3378401235919453,12438,12226,Glades+Hendry+Okeechobee,Glades,12,43,Florida,FL
12051,12CS017,261,244,279,315,36,54,71,534.1285617684391,51,508.5379533840209,-1.4739271677860348,0.2644316912698482,1.8464634263503017,0.9346407871356017,325,304,346,480,134,155,176,385.8801954608643,79,196.3952765692977,1.3712348748167704,1.8817627853009256,2.3910072002010647,0.5056960948020827,40115,40225,Glades+Hendry+Okeechobee,Hendry,12,51,Florida,FL
12093,12CS017,384,367,401,467,66,83,100,826.9379120218367,55,549.0254797734023,0.9896587564808346,2.8126553881638046,4.478717556954267,0.6560069694286788,473,452,494,657,163,184,205,458.0763388934902,103,256.37834474175486,1.5404890651490435,2.0160747652399524,2.5137379471849557,0.556659960659301,40071,40175,Glades+Hendry+Okeechobee,Okeechobee,12,93,Florida,FL
12047,12CS018,138,132,144,176,32,38,44,1070.0135471851238,19,540.5789885482609,3.714131448144772,5.29901292409617,6.9136873320101575,0.4921221456063207,169,162,177,226,49,57,64,405.1106938365734,33,235.84905660377356,1.1879984264489802,1.6950646683180028,2.22307893412139,0.5720914219934171,14059,13992,Hamilton+Lafayette+Suwannee,Hamilton,12,47,Florida,FL
12067,12CS018,67,66,68,97,29,30,31,1436.045773907539,16,772.4803862401931,6.225822915863137,6.636199990630456,7.035535935502564,0.520425089462365,84,83,85,118,33,34,35,410.82152938793325,22,263.06349396149704,1.3514402191941117,1.4794204556046069,1.6008587641029217,0.6222246570212698,8285,8363,Hamilton+Lafayette+Suwannee,Lafayette,12,67,Florida,FL
12121,12CS018,486,467,505,587,82,101,120,922.7867473596957,71,649.231894659839,0.9997327314530879,2.7448408386139405,4.479635793055711,0.6966524272718371,603,580,626,785,159,182,205,409.62237470361896,161,363.0787271948222,-0.05069953518355562,0.46260544404218135,1.0042871922377137,0.8815211021069134,43744,44343,Hamilton+Lafayette+Suwannee,Suwannee,12,121,Florida,FL
12053,12CS019,2450,2365,2534,2676,142,226,311,462.00410654281586,203,414.5712608173997,-1.3925375506023479,0.5037393075278473,2.0553292399659147,0.893383342266388,3043,2940,3146,3688,542,645,748,322.77227907846924,557,278.6532592926109,-0.09567933531453704,0.44357487006382174,0.9133110778798973,0.8619762353674066,195865,199890,Hernando,Hernando,12,53,Florida,FL
12055,12CS020,1332,1289,1376,1582,206,250,293,977.4646579089507,185,724.644777171731,0.8584036835715559,2.4643170871837876,4.220041900338387,0.7383924207480327,1644,1591,1697,2130,433,486,539,471.7461446042087,284,275.7442181097928,1.438420279010978,1.952024196808435,2.4851277711644855,0.5833176602286975,102119,102994,Highlands,Highlands,12,55,Florida,FL
12057,12CS021,9337,8707,9968,10901,933,1564,2194,426.38040731491554,945,257.6992772148844,-0.05393992562345288,1.6674141554360962,3.3753216521927816,0.6040018793192099,11589,10827,12351,14310,1959,2721,3483,184.36404239876663,1769,119.8481877788723,0.1337145387381343,0.6428376943776075,1.1663376153792393,0.6498239093919883,1466826,1476034,Hillsborough,Hillsborough,12,57,Florida,FL
12059,12CS022,239,230,247,286,39,47,56,963.5439405336095,28,570.1196233138203,2.2139453380295397,3.9149047839268976,5.615869829133764,0.579445594069406,294,284,304,362,58,68,78,344.3714430538885,47,237.85425101214577,0.5782073425479713,1.054511416219584,1.5750366992357705,0.6806878994218118,19645,19760,Holmes+Walton,Holmes,12,59,Florida,FL
12131,12CS022,637,604,670,665,-5,28,61,147.74796450313093,49,257.75229478446124,-2.711548015356513,-1.149006134457703,0.6119299319484033,1.6845650678418145,820,779,861,892,31,72,113,90.82971616782207,127,159.84091423968584,-1.1977743771410685,-0.6759652240947941,-0.16532023846635546,1.7357351992531023,76042,79454,Holmes+Walton,Walton,12,131,Florida,FL
12061,12CS023,1823,1754,1892,2023,131,200,269,497.2198702894298,141,351.17869017820453,-0.18959727989750913,1.4007877592314335,3.1666078170267977,0.7027642818625894,2259,2175,2344,2716,372,457,541,279.9028985474968,358,219.39232004314306,0.09332320902303622,0.6012687501147076,1.1070793612743766,0.7821034598325975,160602,163178,Indian River,Indian River,12,61,Florida,FL
12063,12CS024,539,519,559,666,107,127,147,1079.4147305506572,102,865.8008658008658,0.5288986194134496,2.1582953202014328,3.929668136946114,0.7958438263593118,668,643,692,761,69,93,118,195.85687660924395,99,207.8783806484126,-0.5998575164036144,-0.10426675431465451,0.3915395892034434,1.0501206804816416,47124,47624,Jackson+Washington,Jackson,12,63,Florida,FL
12133,12CS024,294,283,305,299,-6,5,16,80.93498329358722,22,346.3476070528967,-4.450854572407591,-2.754120083566448,-0.9603105194301441,3.5824841764471476,361,348,374,418,44,57,70,223.30437008208733,62,243.86406544996856,-0.7383800243205207,-0.20518654676831638,0.31523927811189956,1.0731674665317736,25408,25424,Jackson+Washington,Washington,12,133,Florida,FL
12065,12CS025,154,148,160,184,24,30,36,821.4639447979675,13,358.15138783662786,3.007754921534406,4.687242160127084,6.337910004282461,0.42184388724876365,188,181,196,225,29,37,44,253.23255548095787,32,219.84061555372355,-0.17363274669542103,0.32130936295110885,0.8237619744480577,0.8452073794075561,14519,14556,Jefferson+Madison+Taylor,Jefferson,12,65,Florida,FL
12079,12CS025,193,185,201,273,72,80,88,1762.8100698025419,38,839.8254047184927,7.447526024106426,9.277930626861737,10.987208710495562,0.47051395158050996,238,228,247,303,56,65,75,358.061406787962,51,279.5746080473632,0.23544963320963172,0.7885084533787372,1.285547651122743,0.7690270660675183,18099,18242,Jefferson+Madison+Taylor,Madison,12,79,Florida,FL
12123,12CS025,221,211,230,284,54,63,73,1168.159482345691,31,570.5608981732848,4.2095920217168485,5.977248229441038,7.765434380981786,0.480851074824753,270,258,281,330,49,60,72,276.79262115175584,49,224.69849131012978,0.02386085576673635,0.5425755948530104,1.024251182756966,0.7985636689058854,21733,21807,Jefferson+Madison+Taylor,Taylor,12,123,Florida,FL
12069,12CS026,4023,3857,4189,4366,177,343,509,357.44032727844973,292,304.0494809292252,-1.2080780370185065,0.49523333812984344,2.3397863734141255,0.8481592561101182,5027,4823,5230,5756,526,729,933,184.945914760233,778,197.28367262067778,-0.6443720352968064,-0.14706153932505056,0.39447475936647913,1.0652495300927751,384148,394356,Lake,Lake,12,69,Florida,FL
12071,12CS027,6371,6041,6702,7250,548,879,1209,457.4561419244977,599,311.8930711834754,-0.19149321159943902,1.4513859175829176,3.238394064759911,0.6810236887843554,7978,7573,8383,9408,1025,1430,1835,182.21247590961062,1019,129.87857182004615,0.004920207975101811,0.5243139544389392,1.042545679904553,0.712288141304434,768212,784579,Lee,Lee,12,71,Florida,FL
12013,12CS028,149,143,155,180,25,31,37,914.9285091536007,20,584.1974587410544,1.7171439357181777,3.328019733550466,5.056977342469151,0.618762535050674,182,175,189,239,50,57,64,414.754633751321,42,307.9856273373909,0.5730625644542733,1.0774317795489425,1.587652554924924,0.7296722509363258,13694,13637,Liberty and Nearby Counties,Calhoun,12,13,Florida,FL
12037,12CS028,138,133,143,143,-0,5,10,156.4330333234077,5,161.05653084232566,-1.7981669520679484,8.569835606641353e-4,1.6573353864401648,0.8537575592044959,171,165,178,205,27,34,40,268.45036648041594,38,302.668259657507,-0.8408702231044708,-0.3351827322151312,0.14740508558780568,1.0949764250071614,12418,12555,Liberty and Nearby Counties,Franklin,12,37,Florida,FL
12045,12CS028,154,148,160,197,37,43,49,1208.779971935503,22,624.113475177305,4.124437843456704,5.813944073835626,7.6777026455556125,0.5044773047490241,192,185,200,242,42,50,57,346.40071346785675,32,223.2142857142857,0.7240127768628333,1.2415776915042605,1.7256913943992114,0.6316619824600169,14100,14336,Liberty and Nearby Counties,Gulf,12,45,Florida,FL
12077,12CS028,60,59,61,78,17,18,19,912.6886713045714,15,748.1296758104738,1.2719214323161014,1.6401439343744122,2.0652309786865266,0.7772259184881986,73,72,74,117,43,44,45,558.2596748497201,17,214.89065857666537,3.322167999186148,3.433502384144671,3.552995295774214,0.37640662982624423,8020,7911,Liberty and Nearby Counties,Liberty,12,77,Florida,FL
12129,12CS028,263,248,277,321,44,58,73,688.5776757537423,30,353.4713835459071,1.613265339387241,3.3408232034390024,5.037560154399233,0.5046995197952947,332,314,349,414,65,82,100,238.38941426489205,60,173.53077279037484,0.1666282724096727,0.6703673280426554,1.1663589250062605,0.7192043539219075,33949,34576,Liberty and Nearby Counties,Wakulla,12,129,Florida,FL
12081,12CS029,3636,3462,3809,4106,297,470,644,467.14226161234063,379,376.3280706980439,-0.8346588443275385,0.9057859758928833,2.50798743630576,0.8038875549608866,4541,4329,4753,5302,549,761,973,185.12314338919546,694,168.83138998834724,-0.2865235682283763,0.17027235979577998,0.6797256790612873,0.9107981551975199,402840,411061,Manatee,Manatee,12,81,Florida,FL
12083,12CS030,4620,4458,4782,5251,469,631,793,670.2729506198077,441,468.39899947424595,0.3372492949315658,2.0225146728389776,3.7243182305924933,0.6977126825619303,5742,5544,5941,7072,1131,1330,1528,345.6252408055069,1110,288.5597747673974,0.06970867113724398,0.588301666740429,1.0855684473178195,0.8342645795705607,376602,384669,Marion,Marion,12,83,Florida,FL
12085,12CS031,1646,1578,1715,1995,280,349,417,876.5667653031713,167,419.9488265950826,2.787380211390774,4.535077801734668,6.371756357834221,0.477713227435164,2020,1938,2103,2462,359,442,524,276.4729690263081,225,140.85741473431162,0.8608162079205628,1.3597075525361602,1.8773051894942117,0.5083288417766698,159067,159736,Martin,Martin,12,85,Florida,FL
12086,12CS032,17029,15872,18186,22009,3823,4980,6137,739.8731423878169,3655,543.0583620587187,0.3168489313783005,2.017803382871365,3.558150071698898,0.7338411102517697,20833,19456,22210,26100,3890,5267,6644,197.4835252827433,4101,153.76216768287424,-0.10120414943360959,0.45671153027480516,0.9533647090599306,0.7784597729350561,2692160,2667106,Miami-Dade,Miami-Dade,12,86,Florida,FL
12087,12CS033,657,622,693,662,-31,5,40,23.13441224476742,40,196.4564173716587,-3.4263928998829636,-1.6701210752430133,0.02181926621833266,7.004837034727021,806,764,849,855,6,49,91,59.38403872869845,56,68.07434691173432,-0.6193678324205857,-0.07654700732248881,0.3966323541357274,1.1233455076133967,81443,82263,Monroe,Monroe,12,87,Florida,FL
12089,12CS034,832,793,871,901,30,69,108,302.94521520208883,67,294.58966298063183,-1.7479741668781195,0.046348452681056314,1.7422567562253766,0.958507429131022,1047,999,1095,1209,114,162,210,172.7316939517786,169,180.3185984230125,-0.5926093680612106,-0.07183325623753216,0.43824294589861207,1.0375142720861306,90974,93723,Nassau,Nassau,12,89,Florida,FL
12091,12CS035,1619,1528,1710,1896,186,277,368,523.0176781154844,200,377.5330105426093,-0.2596309725297305,1.5359250607511992,3.155261487646257,0.7192401743596559,1998,1888,2108,2362,254,364,474,170.72277200316395,305,143.16291470306604,-0.209053932545815,0.2531995750033049,0.8315427793333112,0.836270281691223,211902,213044,Okaloosa,Okaloosa,12,91,Florida,FL
12095,12CS036,7361,6748,7974,8379,405,1018,1631,285.949092876958,745,209.25217625774252,-1.0340953217388542,0.7455554903434021,2.5252111276930407,0.7310631291132728,9130,8395,9865,10777,912,1647,2382,115.67666850121924,1451,101.9111680171711,-0.4032000562066336,0.12468335306624985,0.6662319894055342,0.8804656092164307,1424119,1423789,Orange,Orange,12,95,Florida,FL
12097,12CS037,2216,2048,2384,2531,147,315,483,323.518160739795,276,283.28321136417287,-1.3906024647331918,0.35929579492937724,2.173515737395042,0.8728638705349232,2820,2613,3028,3533,505,713,920,177.48892648966344,605,150.69619149625126,-0.30917093323305095,0.2620514055308466,0.7666741485342142,0.8478557319307621,389716,401470,Osceola,Osceola,12,97,Florida,FL
12099,12CS038,12653,12011,13296,14606,1310,1953,2595,522.877621398313,1572,420.93453089028856,-0.6602616222601703,1.0049985413407985,2.716931319311818,0.8046224582398646,15533,14760,16306,17803,1497,2270,3043,151.5972094372811,1994,133.18354081200548,-0.32624136139871207,0.18396635053543778,0.66122855128384606,0.8781486669275894,1493819,1497182,Palm Beach,Palm Beach,12,99,Florida,FL
12101,12CS039,5677,5433,5921,6147,226,470,714,332.18277057399433,352,248.78742634001537,-0.8801403498981789,0.8131175643129166,2.5013883984646945,0.7473572663114414,7113,6812,7413,8130,717,1017,1318,175.00190830309523,1049,180.42810825686496,-0.5785875138239767,-0.04677688587914927,0.4378153523853431,1.0299941920481854,565945,581395,Pasco,Pasco,12,101,Florida,FL
12103,12CS040,10071,9658,10484,11173,689,1102,1515,458.6466985054608,747,310.9416495308819,-0.2781804453107307,1.513293368593674,3.293397381336236,0.6773398896906239,12269,11775,12763,13923,1160,1654,2148,172.87171131638164,1235,129.05895643032332,-0.062297192430892864,0.4243780959645787,0.9334481117519784,0.7461081183838987,960952,956927,Pinellas,Pinellas,12,103,Florida,FL
12105,12CS041,6284,5969,6599,7210,611,926,1241,506.60247143705124,718,392.8106890462989,-0.5039629833376676,1.1650297428122962,3.0177509632027073,0.7745460488199034,7888,7501,8276,9804,1528,1916,2303,255.4129800757761,1555,207.33941528951516,0.005860755908748604,0.4611644843661218,0.9671912337656987,0.8113574770463576,731141,749978,Polk,Polk,12,105,Florida,FL
12107,12CS042,854,823,886,994,108,140,171,759.7280812507686,71,386.01117257689646,1.8622824810341632,3.723592022386795,5.417505067566753,0.5044810518608037,1050,1012,1089,1489,400,439,477,592.4529393495957,265,357.8808054343863,1.8153265193709458,2.346919837659711,2.844571055176931,0.6026923819780313,73573,74047,Putnam,Putnam,12,107,Florida,FL
12109,12CS043,1920,1801,2040,1984,-56,64,183,92.10608193536544,101,145.94953903066386,-2.2160259144090335,-0.5824985855690948,1.2095736741397354,1.560104553563597,2465,2315,2615,2677,62,212,362,72.95094511506288,300,103.37769385040559,-0.8025820256903177,-0.30391345441076784,0.22429590849737613,1.410422755302129,276808,290198,St. Johns,St. Johns,12,109,Florida,FL
12111,12CS044,2952,2809,3095,3405,310,453,596,545.0860596869476,362,436.02900436029,-0.6220577807879505,1.0541058341407752,2.7894822696184187,0.798163169066189,3718,3541,3894,4440,546,722,899,211.38474687865082,522,152.72759190719313,0.0728100934265945,0.5639055396742048,1.090026498393705,0.721511335245088,332088,341785,St. Lucie,St. Lucie,12,111,Florida,FL
12113,12CS045,1426,1344,1507,1572,65,146,228,309.5805623478511,130,275.16576091270366,-1.3252083524644391,0.32497686415676336,2.08119519290693,0.8827982460204716,1796,1696,1896,2097,201,301,401,155.72339389433483,332,171.76352508420032,-0.6966291471096944,-0.16720188315480522,0.30882835058428054,1.0993516146467661,188977,193289,Santa Rosa,Santa Rosa,12,113,Florida,FL
12115,12CS046,5035,4847,5223,5783,560,748,936,685.037723938311,387,354.4321186935467,1.5977355013877952,3.294440146413745,5.065398264477803,0.5166998680445322,6258,6028,6488,7121,633,863,1093,193.6613735684331,682,153.12216544378484,-0.11738175694796833,0.4024838914950125,0.8844585057923703,0.7897540309670558,436755,445396,Sarasota,Sarasota,12,115,Florida,FL
12117,12CS047,3033,2830,3235,3358,123,325,528,276.23512625957056,248,210.58709644549361,-1.0303946532203228,0.6559691576723985,2.2787184318943767,0.7600110180726649,3736,3493,3978,4398,420,662,905,140.87361917028645,530,112.7098423338168,-0.24751935646576362,0.29955747950579353,0.7847862625143629,0.7988717466563122,471064,470234,Seminole,Seminole,12,117,Florida,FL
12119,12CS048,1704,1647,1760,2017,257,313,370,950.3445233887494,117,355.0565207495638,4.248285286384971,5.903322100297181,7.5932938767569995,0.37241899424230596,2130,2060,2199,2742,543,612,682,453.72242913729696,320,237.13013257056474,1.6572779633673937,2.1776890403478193,2.652023460431406,0.5217804136603547,131810,134947,Sumter,Sumter,12,119,Florida,FL
12127,12CS049,6297,6058,6536,6918,382,621,860,447.0176420555906,402,289.3283192687623,-0.13863526395424378,1.5947714501334653,3.308999713117427,0.6462009704239194,7779,7488,8069,9312,1243,1533,1824,272.3238111298838,1137,201.9448514719595,0.2006108296876752,0.709234070166845,1.2581666035033439,0.7410781534554972,555770,563025,Volusia,Volusia,12,127,Florida,FL
13001,13CS001,177,169,185,232,47,55,63,1200.359207367302,48,1041.836236366596,-0.04795486748532909,1.5311024039874872,3.467607100662045,0.8525217389816452,216,207,226,269,43,53,62,286.3353909198877,58,313.8697981492505,-0.7736963464899785,-0.29290431284097135,0.2509811398666803,1.0758289325975976,18429,18479,Appling+Jeff Davis+Long+Wayne,Appling,13,1,Georgia,GA
13161,13CS001,146,140,152,186,34,40,46,1081.3066243283633,26,701.0920857489551,2.0935658092530707,3.8076292815595405,5.466564584895484,0.6325994635349422,178,171,186,216,30,38,45,253.12795880592682,35,235.56333288464126,-0.3188163641210667,0.17323623695875384,0.7110898685477715,0.9065067263777568,14834,14858,Appling+Jeff Davis+Long+Wayne,Jeff Davis,13,161,Georgia,GA
13183,13CS001,80,78,82,105,23,25,27,592.4872114734375,4,94.85978537973557,4.589999871905476,4.985098333975908,5.353097475887928,0.15394263745453482,99,97,102,149,47,50,52,291.22223588358963,29,170.32773405380007,1.0851475865648261,1.2049158828388908,1.3293744406921126,0.5733095023976843,16867,17026,Appling+Jeff Davis+Long+Wayne,Long,13,183,Georgia,GA
13305,13CS001,299,286,312,336,24,37,50,487.5872100968316,40,530.5391604217787,-2.2181788240841165,-0.43504291396736344,1.2745516995254689,1.0592760915779387,367,351,383,512,129,145,161,478.0292366994643,103,339.40751968893136,0.8464977181582232,1.3858658992593131,1.9282113444904587,0.7051532826254152,30158,30347,Appling+Jeff Davis+Long+Wayne,Wayne,13,305,Georgia,GA
13005,13CS002,127,122,132,146,14,19,24,685.8690172706838,25,899.685110211426,-3.9340480534052817,-2.2206070339441473,-0.46877021927009543,1.2463491120833008,155,149,160,185,25,30,36,274.6067252183233,40,360.8479927830401,-1.3525415909888507,-0.861323965244037,-0.3395976690624777,1.2722583389305637,11115,11085,Bacon+Ben Hill+Coffee+Irwin,Bacon,13,5,Georgia,GA
13017,13CS002,195,188,202,267,65,72,79,1683.2703706047957,50,1170.343495816022,3.36973905401138,5.152693886962717,6.778370276609403,0.6857438934725993,239,230,248,287,39,48,57,281.2383379765015,39,227.312467214548,0.04058234449068969,0.541682212465473,1.0441043084518007,0.7918450252867701,17089,17157,Bacon+Ben Hill+Coffee+Irwin,Ben Hill,13,17,Georgia,GA
13069,13CS002,362,343,380,479,99,117,136,1089.3360145237891,94,872.066054364969,0.5244602893359638,2.15132951150253,3.825744558885025,0.7937879907934687,446,424,469,551,82,105,127,241.22201719265183,113,260.74716754736136,-0.7365123046059714,-0.18715384490075554,0.32198615698646643,1.0707004789532462,43116,43337,Bacon+Ben Hill+Coffee+Irwin,Coffee,13,69,Georgia,GA
13155,13CS002,99,99,100,121,21,22,22,895.3863998425298,18,749.1416085735095,1.0706935613171884,1.4758746198698043,1.8873321726464858,0.7995061993083525,122,121,123,155,32,33,34,341.25239600791593,27,280.60694242361257,0.4774293341576369,0.606533837440001,0.7306728324576075,0.7979830406728016,9611,9622,Bacon+Ben Hill+Coffee+Irwin,Irwin,13,155,Georgia,GA
13011,13CS003,153,145,161,168,7,15,23,334.0317681381138,18,393.8299967180834,-2.347888887064006,-0.6466834000889814,1.1590333696034172,1.1065400105327767,190,180,199,268,69,78,88,422.659954598535,41,221.7414818820984,1.5312995957570035,2.0230148422900904,2.5286236851072132,0.5180049316150429,18282,18490,Banks+Habersham,Banks,13,11,Georgia,GA
13137,13CS003,409,389,429,508,79,99,119,856.1745241200059,74,642.179940554965,0.3975670614975571,2.1312344963569188,3.6957380604325696,0.7425310593054503,507,483,531,608,77,101,125,216.7437039800568,94,201.38829376981747,-0.3829237507452199,0.14443890044612775,0.6673166554485006,0.9200596280059056,46093,46676,Banks+Habersham,Habersham,13,137,Georgia,GA
13013,13CS004,567,530,603,619,16,52,89,248.39228151429478,55,261.3199030740723,-1.839429647157889,-0.10947228000894849,1.6461369158969867,1.0322992646453586,716,672,761,889,128,173,217,200.44101340469948,114,132.150930272996,0.16479819443193894,0.6712309099497081,1.1854374379187953,0.6555098121769267,84188,86265,Barrow,Barrow,13,13,Georgia,GA
13015,13CS005,816,769,863,1038,175,222,269,812.2734977399008,119,435.72187030866684,2.096114457942098,3.767232118825699,5.553004988346103,0.5340154012160924,1018,961,1075,1338,263,320,377,288.9869499846984,182,164.5272102693907,0.7337899682737411,1.2702723566992924,1.7564465879527966,0.5675486342045873,109244,110620,Bartow,Bartow,13,15,Georgia,GA
13021,13CS006,1498,1430,1565,1827,262,329,397,841.6961377381266,199,508.6326981814464,1.6356859599628597,3.313402309343248,5.1610181432800175,0.6024654361669743,1835,1754,1916,2317,401,482,563,307.08678773094294,332,211.71849093181643,0.4658477354486043,0.9701657988490742,1.4705525792797702,0.6880131255067137,156498,156812,Bibb,Bibb,13,21,Georgia,GA
13023,13CS007,134,129,139,175,36,41,46,1300.3777066329205,30,950.043543662418,1.816026166627621,3.517746070744871,5.22231308655621,0.7132213667177376,163,157,170,197,27,34,40,266.007339883345,43,341.1886058874871,-1.2471711907907301,-0.7503152988820193,-0.23076993633071152,1.2454777194414666,12631,12603,Bleckley+Dodge+Pulaski+Twiggs,Bleckley,13,23,Georgia,GA
13091,13CS007,187,178,196,289,93,102,111,2044.6970103810895,67,1342.685370741483,5.310027758956822,7.043065352034592,8.68203543356474,0.650293626676415,227,217,238,320,82,93,103,468.7877011879304,64,323.69006676107625,0.9341642038048582,1.4501903498826063,1.9591561701570384,0.6831133005052029,19960,19772,Bleckley+Dodge+Pulaski+Twiggs,Dodge,13,91,Georgia,GA
13235,13CS007,90,89,91,111,20,21,22,835.4496946891165,22,874.925432491549,-0.8071745292369886,-0.37879123036096896,-0.023909255533295804,0.9996645410723713,108,107,110,174,64,66,67,661.7515118297674,34,343.1224139671006,3.072878863220396,3.1824057809513366,3.3090300430547845,0.5107178856889519,10058,9909,Bleckley+Dodge+Pulaski+Twiggs,Pulaski,13,235,Georgia,GA
13289,13CS007,93,92,94,131,37,38,39,1915.387819837604,19,950.2375593898474,9.223649827268002,9.65761848122119,10.066116216221431,0.48348295677345826,111,110,112,161,49,50,51,628.814882599986,26,330.1587301587301,2.8617231832686074,2.9843820673727524,3.1088971887218526,0.5146560992241906,7998,7875,Bleckley+Dodge+Pulaski+Twiggs,Twiggs,13,289,Georgia,GA
13025,13CS008,170,162,178,207,29,37,45,808.0988553403998,29,637.2225884421007,0.03935656729506558,1.6964330621185593,3.463166287119524,0.7676714207431367,209,200,219,294,75,85,94,467.5424379638609,67,370.3294273712138,0.46901096333519077,0.9654537381073621,1.4914192572002951,0.7828220531293593,18204,18092,Brantley+Pierce+Ware,Brantley,13,25,Georgia,GA
13229,13CS008,192,184,201,252,51,60,68,1208.483318705985,37,750.964075502334,2.8770174136743902,4.6346968073538894,6.279242994729756,0.6111462527188882,240,229,250,346,96,106,117,533.4041822151544,78,391.1931390741762,0.8905673112418142,1.433404226511122,1.9612123795318768,0.7265582959502549,19708,19939,Brantley+Pierce+Ware,Pierce,13,229,Georgia,GA
13299,13CS008,411,395,426,505,79,94,110,1045.6292125412594,72,796.900940785833,0.7993534240713918,2.470017143629775,4.284817709642964,0.7541430786199711,503,484,521,650,129,147,166,408.7057210701623,144,399.33444259567386,-0.41783790823792516,0.08713374543110046,0.6368243218819709,0.970485886379622,36140,36060,Brantley+Pierce+Ware,Ware,13,299,Georgia,GA
13027,13CS009,183,176,190,200,10,17,24,411.8427758562829,28,694.2722539052814,-4.665740666377631,-2.8574502403954423,-1.2690354613693848,1.5900400662298595,226,218,235,231,-4,5,13,28.66466054554257,35,215.1992129857354,-2.4372382857589003,-1.8558826259443582,-1.2959332778709103,6.181539023569842,16132,16264,Brooks+Thomas,Brooks,13,27,Georgia,GA
13275,13CS009,473,453,492,539,47,66,86,580.989870750579,76,666.9738256653284,-2.691640750271471,-0.8665824966279747,0.793875056653424,1.1309129454566966,584,560,607,693,86,109,133,238.39092062335416,85,185.46398725753312,0.040211107741049266,0.5324601772013795,1.0305941993219858,0.7709265087312624,45579,45831,Brooks+Thomas,Thomas,13,275,Georgia,GA
13029,13CS010,283,264,302,295,-7,12,31,106.42591864752274,19,171.06714385396268,-2.4141046051822954,-0.6610292589419652,1.0440583118097573,1.4820060227065937,363,339,387,369,-18,6,30,13.200120879379321,54,115.74322151966564,-1.5259666623822614,-1.044137364158028,-0.5217657286604973,7.543462501266849,44427,46655,Bryan+Liberty,Bryan,13,29,Georgia,GA
13179,13CS010,333,305,361,384,23,51,79,312.4481926105753,35,215.65003080714723,-0.7749521032110653,0.9977620697525812,2.5819203569098566,0.6768472006945286,416,382,450,602,152,186,220,283.28491446285955,102,155.39542040555156,0.7736574173100847,1.286739483075072,1.7881172222378094,0.5456138967948674,64920,65639,Bryan+Liberty,Liberty,13,179,Georgia,GA
13031,13CS011,486,451,521,559,38,73,108,358.36218599680126,53,260.93271136165026,-0.6673815669418205,0.9317352255213162,2.7275624846765902,0.7182580947493763,606,564,649,748,99,142,184,172.06762295018902,146,177.42778324644232,-0.592123535251398,-0.05055102525519847,0.4730565372001086,1.0239198555869131,81247,82287,Bulloch,Bulloch,13,31,Georgia,GA
13033,13CS012,224,213,234,248,14,24,35,403.0007443732969,25,411.87857819514807,-1.9464610209871316,-0.03626283650677056,1.6545548627715465,0.9818885672995095,275,262,287,286,-1,11,24,46.649464880401794,52,213.5085198111271,-2.1655621689989117,-1.6792812182775414,-1.1330961639492354,4.206616998765809,24279,24355,Burke+Emanuel+Jenkins+Screven,Burke,13,33,Georgia,GA
13107,13CS012,255,245,265,304,39,49,59,860.2816961328929,47,827.8291501541172,-1.3427427088908057,0.3800788256975064,2.047301411555391,0.9429704834195726,313,301,324,407,83,94,106,415.5207854792935,82,360.9472664847258,0.018993910800329066,0.5467084635679068,1.103748375129954,0.859556695596132,22710,22718,Burke+Emanuel+Jenkins+Screven,Emanuel,13,107,Georgia,GA
13165,13CS012,86,85,87,110,23,24,25,1107.0999279969062,26,1199.5386389850057,-1.3265113930447832,-0.9207044323509734,-0.5342397410632508,1.0401501586010098,105,104,106,133,27,28,29,321.3609767358743,20,231.42791020597085,0.764789784196795,0.9034752255688405,1.0226604807337538,0.6951198786847054,8670,8642,Burke+Emanuel+Jenkins+Screven,Jenkins,13,165,Georgia,GA
13251,13CS012,154,148,160,181,21,27,33,779.2204574303355,17,484.0546697038725,1.279738494487316,2.8970081966677643,4.524261787286368,0.5993043317982714,189,182,196,252,56,63,70,447.6734676375486,43,305.00780252518086,0.8911795619371423,1.4231138903368576,1.9478239246226445,0.6706907543395317,14048,14098,Burke+Emanuel+Jenkins+Screven,Screven,13,251,Georgia,GA
13035,13CS013,242,231,253,290,37,48,59,754.8289826454854,41,643.7431307897629,-0.5623702348205719,1.0775966380660276,2.8476529292113195,0.8354549490216885,298,285,311,361,50,63,76,244.3640062417114,55,213.62541754058884,-0.25522829862197954,0.29262427747884356,0.8576253793907445,0.860531917301924,25476,25746,Butts+Lamar+Monroe,Butts,13,35,Georgia,GA
13171,13CS013,180,172,188,236,48,56,64,1189.793061158015,28,599.8607466123935,4.220335326893171,5.880942010781769,7.635478635632353,0.4952547028069969,224,215,234,307,73,83,92,434.7155225042634,55,289.4279850549913,0.9550102661483437,1.4483044903861173,1.999670546646629,0.6578239913223837,18671,19003,Butts+Lamar+Monroe,Lamar,13,171,Georgia,GA
13207,13CS013,247,235,259,303,44,56,68,801.3607652851604,43,612.928515430119,0.25571063596049415,1.8813221005727778,3.4652190974777985,0.7514925276621861,307,293,322,372,50,65,79,226.05350100376901,65,227.15359077406953,-0.530824057568617,-0.009600534923987524,0.4993190144431201,0.9895682860814006,28062,28615,Butts+Lamar+Monroe,Monroe,13,207,Georgia,GA
13007,13CS014,28,28,28,38,10,10,10,1419.8671953734831,5,696.6213862765587,6.813607496851487,7.240871748070624,7.6201822909033226,0.44678373279072386,34,34,34,46,12,12,12,422.3799675754113,3,106.26992561105206,3.033675215253676,3.1591351417753586,3.2792415924993494,0.2321301116791353,2871,2823,Calhoun and Nearby Counties,Baker,13,7,Georgia,GA
13037,13CS014,52,51,52,70,18,18,19,1293.6772192993644,2,141.69323414806942,11.1311435919903,11.51007826862278,11.935441063093009,0.10384079073668549,63,62,64,68,4,5,6,88.89439599553657,2,36.25815808556926,0.39868815518232414,0.5272673188590127,0.6629422863937183,0.3387869630712938,5646,5516,Calhoun and Nearby Counties,Calhoun,13,37,Georgia,GA
13061,13CS014,36,35,37,37,-0,1,2,132.59103119951646,5,701.7543859649123,-7.393402814659384,-5.687999587964917,-3.9184619578114375,2.5710759849885996,45,43,46,57,11,12,14,431.2328966273958,2,69.56521739130436,3.0963866585205566,3.6299748207420057,4.133062075631214,0.14927661547029605,2850,2875,Calhoun and Nearby Counties,Clay,13,61,Georgia,GA
13099,13CS014,141,137,146,172,26,31,35,1144.5282149255208,35,1308.4112149532712,-3.3262593387313157,-1.7090437026379428,0.15253922024601038,1.1070298698031429,172,166,177,194,17,22,28,209.9645105330696,23,216.02329294636985,-0.5975115055449072,-0.06939920812537913,0.46908930438767044,0.9848031414953976,10700,10647,Calhoun and Nearby Counties,Early,13,99,Georgia,GA
13177,13CS014,224,210,238,267,29,43,57,524.2550238241473,32,390.88743663348197,-0.29580972811778417,1.3151100573812047,3.0881665681771766,0.7286283481743552,283,266,300,310,10,27,44,81.01604253815323,43,128.83123108727565,-0.9812322697026342,-0.4716525696033384,0.028028255307944682,1.533483914527941,32746,33377,Calhoun and Nearby Counties,Lee,13,177,Georgia,GA
13201,13CS014,81,81,82,95,13,14,14,925.7375447207004,3,202.25855385133997,6.835483691665566,7.239658071135146,7.6205213860799255,0.20365213263182677,101,100,101,128,27,27,28,463.78405442393984,20,337.32501264968795,1.142840465510701,1.2653052795172943,1.3941854483944243,0.7018096297891435,5933,5929,Calhoun and Nearby Counties,Miller,13,201,Georgia,GA
13239,13CS014,28,27,29,33,4,5,6,843.6326377951735,5,894.0545373267769,-2.33848230039417,-0.5382464822324643,1.201025815346948,0.8744292449897201,35,34,36,51,15,16,17,725.2782013522692,5,223.2142857142857,4.522567807721621,5.008675035360887,5.5077428069749175,0.28991840559677157,2237,2240,Calhoun and Nearby Counties,Quitman,13,239,Georgia,GA
13243,13CS014,74,74,75,104,29,30,30,1855.4858286141252,25,1555.2099533437015,2.6227680447650563,3.023702104725919,3.4220013442512585,0.8109791079577415,90,89,91,115,24,25,26,393.2274205881386,6,95.23809523809524,2.8489401115401076,2.978731927430335,3.1024187624989605,0.23279881112309306,6430,6300,Calhoun and Nearby Counties,Randolph,13,243,Georgia,GA
13273,13CS014,104,103,105,136,31,32,33,1431.3051620036883,31,1370.317162117361,0.19914502451193378,0.6102843013305442,0.9929992107156431,0.9287081383541148,128,127,129,135,6,7,8,79.45157245159966,15,166.8149466192171,-0.992942825714014,-0.8749142971925916,-0.7464864259560827,1.8417822157225916,9049,8992,Calhoun and Nearby Counties,Terrell,13,273,Georgia,GA
13039,13CS015,331,307,354,357,3,26,50,190.27286963727465,22,160.08440814247513,-1.4814145448756508,0.2945548039163305,2.099140444141211,0.8103511368762619,416,387,445,529,84,113,142,203.29893714103923,82,147.60413291572164,0.07110370598733341,0.5573328420394726,1.0680322734127088,0.7196726550645268,54971,55554,Camden+Charlton,Camden,13,39,Georgia,GA
13049,13CS015,96,94,97,141,44,45,47,1428.994904561975,17,536.9551484523057,8.478196541292208,8.931626361782765,9.300001819128182,0.3676313273317827,119,117,120,178,58,59,61,465.6087040144545,45,353.440150801131,0.9987969799894073,1.121269332042152,1.2432730428460939,0.7465001560076282,12664,12732,Camden+Charlton,Charlton,13,49,Georgia,GA
13043,13CS016,133,129,138,174,36,41,45,1482.6448958373783,35,1274.9294235497678,0.40699095131215196,2.0350062095066423,3.7292954241847336,0.8392820646334622,162,156,168,234,66,72,78,654.3654627322046,42,380.71065989847716,2.210175053705308,2.7210957124895763,3.2101074388438318,0.5738520395599325,10981,11032,Candler+Evans+Tattnall+Toombs,Candler,13,43,Georgia,GA
13109,13CS016,98,97,99,126,27,28,29,1030.25937452498,11,409.91242779951557,5.79099084138861,6.206550250147643,6.6120431574489595,0.38398422309692654,119,118,121,179,58,60,61,558.2542680532704,33,308.87308124298016,2.365516494091948,2.4948032963758053,2.617542747367644,0.5441603791789792,10734,10684,Candler+Evans+Tattnall+Toombs,Evans,13,109,Georgia,GA
13267,13CS016,189,179,199,242,43,53,63,919.6983560214799,34,585.3994490358127,1.6047382516813034,3.3360779120647854,4.98983444149278,0.6248153059999159,228,216,240,346,106,118,130,511.26815820761726,74,321.41771272206057,1.3817520324015828,1.8940295735148729,2.4078916031064725,0.6233717148354171,23232,23023,Candler+Evans+Tattnall+Toombs,Tattnall,13,267,Georgia,GA
13279,13CS016,262,250,274,364,90,102,114,1511.0481240064535,47,696.1158218239716,6.524691709311178,8.183530960523074,9.795158698147032,0.4562123870467912,316,303,330,455,125,139,152,514.2753600797637,96,356.45328976682015,1.0612754036212193,1.5919047044609023,2.087708661091236,0.68814915415033,27007,26932,Candler+Evans+Tattnall+Toombs,Toombs,13,279,Georgia,GA
13045,13CS017,957,905,1008,1159,151,202,254,674.9663167025351,126,420.63445697260033,0.9076100608792222,2.534276236219426,4.232668220091981,0.6201261262395311,1192,1129,1255,1501,246,309,372,254.12928600563296,207,170.22606350172282,0.3557916463451041,0.8512118249438975,1.3539423654943674,0.6676798290661468,119819,121603,Carroll+Heard,Carroll,13,45,Georgia,GA
13149,13CS017,111,110,112,135,23,24,25,830.8939798662797,4,138.79250520471894,6.515912789761338,6.926156568148299,7.318096672971513,0.16034400523734424,136,135,138,178,40,42,43,360.9816110763215,28,242.42424242424244,1.0610779495916005,1.1857598877987914,1.316332309753858,0.6558394432893292,11528,11550,Carroll+Heard,Heard,13,149,Georgia,GA
13047,13CS018,569,540,598,645,47,76,105,447.71362249696625,60,353.1333225431485,-0.8564970391501944,0.927160080499675,2.6477216513707114,0.7785140268536039,700,664,735,901,166,201,237,294.79971526709403,151,220.96698665417938,0.21946721983494033,0.7343208157420094,1.2407254648424244,0.745847211297145,67963,68336,Catoosa,Catoosa,13,47,Georgia,GA
13051,13CS019,2133,2006,2260,2425,165,292,419,396.7902914567137,193,262.2603307469663,-0.40088574917039055,1.3476264595946026,3.0490952256154285,0.6586987027106557,2639,2486,2792,3199,407,560,713,189.0684049128613,396,133.72911748913452,0.03966383671134891,0.5608870273864448,1.0554670063033122,0.7060443891065193,294364,296121,Chatham,Chatham,13,51,Georgia,GA
13055,13CS020,276,266,287,336,49,60,70,957.4026528049678,36,578.057886074425,2.0156483223563706,3.740059142746944,5.599619989816368,0.5938179228264128,337,324,350,380,30,43,56,173.49626036205353,48,192.53910950661853,-0.7288666899329697,-0.19623615047891077,0.33452582231304245,1.0846815959328115,24911,24930,Chattooga+Dade+Walker,Chattooga,13,55,Georgia,GA
13083,13CS020,163,156,170,207,37,44,51,1090.0565773893836,2,49.33094900413146,8.794124842778704,10.37723270714801,12.185142079812584,0.04425403527312229,200,191,208,247,39,47,56,290.67556747104504,31,190.05579057078046,0.5057079327895317,1.0161118380823462,1.5285256970701802,0.6403358921472423,16217,16311,Chattooga+Dade+Walker,Dade,13,83,Georgia,GA
13295,13CS020,705,675,734,830,96,125,155,737.017204132934,63,370.07665873645254,2.023890811098719,3.6206958332731993,5.292613881797167,0.4981571201371373,864,829,899,1000,101,136,171,199.0093390258022,156,228.09351834252044,-0.7741537114451025,-0.2908882473724331,0.20817875073305256,1.1377853936976772,68094,68393,Chattooga+Dade+Walker,Walker,13,295,Georgia,GA
13057,13CS021,1449,1333,1564,1630,66,181,297,270.98765374943736,116,173.4722107986451,-0.6470995098099539,0.9998603187003402,2.7065634851449287,0.6366347430440918,1832,1691,1974,2243,269,411,552,150.01165775924386,260,95.00944613147114,0.028724978035494723,0.5363000925007391,1.1056621972274683,0.631808031842963,267478,273657,Cherokee+Pickens,Cherokee,13,57,Georgia,GA
13227,13CS021,303,289,317,334,17,31,45,373.21925165191533,23,276.2347995796427,-0.6587571515651487,0.9782176035742509,2.524034065238444,0.7170656142017783,377,359,394,470,76,93,111,274.6126442589367,86,253.51531409368275,-0.31090853305092975,0.2023063327467107,0.7297964931988589,0.913369579113732,33305,33923,Cherokee+Pickens,Pickens,13,227,Georgia,GA
13059,13CS022,680,625,735,698,-37,18,73,55.36590790940153,50,155.67109810392603,-2.6690698794448555,-0.9741521157006084,0.6264145672805783,2.6619849859094527,851,785,918,967,49,116,182,90.06006202790242,86,66.83297196900816,-0.28675147836719383,0.22214870448738736,0.7202519244125862,0.7357446025876665,128476,128679,Clarke+Madison+Oconee,Clarke,13,59,Georgia,GA
13195,13CS022,261,248,274,282,8,21,34,278.9439630995617,26,343.4837175506969,-2.3987787524940507,-0.6946489290369008,1.1799017653276302,1.1756905209356745,326,310,342,400,58,74,90,240.1328396818927,50,162.3692927193609,0.25988629573482547,0.780540194805557,1.3067617984918363,0.6671425024838636,30278,30794,Clarke+Madison+Oconee,Madison,13,195,Georgia,GA
13219,13CS022,249,231,268,292,24,43,61,406.215905143554,27,257.9166069637484,-0.1451698285039323,1.5443297906203257,3.2003480748125264,0.6203372461469491,317,295,339,350,11,33,55,77.476402496302,29,67.63532896424657,-0.40777997205905137,0.10006485698591584,0.6025214889746988,0.8474685957115237,41874,42877,Clarke+Madison+Oconee,Oconee,13,219,Georgia,GA
13063,13CS023,1537,1409,1665,1920,255,383,511,516.2111184860798,204,275.0688514864168,0.6987638146335853,2.439399307383741,4.124869761615253,0.5314729109072013,1912,1758,2065,2628,563,716,870,241.01599813520733,432,145.3830776789861,0.44199479530256575,0.9659179560604504,1.4843631599988247,0.6023681452580929,296653,297146,Clayton,Clayton,13,63,Georgia,GA
13067,13CS024,3842,3513,4172,4574,402,732,1061,382.3404877074529,451,235.65680844393353,-0.15862522133339232,1.448682051066588,3.2719619955172488,0.6155120847568007,4786,4391,5182,5655,473,869,1264,113.2754461387514,629,82.03819928108975,-0.17690008655126177,0.32355063322198957,0.8155396175629794,0.7234034486205653,765520,766716,Cobb,Cobb,13,67,Georgia,GA
13071,13CS025,423,404,443,525,82,102,121,887.5745490015546,55,480.17111552480526,2.2211081810555027,4.050280941188237,5.746416882947183,0.5357229419237868,520,497,544,640,96,120,143,261.3012315474595,108,235.7049323439546,-0.2516117609764792,0.25313641321585817,0.7729973982674311,0.8945712622763371,45817,45820,Colquitt+Mitchell,Colquitt,13,71,Georgia,GA
13205,13CS025,220,211,230,288,58,68,77,1250.5482986591228,50,922.2965183306433,1.5944555291748144,3.2725289340923913,4.929520920722951,0.7267933117700086,269,257,280,288,8,19,31,90.34010199355926,35,162.45822502784998,-1.243225466191294,-0.7171868387185748,-0.19261672445190278,1.710414878688824,21685,21544,Colquitt+Mitchell,Mitchell,13,205,Georgia,GA
13073,13CS026,846,778,913,1012,99,166,234,422.8731055688571,101,257.12340013874484,-0.07618014605090154,1.6588687389596612,3.3510883369965097,0.6044005358814271,1065,983,1147,1356,209,291,373,182.6499983301425,175,109.9101249207077,0.20658910656102217,0.7211379223367124,1.2897132034705225,0.5996905860277466,157123,159221,Columbia,Columbia,13,73,Georgia,GA
13077,13CS027,924,860,987,1100,113,176,240,479.3773900227183,95,258.0347260418152,0.514972070883884,2.262267864321108,3.8006040068823737,0.535237878001013,1158,1081,1235,1579,344,421,498,281.4629974190753,247,165.2461297616977,0.6598352393538537,1.159140834300041,1.6491128065601557,0.5857050028065997,147267,149474,Coweta,Coweta,13,77,Georgia,GA
13079,13CS028,130,125,135,140,5,10,15,333.09781515882634,5,164.73107651758502,-0.1891113775264325,1.7076613880085494,3.427107605534586,0.45003076900206873,160,153,166,213,47,53,60,440.0163871025818,30,247.0152326060107,1.3961235387592463,1.932700335323768,2.427553364299937,0.5510654921554485,12141,12145,Crawford+Peach+Pike+Upson,Crawford,13,79,Georgia,GA
13225,13CS028,276,263,288,319,31,43,56,620.2711477156098,36,513.8086062941554,-0.6468294608873976,1.0413021387256765,2.7323432714724736,0.8097293850341079,342,328,357,408,51,66,80,231.52901263754092,68,239.76587567434154,-0.6188585463613359,-0.08079071463146174,0.4325965295074958,1.020041669608006,28026,28361,Crawford+Peach+Pike+Upson,Peach,13,225,Georgia,GA
13231,13CS028,174,166,182,190,8,16,24,342.5707652287216,32,673.8970201116142,-5.279417721099568,-3.2866396744631463,-1.65871178520363,1.8532489970855688,218,208,228,264,36,46,56,235.65365642813754,55,283.5343849881431,-0.9524575380834145,-0.4792500541336019,0.07250851096530996,1.177425215033549,18994,19398,Crawford+Peach+Pike+Upson,Pike,13,231,Georgia,GA
13293,13CS028,340,328,352,421,69,81,93,1174.1289590508604,55,799.3605115907275,2.152618785549678,3.7244372380223116,5.5389913633729275,0.6724872021284921,418,404,432,548,116,130,144,469.34010542836296,97,349.94047404307514,0.7397914814848031,1.193231533665608,1.6798994404827312,0.7399136205805319,27522,27719,Crawford+Peach+Pike+Upson,Upson,13,293,Georgia,GA
13081,13CS029,198,190,207,318,111,120,128,2347.0610069457066,45,883.8259844839439,12.976160960454127,14.622390522326604,16.357309388474782,0.37344208932701994,240,230,251,346,95,106,116,531.2817138938713,66,331.6083002562428,1.474871107600405,1.994255728077366,2.5260414501110398,0.6183191116729532,20366,19903,Crisp+Dooly+Turner+Wilcox,Crisp,13,81,Georgia,GA
13093,13CS029,109,104,114,170,56,61,66,2138.4644311831375,20,698.9951944080384,12.601050825533362,14.372725444861047,15.96980713874653,0.3216115903418527,129,124,135,174,39,45,50,408.448466912129,25,228.89580662882256,1.2621967625648218,1.763895160680355,2.333676174227567,0.5481164994703549,11445,10922,Crisp+Dooly+Turner+Wilcox,Dooly,13,93,Georgia,GA
13287,13CS029,114,113,115,117,2,3,4,132.65507994130957,25,1133.9154099104205,-10.408465232881218,-10.01391928420834,-9.604538405791738,6.369892727493252,142,141,143,135,-8,-7,-6,-80.77940998462499,15,167.28002676480426,-2.6069116306141487,-2.48221743972853,-2.358551064575333,-2.4025025645586537,8819,8967,Crisp+Dooly+Turner+Wilcox,Turner,13,287,Georgia,GA
13315,13CS029,84,83,85,117,32,33,34,1499.1765621705147,25,1147.5786091347259,3.131023046869801,3.5231272604246238,3.9327164040212637,0.7427310088148251,104,103,105,171,66,67,68,766.7850160670191,17,194.55252918287937,5.59436659382241,5.720327046938547,5.849886981806895,0.24999384315186565,8714,8738,Crisp+Dooly+Turner+Wilcox,Wilcox,13,315,Georgia,GA
13085,13CS030,224,213,236,230,-6,6,17,81.87102004545905,18,266.0852211833401,-3.689417472025757,-1.90932085575682,-0.14375265835999376,2.7529797903860875,287,272,301,317,16,30,45,107.39954417278051,56,197.97779820405853,-1.4098743483548295,-0.9059274305254905,-0.38622887645293447,1.7846310405820867,27059,28286,Dawson+Lumpkin+White,Dawson,13,85,Georgia,GA
13187,13CS030,256,242,271,287,16,31,45,362.3768482295472,20,237.5226388765179,-0.3564796374914827,1.24786098145279,2.959300531883416,0.6346579759137397,320,302,337,425,88,105,123,308.49595638098,67,196.02680008192164,0.5960295636651634,1.1262578641717658,1.6399949183354037,0.629457682308312,33681,34179,Dawson+Lumpkin+White,Lumpkin,13,187,Georgia,GA
13311,13CS030,242,230,254,336,82,94,106,1315.2976331829627,33,463.27168076369634,6.8215830182558435,8.576490504453103,10.19032167588841,0.3484985149579222,297,283,312,448,136,151,165,530.8446284285226,67,235.99027860941845,2.421863106265999,2.959344923211385,3.4855294763571547,0.4416259525862881,28493,28391,Dawson+Lumpkin+White,White,13,311,Georgia,GA
13087,13CS031,298,285,310,367,57,69,82,959.0856057404491,39,539.9418524158937,2.36026052351956,4.209343203022058,5.97377243044585,0.554964594924291,365,350,380,397,17,32,47,108.72673536969725,51,175.36620590055705,-1.159106164002386,-0.6607440064873131,-0.13547183836787727,1.5634623541788566,28892,29082,Decatur+Grady+Seminole,Decatur,13,87,Georgia,GA
13131,13CS031,234,223,246,273,27,39,50,593.5815898069396,38,585.7192401063543,-1.66637972352652,0.09857234220784836,1.8701687255943198,0.9617796464582367,287,274,301,349,48,62,75,236.90421991045704,49,188.73738540944456,-0.02603806994649705,0.5007421770509908,0.9907676636086273,0.7839363622643019,25951,25962,Decatur+Grady+Seminole,Grady,13,131,Georgia,GA
13253,13CS031,119,118,120,125,5,6,7,275.68028301165594,14,622.8450672895117,-3.8738103602520417,-3.458706350761539,-3.066546581900141,1.945362125420064,149,148,150,163,13,14,15,154.27411655631826,28,304.74531998258595,-1.634461040217687,-1.4994284484713012,-1.376108163327327,1.8451758020989755,8991,9188,Decatur+Grady+Seminole,Seminole,13,253,Georgia,GA
13089,13CS032,3969,3641,4297,4797,500,828,1156,434.083390559109,479,251.23717261147667,0.07321470903711166,1.8873372872506673,3.5868838816317163,0.5780777939160027,4910,4518,5301,5888,587,978,1370,128.97311440752293,564,74.34660015897518,0.016047384121525697,0.5645316573584991,1.1222057653420316,0.5758618009255337,762626,758609,DeKalb,DeKalb,13,89,Georgia,GA
13095,13CS033,781,745,818,1089,271,308,344,1435.7202859687434,173,807.7129584237927,4.4139662321488125,6.289810875466577,8.034904855509327,0.5607602362917133,953,909,996,1205,209,252,296,297.32876372393685,149,175.4592557701366,0.7340276676517288,1.2354341904792328,1.7232439378104947,0.587790712348395,85674,84920,Dougherty,Dougherty,13,95,Georgia,GA
13097,13CS034,847,785,909,1034,125,187,249,516.0167766979073,108,298.02763654425917,0.38923377841665724,2.172102017967084,3.892806609705569,0.5744819900709773,1053,978,1128,1309,181,256,331,175.66221022838397,164,112.62034582686681,0.10506221446669442,0.6449146351652814,1.131602604313134,0.6386222611838479,144953,145622,Douglas,Douglas,13,97,Georgia,GA
13103,13CS035,422,394,450,470,20,48,76,293.95383583599255,31,190.18988312524922,-0.560393452284379,1.1006663741936427,2.83752682671201,0.6337782702330624,531,497,565,658,93,127,161,190.9355099390193,143,215.00849509088994,-0.8093536013079765,-0.23445577563943445,0.26433004571276253,1.117280912493534,65198,66509,Effingham,Effingham,13,103,Georgia,GA
13105,13CS036,224,216,233,296,63,72,80,1469.3017253127002,27,552.1472392638037,7.554385638062951,9.193759636636758,10.8513497137472,0.3706303995349805,273,263,284,331,47,58,68,293.5880246973038,39,199.12182170938425,0.388436059578272,0.943825926513143,1.499477618552412,0.6666421602488694,19560,19586,Elbert+Franklin+Hart+Stephens,Elbert,13,105,Georgia,GA
13119,13CS036,264,254,274,323,49,59,69,1005.8449623313534,33,562.8997867803838,2.8121754387152342,4.3988396414554645,6.175154783202245,0.5502966014607964,326,314,338,369,31,43,55,181.6597044859007,43,181.18231997640416,-0.517655811618099,-0.011321214755126709,0.5360996414776122,0.974762764867928,23450,23733,Elbert+Franklin+Hart+Stephens,Franklin,13,119,Georgia,GA
13147,13CS036,257,246,268,324,56,67,78,1029.1611766445105,36,554.2938527272028,3.02655624977674,4.719895165815623,6.5034115053252455,0.5306490704023057,319,305,332,408,76,89,103,338.3952438953405,52,197.4933535890619,0.8929906356084436,1.402773390654028,1.9199537616001205,0.577139924543832,25979,26330,Elbert+Franklin+Hart+Stephens,Hart,13,147,Georgia,GA
13257,13CS036,326,314,337,330,-7,4,16,60.17588352693888,42,629.3784887423669,-7.310521412222587,-5.719933791206298,-3.882355973970414,8.37372801875355,399,385,413,488,75,89,103,331.3552120150216,69,256.9258266309205,0.2482467691794169,0.7541165021095011,1.2197106731413074,0.7667624630827596,26693,26856,Elbert+Franklin+Hart+Stephens,Stephens,13,257,Georgia,GA
13111,13CS037,284,273,295,352,57,68,79,1061.504265710091,26,407.2362753543739,4.826337871909068,6.604468988854133,8.412957282252478,0.3780622688749642,347,334,361,470,109,123,136,476.6877676771232,79,306.7246466842677,1.213819777485258,1.6922980019642886,2.233109720336302,0.6382512809788558,25538,25756,Fannin+Rabun+Towns+Union,Fannin,13,111,Georgia,GA
13241,13CS037,181,174,188,234,46,53,60,1254.2391716643842,24,566.3716814159292,5.355841510855909,6.854513389381292,8.48949154056717,0.4432265162597654,221,212,230,286,56,65,74,381.8887408828977,46,269.22626711927893,0.6040984346691557,1.1100968391584407,1.6371159496668544,0.6943447553715497,16950,17086,Fannin+Rabun+Towns+Union,Rabun,13,241,Georgia,GA
13281,13CS037,169,164,175,181,6,12,17,375.3947979662825,26,832.1997279347044,-6.278028697868496,-4.533819889784891,-2.73614574473362,2.0426967659179933,209,203,216,249,33,40,46,310.2211366884747,41,319.6631841571807,-0.6028641480499428,-0.10012398234463386,0.4419863446180465,1.005173875304929,12497,12826,Fannin+Rabun+Towns+Union,Towns,13,281,Georgia,GA
13291,13CS037,279,268,290,361,71,82,93,1322.941021275422,31,499.57697111317026,6.50465310703099,8.213012901206532,9.924445536191609,0.3730813491779059,345,332,358,436,78,91,104,357.9984575104564,64,251.8594309550982,0.532412167770048,1.0765304524146218,1.5930698475677114,0.6958716152268513,24821,25411,Fannin+Rabun+Towns+Union,Union,13,291,Georgia,GA
13113,13CS038,793,742,844,868,24,75,126,251.96591916031588,70,235.5712603062426,-1.6534522045930962,0.17763884652052567,1.8449084099722861,0.9226104729772913,987,925,1050,1189,139,202,264,167.48450678030107,145,120.42289197651337,-0.04379054700100121,0.4801654974935642,0.9948690417961458,0.71546139792278,118860,120409,Fayette,Fayette,13,113,Georgia,GA
13115,13CS039,965,923,1007,1143,136,178,220,722.1123282883398,107,434.2003814470641,1.2700708719437528,2.902955514126182,4.6001149177317044,0.5979319120182585,1185,1134,1236,1454,218,269,320,272.87649044297257,207,209.6308673856904,0.08695801148204317,0.6385767606696734,1.1560007360748386,0.7653856648092131,98572,98745,Floyd,Floyd,13,115,Georgia,GA
13117,13CS040,1091,982,1200,1196,-4,105,214,166.26700348687925,71,112.5336313097092,-1.1109371292687313,0.5749869102575303,2.1452754824360674,0.670433726712572,1392,1258,1525,1702,177,310,444,119.76072827189367,201,77.56904030502771,-0.08228336151087728,0.4055070798712331,0.9123999451590754,0.6456197009766078,252369,259124,Forsyth,Forsyth,13,117,Georgia,GA
13121,13CS041,5852,5393,6312,7006,694,1154,1613,432.1180571623696,687,257.29012082711097,0.08955806910925218,1.7565001241733107,3.549810606306459,0.5949006730892701,7237,6687,7787,8396,609,1159,1709,108.75490251729086,877,82.280048636234,-0.25128018297319066,0.24972930064580343,0.7891326054285434,0.7559119373395745,1068055,1065872,Fulton,Fulton,13,121,Georgia,GA
13123,13CS042,308,294,321,363,42,55,69,704.4055959632813,33,418.88804265041887,1.108562784781661,2.869864392642212,4.451524474313783,0.5841424149050766,382,365,398,506,108,124,141,388.52419051993303,93,291.1800619931745,0.501748346698914,0.9715358776851186,1.51201258211744,0.7434603001012947,31512,31939,Gilmer+Murray,Gilmer,13,123,Georgia,GA
13213,13CS042,326,309,343,406,63,80,97,798.0714892557961,41,410.53369380194255,1.9799227364394933,3.8587105104184083,5.642381834841622,0.5080331211196578,402,381,422,545,123,143,164,358.928031019981,92,230.2936243710731,0.7585559589955431,1.3048198786310188,1.813649128698329,0.6371713620126362,39948,39949,Gilmer+Murray,Murray,13,213,Georgia,GA
13127,13CS043,751,715,787,945,158,194,230,917.1005933933392,107,505.7726622785768,2.4167438776275034,4.108473015817903,5.858762931742907,0.5486630576891092,922,878,966,1142,176,220,264,259.5910150412471,189,223.1404958677686,-0.11435289557149461,0.33808479421936977,0.8864727894846426,0.855693069608434,84623,84700,Glynn+McIntosh,Glynn,13,127,Georgia,GA
13191,13CS043,105,100,110,148,38,43,48,1497.0309956112878,12,418.1184668989547,9.151420526439246,10.845254803467629,12.565327575193354,0.27294569395788915,127,121,132,226,94,99,105,895.369551709343,25,225.18465141415962,6.176325608899437,6.702172000659627,7.207793733032313,0.24899424345166887,11480,11102,Glynn+McIntosh,McIntosh,13,191,Georgia,GA
13129,13CS044,483,459,508,593,85,110,134,757.852199515643,61,422.12341919969555,1.5726542740536036,3.2684357736341205,5.052196762978096,0.5519596404371768,599,569,629,774,145,175,205,300.5347586284126,122,209.7733759757901,0.3555645727788211,0.9150785870059865,1.3939524740024785,0.6940296190415242,57803,58158,Gordon,Gordon,13,129,Georgia,GA
13135,13CS045,3863,3451,4274,4746,472,883,1295,369.6551290483033,531,222.28547986034948,-0.20205645749500073,1.4456536721418298,3.1862347530907966,0.6006518495310286,4873,4376,5371,6005,634,1132,1629,117.4352642800227,761,78.97779281457758,-0.1375075526583526,0.38434388068238606,0.9191831035001689,0.6719281429204301,955528,963562,Gwinnett,Gwinnett,13,135,Georgia,GA
13139,13CS046,1338,1251,1426,1728,302,390,477,763.7031463181617,183,358.66880953314256,2.3004228893660184,4.035221409123349,5.938966199165502,0.46844208174723706,1672,1565,1779,2032,253,360,467,174.05179494810605,332,160.52761365064936,-0.3733880673035918,0.13222008191719878,0.6294380190825979,0.919742898688923,204088,206818,Hall,Hall,13,139,Georgia,GA
13141,13CS047,94,93,94,159,65,65,66,3014.162032273441,40,1844.1678192715538,11.334191127651655,11.700958995065086,12.116929880026996,0.6026167927959294,114,113,115,168,53,54,55,623.8735107091683,30,347.1017007983339,2.648494464461747,2.7661324335971145,2.8896478792542664,0.5462352891810828,8676,8643,Hancock+Jasper+Morgan+Putnam,Hancock,13,141,Georgia,GA
13159,13CS047,141,134,147,144,-3,3,10,95.4462727160626,16,437.09875700040976,-5.147575785215423,-3.4075718014831002,-1.7382996072995722,3.5604525127154405,177,169,185,225,40,48,56,315.85807176063116,53,349.0286466908133,-0.824162869451175,-0.3441617513004182,0.18812577468078484,1.082448947763994,14642,15185,Hancock+Jasper+Morgan+Putnam,Jasper,13,159,Georgia,GA
13211,13CS047,176,167,185,209,24,33,42,660.2743430301152,12,238.9724186000199,2.526496218185339,4.217945096447879,5.845751166899688,0.35133252676596805,219,208,230,294,64,75,86,364.6696203931304,38,184.75301439128745,1.3139226430039372,1.792447351146503,2.317840277480306,0.49996547920946177,20086,20568,Hancock+Jasper+Morgan+Putnam,Morgan,13,211,Georgia,GA
13237,13CS047,210,200,219,258,39,48,58,870.279463628825,30,541.0767427180089,1.5017268294574837,3.292484111603376,4.940057363279776,0.6091043452534638,259,248,271,367,96,108,119,477.76918962456574,51,226.46536412078152,2.0187967018620805,2.5035023307689617,2.9996855116980887,0.4696408434852567,22178,22520,Hancock+Jasper+Morgan+Putnam,Putnam,13,237,Georgia,GA
13143,13CS048,311,298,324,392,68,81,94,1082.992155858463,50,665.9784888948087,2.4137866288621534,4.238131281444246,5.749457784539347,0.6074718287886945,383,367,398,448,50,65,81,214.3078089286573,68,223.05320474972117,-0.5493512631539234,-0.1032773323623211,0.41242952308691644,1.02511720111081,30031,30486,Haralson+Polk,Haralson,13,143,Georgia,GA
13233,13CS048,422,403,440,504,64,82,101,767.8459300916429,46,428.51486993176366,1.5711449453548734,3.4193572726820904,5.159092487737801,0.5513846041832883,517,495,540,668,128,151,173,346.86023360837527,88,202.70425909289844,0.9331286751272938,1.4326834362846455,1.939798123984033,0.5805422048765266,42939,43413,Haralson+Polk,Polk,13,233,Georgia,GA
13145,13CS049,253,238,268,284,16,31,46,356.35539758954656,29,331.06912495005423,-1.4338294573148584,0.20950932264356134,1.8622759785589826,0.9002031371495418,317,299,335,347,12,30,48,84.49971692869907,58,163.26990203805877,-1.2834279766549894,-0.7758866213362775,-0.28573040947011413,1.8699013286574122,35038,35524,Harris+Meriwether+Talbot,Harris,13,145,Georgia,GA
13199,13CS049,233,224,242,284,42,51,60,983.0911099966011,19,366.9901974986721,4.524226054419849,6.117694100456431,7.837867591924721,0.3661091983465737,286,276,297,401,104,115,125,551.799288619825,68,327.4268104776579,1.7371495021499608,2.2284663728918748,2.7107972247854466,0.5882471187978142,20709,20768,Harris+Meriwether+Talbot,Meriwether,13,199,Georgia,GA
13263,13CS049,67,66,68,80,12,13,14,902.5852540947114,2,137.95481979651663,7.235152156668904,7.647266753365628,8.039275587005202,0.1419927143243072,81,81,82,98,16,17,17,290.9364617315112,20,348.4320557491289,-0.7125940348500058,-0.5729851249925415,-0.4501818875329613,1.129959277350751,5799,5740,Harris+Meriwether+Talbot,Talbot,13,263,Georgia,GA
13151,13CS050,1426,1322,1530,1751,221,325,429,538.44176788065,151,250.4852114194715,1.2302683402619758,2.850064347916489,4.519696478345793,0.4637750941655314,1788,1661,1914,2218,304,430,557,175.87764349656874,326,133.2042151370655,-0.0727481320518169,0.41518252203088296,0.9277324774561776,0.7556132065056675,241132,244737,Henry,Henry,13,151,Georgia,GA
13153,13CS051,1097,1027,1168,1304,136,207,277,505.6205194562888,106,259.2986704827603,0.670753396664573,2.4185346701415655,4.167431261405193,0.5103634099085352,1375,1290,1461,1705,244,330,415,197.99115849852,247,148.39112777257108,0.02718898785207283,0.491416430217254,1.0203329564228454,0.7472162945270866,163518,166452,Houston,Houston,13,153,Georgia,GA
13157,13CS052,580,547,613,680,67,100,133,521.9817879494186,77,402.3776863283036,-0.429043769893488,1.2143044300536123,2.8490805218350013,0.7632245511596965,736,695,777,865,88,129,170,161.54989211536886,139,174.26189431454898,-0.6413452679004881,-0.1257988191649254,0.3714226265045272,1.0703812524986829,76545,79765,Jackson,Jackson,13,157,Georgia,GA
13003,13CS053,72,71,73,80,7,8,9,385.4538481372154,11,529.7375391283409,-1.8348181666626606,-1.4419859698616493,-1.054463256287449,1.2216861522340345,89,88,90,139,49,50,51,595.0356645240315,28,334.20864168059205,2.4800262126566146,2.6066767101642854,2.737940998076377,0.5506165256068402,8306,8378,Lanier and Nearby Counties,Atkinson,13,3,Georgia,GA
13019,13CS053,184,176,192,227,35,43,51,940.6347643319582,30,654.485955822198,1.2380797826014374,2.897560712213353,4.5873158735656805,0.6800200540895844,223,214,233,286,53,63,72,344.8142882267659,37,203.86798170698108,0.8915434934606713,1.3817711511262578,1.918600044460738,0.5819408482434248,18335,18149,Lanier and Nearby Counties,Berrien,13,19,Georgia,GA
13065,13CS053,71,70,72,92,20,21,22,1260.9413382908645,13,774.8472656832066,4.445094185693291,4.8527807949012,5.278659085860332,0.5867632537118785,87,86,88,116,28,29,30,431.14339196281503,19,282.52788104089217,1.358269981698521,1.486475735111933,1.6055822023547064,0.6334517231483054,6711,6725,Lanier and Nearby Counties,Clinch,13,65,Georgia,GA
13075,13CS053,167,159,174,213,39,46,54,1071.8394418695784,32,742.7609818371728,1.5757449499042318,3.2297572446694223,4.944575732327251,0.6782891116734627,204,195,213,230,17,26,35,150.7700378912894,29,168.35016835016833,-0.6513276033514165,-0.16682925199950735,0.34923312694131886,1.0752031677325975,17233,17226,Lanier and Nearby Counties,Cook,13,75,Georgia,GA
13101,13CS053,21,21,21,36,15,15,15,1613.7567268859866,4,428.38018741633203,11.485128027061396,11.865580740734437,12.262362662949489,0.24893497159566386,26,25,26,42,16,16,17,444.17522453609723,4,108.13733441470669,3.228777141614724,3.361404244023813,3.4874503121061875,0.2294888389819761,3735,3699,Lanier and Nearby Counties,Echols,13,101,Georgia,GA
13173,13CS053,78,77,79,84,5,6,7,250.23685797612455,10,399.5205753096284,-1.8903516326177807,-1.4979922483233508,-1.1021847901518542,1.3767602894531332,95,93,96,114,18,19,21,196.41781433644354,3,30.278562777553493,1.5386134062642016,1.6606862990328686,1.7807335916329217,0.14661984769824385,10012,9908,Lanier and Nearby Counties,Lanier,13,173,Georgia,GA
13185,13CS054,802,751,853,989,136,187,238,632.4285660618683,107,361.75535871255664,1.110695633955956,2.688972601134845,4.356766718891256,0.5689681941328846,998,937,1060,1238,178,240,301,201.33697490224847,156,130.94278807413377,0.1745990976599887,0.6858233524095504,1.2339279191702046,0.647666193110346,118312,119136,Lowndes,Lowndes,13,185,Georgia,GA
13053,13CS055,35,34,36,35,-1,-0,1,-6.9273602939432415,4,165.68292430361396,-2.1212826296505836,-1.7353921255643008,-1.2971827900526625,4.803326568195671,42,41,43,39,-4,-3,-2,-31.211914121213717,9,98.78169245966416,-1.4279644901176547,-1.2986785871202204,-1.1783409268591876,-4.881441989652706,9657,9111,Marion and Nearby Counties,Chattahoochee,13,53,Georgia,GA
13193,13CS055,135,130,140,147,7,12,17,401.2472278579132,11,362.08031599736665,-1.3553950477232481,0.3768059409411526,2.0822925184070638,0.8339720306662272,164,158,170,174,4,10,16,85.65933125707025,23,191.57088122605364,-1.5795074368330475,-1.0353047153788573,-0.5681341404291749,2.0382374568565824,12152,12006,Marion and Nearby Counties,Macon,13,193,Georgia,GA
13197,13CS055,67,66,68,87,19,20,21,1058.5531117959083,3,157.02695629416385,8.583007568570093,9.031663792230333,9.409110768240197,0.14135169879573445,80,79,81,127,46,47,48,625.1384269583755,30,402.5764895330112,2.0976392140614513,2.2270664802096585,2.359705722402505,0.6304465912702546,7642,7452,Marion and Nearby Counties,Marion,13,197,Georgia,GA
13249,13CS055,31,30,31,40,9,9,10,797.8428710521476,6,517.6876617773943,2.412686584397572,2.8029560338558857,3.2218205911620186,0.5855372946657531,37,36,38,58,20,21,22,469.5434245589595,2,44.57321149988857,4.127877985905638,4.248381386089533,4.377384717018475,0.09062726704974372,4636,4487,Marion and Nearby Counties,Schley,13,249,Georgia,GA
13259,13CS055,49,49,50,59,9,10,10,718.3274098335954,12,873.2035655812261,-1.945524275611655,-1.5392311701528874,-1.1390503104668914,1.1037919048421743,59,58,60,78,18,19,20,358.93683524490683,12,224.97187851518564,1.2208513033262043,1.335873871775224,1.4689976033766625,0.595660884698336,5497,5334,Marion and Nearby Counties,Stewart,13,259,Georgia,GA
13261,13CS055,311,298,323,342,19,31,44,423.09369187596934,69,935.4980849405146,-6.939597420044377,-5.137388738659021,-3.3808698837830646,2.1424357764037527,378,363,393,431,38,53,68,179.6046605578662,58,197.80369688288656,-0.71836174879749,-0.1730010371139763,0.38095658865183746,1.0808055196153739,29503,29322,Marion and Nearby Counties,Sumter,13,261,Georgia,GA
13269,13CS055,82,82,83,98,15,16,16,798.7173514897489,17,866.5732126927488,-1.0589749572640157,-0.6728764953310054,-0.25936012589800816,1.0198671535619581,101,100,102,138,36,37,38,476.49604178562214,15,192.28304063581592,2.7106827293453213,2.8442011340109707,2.9628928726347885,0.3929637872253885,7847,7801,Marion and Nearby Counties,Taylor,13,269,Georgia,GA
13307,13CS055,21,21,21,27,6,6,6,1015.4726010203123,8,1342.2818791946308,-3.690496829344235,-3.2712616671767507,-2.879290741430737,1.1343950899352333,26,25,26,25,-1,-1,-0,-27.632429246344913,3,126.84989429175475,-1.6595743342473444,-1.5419207239536747,-1.4233009963377192,8.658182363287255,2384,2365,Marion and Nearby Counties,Webster,13,307,Georgia,GA
13215,13CS056,1781,1692,1869,1981,112,200,289,390.4019921704036,190,370.31081746112955,-1.5052692717054903,0.16549210778466186,1.8678846307814938,0.9438253522742683,2186,2080,2292,2572,280,386,492,187.53872748029974,369,179.28896619747053,-0.4150887598946012,0.08575229875064944,0.5808232998545011,0.9535399145251291,205233,205813,Muscogee,Muscogee,13,215,Georgia,GA
13217,13CS057,786,738,835,999,164,213,261,752.7669643486657,104,368.405671321921,2.224878248635927,3.932830191528833,5.6295579778048985,0.4871097821724447,988,928,1047,1256,209,268,328,233.23219375811325,199,173.0750832760765,0.06824160284860953,0.5968414019257232,1.100577602219398,0.7393151021850035,112919,114979,Newton,Newton,13,217,Georgia,GA
13223,13CS058,849,776,922,1046,124,197,270,462.71355094523557,106,249.35749278098297,0.38432781434511737,2.1352824197323197,3.7651836987430163,0.5361765930833021,1076,987,1166,1297,131,221,310,127.39404920834332,188,108.55819701003009,-0.2975805863327375,0.18314289225288094,0.7062223017954199,0.8482998833681251,170037,173179,Paulding,Paulding,13,223,Georgia,GA
13245,13CS059,1775,1686,1863,2116,253,341,430,663.3832723588022,236,458.87168120084385,0.23317091249379363,2.044736665111422,3.8786861993181634,0.6896927933407544,2175,2068,2281,2658,377,483,590,234.969113189353,391,190.01890469409872,-0.05657600982620501,0.45650192810878537,0.9574310529929528,0.8070282134245831,205722,205769,Richmond,Richmond,13,245,Georgia,GA
13247,13CS060,655,615,695,777,82,122,162,522.8080007772141,71,304.6262429072499,0.2958234989326389,2.229708584528111,3.8008355167818944,0.5779303800160878,816,768,865,1011,146,195,243,207.37163077865364,151,160.61437658221118,-0.0329310888076454,0.4658774316137848,0.962777257999328,0.7705718509676037,93229,94014,Rockdale,Rockdale,13,247,Georgia,GA
13255,13CS061,662,633,691,839,148,177,206,1050.0493100992858,94,558.029088750371,3.238775879941815,4.897681434335397,6.568417541009436,0.5284437481621618,814,779,849,1108,259,294,329,432.90407722306537,205,302.1949673482023,0.8020290650264872,1.3229067054435848,1.8177780094364893,0.6956955207085829,67380,67837,Spalding,Spalding,13,255,Georgia,GA
13133,13CS062,196,188,204,212,8,16,24,332.5116750392926,23,484.69522153732674,-3.2821080242389744,-1.5086880744308562,0.2217725917379055,1.3708010808983093,246,236,256,275,19,29,39,147.34614404557752,33,169.56990904886698,-0.7447456241679997,-0.21819986470845204,0.2816805275395606,1.1120459376372858,18981,19461,Taliaferro and Nearby Counties,Greene,13,133,Georgia,GA
13181,13CS062,79,78,80,96,16,17,18,883.6392057569036,17,877.7591325674454,-0.3535185166929875,0.06768314727164412,0.48068213703475077,0.9385067045278916,97,96,98,122,24,25,26,325.17156974545384,17,219.58150348747094,0.9210793725854735,1.0566699108431687,1.1833539217624631,0.649480075753177,7747,7742,Taliaferro and Nearby Counties,Lincoln,13,181,Georgia,GA
13189,13CS062,220,211,229,238,9,18,27,330.2877121367656,23,426.8745360059391,-2.6421730984104146,-0.9652511842480689,0.8237975604592809,1.2236709941211619,271,260,282,311,29,40,51,184.2825002898169,37,171.09035420327382,-0.4057683086067111,0.15424260689527944,0.630393464058986,0.9056877148986052,21552,21626,Taliaferro and Nearby Counties,McDuffie,13,189,Georgia,GA
13221,13CS062,141,135,148,151,3,10,16,257.5534942922059,2,53.52602703064365,0.36685613536796624,2.0714056572358808,3.755497617843044,0.18826211479383703,176,168,184,195,11,19,27,126.50903643214798,20,132.4503311258278,-0.5947702612552851,-0.05456022117237261,0.4547461975113234,0.9948830923449776,14946,15100,Taliaferro and Nearby Counties,Ogelthorpe,13,221,Georgia,GA
13265,13CS062,21,21,21,23,2,2,2,521.54363626044,5,1285.3470437017995,-8.037081891189484,-7.63795014182133,-7.221550875138853,1.6508162198855516,26,26,26,37,11,11,11,723.5387056187024,2,128.36970474967907,5.818357466294794,5.946127890256774,6.074567811318598,0.1629628864682647,1556,1558,Taliaferro and Nearby Counties,Taliaferro,13,265,Georgia,GA
13301,13CS062,66,66,67,89,22,23,23,1746.5752721288984,6,460.5641911341394,12.406623666016156,12.854518102931909,13.268396727157311,0.25259425500701116,82,81,82,86,4,4,5,84.40702893723585,13,248.32855778414518,-1.76417488441276,-1.644968864334321,-1.5162549108916357,2.3990958885944624,5211,5235,Taliaferro and Nearby Counties,Warren,13,301,Georgia,GA
13317,13CS062,134,130,138,135,-3,1,5,40.59529873722274,11,459.146405092351,-5.894128222728987,-4.255305026173355,-2.4234075122321066,5.576504428124683,163,158,168,179,11,16,21,170.79825379514847,21,220.6114087614245,-1.0267695008322035,-0.5112597708561919,0.02304705428292212,1.2168068294386893,9583,9519,Taliaferro and Nearby Counties,Wilkes,13,317,Georgia,GA
13277,13CS063,391,373,408,450,42,59,77,575.0658358351095,69,669.3830034924331,-2.4501713332395467,-0.9682913943617079,0.6389989002971106,1.1447002978896923,484,462,505,546,41,62,84,151.09059498479536,79,191.5987582460225,-0.8979353195437966,-0.40734514935501853,0.09071968402651316,1.2480711352059461,41232,41232,Tift+Worth,Tift,13,277,Georgia,GA
13321,13CS063,214,205,222,240,18,26,35,513.4792036012442,40,775.7951900698215,-4.291806287737656,-2.6457130748493327,-0.9217737831267357,1.4558696215591977,263,252,274,315,41,52,63,252.98475627230374,41,199.24190883467782,0.03508178866682841,0.5435070282590683,1.044041288483219,0.7727217441883383,20624,20578,Tift+Worth,Worth,13,321,Georgia,GA
13285,13CS064,600,570,630,789,159,189,219,1087.4931608987588,100,575.3739930955121,3.3383521581433326,5.1111525479563635,6.810284218079727,0.5262983070510742,737,701,773,942,169,205,241,293.5892933690775,161,231.08278792054196,0.1179400118199982,0.6238460526383967,1.1686748950303338,0.7832661940922546,69520,69672,Troup,Troup,13,285,Georgia,GA
13297,13CS065,783,741,825,904,79,121,163,497.87220831816677,91,374.9484960857025,-0.475837964992687,1.2178771923327523,3.0455090327903003,0.7469204819899117,983,931,1034,1244,210,261,313,262.64487552472946,213,214.16290457182504,-0.02270024078983544,0.4992390902452911,1.0147999892882302,0.8122990036528552,97080,99457,Walton,Walton,13,297,Georgia,GA
13009,13CS066,390,371,409,498,89,108,127,983.255244423395,45,409.5190426354826,4.080111471648129,5.754651357214921,7.390210185635406,0.4126736572470616,480,457,502,620,118,140,163,320.6996803567456,88,201.00502512562815,0.6705839104731574,1.1982378265440428,1.7467050227699426,0.6223377378995317,43954,43780,Washington and Nearby Counties,Baldwin,13,9,Georgia,GA
13125,13CS066,32,32,33,38,5,6,6,760.9762949491071,10,1380.2622498274673,-6.58220574315113,-6.1952172650228094,-5.794250211867214,1.5353263413901153,40,40,40,51,11,11,11,373.49305707214717,4,137.26835964310226,2.2338843637750463,2.361354581379288,2.4918523435933517,0.33659868607646604,2898,2914,Washington and Nearby Counties,Glascock,13,125,Georgia,GA
13163,13CS066,192,186,199,257,58,65,71,1658.2684666816554,33,846.2623413258111,6.315603356415237,8.088125844191675,9.839566057541521,0.5025571106468398,234,226,242,278,36,44,52,281.27154445033466,47,302.367472979928,-0.7251233877196657,-0.20614742411612197,0.2919610748176931,1.0509639505568846,15598,15544,Washington and Nearby Counties,Jefferson,13,163,Georgia,GA
13167,13CS066,87,86,88,124,36,37,38,1594.4831244655875,24,1038.0622837370242,5.165567717623821,5.572438979350334,5.991806460067132,0.6338399238047158,106,105,107,142,35,36,37,390.81362546573826,25,272.89597205545243,1.0484859215103992,1.1840445198819878,1.3067544320247755,0.6793028549658103,9248,9161,Washington and Nearby Counties,Johnson,13,167,Georgia,GA
13169,13CS066,219,207,232,263,31,44,56,612.9428102879323,18,253.44081101059524,1.8382636532676035,3.628487052295995,5.350949275197987,0.40419708604006227,272,257,286,387,101,115,130,406.300231774508,60,211.31224906670425,1.4751610334631844,1.951808971156224,2.447080392665696,0.5156194547099118,28409,28394,Washington and Nearby Counties,Jones,13,169,Georgia,GA
13303,13CS066,198,189,207,271,64,73,82,1460.9545985415596,53,1061.3797937318514,2.178973324885338,3.978665333932781,5.7795615270980125,0.7166736488796519,242,232,252,312,60,70,80,354.65949611472234,58,292.84055336766636,0.09163449099365018,0.6243316118930258,1.1416548784476883,0.8141052458756266,19974,19806,Washington and Nearby Counties,Washington,13,303,Georgia,GA
13319,13CS066,102,101,103,130,27,28,29,1252.843307168372,13,587.1725383920506,6.26300511690754,6.659769953096081,7.031942967802475,0.4523634994403487,125,124,126,193,67,68,69,767.287653888359,26,294.3507302162346,4.609383604055388,4.730881082976,4.851021183262476,0.3780469944273488,8856,8833,Washington and Nearby Counties,Wilkinson,13,319,Georgia,GA
13175,13CS067,502,481,523,642,119,140,161,1139.7861772098909,103,837.0411003433494,1.1759413822026732,3.0195959911245938,4.766587199943472,0.7291852723968418,617,592,643,811,168,194,219,390.68598672238454,116,234.15421881308032,1.0429633251081438,1.5720881377947578,2.107161677480204,0.5962605075415379,49221,49540,Wheeler and Nearby Counties,Laurens,13,175,Georgia,GA
13209,13CS067,76,75,77,101,24,25,26,1138.3143464772081,14,646.0544531610522,4.533151538928406,4.938175363615422,5.336857265399763,0.5454416839078808,94,93,95,151,56,57,58,662.696505529759,30,347.14186530895626,3.0274763381257497,3.157243692805893,3.291535686139554,0.5148426386210737,8668,8642,Wheeler and Nearby Counties,Montgomery,13,209,Georgia,GA
13271,13CS067,116,110,121,192,71,76,82,2349.6640304401585,33,1019.6987253765933,11.509672277051685,13.277242875773034,15.06096979504997,0.4283433374958601,139,132,145,185,40,46,53,371.2230412399664,32,257.62821028902664,0.6152957671016779,1.1344017711884353,1.6486660506116961,0.6792668696525954,12945,12421,Wheeler and Nearby Counties,Telfair,13,271,Georgia,GA
13283,13CS067,63,62,63,93,30,30,31,1873.738688714382,13,806.201550387597,10.302715607031244,10.681540702346183,11.087617522281361,0.4164792996308944,76,75,76,132,56,56,57,891.6917486438497,33,522.3171889838557,3.5672866087223616,3.6919377219685816,3.8281468052376733,0.5755437372612555,6450,6318,Wheeler and Nearby Counties,Treutlen,13,283,Georgia,GA
13309,13CS067,53,53,54,68,14,15,15,776.6743859283055,12,640.1707121899174,0.9675275794355152,1.3294810036939653,1.7370682956266434,0.7712696222458514,66,65,67,78,11,12,13,164.5109063592334,12,160.75016744809108,-0.09666162314530105,0.037923572619388654,0.1503207582837898,0.9035641657957172,7498,7465,Wheeler and Nearby Counties,Wheeler,13,309,Georgia,GA
13313,13CS068,733,689,778,916,138,183,227,709.2501064019293,138,536.1097082475428,0.09892831433642653,1.740199447155145,3.356165874694234,0.7517647272943795,905,852,958,1139,181,234,287,227.86257785450604,199,193.52329086842363,-0.20232004343379242,0.35768294385999666,0.8670352883170128,0.8456890026230387,102964,102830,Whitfield,Whitfield,13,313,Georgia,GA
15001,15CS001,1505,1418,1591,1531,-60,26,113,51.92904271302502,47,93.44958196224239,-2.092377875715809,-0.3058620864463229,1.4161270957323318,1.7332011624369092,1865,1760,1969,2053,84,188,293,92.98185967325749,107,52.81577167791264,-0.12939402760541477,0.40962662768950625,0.9101137751526213,0.5650228289193181,201178,202591,Hawaii (county),Hawaii (county),15,1,Hawaii,HI
15003,15CS002,6754,6321,7188,6909,-279,155,588,61.522607029214804,275,109.327961023588,-2.257944784520651,-0.5143799045919791,1.248530256268957,1.7656277904211224,8295,7778,8813,8768,-45,473,990,47.13673976652947,470,46.873955932497516,-0.51424584823128106,0.008317211862466228,0.5550220191156489,0.9923255136766055,1006147,1002689,Honolulu,Honolulu,15,3,Hawaii,HI
15005,15CS003,1,1,1,1,0,0,0,1490.8794540230742,1,4819.2771084337355,-34.920139650570995,-33.23683348635356,-31.578065920367138,0.7637333655248306,1,1,1,3,2,2,2,2629.703316503797,3,3658.5365853658536,-10.757018914780783,-10.278885170519745,-9.752624461329145,0.9504629123300607,83,82,Kalawao+Maui,Kalawao,15,5,Hawaii,HI
15009,15CS003,990,919,1061,1026,-35,36,107,87.36278977721064,16,38.77589351170244,-1.1969803433452366,0.48027457874026264,2.2205942947113724,0.43186879068317646,1222,1137,1307,1389,82,167,252,101.51076435444051,84,51.13096832314772,-0.01066925461118863,0.4971874826050931,1.0008581134709502,0.5006975667474998,165051,164284,Kalawao+Maui,Maui,15,9,Hawaii,HI
15007,15CS004,505,474,537,487,-50,-18,13,-101.05139494395047,3,16.420361247947454,-2.8146505255346317,-1.144267891230868,0.6006013782433611,-0.17180074233351686,626,588,664,591,-73,-35,3,-47.70622496475362,18,24.51748232698149,-1.2433834153325736,-0.730373768862283,-0.20270421274975461,-0.529030875197794,73080,73417,Kauai,Kauai,15,7,Hawaii,HI
16001,16CS001,2881,2667,3095,3261,166,380,594,305.76124545830027,315,253.47624565469295,-1.1169657111700106,0.5272716924099812,2.407186717247293,0.8268245725817144,3647,3383,3910,4154,244,507,771,99.50442039826243,451,88.449235826059,-0.4272570654973317,0.10084102252409514,0.6159669500560048,0.8871490286007859,497088,509897,Ada,Ada,16,1,Idaho,ID
16005,16CS002,638,601,676,704,28,66,103,301.25126743799433,59,270.0723244529891,-1.4178715365103072,0.328157553973549,1.8794298198502868,0.8830834631514777,794,749,840,937,97,143,188,162.11480006492317,126,143.0111798422337,-0.3484131680457647,0.1817923782742806,0.7108936395616601,0.8760266265710418,87384,88105,Bannock+Bear Lake+Caribou+Franklin,Bannock,16,5,Idaho,ID
16007,16CS002,53,52,54,69,15,16,17,1006.97138067659,6,377.774279867779,5.876671836980466,6.293014330582874,6.686510975814625,0.3530819325082967,67,66,68,79,11,12,13,185.3702201009114,11,168.7375364319681,0.030696048413085823,0.16172198973997132,0.28823133474575324,0.8407032020174884,6353,6519,Bannock+Bear Lake+Caribou+Franklin,Bear Lake,16,7,Idaho,ID
16029,16CS002,58,57,59,74,15,16,17,901.7209972079881,7,397.444996451384,4.6565097270933355,5.038919498744628,5.446412829183416,0.4146535959406701,72,71,73,78,5,6,7,83.96524350801243,15,211.35691137100184,-1.3988596376489972,-1.2712630304296997,-1.1472432410146602,2.1554779801231545,7045,7097,Bannock+Bear Lake+Caribou+Franklin,Caribou,16,29,Idaho,ID
16041,16CS002,97,95,98,91,-7,-6,-4,-162.85097639779997,5,140.29180695847361,-3.4344100031791953,-3.00565466137583,-2.6021910227722014,-1.0407974276047638,122,120,124,134,10,12,14,79.77400178188489,16,109.52902519167579,-0.42162726574247855,-0.29813041297659437,-0.17060652253205288,1.264483654574076,14256,14608,Bannock+Bear Lake+Caribou+Franklin,Franklin,16,41,Idaho,ID
16009,16CS003,112,111,113,102,-11,-10,-9,-403.5009949890016,4,167.13673874438527,-6.105258601027772,-5.696395542911342,-5.312233011738774,-0.46206516806455106,141,139,142,158,16,17,19,174.7188833973574,23,232.81708674967103,-0.7093141925095132,-0.5805727150325812,-0.45864312342732605,1.2595507840364895,9573,9879,Benewah+Latah+Nez Perce,Benewah,16,9,Idaho,ID
16057,16CS003,182,165,199,213,14,31,48,315.5588240497038,2,20.103028018595303,1.2360890824718063,2.9551305681534075,4.638641213381746,0.06173952626452721,227,206,247,303,56,76,97,189.87175011130074,29,72.11956927208972,0.6604024888798045,1.182683735780856,1.7045015141919666,0.37492244872690794,39795,40211,Benewah+Latah+Nez Perce,Latah,16,57,Idaho,ID
16069,16CS003,443,425,461,463,2,20,38,188.85615397410663,37,353.14610226920234,-3.2890867799536094,-1.6308163157685833,-0.03136306391343328,1.7799645027832733,543,522,565,609,44,66,87,154.48213103533905,58,136.7892266691823,-0.35838518646596457,0.17912820246736727,0.7171337067886526,0.8721546356090505,41909,42401,Benewah+Latah+Nez Perce,Nez Perce,16,69,Idaho,ID
16011,16CS004,350,329,371,406,35,56,77,466.30470489761626,43,358.60976169130373,-0.6713708557275834,1.112227342709893,2.751719972081858,0.7555334292864815,438,413,463,504,41,66,91,135.40404584704908,75,153.82091144017392,-0.7107562663973696,-0.1737167759520476,0.32017639486573846,1.1190638473623513,47963,48758,Bingham+Oneida+Power,Bingham,16,11,Idaho,ID
16071,16CS004,38,38,38,39,1,1,1,85.1441440606338,4,351.493848857645,-3.0572134240030193,-2.6571606720455456,-2.2819479253159662,2.031549600211653,47,47,48,63,15,16,16,342.0901208620898,6,130.3497718878992,1.9894227080938087,2.121883372174615,2.241198001780081,0.358285783176297,4552,4603,Bingham+Oneida+Power,Oneida,16,71,Idaho,ID
16077,16CS004,55,55,56,63,7,8,8,388.2528822677186,3,152.84677111196027,1.9688352229006227,2.3569797642058803,2.748264113065711,0.3480103429306187,69,68,70,88,18,19,20,239.92136825994118,12,151.13350125944584,0.7615719118960362,0.8849907478561824,1.0128976505764675,0.5985110051737846,7851,7940,Bingham+Oneida+Power,Power,16,77,Idaho,ID
16015,16CS005,51,50,52,57,5,6,7,302.1560455557735,3,155.21924718665113,1.0675324594816942,1.469221993019726,1.8472807557228934,0.43860155884079116,66,65,67,93,26,27,28,341.3902405301113,3,37.36455349358575,2.9010063871553564,3.0378997081086556,3.1694100214677547,0.10559579423481305,7731,8029,Boise+Gem+Payette+Washington,Boise,16,15,Idaho,ID
16045,16CS005,200,192,209,227,18,27,35,555.557351250958,17,354.9801628732512,0.1947008579143186,1.9557447095541365,3.4867705876878965,0.6158161536779316,251,241,261,304,43,53,63,269.63282144084167,37,187.68387947651416,0.30889995399426645,0.8106123736417844,1.3317203848456438,0.6832188507290421,19156,19714,Boise+Gem+Payette+Washington,Gem,16,45,Idaho,ID
16075,16CS005,219,208,230,220,-10,1,12,13.34035630786627,25,393.0199654142431,-5.368196331026663,-3.8294624562572537,-2.0734430896810885,13.523893542295983,276,262,289,338,49,62,76,236.93779532668282,47,179.12267998018217,0.039990139108188244,0.5852604512796801,1.0515098745189493,0.74402278865608,25444,26239,Boise+Gem+Payette+Washington,Payette,16,75,Idaho,ID
16087,16CS005,107,106,108,138,30,31,32,1166.9950887854634,13,494.296577946768,6.312409901578405,6.733350456131217,7.1442413716430035,0.4101985347537739,136,134,137,163,26,27,29,250.09476125121083,28,258.1596902083717,-0.20746963442783903,-0.07576023231050308,0.04578056911007581,0.9955457220307815,10520,10846,Boise+Gem+Payette+Washington,Washington,16,87,Idaho,ID
16017,16CS006,417,396,437,414,-23,-3,18,-22.676685469993757,18,151.98530808688494,-3.4181198722396884,-1.7829351331990801,-0.05486178777570154,-10.678331822365497,528,502,553,618,65,90,116,183.66553789800156,120,243.97682220189083,-1.1165070877735186,-0.6089606947052646,-0.11785105242950714,1.3138317661734784,47373,49185,Bonner+Boundary+Shoshone,Bonner,16,17,Idaho,ID
16021,16CS006,99,98,100,113,13,14,15,456.9689431723365,1,32.80570819322562,3.877290292588903,4.244986338567133,4.656172989532395,0.06698122922809213,125,123,126,179,53,54,56,434.76607358775175,41,328.10499359795136,0.9380799994908238,1.0634818839731612,1.1937054030325396,0.7410303442953311,12193,12496,Bonner+Boundary+Shoshone,Boundary,16,21,Idaho,ID
16079,16CS006,167,161,172,158,-14,-9,-3,-259.3117424226673,24,728.0448961019263,-11.596064582937482,-9.89379706349012,-8.288881630603523,-3.1795611075730963,208,201,215,246,31,38,45,282.49322307136515,42,309.96309963099634,-0.7907501008675588,-0.27782843656198697,0.23651677856813735,1.069305461992096,13186,13550,Bonner+Boundary+Shoshone,Shoshone,16,79,Idaho,ID
16019,16CS007,835,781,888,942,54,107,161,345.9484262183505,111,357.5138295045535,-1.8082398150986956,-0.06797815339308963,1.596263093925159,1.0238983171079339,1054,988,1120,1104,-16,50,116,39.19944314319258,115,90.23287929194652,-1.0329182843215732,-0.4954838960647295,0.028448614212321505,2.25672033323178,124191,127448,Bonneville,Bonneville,16,19,Idaho,ID
16027,16CS008,1425,1324,1526,1649,123,224,325,383.8138232946011,209,358.12046727010255,-1.4292024671131744,0.2202383155338757,2.1582161715234958,0.9289107417853832,1818,1693,1943,2131,188,313,438,129.48962393610307,334,138.24617753458224,-0.5760248557764651,-0.09554476517446224,0.42225780023924175,1.064221831299278,233441,241598,Canyon,Canyon,16,27,Idaho,ID
16003,16CS009,38,38,39,41,2,3,3,235.22270027512326,3,271.37042062415196,-0.7716306954223056,-0.35009339768658637,0.047721144856512944,0.8332437708440102,49,48,50,55,5,6,7,131.88372005482552,4,87.03220191470844,0.31472851340817865,0.4461464961256508,0.568659737230282,0.5664618522196115,4422,4596,Central Idaho,Adams,16,3,Idaho,ID
16035,16CS009,92,91,92,104,12,12,13,569.4086791940541,4,182.5025664423406,3.4705418057913824,3.8607907929015415,4.290735667856893,0.296735580875512,113,112,115,132,17,19,20,209.13787171427234,16,180.30200585981518,0.16366878247466726,0.28853693581881296,0.41366784299019665,0.818042134590163,8767,8874,Central Idaho,Clearwater,16,35,Idaho,ID
16037,16CS009,45,43,47,40,-7,-5,-3,-438.918240615013,2,186.74136321195147,-8.183843889290017,-6.253023453482641,-4.626665917812792,-0.5404215956480465,56,53,58,69,11,13,16,300.69418520799314,4,90.82652134423252,1.5741894025477772,2.0968963755123293,2.6161354758704225,0.28084815182496287,4284,4404,Central Idaho,Custer,16,37,Idaho,ID
16049,16CS009,168,161,176,181,5,13,20,302.0801962746416,16,385.07821901323706,-2.6442657487883112,-0.850214497927585,0.872969349913255,1.180687016452871,209,200,218,257,39,48,57,283.8986895209183,30,176.78255745433117,0.5533538553785735,1.0650259006543117,1.5586834686433528,0.610033742122557,16620,16970,Central Idaho,Idaho (county),16,49,Idaho,ID
16059,16CS009,90,89,91,109,18,19,20,946.3340102900708,11,550.8262393590386,3.5588269465105866,3.950524044106718,4.350736887545106,0.552811316824588,112,111,113,148,35,36,37,439.6059756758029,13,159.8819333415324,2.6722916501712026,2.793681243182428,2.921796965512413,0.35379577529954964,7988,8131,Central Idaho,Lemhi,16,59,Idaho,ID
16061,16CS009,37,36,39,47,8,10,11,1074.6329382965089,8,889.8776418242492,0.007525091941319886,1.8283541798137746,3.454900606557553,0.750402160547552,47,45,49,67,18,20,22,550.7762386035084,12,325.3796095444685,1.743140243929684,2.2507316219897113,2.7601121376725026,0.5630464802531746,3596,3688,Central Idaho,Lewis,16,61,Idaho,ID
16085,16CS009,77,76,79,83,4,6,7,186.59653139182578,4,135.3408898663509,0.09589918087418536,0.5103585587947035,0.9209332222047036,0.6139809147155917,98,97,100,101,1,3,4,23.290090087226936,1,8.208832703989492,0.022116463282795602,0.15033021577360967,0.27370460033608257,0.26060677561578555,11822,12182,Central Idaho,Valley,16,85,Idaho,ID
16039,16CS010,194,181,206,209,3,15,28,214.04723583647146,11,154.407636159461,-1.08095148524439,0.5798914733827776,2.1933347614566645,0.6769761901423985,241,226,256,239,-17,-2,13,-7.652995896242891,43,149.28482155256214,-2.0862156757542936,-1.569419945597503,-1.0689941931372868,-35.7033452498834,28496,28804,Elmore+Gooding+Owyhee,Elmore,16,39,Idaho,ID
16047,16CS010,120,119,122,169,47,49,50,1252.7980750841923,20,512.6561999359179,7.01418046641654,7.389800493819635,7.796743330570276,0.40100423567554955,149,147,151,170,19,21,23,134.07487327304437,26,165.04792737891194,-0.43127566028445796,-0.3077400204105697,-0.17793077511013267,1.175363577277867,15605,15753,Elmore+Gooding+Owyhee,Gooding,16,47,Idaho,ID
16073,16CS010,89,88,90,118,28,29,30,968.5663741016276,17,566.9974151588426,3.592721041036257,4.007305143753887,4.437460675274064,0.5659113389265167,112,110,113,140,27,28,30,228.6975396001577,19,154.67274503419083,0.6097616370026337,0.7377529738244221,0.8618017983730817,0.6530734410573265,11993,12284,Elmore+Gooding+Owyhee,Owyhee,16,73,Idaho,ID
16023,16CS011,25,25,25,31,6,6,6,933.6248786558185,1,154.38054805094558,7.413930310989415,7.779459100642141,8.182657256010687,0.14189317834400264,31,31,32,45,13,14,14,521.0869400703622,4,151.3431706394249,3.5707391675298283,3.702476445302396,3.820727075803415,0.27077655242281123,2591,2643,Jefferson and Nearby Counties,Butte,16,23,Idaho,ID
16033,16CS011,5,5,5,6,1,1,1,386.5805084340226,6,3003.754693366708,-26.583137637663057,-26.191450593060807,-25.759547615073128,3.3856327722001067,6,6,6,10,4,4,4,456.11652126256627,4,505.0505050505051,-0.6253970647197358,-0.48384339165656387,-0.3619776501094356,0.8672194174477335,799,792,Jefferson and Nearby Counties,Clark,16,33,Idaho,ID
16043,16CS011,95,94,96,111,15,16,17,475.47283799801966,13,388.63976083707024,0.43495186600472946,0.8797448120590192,1.256206493773179,0.7690229769001545,119,117,120,164,44,45,47,334.1573990178432,5,36.85956505713233,2.8422792325022717,2.9785205127635663,3.097558950139039,0.1079250411571508,13380,13565,Jefferson and Nearby Counties,Fremont,16,43,Idaho,ID
16051,16CS011,163,150,176,176,-0,13,26,166.2478261604768,16,206.39169273436744,-1.978261725417874,-0.42061888249350454,1.3246271335189814,1.1520781207424298,207,190,223,251,28,44,61,138.0394758284818,37,115.49867332604964,-0.2667793079949475,0.20248639505249788,0.7705434343602587,0.8182049073716896,31009,32035,Jefferson and Nearby Counties,Jefferson,16,51,Idaho,ID
16065,16CS011,174,152,196,164,-32,-10,12,-78.2667925429309,15,117.34105176696067,-3.6241558291019498,-1.9555112030527926,-0.2533422313350917,-1.6657339005194507,225,197,253,234,-19,9,37,16.683871132604025,20,37.2203818811181,-0.7228575557755308,-0.20925187487774707,0.3020658827263004,2.007042448146201,51133,53734,Jefferson and Nearby Counties,Madison,16,65,Idaho,ID
16081,16CS011,45,44,46,37,-9,-8,-7,-260.28647515241875,7,236.4864864864865,-5.36802154231618,-4.969076820963505,-4.563337856774589,-1.0440780418878237,57,56,59,70,11,13,14,104.66108771690158,7,57.4288292722947,0.33482387670026337,0.4709131996784082,0.5985383925576839,0.5088266899409298,11840,12189,Jefferson and Nearby Counties,Teton,16,81,Idaho,ID
16055,16CS012,1381,1307,1455,1387,-68,6,80,13.989150656883368,115,266.86623619982475,-4.271898625620116,-2.544717677146841,-0.9117566911887768,16.36239787181791,1757,1665,1849,2018,169,261,353,145.94215063168946,310,173.4294841312022,-0.7720352479119789,-0.26716771572755355,0.2595815769391744,1.1838060706777471,172371,178747,Kootenai,Kootenai,16,55,Idaho,ID
16013,16CS013,112,110,115,121,6,9,11,146.89997899226475,15,248.12869608370207,-1.405503702024423,-1.0132070681187115,-0.6221827238279449,1.5181462533838272,142,139,145,156,11,14,17,55.532686419408975,11,44.530807222087276,-0.008887853787574052,0.11650070946109199,0.22640907118749162,0.7474001922467146,24181,24702,Lincoln and Nearby Counties,Blaine,16,13,Idaho,ID
16025,16CS013,10,10,11,12,1,2,2,555.7358535948464,0,0,3.884992263849149,5.58254335548951,7.3359524205517275,0,13,13,14,7,-7,-6,-6,-554.7703316268659,7,618.3745583038869,-12.243658742746453,-11.751727418975445,-11.200712523747608,-1.3257575370855996,1094,1132,Lincoln and Nearby Counties,Camas,16,25,Idaho,ID
16031,16CS013,185,175,196,192,-4,7,17,107.36820728643839,18,292.0537054313877,-3.5114604733707537,-1.8146874227924725,-0.2045746768457018,2.36301998628141,232,219,245,234,-11,2,15,6.196676009129715,25,99.6174689193497,-1.460427692021235,-0.9269011610572508,-0.42430254016905816,9.784284657997029,24653,25096,Lincoln and Nearby Counties,Cassia,16,31,Idaho,ID
16053,16CS013,154,143,164,158,-6,4,15,73.93990495946355,17,279.76631284456516,-3.788219925907785,-2.0813201115919475,-0.2137886170252852,3.0948714689962085,193,180,205,242,37,49,62,200.12490685380547,39,158.54947556711926,-0.10868939327360075,0.414192909287602,0.9357597165452278,0.7764790620926956,24306,24598,Lincoln and Nearby Counties,Jerome,16,53,Idaho,ID
16063,16CS013,33,33,34,39,5,6,6,431.6134618576277,4,309.059300753332,0.8200017034092275,1.2443793271324055,1.6472160740035384,0.6073344228291244,42,41,43,38,-5,-4,-3,-74.75462674806954,2,38.02281368821293,-1.2502879388578816,-1.123225650215386,-1.0042354052853635,-0.6821065190299438,5177,5260,Lincoln and Nearby Counties,Lincoln,16,63,Idaho,ID
16067,16CS013,175,166,185,178,-7,3,12,49.55151067025539,23,426.08373471656165,-5.493259567617287,-3.7213858613946376,-2.075739846655173,6.258860120655911,219,207,230,228,-2,9,21,42.6839599490308,29,132.33549329195947,-1.376492061976754,-0.882262888337818,-0.4421896988331091,2.8009140297078097,21592,21914,Lincoln and Nearby Counties,Minidoka,16,67,Idaho,ID
16083,16CS014,693,655,732,838,106,145,183,642.5014975606654,98,435.4394383719897,0.29604720058038675,2.0357991004650198,3.8531817396821983,0.6730705111511187,868,820,915,986,71,118,166,128.4987063888981,130,141.37042313255108,-0.6495797717014385,-0.12741129207239288,0.35769675696809,1.0909375733754376,90024,91957,Twin Falls,Twin Falls,16,83,Idaho,ID
17001,17CS001,681,653,710,745,35,64,92,388.74274765255046,71,433.9123924768147,-2.1498490495590508,-0.490301853714726,1.3247325663635914,1.0989180403441485,828,794,861,936,75,108,142,166.59666742930062,103,158.36895353485656,-0.44566014358960937,0.06939073020201719,0.5903092860077946,0.9419197593185712,65451,65038,Adams,Adams,17,1,Illinois,IL
17005,17CS002,151,143,158,165,7,14,22,346.9349944725207,11,264.64573559485143,-0.7469921974842196,0.8732096038646683,2.562951224864075,0.7133429414826626,183,174,192,219,27,36,45,216.38342335663606,28,168.61375406479587,-0.058331806476396394,0.4818730274099322,0.9952725817516839,0.7581371548035172,16626,16606,Bond+Effingham+Fayette,Bond,17,5,Illinois,IL
17049,17CS002,308,294,323,379,56,71,85,818.3372956957841,44,509.8345934358796,1.3918666765560137,3.0630696614332735,4.7489592616588405,0.6143144670236765,375,357,392,430,38,55,73,160.4677251863712,53,153.81489973009838,-0.4334938554603638,0.06365216355325162,0.5525488567984687,0.9415131319849716,34521,34457,Bond+Effingham+Fayette,Effingham,17,49,Illinois,IL
17051,17CS002,192,182,201,226,25,34,44,639.9924601726465,34,634.5355293239397,-1.582454968390047,0.028354364932415714,1.711339639993632,0.963380327102095,233,222,244,244,-0,11,22,51.108657066800504,30,140.21967749474175,-1.3951768139728822,-0.9061857831730311,-0.351241622983365,2.513679195118272,21433,21395,Bond+Effingham+Fayette,Fayette,17,51,Illinois,IL
17007,17CS003,359,336,382,401,19,42,65,314.7015064309815,57,427.75130389103595,-2.812371930101793,-1.1700328851679849,0.6949736230106814,1.327571231990051,442,415,470,500,30,58,85,108.4105605020117,37,69.57110354812627,-0.13301187064614053,0.3935157564170732,0.8836009183301872,0.6307966332928091,53302,53183,Boone,Boone,17,7,Illinois,IL
17009,17CS004,47,46,48,60,12,13,14,818.5831556718595,2,127.04462442432904,6.493261378498748,6.9259833965072,7.31673458403213,0.14402430213824774,59,58,60,67,7,8,9,127.94810082988727,8,125.17602879048661,-0.09731154533603327,0.023759246126274225,0.1542209535271669,0.8717290835819724,6297,6391,Brown and Nearby Counties,Brown,17,9,Illinois,IL
17013,17CS004,41,41,42,59,17,18,18,1598.6732252365152,5,448.93378226711565,11.093579723752116,11.499415936857222,11.88101583976741,0.26588357860740575,50,49,50,68,18,18,19,419.1284602263267,2,45.714285714285715,3.6094025393959956,3.732184505173067,3.8618495187765234,0.10342935470152069,4455,4375,Brown and Nearby Counties,Calhoun,17,13,Illinois,IL
17017,17CS004,125,124,127,140,13,15,16,459.9542335368476,27,842.5651427679825,-4.240620743780353,-3.827361070761626,-3.4324427768741295,1.7154583892579114,153,152,155,149,-6,-4,-3,-34.8299436604893,16,125,-1.7170658884926537,-1.597235428845024,-1.4755716681975446,-4.626640535307261,12818,12800,Brown and Nearby Counties,Cass,17,17,Illinois,IL
17149,17CS004,171,164,177,217,40,46,53,1255.1419868507883,39,1056.2665041641276,0.3069990114572183,2.0291512239363465,3.7253954959671347,0.8237757739832935,208,200,215,236,21,28,36,193.5478646375374,32,218.87824897400822,-0.7371122081861077,-0.26868044076180975,0.2734686845884814,1.0922732728283309,14769,14620,Brown and Nearby Counties,Pike,17,149,Illinois,IL
17169,17CS004,78,78,79,80,1,2,2,103.84702012167415,4,233.0662782228696,-1.699207896486493,-1.2841663003854074,-0.8870364713475027,1.437672675601564,96,95,96,108,12,12,13,181.01338697684315,3,43.80841121495327,1.2489575810058273,1.3742011479612903,1.4902234689599405,0.22395084504402413,6865,6848,Brown and Nearby Counties,Schuyler,17,169,Illinois,IL
17171,17CS004,50,50,51,59,8,9,9,703.6263834651085,4,324.9390739236393,3.39235109432052,3.7750462533700104,4.1753790978119305,0.4140083543668475,61,60,61,69,8,8,9,169.2363436964141,6,123.73685295937307,0.32732148550892837,0.45251147186767376,0.5893339267602988,0.651729723403241,4924,4849,Brown and Nearby Counties,Scott,17,171,Illinois,IL
17011,17CS005,345,330,359,417,58,72,87,875.9159923732009,57,690.4697010993004,0.055528287588090704,1.8409672614497925,3.5102932879914195,0.7775301431835263,420,403,437,447,10,27,44,80.94793909297726,51,154.9351398973175,-1.2073149081145589,-0.7280485190094784,-0.24484661479909695,1.844775983056555,33021,32917,Bureau+Marshall+Putnam+Stark,Bureau,17,11,Illinois,IL
17123,17CS005,148,143,153,148,-5,0,5,4.917247831924344,6,205.92020592020592,-3.682716971851639,-2.0130511786614362,-0.5138647636741077,5.2480751628697275,180,174,186,184,-2,4,10,31.1756645587993,17,145.71012256792662,-1.6093021156860217,-1.13237456010954,-0.640282420485083,3.6659541327853225,11655,11667,Bureau+Marshall+Putnam+Stark,Marshall,17,123,Illinois,IL
17155,17CS005,49,48,50,42,-8,-7,-6,-500.8624410735305,6,425.2303330970942,-9.680901994399179,-9.263517823871425,-8.862885256957483,-0.9889290964096425,59,59,60,71,11,12,12,207.78890817707156,8,143.47202295552367,0.5186812069195529,0.6464397541239809,0.7676704956713567,0.6356112558107144,5644,5576,Bureau+Marshall+Putnam+Stark,Putnam,17,155,Illinois,IL
17175,17CS005,63,63,64,77,13,14,14,1018.4345645092404,12,894.0212330042838,0.8532504253641887,1.252414869521312,1.6671846456385113,0.817999370368265,77,76,77,97,20,20,21,384.72385231339155,4,75.35795026375283,2.968988985679627,3.0911430118152774,3.220760684049204,0.18673140698628807,5369,5308,Bureau+Marshall+Putnam+Stark,Stark,17,175,Illinois,IL
17015,17CS006,171,164,178,216,38,45,52,1164.1930170674786,26,672.095127310327,3.177238119189252,4.907448149081045,6.629064332793487,0.5647654946204044,210,202,218,214,-4,4,12,24.886498470629423,13,82.83948257184731,-1.0883669679489458,-0.5858354117943229,-0.07396042383837652,2.6501200212369067,15474,15693,Carroll+Jo Daviess+Stephenson,Carroll,17,15,Illinois,IL
17085,17CS006,207,198,216,247,31,40,49,731.0683886700422,23,419.9570913406674,1.3996620224778082,3.0533308550808282,4.8789128190695905,0.5604454013889985,253,241,264,259,-5,6,18,28.569565892953978,18,81.99334942832415,-1.0560318975897218,-0.5261855267949079,-0.024602101618529222,2.475289460186042,21907,21953,Carroll+Jo Daviess+Stephenson,Jo Daviess,17,85,Illinois,IL
17177,17CS006,462,443,481,573,92,111,130,998.702231772228,64,576.5895628279916,2.557657969312041,4.274554205092051,5.914421363776352,0.5721772501817065,560,537,582,653,71,93,116,212.04305136126104,93,210.95610751956445,-0.5303774493271671,-0.008504942571964576,0.5513891622985182,0.9843438606764738,44399,44085,Carroll+Jo Daviess+Stephenson,Stephenson,17,177,Illinois,IL
17019,17CS007,1126,1037,1214,1277,63,151,240,293.5250723764557,66,128.0788655317456,-0.15494728196173949,1.6877990696723306,3.3342760736885615,0.43348138998859065,1399,1293,1505,1642,137,243,349,118.07228760999465,128,62.173951057442906,0.01285523282277298,0.5531544892684627,1.1579018819955111,0.5244179197408537,206123,205874,Champaign,Champaign,17,19,Illinois,IL
17021,17CS008,371,357,386,418,32,47,61,553.6678853750701,61,724.8960190136661,-3.471563127384915,-1.6743818890851474,0.08780021829925991,1.281750844978704,453,436,471,501,30,48,65,141.70351765574455,40,118.70492922218595,-0.31906214288666884,0.2331185812668232,0.7490282441898899,0.8205156086760885,33660,33697,Christian+Shelby,Christian,17,21,Illinois,IL
17173,17CS008,201,192,210,234,24,33,42,631.5939797996115,30,571.5918833952558,-1.1137478258009677,0.5878581924181953,2.2980498217701366,0.8784976277294863,244,234,255,321,66,77,87,368.0108140251704,48,230.71377072819035,0.8989436529935364,1.3668039632985436,1.8556363621184844,0.6188386086692101,20994,20805,Christian+Shelby,Shelby,17,173,Illinois,IL
17023,17CS009,163,157,170,191,21,28,34,723.9234190920895,18,467.4110620618021,0.8326227530357834,2.6131761635373105,4.280177178300498,0.6233055855523342,197,189,205,234,29,37,45,243.7687724759806,30,195.87359623922697,-0.0097325825880573,0.4879627792257478,1.009724822447635,0.7825619081316271,15404,15316,Clark+Crawford+Cumberland+Jasper,Clark,17,23,Illinois,IL
17033,17CS009,186,178,194,195,1,9,17,197.43898680718596,29,622.0506220506221,-5.944280845088055,-4.2457591738157365,-2.47375486826569,2.841854083964217,225,216,235,240,5,15,24,77.88232416464854,27,144.72555746140654,-1.2115083951158783,-0.6910873676783595,-0.16793941520011088,1.738601138953854,18648,18656,Clark+Crawford+Cumberland+Jasper,Crawford,17,33,Illinois,IL
17035,17CS009,94,93,95,103,8,9,10,332.145051279055,20,764.525993883792,-4.740767203882881,-4.32554972504534,-3.9131827532135985,2.064214718214047,114,113,115,157,42,43,44,413.7599360419426,19,183.4508062180168,2.1748077538946164,2.3031127223547396,2.4233274171175694,0.43326453131628223,10464,10357,Clark+Crawford+Cumberland+Jasper,Cumberland,17,35,Illinois,IL
17079,17CS009,82,81,83,87,4,5,6,212.30461958731286,13,559.4405594405595,-3.879453500152184,-3.480089541447605,-3.064563619469788,2.190976058113598,99,98,101,124,23,25,26,268.01115908384367,13,141.28899032713835,1.140897207426244,1.267222738987136,1.4001555861550137,0.5066308874073803,9295,9201,Clark+Crawford+Cumberland+Jasper,Jasper,17,79,Illinois,IL
17025,17CS010,157,151,163,176,13,19,25,574.9712957368794,29,876.0667623291291,-4.608626300395085,-3.032651472474735,-1.2320522535737957,1.447612357603917,190,184,197,182,-15,-8,-2,-64.47276441616741,19,144.36592964060483,-2.602556057222881,-2.097418485939494,-1.603557445390046,-2.538321804166961,13241,13161,Clay+Hamilton+Wayne+White,Clay,17,25,Illinois,IL
17065,17CS010,86,85,87,107,20,21,22,1045.2540385992613,11,550.4816714625298,4.567803240553661,4.942976792038901,5.312921547468838,0.50258629017232,105,104,106,103,-3,-2,-1,-22.057541061775307,18,227.24403484408535,-2.6163058973101223,-2.4986820984534,-2.3657854732855554,-24.090650628845616,7993,7921,Clay+Hamilton+Wayne+White,Hamilton,17,65,Illinois,IL
17191,17CS010,172,165,179,215,36,43,50,1058.7345328491567,32,794.2910331988829,0.9543717738870223,2.676410034887047,4.372936183824764,0.7330409684741815,209,201,218,242,24,33,41,204.7680124221549,29,181.40873264106094,-0.26897412050203096,0.23344029192589763,0.7361327493723341,0.8596613396584508,16115,15986,Clay+Hamilton+Wayne+White,Wayne,17,191,Illinois,IL
17193,17CS010,192,186,198,215,17,23,29,656.075815527835,31,900.4429598431486,-4.120343891629491,-2.4590791118442814,-0.7633075061595977,1.3142804978665794,234,227,242,253,11,19,26,135.0168637584637,22,159.55903684363213,-0.7664985066429393,-0.24538061814799136,0.3028610436581088,1.121526285324643,13771,13788,Clay+Hamilton+Wayne+White,White,17,193,Illinois,IL
17027,17CS011,292,276,308,347,39,55,71,594.1277866948791,41,443.66292438793454,-0.19643481412541824,1.5099231456340245,3.1436868584777318,0.7333891723121005,355,336,374,364,-10,9,28,24.03608857015418,35,95.08802434253424,-1.2448180031316822,-0.7292899341358131,-0.20152394920685415,3.5543085981597655,36965,36808,Clinton+Marion,Clinton,17,27,Illinois,IL
17121,17CS011,439,423,456,567,111,128,144,1359.9123035391933,51,543.3479824210947,6.507856914981487,8.155604356998694,9.862870783549075,0.3964405281194525,531,512,551,593,42,62,81,165.11712747430778,67,179.03428372925742,-0.6619896882896226,-0.14280625950185227,0.38870829275050073,1.0670186003654551,37545,37423,Clinton+Marion,Marion,17,121,Illinois,IL
17029,17CS012,401,381,421,524,103,123,143,1040.6010628156264,50,422.5738976103446,4.536628763862107,6.216834684149302,7.950974459670435,0.40281480782749934,488,464,512,597,85,109,133,233.75469624489605,64,136.86619191206347,0.4883842626718188,0.9613798185166103,1.4512821609527236,0.5802039830720026,47329,46761,Coles,Coles,17,29,Illinois,IL
17031,17CS013,34998,32744,37252,44691,7439,9693,11947,740.4581392293353,7636,583.3143153972711,-0.12687884822556483,1.6065026999574783,3.3931215186420074,0.7876936082587671,42715,40037,45392,47087,1695,4372,7050,84.30640464763923,4196,80.90683527784827,-0.4982528095267756,0.053820974896496676,0.553567404829447,0.9594565854623152,5236285,5186212,Cook,Cook,17,31,Illinois,IL
17037,17CS014,602,559,646,753,107,151,194,596.2946289587572,56,221.85686270625757,2.0714090191062047,3.744268449899659,5.527461018669023,0.3696035194116799,744,692,796,892,96,148,200,147.386876782613,69,68.7333147388134,0.27777514180827706,0.7766048163464817,1.2971875283313898,0.46321552524667614,100966,100388,DeKalb,DeKalb,17,37,Illinois,IL
17039,17CS015,171,164,177,205,28,34,41,889.8384472102167,21,543.4431002134955,1.8427893804755493,3.471900422181788,5.266721935264984,0.5934620457419933,208,200,216,230,14,22,30,144.23959929112422,21,136.75436311539463,-0.4278112923044272,0.08221973114000383,0.5742596440158665,0.9071496533206378,15457,15356,De Witt+Logan+Mason+Menard,De Witt,17,39,Illinois,IL
17107,17CS015,291,278,303,351,48,60,73,864.0686098639072,47,671.4045926931182,0.2537555179121328,1.9396520671346162,3.521055316562389,0.7643896821751821,357,342,371,332,-39,-25,-10,-88.01809921576236,30,107.23477266228196,-2.4411917378129724,-1.946371453625048,-1.4570793374901625,-1.2698980625529097,28001,27976,De Witt+Logan+Mason+Menard,Logan,17,107,Illinois,IL
17125,17CS015,156,150,161,193,32,37,43,1146.0515164041587,33,1010.4102878138395,-0.34805925569283314,1.4248701867571483,3.105179109574929,0.8587031871713374,188,182,195,222,27,34,40,260.90412775312416,20,155.0147263990079,0.5505699272642796,1.050391711970687,1.5611573435084414,0.5770032377185758,13064,12902,De Witt+Logan+Mason+Menard,Mason,17,125,Illinois,IL
17129,17CS015,106,105,108,111,3,5,6,149.25471028612037,12,391.99673336055537,-2.849510771658678,-2.4097622592598196,-2.0370045325745503,2.1547622742080197,130,129,132,162,30,32,33,260.6846989930604,14,114.95196649971263,1.3377985832180976,1.4553185927248848,1.581757423972446,0.42749671721817395,12245,12179,De Witt+Logan+Mason+Menard,Menard,17,129,Illinois,IL
17041,17CS016,169,161,178,200,22,31,39,624.8798372098088,29,588.9221708889679,-1.2964415854065026,0.36968174127399717,2.112522366331165,0.9127922851319721,208,198,218,247,29,39,49,199.2363745016003,17,86.1850443599493,0.6077430233006932,1.1227849854566248,1.6644411023772545,0.4218427718706226,19697,19725,Douglas+Edgar+Moultrie+Piatt,Douglas,17,41,Illinois,IL
17045,17CS016,193,186,201,242,41,49,56,1156.4029329769824,36,857.6022869394318,1.4048545966241084,3.0142155509619233,4.739349884847672,0.7266429096182876,233,225,242,278,36,45,53,271.2344230599834,42,253.71511417180136,-0.33981997568165523,0.16783039311879458,0.7225514024606227,0.9150297613448413,16791,16554,Douglas+Edgar+Moultrie+Piatt,Edgar,17,45,Illinois,IL
17139,17CS016,165,159,172,183,11,18,24,483.7062223907828,20,552.2954780807731,-2.377828351640429,-0.8372299973974293,0.8976018043690852,1.0801345575144863,202,195,210,216,6,14,21,95.37160100214041,19,130.98028402040535,-0.9029410697018322,-0.3547990699698433,0.10297503931667516,1.2807891221563772,14485,14506,Douglas+Edgar+Moultrie+Piatt,Moultrie,17,139,Illinois,IL
17147,17CS016,152,144,159,162,3,10,18,252.48874358346987,2,48.11740647179117,0.3054471619315983,2.0211855419287854,3.7568675789193784,0.1739933129927624,187,178,195,209,14,22,31,133.43807131019187,10,59.74072525240456,0.2242592442325349,0.7362388151770424,1.2451213838422048,0.42851880481032495,16626,16739,Douglas+Edgar+Moultrie+Piatt,Piatt,17,147,Illinois,IL
17043,17CS017,5387,4987,5787,6490,703,1103,1503,474.86780894282975,821,353.3933944274898,-0.5128245160009819,1.2266767548457667,2.9424860472157217,0.7435192392616844,6647,6169,7125,6994,-131,347,825,37.50172686299031,393,42.44981902119142,-0.5754907210411284,-0.05069577062434434,0.4501921586824869,1.1286921190271277,929276,925799,DuPage,DuPage,17,43,Illinois,IL
17047,17CS018,61,60,61,81,20,20,21,1312.162031908452,10,642.9834431763381,6.2792917768394485,6.6842064268043435,7.088883294603657,0.4671281892903012,73,72,73,90,17,17,18,285.523464748511,18,295.3724975385625,-0.21881012397940977,-0.09647626220944598,0.017659403861352733,0.9782715060468364,6221,6094,Edwards+Lawrence+Richland+Wabash,Edwards,17,47,Illinois,IL
17101,17CS018,163,156,170,180,10,17,24,445.7744406096514,30,784.9293563579278,-5.095599107157343,-3.446377797231286,-1.6640558209293819,1.663201744335399,196,188,204,197,-7,1,9,5.250094720810407,20,131.89132155104195,-1.7848962912151014,-1.2569475674953108,-0.73923143483723,11.135086415414749,15288,15164,Edwards+Lawrence+Richland+Wabash,Lawrence,17,101,Illinois,IL
17159,17CS018,174,167,181,222,41,48,55,1215.9330523473786,29,735.9939090159254,3.1015617750004,4.753046828755629,6.677814745261283,0.59291605857543,211,203,219,265,46,54,62,341.1025208211864,41,259.5429511932645,0.30865246935698765,0.8154598322730956,1.3374500726412613,0.7470305733203444,15761,15797,Edwards+Lawrence+Richland+Wabash,Richland,17,159,Illinois,IL
17185,17CS018,123,118,128,139,11,16,21,558.105411602678,15,530.4101838755304,-1.4489415095341232,0.2825871359858551,2.1299712046906305,0.8937497733086767,148,142,154,161,7,13,19,114.87108319101235,15,133.70175594972815,-0.7100386432514291,-0.18221248794923117,0.3200309084907053,1.080116813261199,11312,11219,Edwards+Lawrence+Richland+Wabash,Wabash,17,185,Illinois,IL
17053,17CS019,173,167,178,203,25,30,36,903.5275872259498,24,713.8077180459514,0.31589374481849647,1.8784085495793443,3.6036957357800454,0.7648462317872716,211,204,218,237,19,26,33,194.65198086120216,20,147.9946721918011,-0.08755879363609986,0.4830802217599676,0.9466004510322806,0.7324593734798257,13449,13514,Ford+Iroquois+Livingston,Ford,17,53,Illinois,IL
17075,17CS019,319,307,331,381,50,62,74,920.2987614383302,44,652.2383634746516,0.9520037104602613,2.661685859730853,4.545863108047819,0.6974898590281087,387,373,401,418,17,31,45,115.29350424926241,43,160.14897579143388,-0.9815754855941202,-0.4479729670259248,0.06628925873894453,1.3455873199726935,26984,26850,Ford+Iroquois+Livingston,Iroquois,17,75,Illinois,IL
17105,17CS019,375,359,390,420,30,45,61,506.3489598559012,54,604.8048384387075,-2.7524800439139985,-0.9801173803405094,0.694990909029031,1.1685942406303336,457,439,476,482,6,25,43,69.39105893438413,64,179.38728032065475,-1.6523009249302862,-1.118714853002036,-0.6035220310291578,2.48479537249604,35714,35677,Ford+Iroquois+Livingston,Livingston,17,105,Illinois,IL
17055,17CS020,428,412,444,518,74,90,106,955.026685359269,60,635.8289620092195,1.5505984141141849,3.175656909208636,4.907308523298987,0.6584644445832056,519,500,539,644,105,125,144,332.7284395107117,88,234.8545503069122,0.4698819184411425,0.989546442961575,1.4946436105275103,0.700228032447473,37746,37470,Franklin+Gallatin+Saline,Franklin,17,55,Illinois,IL
17059,17CS020,63,63,64,68,4,5,5,398.0782715275248,1,81.20178643930167,2.7328968627798047,3.1683105926452617,3.5680132199376864,0.1694245047118611,77,76,78,91,13,14,15,283.26563531383897,1,20.370747606437156,2.5027642830182186,2.6281694611443673,2.760455682325938,0.06708928426336107,4926,4909,Franklin+Gallatin+Saline,Gallatin,17,59,Illinois,IL
17165,17CS020,309,299,320,330,10,21,31,347.99603671634753,41,695.2687807359674,-5.170240870992338,-3.430248056886065,-1.7953729308021655,1.9050870497821386,373,361,385,423,38,50,62,212.18063231511022,53,226.82530172044852,-0.669083920724684,-0.14477973011839873,0.3517828159266631,1.0478838110188373,23588,23366,Franklin+Gallatin+Saline,Saline,17,165,Illinois,IL
17057,17CS021,390,376,404,450,46,60,74,714.904424470193,31,369.80704422772953,1.8040200449068506,3.451226249780356,5.289446453038422,0.5087918355849944,474,457,491,515,24,41,58,123.41106729941473,55,165.50312951372172,-0.9198080963097746,-0.4199795302988335,0.1455502751417284,1.3091508298047496,33531,33232,Fulton+McDonough,Fulton,17,57,Illinois,IL
17109,17CS021,248,236,260,318,58,70,82,1021.5102530388561,31,451.7633343048674,3.8979733070353735,5.723150020759007,7.439733109294885,0.4360299505639879,301,287,314,323,9,22,36,83.71990504891097,32,119.1140889633352,-0.8933701298010323,-0.35699242068624926,0.12053631625033377,1.3622033900231443,27448,26865,Fulton+McDonough,McDonough,17,109,Illinois,IL
17061,17CS022,136,131,141,163,22,27,32,893.4519115621188,26,862.7841380454622,-1.4619684378456819,0.2980057406492638,2.0964366822198115,0.9310929161458912,165,159,171,181,10,16,22,134.41575987968682,19,160.28344862493674,-0.7866333452862976,-0.2543084585470205,0.24576879343952696,1.1220266472100386,12054,11854,Greene+Jersey+Morgan,Greene,17,61,Illinois,IL
17083,17CS022,233,224,242,271,29,38,47,706.580414205101,36,670.859538784067,-1.3171410390239915,0.3841553339438316,1.979815111257863,0.9250486648449109,285,274,296,317,21,32,43,149.983153684673,29,135.83774415663498,-0.37981096573828893,0.15970063323374137,0.6456685018526915,0.8782581698774943,21465,21349,Greene+Jersey+Morgan,Jersey,17,83,Illinois,IL
17137,17CS022,339,325,353,414,61,75,89,911.8643937568208,54,656.4152434206528,0.9178860547138841,2.5668911965483616,4.229235592838021,0.7103905531218602,414,397,431,437,6,23,40,69.91302810629423,31,94.99295213580929,-0.7652293402997505,-0.2625613510645251,0.25838591844685577,1.3016777841486429,32906,32634,Greene+Jersey+Morgan,Morgan,17,137,Illinois,IL
17063,17CS023,369,347,392,466,74,97,119,740.1974430141868,44,336.2179303493992,2.3262306080558273,4.039172572344802,5.651344823629287,0.4495861253880081,460,433,487,527,40,67,94,126.80018385860569,55,103.93046107331821,-0.33844010551093645,0.2190970118557857,0.7547102945464714,0.8076043165152104,52347,52920,Grundy,Grundy,17,63,Illinois,IL
17067,17CS024,176,169,184,235,51,59,66,1334.1259957467298,32,729.0124159927099,4.268351260028697,6.051558407662338,7.905326803627269,0.5372601626389731,216,207,225,239,14,23,32,132.67499416789076,24,137.7568591436115,-0.5796622254411952,-0.04526794013146929,0.47032836256634053,0.9952461452507292,17558,17422,Hancock+Henderson+Mercer+Warren,Hancock,17,67,Illinois,IL
17071,17CS024,70,69,70,95,25,25,26,1582.4970291094444,15,938.9671361502348,6.022349863069387,6.444316778029625,6.82531594179977,0.57076778454033394,85,84,86,109,23,24,25,383.6504035646861,10,158.32805573147562,2.123570583952635,2.251452837307928,2.3829787047780897,0.396332191466019,6390,6316,Hancock+Henderson+Mercer+Warren,Henderson,17,71,Illinois,IL
17131,17CS024,173,166,180,192,12,19,26,482.43763848189354,16,410.07240340872687,-1.0416440431966676,0.7507565413212346,2.500364910414646,0.8071224292994232,213,204,221,206,-15,-7,2,-41.859493346873364,16,102.63647443710309,-1.9614558121032506,-1.4250482103349502,-0.9300538609647399,-2.8956779090268605,15607,15589,Hancock+Henderson+Mercer+Warren,Mercer,17,131,Illinois,IL
17187,17CS024,163,156,170,218,48,55,62,1307.6938387133719,31,739.9892582204452,3.92535807702605,5.701523844927333,7.486145273029248,0.5557292046156697,199,191,208,215,7,16,24,95.94186339486559,28,169.01068388966019,-1.2457560063872706,-0.7374249180221685,-0.17829393155620724,1.6573256136508003,16757,16567,Hancock+Henderson+Mercer+Warren,Warren,17,187,Illinois,IL
17073,17CS025,454,433,475,583,108,129,150,1050.9439064243363,64,521.5548855024041,3.7429839040651105,5.308167238832915,7.058478401025609,0.4924541907724881,553,528,578,601,23,48,73,97.64697981530081,41,83.77434053247788,-0.38474949891143784,0.12598304999719784,0.6563529889466917,0.840346324166981,49084,48941,Henry,Henry,17,73,Illinois,IL
17077,17CS026,382,359,405,535,130,153,176,1147.8338954118356,68,509.0106106255965,4.492767957299527,6.333930256697126,7.9555432528670975,0.44058001155975235,466,439,493,611,118,145,172,274.9663464008874,64,121.6429399578051,1.033904813996011,1.5318531273244895,2.047061837330572,0.4393551139730831,53437,52613,Jackson,Jackson,17,77,Illinois,IL
17081,17CS027,373,357,388,486,98,113,129,1223.1585920304758,65,700.7708479327259,3.4989750473966565,5.22938935943642,6.8888421604494186,0.5679133738511868,454,435,473,549,76,95,114,257.023229001226,67,181.57673649692404,0.24922036251506244,0.7644088836922577,1.2836777331939422,0.6990890880825387,37102,36899,Jefferson+Washington,Jefferson,17,81,Illinois,IL
17189,17CS027,138,132,144,149,5,11,17,331.7076357570307,17,495.0134672781539,-3.40842424056379,-1.6533797572484796,0.14808219870785855,1.3718893992520818,168,161,175,167,-8,-1,6,-5.672295023360095,21,153.69977310985874,-2.1164021418921704,-1.5874503281251238,-1.1099642853272966,93.33568499506391,13737,13663,Jefferson+Washington,Washington,17,189,Illinois,IL
17089,17CS028,2735,2512,2957,3584,627,849,1072,655.2237277174914,513,395.7959220675515,0.852005380316073,2.6426348160855215,4.332493420961403,0.6033518020097696,3387,3121,3653,3905,252,518,784,100.45501893135052,326,63.218602558608104,-0.17254428885654075,0.3627165908600767,0.861708767231997,0.6281099623576736,518449,515671,Kane,Kane,17,89,Illinois,IL
17091,17CS029,955,909,1001,1149,148,194,240,722.3890988620924,124,461.3524323318761,0.9167277861056381,2.57521915930853,4.402411258759046,0.635375678271756,1163,1108,1218,1378,160,215,270,201.13035173074286,132,123.718297186346,0.26629199241590273,0.7748466211533159,1.2844713760316366,0.6122618871599252,107510,106694,Kankakee,Kankakee,17,91,Illinois,IL
17093,17CS030,532,476,589,630,41,98,154,295.4503374684285,74,224.13205618445463,-1.184889961141519,0.7169395188168457,2.3543988923912864,0.750913612915564,679,609,748,780,32,101,171,75.44751207892952,61,45.35619483831632,-0.181789449328419,0.2963101171576229,0.808284551443049,0.5952955250490217,132065,134491,Kendall,Kendall,17,93,Illinois,IL
17095,17CS031,570,549,591,694,103,124,145,998.1227348794347,106,853.51369849226,-0.3461363769310866,1.4587434884075408,3.1773458104312695,0.8482758066889597,691,666,717,730,13,39,64,78.76045366415934,73,147.96497486622343,-1.1958984419105414,-0.6852436197292628,-0.1723304725424592,1.8315359541980878,49677,49336,Knox,Knox,17,95,Illinois,IL
17097,17CS032,4052,3746,4358,4865,507,813,1119,457.6809308849884,699,393.4337649472467,-1.0463073713557287,0.623064417724456,2.3287294189813035,0.8585686906733653,5026,4659,5394,5214,-180,188,555,26.380998225230048,373,52.42246604837202,-0.7693053408420225,-0.2749104872268998,0.24687850815487078,1.9765995493914654,710666,711527,Lake,Lake,17,97,Illinois,IL
17099,17CS033,1121,1074,1168,1295,127,174,221,636.8877321395671,180,659.370850313659,-1.9155669303376364,-0.19918416908938272,1.5688907827168614,1.02938087617977,1368,1311,1424,1435,11,67,124,61.74984714751823,129,118.32474179523399,-1.0674531163418801,-0.570055238448812,-0.058385697785712024,1.8881479216309016,109195,109022,La Salle,La Salle,17,99,Illinois,IL
17103,17CS034,323,308,337,387,50,64,79,758.127079853132,64,752.2774022920952,-1.7146100685761132,0.04914368148339379,1.7963658239817129,0.977134125274759,397,379,414,420,6,23,41,68.96126362129536,39,114.55426641210163,-0.9800588497232751,-0.45789448324361126,0.04456103422903726,1.593276393238586,34030,34045,Lee+Whiteside,Lee,17,103,Illinois,IL
17195,17CS034,573,549,597,706,109,133,157,958.7401253328154,148,1067.724772296871,-2.7399136960813077,-1.196929947333468,0.6312797435496544,1.105357231941252,701,673,730,757,27,56,84,100.52433349932554,79,142.76678413300803,-0.92622823269326,-0.42869429747713167,0.06780815271217426,1.395140039938531,55445,55335,Lee+Whiteside,Whiteside,17,195,Illinois,IL
17111,17CS035,1837,1704,1970,2165,195,328,461,423.69454883782583,234,302.35390265884075,-0.43558956150959954,1.163931858107886,2.8968367525639698,0.7114432791634472,2284,2123,2444,2536,92,252,413,81.1548560883561,183,58.85663745276192,-0.2720286809528883,0.23108888252516258,0.7597566522404581,0.7223758264711522,309571,310925,McHenry,McHenry,17,111,Illinois,IL
17113,17CS036,1025,952,1099,1220,121,195,268,456.1579774290397,110,257.41381025091994,0.18752215328473248,1.9517621219004144,3.782265453924943,0.5614282994404427,1270,1181,1358,1412,54,142,231,83.2717188711109,145,84.85188956380277,-0.5472421404782585,-0.025963147828024544,0.47925890786631853,1.0118652752034625,170931,170886,McLean,McLean,17,113,Illinois,IL
17115,17CS037,1044,1000,1089,1242,153,198,242,763.4185495334062,142,548.4001776507617,0.5401814149445975,2.0949554944549,3.809955950284816,0.7147323064860455,1268,1215,1321,1433,112,165,218,160.87948520710853,136,132.54197974836515,-0.23267181361439898,0.30389803725891323,0.785536372636898,0.8188980919290355,103574,102609,Macon,Macon,17,115,Illinois,IL
17117,17CS038,470,451,489,568,79,98,117,873.7127847946025,66,589.1936527774677,1.094646426708919,2.7613279416969116,4.599133709338065,0.6675356641173016,570,547,593,647,54,77,100,172.41464660624285,70,157.42718992465984,-0.4042412199978749,0.17225976232634332,0.6685783543718891,0.9013164969694529,44807,44465,Macoupin+Montgomery,Macoupin,17,117,Illinois,IL
17135,17CS038,300,288,312,360,48,60,72,848.8015770101907,29,411.56643604754305,2.5290012405217785,4.420900319415798,6.022156623482681,0.4769055908766202,366,351,380,460,80,94,109,335.6501999201652,69,245.59530165509878,0.36824268585974573,0.9231209323329346,1.4079361019139278,0.7240223635259448,28185,28095,Macoupin+Montgomery,Montgomery,17,135,Illinois,IL
17119,17CS039,2468,2354,2582,2909,327,441,555,664.8488464713316,294,443.5760680149971,0.5713520013595258,2.2460432484371524,3.8825361693021563,0.6656726992912834,3022,2885,3159,3378,219,356,493,134.52967831580634,319,120.5424789428538,-0.41028440394311355,0.11879305556553396,0.6786844209640831,0.8935191172675168,265118,264637,Madison,Madison,17,119,Illinois,IL
17133,17CS040,264,249,279,302,23,38,53,436.9071613302954,45,516.0846378806124,-2.589257703501194,-0.8223102320961745,0.9110617939854174,1.1510093604696339,326,308,344,358,14,32,50,91.22309870772345,35,100.20900735820426,-0.5899586261975253,-0.09334956909073765,0.38892199471760414,1.0650764224220381,34878,34927,Monroe+St. Clair,Monroe,17,133,Illinois,IL
17163,17CS040,2176,2065,2286,2685,399,509,620,792.8070725044514,324,504.21541202880564,1.1838510824272954,2.880188209280111,4.605414868328995,0.6347415804933172,2660,2528,2792,3073,281,413,545,161.94699689428836,295,115.64681853642091,-0.0969929570529793,0.45726174376044326,0.9770443508568003,0.7123784443859673,257033,255087,Monroe+St. Clair,St. Clair,17,163,Illinois,IL
17141,17CS041,449,427,471,518,47,69,91,537.2376703544803,52,403.8364462392731,-0.3166167681151207,1.3970655104149672,3.087227241176196,0.7409791985794877,550,524,577,592,15,42,68,80.95129482124857,49,95.17889747873043,-0.691482846543853,-0.13178241294403067,0.33994803713264043,1.1482039409692164,51506,51482,Ogle,Ogle,17,141,Illinois,IL
17143,17CS042,1539,1461,1617,1770,153,231,309,511.6477482430628,146,323.06960379717424,0.2115342700304042,1.881864683149844,3.546777909746472,0.628710652025025,1872,1779,1964,2148,184,276,369,153.8040128377713,211,117.42249280717668,-0.12045437318363841,0.3902140226523667,0.8378363999857393,0.7607028965451113,180766,179693,Peoria+Woodford,Peoria,17,143,Illinois,IL
17203,17CS042,326,310,343,383,40,57,73,590.3338275361608,46,479.5288108206719,-0.5158077112814422,1.155501189315106,2.7162622984377833,0.7982057966061313,398,378,418,421,3,23,43,59.523791082845975,58,151.63398692810458,-1.4296873521164357,-0.9164542770310534,-0.42946243427550995,2.440271197535985,38371,38250,Peoria+Woodford,Woodford,17,203,Illinois,IL
17145,17CS043,197,188,206,232,26,35,44,662.1308628703991,29,555.0504808842528,-0.7041862379508717,1.100488079370067,2.9229020488108315,0.8147284414549835,242,231,253,302,49,60,71,287.28350097786176,40,190.74868860276584,0.47465909263146044,0.9530938726953309,1.4847104362470167,0.653132134325227,20899,20970,Perry+Randolph,Perry,17,145,Illinois,IL
17157,17CS043,295,282,308,362,54,67,80,881.1209824416969,51,673.0896133034182,0.4226033615059849,2.0548497638071286,3.8086750567603804,0.7526282571255563,359,344,375,444,69,85,100,281.4846465738056,50,165.95306847223605,0.6459056105352056,1.1463123077472406,1.7267254900310158,0.5826927945239523,30308,30129,Perry+Randolph,Randolph,17,157,Illinois,IL
17161,17CS044,1363,1301,1425,1652,227,289,351,803.5960823884407,192,534.2162741197257,0.9661521923297709,2.7740488845762927,4.4901790042423855,0.6624882749274007,1661,1587,1735,1776,41,115,189,80.16747204186436,160,111.80445400993662,-0.8153019477823871,-0.29784517588241305,0.1867384774336183,1.3825848753545489,143762,143107,Rock Island,Rock Island,17,161,Illinois,IL
17167,17CS045,1682,1598,1766,1899,133,217,301,444.1386930692108,190,388.32173477625514,-1.1658472811096843,0.5396262253603817,2.3445909525036934,0.8703204227488873,2055,1954,2155,2118,-37,63,164,32.443628920665795,141,72.3373691770983,-0.9233856360398388,-0.4181612596285857,0.10039906901378766,2.194924163419706,195714,194920,Sangamon,Sangamon,17,167,Illinois,IL
17003,17CS046,69,69,70,99,29,30,30,2268.971309600356,11,839.0541571319604,13.924597983618993,14.294495809243362,14.694345368227713,0.3577676278099609,82,81,82,103,21,21,22,419.0877919342687,12,237.6237623762376,1.6925265635423838,1.8167902136631302,1.9467406209642755,0.5414201411479098,5244,5050,Southern Illinois,Alexander,17,3,Illinois,IL
17069,17CS046,51,51,52,62,10,11,11,1161.0054848299667,10,1090.80992637033,0.35425637597669735,0.6989314207635028,1.1070479207920674,0.8588469728028202,63,62,63,84,21,21,22,584.953919356626,11,301.53508771929825,2.707771035684923,2.8323487547986455,2.9607821838295525,0.4924097503920875,3667,3648,Southern Illinois,Hardin,17,69,Illinois,IL
17087,17CS046,122,120,123,140,17,18,20,556.4626362267537,16,485.2896572641796,0.31011297746942496,0.7141689884896756,1.10801502573891,0.8270198501687166,153,151,154,175,21,22,24,165.75210762242355,32,238.09523809523813,-0.8425136455885334,-0.7248539425730189,-0.6009016737798215,1.374742687322298,13188,13440,Southern Illinois,Johnson,17,87,Illinois,IL
17127,17CS046,181,175,187,200,13,19,25,534.4966025429923,23,654.5247581104155,-2.840087863730278,-1.1859064088782514,0.6115048594723999,1.1626607586750686,221,213,228,239,11,18,26,131.4701742198926,29,207.3798627002288,-1.240014198676822,-0.7447441010424221,-0.29279584233300066,1.4960183345964704,14056,13984,Southern Illinois,Massac,17,127,Illinois,IL
17151,17CS046,40,40,41,42,1,2,2,179.81234207810556,6,629.7559695617948,-4.877944264247824,-4.504889831279174,-4.097729142122261,2.2114417800528843,49,49,50,71,21,22,22,581.098717504563,12,317.9650238473768,2.502672398256921,2.6329951531993663,2.7608442350120534,0.5233166891030421,3811,3774,Southern Illinois,Pope,17,151,Illinois,IL
17153,17CS046,66,66,67,68,1,2,2,129.33613598971561,7,541.2719891745603,-4.534064042902589,-4.11559059796434,-3.7351557931020385,2.6191335546407384,80,79,81,107,26,27,28,532.7274408319407,16,315.0226422524119,2.0532268841113557,2.1748641011056407,2.3017669466184008,0.5702630612696244,5173,5079,Southern Illinois,Pulaski,17,153,Illinois,IL
17181,17CS046,200,193,207,231,24,31,38,723.1279023471071,22,515.192318950881,0.2801074913025196,2.1245287881468893,3.790054881215107,0.6901014831093509,244,235,252,278,26,34,43,202.66722087808418,32,188.67924528301887,-0.36932456364930477,0.1237463219339592,0.6550624951076477,0.9046611366074692,17081,16960,Southern Illinois,Union,17,181,Illinois,IL
17179,17CS047,1182,1126,1239,1421,182,239,295,728.4298903852426,112,341.78644450547773,2.1485058774608103,3.8750344549889326,5.4984557177577225,0.4672523075083578,1441,1374,1509,1718,209,277,344,212.08354095630736,165,126.4358127523927,0.34846757809681955,0.848506276608902,1.376576699935939,0.5940141907494083,131076,130501,Tazewell,Tazewell,17,179,Illinois,IL
17183,17CS048,798,766,829,928,99,130,162,703.8628809911386,84,453.61882518124503,0.7414428858933565,2.4971216940120606,4.174879590038982,0.639563544077212,965,927,1003,1186,183,221,259,301.8026855538804,157,214.45157765332604,0.3898030984931299,0.8778445337530355,1.3733525751985554,0.7073673332048347,74071,73210,Vermilion,Vermilion,17,183,Illinois,IL
17197,17CS049,4024,3725,4323,4966,643,942,1241,541.8693009041556,644,370.53658761118976,-0.0514934966043184,1.6736619906570316,3.4900030828527124,0.6830864220468397,5005,4645,5364,5525,161,520,880,74.6677998672987,461,66.13538386497478,-0.38973031124642304,0.0784636355695119,0.5861087596217494,0.8840298019473516,695208,697055,Will,Will,17,197,Illinois,IL
17199,17CS050,638,609,667,744,77,106,135,634.5866612484166,76,453.7042564623008,0.07593738468222548,1.8429963114686334,3.5337950557074476,0.7082970650919019,778,743,813,889,76,111,146,165.82740075392525,97,144.97085637423405,-0.29277746410038313,0.21732785518611913,0.6898759032501243,0.8664186625255031,67004,66910,Williamson,Williamson,17,199,Illinois,IL
17201,17CS051,2538,2416,2661,2933,272,395,517,555.1611330056144,323,454.4047719535185,-0.6720430049190267,0.957212953059734,2.661558191190206,0.8164407682239068,3101,2954,3247,3540,293,439,586,155.03126717729066,303,106.926206801636,-0.038892703428982586,0.4709369430615618,1.0281392069070223,0.6881409760488578,284328,283373,Winnebago,Winnebago,17,201,Illinois,IL
18001,18CS001,271,256,287,336,49,65,80,722.9354299090021,43,480.17867113344505,0.7930934898489297,2.3611682625233144,4.099276824046405,0.6541031428257071,334,316,353,382,29,48,66,132.35686848322922,55,153.02857460838595,-0.6961256313720053,-0.22742507747247262,0.31706995242560615,1.1323773382099134,35820,35941,Adams+Wells,Adams,18,1,Indiana,IN
18179,18CS001,261,249,273,315,42,54,66,770.3848560800606,46,653.0844040604813,-0.49056687584976383,1.165913582798387,2.9138247738854717,0.8323975294414107,319,305,334,363,29,44,58,155.02101249622646,54,191.5301127899553,-0.8624407684239493,-0.35767632059168525,0.144827100391102,1.2078746917258656,28174,28194,Adams+Wells,Wells,18,179,Indiana,IN
18003,18CS002,2958,2792,3124,3470,346,512,678,531.6425537369195,428,444.4779072152369,-0.9180429503106659,0.8606090204052939,2.5678752633331383,0.8344165880839571,3664,3464,3864,3912,48,248,448,63.89071797819686,387,99.68779944978516,-0.8649667435067785,-0.3446495413707024,0.14908212382959068,1.5540206859168473,385171,388212,Allen,Allen,18,3,Indiana,IN
18005,18CS003,631,596,667,726,59,95,130,459.5515194294322,101,489.8869864674783,-1.964560694951185,-0.26815904390433754,1.4945634212573748,1.0548772552908803,773,731,816,892,76,119,161,143.95296682507038,87,105.54537844690583,-0.12365160741177657,0.3738292613486081,0.9017063541431267,0.7270661339805039,82468,82429,Bartholomew+Brown,Bartholomew,18,5,Indiana,IN
18013,18CS003,147,140,154,172,18,25,32,649.9387339674248,18,466.9260700389105,0.11143626543484204,1.790139892599227,3.384306179020521,0.6908426225057661,180,172,188,204,16,24,32,152.66982562029486,23,148.00514800514802,-0.4794783338449941,0.042543912405720065,0.5754689969047083,0.9302366627916412,15420,15540,Bartholomew+Brown,Brown,18,13,Indiana,IN
18007,18CS004,74,73,75,95,20,21,22,973.5493221380514,11,504.5871559633028,4.279164716864463,4.688318962478482,5.0828084842817685,0.49497431824887106,91,90,92,107,15,16,17,187.50685539294793,11,126.23364700481983,0.4942980575492349,0.6130003900328027,0.7423786108407283,0.6343952721865083,8720,8714,Benton+Jasper+Newton,Benton,18,7,Indiana,IN
18073,18CS004,277,262,291,350,59,73,88,889.0055600958376,34,411.94644696189494,2.9774903224872995,4.816527031469633,6.408847727333302,0.4571485494336027,341,324,358,425,67,84,101,254.18364868269398,75,226.83280909750786,-0.2662296291399462,0.2632502570718443,0.7489038068866876,0.8819038798663518,33014,33064,Benton+Jasper+Newton,Jasper,18,73,Indiana,IN
18111,18CS004,147,141,153,163,10,16,22,475.18523656501844,23,665.5574043261231,-3.6251939821410177,-1.8634865297454202,-0.11198315529743924,1.3202294769708232,179,172,186,223,37,44,51,317.0060648263096,31,224.5400550485296,0.41345189209224187,0.9090494987919033,1.4632491506017715,0.6924920433307611,13823,13806,Benton+Jasper+Newton,Newton,18,111,Indiana,IN
18009,18CS005,147,142,152,173,21,26,31,870.2862431990649,22,730.1692665117823,-0.28050942802082524,1.3834513441863097,3.0107977923981797,0.8081780415442706,180,174,186,204,18,24,30,198.45528550198696,35,289.4475686404234,-1.4109630086226752,-0.912472440700429,-0.3802260708007755,1.400156082516897,12052,12092,Blackford+Jay+Randolph,Blackford,18,9,Indiana,IN
18075,18CS005,199,190,208,226,18,27,36,531.5170044737839,34,665.5899769979935,-3.03979700171492,-1.3683720055693156,0.21062871055020488,1.2077630441271348,243,232,253,297,44,54,65,267.07817576116094,38,187.39520662787257,0.24513216188708414,0.8040027351980862,1.3774063687221498,0.688928578061735,20433,20278,Blackford+Jay+Randolph,Jay,18,75,Indiana,IN
18135,18CS005,261,251,272,327,55,66,76,1076.8669905450936,56,918.0704127218329,-0.046128542706215955,1.601622865999556,3.2549926697926077,0.839754024426892,321,308,333,415,82,94,107,386.75829182576547,54,221.44761123641584,1.118432169544935,1.6524182877954379,2.1766162080572755,0.5665662372581646,24399,24385,Blackford+Jay+Randolph,Randolph,18,135,Indiana,IN
18011,18CS006,490,460,521,511,-10,21,51,117.77490939690112,76,428.8273546712558,-4.768967926984442,-3.145298988798134,-1.451097732062501,3.474610897339544,616,579,654,640,-14,24,61,32.63312004266896,54,74.1992662517004,-0.9300467140670015,-0.42173826266245124,0.1300732316441365,2.1818705666833305,70891,72777,Boone,Boone,18,11,Indiana,IN
18015,18CS007,162,154,171,165,-6,3,11,54.13643556820964,18,354.5575417343773,-4.779589044010324,-3.011621136944927,-1.255790495678716,4.802085394953943,199,188,209,236,27,37,48,183.20957383781726,34,166.4708186447317,-0.35506895726402493,0.1674748052776861,0.657069554943953,0.8849851589508239,20307,20424,Carroll+Clinton,Carroll,18,15,Indiana,IN
18023,18CS007,318,303,332,387,55,69,84,840.8069025137584,35,424.01114543582287,2.428534812329971,4.130747012697684,5.901846478593408,0.4971279796797745,386,369,403,435,32,49,66,148.54654183300914,49,148.13471189310116,-0.5103617276247969,0.004122581503641118,0.5455164168636382,0.9773372425808684,33018,33078,Carroll+Clinton,Clinton,18,23,Indiana,IN
18017,18CS008,358,342,374,450,76,92,108,977.241798901533,75,795.2075491703333,0.09903687882523433,1.8571205031049816,3.4015113239418517,0.8049925832058206,437,417,456,495,39,58,78,154.94000271541435,63,167.58439071103663,-0.6599083854816725,-0.13112854815181874,0.39762762259818973,1.0633522443813985,37726,37593,Cass+White,Cass,18,17,Indiana,IN
18181,18CS008,257,246,267,279,12,22,33,366.21134895060464,31,504.5983559860015,-3.002609645261697,-1.4040952564798128,0.17214062760119275,1.3192503094534367,314,302,327,516,189,202,214,818.5122202551361,52,210.9619051482819,5.573360161063667,6.05242496617528,6.593693794888908,0.25646706719074674,24574,24649,Cass+White,White,18,181,Indiana,IN
18019,18CS009,1117,1065,1169,1253,84,136,188,448.71377825021443,129,426.506203350884,-1.4230395740965078,0.2219991658509758,1.9439565060856319,0.9435559865413804,1384,1320,1447,1539,92,155,219,126.83606679010461,181,147.72374842890488,-0.7056469542079984,-0.2098113535078185,0.2946615924183739,1.1572360301874487,120983,122526,Clark+Scott,Clark,18,19,Indiana,IN
18143,18CS009,280,270,291,333,42,53,63,867.4978753611801,38,626.3392121312015,0.8383031005968591,2.431534031555091,4.066911079725817,0.7085441612166069,343,330,355,437,82,94,107,386.7110373377156,55,225.85413929040737,1.0783944709108393,1.614452046977378,2.1549857475646634,0.5779018417160888,24268,24352,Clark+Scott,Scott,18,143,Indiana,IN
18021,18CS010,257,246,269,317,48,60,71,902.316306357981,32,484.6465487864905,2.557082072987049,4.155397608372944,5.8779887366132515,0.5282472811903033,312,299,326,350,24,38,51,143.0450777284505,36,136.2965206527089,-0.49105744164682785,0.07116657683346914,0.6262376561666457,0.9282538093184548,26411,26413,Clay+Sullivan+Vermillion+Vigo,Clay,18,21,Indiana,IN
18153,18CS010,196,187,205,225,20,29,38,564.9027111512191,28,539.2652510953826,-1.2969371433539816,0.18438701029087035,1.9121290385403042,0.9231430337193056,237,227,248,274,26,37,47,176.851894207827,30,144.47387430772935,-0.2328018790281248,0.3215048466748459,0.8535805817807746,0.7952645530603009,20769,20765,Clay+Sullivan+Vermillion+Vigo,Sullivan,18,153,Indiana,IN
18165,18CS010,174,167,181,195,14,21,28,542.8926863690476,26,675.412391219639,-3.079317258859923,-1.290107660655589,0.314509168508156,1.187287586049001,210,202,218,233,15,23,31,147.93315826201416,27,175.91868647380767,-0.787114066696395,-0.2939021514641704,0.1967628801213264,1.1390107274927863,15398,15348,Clay+Sullivan+Vermillion+Vigo,Vermillion,18,165,Indiana,IN
18167,18CS010,953,908,999,1144,145,191,236,718.5862684034997,138,520.048236358155,0.2578106135765233,2.0415512065254298,3.72699452959652,0.7199346968513273,1157,1102,1211,1348,137,191,246,180.65976134271096,128,120.75927393486548,0.11179062084574586,0.5975565577277392,1.1253323075007948,0.6649622830233186,106144,105996,Clay+Sullivan+Vermillion+Vigo,Vigo,18,167,Indiana,IN
18025,18CS011,105,104,106,124,18,19,20,713.7592848521639,11,417.2593646277857,2.5592141808398234,2.964611801948968,3.3910332723475554,0.5550935622038776,129,128,130,166,36,37,38,352.39329711549476,26,247.19528427457695,0.9291701377431518,1.0526893435365143,1.1761881398558476,0.6830470636612042,10545,10518,Crawford+Harrison+Perry,Crawford,18,25,Indiana,IN
18061,18CS011,352,335,369,403,34,51,68,512.7640576654236,41,412.1120743812037,-0.9344653248581609,1.0845243709405217,2.6718070859911793,0.7882551643614898,433,413,454,542,88,109,129,274.0493292757583,72,181.1548622468235,0.3908867667170291,0.9254761744087716,1.4388384239810774,0.6550164356539736,39795,39745,Crawford+Harrison+Perry,Harrison,18,61,Indiana,IN
18123,18CS011,191,182,199,210,11,19,28,405.9516719000117,25,521.593991237221,-2.761471244224428,-1.1045241870667337,0.5748971887746007,1.222059824181236,235,225,245,245,-0,10,20,50.652842391619544,32,165.87186398507154,-1.6719823481873126,-1.1396332200224912,-0.6009508933743852,2.9706794805517354,19172,19292,Crawford+Harrison+Perry,Perry,18,123,Indiana,IN
18027,18CS012,292,278,306,336,30,44,58,527.8878632019555,70,838.3484535465134,-4.862498888377456,-3.131236708784408,-1.332463235229793,1.5528874582523995,359,342,376,343,-33,-16,1,-48.05483731913248,38,113.78608216552881,-2.1016902536299926,-1.6250700531063924,-1.1014208410971034,-2.5251864973483213,33399,33396,Daviess+Knox+Martin,Daviess,18,27,Indiana,IN
18083,18CS012,373,358,389,477,88,104,119,1142.076842804944,68,750.0137870181437,2.1255747899066977,3.995725923651704,5.580980371403821,0.6504289194263533,455,436,473,503,30,48,67,134.40900576766353,43,119.45108061558976,-0.33723351783248823,0.14139815235311856,0.6563541094732652,0.870717595026627,36266,35998,Daviess+Knox+Martin,Knox,18,83,Indiana,IN
18101,18CS012,90,89,91,95,4,5,6,197.35026372423624,10,406.38016864777,-2.5162882345121984,-2.0962670301920863,-1.7073018187330258,1.7075637827291004,110,109,111,128,17,18,19,182.7996015769706,5,51.11951743175544,1.1935727296252296,1.3163903689751328,1.438399216899572,0.2648357121843042,9843,9781,Daviess+Knox+Martin,Martin,18,101,Indiana,IN
18029,18CS013,436,414,457,474,17,38,60,304.46394639089,58,458.79723930626693,-3.2036808708137916,-1.5571742853817678,0.20996212996366193,1.4687422176328215,536,510,562,616,54,80,106,157.6347510263925,84,165.3445662657717,-0.6218569315938625,-0.06600789446835559,0.46361446810609513,1.0359731493489635,50567,50803,Dearborn+Ohio+Ripley+Switzerland,Dearborn,18,29,Indiana,IN
18115,18CS013,57,56,58,66,8,9,10,612.8375856566734,16,1078.894133513149,-5.0895871879533665,-4.668668099663676,-4.274908875827,1.585982862173749,70,70,71,89,18,19,19,313.54398626563164,2,33.49522693016245,2.6666086047506288,2.8021979115253495,2.9233817920846303,0.10141107723439273,5932,5971,Dearborn+Ohio+Ripley+Switzerland,Ohio,18,115,Indiana,IN
18137,18CS013,265,252,277,332,55,67,80,929.5004928559563,43,594.8469652429535,1.6590205491773198,3.374196209930348,5.093223402130024,0.6305792804429978,326,311,341,421,80,95,110,327.8774215918551,74,254.59299525218466,0.2267247532811789,0.7366162475567961,1.255135883858847,0.7684251899648584,28915,29066,Dearborn+Ohio+Ripley+Switzerland,Ripley,18,137,Indiana,IN
18155,18CS013,85,84,86,90,4,5,6,196.0590016001208,6,242.66936299292215,-0.8829691108073038,-0.45569683996678007,-0.03442291507793974,1.0260692008872776,103,102,105,116,11,13,14,128.79067950648573,12,122.69938650306749,-0.07360104979882491,0.059838632155174785,0.18904647958471527,0.8826301613091376,9890,9780,Dearborn+Ohio+Ripley+Switzerland,Switzerland,18,155,Indiana,IN
18031,18CS014,247,235,258,332,74,85,97,1291.2172187743715,61,922.1466364323506,1.9352440676406868,3.6584497190818053,5.3806434348679035,0.7059039805164401,302,288,315,332,17,30,44,115.20167186750132,38,144.25084462665603,-0.7805172880523376,-0.28228905686541156,0.182550442182904,1.2122149250328638,26460,26343,Decatur+Shelby,Decatur,18,31,Indiana,IN
18145,18CS014,408,389,427,492,65,84,103,747.6877610219893,62,551.2336074683262,0.19236359823456453,1.941541603349767,3.738736292401803,0.7285873388089661,502,479,525,541,16,39,62,87.02022865031945,69,153.20736283500233,-1.1930557729858537,-0.6562784165916619,-0.14454342229461745,1.7167894383200055,44990,45037,Decatur+Shelby,Shelby,18,145,Indiana,IN
18033,18CS015,364,346,383,458,75,94,112,866.4781983488245,63,581.6905960020313,1.2434483777290322,2.8167369258076373,4.484628796377838,0.664249212337095,446,424,469,489,20,43,65,98.28682907409667,55,126.95042009048102,-0.7694726235120865,-0.3017810797162777,0.2432671364369829,1.26199509623092,43322,43324,DeKalb+Steuben,DeKalb,18,33,Indiana,IN
18151,18CS015,277,262,292,306,14,29,44,337.5301734032087,32,370.9392297215058,-1.9913620751536654,-0.2994273698090019,1.2928199900668227,1.0624916329218819,341,323,359,395,36,54,72,156.87692255821676,60,173.39035949601202,-0.6534461911664822,-0.14034452052190996,0.3697529254273629,1.0852717890272179,34507,34604,DeKalb+Steuben,Steuben,18,151,Indiana,IN
18035,18CS016,1100,1052,1148,1343,195,243,291,867.0551526830292,120,428.58673524054427,2.7211502568877015,4.367972531521925,6.000622655808974,0.49227381942639176,1351,1293,1409,1554,145,203,261,181.35857428649146,183,163.62368341052556,-0.322751145909703,0.17155035747928354,0.6646099129206823,0.8977847236115248,111996,111842,Delaware,Delaware,18,35,Indiana,IN
18037,18CS017,358,339,377,412,35,54,73,498.5076493421549,55,506.3407673364174,-1.8682370462707596,-0.10748385626096264,1.7653091181462144,0.9972955675944037,438,416,461,534,73,96,118,219.5285156197542,62,142.34221824276236,0.2824137416227721,0.7688285088055689,1.300227331522987,0.6416888551948466,43449,43557,Dubois+Pike+Spencer,Dubois,18,37,Indiana,IN
18125,18CS017,139,134,144,154,10,15,20,491.53479606305103,25,816.5931732810715,-4.771565047546275,-3.296334390970584,-1.5761687067798849,1.5577937316888628,168,162,174,189,15,21,27,172.2514353466197,16,131.61141729044994,-0.13002175857755294,0.4114485294491484,0.8878483075770527,0.729241447311901,12246,12157,Dubois+Pike+Spencer,Pike,18,125,Indiana,IN
18147,18CS017,170,161,178,195,17,25,34,510.9536528763226,12,241.40012070006034,0.9677950446178664,2.6537730904940195,4.322298841311115,0.45455395875962123,207,197,217,281,64,74,84,374.64301271084634,43,217.16074945709812,1.032090520341372,1.568032036805359,2.104856210748132,0.5719373262350903,19884,19801,Dubois+Pike+Spencer,Spencer,18,147,Indiana,IN
18039,18CS018,1489,1400,1578,1781,203,292,381,565.23394268192,331,640.3342893208297,-2.606448748983265,-0.7529371970733262,0.9485558570023621,1.1290018814310463,1833,1726,1939,2092,153,259,366,125.36402996112784,219,105.84363174149021,-0.3186648043769099,0.19202992183661186,0.7307467158128931,0.841047864868666,206767,206909,Elkhart,Elkhart,18,39,Indiana,IN
18041,18CS019,282,272,292,344,52,62,72,1066.8071967939566,44,755.591808697892,1.454129979030579,3.1280123227707626,4.921280386887941,0.6970534432324332,345,333,357,390,33,45,57,193.4238493031828,61,261.17485870868296,-1.1844564141019747,-0.677139454333126,-0.179440328476104,1.3210304470375183,23293,23356,Fayette+Franklin+Union,Fayette,18,41,Indiana,IN
18047,18CS019,187,177,197,249,52,62,72,1089.7500377168315,30,526.9166593483798,3.988515410434814,5.641025735799978,7.366200744743201,0.47585119883720084,231,219,242,263,21,32,44,141.59375957659455,36,157.68034689676318,-0.6853303412032824,-0.16128053466421868,0.3423234619033996,1.0801964472609895,22774,22831,Fayette+Franklin+Union,Franklin,18,47,Indiana,IN
18161,18CS019,64,63,65,94,29,30,31,1684.9765283542072,1,56.401579244218844,15.902632096646396,16.28903236877986,16.677553766658434,0.03238904807526467,78,78,79,89,10,11,11,150.3652981155073,19,269.38891251949525,-1.3128400283083705,-1.1886187936311419,-1.0594179118260147,1.6371880226556248,7092,7053,Fayette+Franklin+Union,Union,18,161,Indiana,IN
18043,18CS020,722,687,756,830,74,108,143,539.4300511912459,87,434.0721707350538,-0.621600016806599,1.1027543840168468,2.754312230909188,0.7973121117820041,889,848,931,955,24,66,107,81.43246096052519,95,118.08283199920449,-0.8900370690277314,-0.3761706664958066,0.14693008165181454,1.4282698060820918,80171,80452,Floyd,Floyd,18,43,Indiana,IN
18045,18CS021,189,182,196,227,31,38,45,927.3514326325849,26,631.8731393158758,1.1416515324739447,2.966023989944709,4.6518888712924,0.6639734359218376,231,222,239,258,19,27,36,165.26904945543822,34,206.90074849388424,-0.9586571851624627,-0.398189957412989,0.07737064018749466,1.2074436959010453,16459,16433,Fountain+Montgomery+Warren,Fountain,18,45,Indiana,IN
18107,18CS021,354,337,370,405,35,51,68,542.0669148224855,63,663.2277081798084,-2.9602899833295924,-1.17920301341511,0.542938214281375,1.2002072074532069,436,416,455,488,33,52,72,137.72962645613003,63,165.5977289454316,-0.788636178281352,-0.298864860841894,0.242901481022769,1.1798225823067374,37996,38044,Fountain+Montgomery+Warren,Montgomery,18,107,Indiana,IN
18171,18CS021,73,72,74,105,31,32,33,1528.3416455226409,8,381.08848398237467,11.070195418679411,11.463470198825442,11.88381356230026,0.2418108343325972,90,89,91,98,7,8,9,90.06260886080608,11,129.9314906685566,-0.5306684728439082,-0.39758718073688504,-0.2664507545845497,1.275406611877718,8397,8466,Fountain+Montgomery+Warren,Warren,18,171,Indiana,IN
18049,18CS022,212,204,221,237,16,25,33,484.32580816340067,31,608.6785784409974,-2.9073202042183706,-1.2425708274274028,0.5263989340621401,1.20779000821389,260,249,271,293,22,33,44,161.73851293192868,41,201.049379689109,-0.8964268938477468,-0.4025594483119607,0.10536066161723519,1.2064737045297134,20372,20393,Fulton+Miami+Wabash,Fulton,18,49,Indiana,IN
18103,18CS022,334,318,349,387,38,53,69,591.603418353842,37,412.52055634529086,0.03189635353292775,1.8292396152361037,3.4520831497377182,0.6843944611638026,412,393,430,521,91,109,128,303.24609935937497,77,213.54484441732765,0.3689682223266211,0.8898011643402477,1.425473649834056,0.6978147075579582,35877,36058,Fulton+Miami+Wabash,Miami,18,103,Indiana,IN
18169,18CS022,379,366,392,434,42,55,68,714.4136883748641,54,699.0065046438626,-1.5869549916461914,0.15248731822614406,1.8950962166611092,0.9610209295018913,462,446,477,530,53,68,84,222.0840607077639,62,201.1289171478622,-0.3345126406045387,0.21765525711602646,0.7311959522337043,0.8926047795026834,30901,30826,Fulton+Miami+Wabash,Wabash,18,169,Indiana,IN
18051,18CS023,306,292,321,382,61,76,90,912.2502963905551,71,857.7209990637551,-1.2024132316083147,0.5685568911699788,2.228220435505198,0.9279371957992428,374,357,391,401,10,27,44,83.00100997279009,48,145.72833808974437,-1.142926232515104,-0.6183610957681248,-0.12918352197908448,1.6937865019435867,33111,32938,Gibson+Posey,Gibson,18,51,Indiana,IN
18129,18CS023,209,199,220,233,13,24,34,375.4545840389174,23,365.19530009526835,-1.6840641684448496,0.12406191823452159,1.8498913162432697,0.9332094035605947,256,243,269,255,-14,-1,12,-5.034941922099918,20,79.60832703100743,-1.4061565044602897,-0.8459992065887156,-0.36066377561530216,-75.49207838508937,25192,25123,Gibson+Posey,Posey,18,129,Indiana,IN
18053,18CS024,725,696,753,892,139,167,196,1008.6761945020854,120,723.5671862281046,1.2503507786332297,2.8079483873030453,4.630426000371535,0.7130806780712655,886,851,920,1121,201,235,270,355.0087807111018,144,217.22733443958367,0.8542710975965255,1.3627946876299764,1.9283340908079694,0.6093037619309001,66338,66290,Grant,Grant,18,53,Indiana,IN
18055,18CS025,323,309,336,367,31,44,58,572.9114008571374,55,710.0668108317465,-3.1418230897258432,-1.4319375576897557,0.3628561147457185,1.2120868908453355,394,378,410,448,38,54,70,175.5973453679812,40,129.92496833078897,-0.024246951956730604,0.4595398606528829,0.9985075032348746,0.7264649679895601,30983,30787,Greene+Owen+Parke+Putnam,Greene,18,55,Indiana,IN
18119,18CS025,207,205,209,259,50,52,54,978.5496522905215,23,432.880063990966,5.090584484427833,5.465805365921059,5.84660617761403,0.4340213123383622,256,254,259,77,-182,-179,-177,-836.8884661314739,21,98.02091112770725,-9.47249014685849,-9.347346337564153,-9.21946423782133,-0.11778233696188199,21253,21424,Greene+Owen+Parke+Putnam,Owen,18,119,Indiana,IN
18121,18CS025,142,135,149,150,1,8,15,196.09735849647723,13,319.2534381139489,-2.8439378641242747,-1.1474055863967279,0.4478343413511198,1.4468422739639393,176,168,185,194,9,18,26,109.65686999047685,31,189.37080024434943,-1.3091611034410036,-0.7865268114329846,-0.28266028177917213,1.6358122903215646,16288,16370,Greene+Owen+Parke+Putnam,Parke,18,121,Indiana,IN
18133,18CS025,310,295,326,363,37,53,68,571.6560258930626,38,412.70703231061634,-0.08580881287870706,1.6472806092762156,3.274777061628006,0.7084895693212787,384,365,403,441,38,57,76,154.80000076804563,51,138.08788887986353,-0.37247235710145626,0.17991870589212558,0.6949278595434997,0.8767061604683,36830,36933,Greene+Owen+Parke+Putnam,Putnam,18,133,Indiana,IN
18057,18CS026,1638,1488,1788,1971,183,333,483,382.19711826732873,274,314.8638127824366,-1.0570384309585064,0.656408573537032,2.3067917243809752,0.8213561698657075,2086,1902,2270,2313,43,227,411,63.83963014755357,168,47.255390067929625,-0.35980961900525776,0.17359691753438625,0.6842490391666834,0.7369731406420762,348087,355515,Hamilton,Hamilton,18,57,Indiana,IN
18059,18CS027,603,569,638,659,21,56,90,278.9872447302551,81,404.82288998563126,-2.924535428805452,-1.2131698128544304,0.6016199585013343,1.4255077100544133,752,710,794,918,124,166,208,203.13687033773053,104,127.52755944133119,0.263961749190444,0.7472226551970758,1.276340337193259,0.6240244026148347,80035,81551,Hancock,Hancock,18,59,Indiana,IN
18063,18CS028,1104,1029,1180,1288,108,184,259,419.5696987241663,189,431.7310932048039,-1.8502498619857672,-0.13565519353854769,1.6082584132038376,1.0234135582716368,1391,1299,1483,1460,-23,69,161,38.524119744040306,157,87.80907957068631,-1.0091256879172672,-0.495658536076379,0.05881236406477519,2.2467095957404504,175109,178797,Hendricks,Hendricks,18,63,Indiana,IN
18065,18CS029,514,493,535,622,87,108,129,887.4373425450733,63,516.7640725930482,1.9835364009464467,3.7383334081143667,5.402424101288068,0.5769774722508351,628,603,653,734,81,106,131,216.47958905239244,109,222.77632439502943,-0.5659009339091211,-0.08461901136488673,0.4161688039361104,1.019462060751958,48765,48928,Henry+Rush,Henry,18,65,Indiana,IN
18139,18CS029,170,162,177,183,6,13,21,321.89423587043535,17,406.7958841828189,-2.5960184044251524,-0.8688559837926749,0.826237901421515,1.1763110237186944,206,198,215,220,5,14,22,81.3878982075745,21,125.88418654837548,-0.9422768080160796,-0.4521096449866285,0.058804274560835326,1.4406128766609798,16716,16682,Henry+Rush,Rush,18,139,Indiana,IN
18067,18CS030,922,886,958,1064,106,142,178,681.6580918237181,137,656.3974798169753,-1.517615793340199,0.23150666658014274,1.9114680405186033,0.9562213351212643,1129,1085,1172,1334,162,205,249,245.52330912040242,184,219.89316060566222,-0.23724202327077223,0.23683169261887718,0.8228682430269796,0.8912719029299957,83486,83677,Howard+Tipton,Howard,18,67,Indiana,IN
18159,18CS030,163,157,170,186,16,23,29,596.0178271012351,36,939.2121054004697,-5.0646824974265225,-3.483995748942654,-1.7180513223127636,1.5097274689327158,200,192,208,230,22,30,38,195.73440190121977,36,234.20727343699176,-0.901651195246911,-0.38735884766267253,0.16858487468937916,1.1580651143662832,15332,15371,Howard+Tipton,Tipton,18,159,Indiana,IN
18069,18CS031,357,341,372,426,54,69,85,757.1077355512654,44,480.8349042428216,0.9859023028606559,2.782198569251801,4.398516208736274,0.6260579302008898,438,419,457,520,63,82,101,223.5429760708448,71,193.46049046321525,-0.2417854902378609,0.28971555533066917,0.8017158774452102,0.8550068310663587,36603,36700,Huntington+Whitley,Huntington,18,69,Indiana,IN
18183,18CS031,277,262,291,305,14,28,43,331.9416169599115,27,315.20882584712376,-1.6301610673908742,0.19280538040814274,1.9296750289367062,0.9173286733189112,341,324,359,385,26,44,61,126.8666134526403,40,116.2351436956964,-0.41103546469091307,0.10665206643319347,0.6210418834110296,0.8956839917612225,34263,34413,Huntington+Whitley,Whitley,18,183,Indiana,IN
18071,18CS032,430,410,450,474,24,44,64,379.6282863324295,50,434.58421155559415,-2.2227241762451433,-0.5562030995830279,1.130863611075514,1.1191394841859736,525,502,549,567,18,42,65,90.37196596889694,48,104.09437890353921,-0.6568736374694559,-0.1254347356295474,0.37095157887580454,1.1248509322698244,46021,46112,Jackson+Washington,Jackson,18,71,Indiana,IN
18175,18CS032,272,260,284,293,9,21,33,295.24097997351424,19,269.6469753414937,-1.334483615995797,0.2885652477990217,2.003468762846895,0.8714230214241883,331,317,346,397,51,66,80,232.99572820941364,44,156.477826380739,0.24756675175225853,0.7642608395146467,1.252706321389809,0.661494294292118,28185,28119,Jackson+Washington,Washington,18,175,Indiana,IN
18077,18CS033,331,316,345,382,37,51,66,622.6407725632563,45,546.0502366217693,-1.1465505302050352,0.6990793823230949,2.4124619696922407,0.860226135910802,406,389,423,427,4,21,38,62.69533543306295,75,226.3740907307356,-2.1753456209915534,-1.6301048091815389,-1.1206583057591342,3.444856096826527,32964,33131,Jennings+Jefferson,Jefferson,18,77,Indiana,IN
18079,18CS033,262,250,274,300,26,38,50,549.6995949174801,30,435.3820477468979,-0.5459308736855045,1.1799788215687579,2.7582343981604707,0.7716634761748826,320,306,334,346,12,26,40,95.50862746662314,32,116.65208515602218,-0.7224468759364374,-0.21921135656538596,0.26017602708461823,1.176473759236745,27562,27432,Jennings+Jefferson,Jennings,18,79,Indiana,IN
18081,18CS034,1213,1143,1282,1462,180,249,319,616.3776320382217,223,551.1650467439863,-1.1180182839715076,0.6718404923695698,2.321712146920724,0.8906289694033099,1508,1423,1592,1742,150,234,319,142.95943848499016,199,121.34960271725542,-0.3189199048942496,0.21129302970224725,0.7256200870900809,0.8452340246051055,161839,163989,Johnson,Johnson,18,81,Indiana,IN
18085,18CS035,626,592,661,679,18,53,87,264.04994327601065,67,335.1382445258669,-2.558621677447006,-0.6759132536364034,1.0214451890861798,1.245626259128063,772,730,813,924,111,152,194,190.3159370853582,97,121.10165047816426,0.21567893754610554,0.6724242837385862,1.2002111507552484,0.6321719776996604,79967,80098,Kosciusko,Kosciusko,18,85,Indiana,IN
18087,18CS036,252,234,269,308,39,56,74,556.2444556586057,72,712.7477912242928,-3.2812468239490906,-1.5404976862322997,0.12903517076428178,1.2589520165640393,314,293,335,313,-22,-1,20,-2.694764752522308,32,78.96749993830664,-1.3526033517895464,-0.823603854630522,-0.2991049678124229,-347.8278991980435,40407,40523,LaGrange+Noble,LaGrange,18,87,Indiana,IN
18113,18CS036,395,375,415,437,22,42,62,353.2692539950767,47,396.29005059021927,-2.312900935428455,-0.39650973704028475,1.357504719180336,1.0956289794169753,486,461,510,552,42,66,91,139.98355731064507,59,124.87036762682808,-0.3651046740034244,0.13636882073979717,0.6851965932129965,0.878749922018842,47440,47249,LaGrange+Noble,Noble,18,113,Indiana,IN
18089,18CS037,4383,4170,4597,5247,650,864,1077,695.2901261432373,627,504.84006352772093,0.16379499691299637,1.879588439264108,3.67620055261696,0.7252456209523018,5395,5138,5652,6032,380,637,894,127.76184341193522,617,123.7554255822723,-0.4663773939930968,0.031898839845232986,0.5901561851014717,0.96712320772274,496791,498564,Lake,Lake,18,89,Indiana,IN
18091,18CS038,1061,1013,1109,1271,162,210,258,750.9316327964656,130,464.60928146387664,0.927543667176149,2.91713200213004,4.572361724175785,0.6157798060606727,1301,1243,1359,1366,7,65,123,57.49686914628781,107,95.22453411174199,-0.9138816985814587,-0.38326692846078875,0.13700983054427027,1.6309252202891913,111922,112366,LaPorte,LaPorte,18,91,Indiana,IN
18093,18CS039,463,443,482,545,63,82,102,729.5308767112741,82,727.5146944660087,-1.6652512410345184,-0.035018762020756246,1.7321927551296554,0.9852542411658377,565,542,588,733,145,168,191,372.48530226240433,108,239.6644697423607,0.8221177203311002,1.3404364521578216,1.8724708226721194,0.6396094051913318,45085,45063,Lawrence+Orange,Lawrence,18,93,Indiana,IN
18117,18CS039,203,195,212,264,52,61,69,1226.0343508222331,35,706.6424389259034,3.5876509267933647,5.221832150622777,6.9042304622496244,0.5670267644464319,248,238,259,310,51,62,72,310.8400485350066,39,196.66179214361352,0.633332424328198,1.139937661091146,1.6607202021370278,0.6225786278406907,19812,19831,Lawrence+Orange,Orange,18,117,Indiana,IN
18095,18CS040,1303,1247,1359,1558,199,255,311,785.0572017769458,227,698.2198469760468,-0.7263285932374045,0.8484672476232975,2.5507790181660512,0.8859162015835598,1602,1534,1669,1950,281,348,416,266.59241787073137,261,199.72910305562573,0.17131069778293842,0.6773889408960223,1.2066271674803035,0.7470483563427925,130045,130677,Madison,Madison,18,95,Indiana,IN
18097,18CS041,7153,6733,7572,8757,1185,1604,2024,658.6474487102453,1268,520.5831516629512,-0.10024598088308415,1.3677627260083147,3.1059755282683432,0.7898897351959403,8768,8266,9270,10250,980,1482,1984,152.47044401070556,1003,103.19683845219146,-0.022168062754373864,0.4852434262107412,1.008359420957587,0.6763753335825966,974292,971929,Marion,Marion,18,97,Indiana,IN
18099,18CS042,392,372,412,515,103,123,143,1065.7703755386312,74,642.7098034958202,2.5216899995679456,4.240984731362683,5.916835104856836,0.5981724863108535,483,459,507,541,34,58,82,125.26792981396677,71,153.99297271504793,-0.772227543653983,-0.2930442922503468,0.21176618794736343,1.2083865761785102,46055,46106,Marshall+Pulaski+Starke,Marshall,18,99,Indiana,IN
18131,18CS042,145,140,151,163,12,18,23,562.5545747140121,28,899.0928795054989,-5.134675557592061,-3.3573076085449673,-1.5688935978970795,1.511931637219254,176,170,183,211,28,35,41,280.0187649285147,33,266.9686918534099,-0.40334781689456173,0.1323614336062518,0.6610520823212834,0.9266248066135856,12457,12361,Marshall+Pulaski+Starke,Pulaski,18,131,Indiana,IN
18149,18CS042,236,226,246,296,50,60,70,1025.715241062251,49,840.949071094521,0.23506558413140957,1.824427358049743,3.5590954868764637,0.8063738048835778,290,278,302,374,72,84,96,359.4032755937135,42,179.7175866495507,1.2728385552611128,1.8036103890945654,2.324307573846467,0.4941609849408625,23307,23370,Marshall+Pulaski+Starke,Starke,18,149,Indiana,IN
18105,18CS043,801,741,861,1017,156,216,276,613.2946076408626,113,320.98397210564065,1.164657267558076,2.939083282894204,4.552216500909052,0.5209635576294934,988,916,1060,1162,102,174,246,124.423417551601,116,82.96203056721713,-0.0896713546986906,0.40571957988746876,0.9225557982232034,0.6629611136348766,140817,139823,Monroe,Monroe,18,105,Indiana,IN
18109,18CS044,626,595,656,720,64,94,125,527.0344175574199,93,519.2629815745394,-1.833453153030423,0.0684744023779922,1.79504058743526,0.9749259100345613,774,737,811,903,92,129,166,178.85120099089409,112,155.23861006001636,-0.3224751842966946,0.23185479279754317,0.741062379929282,0.8613014315242996,71640,72147,Morgan,Morgan,18,109,Indiana,IN
18127,18CS045,1337,1262,1411,1602,191,265,340,613.0632571629211,180,416.25474790571826,0.21812038329391625,1.9861436578401697,3.62686239643623,0.6764236732083606,1656,1566,1746,1902,156,246,336,141.50333367650856,192,110.28208088501371,-0.2595571270814962,0.314852736623149,0.8112779610147635,0.776209537018902,172971,174099,Porter,Porter,18,127,Indiana,IN
18141,18CS046,2343,2226,2461,2802,341,459,576,673.4642623854472,372,546.2775662747027,-0.5066272880839466,1.291255192291995,2.97616670170415,0.8093807359279258,2874,2734,3015,3115,100,241,381,88.39470650059309,250,91.8236545079905,-0.5381186543092956,-0.03454189168929678,0.481199561618286,1.034492838723563,272389,272261,St. Joseph,St. Joseph,18,141,Indiana,IN
18157,18CS047,1032,951,1112,1164,52,132,213,282.233161380749,83,176.97982856411787,-0.6119869352452412,0.9887864877430415,2.6219426479493646,0.6223675538472354,1277,1181,1374,1497,123,220,316,117.48687232140979,167,89.32630846995266,-0.23528947276768225,0.28139520844089927,0.7974570057754161,0.7568630409356226,187592,186955,Tippecanoe,Tippecanoe,18,157,Indiana,IN
18163,18CS048,1697,1619,1774,2038,264,341,419,757.2426332778188,247,547.8388643987912,0.39347995578497025,2.1136161620628253,3.8233834237625133,0.7213525773857902,2076,1983,2169,2334,165,258,351,143.3598714515157,219,121.65855609626024,-0.2769980688543923,0.21858553780011325,0.7200546442883972,0.8453477846914401,180345,180012,Vanderburgh,Vanderburgh,18,163,Indiana,IN
18173,18CS049,529,502,557,661,104,132,159,824.2013161318488,85,532.4146570623238,1.1555288132021224,2.9462695228364,4.56991362441139,0.6411042554899962,657,624,691,722,31,65,98,100.29847932373558,73,113.29422354657478,-0.635115836999687,-0.13036841190227932,0.39175089117363443,1.112358541344571,63860,64434,Warrick,Warrick,18,173,Indiana,IN
18177,18CS050,764,736,793,935,142,171,199,1028.5350019660177,131,789.3943959023802,0.734859647499572,2.448966082802773,4.024703670289944,0.7630236032400006,934,900,969,1028,59,94,128,140.88983539624581,113,170.03731792464188,-0.8435406330484478,-0.2772086242388411,0.2096581990571014,1.1941276520446993,66380,66456,Wayne,Wayne,18,177,Indiana,IN
19005,19CS001,158,152,164,169,5,11,17,307.46202931453934,27,771.7041800643086,-6.36339813828136,-4.623369557548983,-2.7972448066867814,2.2964401922473123,192,185,199,169,-30,-23,-16,-165.5317139885511,20,143.40001434000143,-3.6084440779399434,-3.1008728621488517,-2.5750081448693547,-0.905521993779557,13995,13947,Allamakee+Clayton+Winneshiek,Allamakee,19,5,Iowa,IA
19043,19CS001,165,158,172,197,25,32,39,748.4307407630569,43,1007.6747319702384,-4.327410766771817,-2.560694530838982,-0.7717973940148898,1.3055063824053355,201,193,210,223,13,22,30,127.09319132448687,16,94.12872102600306,-0.18693200330861523,0.33845801898670885,0.8573713872776094,0.7078612207892518,17069,16998,Allamakee+Clayton+Winneshiek,Clayton,19,43,Iowa,IA
19191,19CS001,166,157,175,161,-14,-5,4,-98.58342826247284,22,439.7581330268353,-7.125137460812085,-5.360289115285742,-3.6115232237208263,-5.595284253370821,203,192,213,202,-11,-1,10,-3.0599189750773954,16,80.35355564483729,-1.3376561333283843,-0.841902183127664,-0.2989437196309107,40.951200806169325,20011,19912,Allamakee+Clayton+Winneshiek,Winneshiek,19,191,Iowa,IA
19001,19CS002,90,89,91,98,7,8,9,420.27461960353105,16,861.4887602638308,-4.833418594392416,-4.41526205572639,-4.006690557772583,1.817035769826627,112,111,113,130,17,18,19,241.61418819009768,19,252.25703664365375,-0.23090522764784874,-0.10515531006652204,0.028619337852224307,0.9896668027346419,7429,7532,Audubon and Nearby Counties,Adair,19,1,Iowa,IA
19009,19CS002,73,72,73,68,-5,-5,-4,-349.1931812786009,4,283.63765289842223,-6.740629971965555,-6.323748743649403,-5.93211919856018,-1.019238940459467,89,88,90,82,-8,-7,-6,-126.27678632440092,4,70.92198581560284,-2.0873776287827783,-1.9719563590674603,-1.8482931092115225,-0.653380100786636,5641,5640,Audubon and Nearby Counties,Audubon,19,9,Iowa,IA
19029,19CS002,172,166,177,205,28,33,39,1021.7344004393036,41,1256.0312476066479,-4.082178772552018,-2.369713744072357,-0.6405416264632946,1.1935270602851613,209,202,215,203,-12,-6,1,-43.832322486772036,25,191.45351508653698,-2.898800187772759,-2.331965045981132,-1.8496975440535912,-5.29254581911821,13057,13058,Audubon and Nearby Counties,Cass,19,29,Iowa,IA
19077,19CS002,104,103,105,133,28,29,30,1081.4014569485885,20,752.8703180877094,2.8641009456219444,3.293475412622626,3.6916178508034543,0.6727793219679882,127,126,128,127,-1,-0,1,-0.14657568460303153,14,132.40022697181766,-1.4679291194234028,-1.3257206329490696,-1.1921395984286425,14.220400752523174,10626,10574,Audubon and Nearby Counties,Guthrie,19,77,Iowa,IA
19165,19CS002,128,127,129,162,33,34,35,1158.1083880799206,28,959.3969504882646,1.54741139876955,1.9830986804645314,2.4135144240939876,0.8046117285349865,158,156,159,150,-9,-8,-6,-67.8414188442169,13,110.54421768707483,-1.9039842587765217,-1.7857370728431772,-1.6572343548138764,-1.862957718759174,11674,11760,Audubon and Nearby Counties,Shelby,19,165,Iowa,IA
19011,19CS003,212,201,223,267,44,55,66,858.8033391075164,41,641.8033107658592,0.3372732506203898,2.179472693010009,3.7817723107836696,0.7339448974948161,263,250,276,235,-41,-28,-15,-108.52670989380135,14,54.54262116253701,-2.138603208329662,-1.631482381786757,-1.1157702177689444,-0.5212864356672628,25553,25668,Benton+Iowa (county)+Keokuk+Washington,Benton,19,11,Iowa,IA
19095,19CS003,171,164,179,195,16,24,31,568.0997945805996,22,530.4400241109103,-1.295878906368688,0.317756101297532,2.088038039820542,0.8956947583701579,210,201,219,214,-5,4,13,24.484056894696856,14,84.4187168355041,-1.1135459420181426,-0.6009264368803203,-0.08931917739947716,2.7665600380442426,16590,16584,Benton+Iowa (county)+Keokuk+Washington,Iowa (county),19,95,Iowa,IA
19107,19CS003,100,99,101,128,27,28,29,1125.8138369034693,26,1038.4423364952572,0.46270045324505976,0.8700624135034106,1.290207307232394,0.8907903397535132,122,120,123,156,33,34,36,347.2272396979421,18,181.34193028410238,1.5341730502158344,1.6578591571318224,1.7936222541036733,0.5075315452058322,10015,9926,Benton+Iowa (county)+Keokuk+Washington,Keokuk,19,107,Iowa,IA
19183,19CS003,217,207,226,263,37,46,56,824.756205431444,32,570.4354026471767,0.9362680458856673,2.548680019123852,4.333790592121931,0.6770085185538964,267,255,278,265,-13,-2,10,-7.495893607541393,34,151.1514181559527,-2.09556181921195,-1.5967318418909784,-1.093489538080893,-49.55355828743099,22439,22494,Benton+Iowa (county)+Keokuk+Washington,Washington,19,183,Iowa,IA
19013,19CS004,1050,994,1106,1302,196,252,308,769.4938101772631,239,730.1500015275104,-1.3951597868472652,0.3911781133055308,2.050389919391858,0.945118252892768,1289,1222,1357,1450,93,161,228,123.06157814592649,141,108.08159010248589,-0.3600432324664588,0.15352789692944718,0.6586787436113618,0.8728356299427857,130932,130457,Black Hawk,Black Hawk,19,13,Iowa,IA
19015,19CS005,252,241,264,284,20,32,43,478.95365729791024,15,225.19986488008107,0.8098293783435937,2.5697278048498715,4.31945263714602,0.4559006436827839,308,294,322,334,12,26,40,96.518171422538,27,101.05546822366944,-0.5757564410900755,-0.04010208420612099,0.4630668822233251,1.007924336949255,26643,26718,Boone+Carroll+Greene,Boone,19,15,Iowa,IA
19027,19CS005,204,195,213,239,26,35,44,673.7901781982208,36,698.4866123399302,-1.84192508437623,-0.271849637591335,1.369441545145301,1.007637168032139,250,239,260,281,21,31,42,151.8588501595714,10,48.32552070748562,0.5250333309139474,1.0366847539388602,1.5296470705205776,0.3084120763464237,20616,20693,Boone+Carroll+Greene,Carroll,19,27,Iowa,IA
19073,19CS005,99,98,100,85,-15,-14,-13,-632.709327469465,4,182.58587241812162,-8.56727785421268,-8.152754829582621,-7.761651441628957,-0.31101588101764277,120,119,121,130,9,10,11,111.76360584489399,10,114.66574934067195,-0.15451765621458963,-0.03013691846321807,0.09232960857336718,0.9305005366043297,8763,8721,Boone+Carroll+Greene,Greene,19,73,Iowa,IA
19017,19CS006,203,192,213,272,59,69,80,1110.1963772488843,44,703.6059806508356,2.3156449938207864,4.027505906591462,5.80890777943774,0.6247681040839214,251,238,264,254,-10,3,16,11.873401916809843,23,91.76142030720128,-1.3302498840139843,-0.8043080002605374,-0.2609649640686855,5.784609040471777,25014,25065,Bremer+Butler+Grundy,Bremer,19,17,Iowa,IA
19023,19CS006,164,158,170,153,-17,-11,-5,-315.366064534245,22,614.2248900677043,-11.051591252203934,-9.298309239851083,-7.677052631613003,-2.136830168315954,201,194,209,199,-10,-2,5,-17.143376441986245,21,146.55593551538837,-2.1866388277498885,-1.6335049475932866,-1.1411913204958806,-14.418378963921066,14327,14329,Bremer+Butler+Grundy,Butler,19,23,Iowa,IA
19075,19CS006,124,123,126,142,16,18,19,571.6301659336501,26,845.322279118914,-3.138074138886542,-2.7181550223792277,-2.3524308895895336,1.3992099436295304,154,152,155,147,-8,-7,-5,-53.669863566040426,3,24.307243558580456,-0.9055732570046489,-0.7776703039763657,-0.6623421620899975,-0.5334343718422443,12303,12342,Bremer+Butler+Grundy,Grundy,19,75,Iowa,IA
19019,19CS007,173,164,182,191,9,18,27,344.3071105366504,22,425.63482466747274,-2.4285515272028237,-0.8207905870891313,0.8598837225235642,1.1704385251292853,212,202,223,223,-0,11,21,51.22632477698912,20,96.86637283866905,-0.9826434332654707,-0.45755930229442154,0.05412696122425578,1.727608148226216,20675,20647,Buchanan+Delaware+Fayette,Buchanan,19,19,Iowa,IA
19055,19CS007,151,143,158,187,29,36,44,830.5144801603723,32,735.4208560758402,-0.7836208267163997,0.932197235780788,2.6126273197791012,0.8616566767719777,186,177,195,189,-6,3,12,19.220879058971686,23,131.4135527368301,-1.6252208751227577,-1.118329949591493,-0.5968932112486054,5.270347936274284,17405,17502,Buchanan+Delaware+Fayette,Delaware,19,55,Iowa,IA
19065,19CS007,210,201,218,250,32,40,49,829.625533033036,26,535.8062854198866,1.2124298895104264,2.9365449019245333,4.750072215475208,0.6301872440462905,254,244,264,273,9,19,29,96.36013449769476,30,155.60973079516572,-1.092660100129596,-0.5896075662710102,-0.08663815339397059,1.5323893216266515,19410,19279,Buchanan+Delaware+Fayette,Fayette,19,65,Iowa,IA
19031,19CS008,155,147,163,181,18,26,34,561.8995599675408,18,389.3365057048613,0.05458677221861871,1.7248252913197935,3.5746975382204758,0.6672097901095054,189,179,198,213,15,24,34,130.87623796404804,5,27.14146129627619,0.5212333032620673,1.0244933827449332,1.5421688751165359,0.19912369201384003,18493,18422,Cedar+Clinton+Jackson+Jones,Cedar,19,31,Iowa,IA
19045,19CS008,471,451,491,531,40,60,80,519.0122519632796,71,611.5022716017484,-2.689072124592525,-0.9606252167972602,0.7529342207105822,1.1589714625811354,574,550,598,611,13,37,61,79.62503839736358,47,101.17100051661788,-0.7386928435963382,-0.21974719025454467,0.270452712777045,1.2371478814070933,46443,46456,Cedar+Clinton+Jackson+Jones,Clinton,19,45,Iowa,IA
19097,19CS008,191,182,199,223,24,32,41,667.8460741198519,32,659.0803769115905,-1.6451371198993097,0.15691263505090022,1.7798151278288379,0.9573501548994158,232,222,242,269,27,37,47,191.62406924983847,27,139.33326452678295,-0.02071406568076775,0.5221399270415349,1.0426980004952215,0.7080497786640478,19421,19378,Cedar+Clinton+Jackson+Jones,Jackson,19,97,Iowa,IA
19105,19CS008,173,164,182,210,28,37,46,722.0106554176641,48,929.2420869228536,-3.784781306249962,-2.0771655022377677,-0.26410194448615665,1.2534122711051567,212,202,223,242,19,30,40,142.58931605924727,14,67.3659897988644,0.1847345724119439,0.7309588096207468,1.2847933765100454,0.4570247893448579,20662,20782,Cedar+Clinton+Jackson+Jones,Jones,19,105,Iowa,IA
19033,19CS009,449,430,467,533,66,84,103,787.86948476295,67,625.1895397391933,-0.18730122028766955,1.6013844429333701,3.2578162851179813,0.7842310747567881,548,526,570,601,31,53,75,124.91332367471212,63,147.38910724312183,-0.7266303240877763,-0.2264295714626341,0.2704772074151276,1.158238315056008,42867,42744,Cerro Gordo+Hancock+Winnebago,Cerro Gordo,19,33,Iowa,IA
19081,19CS009,101,100,102,120,18,19,20,721.46281582563,20,745.2953232718464,-0.6397081635415406,-0.23230515861670759,0.14902698577599083,0.9822963352905145,123,122,124,154,30,31,32,290.4222008320204,16,149.85482813524396,1.2732381167150877,1.4062802241289114,1.5288502738208092,0.49986912203525885,10734,10677,Cerro Gordo+Hancock+Winnebago,Hancock,19,81,Iowa,IA
19189,19CS009,111,110,112,137,25,26,27,992.4179107416475,24,904.9773755656109,0.4770578953695236,0.8787303207696499,1.2752327453833452,0.8785119386392031,136,135,138,126,-12,-10,-9,-98.0909330709326,11,103.23791647114031,-2.1361960227312964,-2.0124551049909036,-1.8809406207055333,-1.1638254789337383,10608,10655,Cerro Gordo+Hancock+Winnebago,Winnebago,19,189,Iowa,IA
19049,19CS010,481,438,524,557,33,76,119,303.57723275024676,63,252.426600955615,-1.148275170768544,0.5225864370148243,2.187996945613015,0.8206753196320797,617,564,670,585,-85,-32,21,-31.118400377516284,46,44.524890381655744,-1.2814780362720273,-0.7598415621940782,-0.22616759688375984,-1.4767561954351685,99831,103313,Dallas,Dallas,19,49,Iowa,IA
19051,19CS011,81,80,82,91,9,10,11,452.5099820136154,20,879.4107947675058,-4.680683519687228,-4.264392270132838,-3.8936571352818157,1.7712896201128354,100,99,101,82,-19,-18,-17,-195.15254401692886,2,21.89621195533173,-2.2960133656658614,-2.172008710948435,-2.0421348165102,-0.11886907931428108,9097,9134,Davis+Jefferson+Van Buren+Wapello,Davis,19,51,Iowa,IA
19101,19CS011,137,130,143,178,35,41,48,1034.433173348056,25,624.02496099844,2.3519450302381397,4.155395743467824,5.81032120162125,0.5890394506751355,166,158,174,183,9,17,25,109.9501528032312,15,95.85277014505719,-0.3503454615116287,0.13823548397272037,0.6457715498974157,0.8238997085760631,16025,15649,Davis+Jefferson+Van Buren+Wapello,Jefferson,19,101,Iowa,IA
19177,19CS011,81,81,82,80,-2,-1,-1,-80.51005745334065,13,723.7299930410578,-8.457155448920624,-8.05047832039954,-7.669599626249238,-29.137404596569272,101,100,102,91,-11,-10,-9,-135.25795698498598,4,55.27152134862512,-2.037571191674318,-1.905869814745345,-1.774081584615593,-0.45513411119551445,7185,7237,Davis+Jefferson+Van Buren+Wapello,Van Buren,19,177,Iowa,IA
19179,19CS011,358,343,373,456,83,98,113,1109.7647437986357,95,1076.3652843870384,-1.4783324990003088,0.3599312848482203,1.9184674236950139,0.9601018431955379,439,420,457,469,12,30,49,85.9992872660045,60,170.12589316093909,-1.3356334599300372,-0.8428952203077279,-0.3180251401514545,1.915083375320509,35304,35268,Davis+Jefferson+Van Buren+Wapello,Wapello,19,179,Iowa,IA
19057,19CS012,391,374,407,434,27,43,60,445.1085237882981,42,432.6774492634181,-1.6788907946362,0.07598907695410695,1.8084051279362863,0.9500825625383491,475,456,495,549,54,74,93,190.78161349635857,63,163.46228691523314,-0.24094625087001004,0.25582963029736927,0.7984703791659503,0.845306930937249,38828,38541,Des Moines+Henry+Lee,Des Moines,19,57,Iowa,IA
19087,19CS012,190,181,199,246,47,56,65,1097.5099541163795,35,688.8068880688808,2.3566089936458776,4.11318208029278,5.68547255780568,0.6165529543047537,234,223,244,250,6,16,27,79.60922726466328,23,112.79486047766171,-0.847622303410906,-0.33664273412684415,0.17042301311281377,1.3346395368051556,20325,20391,Des Moines+Henry+Lee,Henry,19,87,Iowa,IA
19111,19CS012,365,350,379,439,60,74,89,888.1529924488574,33,394.02985074626866,3.1980212030709687,4.965060060130662,6.793598949850191,0.43776556797532024,443,426,460,509,49,66,83,198.52654529771374,75,225.50965181309758,-0.7596284363862561,-0.26892578188948124,0.2515587458864364,1.1189694522996767,33500,33258,Des Moines+Henry+Lee,Lee,19,111,Iowa,IA
19061,19CS013,794,751,837,867,30,73,116,295.01667519767835,151,610.6314576298603,-4.980263182485166,-3.143669907453176,-1.3837492502177817,2.0418319019208586,974,923,1025,1052,27,78,129,79.08252711853788,100,101.22174648001378,-0.7042741248640167,-0.2120026557328135,0.2997587379673983,1.2637751328951834,98914,98793,Dubuque,Dubuque,19,61,Iowa,IA
19069,19CS014,103,102,104,135,31,32,33,1263.2169488926631,18,720.4322593556134,5.048485678540326,5.428954664848586,5.826591207553699,0.5528005024724273,127,125,128,168,40,41,43,415.46675845639925,16,160.69097117605705,2.4170829964340785,2.5506522927920163,2.677821340139209,0.3776432804530628,9994,9957,Franklin+Hamilton+Hardin+Wright,Franklin,19,69,Iowa,IA
19079,19CS014,161,155,168,176,8,15,21,391.4309870948522,33,881.5279818351811,-6.68584215891306,-4.8311949568386225,-3.140643022080282,2.1081925702312927,197,189,205,193,-12,-4,4,-27.992715905815686,22,147.59157386287401,-2.2830063952636666,-1.749344569376417,-1.2192681339994456,-6.934388196168863,14974,14906,Franklin+Hamilton+Hardin+Wright,Hamilton,19,79,Iowa,IA
19083,19CS014,188,181,195,215,20,27,34,648.1067042988955,28,666.3890045814244,-1.8878974367394274,-0.19648333598376877,1.6390959524154531,0.9917885768764874,229,221,238,280,42,51,59,302.86748407293527,15,89.6914613728773,1.6258591727432574,2.144402852303296,2.65753887994773,0.2904075030890927,16807,16724,Franklin+Hamilton+Hardin+Wright,Hardin,19,83,Iowa,IA
19197,19CS014,159,153,164,161,-3,2,8,75.54692143784155,23,716.0647571606476,-8.06369035124652,-6.415982990195019,-4.666976707316672,6.712257258492758,193,187,200,189,-11,-4,2,-33.38492468681064,25,195.25148391127775,-2.8100273288242303,-2.2728896690831677,-1.73043838956184,-7.634506824929306,12848,12804,Franklin+Hamilton+Hardin+Wright,Wright,19,197,Iowa,IA
19071,19CS015,77,76,77,70,-7,-7,-6,-401.08421331307363,5,302.43459851807046,-7.430226304540618,-7.018301735917104,-6.682188867912563,-0.8879536161695175,93,92,94,97,3,4,5,57.873224079527105,12,182.75967103259214,-1.3707312787068393,-1.2482741402796291,-1.125378848742067,2.500022972574766,6613,6566,Fremont+Harrison+Mills+Pottawattamie,Fremont,19,71,Iowa,IA
19085,19CS015,169,162,175,235,60,66,73,1831.9039283260113,61,1684.6175089754213,-0.3244737176923685,1.4459261100837926,3.219077133781251,0.9059418330736484,208,200,215,193,-22,-15,-7,-98.9942559691834,20,136.50945327963962,-2.861077720975815,-2.3603240918642476,-1.8448110845205101,-1.4810812119284629,14484,14651,Fremont+Harrison+Mills+Pottawattamie,Harrison,19,85,Iowa,IA
19129,19CS015,112,110,113,136,23,24,26,662.7382284363563,16,440.8928079360706,1.8042444358038356,2.212097963112382,2.6348679714440184,0.6387029142030606,137,135,139,156,17,19,21,131.15441914767888,15,103.76314333148866,0.14511474108496092,0.27581045459837455,0.399076526818287,0.7515149477205216,14516,14456,Fremont+Harrison+Mills+Pottawattamie,Mills,19,129,Iowa,IA
19155,19CS015,807,767,847,994,147,187,227,799.779391531395,111,474.810450107474,1.618338965668934,3.245909715723111,4.958199211341245,0.5905184232781068,987,939,1036,1141,105,154,202,164.53680818142976,117,125.34684650903677,-0.16088510499994144,0.39280739448126145,0.9172315488625502,0.7568881571060087,93511,93341,Fremont+Harrison+Mills+Pottawattamie,Pottawattamie,19,155,Iowa,IA
19099,19CS016,337,321,354,388,34,51,67,537.3340092766676,58,615.2866917731926,-2.4935126868516506,-0.8181292177614014,0.9725686811631418,1.1229039607007356,413,393,432,448,16,35,55,93.01043547489093,29,76.78051363516018,-0.37520925544063505,0.16678581450734836,0.7008601035366818,0.8026561502001899,37706,37770,Jasper+Poweshiek,Jasper,19,99,Iowa,IA
19157,19CS016,185,177,193,194,1,9,17,183.35378452751138,25,537.345513164965,-5.251027801163383,-3.4871935604794513,-1.8147352306520288,2.6231476468715687,226,216,236,245,9,19,29,101.73026791094699,25,134.45197375497472,-0.8346435641279953,-0.34728245212555636,0.1758604341513031,1.255289412031321,18610,18594,Jasper+Poweshiek,Poweshiek,19,157,Iowa,IA
19103,19CS017,651,585,717,727,10,76,142,198.37055098671448,53,138.47701412204268,-1.1150911561300503,0.6216546639300233,2.195394120643015,0.6889975286935344,821,741,901,906,5,85,165,55.0385374264965,59,38.189926921309336,-0.35731220850300754,0.1573408988973884,0.6932845883621925,0.6858105700199689,153094,154491,Johnson,Johnson,19,103,Iowa,IA
19113,19CS018,1565,1466,1664,1921,257,356,455,619.6944814300573,266,463.24515421187374,-0.2799232817413364,1.5881989334841422,3.140484043052166,0.7454430557741062,1922,1804,2040,2075,35,153,271,66.75722733465521,177,77.24804915943648,-0.6202520598853706,-0.09900838051922449,0.41569311537683734,1.1496330549455205,229684,229132,Linn,Linn,19,113,Iowa,IA
19115,19CS019,93,92,94,111,17,18,19,675.1965655639167,30,1107.3175232998062,-4.750901624482273,-4.3173378645945215,-3.906024696814062,1.5549872288276723,113,112,114,122,8,9,10,82.89509824690865,20,185.9254438969973,-1.154116360267462,-1.0310592845831421,-0.9031501112208595,2.016733703014588,10837,10757,Louisa+Muscatine,Louisa,19,115,Iowa,IA
19139,19CS019,357,338,375,431,56,74,93,691.1875969716051,79,735.0546638753199,-2.1343795239290366,-0.4760555349672635,1.2810757252164189,1.0493404253369962,436,414,458,486,28,50,72,117.90900833735637,45,105.26315789473684,-0.3620626709748262,0.12419965320503495,0.6074295603807592,0.8753824753949548,42990,42750,Louisa+Muscatine,Muscatine,19,139,Iowa,IA
19007,19CS020,147,142,153,180,27,33,38,1064.888029920968,40,1299.2285830288267,-3.940811661797201,-2.335143285039473,-0.6812609707330967,1.1839489593124157,178,172,184,188,4,10,16,81.94428233330167,16,130.4950656553299,-1.0087644028402567,-0.4774473543287516,0.016846631579931493,1.4483323121030502,12315,12261,Lucas and Nearby Counties,Appanoose,19,7,Iowa,IA
19039,19CS020,97,96,98,100,2,3,4,111.03697784042684,4,165.25511258004545,-0.9678612475614264,-0.5093430732594016,-0.13897760709783377,1.0847016249518358,120,119,121,159,38,39,40,396.4449654489666,22,225.04091653027825,1.5852901514039406,1.7110744239187403,1.8432544445359824,0.5533691907765103,9682,9776,Lucas and Nearby Counties,Clarke,19,39,Iowa,IA
19053,19CS020,70,70,71,76,5,6,6,290.9481927036489,2,104.57516339869282,1.4327384336609927,1.8662693571254436,2.274468578498921,0.30467442847583376,86,85,87,99,12,13,14,166.5309227662677,15,196.02718243596442,-0.4367075141950855,-0.2934578601136122,-0.1660102656505136,1.0914690176844075,7650,7652,Lucas and Nearby Counties,Decatur,19,53,Iowa,IA
19117,19CS020,95,94,96,98,2,3,4,132.55792507463832,11,510.6185447371475,-4.177123622512402,-3.785815717809711,-3.370571289890722,2.8529715156922477,117,116,119,125,6,8,9,86.99700942890938,12,137.9944802207912,-0.6402517552529768,-0.507757686374671,-0.3851859183870088,1.401008268767955,8617,8696,Lucas and Nearby Counties,Lucas,19,117,Iowa,IA
19135,19CS020,84,84,85,101,16,17,17,878.4235844923282,16,842.2160810632979,-0.03753851510418283,0.36491813684218916,0.7705622912794664,0.9045756351892824,103,102,104,109,5,6,7,76.20028472845208,17,223.50775703392057,-1.6107355477666303,-1.4739590187354445,-1.3507652458117303,2.501547407030945,7599,7606,Lucas and Nearby Counties,Monroe,19,135,Iowa,IA
19185,19CS020,74,73,75,94,19,20,21,1234.719847777274,17,1046.9591993841416,1.4306093818336274,1.8869299596983757,2.2761398651826896,0.8076483911825456,91,90,91,86,-5,-5,-4,-70.9189897804604,7,107.55992624462202,-1.9127064632314876,-1.7822614106497063,-1.660757610607278,-1.9361577672319572,6495,6508,Lucas and Nearby Counties,Wayne,19,185,Iowa,IA
19119,19CS021,95,93,96,112,16,17,19,584.24626292973835,35,1175.3840987322644,-6.305724970565647,-5.909426733507939,-5.537322571092323,1.9024434505708405,117,115,118,94,-24,-23,-21,-188.47491097615298,3,25.006251562890725,-2.2647482181944176,-2.13474859361126,-2.00271534903677,-0.13881604215146268,11911,11997,Lyon+O'Brien+Osceola+Sioux,Lyon,19,119,Iowa,IA
19141,19CS021,172,166,178,220,42,48,54,1374.8054188483839,50,1419.7487044793072,-2.023602479045667,-0.47656620715721093,1.2659954275074599,1.0117932631893645,207,200,214,183,-31,-24,-17,-172.75857803013446,11,78.37548984681155,-2.982635023602951,-2.5024486194713993,-2.0337717373889492,-0.473186124761814,14087,14035,Lyon+O'Brien+Osceola+Sioux,O'Brien,19,141,Iowa,IA
19143,19CS021,61,61,62,71,9,10,10,629.1072412796811,10,650.0893872907525,-0.6459378795999483,-0.21205541621095084,0.17407314191569465,0.9365714357538121,75,74,76,91,15,16,17,258.29043742109576,4,64.9034561090378,1.811540412362786,1.9314508189969226,2.0716285716254332,0.23642842252574975,6153,6163,Lyon+O'Brien+Osceola+Sioux,Osceola,19,143,Iowa,IA
19167,19CS021,213,198,229,279,50,66,81,737.2925237429928,63,705.1515236309707,-1.3722168189037391,0.3264805871270169,1.9823637557101985,0.9421045739222957,263,244,281,257,-24,-6,13,-15.341749573439433,13,36.22178879910838,-1.0527112975061763,-0.5175472330083342,-0.02266348286727163,-2.8849436182812913,35737,35890,Lyon+O'Brien+Osceola+Sioux,Sioux,19,167,Iowa,IA
19121,19CS022,143,136,150,122,-28,-21,-14,-513.3649615212734,10,241.10910186859553,-9.283164408021904,-7.562471136425868,-5.920514951669397,-0.4928096174390045,177,168,186,180,-6,3,12,18.748502398174228,15,89.54154727793697,-1.2044047115346022,-0.6918166865919239,-0.21636494844424206,3.6225329183162436,16590,16752,Madison+Warren,Madison,19,121,Iowa,IA
19181,19CS022,381,359,404,423,19,42,64,318.8478437195707,48,365.7769903412014,-2.066340710907719,-0.4691332992912945,1.2252295720260842,1.1204061925018358,475,447,502,534,32,59,87,111.47208578943648,62,116.37291889558345,-0.6089801517414171,-0.04239958858611428,0.47543154103526375,1.0266773303677927,52491,53277,Madison+Warren,Warren,19,181,Iowa,IA
19123,19CS023,205,195,214,250,36,45,55,819.5832608984923,38,685.5493415118167,-0.3023485073104057,1.3749092851305813,3.0809876019862465,0.8184451668857279,250,239,261,274,13,24,35,109.4099526335682,34,154.4892766266812,-0.9507985486445837,-0.4538118642768132,0.0842683321184756,1.3557190526936014,22172,22008,Mahaska+Marion,Mahaska,19,123,Iowa,IA
19125,19CS023,297,283,311,329,18,32,46,382.70553513482014,51,611.4558043341426,-4.057736920306543,-2.265900421509263,-0.6199124918786749,1.549186115975723,366,348,383,371,-12,5,23,15.798974791007867,45,134.81126423007788,-1.708298346412554,-1.1963564557637536,-0.6675651958846861,7.172803271761332,33363,33380,Mahaska+Marion,Marion,19,125,Iowa,IA
19127,19CS024,409,392,426,467,41,58,75,579.3715072774307,60,600.7208650380456,-1.9065700585002578,-0.23980322796197123,1.4776445127025748,1.019235935390108,499,479,520,531,11,32,52,79.20901725550142,26,65.19068274703507,-0.33975501667022157,0.1356347022977381,0.6359015447084123,0.7977679103861287,39952,39883,Marshall+Tama,Marshall,19,127,Iowa,IA
19171,19CS024,178,171,185,222,37,44,51,1032.0339424329977,56,1315.634911312111,-4.480810929225945,-2.8492195053882177,-1.1124875372089371,1.2464241881870128,216,207,225,216,-9,-0,9,-0.6035986896889483,20,118.36420666390484,-1.6664487761145712,-1.1809250878535305,-0.6977146107720092,22.271468661031747,17026,16897,Marshall+Tama,Tama,19,171,Iowa,IA
19037,19CS025,115,114,116,133,17,18,19,598.752021637846,11,367.98528058877645,1.937038093866597,2.297252453687108,2.7043592587965617,0.5820661768200489,141,139,142,146,4,5,7,44.811147569149895,13,109.25287839314228,-0.773557140429451,-0.6447926669159909,-0.5216057109935667,2.0530383671309886,11957,11899,Mitchell and Nearby Counties,Chickasaw,19,37,Iowa,IA
19067,19CS025,154,147,161,202,41,48,55,1230.3240301473945,30,771.5553269465698,2.850659939938091,4.617743353772515,6.427507316900534,0.6142748368254118,188,180,196,199,3,11,19,72.06106023485762,17,110.15356703168536,-0.9264702598344356,-0.37647608722713133,0.1585144573579569,1.4025033202179742,15553,15433,Mitchell and Nearby Counties,Floyd,19,67,Iowa,IA
19089,19CS025,102,101,103,99,-4,-3,-2,-121.60102683899362,15,635.862653666808,-8.004814447376372,-7.5773959263029544,-7.155258754468984,-8.027536706612127,126,124,127,134,7,8,10,89.20100621038063,7,73.84745226289694,0.014232528949643988,0.15470256554489842,0.2775202854084208,0.7403205693587799,9436,9479,Mitchell and Nearby Counties,Howard,19,89,Iowa,IA
19131,19CS025,117,116,118,129,11,12,13,460.9176993825837,37,1399.2625508178123,-9.769682226568174,-9.388065253630822,-9.00804349610255,2.8056199187127278,143,142,144,150,6,7,8,65.91258678128352,2,18.941187612463303,0.3380518963578344,0.4671067627985514,0.5959443403765411,0.25126543434279436,10577,10559,Mitchell and Nearby Counties,Mitchell,19,131,Iowa,IA
19195,19CS025,72,71,73,59,-14,-13,-12,-702.002216602212,5,269.61445133459154,-10.10174356701262,-9.722536489250647,-9.313327579847657,-0.4160207560688371,88,87,89,99,10,11,12,147.30097513778415,6,81.17981328642944,0.5404907287605992,0.6672470475128406,0.7913504252538421,0.5047524515985677,7418,7391,Mitchell and Nearby Counties,Worth,19,195,Iowa,IA
19041,19CS026,165,158,172,187,15,22,29,537.0420357028162,16,392.4213624379177,-0.21189462732242798,1.4270534252994396,3.241905479935032,0.6987953431927046,203,194,211,198,-13,-5,4,-27.550432862943847,20,121.77301509985388,-2.0279340398968144,-1.4891354338948743,-0.9410914541587564,-5.6739470416456905,16309,16424,Palo Alto and Nearby Counties,Clay,19,41,Iowa,IA
19059,19CS026,179,172,187,197,10,18,25,398.4937896469797,28,633.0902718896614,-4.018606857463885,-2.3881357622795787,-0.697243245827084,1.5034054214788735,220,211,229,217,-12,-3,6,-17.539607959599067,27,151.37923301188607,-2.2057253592400654,-1.6843924239160224,-1.1640512751557022,-12.685797150156171,17691,17836,Palo Alto and Nearby Counties,Dickinson,19,59,Iowa,IA
19063,19CS026,104,103,105,132,27,28,29,1188.379065659757,32,1374.127750939345,-2.251041679400927,-1.860353624974939,-1.4613052655492587,1.1159788912393387,128,127,129,131,2,3,4,32.10243800780156,14,150.16625549715755,-1.3026993718793416,-1.1748858403842775,-1.062608566549262,3.5062145062193055,9315,9323,Palo Alto and Nearby Counties,Emmet,19,63,Iowa,IA
19109,19CS026,152,146,159,175,16,23,29,611.277018889255,44,1192.6543335366268,-7.425087550032317,-5.782551916861903,-4.120482414040325,1.8682432155706612,184,176,191,219,28,35,43,243.6583320144289,30,205.95908279555127,-0.14205680459846107,0.36950933441442324,0.8911648513430405,0.8221143804700042,14757,14566,Palo Alto and Nearby Counties,Kossuth,19,109,Iowa,IA
19147,19CS026,109,108,110,119,9,10,11,456.84441974548247,11,492.0599418474614,-0.747180253341387,-0.34769950958441226,0.051536882452888504,0.9810254513367629,133,132,134,139,5,6,7,68.8031350688804,22,246.80278214045322,-1.898932418497409,-1.782315636442792,-1.6612761797701152,3.0842080799164515,8942,8914,Palo Alto and Nearby Counties,Palo Alto,19,147,Iowa,IA
19021,19CS027,166,157,175,175,-0,9,18,171.691901508372,31,601.4454091283892,-6.011862432239297,-4.260281959573509,-2.525792531660438,3.14739030827727,205,195,216,184,-32,-21,-11,-102.6954487738566,14,67.39842095128057,-2.261822319565815,-1.6890793625786724,-1.1686311013296484,-0.6885731756849681,20617,20772,Pocahontas and Nearby Counties,Buena Vista,19,21,Iowa,IA
19025,19CS027,116,115,117,111,-6,-5,-4,-222.26758379823366,4,162.43654822335026,-4.239450874177918,-3.850870325263567,-3.437706394511365,-0.8941865965291237,143,142,145,145,0,2,3,16.208593596417526,10,100.8979921299566,-0.9747574117655621,-0.8465115631098735,-0.7162488677881088,3.836660014213546,9850,9911,Pocahontas and Nearby Counties,Calhoun,19,25,Iowa,IA
19091,19CS027,98,97,99,106,7,8,9,339.278408560572,20,834.6374543557641,-5.347726148768883,-4.943719113383434,-4.552907910724115,2.190590373455017,120,119,122,129,7,9,10,89.32447457538268,10,103.8637307852098,-0.2743562586132832,-0.14820348894284446,-0.011049303161305592,1.041649261128747,9585,9628,Pocahontas and Nearby Counties,Humboldt,19,91,Iowa,IA
19151,19CS027,84,84,85,95,10,11,11,602.1651519533507,15,855.9201141226819,-2.944174795232633,-2.5357119457393678,-2.1290083831433613,1.2983703224123746,104,103,105,112,7,8,9,109.5027933595578,10,141.3627367825841,-0.44192727783461433,-0.31983367039944693,-0.20184811677904688,1.143350076714401,7010,7074,Pocahontas and Nearby Counties,Pocahontas,19,151,Iowa,IA
19161,19CS027,115,114,116,128,12,13,14,517.5325983260183,15,614.1248720573183,-1.3539949782296292,-0.9643906310702824,-0.5443794221804806,1.0996475933314847,141,140,142,151,9,10,11,102.7962751540176,12,122.97601967616313,-0.33102449583314575,-0.20315023904779098,-0.08193960075155855,1.0878571048810406,9770,9758,Pocahontas and Nearby Counties,Sac,19,161,Iowa,IA
19187,19CS027,374,358,390,469,79,95,111,1031.9923748497074,68,738.488271068636,1.2581214047597762,2.9195542431603854,4.518982857158571,0.7081425930887868,461,441,480,510,30,49,69,133.18372995175437,47,126.61979040383632,-0.43190691800654624,0.0738525197477241,0.5701815896624745,0.9318653980353887,36832,37119,Pocahontas and Nearby Counties,Webster,19,187,Iowa,IA
19153,19CS028,3158,2946,3370,3754,384,596,808,483.83323789384207,437,354.6070515681422,-0.5117550144791253,1.2885739648529981,3.044080053678427,0.7316845819848339,3925,3669,4181,4348,167,423,679,85.21502072615324,380,76.57430730478589,-0.4315151982580411,0.07987112475260222,0.5872811705576534,0.8964811080125785,492940,496250,Polk,Polk,19,153,Iowa,IA
19163,19CS029,1322,1247,1397,1594,197,272,347,623.2388050426146,178,408.50048193877086,0.4024550942095787,2.139076719252138,3.8783276694486193,0.6530430706788527,1625,1535,1715,1826,111,201,291,115.18610459463633,133,76.34201221472195,-0.10683058143198532,0.39579049990801485,0.9031634460551192,0.659484650791272,174296,174216,Scott,Scott,19,163,Iowa,IA
19169,19CS030,481,438,523,477,-46,-4,39,-15.22950096803755,35,142.0843778226584,-3.282377504949254,-1.5769520165287076,0.03328449158906183,-12.72023706142491,604,553,655,628,-27,24,75,24.266150245482255,26,26.17089595055714,-0.5749258888714762,-0.016357023723171465,0.5258870748244301,1.035539216647796,98533,99347,Story,Story,19,169,Iowa,IA
19003,19CS031,37,37,38,40,2,3,3,287.95641071510414,5,543.92167527876,-2.967120658892186,-2.56774627969247,-2.1567483651919326,1.3709750790076662,45,45,46,62,16,17,17,455.5264778095385,6,164.4286105782406,2.7856587451987926,2.9088843132284845,3.037668253721871,0.34048037243128043,3677,3649,Taylor and Nearby Counties,Adams,19,3,Iowa,IA
19137,19CS031,141,136,145,169,24,28,33,1101.2912300848095,30,1168.110581135014,-2.42164914423995,-0.6891318937928738,0.9451690570580751,1.0244532896745373,172,167,178,159,-19,-13,-8,-127.85986915122376,15,145.29252227818674,-3.2209652910640387,-2.745402040008781,-2.206493634774578,-1.2294827110390028,10273,10324,Taylor and Nearby Counties,Montgomery,19,137,Iowa,IA
19145,19CS031,177,170,183,189,6,12,19,321.11938286338227,15,395.41320680110715,-2.4762127131392666,-0.7206401676216209,1.0725247181819153,1.1379443627295125,217,209,225,219,-6,2,10,15.112357581998442,18,118.46001974333662,-1.5404894645768472,-1.0161203922725581,-0.5189340276771496,5.46063035974783,15174,15195,Taylor and Nearby Counties,Page,19,145,Iowa,IA
19159,19CS031,64,64,65,93,28,29,29,2454.2408169138894,8,684.931506849315,17.300261412106106,17.70610204422702,18.071925700018436,0.2696732288510004,78,77,79,87,8,9,10,192.52774837069305,16,344.90191851692174,-1.6459874445792966,-1.521991052656888,-1.3844286934289618,1.6110579397068894,4672,4639,Taylor and Nearby Counties,Ringgold,19,159,Iowa,IA
19173,19CS031,62,62,63,79,16,17,17,1142.0473382016273,5,338.46674564224065,7.63046112825568,8.033549756742884,8.43636313647546,0.27978454323896823,75,75,76,105,29,30,30,502.8746268127222,11,187.48934719618205,3.0336675383335345,3.1549316523507462,3.2738968416884346,0.36061253094287066,5909,5867,Taylor and Nearby Counties,Taylor,19,173,Iowa,IA
19175,19CS031,129,124,135,151,16,22,27,713.1043546496418,23,759.8909721648633,-2.2353028509560287,-0.45809367374760496,1.276187523887112,1.0184252588168576,158,152,164,172,8,14,20,117.83630188523314,13,108.06317539484621,-0.4273679292487949,0.09750898310903053,0.6339135034179764,0.8566322412491808,12107,12030,Taylor and Nearby Counties,Union,19,175,Iowa,IA
19035,19CS032,151,146,156,152,-4,1,6,37.17822483722824,25,865.0519031141869,-9.997842819861416,-8.244966526744433,-6.647935436905238,12.051383060856784,182,176,188,172,-16,-10,-4,-90.6568059164016,17,147.5438291963201,-2.877547187409267,-2.383112737304811,-1.8594482708009406,-1.7998031947139297,11560,11522,West Central Iowa,Cherokee,19,35,Iowa,IA
19047,19CS032,149,142,156,169,13,20,27,485.43420122442257,23,557.8462284744119,-2.513379166775865,-0.7373743706608744,0.9979206034095712,1.0944848750998208,180,171,188,158,-30,-22,-13,-132.56224163424923,20,123.22099685786458,-3.064803760414322,-2.5526469744125335,-2.007806905771727,-0.9748404671789739,16492,16231,West Central Iowa,Crawford,19,47,Iowa,IA
19093,19CS032,88,87,88,117,29,29,30,1690.0893516267488,31,1777.7777777777778,-1.28979551608835,-0.8845251341334348,-0.5018316734571041,1.0173630039425006,107,106,108,96,-12,-11,-10,-159.80025874947134,6,86.16975441619991,-2.5811145243277527,-2.4590832837792056,-2.336907547538336,-0.5924818779631827,6975,6963,West Central Iowa,Ida,19,93,Iowa,IA
19133,19CS032,118,117,119,154,35,36,37,1636.2196791897115,17,780.8911345888838,8.163562599873455,8.551157265694712,8.97550840534846,0.464220829274888,143,142,144,157,13,14,15,160.32376761563597,22,255.87345894394045,-1.0889041158000503,-0.9564540694980956,-0.8265937465627654,1.488031068809452,8708,8598,West Central Iowa,Monona,19,133,Iowa,IA
19149,19CS032,210,199,221,262,41,52,63,807.4632613520392,64,999.6875976257419,-3.7169013262329957,-1.8874587771348534,-0.1910870247629893,1.2145641885599323,258,244,271,250,-21,-8,6,-29.585364410036284,19,74.05963749756383,-1.6166631402915275,-1.0374788300731548,-0.49343225975167093,-2.883101505631603,25608,25655,West Central Iowa,Plymouth,19,149,Iowa,IA
19193,19CS032,851,806,896,1064,168,213,258,808.4250338920288,175,664.0547181087721,-0.43049547247103637,1.4265865784435905,3.261199121678037,0.8175802353406435,1043,988,1097,1084,-13,41,96,39.21367539141678,91,86.14242845918648,-0.9585475262654624,-0.4769473250137691,0.046421872957556155,2.1449650063631087,105413,105639,West Central Iowa,Woodbury,19,193,Iowa,IA
20001,20CS001,143,137,148,129,-19,-14,-8,-441.3973125378274,4,127.89768185451639,-7.417822401766798,-5.704275803938235,-3.949489395384835,-0.31238527285703876,173,166,179,199,20,26,33,210.9984781937402,27,216.43286573146295,-0.5960772709151153,-0.049223147640632535,0.4713581739682036,0.9882124498355571,12510,12475,Allen+Anderson+Franklin+Osage,Allen,20,1,Kansas,KS
20003,20CS001,88,87,89,90,1,2,3,111.98187580484334,5,254.77707006369425,-1.7938949432248747,-1.434204155839102,-1.0012324542025235,1.563651085328178,106,106,107,103,-4,-3,-3,-44.93501887799791,21,269.6456086286595,-3.268996145173899,-3.1502582224848297,-3.0156302470056295,-8.40154833741198,7850,7788,Allen+Anderson+Franklin+Osage,Anderson,20,3,Kansas,KS
20059,20CS001,232,220,243,269,26,37,49,576.0537439604672,21,323.5248806039131,0.7744291857413588,2.509729153467459,4.299482472765623,0.5469939637731599,282,268,295,338,43,56,70,215.84573738319193,40,153.8935056940597,0.11172714432696379,0.615474223885473,1.1684083028749706,0.7004932025106696,25964,25992,Allen+Anderson+Franklin+Osage,Franklin,20,59,Kansas,KS
20139,20CS001,164,157,170,230,60,66,73,1685.3774044650254,23,583.9416058394161,9.276581142789148,11.044203676187252,12.72475902268967,0.34133338389615075,199,191,207,232,25,33,41,209.8838364780383,23,145.92056845577972,0.12378039407817892,0.625346612639605,1.153861246633234,0.6748451976613137,15755,15762,Allen+Anderson+Franklin+Osage,Osage,20,139,Kansas,KS
20011,20CS002,163,157,169,181,12,18,24,503.2317186898819,17,473.6695458344943,-1.4607090873126363,0.3498877603964506,2.090359179731398,0.8918740960051428,197,190,204,213,9,16,23,112.32468697553377,34,237.36386484222285,-1.7272594545190632,-1.251144451170811,-0.73801526888222,1.989538752174609,14356,14324,Bourbon+Linn+Miami,Bourbon,20,11,Kansas,KS
20107,20CS002,93,92,94,122,28,29,30,1187.1738647759657,5,207.9434393844874,9.394713248917036,9.80624244102561,10.195707303982877,0.16922996142382715,115,114,117,166,49,51,52,519.5765332664832,24,246.8373958654736,2.604648046852376,2.728102432053927,2.858198332544548,0.4658527387172397,9618,9723,Bourbon+Linn+Miami,Linn,20,107,Kansas,KS
20121,20CS002,254,240,269,292,23,38,52,438.35754483348995,23,268.73083102088503,0.12301942051017307,1.7563882897217309,3.3536559591785764,0.5971245642872263,312,294,330,419,89,107,125,309.85643465410544,61,176.64263168563403,0.8036696486506657,1.3310280459964414,1.849974941165078,0.5648005767199342,34235,34533,Bourbon+Linn+Miami,Miami,20,121,Kansas,KS
20005,20CS003,155,148,162,146,-16,-9,-2,-227.48938956216642,3,73.7372496005899,-4.776639962992899,-3.011426761936083,-1.3459442136265434,-0.3633982468542072,189,181,198,218,20,29,37,175.70915818427915,26,160.0098467598006,-0.3540882167600615,0.15245032571327416,0.6511932760154735,0.879835424084864,16274,16249,Brown and Nearby Counties,Atchison,20,5,Kansas,KS
20013,20CS003,111,110,111,147,36,36,37,1539.400650119988,31,1307.8789157261892,1.9297507520672061,2.314646815962885,2.737864793414051,0.8269391395965993,136,134,137,157,20,21,23,225.65322805168947,11,116.30365827870585,0.9613877533670623,1.0943449890517958,1.2173179175219704,0.49234003258053594,9481,9458,Brown and Nearby Counties,Brown,20,13,Kansas,KS
20043,20CS003,76,75,77,92,15,16,17,868.1671428549851,10,534.3307507347048,2.9413510140108086,3.3294132220123926,3.7390743409850593,0.5797858337487777,93,92,94,111,17,18,19,238.35894697091868,17,227.54651318431266,-0.016758378815588552,0.10833289563648356,0.22813221718442853,0.9038804526070239,7486,7471,Brown and Nearby Counties,Doniphan,20,43,Kansas,KS
20085,20CS003,130,125,136,125,-11,-5,0,-162.55834566389248,12,362.9764065335753,-6.963165757775907,-5.1754550534856465,-3.618467240109876,-2.7433720141208457,160,153,166,157,-9,-3,4,-20.02964277302999,14,105.61255280627641,-1.7687990775482243,-1.2478657842074092,-0.7781481792162439,-8.458552914936437,13224,13256,Brown and Nearby Counties,Jackson,20,85,Kansas,KS
20087,20CS003,158,151,166,180,14,22,29,466.4743524635839,23,498.9695194706584,-2.152869381630829,-0.3396639836102279,1.470061316594061,1.0221252213208498,194,185,204,204,0,10,19,53.01228264756081,27,146.77901603696657,-1.4711314866495144,-0.9322666911023831,-0.40829610949148404,2.5112519449908146,18438,18395,Brown and Nearby Counties,Jefferson,20,87,Kansas,KS
20117,20CS003,118,117,119,123,4,5,6,217.4649835782413,24,963.5651912074676,-7.8468191684049895,-7.477068331950559,-7.05621153454136,3.7403516002978785,145,144,146,132,-14,-13,-12,-129.98098520167343,14,140.22435897435898,-2.836029222043246,-2.6996862177686767,-2.575628297059724,-1.16887764133717,9963,9984,Brown and Nearby Counties,Marshall,20,117,Kansas,KS
20131,20CS003,114,112,115,158,43,44,46,1742.7705692146842,42,1645.2844971109587,0.5521089640764315,0.9763725881409714,1.3669700578904793,0.9233087505706131,140,139,141,123,-18,-17,-16,-164.81929731595434,7,68.51996867658575,-2.4640932433164573,-2.3337661804886034,-2.2035919852787322,-0.441976687567175,10211,10216,Brown and Nearby Counties,Nemaha,20,131,Kansas,KS
20015,20CS004,562,533,591,638,47,76,105,449.23260263316524,38,225.57618390395203,0.5566210259917477,2.181593605451594,4.108056258613888,0.49558795546583007,695,660,730,790,60,95,130,139.82954535582658,101,148.92801321183165,-0.6628944755881638,-0.08966694170914714,0.4162598870753667,1.0539540901024969,67383,67818,Butler+Harvey,Butler,20,15,Kansas,KS
20079,20CS004,344,330,359,380,21,36,50,420.8396863405497,40,470.5605552614552,-2.331910654824461,-0.5007894752302822,1.1676860883968117,1.0877404770691588,420,402,437,512,75,92,110,272.8799791996562,61,180.28668538495643,0.44136263915992907,0.9379698476740933,1.4595991721433001,0.6536021878219295,34002,33835,Butler+Harvey,Harvey,20,79,Kansas,KS
20009,20CS005,241,230,252,306,54,65,76,1023.9646201809619,36,565.2822485671666,2.9036914673787466,4.562797918143286,6.2764506012191434,0.5437147666458105,291,278,304,368,64,77,90,304.2293683822774,50,198.05117642398795,0.539633223428809,1.0473487753873008,1.593033763195851,0.6426260572112116,25474,25246,Central Kansas,Barton,20,9,Kansas,KS
20051,20CS005,207,194,219,259,40,52,65,724.7988991354902,57,789.5830447430393,-2.489628816504025,-0.583964414832614,1.098820151408229,1.0689524489993651,252,238,267,235,-32,-17,-3,-60.342406829844414,18,62.47613758633855,-1.7376648932650063,-1.2278703031039142,-0.6712581986138242,-1.098548944098246,28876,28811,Central Kansas,Ellis,20,51,Kansas,KS
20053,20CS005,72,71,73,92,19,20,21,1260.0871745344177,17,1076.9718086791258,1.4216258034907039,1.8318063162723994,2.231092360934506,0.8137679562347273,89,88,89,83,-6,-6,-5,-87.09482131686472,8,126.20287111531788,-2.2579749417539716,-2.131357830853081,-2.0103345975857474,-1.769543218917252,6314,6339,Central Kansas,Ellsworth,20,53,Kansas,KS
20113,20CS005,324,311,337,356,19,32,45,428.81793990569787,48,641.51825988172,-3.840897104676434,-2.1012983373573166,-0.4730213725197993,1.4507984243208283,396,380,411,422,11,26,42,87.65464060543175,46,152.58060236168237,-1.1886445590616177,-0.6467894704837822,-0.14758507253922512,1.6772331718582671,29929,30148,Central Kansas,McPherson,20,113,Kansas,KS
20159,20CS005,100,99,101,107,6,7,8,293.76456394908365,10,425.7130693912303,-1.7156634461064593,-1.3305572211604277,-0.9222735696464505,1.26573793115493,122,121,124,145,21,23,24,241.30835838985968,15,159.77844056242012,0.6862474165430349,0.8141303011482982,0.9433305859814315,0.6341414479262153,9396,9388,Central Kansas,Rice,20,159,Kansas,KS
20167,20CS005,75,74,76,120,44,45,46,2692.1825790520525,19,1133.6515513126492,15.178697534033077,15.577079091762984,15.946112430081293,0.41196002317680774,92,91,92,85,-7,-7,-6,-97.08335852398253,13,194.08778739922366,-3.04625479890504,-2.9086331392664913,-2.783300631435968,-2.3625009225248754,6704,6698,Central Kansas,Russell,20,167,Kansas,KS
20017,20CS006,28,28,28,21,-7,-7,-7,-1121.1136960797571,1,155.58148580318942,-13.169093948640594,-12.775760335544826,-12.336053450490175,-0.16113546927515193,35,35,35,32,-3,-3,-3,-109.46425385984939,5,192.82684149633627,-3.147020363839444,-3.024742362151331,-2.89662497526529,-2.719744322801356,2571,2593,Chase+Coffey+Lyon+Marion,Chase,20,17,Kansas,KS
20031,20CS006,86,85,87,89,2,3,4,136.5963026147321,8,384.0153606144246,-2.9084487164393096,-2.473110835896038,-2.100533527969793,2.080276586715121,106,105,107,111,4,5,6,64.09763808123489,15,179.79144192736425,-1.2829273148372673,-1.1527960711370124,-1.0284501925856036,2.3630733138277193,8333,8343,Chase+Coffey+Lyon+Marion,Coffey,20,31,Kansas,KS
20111,20CS006,240,226,253,323,70,83,97,1034.2640572790415,68,843.3324031873003,0.14800121791569806,1.875012959140089,3.492468012911775,0.8057321052316374,294,277,310,320,10,26,43,82.75973778375696,30,93.71192952862899,-0.648216907720177,-0.11186372989505669,0.4248431571419823,1.0911521259315646,32253,32013,Chase+Coffey+Lyon+Marion,Lyon,20,111,Kansas,KS
20115,20CS006,148,143,153,133,-20,-15,-10,-500.84156548406787,10,340.1071337471303,-10.01001186085505,-8.416877352472106,-6.572990979475604,-0.7285446799635694,179,173,186,222,36,43,49,363.03669895779194,29,247.4825055470217,0.6686447705952437,1.1671324911742231,1.6614420571195447,0.6660444068879747,11761,11718,Chase+Coffey+Lyon+Marion,Marion,20,115,Kansas,KS
20021,20CS007,228,220,236,271,35,43,51,888.1053857210683,26,537.2455832214072,1.7630233678699525,3.529431346511447,5.185651145844372,0.5911796880678921,278,268,288,312,24,34,44,179.1260334590154,43,224.53135606495746,-0.9748189902061819,-0.4475243911625409,0.01596022203752145,1.2179775755796873,19358,19151,Cherokee+Crawford,Cherokee,20,21,Kansas,KS
20037,20CS007,379,362,396,484,88,105,122,1078.8348197396865,53,544.7070914696814,3.666319309283573,5.31807652060816,7.106970945966009,0.5001385857567033,470,449,490,518,28,48,69,123.99267441638719,63,161.19128031931226,-0.9221684180854249,-0.3625581607264598,0.1480080925851509,1.2737231732314687,38920,39084,Cherokee+Crawford,Crawford,20,37,Kansas,KS
20027,20CS008,84,83,85,90,5,6,7,306.23272298842994,17,840.2322995181021,-5.741571786314567,-5.344625121396253,-4.9249738208940075,2.3624716428252217,102,101,103,113,10,11,12,136.55837056918344,10,123.73174956693887,0.0011377820784056333,0.13246306687397097,0.25480483738123094,0.8307961159608063,8093,8082,Cloud and Nearby Counties,Clay,20,27,Kansas,KS
20029,20CS008,117,116,118,128,10,11,12,484.17558981950424,21,938.4426321081444,-4.9313888704133895,-4.544640892568085,-4.151160677470348,1.7744520586169164,142,141,144,157,13,15,16,162.58510357723472,17,190.22043191227482,-0.39923512093664043,-0.27293346805544627,-0.15682830260642294,1.0946392440048358,8951,8937,Cloud and Nearby Counties,Cloud,20,29,Kansas,KS
20089,20CS008,32,32,32,31,-1,-1,-1,-120.91204550596817,1,137.12718546451833,-3.0233981723920933,-2.5900376511153107,-2.1963060665260787,8.456737704086962,39,39,39,59,20,20,20,678.6229413237218,11,374.78705281090294,2.9174954275225162,3.0365101056377592,3.172766242881948,0.5258733682372274,2917,2935,Cloud and Nearby Counties,Jewell,20,89,Kansas,KS
20105,20CS008,30,29,30,39,9,9,10,1271.9667097056802,5,679.1171477079796,5.536729342569847,5.9364925234310775,6.322748616978985,0.4823994207482468,36,35,36,40,4,4,5,148.72775916749262,4,137.50429700928154,-0.01586159110167181,0.1132893082520327,0.23804202025009602,0.7509635076509692,2945,2909,Cloud and Nearby Counties,Lincoln,20,105,Kansas,KS
20123,20CS008,68,67,68,76,8,8,9,568.7605968759249,4,276.2430939226519,2.4953154289502466,2.9216110942259492,3.3455261393133644,0.4331041679713745,82,81,83,97,14,15,16,261.67729819406395,12,208.69565217391303,0.40749319876688966,0.5312041473867843,0.6514010808724426,0.7478292085638206,5792,5750,Cloud and Nearby Counties,Mitchell,20,123,Kansas,KS
20141,20CS008,49,49,50,48,-2,-1,-1,-164.9368347132221,4,458.97877223178426,-6.628663024906334,-6.245624429621519,-5.8204754857583865,-9.144434907442092,60,60,61,59,-2,-1,-1,-40.00138105703598,7,200.17157563625966,-2.5340170083961095,-2.3972116891082047,-2.2672437717350826,-17.55053256550058,3486,3497,Cloud and Nearby Counties,Osborne,20,141,Kansas,KS
20143,20CS008,61,60,61,64,3,3,4,222.72232479901743,11,766.417000522557,-5.831419335155167,-5.446231339640304,-5.006940891790644,2.6211556730892807,75,74,76,75,-1,-0,1,-2.2738832825421107,10,171.7327837884252,-1.8598197214680285,-1.7371724619906013,-1.613247258651381,11.526158121081524,5741,5823,Cloud and Nearby Counties,Ottawa,20,143,Kansas,KS
20157,20CS008,69,69,70,65,-5,-4,-4,-381.7934263966158,10,858.1849388543231,-12.82026591436453,-12.408759208531285,-11.992610505433936,-2.8995189949807534,85,84,85,86,1,1,2,29.239523464260248,7,150.05359056806003,-1.3295248662259576,-1.2061325301714139,-1.0872060940442636,2.961053137448572,4661,4665,Cloud and Nearby Counties,Republic,20,157,Kansas,KS
20183,20CS008,47,47,47,43,-4,-4,-4,-440.2820018869501,5,561.324726354196,-10.406097519263017,-10.013887572176326,-9.615985831134429,-1.7112668839386986,57,57,58,55,-3,-2,-2,-65.03320727699256,2,55.959709009513155,-1.3305696155128879,-1.21214478871362,-1.0916825266887689,-1.5102468419927622,3563,3574,Cloud and Nearby Counties,Smith,20,183,Kansas,KS
20201,20CS008,60,60,61,66,5,6,6,431.1950154439909,10,725.5577725376384,-3.3578377805931368,-2.944761433624866,-2.538409194482591,1.440310929640493,73,72,74,83,9,10,11,178.38310596945848,10,181.3894431344096,-0.14718558258020792,-0.02903385263706333,0.08716149792910041,0.9229979174005868,5513,5513,Cloud and Nearby Counties,Washington,20,201,Kansas,KS
20041,20CS009,198,190,206,203,-3,5,13,111.74100453385691,23,500.8710801393728,-5.661945598017854,-3.916406243673986,-2.1806698717659376,3.7513372733300736,242,233,252,285,33,43,52,232.20002459182626,47,254.82541747993926,-0.7459486890518713,-0.22439429099689095,0.29212551156335226,1.0723989653106367,18368,18444,Dickinson+Geary+Morris,Dickinson,20,41,Kansas,KS
20061,20CS009,195,179,211,214,3,19,35,212.18882853162017,26,289.1378687202869,-2.637971570381187,-0.7585099465897385,0.8947251154793585,1.2947852566751867,240,222,259,273,14,33,51,91.00017922427494,40,110.94777133664327,-0.7141757046532148,-0.19400423065264857,0.3057145177891522,1.1831416063616451,35969,36053,Dickinson+Geary+Morris,Geary,20,61,Kansas,KS
20127,20CS009,64,63,64,77,13,13,14,975.8991133395597,14,1037.4212671359764,-1.044793035311237,-0.624635710349852,-0.21635829936538972,0.9880196593256104,77,77,78,75,-3,-2,-2,-44.83345369989366,2,37.334328915437744,-0.9463966593839389,-0.8214850741817281,-0.6907907658284286,-1.4268102201997497,5398,5357,Dickinson+Geary+Morris,Morris,20,127,Kansas,KS
20045,20CS010,622,571,673,729,56,107,158,358.56963842502483,53,177.59162303664922,0.04388596203781133,1.7839658246949324,3.4282188037340426,0.49069245993090355,773,711,834,849,15,76,138,63.99791160704544,40,33.53369717394767,-0.2120491913602109,0.32085197741325294,0.8428230897461683,0.5172059625024668,119375,119283,Douglas,Douglas,20,45,Kansas,KS
20019,20CS011,45,43,46,41,-5,-4,-2,-440.464042080453,5,595.2380952380952,-12.192219468527028,-10.340485437883782,-8.583782824575096,-1.8519218452545885,55,53,57,65,8,10,12,299.84985122184446,10,294.6375957572186,-0.4520689806252329,0.049044667692631834,0.5699170528070389,0.8947021504626981,3360,3394,Elk and Nearby Counties,Chautauqua,20,19,Kansas,KS
20035,20CS011,370,355,384,429,45,59,74,688.6855661004329,63,729.5888824551246,-2.0576562082035847,-0.4214454105820389,1.2144592815244046,1.041873411134453,452,434,469,504,35,52,70,151.9807729630267,64,185.5287569573284,-0.8531789463915133,-0.3457850989944474,0.11541786459338918,1.1978897500698562,34540,34496,Elk and Nearby Counties,Cowley,20,35,Kansas,KS
20049,20CS011,33,32,34,36,2,3,4,518.3208181594815,2,323.10177705977384,0.3363687364457555,1.9283038764875904,3.6596956983611113,0.475239333951866,40,38,41,50,9,10,12,428.62920387803274,5,204.4153720359771,1.7638506186892933,2.241856281510474,2.7051303338637407,0.43537811786850655,2476,2446,Elk and Nearby Counties,Elk,20,49,Kansas,KS
20073,20CS011,82,81,82,87,5,5,6,359.365098331872,5,334.8401138456387,-0.16121822955646933,0.24943090628649683,0.634620807223953,0.7853954977293777,99,98,100,124,24,25,26,420.84545666023905,13,218.70794078061908,1.8949848363195483,2.0223538604418283,2.146207896213021,0.49971066860139746,5973,5944,Elk and Nearby Counties,Greenwood,20,73,Kansas,KS
20205,20CS011,92,92,93,112,19,20,20,910.368316637945,6,280.1120448179272,5.899529750792123,6.289633919946761,6.715925462247083,0.29268165127430695,112,111,113,155,42,43,44,500.422116000518,26,304.6994023204031,1.8386998277980153,1.96085112675009,2.0906820960959456,0.594951799769354,8568,8533,Elk and Nearby Counties,Wilson,20,205,Kansas,KS
20207,20CS011,41,40,42,51,9,10,11,1272.8565778515153,2,257.8981302385558,8.461869369242244,10.127410954793785,11.894834649935106,0.1839756684756969,50,49,52,55,3,5,6,157.51089029233427,1,32.23726627981947,0.722141857651901,1.2617657599156076,1.7609779609509253,0.16989501696455697,3102,3102,Elk and Nearby Counties,Woodson,20,207,Kansas,KS
20091,20CS012,3547,3285,3810,3992,182,445,707,291.77357928270476,479,314.24827253657077,-1.9268792906116337,-0.2126368905788324,1.5151825043767675,1.0746116000071213,4416,4100,4733,4825,92,409,725,66.71078789061143,420,68.5347275255047,-0.5788967866266382,-0.02184090687050562,0.47989587532880024,1.0248342040436225,609709,612828,Johnson,Johnson,20,91,Kansas,KS
20099,20CS013,227,219,236,241,5,14,22,273.3519665525075,28,558.9659130608375,-4.76060749821723,-2.8164160273412655,-1.1581551131307906,1.9056844914101823,276,266,287,303,16,27,37,133.60872661079637,39,195.56714471968712,-1.14054263505403,-0.6092896197314948,-0.11445092046217467,1.4107815119097444,20037,19942,Labette+Montgomery+Neosho,Labette,20,99,Kansas,KS
20125,20CS013,365,351,378,412,34,47,61,602.6135183432334,41,522.2597286797019,-0.8731803589802334,0.8118359885986733,2.393981802134469,0.8487176472748699,443,427,459,544,85,101,117,323.5539153083206,79,253.3187968960431,0.1731781507870236,0.7026078840797626,1.240319632748175,0.7752430620382884,31402,31186,Labette+Montgomery+Neosho,Montgomery,20,125,Kansas,KS
20133,20CS013,174,167,181,192,11,18,25,461.1771768364057,17,427.80748663101605,-1.3642780254400326,0.32452138652220475,2.103125936984743,0.8796427255114597,211,203,219,241,22,30,38,187.8885072566421,39,246.80420199974688,-1.1022798129256923,-0.6056557569313594,-0.06326127630509794,1.270766362236503,15895,15802,Labette+Montgomery+Neosho,Neosho,20,133,Kansas,KS
20103,20CS014,549,514,584,669,85,120,155,586.0662313258246,62,302.77503082689327,0.9766227809091758,2.8234033773600298,4.466923890528381,0.5123533035887544,679,636,721,793,72,114,157,139.19125907008444,88,107.13676982638974,-0.17763709802993455,0.3106936277369999,0.8815623754872962,0.7630350025476055,81909,82138,Leavenworth,Leavenworth,20,103,Kansas,KS
20023,20CS015,31,31,31,48,17,17,17,2613.5620314896037,12,1830.6636155606407,7.398752617162265,7.831581039356355,8.2409517700461,0.6618170508756417,38,38,38,41,3,3,3,117.47806106356416,6,228.05017103762827,-1.2265792000094877,-1.1067245068016358,-0.9839895540162736,1.4666886457324277,2622,2631,Northwest Kansas,Cheyenne,20,23,Kansas,KS
20039,20CS015,39,38,39,35,-4,-4,-3,-534.3956922898464,5,724.9003262051468,-13.019450120931845,-12.601981124263,-12.177414667863381,-1.8615080542576004,47,47,48,58,10,11,11,394.16693884968475,10,363.50418029807344,0.1795708700461123,0.3071633800214614,0.4472196495404073,0.8443426832610221,2759,2751,Northwest Kansas,Decatur,20,39,Kansas,KS
20063,20CS015,29,29,29,47,18,18,18,2683.037712118156,20,2967.359050445104,-3.26402949130963,-2.8366554839894853,-2.4264528687104576,1.048016215939145,36,36,36,44,8,8,8,288.927744430485,4,145.66642388929353,1.3021150733796059,1.4313893908482187,1.551005017427706,0.4477299934944133,2696,2746,Northwest Kansas,Gove,20,63,Kansas,KS
20065,20CS015,30,30,30,28,-2,-2,-2,-302.28300813755874,5,829.8755186721992,-11.72816780347051,-11.324464609940897,-10.916128600283278,-6.0882420744868435,36,36,37,40,3,4,4,152.07114414797235,2,83.29862557267805,0.5606511799828905,0.6867703667143101,0.8205287145582919,0.42999395567667775,2410,2401,Northwest Kansas,Graham,20,65,Kansas,KS
20109,20CS015,28,28,28,39,11,11,11,1605.3407291360031,4,582.6656955571741,9.841775877251575,10.22893771049169,10.620226233196167,0.33276031714118093,34,34,34,50,16,16,16,586.5085014069258,3,110.09174311926607,4.641798823427031,4.764804919265704,4.8902864701781255,0.1766539273360309,2746,2725,Northwest Kansas,Logan,20,109,Kansas,KS
20137,20CS015,57,57,58,76,18,19,19,1394.0783234736482,22,1624.815361890694,-2.7337887313789193,-2.324182822845543,-1.8910097461476487,1.1068725439628835,69,68,70,56,-14,-13,-12,-246.030227738116,2,37.34129947722181,-2.9614957415034895,-2.829376992726493,-2.7076114621626677,-0.16423895490034335,5416,5356,Northwest Kansas,Norton,20,137,Kansas,KS
20147,20CS015,58,58,59,65,6,7,7,535.3600753052873,15,1204.3356081894822,-7.1287479322699925,-6.699600354767245,-6.321592339631919,1.9562045606518215,69,69,70,77,7,8,8,159.44658703387515,16,330.9203722854188,-1.8385463118146894,-1.7134136330093555,-1.5926730636661461,1.8371287779700443,4982,4835,Northwest Kansas,Phillips,20,147,Kansas,KS
20153,20CS015,35,35,36,32,-4,-3,-3,-544.4868543215979,4,628.6836935166993,-12.155515045494608,-11.73550219308669,-11.349376916691641,-1.6231805698954256,43,43,44,37,-7,-6,-6,-252.4760829817954,3,117.6470588235294,-3.83048539816227,-3.69659061298969,-3.5750006373618666,-0.5516591952373042,2545,2550,Northwest Kansas,Rawlins,20,153,Kansas,KS
20163,20CS015,55,55,56,59,3,4,4,299.5420275205648,10,817.3273395995096,-5.551866691399611,-5.171220172049632,-4.763447529892078,2.1436701879394593,67,66,68,73,5,6,7,124.0368604936014,3,61.98347107438017,0.5006922844384658,0.6217989255708374,0.7404968242578517,0.4283643420788436,4894,4840,Northwest Kansas,Rooks,20,163,Kansas,KS
20179,20CS015,25,24,25,44,19,19,20,3166.704408703789,10,1628.001628001628,14.980792102695515,15.383986492138735,15.78652959946721,0.48896212425569746,30,30,31,40,9,10,10,393.34893416933716,2,80.87343307723413,3.008146441214258,3.1254968467215587,3.2446655914508082,0.18643639536080941,2457,2473,Northwest Kansas,Sheridan,20,179,Kansas,KS
20181,20CS015,59,58,59,51,-8,-8,-7,-529.0615167355111,11,746.9020539806484,-13.201040449929176,-12.741642588416802,-12.378082627015782,-1.6196111975920797,72,71,73,62,-11,-10,-9,-170.70978668300526,4,67.87714237230612,-2.5086446920970658,-2.3880849758119846,-2.263763963746358,-0.4415046255937606,5891,5893,Northwest Kansas,Sherman,20,181,Kansas,KS
20193,20CS015,70,70,71,69,-2,-1,-1,-73.14290286027793,10,507.54980332445126,-6.213577936065018,-5.8055148913309145,-5.4279816454713785,-22.670696787228117,86,85,87,72,-15,-14,-13,-182.5858430457912,14,177.59736141063047,-3.7290039564083264,-3.601264491756801,-3.476946775094417,-1.0453032949281122,7881,7883,Northwest Kansas,Thomas,20,193,Kansas,KS
20195,20CS015,37,37,37,45,8,8,8,1160.238890155054,2,285.5103497501784,8.348303963777115,8.754824579748584,9.200009456840649,0.2191186878073566,45,45,45,45,-0,0,0,0.5965589125402828,4,143.11270125223612,-1.5493573403566467,-1.4221567756309357,-1.3055944936287778,3.9343985406089432,2802,2795,Northwest Kansas,Trego,20,195,Kansas,KS
20199,20CS015,14,14,14,15,1,1,1,251.53374785595494,5,1321.003963011889,-11.093885009058909,-10.694593132930715,-10.298237168713177,2.561402929960662,17,17,17,19,2,2,2,121.75670764747424,3,198.80715705765405,-0.9002744213551209,-0.7678741182226589,-0.646437368193129,1.0573399998895205,1514,1509,Northwest Kansas,Wallace,20,199,Kansas,KS
20025,20CS016,27,27,27,33,6,6,6,1217.6904574441792,7,1415.5712841253792,-2.4040944507041377,-1.9891409128942206,-1.5617328967224307,0.996940913572932,33,33,34,31,-3,-2,-2,-117.8342096894805,3,151.82186234817814,-2.8316403786334226,-2.692002101927808,-2.570699330844023,-2.2583491447961292,1978,1976,Pawnee and Nearby Counties,Clark,20,25,Kansas,KS
20033,20CS016,25,25,25,29,4,4,4,946.3796703935334,2,475.34165181224006,4.2873775331812265,4.706651507118664,5.137220574083728,0.4014538681397107,31,30,31,32,1,1,2,78.92905028264619,4,239.23444976076553,-1.740512364937418,-1.6059625725401478,-1.4720731748775486,1.7243655764815276,1683,1672,Pawnee and Nearby Counties,Comanche,20,33,Kansas,KS
20047,20CS016,38,37,38,69,31,31,32,4358.943785346808,11,1530.9672929714684,27.86320298822364,28.279490470803548,28.687198858907536,0.34035694863129956,46,46,46,59,13,13,13,454.17508291063103,2,70.37297677691767,3.7232723913908345,3.834710267728555,3.9642966647370486,0.14380568664208992,2874,2842,Pawnee and Nearby Counties,Edwards,20,47,Kansas,KS
20057,20CS016,220,205,235,253,18,33,48,388.5004090017939,41,481.27714520483624,-2.6669487071356417,-0.898661488881758,0.7529772059468094,1.2024747572380472,274,257,292,276,-16,2,19,4.997525186416315,56,163.90563718316454,-2.1067225265275193,-1.5797053541354777,-1.1172787832148268,20.68363509961591,34076,34166,Pawnee and Nearby Counties,Ford,20,57,Kansas,KS
20083,20CS016,22,22,22,20,-2,-2,-2,-428.6362164326493,2,464.0371229698376,-9.324612353800644,-8.926473149322087,-8.514435309410697,-2.360098960051165,27,27,27,41,14,14,14,826.9586204740966,5,292.22676797194623,5.217783913284711,5.3501595308062075,5.471023645497432,0.33004908101908126,1724,1711,Pawnee and Nearby Counties,Hodgman,20,83,Kansas,KS
20097,20CS016,25,25,25,29,4,4,4,682.9046290949724,3,490.19607843137254,1.5257846835288587,1.9337290013654949,2.362769925535807,0.5792203170462675,30,30,31,37,6,7,7,280.5789385919187,4,166.5972511453561,1.013323957517642,1.1373544163466291,1.2622491535414746,0.5170162778489299,2448,2401,Pawnee and Nearby Counties,Kiowa,20,97,Kansas,KS
20135,20CS016,38,38,39,55,16,17,17,2491.0927906889215,14,2079.46528035648,3.739064278119308,4.115691238948498,4.492677938911773,0.7877878383762345,47,47,47,53,6,6,6,228.41885112349783,3,112.23344556677891,1.032619151944367,1.1609732116816331,1.2843469005999444,0.42220007416898064,2693,2673,Pawnee and Nearby Counties,Ness,20,135,Kansas,KS
20145,20CS016,72,72,73,82,9,10,10,617.7958830755045,3,191.63206643244968,3.8532543498251695,4.26681879961492,4.69297276017788,0.2811201255886676,89,88,90,86,-4,-3,-2,-51.404692539156315,13,208.73474630700068,-2.727253731393746,-2.5995624495415472,-2.4828322075436953,-5.9051069713967275,6262,6228,Pawnee and Nearby Counties,Pawnee,20,145,Kansas,KS
20165,20CS016,50,50,50,58,8,8,8,1073.0945160441331,13,1761.5176151761516,-7.277543449084717,-6.877949385212802,-6.515399255017045,1.4574910086649462,62,61,62,60,-2,-2,-1,-58.10327956514163,1,33.87533875338753,-1.043793930048013,-0.9213196176916914,-0.7862319911414778,-1.398193062158755,2952,2952,Pawnee and Nearby Counties,Rush,20,165,Kansas,KS
20149,20CS017,167,156,178,180,2,13,24,211.91348558548222,16,252.97442586663504,-2.2383569106420538,-0.39486374054790657,1.2200130135232712,1.1108798182518507,208,195,221,225,4,17,30,66.65567532934176,34,132.1311985076947,-1.1727796377751887,-0.6692448794505036,-0.16315836453789404,1.8730885156750554,25299,25732,Pottawatomie+Riley+Wabaunsee,Pottawatomie,20,149,Kansas,KS
20161,20CS017,308,277,339,348,9,40,71,222.31593206349328,22,122.0019409399695,-0.7465005400831506,1.00554282141745,2.7988802053928623,0.5354215363923258,384,347,421,431,10,47,84,64.98703279212027,32,44.33545312218574,-0.3259329735723327,0.2264361153454674,0.7714263621450254,0.6679790972684768,72130,72177,Pottawatomie+Riley+Wabaunsee,Riley,20,161,Kansas,KS
20197,20CS017,54,54,55,57,2,3,3,148.3245011552613,6,348.12880765883375,-2.4156254512725455,-1.9993059925998147,-1.5873697350171097,1.687112227972922,67,66,68,92,24,25,26,354.7585610860051,10,143.80212827149842,1.9859178196083098,2.1102360416584376,2.2367100400345916,0.3895611581170009,6894,6954,Pottawatomie+Riley+Wabaunsee,Wabaunsee,20,197,Kansas,KS
20155,20CS018,612,585,638,746,108,134,161,870.1509254260999,94,608.5127043210875,0.882876073443227,2.58194916635695,4.330472692505105,0.694154371377801,744,712,776,825,49,81,113,131.545205977591,75,122.00875209448358,-0.41500392850784545,0.08683521025081949,0.6113109567742642,0.9161742848493254,61790,61471,Reno,Reno,20,155,Kansas,KS
20169,20CS019,479,455,502,545,43,66,90,490.6451813263889,77,568.4439768931214,-2.479745638632545,-0.7950383705513865,0.7851907297347838,1.1413905783698086,586,558,614,736,122,150,178,278.3685500290504,130,241.01746449627348,-0.1659354517230827,0.3649095578443403,0.8790599690963885,0.8600930983121651,54183,53938,Saline,Saline,20,169,Kansas,KS
20055,20CS020,204,187,220,275,55,71,88,752.5615515488444,59,621.1670570894639,-0.4289644147455499,1.2927842886387249,3.051381072957924,0.8140156657732879,253,234,273,325,52,72,91,187.6210506818828,45,118.00183558410909,0.14658256469126582,0.6999891392172267,1.1637928614644386,0.6202679783709814,37993,38135,Scott and Nearby Counties,Finney,20,55,Kansas,KS
20071,20CS020,21,21,21,24,3,3,3,1059.3078018091094,3,944.8818897637796,0.7608637344019965,1.138790865139796,1.5584139322527608,0.6875526410615862,26,26,26,27,1,1,1,94.21683043370658,3,230.7692307692308,-1.4909951367304175,-1.3670580470378253,-1.2275721934633026,1.348424422645825,1270,1300,Scott and Nearby Counties,Greeley,20,71,Kansas,KS
20075,20CS020,20,20,21,20,-1,-0,-0,-53.78292416403897,3,480.7692307692308,-5.736183301435145,-5.34651674834789,-4.929637188759666,4.515389214852404,25,24,25,27,2,2,3,88.91613689304974,7,281.69014084507046,-2.058134571647482,-1.9297772606244628,-1.806000702776865,2.1809802310004094,2496,2485,Scott and Nearby Counties,Hamilton,20,75,Kansas,KS
20093,20CS020,29,28,29,29,-0,0,1,31.828077006713677,7,710.8403148007109,-7.184941670303619,-6.7931631654961375,-6.379692558545995,5.329569182170088,35,34,35,48,13,13,14,337.5759009120858,2,51.24263387138099,2.7347505977875435,2.8607547510996514,2.9908330674839383,0.14108762774955472,3939,3903,Scott and Nearby Counties,Kearny,20,93,Kansas,KS
20101,20CS020,24,24,25,26,1,2,2,384.5502194276358,6,1536.4916773367477,-11.904660463958658,-11.518480323072604,-11.137348941783742,2.3983992058481234,30,30,30,33,3,3,3,193.60501081713562,5,319.4888178913738,-1.3831099247765926,-1.257538529556447,-1.1352861552321745,1.2407199054126705,1562,1565,Scott and Nearby Counties,Lane,20,101,Kansas,KS
20171,20CS020,45,44,45,55,10,10,11,791.4328471325163,16,1256.1334641805693,-5.074403854140113,-4.639686232985522,-4.253213945153664,1.443929176567468,55,55,56,72,16,17,17,324.0834721015247,12,233.82696804364772,0.7734157735757035,0.9028345748012039,1.029391188331335,0.6805821599972133,5095,5132,Scott and Nearby Counties,Scott,20,171,Kansas,KS
20203,20CS020,19,19,20,31,11,12,12,2183.141336881876,5,937.207122774133,12.015321756375211,12.450563538464753,12.849527115176246,0.3953488306842045,23,23,23,30,7,7,7,325.0478471008149,7,334.7680535628886,-0.22087223109930415,-0.0963627559663954,0.02691553834541611,0.8978099293253345,2134,2091,Scott and Nearby Counties,Wichita,20,203,Kansas,KS
20173,20CS021,3917,3692,4142,4833,691,916,1141,700.398189086257,497,380.05368162666036,1.5432343496790193,3.1943790734205715,5.00210556462083,0.5420333705072733,4821,4550,5091,5624,533,803,1074,153.34522212359374,611,116.62775893366724,-0.17612009856129957,0.3632766569919622,0.892126882583633,0.759611304588491,523084,523889,Sedgwick,Sedgwick,20,173,Kansas,KS
20177,20CS022,1646,1570,1723,1914,191,268,344,600.3234065185375,239,536.1779931463441,-1.0301638718797634,0.6442567598297696,2.388843575507136,0.8898232814465065,2018,1926,2110,2155,45,137,229,76.8061854378799,238,133.47241383177987,-1.092069884054172,-0.5685199829290104,-0.07796046322512945,1.7251854712799888,178299,178314,Shawnee,Shawnee,20,177,Kansas,KS
20007,20CS023,49,49,49,66,17,17,17,1612.9063432095054,3,283.88928317956,12.902275773623458,13.286448285210513,13.703220032531247,0.16625667970929023,59,58,59,66,7,7,8,170.69367169792253,5,121.2709192335678,0.3688156669358029,0.4963312172226288,0.6230101518765893,0.6220684956742245,4227,4123,South Central Kansas,Barber,20,7,Kansas,KS
20077,20CS023,77,77,78,94,16,17,17,1224.3705352733718,14,1028.4664830119375,1.5670568271131826,1.9514639455456326,2.3329783718474864,0.7924493653275364,94,93,94,78,-16,-16,-15,-290.993428181618,7,130.84112149532712,-4.348494266695948,-4.222455287813967,-4.096860297810312,-0.48050032194154396,5445,5350,South Central Kansas,Harper,20,77,Kansas,KS
20095,20CS023,158,155,161,212,51,54,57,2933.4258875992114,31,1679.3066088840735,10.978904704137122,12.5145007661621,14.36294855331185,0.5620927355206614,193,189,196,265,69,72,76,978.4481218392942,35,472.972972972973,4.553079460186073,5.036621609233643,5.584873583925877,0.4768057111450205,7384,7400,South Central Kansas,Kingman,20,95,Kansas,KS
20151,20CS023,101,101,102,124,22,23,23,985.6255913015362,25,1093.0156301235108,-1.487736579865759,-1.0754051001685543,-0.6626901218314134,1.06185422610589,126,125,127,129,2,3,4,35.528602845167804,6,65.38084341288003,-0.42443120484300445,-0.2988780439125562,-0.1704566776779392,1.408298673060805,9149,9177,South Central Kansas,Pratt,20,151,Kansas,KS
20185,20CS023,51,50,51,59,8,8,9,825.3936302174353,8,787.5953728771843,-0.012909839078488377,0.3815120090109342,0.7548706399397159,0.8525207515709058,62,62,63,81,18,19,19,469.3065545237168,16,396.235760277365,0.5971558814234292,0.7259768749599308,0.8524392780347726,0.8019809462019792,4063,4038,South Central Kansas,Stafford,20,185,Kansas,KS
20191,20CS023,230,221,240,270,30,40,49,711.2075218771033,42,749.7656982193065,-2.079556197759878,-0.35034790709214214,1.386612420612627,1.028401829828462,286,275,298,322,24,36,47,159.73790617567047,30,134.0662287169862,-0.2856709905512203,0.26610800377485566,0.7897487101424601,0.8164475811311103,22407,22377,South Central Kansas,Sumner,20,191,Kansas,KS
20067,20CS024,51,50,52,60,8,9,10,493.2632579489192,16,876.8324428003837,-4.246447605567824,-3.8493744794944242,-3.433517048823231,1.599868602883973,63,63,64,59,-5,-4,-4,-61.43666389279331,16,218.45985800109227,-2.92357910912457,-2.800737989040604,-2.6749598570433544,-4.571923301197702,7299,7324,Southwest Kansas,Grant,20,67,Kansas,KS
20069,20CS024,45,45,46,55,9,10,10,694.8109546402917,10,703.358537014243,-0.48368801540197054,-0.09213394119092767,0.3053618701105856,0.9192465149774522,55,55,56,66,10,11,11,187.6204663908948,11,194.96632399858206,-0.19616584456116895,-0.07399045670875704,0.059340827989868734,0.9494588621287835,5687,5642,Southwest Kansas,Gray,20,69,Kansas,KS
20081,20CS024,25,25,26,25,-1,-0,-0,-44.672983096126856,5,528.9605924358635,-6.116162636545043,-5.750348323547982,-5.358118820700211,8.654582383267122,31,30,31,35,4,4,5,115.87129463642215,3,81.49959250203749,0.22058229288088738,0.34136327588773663,0.462164527892374,0.5697765065568837,3781,3681,Southwest Kansas,Haskell,20,81,Kansas,KS
20119,20CS024,42,42,43,56,13,14,14,1343.9770251091286,5,495.1720722951226,8.081535555742793,8.491853137281826,8.903573609317315,0.3431518688745196,52,52,53,58,5,6,6,146.1995729739088,7,173.91304347826087,-0.4050349442588293,-0.27740103860534543,-0.14669658384391415,1.0167719714539751,4039,4025,Southwest Kansas,Meade,20,119,Kansas,KS
20129,20CS024,32,32,32,36,4,4,4,613.7692376812789,1,149.7005988023952,4.235845145027119,4.6355749707445435,5.04643850438098,0.19607925768472237,40,39,40,44,4,4,5,164.765540421545,5,185.73551263001485,-0.33398196961517185,-0.2066068967385542,-0.07620185616901023,0.9198805479370822,2672,2692,Southwest Kansas,Morton,20,129,Kansas,KS
20175,20CS024,117,115,119,141,22,24,26,446.6297111169965,38,698.4331204337637,-2.9199776973437594,-2.5224833363117445,-2.0810697606975723,1.5019759279340885,146,143,148,163,15,17,20,79.8053889830367,14,64.34119215037455,0.026851561167931814,0.1525134750935842,0.2851181315505881,0.7623256657051668,21763,21759,Southwest Kansas,Seward,20,175,Kansas,KS
20187,20CS024,18,18,18,16,-2,-2,-2,-381.2912705979833,2,388.9158969372873,-8.106959878785396,-7.7095895222646424,-7.279514585094677,-2.0816195553598904,22,22,22,19,-3,-3,-3,-151.58239628446506,4,195.3125,-3.5939516283296036,-3.466651122426757,-3.348176376686794,-1.9007725670040188,2057,2048,Southwest Kansas,Stanton,20,187,Kansas,KS
20189,20CS024,40,39,41,46,5,6,7,457.59423715722056,5,379.7228023542814,0.37434925890825055,0.7768245400398871,1.156463084664754,0.7117060728149358,50,49,50,54,4,4,5,81.52351083760108,10,189.2147587511826,-1.199259319266754,-1.0776250673169927,-0.9498291275248265,1.883765083192772,5267,5285,Southwest Kansas,Stevens,20,189,Kansas,KS
20209,20CS025,1213,1141,1286,1474,188,261,333,619.6665218356533,213,506.34415951029627,-0.6675274532187521,1.1396635641164383,2.8034504142890704,0.8140009127941167,1486,1399,1572,1653,81,167,254,99.95975094274412,174,103.99732236779191,-0.5726623850871869,-0.041896901164243765,0.48824601939024564,1.034208167760449,168265,167312,Wyandotte,Wyandotte,20,209,Kansas,KS
21001,21CS001,175,167,183,268,85,93,101,1963.7004451786809,44,928.0742459396752,8.7348491899081,10.406968679188045,12.118691221092005,0.4675924524379518,214,205,224,270,46,56,65,293.3639766872029,40,211.38297310151665,0.3008012715695006,0.8298378721321568,1.3356334366338098,0.7077984218683958,18964,18923,Adair and Nearby Counties,Adair,21,1,Kentucky,KY
21045,21CS001,169,162,175,210,35,41,48,1038.6436000898307,25,627.7463904582548,2.3186892205173644,4.107194766912792,5.864712259210047,0.5901239493885848,206,198,214,242,28,36,44,228.36974409438346,39,245.76217783099122,-0.682897345471798,-0.18792790990714622,0.3537931092165018,1.0472611589850451,15930,15869,Adair and Nearby Counties,Casey,21,45,Kentucky,KY
21087,21CS001,129,128,130,141,11,12,13,436.5781303695334,16,576.213198883587,-1.7758297530279337,-1.391291022399656,-1.0030166167952885,1.2192628377466188,160,159,162,164,2,4,5,33.28046401194978,28,248.55747891699954,-2.282767190178957,-2.156723143410272,-2.021043892080558,5.895923137903621,11107,11265,Adair and Nearby Counties,Green,21,87,Kentucky,KY
21207,21CS001,218,210,226,272,46,54,62,1202.6024622017194,33,733.7817555172605,3.0161361601568344,4.6795321893095405,6.355014438902714,0.5990846070926588,268,259,277,310,33,42,51,232.08807860788983,35,193.05019305019306,-0.1346005877523035,0.40607498927704067,0.9077996948625666,0.8124878236063482,17989,18130,Adair and Nearby Counties,Russell,21,207,Kentucky,KY
21217,21CS001,269,258,280,311,31,42,53,646.647332093518,28,430.7526633591016,0.41455255019454645,2.1617266992172377,3.8624955889144315,0.6506529631793567,331,318,345,447,102,116,129,440.90208176221154,66,251.86994352007326,1.3812175243225777,1.896915780864608,2.3898307585716547,0.566358405914289,26001,26204,Adair and Nearby Counties,Taylor,21,217,Kentucky,KY
21005,21CS002,213,202,223,246,23,33,44,563.626822961703,13,219.26125822229716,1.710869740218396,3.482168288565412,5.122832269040867,0.3777155459663226,262,250,275,291,16,29,41,120.0759515690777,47,195.74361750864188,-1.2776488606025214,-0.7663399864809547,-0.2605632937067513,1.5755191552930827,23716,24011,Anderson+Franklin,Anderson,21,5,Kentucky,KY
21073,21CS002,487,465,509,528,19,41,63,318.2838592586132,40,310.79427361550864,-1.6127381111245216,0.027730829071434208,1.7669305763420224,0.9531996056782895,596,569,623,759,136,163,190,315.1504628988458,79,152.90519877675843,1.0968500750217343,1.6176920334708818,2.143899505193077,0.48222000467478354,51481,51666,Anderson+Franklin,Franklin,21,73,Kentucky,KY
21003,21CS003,204,195,213,231,18,27,36,525.4147982057362,30,579.0946819805038,-2.2639354903182007,-0.5717617911464934,0.9957518075706957,1.0631092245797367,250,239,261,290,29,40,51,193.3733739238202,47,226.30970724191062,-0.8772684031804915,-0.31682739405291377,0.19356811599624213,1.1418913652514093,20722,20768,Barren and Nearby Counties,Allen,21,3,Kentucky,KY
21009,21CS003,447,428,466,507,41,60,79,540.2752771717679,45,405.2502420244501,-0.36223160848636193,1.3127401657680948,3.1851878714579973,0.7377833230485046,547,524,570,653,83,106,129,238.53168203874188,111,249.27015495171796,-0.6128317265143007,-0.11484330918798133,0.4069265418609151,1.0352724021590654,44417,44530,Barren and Nearby Counties,Barren,21,9,Kentucky,KY
21099,21CS003,195,187,203,227,24,32,40,661.7084127622577,31,644.055471874513,-1.6734958807175244,0.18112933165447556,1.768382129355859,0.9436925970877882,240,230,250,269,19,29,39,148.52974630718708,45,231.57678056813504,-1.3436205149522573,-0.8136002461422989,-0.3071435790021883,1.5069167326123374,19253,19432,Barren and Nearby Counties,Hart,21,99,Kentucky,KY
21169,21CS003,118,117,119,148,29,30,31,1177.7929838085886,14,546.2348809988295,5.91126416727394,6.3152835586152705,6.714779199648422,0.44890737935870206,145,144,147,160,13,15,16,141.30658921629347,34,328.8837299284194,-2.0061626438667455,-1.8736426429939528,-1.7589541779650437,2.178331659276184,10252,10338,Barren and Nearby Counties,Metcalfe,21,169,Kentucky,KY
21171,21CS003,150,145,155,152,-3,2,7,75.93095680456331,37,1321.4285714285716,-14.152696416116898,-12.48706317240092,-10.6898143963241,11.835959523357882,182,176,188,185,-3,3,9,24.25311520664007,37,329.0936582762608,-3.523516526801582,-3.0433570021727845,-2.54363343674124,9.92814773369536,11200,11243,Barren and Nearby Counties,Monroe,21,171,Kentucky,KY
21011,21CS004,147,142,153,150,-3,3,8,83.66916967500558,10,315.20882584712376,-3.9528451730951075,-2.37813537026505,-0.6929146267793056,2.736424019814014,180,174,187,220,33,40,46,312.01135941914214,19,148.8095238095238,1.107704926117653,1.6465895179953691,2.137334694573666,0.4652573896356528,12690,12768,Bath+Clark+Montgomery+Rowan,Bath,21,11,Kentucky,KY
21049,21CS004,366,351,382,396,14,30,45,320.42895488114414,17,184.3767793714921,-0.41994570353306515,1.3388041316377812,3.069448465030466,0.5565677319532149,446,427,465,523,58,77,96,207.6071844473167,31,84.03361344537815,0.7190453233909677,1.2413829766725966,1.7471225588540475,0.3995551258232139,36881,36890,Bath+Clark+Montgomery+Rowan,Clark,21,49,Kentucky,KY
21173,21CS004,269,257,281,306,25,37,49,530.8753706017648,20,284.4950213371266,0.7550353267964922,2.444104865444457,4.229786145014369,0.5219133330336655,329,314,343,433,90,104,119,369.6836676469957,67,237.5886524822695,0.8031944800107633,1.3380426814068545,1.8363037437246201,0.6365747684907455,28120,28200,Bath+Clark+Montgomery+Rowan,Montgomery,21,173,Kentucky,KY
21205,21CS004,198,188,209,230,21,32,42,511.95557037368525,11,178.03674030913652,1.683776582697257,3.3307967807120433,5.006487149917789,0.33710094804959284,244,231,257,328,71,84,97,338.7392310994067,45,181.14483535947187,1.0754648908369093,1.5898723458435213,2.062751055736055,0.5284816383298567,24714,24842,Bath+Clark+Montgomery+Rowan,Rowan,21,205,Kentucky,KY
21013,21CS005,318,307,328,362,34,44,55,731.9162126047087,40,660.1477080496761,-1.1573643873515689,0.6768605475807123,2.3433535820551468,0.8820552518306028,385,372,397,545,148,160,173,671.508808993492,80,335.14872224549646,2.8714231878336554,3.35607230576409,3.9109317380104343,0.49600359762230734,24237,23870,Bell+Harlan,Bell,21,13,Kentucky,KY
21095,21CS005,365,353,376,471,95,106,118,1600.9348138821458,31,467.4306393244874,9.665475311391495,11.369121660960586,13.015205680889714,0.2892492666990843,441,427,454,586,132,145,159,554.266483241241,87,331.5422430547616,1.7056344282606042,2.2315370875948344,2.7395303213024786,0.5940794133047492,26528,26241,Bell+Harlan,Harlan,21,95,Kentucky,KY
21015,21CS006,828,769,886,911,25,83,142,244.65651387036456,91,267.43075453677176,-2.0597897260353832,-0.2429317803952927,1.5637800411882845,1.0801123450034773,1032,961,1103,1168,65,136,207,99.17040617623805,160,116.56285287582413,-0.6720819653126765,-0.16827315612860935,0.32122494086721043,1.1668078914242617,136110,137265,Boone,Boone,21,15,Kentucky,KY
21017,21CS007,205,196,213,202,-11,-3,6,-52.7191694724158,1,19.79707993071022,-2.3852544945016936,-0.7527308668841061,1.0592685103513544,-0.6013312097226197,251,240,261,334,73,83,94,410.56278141589144,37,182.8334239264713,1.7385879230474006,2.295691438603922,2.8249514414679164,0.44002783315118527,20205,20237,Bourbon+Fleming+Lewis+Nicholas,Bourbon,21,17,Kentucky,KY
21069,21CS007,164,157,170,179,9,15,22,405.2376997873071,17,452.45858007851484,-2.155017641424861,-0.5118165683371773,1.3621840332103357,1.047714555588417,202,194,210,208,-2,6,14,37.33357628727887,29,190.72673462676752,-2.0216645878397572,-1.5221439829529417,-1.0174185386463606,4.343547481383378,15029,15205,Bourbon+Fleming+Lewis+Nicholas,Fleming,21,69,Kentucky,KY
21135,21CS007,157,151,162,174,12,17,23,530.5054574930634,29,886.2403544961418,-5.344620635481291,-3.5954998230271085,-1.8266480708071653,1.5795667392310762,190,184,197,231,34,41,47,313.21421981220914,39,300.04616094783813,-0.36271040071135235,0.13985963327351036,0.6242403084209578,0.9349920570683381,13089,12998,Bourbon+Fleming+Lewis+Nicholas,Lewis,21,135,Kentucky,KY
21181,21CS007,87,86,88,77,-11,-10,-9,-545.4402817597381,4,212.99254526091588,-7.964236994370631,-7.591256406760225,-7.195143189333418,-0.4327426742427143,109,108,110,116,6,7,8,87.17806950065398,21,273.224043715847,-1.990290865379568,-1.867313725028384,-1.7273675077421866,2.727093368884688,7512,7686,Bourbon+Fleming+Lewis+Nicholas,Nicholas,21,181,Kentucky,KY
21019,21CS008,569,549,590,641,51,72,92,596.7988333107797,50,417.09244854121914,0.031406841711855295,1.7922305226038804,3.5243912980069223,0.6892487329865618,698,673,723,795,72,97,122,201.97686924655764,78,162.70677319093014,-0.08428675561718514,0.39689374276728684,0.8701067606578392,0.797336557760081,47951,47939,Boyd+Carter+Greenup,Boyd,21,19,Kentucky,KY
21043,21CS008,292,280,303,304,1,12,24,182.18469739906521,22,331.00127886857746,-3.1497906091627725,-1.4528826361111467,0.2908123750268654,1.6782483714987702,357,344,371,436,65,79,92,297.49823819646,56,211.83234982599487,0.36659250378132857,0.8500630881710023,1.4017980185473282,0.7031056682758678,26586,26436,Boyd+Carter+Greenup,Carter,21,43,Kentucky,KY
21089,21CS008,425,410,441,498,57,73,88,813.930576280911,37,414.20615152108815,2.251285050151281,3.9833627565967036,5.730968083370953,0.5019917979496094,521,503,539,577,38,56,74,156.85082811125042,66,184.9827629698142,-0.8107568391871175,-0.27354309899282014,0.19763025116815808,1.158650767407676,35731,35679,Boyd+Carter+Greenup,Greenup,21,89,Kentucky,KY
21021,21CS009,302,289,315,339,24,37,50,480.3213006645636,45,588.1584106652725,-2.9092689794545543,-1.1184957087489433,0.6216435942872724,1.1920724728432406,373,357,389,442,53,69,85,224.65443338032316,55,178.91997397527652,-0.05064163445397292,0.4581296827539639,0.990454329061564,0.7850551442063859,30604,30740,Boyle+Lincoln+Mercer,Boyle,21,21,Kentucky,KY
21137,21CS009,262,251,272,309,37,47,58,779.4519577215574,37,609.5551894563428,0.006712724938527793,1.7312329771638704,3.4085256680809293,0.7658436412926025,321,308,333,435,102,114,127,470.38146596361224,64,264.0046200808514,1.5210746355134221,2.0759840258154423,2.5799181414018415,0.5563772021115401,24280,24242,Boyle+Lincoln+Mercer,Lincoln,21,137,Kentucky,KY
21167,21CS009,256,247,266,260,-6,4,13,63.270720861132304,25,443.675407072186,-5.63122263985094,-3.8713075529125947,-2.0745079193336124,5.476274982643544,318,306,329,351,22,33,45,146.32749534888626,51,223.52734922861148,-1.2837361476082556,-0.7709960252599192,-0.2394835063299629,1.4831582435201962,22539,22816,Boyle+Lincoln+Mercer,Mercer,21,167,Kentucky,KY
21023,21CS010,83,82,83,90,7,7,8,352.6584023191412,8,381.58836155497255,-0.685422386407834,-0.2957236082820404,0.14101835336825286,0.9531203690229286,102,101,103,140,37,38,39,452.9223564173026,22,260.91081593927896,1.7977942959532673,1.9194531823037841,2.0392948231645365,0.56136177865064385,8386,8432,Bracken and Nearby Counties,Bracken,21,23,Kentucky,KY
21097,21CS010,198,190,206,209,3,11,19,233.88642114045072,11,234.66666666666666,-1.723979928154757,0.021716155425598536,1.7237258955660768,0.9194690557966643,245,236,255,298,43,53,62,278.228479889149,43,227.34482393993866,-9.414548425029174e-5,0.4977019984400641,1.0605419233375601,0.8018777412745633,18750,18914,Bracken and Nearby Counties,Harrison,21,97,Kentucky,KY
21161,21CS010,203,195,210,197,-13,-6,2,-130.82335584975948,21,492.26441631504923,-7.96072192518447,-6.213083987467213,-4.573795297081964,-4.584227624634973,247,238,255,272,17,25,34,149.79868227293085,44,259.54108417389256,-1.612200842820394,-1.0934378520727597,-0.5889911040852359,1.666958977664378,17064,16953,Bracken and Nearby Counties,Mason,21,161,Kentucky,KY
21191,21CS010,147,141,154,153,-1,6,12,154.63895532670156,8,218.78845890879256,-2.3571233502225484,-0.6965302665550076,1.1181050097198033,1.2022168756222211,181,173,188,209,21,28,36,191.9289003431207,23,157.4048727073638,-0.13745358520923756,0.35999871234541125,0.8887259100822273,0.791884194608714,14626,14612,Bracken and Nearby Counties,Pendleton,21,191,Kentucky,KY
21201,21CS010,27,27,27,39,12,12,12,2198.9200322121837,1,182.9826166514181,19.763008776031736,20.158014033793194,20.510071668913195,0.076822038356067393,34,34,34,39,5,5,5,225.80824005351232,7,311.6651825467498,-0.9791875239238328,-0.8608196132356819,-0.7298228576472079,1.1528985463184884,2186,2246,Bracken and Nearby Counties,Robertson,21,201,Kentucky,KY
21027,21CS011,204,195,213,249,36,45,54,882.8078078554144,15,293.2551319648094,4.110000859201102,5.8804303664866096,7.605255662189759,0.32498751406991633,250,239,261,355,94,105,116,509.9338023361064,44,213.395411998642,2.4448860725942776,2.9824455493650857,3.4718594331074564,0.4145341291914454,20460,20619,Breckinridge+Grayson+Hancock+Meade,Breckinridge,21,27,Kentucky,KY
21085,21CS011,280,269,291,314,23,34,45,515.5071666992304,40,605.4643154469084,-2.600604456500906,-0.8412263178166646,0.7274318136599294,1.1409995640106458,341,328,355,447,92,106,119,398.7070686234861,65,245.21824423737127,1.0425660968135628,1.5125154246761088,2.036091240247879,0.6092686673095224,26426,26507,Breckinridge+Grayson+Hancock+Meade,Grayson,21,85,Kentucky,KY
21091,21CS011,77,76,78,102,24,25,26,1113.0917440839798,4,177.10870046491033,8.940080740428984,9.363664614586767,9.75539817878798,0.1530270059328189,95,94,96,114,18,19,20,212.93358360258196,8,88.2223202470225,1.1182074769446344,1.2432727045934202,1.3788237239208339,0.3939175707656139,9034,9068,Breckinridge+Grayson+Hancock+Meade,Hancock,21,91,Kentucky,KY
21163,21CS011,235,222,248,243,-5,8,21,105.4411380162715,13,174.51421284021882,-2.303801973560612,-0.7052647049815154,0.920289702348667,1.4681677558566257,289,274,305,357,52,68,83,224.98005554164536,63,209.23976219734962,-0.35160407886694833,0.15016911480351286,0.6871373268869142,0.9165070124139403,29797,30109,Breckinridge+Grayson+Hancock+Meade,Meade,21,163,Kentucky,KY
21029,21CS012,569,534,605,699,94,130,165,630.4937786933854,63,306.24521491851687,1.6352443685449223,3.2620606659493667,5.078738484741988,0.48200660204712253,704,661,747,856,109,152,195,183.31999955788265,103,124.35558453161408,0.07125138734626138,0.6021145801409807,1.0816278381661673,0.673914161873087,82287,82827,Bullitt+Spencer,Bullitt,21,29,Kentucky,KY
21215,21CS012,148,139,156,157,1,9,18,187.9968261963181,12,245.37368367242613,-2.4071147609621644,-0.5627024866197677,1.1817494987955988,1.1771647940365124,184,174,194,213,19,29,39,146.3701767354941,26,130.88346337780015,-0.3373273800311456,0.1507807591490899,0.6506187530818333,0.8644641385845253,19562,19865,Bullitt+Spencer,Spencer,21,215,Kentucky,KY
21031,21CS013,145,140,150,170,20,25,30,806.2313308929979,20,645.421540943929,-0.20196872260176446,1.569812116467657,3.371715295776471,0.7697312909684133,176,170,183,189,6,13,19,102.54133652993086,30,243.9421044072207,-1.9315040045768135,-1.4118254116894327,-0.8413824830040135,2.2041751598885218,12395,12298,Butler+McLean+Muhlenberg+Ohio,Butler,21,31,Kentucky,KY
21149,21CS013,101,100,102,128,26,27,28,1199.0160648113938,16,701.7543859649123,4.58309931973698,4.957825474011456,5.389183360794873,0.5646215290051632,123,122,124,145,21,22,23,238.21561746066072,21,230.71852340145026,-0.04852050206149801,0.0743028976019043,0.20132269742720518,0.925828546509132,9120,9102,Butler+McLean+Muhlenberg+Ohio,McLean,21,149,Kentucky,KY
21177,21CS013,333,319,346,364,18,31,45,406.70787265405966,42,544.959128065395,-3.1135636924649646,-1.394771536095959,0.34374513112740546,1.2985015147494827,406,390,422,482,60,76,92,247.85543324804073,61,198.56770833333331,-0.024719710999627637,0.4889880868523017,1.033811662836607,0.7907578391853463,30828,30720,Butler+McLean+Muhlenberg+Ohio,Muhlenberg,21,177,Kentucky,KY
21183,21CS013,247,236,257,260,3,13,24,226.15216779310458,29,488.0511612251767,-4.256252029678235,-2.609687224463472,-0.9455719763829886,2.008593760054084,301,289,314,372,58,71,83,297.61618224172304,46,194.14197687178188,0.5363931273456456,1.037337617360155,1.5483634417265764,0.6432021109427435,23768,23694,Butler+McLean+Muhlenberg+Ohio,Ohio,21,183,Kentucky,KY
21035,21CS014,329,313,345,404,59,75,91,802.9413119771265,40,426.9968775853327,1.9500650164936701,3.6881057648407825,5.526146776220571,0.5248136157875855,406,386,425,511,86,105,125,280.7562479887154,40,106.66666666666667,1.2204430172593796,1.7585657252881641,2.254519536977424,0.3763515973871208,37471,37500,Calloway+Marshall,Calloway,21,35,Kentucky,KY
21157,21CS014,380,366,393,385,-8,5,19,65.87739998225928,35,443.1361377520337,-5.643197666230969,-3.8145384416631143,-2.203792208723303,5.642283958385622,466,449,482,510,28,44,61,140.00366346488912,48,151.24779430299975,-0.6166611186865577,-0.10704831898491833,0.38467726515513584,1.0565342069189305,31593,31736,Calloway+Marshall,Marshall,21,157,Kentucky,KY
21037,21CS015,745,705,785,817,32,72,112,309.49005096883917,58,248.9484075886342,-1.1971455113553624,0.589268111601151,2.231549889326488,0.793379471824832,914,866,962,957,-5,43,91,45.75294202723651,84,90.26919563698887,-0.9716014379961676,-0.42626098800187284,0.06896316832510548,1.92769313896879,93192,93055,Campbell,Campbell,21,37,Kentucky,KY
21047,21CS016,534,503,566,668,102,134,165,736.7257848468058,72,397.25233799553087,1.8014895388156513,3.422989892323743,5.160043693678673,0.5352051046609302,660,622,697,835,138,175,213,242.10224528430817,102,140.87230340027068,0.524238420898222,1.0174513229106608,1.500854499869485,0.5785705903180567,72498,72406,Christian,Christian,21,47,Kentucky,KY
21051,21CS017,240,232,249,236,-13,-4,4,-85.86666469827748,21,415.24543971526026,-6.742150353209367,-5.024080528356785,-3.308785911141254,-6.2827377374197715,296,286,306,390,84,94,104,464.9051577364191,43,212.6712498145309,2.047385095461126,2.525360622743865,3.010742359188241,0.45263551524340134,20229,20219,Clay+Jackson+Leslie+Owsley,Clay,21,51,Kentucky,KY
21109,21CS017,154,149,160,173,13,19,24,576.7311167268282,23,707.2570725707257,-3.180740920917883,-1.2288087286469207,0.31591851527893383,1.164244772533262,190,183,197,224,27,34,41,260.8167441737754,42,323.59966099083135,-1.1278547035861592,-0.6368529562742591,-0.13053263608153298,1.205116399963356,13008,12979,Clay+Jackson+Leslie+Owsley,Jackson,21,109,Kentucky,KY
21131,21CS017,140,139,141,132,-9,-8,-7,-306.9853158057384,3,115.90843233845263,-4.613141054853251,-4.239144275832071,-3.8296696895815585,-0.4319313959764695,171,170,173,206,33,35,36,337.04999647188345,29,281.444099378882,0.4413213200470798,0.5556188091574584,0.6747877418452078,0.8116512449684722,10353,10304,Clay+Jackson+Leslie+Owsley,Leslie,21,131,Kentucky,KY
21189,21CS017,58,57,58,91,33,33,34,3267.4513937167053,12,1179.651019906611,20.47522451295885,20.86435665753349,21.27728790720014,0.35048623376073157,69,69,70,83,13,14,14,349.9715677807126,7,176.67844522968198,1.6050330504651589,1.7387635342829686,1.8600324140577846,0.47087713969277806,4069,3962,Clay+Jackson+Leslie+Owsley,Owsley,21,189,Kentucky,KY
21053,21CS018,104,103,105,145,40,41,42,1756.2269538332578,21,896.9567538707954,8.194893312093617,8.59307491921665,8.974576719433898,0.4986031566487185,126,125,127,157,30,31,32,335.85315458285606,21,226.83084899546338,0.9722895255192271,1.0902426329032588,1.215773226503579,0.6543424883568255,9365,9258,Clinton+Cumberland+McCreary+Wayne,Clinton,21,53,Kentucky,KY
21057,21CS018,78,78,79,97,18,19,19,1263.1434931443455,4,267.9618154412996,9.55029277844274,9.941352872427991,10.36418311940847,0.20145476028540063,94,93,95,111,16,17,18,286.49033091427674,11,187.20217835262082,0.8661331902808449,0.9946417055021594,1.1221678055458681,0.6167934286995356,5971,5876,Clinton+Cumberland+McCreary+Wayne,Cumberland,21,57,Kentucky,KY
21147,21CS018,189,181,196,198,2,9,17,222.6675078838076,11,260.12415016257756,-2.1719966947403857,-0.39041038952825635,1.439171222583412,1.056062291828892,230,221,239,290,51,60,69,354.18952875233623,57,337.55774013976077,-0.3936417885494575,0.15446930787023969,0.699890175820304,0.937369819295618,16915,16886,Clinton+Cumberland+McCreary+Wayne,McCreary,21,147,Kentucky,KY
21231,21CS018,197,188,205,258,53,61,70,1248.5525002217473,26,529.5585314934569,5.421514749708123,7.188774555763932,8.919613644228866,0.41733007180622933,240,230,250,334,84,94,104,481.342587364142,46,235.43863240863956,1.991635646769077,2.4455537474564695,2.973395924085487,0.48398272471961656,19639,19538,Clinton+Cumberland+McCreary+Wayne,Wayne,21,231,Kentucky,KY
21059,21CS019,947,902,991,1034,43,87,132,339.2455828465703,92,357.2329974566564,-1.9456580126324352,-0.1450981218715229,1.5227434069516825,1.0411054318790587,1160,1107,1214,1310,96,150,203,145.11024337233513,191,185.26421975634358,-0.9351021940926575,-0.392633135643576,0.07902854489713987,1.2682362368800186,103014,103096,Daviess,Daviess,21,59,Kentucky,KY
21061,21CS020,135,130,140,140,-0,5,10,156.9220944634839,19,625.4629248621512,-6.379349608416071,-4.684300330718748,-2.9300786035706095,3.2946638495328213,166,160,173,187,14,21,27,169.34260008078599,29,236.3873492011738,-1.1979461397423503,-0.6588781763170876,-0.16668804812210125,1.3318055730579117,12151,12268,Edmonson+Warren,Edmonson,21,61,Kentucky,KY
21227,21CS020,922,864,980,1081,101,159,217,471.4781996080975,95,281.7883176495888,0.18692214006820693,1.9252073113792783,3.7533869029614615,0.5939332873322128,1149,1078,1219,1336,117,187,258,136.961957650437,158,115.42957334891877,-0.29989953773207756,0.20529390594337169,0.7140076765454842,0.8383140167491754,134853,136880,Edmonson+Warren,Warren,21,227,Kentucky,KY
21063,21CS021,67,66,68,65,-3,-2,-1,-102.7003681373744,3,163.02132862382828,-3.0591958975695257,-2.656093113087997,-2.2529757666093073,-3.3710004252084236,83,82,84,115,31,32,33,436.04701655501856,15,203.41741253051262,2.2002522536004587,2.3254697293973647,2.459318238495256,0.45243263525852023,7361,7374,Elliott+Johnson+Lawrence+Magoffin,Elliott,21,63,Kentucky,KY
21115,21CS021,273,264,283,302,19,29,38,505.6414906166998,17,301.40507956207614,0.30241981332505796,2.064436515961485,3.880091601374031,0.5758916021420347,335,324,347,435,88,100,111,442.251474329383,68,301.3249435015731,0.8966523380417951,1.416726618890455,1.8921576411163297,0.6745838324382137,22561,22567,Elliott+Johnson+Lawrence+Magoffin,Johnson,21,115,Kentucky,KY
21127,21CS021,191,184,198,182,-16,-9,-2,-228.06241141718817,14,346.57754672607996,-7.425952997337847,-5.7195753789779875,-4.171385644363224,-1.7047015808856147,236,227,244,276,32,40,49,246.7100883186295,37,227.13321055862494,-0.3093211646129431,0.1895230198484571,0.7397418828963478,0.8982964887863626,16158,16290,Elliott+Johnson+Lawrence+Magoffin,Lawrence,21,127,Kentucky,KY
21153,21CS021,142,137,147,152,5,10,15,345.3330163344618,10,342.7592116538132,-1.6191797828528895,0.045491827460485953,1.667776741860292,0.9029271384158463,172,166,178,217,39,45,51,388.6024999845812,24,208.49622100599427,1.2760164128617313,1.80111929205014,2.3006424498450895,0.5247962537378197,11670,11511,Elliott+Johnson+Lawrence+Magoffin,Magoffin,21,153,Kentucky,KY
21065,21CS022,172,166,178,195,17,23,29,645.3378019519563,11,311.37216049819546,1.5061293126502089,3.334033385114287,4.952636529282989,0.4622203911497563,210,203,217,273,56,63,70,447.22577187784754,27,191.51652716697404,2.054648289871287,2.5553357420186478,3.0495279349592397,0.4215463958943601,14131,14098,Estill+Madison+Rockcastle,Estill,21,65,Kentucky,KY
21151,21CS022,710,669,750,833,83,123,164,530.2618957336803,63,270.5953096812989,0.8190911197190085,2.5912898001070346,4.344829964718777,0.5062047258256056,888,839,937,1071,134,183,232,193.84587789526688,142,150.4062026670621,-0.06917055377139888,0.43713239737522835,0.9522150422616809,0.7716895083681515,93128,94411,Estill+Madison+Rockcastle,Madison,21,151,Kentucky,KY
21203,21CS022,168,161,175,192,17,24,31,596.5968788473754,13,321.8020917135961,1.1147463658762833,2.732383211328628,4.420140247050277,0.5179071906307905,206,197,214,317,103,111,120,691.6053042075308,39,242.14578417980874,3.9928863566732926,4.489810000311034,5.019521727128805,0.34700611484747945,16159,16106,Estill+Madison+Rockcastle,Rockcastle,21,203,Kentucky,KY
21067,21CS023,2089,1950,2228,2478,250,389,528,482.5145992003877,142,176.09072392508705,1.3592690087789683,3.106665934851699,4.758022194444827,0.3640083148067771,2571,2405,2737,2837,100,266,432,82.60387570226133,229,71.1440838568171,-0.38526615359393135,0.11075256590324661,0.636230316872545,0.8580410204784858,322561,321882,Fayette,Fayette,21,67,Kentucky,KY
21071,21CS024,457,442,472,541,69,84,99,940.6026733127744,46,515.8251801183034,2.581201939134404,4.186978751385678,5.937442476968994,0.5419377662768041,552,534,571,680,109,128,146,360.89188526901745,110,311.22679945676776,-0.04328667388988971,0.501187884174037,1.0083586273535288,0.8556740231426282,35671,35344,Floyd+Martin,Floyd,21,71,Kentucky,KY
21159,21CS024,131,126,136,140,4,9,14,323.7155162048606,6,213.84656508954825,-0.5322768070431899,1.0754275195901177,2.8605066146940357,0.5950817625410528,159,153,165,185,20,26,32,233.1355168840513,29,260.01972563435845,-0.7798132980765309,-0.2750893583810541,0.2929556854596621,1.0740102620296905,11223,11153,Floyd+Martin,Martin,21,159,Kentucky,KY
21079,21CS025,155,148,162,203,41,48,55,1123.143187587047,22,514.9511381590497,4.422996279327192,6.07769443494318,7.847951165728525,0.4491309688478537,193,184,202,241,39,48,57,278.8978526992066,33,190.7514450867052,0.35050692863488175,0.8731686584516225,1.3771778911145371,0.670059897134109,17089,17300,Garrard+Jessamine,Garrard,21,79,Kentucky,KY
21113,21CS025,414,391,437,454,17,40,63,300.20451213909035,49,368.4764626259588,-2.361537697986112,-0.6956492921648801,1.0624764901686372,1.1974234568059794,513,485,541,597,56,84,112,156.80844418353877,51,95.27189852608768,0.09164591958816985,0.6048654958991739,1.1346792890733843,0.6004158532761598,53192,53531,Garrard+Jessamine,Jessamine,21,113,Kentucky,KY
21093,21CS026,828,781,876,1003,127,175,222,630.0861087339409,84,303.1177829099307,1.6297432883923582,3.273660260583319,4.896085341525584,0.4783341331780044,1030,972,1088,1396,308,366,424,328.2914542078065,223,200.0394696711459,0.7765404545624378,1.287810995665235,1.7855679685991863,0.6076745524769537,110848,111478,Hardin+Larue,Hardin,21,93,Kentucky,KY
21123,21CS026,161,154,167,162,-5,1,8,33.11099953809198,6,161.9761085239927,-3.1118459267887864,-1.2574256696993262,0.3911894415437586,2.6947952988351225,199,191,207,225,18,26,34,173.0531302307422,34,226.59113628790405,-1.0613794724010452,-0.5342823010120163,-0.018842253811497473,1.260817901442341,14817,15005,Hardin+Larue,Larue,21,123,Kentucky,KY
21101,21CS027,429,410,448,543,95,114,133,1018.6939961263032,60,536.8647100930566,2.9302740543269152,4.780965369536521,6.477398149864166,0.5224240010110603,521,498,544,638,94,117,140,264.383890833244,71,160,0.5401791507893025,1.0472570810849022,1.5493208980215363,0.600065830311914,44704,44375,Henderson+Union,Henderson,21,101,Kentucky,KY
21225,21CS027,145,139,151,142,-9,-3,3,-81.65523214231504,13,377.93444291009524,-6.33556494747364,-4.582856910506752,-2.907464341856638,-7.187340272566491,175,168,182,245,63,70,77,518.8278320542945,40,295.00700641640236,1.7242095638327177,2.2378920017413177,2.721361127866668,0.5606334482539965,13759,13559,Henderson+Union,Union,21,225,Kentucky,KY
21103,21CS028,161,155,168,164,-4,3,9,69.75499058426172,3,76.3213127265789,-1.7200585751305333,-0.02202325625235178,1.8043334184273458,0.8017329634619803,197,189,205,230,25,33,41,212.86060289286237,29,185.20883893217524,-0.22614547805047558,0.2575017666662906,0.7792383294056591,0.8447492651696645,15723,15658,Henry+Shelby,Henry,21,103,Kentucky,KY
21211,21CS028,332,311,352,416,64,84,105,697.4766821480142,39,322.77420289255343,2.097645216720734,3.731197021570579,5.5033650437793575,0.457347299428371,410,385,435,508,73,98,123,201.46328030604292,77,159.0251961999174,-0.08640395860311924,0.4329488840852693,0.9488943093552419,0.7813410058994311,48331,48420,Henry+Shelby,Shelby,21,211,Kentucky,KY
21107,21CS029,504,484,523,613,90,109,129,965.9187247995643,95,839.9646330680813,-0.4102702078884052,1.227265460897913,2.852478552095162,0.8617138973627955,608,585,632,756,124,148,171,327.0884249880379,103,228.0224037546213,0.46059678286089917,0.9739220600127477,1.4854390813691258,0.6924411063877077,45240,45171,Hopkins+Webster,Hopkins,21,107,Kentucky,KY
21233,21CS029,147,141,153,174,21,27,33,831.7818704769458,23,709.6575131132366,-0.4689191831214819,1.240061279008245,2.8705182388883634,0.8226610816100264,176,170,183,205,22,29,35,224.04702816635185,28,218.0855206791806,-0.4172148476304546,0.057369743074153344,0.5972929429927946,0.9406895903268556,12964,12839,Hopkins+Webster,Webster,21,233,Kentucky,KY
21111,21CS030,6914,6579,7250,8138,888,1224,1559,627.9405189875183,753,386.3574267979666,0.6526910831432076,2.409420130291622,4.167783064818252,0.6147747753158466,8450,8048,8852,9578,726,1128,1530,144.91005067951687,907,116.5069994116846,-0.22877671068457486,0.28258205270377956,0.8056225762853014,0.803283240948181,779589,778494,Jefferson,Jefferson,21,111,Kentucky,KY
21117,21CS031,1334,1262,1407,1390,-17,56,128,131.80018026414228,109,258.07062611722085,-2.9273762720527383,-1.247673847069965,0.3423278244833294,1.9234915143225737,1641,1553,1728,1753,25,112,200,66.34158484520702,197,116.25848332841547,-1.0430339151094414,-0.5184353419211257,-0.003441672071578035,1.7369711542999702,168946,169450,Kenton,Kenton,21,117,Kentucky,KY
21119,21CS032,169,163,175,197,22,28,34,791.1184972742248,11,308.7502631394288,3.288953443603771,4.913472549523252,6.513489197805233,0.37689852875222646,206,199,213,269,56,63,70,447.1282384158832,34,241.666074347857,1.541940943941635,2.0489811327911998,2.556680300322946,0.5320274928184284,14251,14069,Knott+Letcher+Perry,Knott,21,119,Kentucky,KY
21133,21CS032,286,277,295,324,29,38,47,707.0481131466211,24,447.99104017919643,0.8433374874148651,2.5323688730260283,4.301303122717417,0.6173103857033071,349,338,360,427,67,78,89,364.6439773966637,61,286.6676065604587,0.2722933963204837,0.7725443831698793,1.2847558854151315,0.7761545775029854,21429,21279,Knott+Letcher+Perry,Letcher,21,133,Kentucky,KY
21193,21CS032,404,392,416,436,20,32,44,454.91195794648655,33,472.1874441065999,-1.8766912564414298,-0.20124471923010792,1.4996263084639325,1.006322772913908,494,480,509,594,85,100,114,356.91284738880904,87,310.78088161748946,-0.03839890406345784,0.45915360326764193,1.0021378832734966,0.8621186620790813,27955,27994,Knott+Letcher+Perry,Perry,21,193,Kentucky,KY
21121,21CS033,337,324,350,411,61,74,87,974.8071902648096,30,396.56311962987445,4.169359922724132,5.722930951628883,7.388684233160275,0.4013691292695999,407,392,423,526,103,119,134,396.4176845214216,84,280.5423819384143,0.6572429415571736,1.149166558252767,1.641172727668585,0.701781454095352,30260,29942,Knox+Whitley,Knox,21,121,Kentucky,KY
21235,21CS033,430,414,446,474,28,44,60,482.938523714614,25,272.73223149511807,0.3709309817253462,2.118260518640524,3.8715642377789496,0.5522596725749712,526,507,545,635,90,109,128,295.5108098061596,108,292.6670641157661,-0.49242041370073364,0.027352846486209254,0.5596305373119421,0.9813774627335912,36666,36902,Knox+Whitley,Whitley,21,235,Kentucky,KY
21125,21CS034,585,559,612,687,75,102,128,651.3483806437836,27,173.11576315198923,3.055942353074213,4.760529311198337,6.51259427094581,0.2631898310346154,719,687,752,940,188,221,253,352.6750456790795,142,226.92406034262336,0.751431253674252,1.2701038702202645,1.8011145466067797,0.6405342623484622,62386,62576,Laurel,Laurel,21,125,Kentucky,KY
21141,21CS035,282,270,293,317,24,35,47,516.3353469119633,40,582.4747897630056,-2.3739003046052423,-0.6803507073247517,1.2003194518056661,1.097151711270665,347,333,362,389,27,42,56,150.04788396363872,41,147.84897767841045,-0.4984558968680196,0.013320465579895838,0.5533721535191115,0.9622204397442051,27469,27731,Logan+Simpson+Todd,Logan,21,141,Kentucky,KY
21213,21CS035,195,187,204,222,18,27,35,548.6717361565203,24,493.04093266909763,-1.1733509379831588,0.5241922279488734,2.361447469693076,0.8661768203893357,241,231,251,265,14,24,34,121.40661731480672,55,279.13114088509946,-2.0863157226769173,-1.5678873333255057,-1.085401649728437,2.206889035785921,19471,19704,Logan+Simpson+Todd,Simpson,21,213,Kentucky,KY
21219,21CS035,119,118,120,121,1,2,3,72.65603265778645,13,423.2459710239297,-3.8986213035421406,-3.5209675714334714,-3.1022631572152792,4.022737697906235,146,144,148,184,36,38,40,309.1553936121952,20,162.813415825464,1.335623094710796,1.463786523917706,1.593666357595875,0.5131277506752595,12286,12284,Logan+Simpson+Todd,Todd,21,219,Kentucky,KY
21033,21CS036,146,141,152,145,-7,-1,4,-35.439898737893266,14,442.82777162739205,-6.385587893921195,-4.691341245476814,-3.0486416144341266,-116.24778849314455,178,172,185,210,25,32,38,251.40843456523194,30,237.6237623762376,-0.37581448399815964,0.13950928576054292,0.61815591188396,0.916301511599531,12646,12625,Lyon and Nearby Counties,Caldwell,21,33,Kentucky,KY
21055,21CS036,110,109,110,112,2,2,3,108.52647000459052,12,536.0134003350084,-4.68949889353587,-4.269216532472534,-3.8721683437547734,3.4989132330895054,134,133,135,157,22,23,24,253.73809697615508,23,256.8971294538144,-0.15668498738821465,-0.030884134122124495,0.08837501731966775,0.9697614948506805,8955,8953,Lyon and Nearby Counties,Crittenden,21,55,Kentucky,KY
21139,21CS036,125,122,129,154,25,29,32,1285.7508706062792,19,853.836647567689,2.6284523802661486,4.3613003936228925,5.92638969284901,0.6416497287717601,154,149,158,174,16,20,25,227.76248143256194,27,301.94587340639674,-1.2220020922145547,-0.7490345554208944,-0.21469821976239029,1.2636591556786512,8901,8942,Lyon and Nearby Counties,Livingston,21,139,Kentucky,KY
21143,21CS036,105,104,106,112,6,7,8,308.711499985838,12,556.9091541942221,-2.876487999972507,-2.484383898351727,-2.120257223182734,1.5682254428568214,132,130,133,139,6,7,9,84.25912849561097,13,148.01320733234658,-0.7639538432790386,-0.6345032456055418,-0.515676669331381,1.5475307543996975,8619,8783,Lyon and Nearby Counties,Lyon,21,143,Kentucky,KY
21221,21CS036,152,146,158,196,38,44,50,1231.5446404577035,6,169.39582156973464,8.882061247601813,10.576840903498969,12.382613602908021,0.13446489678018866,187,180,194,258,64,71,78,501.988921903764,25,176.37928601665018,2.7430440113776475,3.2695647223782154,3.754772882774776,0.3464911749743224,14168,14174,Lyon and Nearby Counties,Trigg,21,221,Kentucky,KY
21145,21CS037,703,674,732,795,63,92,121,546.3731643973789,76,450.550590606613,-0.8323551870366861,0.9991508689124662,2.701702400778143,0.8157693250837222,856,821,891,1006,115,150,185,221.7042838184849,109,161.45756184268998,0.09695781098879848,0.6178708441396304,1.1142923858118647,0.7234230210790559,67473,67510,McCracken,McCracken,21,145,Kentucky,KY
21155,21CS038,189,180,197,232,35,43,52,888.2538065172585,27,552.5709900230238,1.6589780590458565,3.381738368141299,5.015442354473724,0.6080765864457142,233,223,243,256,13,23,33,117.46369517679487,30,152.2533495736906,-0.8783909862955697,-0.34459910809343886,0.17768608397130678,1.242490877080633,19545,19704,Marion+Nelson+Washington,Marion,21,155,Kentucky,KY
21179,21CS038,388,368,408,441,33,53,73,454.937571078349,36,308.2587661086612,-0.29854360179414746,1.4489113109602905,3.1574310825826006,0.6650670051585186,480,456,505,618,113,138,162,292.75213722586517,87,184.9175310321374,0.5676725210858078,1.075893260941578,1.596026459444264,0.627099225821773,46714,47048,Marion+Nelson+Washington,Nelson,21,179,Kentucky,KY
21229,21CS038,130,125,136,150,14,20,25,651.0789244662186,27,897.0099667774086,-4.231468430948851,-2.4590790071212627,-0.8514694300539106,1.3108402451682148,160,154,166,151,-15,-9,-3,-73.82644505229686,18,149.1918773311231,-2.765369575009603,-2.2200101784866835,-1.7235404335898676,-2.2764176574468675,12040,12065,Marion+Nelson+Washington,Washington,21,229,Kentucky,KY
21185,21CS039,376,347,405,424,19,48,77,282.5615318578788,50,295.72674848440045,-1.7347350835765716,-0.1921025004145692,1.5415209966747585,1.0251344305147074,473,437,508,486,-22,13,49,19.57606625110423,37,53.98858943866458,-0.864451311592762,-0.36446872903335575,0.13460440147066455,2.5665810162558467,67630,68533,Oldham,Oldham,21,185,Kentucky,KY
21041,21CS040,120,119,121,122,1,2,3,88.83744865025736,13,480.99158264730363,-4.3139439161364965,-3.921960281163521,-3.5198962329498733,3.8223443238171413,147,145,148,154,6,7,9,66.99928316597244,23,211.80587531080212,-1.566342538688958,-1.4510812970509341,-1.331399806680804,2.779304327801093,10811,10859,Owen and Nearby Counties,Carroll,21,41,Kentucky,KY
21077,21CS040,86,85,87,100,13,14,15,654.213315305333,11,505.514705882353,1.1008470948453333,1.4867899861955238,1.8711091756300118,0.7219893528207953,105,104,107,120,13,15,16,165.86331527703172,23,262.58705331658865,-1.0856829508209191,-0.9647960808717913,-0.8391208163486489,1.4811983331165415,8704,8759,Owen and Nearby Counties,Gallatin,21,77,Kentucky,KY
21081,21CS040,208,197,219,227,8,19,30,301.7453799236012,13,207.59311748972013,-0.8826266037442219,0.9158406271234225,2.6377049733379674,0.6533960240622132,254,241,267,321,54,67,80,264.13010237481546,36,142.80047600158667,0.7040864543357858,1.2156101714909506,1.7293955066331077,0.5326452439891738,25049,25210,Owen and Nearby Counties,Grant,21,81,Kentucky,KY
21187,21CS040,105,104,106,133,27,28,29,985.3358573292733,11,391.668150258145,5.560638839136066,5.925699890563404,6.331604291011648,0.38363406540182593,129,128,131,160,29,31,32,270.71818400502474,18,159.37666017354348,0.993675401699715,1.1125975827533436,1.2320624482499016,0.5700728530977718,11234,11294,Owen and Nearby Counties,Owen,21,187,Kentucky,KY
21223,21CS040,87,86,87,98,11,11,12,542.4135473693678,11,518.9903279075254,-0.16733603690111043,0.23372245925481105,0.6552675729723545,0.8802496291829505,106,105,107,147,40,41,42,478.73221994009344,25,293.42723004694835,1.7244152837555387,1.8539203113875127,1.9789666084372641,0.5982580858326709,8478,8520,Owen and Nearby Counties,Trimble,21,223,Kentucky,KY
21195,21CS041,682,657,707,781,74,99,124,681.0066987314653,47,322.8520890934382,1.9065323278824895,3.6518128968009576,5.283397912000261,0.46934642250667974,824,794,854,1076,222,252,282,438.08774405498457,160,278.0722640296147,1.076811324716576,1.6029180103875231,2.0952630337173384,0.6322328748523508,58231,57539,Pike,Pike,21,195,Kentucky,KY
21199,21CS042,710,682,738,814,76,104,132,636.4833633842502,66,405.57979475204326,0.5605276422755899,2.2963177023578845,4.057196611725074,0.6311263619825853,870,836,903,1042,139,172,206,263.6191273302004,165,252.4325316688085,-0.3840966655442479,0.11909252465859091,0.6495277494915922,0.9520402160165499,65092,65364,Pulaski,Pulaski,21,199,Kentucky,KY
21209,21CS043,377,352,402,389,-13,12,37,84.32918570734688,23,160,-2.3907720144030096,-0.748103380831377,0.9928201266640894,1.7527387854644307,470,440,500,559,59,89,119,152.81182195658994,51,87.7208070314247,0.1540118033979274,0.65246412567614,1.1425130523575162,0.5676552372067905,57500,58139,Scott+Woodford,Scott,21,209,Kentucky,KY
21239,21CS043,220,209,232,237,5,17,28,249.17547183513005,6,89.29900282780176,-0.1035498268597735,1.5439665307847814,3.1715094514606044,0.3381786832465639,272,258,286,301,15,29,43,107.30878002594557,31,114.61106181603076,-0.6268864498230811,-0.08480664839156983,0.4569656057292625,1.0324771062152183,26876,27048,Scott+Woodford,Woodford,21,239,Kentucky,KY
21007,21CS044,91,90,91,96,5,5,6,282.2763546869156,6,310.27795733678084,-0.6824599475653553,-0.269227444704264,0.1322462545280339,0.9290055493935305,111,110,112,134,22,23,24,297.0141304067338,24,311.72879594752567,-0.2758966436986557,-0.1471866614215215,-0.014409372809982411,1.005567580490541,7735,7699,Southwest Kentucky,Ballard,21,7,Kentucky,KY
21039,21CS044,63,62,63,69,6,6,7,536.7014353882059,4,333.6113427856547,1.660542615263428,2.015245216520108,2.4217505727278525,0.5379923318414461,77,76,78,107,29,30,31,625.6074283440879,10,208.59407592824365,4.047633092382521,4.1678997078779725,4.288760296366478,0.3226678683770872,4796,4794,Southwest Kentucky,Carlisle,21,39,Kentucky,KY
21075,21CS044,86,86,87,111,24,25,25,1535.8721277962745,19,1182.511280535242,3.1315337374172136,3.53739808340985,3.974207519678496,0.7399438107742407,108,107,108,125,17,17,18,266.8892761715331,14,215.05376344086022,0.38907669677476,0.5218459969438993,0.6482100924990031,0.7619258313302324,6427,6510,Southwest Kentucky,Fulton,21,75,Kentucky,KY
21083,21CS044,394,379,410,471,61,77,92,835.794923524116,66,720.937218383899,-0.5933219724294019,1.1257741387361,2.8648062589392604,0.8514488124355851,485,466,504,578,74,93,112,254.9794588944371,52,142.07650273224044,0.627243502015482,1.1162378832307334,1.6394140486292823,0.5513001664291218,36619,36600,Southwest Kentucky,Graves,21,83,Kentucky,KY
21105,21CS044,57,56,57,76,19,19,20,1715.417594694917,7,623.885918003565,10.526227584632759,10.925238502890663,11.336422192260601,0.3457304807305453,69,69,70,72,2,3,3,64.66347043666683,11,247.85939612438037,-1.9471469799068628,-1.8354468300304327,-1.709438341169115,2.8425500043033662,4488,4438,Southwest Kentucky,Hickman,21,105,Kentucky,KY
21025,21CS045,176,171,182,183,1,7,12,194.56036164085387,7,207.2538860103627,-1.760261211770014,-0.11020083455660527,1.6208757562170306,0.9245469061963665,216,209,223,277,54,61,68,447.6515367289412,47,346.32672610714025,0.4652260263684598,1.0179025990487387,1.5526092581660087,0.7611238651738073,13510,13571,Wolfe and Nearby Counties,Breathitt,21,25,Kentucky,KY
21129,21CS045,94,94,95,124,29,30,30,1600.94682046053,16,867.9142934635205,6.933012734832554,7.347983335336565,7.7344211924057324,0.5243588505887458,117,116,118,150,32,33,34,443.0169017324665,22,295.778435063189,1.353749182438437,1.4782912856752917,1.6010449502630335,0.6479812982654389,7374,7438,Wolfe and Nearby Counties,Lee,21,129,Kentucky,KY
21165,21CS045,73,72,74,80,6,7,8,451.53584580541064,5,323.78177108628785,0.8635578042464315,1.269455563037065,1.7144929265835684,0.6271289224824081,90,89,91,127,36,37,38,601.0762865643128,22,355.8718861209964,2.32202472573789,2.449511583351059,2.579249625977687,0.5765420345158697,6177,6182,Wolfe and Nearby Counties,Menifee,21,165,Kentucky,KY
21175,21CS045,132,130,133,138,5,6,8,180.2412103712986,7,204.8580626280363,-0.6453923902068038,-0.25364498828916515,0.16830090537978157,0.9778117529520923,164,162,166,183,17,19,21,137.1708857291074,19,137.63129300977906,-0.13120057619559053,-0.006507974407781923,0.12683254725534904,0.9530286882459932,13668,13805,Wolfe and Nearby Counties,Morgan,21,175,Kentucky,KY
21197,21CS045,169,163,174,163,-11,-6,-0,-174.73755075960054,5,154.13070283600493,-5.108808463905908,-3.3101772455387164,-1.56871280264302,-1.071010996486956,208,202,215,218,3,10,16,73.38201876586159,19,144.7508761237239,-1.2199212504005923,-0.7300045652289296,-0.20679117621733648,1.7870371326949492,12976,13126,Wolfe and Nearby Counties,Powell,21,197,Kentucky,KY
21237,21CS045,86,85,87,102,15,16,17,967.7216594116184,4,241.14544084400902,6.854770701714239,7.268383983517427,7.711677443346821,0.23457544711813919,104,103,104,164,60,60,61,926.9428901636137,11,168.86705557261283,7.468193364147204,7.5758530985652,7.699564698346892,0.17920837509399368,6635,6514,Wolfe and Nearby Counties,Wolfe,21,237,Kentucky,KY
22001,22CS001,529,504,554,770,216,241,266,1659.6801556949565,134,922.0553577265143,5.699130527739083,7.349049774029261,9.198141966863238,0.5532682367939532,646,617,676,882,206,236,265,411.05811817763987,83,144.821328866555,2.1641805908857865,2.6596708048308253,3.147759772689168,0.35082435251706023,58131,57312,Acadia +Jefferson Davis,Acadia,22,1,Louisiana,LA
22053,22CS001,342,329,356,365,9,23,36,281.7230011689445,56,698.2761308020824,-5.881473835645431,-4.1193676528614,-2.5982868882260215,2.3735370569848024,423,407,440,515,75,92,108,283.84042475168326,66,204.2142393019586,0.2947595949301305,0.7918001464123621,1.2975942946011163,0.7117101026247188,32079,32319,Acadia +Jefferson Davis,Jefferson Davis,22,53,Louisiana,LA
22003,22CS002,206,196,215,320,105,114,124,1979.4837908796915,53,917.0343455316204,8.760440720253182,10.606455558338057,12.260662575803595,0.45925512095524934,250,238,261,339,78,89,101,393.3467235176272,39,171.89703808180536,1.7002254177463285,2.2234160533686165,2.743583659827857,0.4321688561191509,23118,22688,Allen+Evangeline,Allen,22,3,Louisiana,LA
22039,22CS002,315,301,329,416,87,101,115,1243.8441087015824,57,702.489524279024,3.639068674990103,5.4227932766383065,7.099835846184051,0.5592319278257892,384,368,401,490,89,106,122,327.5273862546884,78,242.0255678292168,0.363052031250144,0.8572608707249605,1.3818182909959433,0.7320127157847978,32456,32228,Allen+Evangeline,Evangeline,22,39,Louisiana,LA
22005,22CS003,655,601,710,841,131,186,240,584.2094000044874,116,365.0640042171187,0.5043875590984321,2.1856648150028457,3.684142324009084,0.621537349205298,821,755,887,1009,122,188,254,146.65627660349386,115,89.72668471603455,0.07813017152350916,0.5601329870350444,1.093561385402828,0.6085784690709304,127101,128167,Ascension,Ascension,22,5,Louisiana,LA
22007,22CS004,180,171,189,226,37,46,55,867.3181007166073,24,455.45118132650157,2.363977829019552,4.10987649927147,5.780491699206311,0.5138820160920218,219,208,230,325,95,106,117,512.1867232899878,31,149.54172696575012,3.1060072576723625,3.632235671804824,4.152807953512997,0.2892430300526632,21078,20730,Assumption+St.James+St.John the Baptist,Assumption,22,7,Louisiana,LA
22093,22CS004,167,158,176,210,34,43,52,851.0044835215017,38,751.693783690223,-0.5938997175341068,1.0647160524230304,2.7759967835951387,0.8632360545290397,202,192,212,254,42,52,62,262.78809677061025,21,106.07132033538741,1.0296565723041877,1.5649892792585105,2.0930451921954853,0.39602625446882067,20221,19798,Assumption+St.James+St.John the Baptist,St. James,22,93,Louisiana,LA
22095,22CS004,349,331,367,440,73,91,109,857.0760550634703,91,857.9846788450207,-1.794102882438619,0.007218889560529238,1.6730948614007912,0.9901676451831652,427,406,449,476,27,49,70,115.46421082016145,43,102.04565949973896,-0.39079582857209655,0.11854695294885702,0.6705943486975144,0.8659872774672164,42425,42138,Assumption+St.James+St.John the Baptist,St. John the Baptist,22,95,Louisiana,LA
22009,22CS005,410,393,427,526,99,116,133,1169.557830410035,71,716.2131490681663,2.6938072909100628,4.60793801651212,6.26717726533704,0.6071427784729463,500,480,520,627,107,127,147,323.64005193375016,75,190.88340841414063,0.8319546304821626,1.3250181830544636,1.8391725590987982,0.5851995414091161,39653,39291,Avoyelles+East Feliciana+Pointe Coupee+West Feliciana,Avoyelles,22,9,Louisiana,LA
22037,22CS005,219,210,227,278,51,59,68,1221.2599020180555,67,1382.2983288632142,-3.265189196407785,-1.6329277502241213,-0.10594289641044585,1.1130591038909954,268,258,278,293,15,25,35,131.03566456434285,38,196.34184147979744,-1.1937357967146476,-0.6474152603811496,-0.16134269635598358,1.44154301138457,19388,19354,Avoyelles+East Feliciana+Pointe Coupee+West Feliciana,East Feliciana,22,37,Louisiana,LA
22077,22CS005,211,202,220,281,61,70,79,1345.9894634505422,45,865.0934781563896,3.1873586125781483,4.831109987395618,6.457925652691061,0.6336688814779305,255,245,266,327,61,72,82,351.6302811289066,27,132.32050967900025,1.6863159632397493,2.19633676211191,2.7460792045419384,0.37113321017405565,20807,20405,Avoyelles+East Feliciana+Pointe Coupee+West Feliciana,Pointe Coupee,22,77,Louisiana,LA
22125,22CS005,120,118,121,149,28,29,31,768.4332345621328,26,678.5411365564037,0.5008634376145008,0.8899661939762629,1.3049705889811096,0.8540147101604586,149,147,151,168,17,19,21,124.20462104533729,14,90.56213209133837,0.21190462865265067,0.33632943121656683,0.45955870704363583,0.6930421215849969,15327,15459,Avoyelles+East Feliciana+Pointe Coupee+West Feliciana,West Feliciana,22,125,Louisiana,LA
22011,22CS006,323,307,339,423,84,100,116,1090.2436489365607,54,588.0591326127794,3.3670028612212306,4.959005124407742,6.791604008070253,0.5340488339076624,396,377,415,468,53,72,91,197.8249014797593,75,205.01886173527967,-0.5748855537194795,-0.07466035396846074,0.44265560466867787,1.0222397741158007,36731,36582,Beauregard +Vernon,Beauregard,22,11,Louisiana,LA
22115,22CS006,348,327,369,463,94,115,136,945.6684834551055,63,519.6197702950698,2.689106148084488,4.2305948111472,6.0339600713432056,0.5447225369087576,427,402,451,490,39,63,88,131.73053866054246,75,155.89922673983537,-0.7642026640701728,-0.25231620448129477,0.2759490805504391,1.1650860519708168,48497,48108,Beauregard +Vernon,Vernon,22,115,Louisiana,LA
22013,22CS007,163,157,168,223,55,60,66,1860.615373563358,44,1360.649400850406,3.2336447083504987,4.976471865443769,6.614629828923129,0.7193344890164407,197,190,204,264,60,67,74,524.2374665530499,30,234.4849148038143,2.3810332297514174,2.896238393081451,3.4164823509868802,0.44071668985025214,12935,12794,Bienville+Natchitoches+Red River,Bienville,22,13,Louisiana,LA
22069,22CS007,340,324,356,424,68,84,100,893.5916452155037,51,544.9300138903728,1.8070192055895005,3.4514030484898983,5.128418846399504,0.6026143389739057,415,396,434,533,99,118,137,319.08761679138775,72,194.2114207104901,0.7223549647561023,1.2467436650391819,1.7490796948545515,0.6035440500275644,37436,37073,Bienville+Natchitoches+Red River,Natchitoches,22,69,Louisiana,LA
22081,22CS007,83,82,84,139,55,56,57,2904.8254175168786,27,1398.2392542723976,14.641948693276381,15.059066619912395,15.492256154812226,0.47291941841614044,100,99,101,135,34,35,36,467.2468590533694,19,250.9244585314316,2.0344442943687207,2.162595594761802,2.2794334401832526,0.5222659545517956,7724,7572,Bienville+Natchitoches+Red River,Red River,22,81,Louisiana,LA
22015,22CS008,934,879,989,1132,143,198,253,616.7372326820151,169,526.1109813993306,-0.9464232556309781,0.8866681295246152,2.6554803223402415,0.8487710150626879,1155,1089,1222,1379,157,224,290,173.3296960829706,142,110.02037701348911,0.12760251349646065,0.6245230251475551,1.1366679082174422,0.6319215467217673,128490,129067,Bossier,Bossier,22,15,Louisiana,LA
22017,22CS009,2263,2161,2365,3042,677,779,881,1314.3226874635652,463,780.9897315874924,3.6776552773378306,5.306037243133346,7.05171727560278,0.5934529631590857,2735,2615,2856,3398,542,663,783,283.6711045822131,409,175.033166431292,0.5941437767009251,1.071637362977467,1.5759443983647445,0.6160990723949126,237135,233670,Caddo,Caddo,22,17,Louisiana,LA
22019,22CS010,1840,1748,1932,2226,294,386,478,723.5065336060862,269,504.09695902104,0.49074142801242276,2.1621800084406275,3.8969626866967184,0.6949414259460696,2181,2074,2288,2454,166,273,380,132.01682487760556,327,158.0427827129228,-0.8055344367380564,-0.25976722483675935,0.2432035749709515,1.192774493048542,213451,206906,Calcasieu,Calcasieu,22,19,Louisiana,LA
22023,22CS011,37,36,38,61,23,24,25,1671.0070907248141,3,208.29717063009895,14.21422517440085,14.627732002179892,15.042319552985623,0.11968078919826369,41,40,41,52,11,11,12,218.28571760121278,3,58.15080441946114,1.4801638138342252,1.6039990767378387,1.7224683562378067,0.24467106080808773,5761,5159,Cameron +Vermilion,Cameron,22,23,Louisiana,LA
22113,22CS011,479,454,504,639,135,160,185,1110.742580037748,65,451.28703591203373,4.963435413768938,6.551222927198452,8.289629971282812,0.40376926520640216,587,557,616,778,162,191,221,334.18124537816357,84,146.81208053691276,1.40638902595823,1.8718989609290462,2.357249273851876,0.43703305441036117,57613,57216,Cameron +Vermilion,Vermilion,22,113,Louisiana,LA
22021,22CS012,104,103,105,125,20,21,22,868.5503756403666,23,952.3809523809525,-1.260002027948549,-0.8375058689332742,-0.42997260817927496,1.0466205010678264,126,125,128,158,30,32,33,330.6011884773859,16,167.04948841094173,1.5153472882667984,1.636125287471414,1.761884565883003,0.4898211816590517,9660,9578,Catahoula and Nearby Parishes,Caldwell,22,21,Louisiana,LA
22025,22CS012,97,97,98,140,42,43,43,1904.7636660284893,22,984.2299519069454,8.781142784860663,9.197778339557015,9.632597644846106,0.5048624004027712,118,117,119,147,28,29,30,333.37887762448975,25,283.67184840576425,0.36391747037030475,0.4972982042232422,0.6228053461710518,0.8228913770481634,8941,8813,Catahoula and Nearby Parishes,Catahoula,22,25,Louisiana,LA
22029,22CS012,198,190,206,258,52,60,68,1278.0035973801828,43,921.1160499116371,1.8644958799250706,3.524458539337407,5.319278394528665,0.7088643978558562,239,229,248,295,47,56,66,305.8630393851474,30,162.9814744390721,0.9125786783067821,1.4359847371684678,1.9553894887596521,0.5235582937341179,18673,18407,Catahoula and Nearby Parishes,Concordia,22,29,Louisiana,LA
22059,22CS012,143,137,149,175,26,32,38,865.1416438708845,25,674.3543057522422,0.08442380405744022,1.9166155065469754,3.5319778430070325,0.7559044392907786,174,167,182,199,17,25,32,166.0309522363648,19,128.11003978153866,-0.1277980531391767,0.35741829598513813,0.8994362163433153,0.7414908888269354,14829,14831,Catahoula and Nearby Parishes,La Salle,22,59,Louisiana,LA
22107,22CS012,45,45,46,71,25,26,26,2478.634839953065,6,579.9903334944418,18.61516393195736,18.979767891002403,19.371923943199068,0.22521273522354052,54,54,55,85,30,31,31,754.2736742100853,6,148.00197335964478,5.933221760739077,6.06586886049649,6.186539274714498,0.19000416733066564,4138,4054,Catahoula and Nearby Parishes,Tensas,22,107,Louisiana,LA
22027,22CS013,150,144,156,202,46,52,58,1453.5012415001484,40,1116.0714285714287,1.5349288381502502,3.4585619656963003,4.958235602881665,0.7533881111813582,180,173,188,202,14,22,29,153.96776626358005,23,163.7243735763098,-0.6029465918789796,-0.10173160814836614,0.40691297253037334,1.0163772936758813,14336,14048,Claiborne+Webster,Claiborne,22,27,Louisiana,LA
22119,22CS013,416,401,432,564,132,148,163,1595.3759075758683,77,832.2974652759012,6.014325078694198,7.750207272286527,9.364523006121958,0.5181828264606929,499,480,517,698,181,199,218,549.1719697150896,74,203.95226414574316,2.928786803272438,3.4435709640908967,3.96462671501882,0.36952688406629036,37006,36283,Claiborne+Webster,Webster,22,119,Louisiana,LA
22031,22CS014,256,245,268,310,42,54,65,796.5697005566709,53,786.7587025903659,-1.6565925934184267,0.08718582332171253,1.7198181201095384,0.9696141604920137,314,300,328,376,48,62,76,230.76049308186916,57,211.81716833890746,-0.3242960898788244,0.20061269273507554,0.7087078145812897,0.9033617129150066,26946,26910,De Soto+Sabine,De Soto,22,31,Louisiana,LA
22085,22CS014,222,212,231,339,108,117,127,2094.701131116669,48,857.9471826265694,10.665153002630849,12.372299024785205,14.079506717204527,0.40611441967108075,270,258,281,374,93,104,116,471.1901871707974,51,230.42515700537658,1.8943337214561877,2.4042851293612246,2.949386643555348,0.48438327370530354,22379,22133,De Soto+Sabine,Sabine,22,85,Louisiana,LA
22033,22CS015,3381,3185,3576,4176,600,795,991,701.5207419421262,522,460.40576565611127,0.598952169316817,2.405776958546388,4.22350695417418,0.6554726169860553,4155,3921,4389,5069,680,914,1148,201.4098998977919,538,118.58631011422197,0.30464415697954494,0.819546835164175,1.3133804379048564,0.5881372890326828,453513,453678,East Baton Rouge,East Baton Rouge,22,33,Louisiana,LA
22043,22CS016,186,177,196,235,39,49,58,878.6154574546986,38,685.5184233076264,0.14061511948409,1.9477402778123394,3.6113118972022646,0.7645282804337307,229,218,241,282,41,53,64,237.34317750165778,33,148.5148514851485,0.35030522814114534,0.8842411816597257,1.369105194088093,0.61409454113689,22173,22220,Grant+Jackson+Winn,Grant,22,43,Louisiana,LA
22049,22CS016,156,150,163,200,37,44,50,1162.1810258991864,17,450.62955599734926,5.430640999410502,7.130612510586783,8.881299542736619,0.3790980566654024,189,181,197,224,27,35,43,235.12088482348335,16,107.44023636852002,0.7164470519968329,1.282380204003456,1.822823885017921,0.4442691781814676,15090,14892,Grant+Jackson+Winn,Jackson,22,49,Louisiana,LA
22127,22CS016,148,142,154,210,56,62,68,1796.212370566639,29,844.7422079813574,7.904919106393784,9.602836678778043,11.25529274797509,0.4627858669756646,179,172,186,211,25,32,39,239.08258656995253,21,155.30247004880934,0.3176380725047461,0.8559168574696877,1.3621101998116598,0.6300866868981327,13732,13522,Grant+Jackson+Winn,Winn,22,127,Louisiana,LA
22045,22CS017,621,591,651,802,151,181,211,1039.023963136937,81,465.2899445673091,4.00546754324753,5.762732064591842,7.38775815198201,0.44535228714561625,757,721,792,928,136,171,207,247.94624539821058,100,144.75131723698684,0.5372694853493732,1.014707165329662,1.5479959572740356,0.5804127499687249,69634,69084,Iberia,Iberia,22,45,Louisiana,LA
22047,22CS018,260,247,273,393,120,133,146,1743.949828109156,56,736.2366474938373,8.489329716697345,10.04563593102155,11.693907518972308,0.419007422324179,313,298,329,435,106,122,137,408.07113126914015,54,180.81971604607554,1.795297820482142,2.270659546712262,2.80548230374482,0.43950190140524253,30425,29864,Iberville+West Baton Rouge,Iberville,22,47,Louisiana,LA
22121,22CS018,185,174,197,249,52,64,75,934.6463274551343,40,588.3650805324704,1.633449197040627,3.4562072523753353,5.21562899942807,0.6197521463253215,231,217,245,285,40,54,68,195.4691648391455,26,93.82555663815813,0.5365360437927119,1.0243535191836943,1.4929204999645105,0.4713008569594657,27194,27711,Iberville+West Baton Rouge,West Baton Rouge,22,121,Louisiana,LA
22051,22CS019,3648,3459,3836,4495,659,847,1036,773.0146163564971,592,540.189111813215,0.6355792384880479,2.3060780241740737,3.997671491638319,0.697984491348228,4445,4220,4669,5112,443,667,892,153.55468553978656,415,95.49318201690805,0.08428072208905497,0.5691956714385105,1.0659793854932775,0.6209533613157441,438365,434586,Jefferson,Jefferson,22,51,Louisiana,LA
22055,22CS020,1537,1433,1642,1930,288,393,497,647.4655349883419,134,220.9024855650941,2.6221265742251805,4.260423313813517,5.989144140764726,0.34031381976963015,1911,1785,2037,2416,379,505,631,207.03495127258606,184,75.44570369519936,0.811496324857877,1.3109979478683456,1.8156129902628677,0.36369018362982114,242641,243884,Lafayette,Lafayette,22,55,Louisiana,LA
22057,22CS021,767,725,809,953,144,186,228,761.7977491393729,132,541.4607133334702,0.5834349884167331,2.197041769724493,3.9024447533115922,0.7069603189510069,944,894,995,1215,220,271,321,277.70780682038367,150,153.8414202639919,0.7083597081895776,1.2421022706220215,1.7550493472419784,0.551930307863011,97514,97503,Lafourche,Lafourche,22,57,Louisiana,LA
22061,22CS022,344,323,364,437,73,93,114,775.9672058879695,68,566.1594821305914,0.2364462831892084,2.0929902589454237,3.7260537189628176,0.7218723409867243,426,401,451,490,39,64,89,133.10177566837174,33,68.51021425012456,0.12247306079531194,0.6565757032790804,1.1975486225465244,0.5068154132943469,48043,48168,Lincoln+Union,Lincoln,22,61,Louisiana,LA
22111,22CS022,225,216,234,351,117,126,135,2374.105927457057,52,978.4551698184213,12.262504469865156,13.957854732263769,15.737550834944546,0.4088954914902936,274,263,285,350,65,76,87,359.6015323897989,34,161.16799393249906,1.461740748180962,1.9965737094809963,2.49074709493773,0.44235387843663443,21258,21096,Lincoln+Union,Union,22,111,Louisiana,LA
22063,22CS023,957,895,1018,1142,124,185,247,518.1811588861019,119,333.1490281986856,0.14328980737420655,1.8415189229670357,3.606441522381014,0.6394651637996916,1199,1124,1274,1590,316,391,466,269.04025480456045,250,171.96667973613432,0.4283860877219932,0.9623130910356658,1.4831510249297355,0.6375556199509906,142879,145377,Livingston,Livingston,22,63,Louisiana,LA
22035,22CS024,76,75,77,82,5,6,7,339.08303471003114,19,1043.2395332875772,-7.440414608116255,-7.043145419723622,-6.6249763203627685,2.6478807352638154,93,92,93,116,23,23,24,323.306504401638,19,262.2860298177802,0.47717269989518407,0.610046172434389,0.731110199950377,0.7780404813172961,7285,7244,Northeast Louisiana,East Carroll,22,35,Louisiana,LA
22041,22CS024,228,220,236,286,50,58,66,1174.3887646146216,55,1113.5857461024498,-1.1114948164227203,0.6521432577152432,2.3441429095138835,0.932155027031636,278,268,288,314,26,36,46,181.83966511571256,46,233.7873551534865,-1.0156474138612486,-0.5248824516054135,-0.016080876622069997,1.2507214586833915,19756,19676,Northeast Louisiana,Franklin,22,41,Louisiana,LA
22065,22CS024,101,100,102,118,16,17,18,672.1442908050213,18,715.0660442943688,-0.8306187846816346,-0.4303982779830536,-0.035354063759042965,1.0044893889641326,121,120,122,147,25,26,27,264.17129971285584,32,325.9319617029945,-0.7368773782675992,-0.6207923450392628,-0.4906061793109082,1.187986271760575,10069,9818,Northeast Louisiana,Madison,22,65,Louisiana,LA
22067,22CS024,314,304,325,405,80,91,101,1431.1428203453645,44,695.5971859932022,5.5693368431991415,7.350827981033257,9.103240164345378,0.4807327813232335,381,368,394,505,111,124,137,495.3815882896169,62,247.16951044490514,1.956156928589985,2.4802241231283753,2.9893198103447443,0.4949644646230066,25302,25084,Northeast Louisiana,Morehouse,22,67,Louisiana,LA
22083,22CS024,197,189,206,250,44,53,61,1056.9499797581816,45,900.0450022501125,-0.16281585946145205,1.5174291654883958,3.269589856949818,0.8357344197880014,240,230,251,303,52,63,73,316.0457279228924,42,211.76826501285734,0.5598473392498365,1.0568010691626648,1.565136158840881,0.6595337648327283,19999,19833,Northeast Louisiana,Richland,22,83,Louisiana,LA
22123,22CS024,121,116,125,156,31,35,40,1435.2295448707148,35,1419.8782961460447,-1.6530224375230305,0.09651241153643288,1.8710783217054483,0.9621091645787962,145,140,150,159,9,14,19,147.46169444762856,17,176.91747320220625,-0.7821367312624886,-0.28168040198266187,0.23038718186975138,1.12066280442609,9860,9609,Northeast Louisiana,West Carroll,22,123,Louisiana,LA
22071,22CS025,2785,2621,2950,3765,815,980,1144,1021.0160479993815,548,571.1680020845548,2.833714967941859,4.4955416897800005,6.35644148684262,0.558840907513511,3386,3191,3582,4069,487,683,878,180.61393151608686,261,69.06753534749438,0.6291207931319812,1.1297435509644949,1.6063386264578308,0.38184479176231434,383775,377891,Orleans,Orleans,22,71,Louisiana,LA
22073,22CS026,1396,1328,1465,1726,261,330,398,830.0672977168815,274,689.6898912605718,-0.29823390253216764,1.3967999506557642,3.127475797303527,0.828372330268992,1712,1630,1794,2054,260,342,424,215.246105455993,282,177.41651357676724,-0.14409138685332373,0.3650112187760038,0.874079757075499,0.8218474333104225,158912,158948,Ouachita,Ouachita,22,73,Louisiana,LA
22075,22CS027,162,151,172,209,37,47,58,810.8739134128806,20,341.58838599487615,2.9414645543029816,4.704980362318858,6.455927205752654,0.41256961292217975,198,186,210,223,13,25,37,105.93971179952771,20,85.73755733699147,-0.33740701108763915,0.19369477536141586,0.7044830538764671,0.77783008252812,23420,23327,Plaquemines+St. Bernard,Plaquemines,22,75,Louisiana,LA
22087,22CS027,305,286,324,379,55,74,93,670.4247047331107,42,378.6256789344391,1.1292334317006922,2.949587133424397,4.622054534141411,0.5572617167194437,376,353,398,489,91,113,136,256.41015902178367,47,106.34205941579746,1.003727362573328,1.4904778832873298,2.0015709497951764,0.4111065310766823,44371,44197,Plaquemines+St. Bernard,St. Bernard,22,87,Louisiana,LA
22079,22CS028,1261,1205,1317,1626,309,365,421,1126.6098861018963,211,651.5563241106719,2.9643082282050814,4.70735621026219,6.59344930201263,0.5767527442881969,1537,1471,1604,1973,369,436,502,338.1860403743353,241,187.12197091456832,1.0329773393392507,1.5130114700045183,2.0212002292505344,0.5520433142516796,129536,128793,Rapides,Rapides,22,79,Louisiana,LA
22089,22CS029,364,341,386,463,77,99,122,755.1854591593291,57,433.88901575702215,1.3839748084219512,3.2785724203700117,4.9490717438099265,0.5688128093427369,449,422,476,502,26,53,80,102.03334303199104,43,82.20068436848847,-0.29081831136963016,0.20263403684638448,0.6732229416206966,0.7908095123773516,52548,52311,St. Charles,St. Charles,22,89,Louisiana,LA
22091,22CS030,111,110,112,136,24,25,26,941.1299886582176,3,111.28628396550124,7.910174148779608,8.292495321531932,8.704682252679747,0.11376343537155488,137,136,139,172,33,35,36,317.6405329069112,19,174.16811806765057,1.3125314889821893,1.4336902703574081,1.5537143364946626,0.5329383122036555,10783,10909,St. Helena +Tangipahoa +Washington,St. Helena,22,91,Louisiana,LA
22105,22CS030,1102,1044,1159,1323,164,221,279,661.0767403524159,155,462.99062070613536,0.18237383681213523,1.9890020026560526,3.6217754636805464,0.6972080649635183,1369,1300,1439,1774,335,405,474,299.71377708617695,286,211.89266080874836,0.33019837293943866,0.9081679637103895,1.3931937463259698,0.7052400533416322,133912,134974,St. Helena +Tangipahoa +Washington,Tangipahoa,22,105,Louisiana,LA
22117,22CS030,510,490,529,630,101,120,140,1056.3922003817493,79,695.1165860096788,1.8915027975454084,3.649754041440287,5.418424632957534,0.6525745070200045,621,598,644,758,114,137,160,303.32423365857335,110,243.53524619199433,0.09963162325084074,0.5918145384429907,1.1114310836533583,0.7970697405767193,45460,45168,St. Helena +Tangipahoa +Washington,Washington,22,117,Louisiana,LA
22097,22CS031,857,822,892,1109,217,252,287,1226.1226019419576,168,817.1106868836712,2.3701958354786505,4.10436239949504,5.686525617986647,0.6637853318850205,1048,1006,1090,1249,159,201,243,244.78283275702995,122,148.59926918392205,0.4651161966448484,0.9692412378168334,1.4561871588236048,0.6040599591951128,82241,82100,St. Landry,St. Landry,22,97,Louisiana,LA
22099,22CS032,412,389,434,580,146,168,191,1299.137523415998,82,632.3135349796619,5.000668604626991,6.604257519503361,8.382155366563152,0.48384602774313124,504,478,531,631,100,127,153,245.6283844306439,62,120.27391413994451,0.7330764728536977,1.2550383227961261,1.7839904480348026,0.4858211685804953,51873,51549,St. Martin,St. Martin,22,99,Louisiana,LA
22101,22CS033,465,444,486,589,103,124,145,1010.3757587748834,87,709.2198581560284,1.277224003590159,3.068236593620641,4.633658172552266,0.6963186670130843,562,537,587,717,130,155,180,319.66194837488064,112,231.57720618641966,0.39482455785160636,0.8877496492375808,1.3533520400127965,0.719788309020155,49068,48364,St. Mary,St. Mary,22,101,Louisiana,LA
22103,22CS034,2000,1886,2114,2355,241,355,469,535.6678305836293,259,391.1382273434315,-0.32145468923622994,1.4693826802953027,3.161218454848356,0.728135208661451,2499,2360,2637,2956,319,457,596,170.1747689268432,307,114.23765898384299,0.04986808273551049,0.5622473713771935,1.0479827030009545,0.6698314266722383,264868,268738,St. Tammany,St. Tammany,22,103,Louisiana,LA
22109,22CS035,872,825,919,1054,135,182,229,663.9674011609911,116,423.9611125324367,0.7790752618283314,2.4175919313896865,4.097434154203217,0.6350314417144974,1068,1012,1125,1393,268,325,381,298.28078930615357,171,157.17345147384577,0.9253199985651537,1.4034129414501733,1.9110906404978096,0.5253124566809991,109444,108797,Terrebonne,Terrebonne,22,109,Louisiana,LA
23001,23CS001,1042,994,1089,1032,-57,-10,38,-34.95406375304107,23,83.14655484057552,-2.8625621578858316,-1.191267242308368,0.3607773762522187,-2.6531339561489973,1282,1225,1339,1480,141,198,255,178.39680274212995,150,135.09253838879633,-0.08181353178364197,0.44541397377135705,0.9293718737625227,0.7534550058858251,110648,111035,Androscoggin,Androscoggin,23,1,Maine,ME
23003,23CS002,733,704,762,796,34,63,92,376.01298922159833,21,125.3843627787563,0.848591253347705,2.3979022568460353,4.255823398444405,0.32824534551534773,892,857,926,1107,181,215,250,321.5916993216806,94,140.5523407945693,1.2983544340927355,1.805945912284239,2.3626481025800476,0.43502947567034145,66994,66879,Aroostook,Aroostook,23,3,Maine,ME
23005,23CS003,2397,2267,2527,2469,-58,72,202,95.41850504547696,106,140.18707038779579,-2.2189410901104534,-0.4927264790107488,1.193429521053822,1.4490963993830939,2965,2807,3122,3102,-20,137,295,45.08446709102435,171,56.07458247390564,-0.6333912783118613,-0.09054959507548556,0.387501280917698,1.234786017000023,302453,304951,Cumberland,Cumberland,23,5,Maine,ME
23007,23CS004,295,283,308,285,-23,-10,2,-139.6868534917121,4,54.16751303405782,-3.633975258106117,-1.8921686323531095,-0.2621535124657154,-0.4294068228553786,364,349,379,410,31,46,61,155.59164168057785,40,134.91635186184567,-0.3061170682518971,0.21066869018281623,0.770837160859212,0.8487197394444302,29538,29648,Franklin+Oxford,Franklin,23,7,Maine,ME
23017,23CS004,583,558,608,608,0,25,50,174.23256032416728,32,220.92963046067283,-2.0426314535501877,-0.407217885362351,1.2491749249341977,1.2196851255208836,721,691,752,849,97,128,158,217.95629570110958,91,155.51567974023754,0.11074528178301477,0.6342465917067535,1.1151378198745878,0.7079666593442061,57937,58515,Franklin+Oxford,Oxford,23,17,Maine,ME
23009,23CS005,534,510,558,575,17,41,65,294.6746766833461,27,194.65421840924247,-0.7070149872098245,1.036551905334675,2.8145101149892646,0.6447978659742982,660,631,689,753,64,93,122,166.02750152490452,44,78.45234911295356,0.38000459360851907,0.8883587407680067,1.3749511164547488,0.4675055773666296,55483,56085,Hancock+Washington,Hancock,23,9,Maine,ME
23029,23CS005,362,349,376,429,53,67,80,857.494751327126,2,25.722645574097296,6.492453601120801,8.298653106681746,9.898639476547917,0.029554163335135133,442,426,458,530,72,88,104,282.6981977939356,38,122.13936744664437,1.0617371131784874,1.5981548311107514,2.085753461092021,0.42719158386762635,31101,31112,Hancock+Washington,Washington,23,29,Maine,ME
23011,23CS006,1153,1100,1206,1193,-13,40,93,130.0039619275672,34,110.02346088504166,-1.4717781497819842,0.19802037626134567,1.9107601316555978,0.8257543186501357,1418,1354,1483,1629,146,211,275,169.29927678315528,124,99.69528618175094,0.2143165449613398,0.6837587222600036,1.1712039260705458,0.5860868258446749,123610,124379,Kennebec,Kennebec,23,11,Maine,ME
23013,23CS007,436,419,454,390,-64,-46,-29,-458.4405384172781,5,49.33520807124004,-6.72366836266497,-5.0785933720359075,-3.440439383123997,-0.10998244083266308,538,517,560,539,-21,1,22,1.2301430490475815,19,46.32451542118737,-0.9333219844138037,-0.44100135260629214,0.07082036681325289,12.628417953745366,40539,41015,Knox+Waldo,Knox,23,13,Maine,ME
23027,23CS007,357,340,374,388,14,31,48,309.2809598453797,20,201.60782238350848,-0.6306593555720595,1.0503935254323082,2.772973882124945,0.6312843485118032,440,419,461,529,68,89,110,223.2497076787028,32,80.25682182985554,0.905860859884466,1.420373975594779,1.9082089837518939,0.3554997679816386,39681,39872,Knox+Waldo,Waldo,23,27,Maine,ME
23015,23CS008,355,340,371,384,13,29,44,324.5761718335023,3,34.106412005457024,1.3022725749177633,2.857920152058468,4.5876149377366495,0.10152380436901022,439,420,457,453,-4,14,33,39.74777794804896,18,50.37078494473206,-0.5939013759261187,-0.10956018270757521,0.37699123259318057,1.1839092175461032,35184,35735,Lincoln+Sagadahoc,Lincoln,23,15,Maine,ME
23023,23CS008,317,302,333,302,-31,-15,0,-167.33631634026497,3,32.754667540124466,-3.712144905778361,-2.003082015187946,-0.20671785018524633,-0.20940459469078088,391,372,410,437,27,46,65,125.31853964737718,21,56.73375658516817,0.16194993999002985,0.6893928114896977,1.1986763442784862,0.44316271984254,36636,37015,Lincoln+Sagadahoc,Sagadahoc,23,23,Maine,ME
23019,23CS009,1433,1368,1499,1529,30,96,161,252.1905583385863,34,89.43896776908963,0.04453810795603123,1.5672617365018369,3.3191976568280577,0.350987269414229,1765,1687,1844,1999,155,234,312,152.98631348078976,211,138.22107511103542,-0.3272970204697021,0.14946624813254106,0.6355139791624366,0.8996343720359353,152059,152654,Penobscot+Piscataquis,Penobscot,23,19,Maine,ME
23021,23CS009,209,202,217,203,-14,-6,1,-152.72277242714358,4,95.09093070248426,-4.131505104585618,-2.4921402127062575,-0.7442532012046759,-0.7374245939413253,260,251,269,302,33,42,51,246.3146698352109,36,210.44017069036065,-0.14809432685317897,0.35397741178426967,0.8635052701532775,0.8345494076526745,16826,17107,Penobscot+Piscataquis,Piscataquis,23,21,Maine,ME
23025,23CS010,523,501,545,559,14,36,58,286.2656550112519,19,150.58152206217432,-0.45624556221694346,1.3449077478755311,2.9977074314532626,0.5118495227377516,640,614,666,774,108,134,160,265.41619103799366,65,128.54741421932167,0.8198924951637394,1.4018615585463348,1.8894061522120071,0.48074186191328816,50471,50565,Somerset,Somerset,23,25,Maine,ME
23031,23CS011,1860,1769,1951,1901,-50,41,132,77.56136227313596,82,154.89964580873672,-2.419085247004403,-0.7518490790219666,0.9173434124421931,1.949640029900811,2306,2195,2417,2367,-50,61,172,28.492410549798933,176,82.15622753540653,-1.0375519115885747,-0.5493440629652502,-0.05127064413644914,2.8369639642541524,211750,214226,York,York,23,31,Maine,ME
24001,24CS001,741,712,770,995,225,254,283,1486.9915932390431,161,942.8851700560754,3.7323324971872083,5.486871339649808,7.191483621242281,0.6316015800760817,900,865,935,1055,120,155,190,228.27159768713258,140,206.60852112572127,-0.3077103582264337,0.2164678390118542,0.7572103560042545,0.8992856744062883,68301,67761,Allegany+Garrett,Allegany,24,1,Maryland,MD
24023,24CS001,284,271,296,376,80,92,105,1279.8428422245152,49,680.6264541445289,4.416922889805726,5.925575621162153,7.6545604489617,0.5260949210442427,347,332,361,396,35,49,64,172.10077362236413,56,195.0471944550869,-0.7283721482938307,-0.23856187976067764,0.25366746467337703,1.1108498604994084,28797,28711,Allegany+Garrett,Garrett,24,23,Maryland,MD
24003,24CS002,3871,3618,4124,4228,104,357,610,242.70790994063182,356,242.32605787917052,-1.7089711176993418,0.019961803299488386,1.8807170581636383,0.995634375519585,4800,4496,5105,4995,-110,195,499,32.9797322492276,412,69.8178465939228,-0.8948616129008813,-0.3541647372157084,0.16044723692579854,2.1061703223245387,587638,590107,Anne Arundel,Anne Arundel,24,3,Maryland,MD
24510,24CS003,5384,5133,5634,6749,1115,1365,1616,935.016206403808,684,468.4017161033634,2.7888815500994117,4.710520185975912,6.39937344058571,0.5005890920108931,6540,6242,6839,7538,699,998,1296,172.73885200274677,604,104.59508368472548,0.17705670100638896,0.6866015972133406,1.168773082237542,0.6049034767448118,584114,577465,Baltimore (city),Baltimore (city),24,510,Maryland,MD
24005,24CS004,7313,6948,7679,8384,705,1071,1436,504.3991211423974,889,418.7968658542761,-0.8027009862260794,0.8983198404018569,2.651234327658773,0.8295139198395466,8968,8530,9407,9467,60,499,937,58.677339084584915,863,101.54565907015711,-0.8977909361855066,-0.4428865151413768,0.07028932871842587,1.727113708418882,849099,849864,Baltimore (county),Baltimore (county),24,5,Maryland,MD
24009,24CS005,614,574,654,711,57,97,137,418.21371211047,52,223.80030126963632,0.3021416245061856,1.9371368849979793,3.6170366725962886,0.5296828352416949,765,717,814,860,46,95,143,100.80556457542777,61,65.05140127116836,-0.1592526695998624,0.35183616345403124,0.8641322776792104,0.6385602855582013,92940,93772,Calvert,Calvert,24,9,Maryland,MD
24011,24CS006,292,278,307,347,40,55,69,655.2818667376414,15,180.00720028801152,3.0623615587229445,4.8278737446975715,6.4719920146397865,0.2697616700979596,360,343,378,436,58,76,93,226.3249046215467,58,173.79839386311878,0.042080916928103694,0.5493218637101535,1.049278773286627,0.7578811752720946,33332,33372,Caroline+Dorchester+Talbot,Caroline,24,11,Maryland,MD
24019,24CS006,354,340,368,379,11,25,39,308.6978436911112,27,333.20992225101816,-2.009208410978038,-0.2795738314511809,1.6168446544871555,1.0379111950605948,434,417,451,493,42,59,76,181.12945078463747,57,175.4277976117198,-0.4724671487787366,0.04670363314517808,0.5750420226607762,0.9523398808508241,32412,32492,Caroline+Dorchester+Talbot,Dorchester,24,19,Maryland,MD
24041,24CS006,391,375,407,458,51,67,83,716.276695255997,1,10.685473099321472,5.355891040524286,7.0240750717452,8.820853808278489,0.014698802172190502,481,462,501,556,55,75,94,198.93095103923534,52,138.294194303343,0.09078497566500793,0.5986136523965797,1.1416622350712406,0.6860155876781049,37434,37601,Caroline+Dorchester+Talbot,Talbot,24,41,Maryland,MD
24013,24CS007,1411,1337,1485,1557,72,146,220,338.3392880193131,178,413.0122047426795,-2.466961904519845,-0.6205121576176981,0.9408039897401331,1.2123898090911085,1746,1656,1836,1887,51,141,231,81.12073162827325,132,75.97996891728545,-0.4885588905028026,0.059398006588279394,0.5582711325253338,0.9300290721186969,172392,173730,Carroll,Carroll,24,13,Maryland,MD
24015,24CS008,868,823,913,1040,127,172,217,663.8217395908573,93,358.85513635530515,1.299682284134275,3.060829532798952,4.948353680297377,0.5374654370313644,1071,1018,1125,1248,123,177,230,170.04105477407043,144,138.62015190458314,-0.14426446407188814,0.2942301165337338,0.7981034202863382,0.8106266483499063,103663,103881,Cecil,Cecil,24,15,Maryland,MD
24017,24CS009,992,920,1063,1223,160,231,303,555.8307623042114,153,367.6514760125434,0.19033344624940957,1.8794816845341766,3.570836948005372,0.658597765356317,1244,1157,1331,1476,145,232,319,137.55546481087958,160,95.00961972399706,-0.08677648841694227,0.4474306156958515,0.9645700885587357,0.6877315843263095,166462,168404,Charles,Charles,24,17,Maryland,MD
24021,24CS010,1720,1603,1838,1873,35,153,270,224.53291399206935,189,278.23987516009834,-2.308616766065124,-0.585882628501631,1.2019456613640644,1.2311222026751263,2172,2028,2316,2209,-107,37,181,13.356120837370014,205,73.52941176470588,-1.0945798308349,-0.5985653347161054,-0.1078141097587045,5.361318208622737,271708,278800,Frederick,Frederick,24,21,Maryland,MD
24025,24CS011,1913,1801,2025,2163,138,250,362,383.4743487133746,158,242.601983040893,-0.39303368861201804,1.4075706167263222,3.2276465422205107,0.6301189744519992,2372,2236,2508,2606,98,234,370,89.02600307081381,231,87.93099510479395,-0.5319093595448793,0.00917755836107127,0.5418981679675213,0.9834949468141898,260509,262706,Harford,Harford,24,25,Maryland,MD
24027,24CS012,1522,1379,1665,1734,69,212,355,255.0608771873149,178,214.50758157765506,-1.2350736162628237,0.42488982329240615,2.014967914255152,0.8370505712820431,1913,1741,2086,1994,-92,81,253,24.110500942707073,93,27.822236848009812,-0.5500272957013781,-0.03320767930022876,0.46287101431615046,1.1398041349201102,331923,334265,Howard,Howard,24,27,Maryland,MD
24029,24CS013,221,213,229,285,56,64,72,1335.7459573725755,34,708.4440277126635,4.673735005654018,6.263435105272081,7.934818332692202,0.5222269957553977,272,262,282,315,33,43,53,225.16582843412456,23,119.47431302270012,0.5215654701550697,1.05887427908067,1.5544224558691924,0.5186409287635851,19197,19251,Kent+Queen Anne's,Kent,24,29,Maryland,MD
24035,24CS013,380,359,402,392,-10,12,33,92.70119964148213,27,215.3281760905973,-2.949829781325841,-1.221960621367446,0.5230560392377694,2.1388165749404826,476,450,502,523,21,47,73,92.44011659637667,48,94.71378677558752,-0.5467538647764361,-0.019478666379598344,0.48928577332950873,1.0031824565273335,50156,50679,Kent+Queen Anne's,Queen Anne's,24,35,Maryland,MD
24031,24CS014,5402,4946,5857,6588,731,1186,1642,448.00056576782185,1118,422.2453026154282,-1.6139861168312,0.21378812842794825,1.9105316862467505,0.9417167478362778,6689,6143,7234,7012,-222,323,869,30.640030435001748,565,53.5157985267527,-0.7560694139340121,-0.24352253445450434,0.2832215673478308,1.7412147766179171,1059100,1055763,Montgomery,Montgomery,24,31,Maryland,MD
24033,24CS015,5499,5087,5912,7260,1348,1761,2173,736.1713279590226,1249,522.2401552086034,0.3700227628110328,2.193270793849111,3.796834756050289,0.7089975996237945,6813,6319,7307,7624,317,811,1305,84.78944645044831,734,76.71348558277688,-0.4988153288529631,0.08039899539648282,0.5690419089200515,0.9036389033767964,956648,956807,Prince George's,Prince George's,24,33,Maryland,MD
24037,24CS016,719,670,768,855,87,136,185,476.2859275213919,88,308.82881934391423,0.051467072805251986,1.676702913150531,3.3903736707476617,0.6436678095528235,894,835,953,1051,98,157,216,136.98017387962236,89,77.80196340685183,0.070821869121233,0.5938544695310739,1.0902945962099373,0.5643779944278431,113979,114393,St. Mary's,St. Mary's,24,37,Maryland,MD
24039,24CS017,220,210,231,300,69,80,90,1292.3503115480557,17,275.0697787306339,8.392179435547792,10.149392003240974,11.967006369298389,0.2102126755373313,269,256,282,312,30,43,56,174.7212536886662,31,126.10853470018714,-0.029175463428984003,0.4940139330132773,1.0067564953627168,0.7053473289489622,24721,24582,Somerset+Worcester,Somerset,24,39,Maryland,MD
24047,24CS017,550,528,573,614,41,64,86,485.29590883798187,53,403.8864545627739,-0.8231937131561625,0.8641575428933707,2.6281007529515295,0.8193812338635069,679,652,707,744,37,65,92,122.28834074574692,70,131.99577613516368,-0.6415846484522943,-0.0918595760441689,0.4236945521519499,1.0629904954263738,52490,53032,Somerset+Worcester,Worcester,24,47,Maryland,MD
24043,24CS018,1406,1340,1473,1660,187,254,320,658.0492089616577,143,371.1658631228546,1.1721790575572115,2.8306651646292,4.599552720001431,0.5618236569547929,1735,1655,1815,2025,210,290,370,187.11463937422943,272,175.61303151995662,-0.3921071060510838,0.11462731346445967,0.616492811876429,0.9353045048216085,154109,154886,Washington,Washington,24,43,Maryland,MD
24045,24CS019,862,817,906,1033,127,171,216,661.3355003407441,83,320.45404090615136,1.754366398461955,3.457294898038801,5.073127845483656,0.4817435039748744,1064,1010,1118,1255,137,191,245,183.93980701216145,151,145.32365792158296,-0.158109408367245,0.39315260517059936,0.9048006173564928,0.7859487116051309,103603,103906,Wicomico,Wicomico,24,45,Maryland,MD
25001,25CS001,2675,2577,2773,2625,-148,-50,48,-87.9329591051464,197,347.1549156783619,-6.195223392989558,-4.348167520516264,-2.57535855444327,-4.028686184029793,3313,3193,3432,3312,-120,-1,119,-0.2526234363937721,199,85.8095201134928,-1.419923685159705,-0.8696715494165185,-0.3742770201658422,480.50975771319776,226988,231909,Barnstable+Dukes+Nantucket,Barnstable,25,1,Massachusetts,MA
25007,25CS001,151,149,153,143,-10,-8,-6,-156.09617955472046,7,138.75123885034688,-3.354726868125697,-2.953466816053288,-2.5576382476507398,-1.0181740787947067,193,190,195,171,-24,-22,-19,-103.83802303960339,6,28.54152792312815,-1.4507118711012965,-1.325292024331345,-1.198452835069985,-0.28806227855691413,20180,21022,Barnstable+Dukes+Nantucket,Dukes,25,7,Massachusetts,MA
25019,25CS001,77,76,78,64,-14,-13,-12,-377.0029331458809,8,231.1303719754424,-6.476466967003047,-6.068486259811535,-5.702109610814038,-0.6639547422211666,99,97,101,91,-10,-8,-6,-55.25973985256192,3,20.75406433759945,-0.8810401492950011,-0.7628170723418952,-0.6261871172301059,-0.42931995430938097,13845,14455,Barnstable+Dukes+Nantucket,Nantucket,25,19,Massachusetts,MA
25003,25CS002,1339,1284,1394,1386,-8,47,102,147.216416242105,121,377.44383183473576,-4.109444981817804,-2.331241774688385,-0.48452416543548343,2.5106718765142104,1642,1575,1708,1760,52,118,185,91.97560262661287,128,99.4777418552599,-0.5994988710302771,-0.0775807017477882,0.3982614800968684,1.0725042410080057,128231,128672,Berkshire,Berkshire,25,3,Massachusetts,MA
25005,25CS003,4766,4517,5014,5477,463,711,960,492.9928389766347,777,538.4400829488776,-2.0709170847588,-0.4239531280046733,1.3125385791287247,1.0906533463177694,5869,5570,6169,6249,80,380,679,65.49838129002661,669,115.34104917252711,-0.9859803008423311,-0.4980946928451091,5.596573241301044e-5,1.7563524081921302,577223,580019,Bristol,Bristol,25,5,Massachusetts,MA
25009,25CS004,6102,5755,6449,7072,623,970,1317,481.2127857736918,1242,616.2609532693587,-2.981820779061006,-1.3701445312641087,0.3005344676893608,1.2793221457363166,7509,7092,7925,7483,-442,-26,391,-3.1764889041898448,631,78.15335149067299,-1.3241161642807602,-0.8113913517861092,-0.2905718146804103,-25.601951720641097,806152,807387,Essex,Essex,25,9,Massachusetts,MA
25011,25CS005,607,577,638,705,67,98,128,551.158926245692,70,394.9948509599786,-0.07345362360938347,1.5179338938921962,3.2199769902493474,0.7093994935467861,745,708,782,717,-65,-28,9,-39.57809680319284,26,36.61404571122784,-1.2818120178818284,-0.7572741904444708,-0.2590118202074807,-0.9592396097254414,70887,71011,Franklin,Franklin,25,11,Massachusetts,MA
25013,25CS006,3896,3696,4096,4817,721,921,1121,792.4698548458878,751,646.2953122075373,-0.29491085592032773,1.4644378075687212,3.228384626359873,0.8146609333393082,4769,4530,5008,5148,140,379,618,81.83378806584145,448,96.75252733582846,-0.6427751067194903,-0.13839416892271156,0.3441311222846188,1.1791933939454295,464803,463037,Hampden,Hampden,25,13,Massachusetts,MA
25015,25CS007,1109,1039,1179,1246,67,137,207,338.156668642444,149,368.02845428049204,-2.007195623814376,-0.2694697176750068,1.4212749888916383,1.0804452480357716,1368,1285,1452,1404,-48,36,119,22.235442020346564,93,57.53383979609512,-0.8976498352823932,-0.3474524371738917,0.15920041507775873,2.5174422270921486,161944,161644,Hampshire,Hampshire,25,15,Massachusetts,MA
25017,25CS008,10013,9313,10712,11522,810,1509,2209,371.4963853408687,2117,521.0291371454765,-3.2909251432113775,-1.4919215219959965,0.24336954803631575,1.4015861361827329,12299,11465,13134,12202,-932,-97,737,-6.0286519309795,823,50.90040528597308,-1.058717574432926,-0.5668131426865644,-0.054620965375509284,-8.530597067620423,1625245,1616883,Middlesex,Middlesex,25,17,Massachusetts,MA
25021,25CS009,5146,4835,5458,5757,299,611,922,337.80156499303047,926,512.2276370596143,-3.552492651640764,-1.7764819567900536,0.07704141109390242,1.513877587066012,6333,5959,6707,6186,-521,-147,227,-20.239719102138984,374,51.6056390889259,-1.2607510291281039,-0.7175253543776604,-0.20636680920298042,-2.5672229904287898,723116,724727,Norfolk,Norfolk,25,21,Massachusetts,MA
25023,25CS010,4129,3901,4357,4799,442,670,898,505.608304733026,740,558.6412937830396,-2.2988978641338447,-0.5130448103980301,1.2116176983511482,1.1032422296098048,5097,4822,5372,5438,66,341,616,64.05260575687032,412,77.34068194958589,-0.6345342215967726,-0.13085253491335344,0.3758545304318357,1.2039272982474156,529857,532708,Plymouth,Plymouth,25,23,Massachusetts,MA
25025,25CS011,4048,3706,4389,5128,739,1080,1422,543.9834287164666,1089,548.3100695961059,-1.653364223320913,-0.048177445316957786,1.621591876111465,1.0070215500147572,4904,4504,5304,5141,-163,237,637,30.602506266570934,393,50.724600269498644,-0.7086039549504513,-0.17444052736558327,0.3250856130060693,1.6505694159772326,794441,774772,Suffolk,Suffolk,25,25,Massachusetts,MA
25027,25CS012,6446,6077,6816,6985,169,539,908,251.4771710933459,1135,529.8575920189909,-4.367672718943339,-2.8122887295935266,-1.1393687577125462,2.1030767926627387,7953,7508,8398,7793,-605,-160,285,-18.552890593683298,665,77.15100481932744,-1.484479698367914,-0.9442013003233425,-0.4527045529062405,-4.184603346026759,856834,861946,Worcester,Worcester,25,27,Massachusetts,MA
26001,26CS001,157,153,162,176,14,19,23,736.5442753888468,20,783.6222940542658,-2.114066758161114,-0.44245516459083056,1.2863670249867303,1.0101800251268993,191,186,196,227,31,36,41,353.31457731030883,35,342.3317683881064,-0.40855845319289075,0.09829482322698413,0.632767721570862,0.9428147210597752,10209,10224,Alcona+Alpena+Presque Isle,Alcona,26,1,Michigan,MI
26007,26CS001,326,314,339,343,4,17,29,231.44095636053598,20,277.700638711469,-2.1857736042312426,-0.43950559362043207,1.1382469539301063,1.131965841206694,397,382,412,477,65,80,95,276.83003540450323,72,249.21255754387178,-0.23709714535282472,0.2820711173563955,0.7474861684762084,0.8891197798083614,28808,28891,Alcona+Alpena+Presque Isle,Alpena,26,7,Michigan,MI
26141,26CS001,171,165,176,170,-6,-1,5,-17.943157095034383,11,340.1360544217687,-5.222700218639374,-3.534944648196076,-1.9320689236829032,26.20805433521256,209,202,215,211,-4,2,9,18.10227175516797,33,252.370755582747,-2.8308889550743217,-2.3457797331231025,-1.846396243601853,9.80085536635055,12936,13076,Alcona+Alpena+Presque Isle,Presque Isle,26,141,Michigan,MI
26003,26CS002,94,93,94,78,-16,-16,-15,-701.8206254994899,6,270.63599458728015,-10.111175120112101,-9.713577003868517,-9.311268860118645,-0.41210593415620733,114,113,115,114,-1,-0,1,-3.8545350095425297,3,34.002040122407344,-0.5020661610922315,-0.3794072705725418,-0.26144886506308057,4.546044318193096,8868,8823,Alger+Delta+Schoolcraft,Alger,26,3,Michigan,MI
26041,26CS002,403,388,419,502,83,99,114,1074.5624089697335,63,687.0229007633587,2.288401795693632,3.8920652407060743,5.7288769673284685,0.6329280968837196,497,478,516,555,39,58,77,158.51057746632463,51,138.48159009449333,-0.30118827486992944,0.2096602100233093,0.7115799758322647,0.8589289172637783,36680,36828,Alger+Delta+Schoolcraft,Delta,26,41,Michigan,MI
26153,26CS002,93,93,94,110,16,17,17,828.6171060304521,2,99.42828734775043,6.919491877916652,7.292661697403058,7.677749197118502,0.11320135470669065,114,113,115,131,16,17,18,207.3426553422391,5,62.25099601593625,1.3312714504820558,1.4540555346458715,1.5796927825869425,0.2832257497391497,8046,8032,Alger+Delta+Schoolcraft,Schoolcraft,26,153,Michigan,MI
26005,26CS003,903,852,955,1042,87,139,190,460.819216513994,73,242.80523195383375,0.39868422657966757,2.1889177789824776,3.8270491722612228,0.5231233060048274,1115,1053,1178,1279,101,164,226,135.5385506434647,168,138.96011513838113,-0.5948626115040859,-0.03585679697446712,0.4581619917949243,1.0190254665435734,120261,120898,Allegan,Allegan,26,5,Michigan,MI
26009,26CS004,233,223,243,259,16,26,36,448.10594416671773,5,85.27693685242825,1.866483909514516,3.6147157836594666,5.443377043975836,0.18332765660167055,288,276,301,333,32,45,57,187.71887681698092,36,151.5406634113487,-0.17121569821209698,0.3612736182062756,0.8374275150445585,0.78956898005003,23453,23756,Antrim+Charlevoix+Kalkaska+Otsego,Antrim,26,9,Michigan,MI
26029,26CS004,246,235,257,242,-15,-4,7,-58.15851916644075,12,184.28225899335817,-4.187259837549447,-2.413284155859101,-0.6991309605662227,-4.305492840548784,302,288,315,376,61,74,88,285.2251020691811,36,138.06327900287633,0.9473369745339436,1.4892224135208887,2.0015441949588983,0.47762812823553663,26047,26075,Antrim+Charlevoix+Kalkaska+Otsego,Charlevoix,26,29,Michigan,MI
26079,26CS004,180,172,188,209,21,29,37,643.3713536996697,13,289.8712302803947,1.9293740364042442,3.5559665743736395,5.266202039790369,0.4354584170746177,221,212,230,251,21,30,39,167.48846551743625,26,144.677536030271,-0.2929045062579343,0.2100060101825923,0.681613495456757,0.8360302775605117,17939,17971,Antrim+Charlevoix+Kalkaska+Otsego,Kalkaska,26,79,Michigan,MI
26137,26CS004,237,226,248,276,28,39,50,618.4696227617478,18,287.3333865432197,1.6286452156758096,3.343129315894601,4.9655264380232715,0.4528982143566679,293,280,306,366,60,73,86,290.0464080389252,59,233.55237115034438,0.07184483161102262,0.5623696737911007,1.0801038486624635,0.7943825189141345,25058,25262,Antrim+Charlevoix+Kalkaska+Otsego,Otsego,26,137,Michigan,MI
26011,26CS005,172,166,179,204,25,32,38,851.2730140683473,15,400.4805766920304,2.7581203266496495,4.540230767962091,6.3653589762327965,0.45614291205819635,210,202,218,254,36,44,52,294.9160298484443,20,133.53809174066902,1.1141863413944515,1.5995997048320298,2.157457519516552,0.44277592905359636,14982,14977,Arenac+Iosco+Ogemaw,Arenac,26,11,Michigan,MI
26069,26CS005,351,340,362,405,43,54,65,851.6391469453254,43,682.079549510251,0.035050040900144255,1.7014289619926137,3.3838550306840744,0.786257521570343,429,416,442,499,57,70,83,274.7013089905603,56,220.968314722014,-0.00808842366998885,0.535604957171211,1.0241782971616251,0.793003974637598,25217,25343,Arenac+Iosco+Ogemaw,Iosco,26,69,Michigan,MI
26129,26CS005,276,267,285,294,9,18,27,344.9858093214179,28,539.3171859199692,-3.6031808237927327,-1.9317687958405216,-0.2346259147870498,1.4806353449595924,336,325,346,385,39,49,60,238.45988711293109,52,250.86839058278656,-0.6197808694867029,-0.1165421011413022,0.3771061616138069,1.0311738652697595,20767,20728,Arenac+Iosco+Ogemaw,Ogemaw,26,129,Michigan,MI
26015,26CS006,497,470,524,534,10,37,64,238.5496971625983,39,249.84384759525295,-1.7881049704904575,-0.047236326999971594,1.5274454170125868,1.0199541915062529,614,581,646,769,123,155,188,246.8784197611932,78,123.95315206509129,0.7303779564867424,1.250049320900843,1.7199858916570707,0.49887055960137633,62439,62927,Barry,Barry,26,15,Michigan,MI
26017,26CS007,1086,1042,1131,1312,181,226,270,872.1581497718097,148,572.3179845126114,1.3872336155458187,2.9334327778220173,4.645074653303308,0.6533122660936301,1326,1273,1379,1559,180,233,286,226.12559299318977,219,212.46871179928982,-0.3761873089968876,0.13413272216975033,0.6547490539941511,0.935590795127519,103439,103074,Bay,Bay,26,17,Michigan,MI
26019,26CS008,181,173,189,226,37,45,53,1003.3433657851348,24,534.2237061769616,2.920817867811121,4.694366871479911,6.442351177101084,0.52088758445465555,224,215,234,241,7,17,26,91.5076480632464,24,131.9623907186452,-0.9038587218122347,-0.4055841891195279,0.08366789759780456,1.3603517361477235,17970,18187,Benzie+Manistee+Mason,Benzie,26,19,Michigan,MI
26101,26CS008,282,271,292,343,51,61,72,982.7467711797325,21,335.6241010068723,4.771503193488105,6.4644915800575715,8.246546291384552,0.33605126543934716,348,335,361,373,12,25,38,99.23104397066666,43,169.90674885411727,-1.2485790388198093,-0.7074028974103672,-0.2143250691383788,1.6466646308786426,25028,25308,Benzie+Manistee+Mason,Manistee,26,101,Michigan,MI
26105,26CS008,295,282,307,349,42,54,67,746.172737075997,21,288.5606320851941,2.884465037588666,4.525762502343931,6.272286132904634,0.37972815157712986,364,349,379,441,62,77,92,261.8302771579947,46,156.80392691573493,0.5110494168133413,1.0584593785345033,1.5409741401322887,0.5911796248747155,29110,29336,Benzie+Manistee+Mason,Mason,26,105,Michigan,MI
26021,26CS009,1485,1419,1551,1652,101,167,233,433.68275260089746,170,441.8941663471599,-1.7907001480851497,-0.08714003393419248,1.5943869128721024,1.0128633191932896,1807,1728,1886,2006,120,199,278,129.97989419860073,204,133.11929838299204,-0.5171620272903661,-0.044368917694543715,0.4858555256236262,1.019037067732115,153883,153246,Berrien,Berrien,26,21,Michigan,MI
26023,26CS010,419,400,438,468,30,49,68,437.2320511609328,71,636.3575253758767,-3.6351528092613368,-1.9874234428440252,-0.4028701692347158,1.4261875710213445,518,495,542,565,23,47,70,103.73188993458875,75,166.81865699859873,-1.1719483620925586,-0.6283910413812314,-0.10882786279274781,1.57441238472715,44629,44959,Branch+Hillsdale,Branch,26,23,Michigan,MI
26059,26CS010,427,408,447,545,98,118,137,1031.6192620289187,63,552.0867564903057,3.153307206166311,4.7939394386378495,6.523196821970444,0.530657458392594,525,501,548,651,103,126,150,277.5399544202119,108,237.0240316032042,-0.1207753223624224,0.4012866066715052,0.928652750688373,0.8473174698016608,45645,45565,Branch+Hillsdale,Hillsdale,26,59,Michigan,MI
26025,26CS011,1327,1269,1384,1625,241,298,356,890.2583872831898,158,471.5080797982662,2.544132884812847,4.260968413838293,5.919645592925206,0.5278611561343446,1622,1552,1691,1847,156,225,295,168.41495929611926,229,171.07170070669795,-0.5740094670304291,-0.044406090478087266,0.4857536039115195,1.011289198796507,134038,133862,Calhoun,Calhoun,26,25,Michigan,MI
26027,26CS012,452,429,474,560,86,108,131,840.2464211260561,66,511.6675711295449,1.680016273179074,3.240212540457503,4.962923931470092,0.6033823096666616,552,526,579,634,55,82,108,158.91156203113252,65,126.22584716962812,-0.2160027614510708,0.3222252813130153,0.8086907656351315,0.7847255336569732,51596,51495,Cass,Cass,26,27,Michigan,MI
26031,26CS013,283,272,294,343,49,60,71,932.9702395205609,39,609.9468251485769,1.5356314981505008,3.177199807358175,5.04042269227966,0.6429901522775728,349,335,362,443,81,94,108,366.6266584527639,52,202.09871745044697,1.0891701584603575,1.663122074318905,2.176263292977828,0.5454562282448195,25576,25730,Cheboygan+Emmet,Cheboygan,26,31,Michigan,MI
26047,26CS013,325,311,340,374,34,49,63,573.1466224678468,32,376.53703594752017,0.2826006080299585,1.9803715035325125,3.520939859106393,0.6437483443378136,401,384,419,387,-32,-14,3,-41.95395767185766,28,81.85937728402281,-1.7818483252725739,-1.2227160216755255,-0.7228755977710906,-2.0973230992286003,33994,34205,Cheboygan+Emmet,Emmet,26,47,Michigan,MI
26033,26CS014,309,293,325,308,-17,-1,15,-8.273973050833755,22,238.92916293339852,-4.326823170799242,-2.4274185424370924,-0.7829562304419851,92.37749361582864,382,363,401,452,51,70,89,189.71485786314753,50,135.84741618214423,0.05457417007205953,0.5292752049131706,1.0886612550862855,0.7059509489313807,36831,36806,Chippewa+Luce+Mackinac,Chippewa,26,33,Michigan,MI
26095,26CS014,55,55,56,65,9,10,10,728.2241651984959,4,292.9866324848929,3.9303652790933454,4.3801357895054105,4.757875951071984,0.3655611956918561,66,65,67,83,16,17,18,321.40380693629766,6,112.9730747505178,1.9435024714756706,2.0786399156965607,2.19130830608229,0.3320465388747318,5461,5311,Chippewa+Luce+Mackinac,Luce,26,95,Michigan,MI
26097,26CS014,146,141,150,140,-10,-6,-1,-210.7520222512361,8,295.33917858790954,-6.679562949774068,-5.055189416944087,-3.379938665309827,-1.698966352133036,179,174,185,195,10,16,21,144.9806062400408,14,128.49931161083066,-0.3375658207618703,0.19725604500641655,0.6938009038216404,0.8335498057290417,10835,10895,Chippewa+Luce+Mackinac,Mackinac,26,97,Michigan,MI
26035,26CS015,392,378,405,434,29,42,56,550.7329453021281,42,544.464609800363,-1.5898459715479996,0.037394110248534715,1.7917492005718967,0.9658827358339307,481,465,497,557,60,76,92,244.38352863870543,65,209.47470190138574,-0.14857599380603187,0.34487750585103083,0.8337095558786733,0.8459993653656968,30856,31030,Clare+Gladwin,Clare,26,35,Michigan,MI
26051,26CS015,314,303,325,390,65,76,87,1195.6196521259842,36,567.1524222134699,4.566865734223503,6.29839631056723,7.882641402358467,0.4681894076902032,385,372,398,481,83,96,109,375.83680523718664,59,231.66326370347102,0.9507060406644497,1.4339792250332872,1.9922841292119835,0.6100201439997708,25390,25468,Clare+Gladwin,Gladwin,26,51,Michigan,MI
26037,26CS016,526,492,560,638,78,112,146,565.4937910978051,48,242.33244982960997,1.4627843990886291,3.1889806915187244,4.907650683900504,0.4247404867881973,650,609,691,771,80,121,162,152.12964269319522,90,113.37440006046636,-0.16055708682777523,0.3750392403727145,0.8974134296595562,0.7391281986857983,79230,79383,Clinton,Clinton,26,37,Michigan,MI
26039,26CS017,156,150,161,155,-6,-1,5,-25.823239278981436,2,60.86890359887393,-2.643879528665617,-0.9283707927433635,0.8419313074903023,13.200194814022778,192,185,198,219,21,27,34,208.24036184455449,12,91.12309211025895,0.6893805446272744,1.1737701703110803,1.692392426799125,0.4221907207157875,13143,13169,Crawford+Montmorency+Oscoda+Roscommon,Crawford,26,39,Michigan,MI
26119,26CS017,143,139,147,159,12,16,20,704.6975574927912,16,696.2576153176675,-1.638071204306891,0.13787487548590494,1.8121665473678759,0.9305598841377741,175,171,180,200,20,25,29,265.0043373900934,26,280.2932298404485,-0.6451831240485637,-0.1580254866898184,0.3556952788704884,1.0163474667733416,9192,9276,Crawford+Montmorency+Oscoda+Roscommon,Montmorency,26,119,Michigan,MI
26135,26CS017,106,105,107,148,41,42,43,2037.0786017437779,13,629.9975769323964,13.674942365735108,14.074772903762351,14.461516605665308,0.3020788816727363,131,130,132,172,40,41,42,496.9404934623582,33,397.5903614457831,0.8594739497374239,0.9911421293773541,1.1189539994742463,0.7811379156342039,8254,8300,Crawford+Montmorency+Oscoda+Roscommon,Oscoda,26,135,Michigan,MI
26143,26CS017,345,335,355,389,34,44,54,754.4812479885093,29,492.9038837426702,0.8992570687615636,2.6972140160520426,4.512475184367891,0.6389085964135877,421,409,433,468,35,47,59,197.88530330229352,61,258.4307744450093,-1.0906381687533826,-0.5922037252948291,-0.10273949724453188,1.2785888539897445,23534,23604,Crawford+Montmorency+Oscoda+Roscommon,Roscommon,26,143,Michigan,MI
26043,26CS018,271,260,282,339,57,68,79,1050.3768179252297,68,1054.4679201395618,-1.6820170387573685,0.005962427406043974,1.7510919738680901,0.989289845624068,332,319,346,360,14,28,41,107.80949021695592,30,116.27456300143406,-0.6148642736535601,-0.06831119540111834,0.423944184285922,1.0410909372013706,25795,25801,Dickinson+Iron+Menominee,Dickinson,26,43,Michigan,MI
26071,26CS018,174,169,179,204,25,30,35,1039.6183816088562,28,969.5290858725762,-0.9623267496147956,0.6782436118345401,2.3604564119773617,0.9025218725553863,213,207,219,197,-22,-16,-10,-135.64116406905381,25,214.86892995272885,-4.0318344112286875,-3.5157760804678437,-3.02144267787038,-1.6912633363255634,11552,11635,Dickinson+Iron+Menominee,Iron,26,71,Michigan,MI
26109,26CS018,251,240,261,248,-13,-3,8,-42.90953301857095,22,377.43941668453783,-5.749333164670122,-4.258713482937886,-2.427945204398426,-14.65602242924547,306,294,319,326,7,20,32,83.7666025273908,33,141.5276407771154,-1.085714857801101,-0.5829367245804423,-0.02299533295872182,1.607258284015911,23315,23317,Dickinson+Iron+Menominee,Menominee,26,109,Michigan,MI
26045,26CS019,888,841,935,1071,136,183,230,669.1816080700147,80,292.9410364620046,2.1216275797743998,3.7722982568140644,5.55260797059348,0.4353777551756193,1092,1035,1148,1330,182,238,295,218.78244955493312,183,167.93921151163644,0.006231337285530499,0.4974339750177892,1.0120795447082844,0.7644018967945888,109237,108968,Eaton,Eaton,26,45,Michigan,MI
26049,26CS020,3916,3742,4090,4701,611,785,959,774.3870413096244,497,490.2516855484259,1.2461272588884276,2.809269332660169,4.573441191863548,0.6322781328077213,4789,4580,4998,5638,640,849,1058,209.99341184810729,670,165.67017293987902,-0.09894814666782945,0.4559436018772836,0.9415013803759218,0.7880024567019005,405506,404418,Genesee,Genesee,26,49,Michigan,MI
26055,26CS021,789,748,830,899,69,110,151,461.3972894711255,37,155.72554425025515,1.2044611392594144,3.0745672084636597,4.825305952140781,0.33445770636523553,978,929,1027,1122,95,144,193,150.2990197087446,113,117.97746943548303,-0.17316598769065092,0.34382191923531974,0.8266098212955812,0.7795366573980654,95039,95781,Grand Traverse+Leelanau,Grand Traverse,26,55,Michigan,MI
26089,26CS021,214,204,223,243,20,29,39,523.1968397368889,10,179.80760586172795,1.7016364089294038,3.464128604724974,5.1482216927162,0.33225249114965194,266,254,277,316,39,50,62,222.23839180316946,28,124.02551381998582,0.4405490958682014,0.9829200422308694,1.518043984243105,0.5471684689620017,22246,22576,Grand Traverse+Leelanau,Leelanau,26,89,Michigan,MI
26057,26CS022,408,390,426,484,58,76,94,734.4802445215997,54,520.3941503842725,0.5780665125412343,2.169141596026215,3.8322949891850633,0.6993443628289051,500,478,521,528,7,28,50,68.17608380094383,48,115.4928899689613,-0.9691541045139144,-0.4797595304168264,0.07029211053687372,1.6362895093709493,41507,41561,Gratiot+Isabella,Gratiot,26,57,Michigan,MI
26073,26CS022,395,367,423,512,89,117,145,716.0786696920914,33,202.23066552273565,3.4804978001763427,5.10393236931554,6.841621851511183,0.2800176423868274,489,455,522,685,163,196,230,303.021004878538,101,155.94602106043294,0.9651185994042362,1.4710957386891446,2.010890220283638,0.5120286583045739,65272,64766,Gratiot+Isabella,Isabella,26,73,Michigan,MI
26063,26CS023,382,369,396,424,28,42,55,535.8841526386046,46,588.3105256426653,-2.190493483642354,-0.5444645774807431,1.1254452737130167,1.0722415296016379,464,448,480,529,49,65,81,207.23422844366573,71,227.08373312863816,-0.6946286839185929,-0.18276596311999477,0.3211395613322226,1.0791281529954184,31276,31266,Huron+Sanilac,Huron,26,63,Michigan,MI
26151,26CS023,419,401,436,492,56,73,91,721.1255837739678,64,630.3866042846589,-0.7732832266172166,0.904450625290879,2.6531254743086516,0.8623910275298241,510,489,531,644,113,134,155,331.3154736375292,99,244.40823581691603,0.3488811928068586,0.8736917079297094,1.362178844172764,0.7322341914955873,40610,40506,Huron+Sanilac,Sanilac,26,151,Michigan,MI
26065,26CS024,1849,1727,1972,2244,272,395,517,553.062650204779,157,219.9834662108198,1.6396546014804212,3.3860978357022873,5.078749245889737,0.3967499028071923,2277,2130,2424,2850,426,573,720,201.65476009241152,345,121.433976874747,0.27703098353349637,0.8098111878609283,1.3152403000568909,0.6011382357405617,285476,284105,Ingham,Ingham,26,65,Michigan,MI
26067,26CS025,473,444,502,520,18,47,76,281.96127609671214,31,186.25889987082044,-0.8446754982291811,0.916485191110944,2.8055700743150136,0.6468005023826215,587,552,621,628,7,41,76,61.470957475878556,82,122.11830583189372,-1.1368594950531588,-0.6199221373089417,-0.06226031904989693,1.9396109911405877,66574,67148,Ionia,Ionia,26,67,Michigan,MI
26075,26CS026,1489,1420,1558,1706,148,217,286,543.361870493154,175,437.72980814927837,-0.5556648012868423,1.1077269258972826,2.757355553302995,0.8019038858715556,1824,1742,1907,2162,255,338,420,210.86807669212416,229,143.06062271977612,0.15178840270203034,0.6983520814665919,1.1930348353950673,0.67643260535252,159916,160072,Jackson,Jackson,26,75,Michigan,MI
26077,26CS027,1841,1728,1954,2161,207,320,433,488.1221325888904,185,282.28759765625,0.266855816599591,2.045545211477283,3.824647482581668,0.5765112714218622,2261,2127,2396,2662,266,401,535,153.34557159213136,249,95.33508943886302,0.015625201362388298,0.5862138880471497,1.0914055483722525,0.6201525710352153,262144,261184,Kalamazoo,Kalamazoo,26,77,Michigan,MI
26081,26CS028,4184,3901,4467,4822,355,638,921,387.92690976616336,442,268.7501900100325,-0.5542560770715802,1.1348007753054548,3.0066258201620406,0.6917014688984522,5166,4827,5506,5811,305,645,984,97.95186154670972,542,82.36518779110851,-0.36102758053492007,0.1597284964087427,0.6630127150003639,0.8395716094465486,657860,658045,Kent,Kent,26,81,Michigan,MI
26085,26CS029,154,149,159,175,16,21,26,692.3030087953315,3,99.42004971002486,4.16514300544571,5.91354177764987,7.617048076454998,0.13704735759221892,190,184,197,194,-3,4,10,28.942621894380483,20,162.89297931259162,-1.8223758346922159,-1.3374395958490168,-0.8333133812802923,4.3921533058457944,12070,12278,Lake+Missaukee+Wexford,Lake,26,85,Michigan,MI
26113,26CS029,149,143,156,167,11,18,24,467.3663402360166,7,185.7379767827529,1.1599714528951575,2.7999665897625694,4.539479695971303,0.37606367701894006,183,175,191,204,13,21,29,137.66659947603304,30,198.3995767475696,-1.1380489330283035,-0.6017713700715193,-0.05101494514436213,1.3751018058084095,15075,15121,Lake+Missaukee+Wexford,Missaukee,26,113,Michigan,MI
26165,26CS029,308,293,322,329,7,21,36,251.72411405350826,12,142.45014245014247,-0.5589593656803696,1.0647295317970686,2.75101340932584,0.5404129989863925,379,361,396,507,111,128,146,378.67993913199274,66,194.87421755049016,1.3322724664208914,1.8442139554125432,2.3524913638649276,0.5106330758432945,33696,33868,Lake+Missaukee+Wexford,Wexford,26,165,Michigan,MI
26087,26CS030,768,730,806,874,68,106,144,479.59013251668466,96,434.2859727892695,-1.2201659309533897,0.4190419943065171,2.1932484971183066,0.8970738759210363,946,900,991,1207,216,261,307,295.3928488434309,210,237.24792408066432,0.049599095406636505,0.5833917754389057,1.086433207393731,0.8001006445724115,88421,88515,Lapeer,Lapeer,26,87,Michigan,MI
26091,26CS031,908,865,950,1037,87,129,172,522.6838105461941,75,302.7672930585552,0.4437189464615611,2.1500268589264775,3.822960345111095,0.5748156254016226,1110,1059,1161,1308,147,198,249,200.0583560283877,188,189.91049962623998,-0.4081431849630287,0.09959637106675759,0.6052727488996984,0.9445063865256653,99086,98994,Lenawee,Lenawee,26,91,Michigan,MI
26093,26CS032,1277,1193,1360,1499,139,222,306,459.1159298246703,80,165.11697505701696,1.2085878411535473,2.9605810960985792,4.683645149823131,0.35803160093633146,1584,1483,1685,1913,228,329,430,168.80224545839303,226,115.97951370713633,-0.010837221082128444,0.5334720815107815,1.1036942330600612,0.6849908144295241,193802,194862,Livingston,Livingston,26,93,Michigan,MI
26099,26CS033,7541,7163,7919,9309,1390,1768,2146,804.6407027278383,1407,640.4056357516573,-0.029456510792953004,1.6989230893966274,3.4291893166651266,0.7954402300826288,9230,8777,9683,10658,975,1428,1881,162.79778025521964,1448,165.04979420068824,-0.5415459820572989,-0.007092069273740807,0.5151646033306406,1.0131238482501181,878818,877311,Macomb,Macomb,26,99,Michigan,MI
26103,26CS034,585,557,613,600,-13,15,43,90.7833132164489,44,266.4284957386579,-3.5050813508429197,-1.7269488425160837,0.0017669922936718527,2.7512660605211696,717,683,752,794,42,77,111,115.83638575629408,41,62.04788280516965,0.029934001764695232,0.5430268275812095,1.036278810842423,0.5287432096385658,66059,66078,Marquette,Marquette,26,103,Michigan,MI
26107,26CS035,323,306,341,412,71,89,106,878.1877549214887,13,128.8340518309301,5.829133336220122,7.482337071104966,9.160929143160109,0.1450673711339609,397,376,418,474,56,77,98,192.42648493556501,59,147.51843980497563,-0.06329062214502201,0.44769410323980746,0.95773877685126,0.7567889162298147,40362,39995,Mecosta+Osceola,Mecosta,26,107,Michigan,MI
26133,26CS035,211,202,221,223,2,12,21,201.67348118144568,17,295.85798816568047,-2.525145008674741,-0.916706045046167,0.8206264366309551,1.3504755573583778,261,249,273,285,12,24,36,104.25989320981071,47,203.70129588696744,-1.489170485462278,-1.0033005287328591,-0.4833707160843642,1.8758068094305538,22984,23073,Mecosta+Osceola,Osceola,26,133,Michigan,MI
26111,26CS036,648,612,684,767,83,119,155,569.3007919833643,37,177.31983466123523,2.268254199559451,3.9629942580354367,5.6181483879793905,0.30886941092519654,797,754,840,938,98,141,184,169.11255876902675,103,123.4124131320393,-0.028215403089043706,0.4532579763998827,0.964406983722314,0.7246308419339169,83465,83460,Midland,Midland,26,111,Michigan,MI
26115,26CS037,1330,1264,1397,1530,133,200,266,517.5828210978011,123,319.05373331776974,0.18211890806929545,1.9697473647260992,3.709745695474863,0.6133563849834219,1642,1562,1722,1933,211,291,371,187.62290669732496,207,133.37285121517488,0.02659118527699421,0.5250188817482018,1.0389951835546676,0.7084231191363023,154206,155204,Monroe,Monroe,26,115,Michigan,MI
26117,26CS038,570,541,598,620,22,50,79,303.5140015083248,70,423.0949394823131,-2.876284501479162,-1.1325940451106793,0.48925383791349025,1.3667701875676908,710,675,745,820,75,110,145,163.8135084031792,90,134.09419372141187,-0.2561292829639065,0.30046019448636363,0.7918895890370573,0.8112002422132067,66179,67117,Montcalm,Montcalm,26,117,Michigan,MI
26121,26CS039,1517,1442,1593,1878,285,361,436,821.9293151038438,247,562.7288933947702,0.8180655335810956,2.609301384001782,4.311191795476976,0.6827514258053754,1869,1778,1960,2152,192,283,374,160.45246280170798,230,130.3780964797914,-0.24474053594403733,0.3119051549963295,0.8357471829584413,0.8097046563573341,175573,176410,Muskegon,Muskegon,26,121,Michigan,MI
26123,26CS040,441,420,463,488,25,47,68,375.0698989067644,30,240.3846153846154,-0.3866486631015192,1.3674897696976072,3.155656154541304,0.627500545440489,541,515,567,641,74,100,126,199.36127363323797,82,163.15485783640742,-0.17489459545036762,0.38914121045746264,0.8511537289101826,0.810300840616259,49920,50259,Newaygo+Oceana,Newaygo,26,123,Michigan,MI
26127,26CS040,231,219,242,284,42,53,65,801.4995115513634,41,614.6235430798637,0.19610487350096403,1.853624560990256,3.659403602643896,0.7527627955181219,282,268,296,330,34,48,62,178.23168201361415,37,138.0803104941036,-0.12759486773731724,0.4171863607245435,0.9264880499516998,0.7588348654762611,26683,26796,Newaygo+Oceana,Oceana,26,127,Michigan,MI
26013,26CS041,89,88,90,105,15,16,17,772.7182093573597,27,1324.5033112582782,-5.93471290850316,-5.514836794766243,-5.1270826781202965,1.6117612536992276,110,109,111,114,3,4,5,43.886370806323654,18,219.45866861741038,-1.876870316971488,-1.7567721971958172,-1.6280656259812434,3.9134176915668184,8154,8202,Northwest Upper Peninsula,Baraga,26,13,Michigan,MI
26053,26CS041,169,163,175,207,32,38,44,1070.2038009468256,38,1065.1716888577437,-1.6111677802938555,0.05784772564425071,1.74998675572374,0.9698944606582351,208,201,215,211,-4,3,10,20.519303509551598,20,139.33398355858995,-1.7299620286676105,-1.1787486272222583,-0.6771575820672366,5.06927053536423,14270,14354,Northwest Upper Peninsula,Gogebic,26,53,Michigan,MI
26061,26CS041,322,306,338,333,-5,11,27,117.49951386841232,27,292.1761714100206,-3.4157098174712517,-1.7645675063278268,0.042980421171354304,2.276918858676165,401,382,420,381,-39,-20,-1,-53.431125083647515,46,123.3541605213054,-2.2737965406930263,-1.764059089755559,-1.2584277745348873,-2.4306471821366036,36964,37291,Northwest Upper Peninsula,Houghton,26,61,Michigan,MI
26083,26CS041,24,23,25,26,1,2,3,330.12836819310417,4,774.818401937046,-6.142144240033849,-4.387633641218599,-2.659635925886692,1.479132563750994,30,29,31,35,4,5,6,222.95685640321508,2,95.28346831824678,0.7577257667770385,1.2855517339491396,1.7690042641973522,0.35212108134131653,2065,2099,Northwest Upper Peninsula,Keweenaw,26,83,Michigan,MI
26131,26CS041,82,81,83,115,32,33,34,2273.0452621505174,20,1380.0241504226324,8.534662295266296,8.928982780474938,9.32867667761212,0.5892385861225501,102,101,102,101,-1,-1,0,-12.356684217000186,13,221.88086704215738,-2.4704847228429276,-2.3441224449822626,-2.2240772416979167,47.09771699869749,5797,5859,Northwest Upper Peninsula,Ontonagon,26,131,Michigan,MI
26125,26CS042,9157,8610,9703,10946,1243,1789,2336,563.5278035228831,1401,441.25358853181615,-0.6504547408505332,1.3313984038033375,2.970520058260004,0.7825826987213773,11265,10609,11920,12423,503,1158,1814,91.1939923029582,1189,93.59507417547384,-0.5185825784535539,-0.020585947997321878,0.5119169555934365,1.02544423635794,1270018,1270366,Oakland,Oakland,26,125,Michigan,MI
26139,26CS043,1761,1633,1888,2147,259,386,514,521.8163800860406,221,298.38957391724074,0.4468436398725825,2.237499073171111,3.9153179051572398,0.5703529185810768,2198,2044,2352,2544,192,346,500,115.7280314646467,290,97.05131337199768,-0.3314866514734579,0.1918528624625747,0.6935740069703509,0.8361973378098558,296257,298811,Ottawa,Ottawa,26,139,Michigan,MI
26145,26CS044,1813,1732,1895,2310,415,497,578,1046.3558084453857,328,690.8863039162511,1.7048840393909928,3.566689973086957,5.1655758120962325,0.6589520578418386,2218,2120,2316,2583,267,365,463,192.27578767030536,337,177.71824538829063,-0.3589460545610494,0.1447604047614153,0.683232379561908,0.9217601123745857,189901,189626,Saginaw,Saginaw,26,145,Michigan,MI
26147,26CS045,1531,1462,1600,1776,176,245,314,611.2729497956435,154,384.7403002972993,0.5683000155774555,2.304405842976579,4.1021161986044765,0.6268463892309782,1874,1791,1957,2357,400,483,566,301.73415037406824,411,256.74021138902077,-0.07776877406336183,0.459272628884121,0.9801204555509074,0.8491242601525042,160108,160084,St. Clair,St. Clair,26,147,Michigan,MI
26149,26CS046,569,542,595,639,44,70,97,462.3008743384579,59,387.67330310795717,-0.8548446682522819,0.7483700702529259,2.343867804273468,0.8268218767228951,696,664,727,792,65,96,128,158.23174905435133,89,146.43215584330113,-0.36747859651324644,0.12116540337746469,0.6257150479215121,0.9159047656828314,60876,60779,St. Joseph,St. Joseph,26,149,Michigan,MI
26155,26CS047,633,604,663,728,65,95,124,556.6836645334943,49,288.3031301482702,0.9549777458126827,2.662558961166475,4.347026239714818,0.5124774901336975,777,742,812,880,68,103,138,152.21499482585364,118,173.80545572379663,-0.7328052255789015,-0.2219995628867066,0.294586749364414,1.1308985962638858,67984,67892,Shiawassee,Shiawassee,26,155,Michigan,MI
26157,26CS048,534,511,557,647,90,113,136,850.2480618988405,90,677.9278006892266,0.03993111763049932,1.7779299764090721,3.3386954406001643,0.7903277437232824,654,626,681,794,113,140,168,264.69530219891783,118,222.77180992656085,-0.07316189369131976,0.4083240619593237,0.964775528144718,0.8356558509743139,53103,52969,Tuscola,Tuscola,26,157,Michigan,MI
26159,26CS049,660,627,692,767,75,107,140,568.4506765847999,90,476.3669083787646,-0.632135237329175,0.8637181929894087,2.560894825428391,0.830278321733339,809,770,848,980,132,171,210,226.28811831693062,117,154.67392884999273,0.21152606066294574,0.71485897690065,1.2068011872094297,0.6795564731787195,75572,75643,Van Buren,Van Buren,26,159,Michigan,MI
26161,26CS050,2004,1845,2164,2311,147,307,466,330.629781526944,179,193.03249739837486,-0.31189993435098434,1.3527542585697627,3.1464769276465203,0.5819346996338353,2485,2294,2676,2640,-36,155,346,41.865212573377264,172,46.521692091312346,-0.5887091529224031,-0.04003627546995859,0.48400681858582933,1.1040923934387936,370922,369720,Washtenaw,Washtenaw,26,161,Michigan,MI
26163,26CS051,15695,14927,16463,19800,3337,4105,4873,921.040816506182,3079,690.8362113501091,0.6073179437296207,2.255314872429696,4.087813931808106,0.7498776912769727,19152,18234,20069,21711,1642,2559,3477,144.00689050483953,2477,139.38729240325188,-0.4771039802750246,0.03809002779865179,0.5495290463964936,0.9675429122538277,1782767,1777063,Wayne,Wayne,26,163,Michigan,MI
27001,27CS001,192,185,198,225,27,33,40,848.6401748998736,29,737.2100413091833,-0.5679688484441469,1.1294909813885687,2.806932568541669,0.8434306799045134,236,228,244,248,4,12,20,76.91559027352557,20,126.1113563276373,-1.0366517781425908,-0.4932558161538669,0.07606816483590789,1.5153761281643512,15735,15859,Aitkin+Itasca,Aitkin,27,1,Minnesota,MN
27061,27CS001,445,426,465,469,4,24,43,211.75715853137393,36,319.8010127032069,-2.872429095204789,-1.1086321040392577,0.6690195923848203,1.4494210433783603,546,523,569,684,115,138,161,306.1895273003612,64,142.04230197305634,1.1257124144664035,1.6265802705618444,2.1258605591561723,0.46056480324609494,45028,45057,Aitkin+Itasca,Itasca,27,61,Minnesota,MN
27003,27CS002,1948,1792,2105,2359,254,411,567,451.6616340650595,331,364.1404195865741,-0.9054239488215343,0.9064019994319097,2.662463809538353,0.8042649685344031,2440,2251,2629,2764,135,324,513,88.42815232952096,307,83.73770187741565,-0.4422710908379718,0.05013547844699843,0.5440541167234613,0.944045540276229,363596,366621,Anoka,Anoka,27,3,Minnesota,MN
27005,27CS003,328,312,343,386,43,58,74,666.4906723615578,40,456.43863753066694,0.4712620021414441,2.098215308949061,3.879524180354563,0.6733110111304847,406,388,424,412,-12,6,24,17.269860063239296,43,122.1313337877755,-1.5819897075167304,-1.0380312821224398,-0.551485839499958,6.073126947199731,35054,35208,Becker+Hubbard+Mahnomen+Norman,Becker,27,5,Minnesota,MN
27057,27CS003,191,182,200,229,29,38,47,704.5443935283986,37,690.0410294666169,-1.5371865388576185,0.15295084529021447,1.719787720132907,0.954157370375089,239,228,250,239,-11,0,11,0.15730696342803904,15,69.23289947382996,-1.198917580912615,-0.6882313739015352,-0.16623874325040966,14.505617699748795,21448,21666,Becker+Hubbard+Mahnomen+Norman,Hubbard,27,57,Minnesota,MN
27087,27CS003,55,55,56,68,12,13,13,937.3966677428498,3,222.13994816734544,6.750080254645741,7.15560774158366,7.554589184152058,0.21962669029960322,68,67,69,89,20,21,22,387.5268178240575,10,184.91124260355028,1.890451172309421,2.0244051438864714,2.1513246877902925,0.45542628400669694,5402,5408,Becker+Hubbard+Mahnomen+Norman,Mahnomen,27,87,Minnesota,MN
27107,27CS003,83,83,84,66,-18,-17,-17,-1074.103108695412,5,311.7206982543641,-14.271049246835691,-13.844999556890606,-13.450036780199799,-0.30809778592695797,102,101,103,85,-18,-17,-16,-265.2553638182151,3,46.75081813931744,-3.2495204488597857,-3.119466391671528,-2.9979009958637537,-0.18724912483714795,6416,6417,Becker+Hubbard+Mahnomen+Norman,Norman,27,107,Minnesota,MN
27007,27CS004,345,325,364,461,97,116,136,1004.0290331301832,40,344.916788824696,4.858210866538295,6.550001163279943,8.380912359917156,0.3406074395587666,424,400,448,511,63,87,111,188.1371151732523,56,120.7989990940075,0.17102889018764372,0.6724972469481011,1.2248023898182638,0.6348011321535367,46388,46358,Beltrami+Clearwater,Beltrami,27,7,Minnesota,MN
27029,27CS004,82,81,83,92,9,10,11,474.19833216114677,10,464.1448131817127,-0.2961941125539251,0.10695348740957672,0.5056033107391396,0.8915355157699195,100,99,101,125,24,25,26,293.94172710383657,15,174.88632388947184,1.0658642705044932,1.1858782709639335,1.3064701631438422,0.5722704753966726,8618,8577,Beltrami+Clearwater,Clearwater,27,29,Minnesota,MN
27009,27CS005,327,309,345,397,52,70,88,679.7605669186011,72,697.4716652136008,-1.9219666281551695,-0.20067941528864375,1.5731741260789156,1.0116382898130083,403,382,425,407,-18,4,25,9.257750350790985,51,123.06652831736687,-1.65916795367616,-1.1516674586481588,-0.6117002182131472,10.544806040765158,41292,41441,Benton+Stearns,Benton,27,9,Minnesota,MN
27145,27CS005,919,851,987,1187,200,268,336,674.546509817669,185,465.96855341951647,0.30395828683314796,2.0739647209443226,3.850891182178709,0.688218081483458,1142,1060,1224,1279,55,137,219,86.24187481402652,121,76.16769482563264,-0.38911188241527556,0.09501796204620269,0.6033907008392666,0.876787181845588,158809,158860,Benton+Stearns,Stearns,27,145,Minnesota,MN
27013,27CS006,434,404,463,456,-7,22,52,129.28557875340445,27,156.53308210739908,-1.9197987280949738,-0.22565054579593663,1.4885668576899433,1.158791008977212,535,499,571,594,23,59,95,85.00024335969132,41,59.1938091938092,-0.24492411283858265,0.25463702939891186,0.7350541890776937,0.6847648506805438,68995,69264,Blue Earth+Faribault+Martin+Watonwan,Blue Earth,27,13,Minnesota,MN
27043,27CS006,162,156,168,159,-9,-3,3,-74.13737294618193,11,317.48322389782817,-5.603566796573178,-3.9256147462022,-2.112705172855751,-7.012289097797511,197,190,204,184,-20,-13,-6,-93.59128637899029,17,122.24938875305624,-2.6884526079140465,-2.1671115139685457,-1.6364946584077305,-1.4149210922090047,13859,13906,Blue Earth+Faribault+Martin+Watonwan,Faribault,27,43,Minnesota,MN
27091,27CS006,214,206,223,215,-8,1,9,10.72736451480038,23,461.9401486242217,-6.098654817717136,-4.508832439485148,-2.8682369447379576,14.992352474088298,261,251,271,302,31,41,51,205.67881827897472,25,125.48310997339757,0.31465528640690793,0.8147416536608234,1.3264486500725403,0.5955586906393414,19916,19923,Blue Earth+Faribault+Martin+Watonwan,Martin,27,91,Minnesota,MN
27165,27CS006,103,102,104,134,30,31,32,1118.7937121189568,10,358.5193152281079,7.212702748629878,7.61094994237411,8.006128208262943,0.3105015960544685,126,124,127,128,1,2,4,21.02437158443315,15,134.55328310010765,-1.264268757774001,-1.1341253761530272,-1.0102858966933796,4.485918328824377,11157,11148,Blue Earth+Faribault+Martin+Watonwan,Watonwan,27,165,Minnesota,MN
27015,27CS007,257,246,268,268,0,11,22,174.91898389577798,30,466.12802983219393,-4.640050177469517,-2.903182478498613,-1.2293401351472422,2.4474240683301085,316,303,330,342,12,26,39,99.98447122373105,30,116.14851523481359,-0.6965371923826791,-0.15206203444043223,0.3590526779949447,1.1183601946325457,25744,25829,Brown+Le Sueur+Nicollet,Brown,27,15,Minnesota,MN
27079,27CS007,210,198,223,216,-7,6,18,78.34029210264603,19,264.9653104626434,-3.5886897596493927,-1.8356724400418498,-0.1357772514766905,2.8711373869652776,262,247,277,284,7,22,37,75.50640431148473,32,111.07254425546687,-0.843059205213005,-0.3609841030570141,0.12204566055509639,1.4063835258202748,28683,28810,Brown+Le Sueur+Nicollet,Le Sueur,27,79,Minnesota,MN
27103,27CS007,224,209,239,238,-1,14,29,164.93586750219816,30,348.3612506168897,-3.4558461455788647,-1.8177392339124412,-0.18551024729050336,1.9731825328110462,278,260,296,298,2,20,38,58.053045489991334,20,58.21568912822005,-0.5282198312121066,-0.003995176663473126,0.49868914537389886,0.9549217819714023,34447,34355,Brown+Le Sueur+Nicollet,Nicollet,27,103,Minnesota,MN
27019,27CS008,476,430,522,510,-12,34,80,125.84487215506697,36,134.43997348544968,-1.7069856383862099,-0.11829653875000978,1.657266141705152,1.0375110610060074,602,546,658,674,16,72,128,66.59212771422766,53,48.87901061504551,-0.34213946202844875,0.16948767672061044,0.7110573371571957,0.723979329142812,107111,108431,Carver,Carver,27,19,Minnesota,MN
27021,27CS009,291,278,303,310,7,19,32,258.8476010149226,24,318.8839063278525,-2.2881998543165314,-0.6030301259522999,1.211316176973945,1.1717881703028687,361,345,377,429,52,68,84,222.8109042193741,40,130.87292239235703,0.39011417704111406,0.899680421307596,1.4337702781517352,0.578871831419239,30105,30564,Cass+Crow Wing,Cass,27,21,Minnesota,MN
27035,27CS009,609,581,638,619,-19,10,38,58.21071246173721,68,410.93199981870646,-5.198638848384617,-3.543520751853082,-1.8225916999087803,6.3954475420369175,757,722,792,815,23,58,93,86.55105886428959,67,99.8227029604136,-0.6876727474996838,-0.14322058532474513,0.3648685744420186,1.1338212844525033,66191,67119,Cass+Crow Wing,Crow Wing,27,35,Minnesota,MN
27025,27CS010,389,364,413,412,-1,23,48,164.2578796286105,27,190.35868511500837,-2.0511943577861773,-0.2784005589044088,1.524103822265509,1.1112059064945838,486,456,515,544,29,58,88,101.54518598842418,64,111.59157483609987,-0.6139357202693447,-0.09515792192090702,0.40826657865650523,1.0803840313913402,56735,57352,Chisago+Isanti,Chisago,27,25,Minnesota,MN
27059,27CS010,294,276,312,314,2,20,38,192.8006610288982,31,300.2348611413767,-2.743969239380378,-1.1142387014120076,0.6335948083943561,1.4827463152574003,367,346,389,435,46,68,89,161.63010057280044,57,136.26583791537175,-0.27548909953141404,0.24323971989180806,0.7469611505815197,0.8307842459312508,41301,41830,Chisago+Isanti,Isanti,27,59,Minnesota,MN
27027,27CS011,423,395,451,489,38,66,94,402.7171556692589,83,508.8746512982434,-2.6674202899375907,-1.0917643111992625,0.6515426378773388,1.2446543282130036,523,490,557,543,-14,20,53,29.838377598048538,32,48.82439999389695,-0.7159419883783714,-0.1783062626428799,0.36280055205881157,1.5566949975852096,65242,65541,Clay,Clay,27,27,Minnesota,MN
27037,27CS012,2337,2148,2526,2746,220,409,598,372.4213691909107,285,259.7331583552056,-0.5692357545053357,1.0791645621557062,2.6751322183469104,0.6957149718981863,2922,2694,3150,3241,91,319,547,72.1674947033331,333,75.37569009500054,-0.5698126081613573,-0.03718196736184599,0.5048400716106718,1.0411891624095735,438912,441787,Dakota,Dakota,27,37,Minnesota,MN
27039,27CS013,139,137,141,133,-8,-6,-4,-111.70442431962695,7,134.0675125688293,-2.829672886387552,-2.464387651662819,-2.0550531306231132,-1.448565398886749,171,169,174,163,-11,-8,-6,-40.33921131675717,11,52.57121009367234,-1.056755164193781,-0.9264891551050215,-0.7992071931937109,-1.478380053986938,20885,20924,Dodge+Steele+Waseca,Dodge,27,39,Minnesota,MN
27147,27CS013,278,262,294,299,5,21,37,230.40713969398422,4,42.947255401959474,0.0819373557863009,1.83047901136909,3.5808482658714444,0.17809799819027486,344,325,363,383,20,39,58,103.90084774538948,33,88.3557792711987,-0.34664135973261107,0.1541955068075383,0.6655739047761047,0.8290222579752343,37255,37349,Dodge+Steele+Waseca,Steele,27,147,Minnesota,MN
27161,27CS013,162,154,170,162,-8,0,8,1.3193593265840475,18,380.9322258081583,-5.491804887937482,-3.8189855923484464,-2.1768135719488675,16.943679724577603,200,191,210,188,-22,-12,-3,-65.45280813802793,14,73.71136734586426,-1.8910837017068303,-1.3840472687069891,-0.8964168347936176,-1.224691332660578,18901,18993,Dodge+Steele+Waseca,Waseca,27,161,Minnesota,MN
27041,27CS014,386,369,403,433,30,47,64,484.1687117665122,52,534.045393858478,-2.2202720049122235,-0.5180102212746568,1.2015000435362535,1.0801041041332926,473,453,494,448,-46,-25,-5,-64.83788190776829,46,117.30205278592375,-2.3452009280901485,-1.8148329402351049,-1.2739094515352876,-1.8832256489317163,38948,39215,Douglas+Morrison+Todd,Douglas,27,41,Minnesota,MN
27097,27CS014,281,266,295,323,28,42,57,500.8532335714642,43,507.5842530838695,-1.7359536153458188,-0.1152476466113675,1.6195194736265701,0.9901039870484853,344,327,362,415,53,71,88,208.08672931130977,34,100.02942041776994,0.5424149596621257,1.0942931545539651,1.5917738971857072,0.4740084487148606,33886,33990,Douglas+Morrison+Todd,Morrison,27,97,Minnesota,MN
27153,27CS014,188,178,199,214,15,26,36,406.7261496718595,31,492.61083743842363,-2.7216840300903544,-0.8097725051124142,0.7722930098028499,1.1656205147849572,232,219,245,252,7,20,33,80.96409842681462,28,110.93941915289828,-0.8214446868387125,-0.2915272022247309,0.17262718607153008,1.3063035002412036,25172,25239,Douglas+Morrison+Todd,Todd,27,153,Minnesota,MN
27045,27CS015,199,189,208,206,-2,7,17,139.96651893525177,5,94.22850412249706,-1.2159493390719647,0.42683206240979565,2.0942862505643687,0.5933328321022436,242,231,253,248,-5,6,17,27.241812275940923,14,65.8296891898246,-0.8815601460703876,-0.39654908235838493,0.1425853230793087,2.0607884861648875,21225,21267,Fillmore+Houston+Winona,Fillmore,27,45,Minnesota,MN
27055,27CS015,165,157,173,179,6,14,22,296.02093238855593,12,255.4278416347382,-1.3447076200889387,0.3986841030688829,2.165681905311077,0.804987520016215,201,191,211,202,-9,1,11,4.8610275388139454,6,31.942078364565585,-0.809095459006102,-0.25951733221720125,0.23535317886912346,3.1362784937807207,18792,18784,Fillmore+Houston+Winona,Houston,27,55,Minnesota,MN
27169,27CS015,356,335,377,389,12,33,54,264.2435103502526,41,329.5687472368474,-2.3882449773686187,-0.6389112969406395,0.9999805705573875,1.2103959227145826,435,409,461,431,-30,-4,22,-8.111376427952466,20,40.301454882521256,-0.9815223555142182,-0.4834763506659132,0.011054712281059373,-6.61080172062978,49762,49626,Fillmore+Houston+Winona,Winona,27,169,Minnesota,MN
27047,27CS016,311,297,324,326,2,15,29,198.69819427208623,17,220.80789712949732,-1.9350627348872613,-0.2847473410893664,1.5526843561984702,1.0430872353477687,379,363,394,391,-3,12,28,40.30017833319507,24,78.00058500438753,-0.896879230046599,-0.37705024393496767,0.11438557800532825,1.7910498724127022,30796,30769,Freeborn+Mower,Freeborn,27,47,Minnesota,MN
27099,27CS016,354,336,371,354,-17,0,18,4.592456760654603,30,299.55815172620385,-4.745986408098518,-2.8314916676547397,-1.223601564074948,20.549028062725096,433,413,454,447,-7,14,34,33.74238978710629,21,52.31428429076778,-0.7591401459905699,-0.2087991929005985,0.2500375840229181,1.4438080122804495,40059,40142,Freeborn+Mower,Mower,27,99,Minnesota,MN
27049,27CS017,427,407,448,482,34,55,75,461.3100304892608,42,354.3257265786477,-0.616717500024224,1.0262564423619154,2.858710283350816,0.7542915896267075,529,504,554,567,13,38,63,79.64473446630055,43,89.76098528337334,-0.6346666666421549,-0.08373823504459016,0.3992644999003673,1.0982328399047763,47414,47905,Goodhue+Wabasha,Goodhue,27,49,Minnesota,MN
27157,27CS017,168,159,177,194,17,26,35,487.73630600836594,6,111.90898069570083,2.1716699643240123,3.70625544199718,5.527825856639539,0.22099462127426578,207,196,218,219,1,12,23,55.070792849532324,10,46.52028284331969,-0.4343402879728393,0.07876772581832837,0.5782523184819879,0.7789364594657695,21446,21496,Goodhue+Wabasha,Wabasha,27,157,Minnesota,MN
27053,27CS018,7636,7086,8185,9067,882,1431,1981,448.22525058686307,1286,402.6693281668917,-1.1217127917889633,0.5124745980046794,2.1794193197999965,0.8977366411899065,9379,8723,10034,9922,-112,543,1199,42.796173762240144,683,53.80342136192766,-0.5934408498728526,-0.10606218653150368,0.385592099203557,1.2548917896845204,1277475,1269436,Hennepin,Hennepin,27,53,Minnesota,MN
27065,27CS019,142,135,149,181,32,39,46,968.105694638346,19,472.079011118703,3.3175831964235853,4.926434114995399,6.589212254471873,0.47542986056265685,174,166,182,213,31,39,47,240.85758880179387,29,179.6555569322265,0.12155825855844585,0.6264664550843267,1.0843198247763755,0.7271955490856681,16099,16142,Kanabec+Mille Lacs+Pine,Kanabec,27,65,Minnesota,MN
27095,27CS019,261,249,272,306,34,45,57,686.7925069852012,42,635.8337748845659,-1.0841836155457363,0.4887326446538459,2.178542245424246,0.9058346287098792,322,308,336,377,41,55,69,205.30154913689717,47,175.3731343283582,-0.22533675341544346,0.2920180962134912,0.8279410883430735,0.8389738681680159,26422,26800,Kanabec+Mille Lacs+Pine,Mille Lacs,27,95,Minnesota,MN
27115,27CS019,250,237,262,302,40,52,65,720.7838889499862,18,248.4043470760738,3.0036511974454694,4.737362475650328,6.455571030373448,0.33815642998233425,308,293,323,394,71,86,101,293.8438995391475,38,129.97229537914288,1.1390211288661447,1.6257528907155963,2.112729769661911,0.43722818044824735,28985,29237,Kanabec+Mille Lacs+Pine,Pine,27,115,Minnesota,MN
27067,27CS020,337,318,356,406,50,69,88,634.9438172588153,69,632.8243224652634,-1.6649162208646662,0.03807299802374972,1.6853217501159514,0.9824707411626535,415,392,437,439,2,24,47,55.31652060171061,48,109.70174837161468,-1.0897207117711023,-0.5534608209184133,-0.032906958206303245,1.9044789846385726,43614,43755,Kandiyohi+Renville,Kandiyohi,27,67,Minnesota,MN
27129,27CS020,159,152,165,174,9,15,22,416.7534630737862,34,927.884287371222,-6.8417418491853805,-5.127473428386193,-3.3569829402573976,2.0896215615010028,193,186,201,203,2,10,17,67.39597224923531,10,68.40413160954921,-0.5017104473805934,-0.006359661356996428,0.4774381092477751,0.9214367217852117,14657,14619,Kandiyohi+Renville,Renville,27,129,Minnesota,MN
27085,27CS021,294,279,310,376,66,82,97,892.7000970200696,39,426.49752576755884,3.0371823204385877,4.638861453475445,6.459532562687241,0.4719793792273399,361,342,380,417,37,56,75,152.7475844243275,43,117.07051456575007,-0.12250734632196941,0.3404176108364902,0.8979735021726293,0.7530095722827461,36577,36730,McLeod+Meeker+Sibley,McLeod,27,85,Minnesota,MN
27093,27CS021,194,184,204,226,22,32,42,550.2114939354345,29,496.0656859391037,-1.1606616448733351,0.451031400582277,2.32609749368284,0.8744062045099026,237,225,249,244,-5,7,19,31.15889169520167,27,115.46356483065343,-1.3469053793354484,-0.8443121524191614,-0.32972248812467636,3.258431552420333,23384,23384,McLeod+Meeker+Sibley,Meeker,27,93,Minnesota,MN
27143,27CS021,122,121,123,93,-30,-29,-28,-782.4735647600195,3,80.94981111710739,-9.062658570562407,-8.636630518215044,-8.2750628243161,-0.10714871086824465,150,148,152,170,18,20,22,131.82278833938906,12,80.53691275167785,0.3871331214714917,0.5155125904520379,0.6373564685603545,0.5813504107160972,14824,14900,McLeod+Meeker+Sibley,Sibley,27,143,Minnesota,MN
27069,27CS022,50,49,50,74,24,24,25,2298.090746890718,19,1812.9770992366412,4.431563468259985,4.848698715544826,5.237291185707009,0.7574552223063137,61,60,61,62,1,1,2,31.751662304826553,5,120.45290291496025,-1.012051342999705,-0.8851240768597898,-0.7609623165215985,2.1570212206006465,4192,4151,Northwest Minnesota,Kittson,27,69,Minnesota,MN
27077,27CS022,39,38,39,45,6,6,7,667.6413176809226,7,744.0871644964125,-1.13778524904723,-0.7602446173836616,-0.375307118844863,0.9614280959211379,48,48,49,50,1,2,2,45.99388817567374,3,78.65757734661773,-0.4659823903559313,-0.3274506291062204,-0.1959017077430992,1.089242789067232,3763,3814,Northwest Minnesota,Lake of the Woods,27,77,Minnesota,MN
27089,27CS022,72,71,73,87,14,15,16,665.9118331906215,15,661.1570247933884,-0.35819229010864634,0.04454103472603091,0.4659662919198132,0.931221546288455,88,87,89,99,10,11,12,123.56916932115344,12,133.40744858254587,-0.2197575006671316,-0.1000886288528105,0.017118926620606528,0.9905038104662115,9075,8995,Northwest Minnesota,Marshall,27,89,Minnesota,MN
27113,27CS022,116,114,117,121,4,5,7,155.4555424613769,13,373.00050211606055,-2.57441232387448,-2.172736175911014,-1.7706918445911524,2.025548620683556,141,139,143,156,13,15,17,108.2547349870511,13,94.18242411070058,0.018209489324981447,0.1425929979489679,0.2636873432299925,0.8154355133022517,13941,13803,Northwest Minnesota,Pennington,27,113,Minnesota,MN
27119,27CS022,301,288,315,349,34,48,61,613.4784813917,60,772.6731270725347,-3.272186678228298,-1.5450347791382875,0.10477410333957606,1.233599860997856,368,352,384,380,-4,12,28,38.54499849645678,35,113.63636363636363,-1.264123568298075,-0.757163537723791,-0.21951314938657393,2.719109845756258,31061,30800,Northwest Minnesota,Polk,27,119,Minnesota,MN
27125,27CS022,28,28,29,27,-2,-1,-1,-134.79801187080196,0,0,-1.7471909464990596,-1.3395576860983136,-0.9668259406841652,-0,35,34,35,43,8,8,9,207.2246747019416,8,203.40706839562674,-0.09811702531563742,0.038351842995723376,0.16151592560274006,0.8743029456900394,3950,3933,Northwest Minnesota,Red Lake,27,125,Minnesota,MN
27135,27CS022,120,118,121,174,53,54,56,1424.5815526671622,17,445.23014469979705,9.391252025784107,9.789162640265442,10.188547877040577,0.3068919715644257,147,146,149,171,22,24,25,154.29578863395034,15,98.27687872633166,0.4396945161116741,0.5589724347452997,0.6911828783242219,0.6109938265211833,15273,15263,Northwest Minnesota,Roseau,27,135,Minnesota,MN
27109,27CS023,970,900,1040,1055,15,85,155,209.11210535516744,57,140.44857303017795,-1.1208542719441916,0.7084206348183437,2.2874086689242663,0.6638205487378438,1206,1122,1290,1266,-24,60,144,36.723601288832974,51,31.217290706428923,-0.48579548263397526,0.03783112353007437,0.573183635075695,0.8361243127154385,162337,163371,Olmsted,Olmsted,27,109,Minnesota,MN
27111,27CS024,582,556,608,675,67,93,119,622.2054568934844,53,354.33136668282333,0.912198947239155,2.713906424644933,4.453399142881161,0.5634225841795338,712,681,743,783,40,71,102,118.25896205807126,82,136.5687923654714,-0.7053542757736794,-0.16566129181393704,0.3193168792474569,1.1387903742130512,59831,60043,Otter Tail+Wadena+Wilkin,Otter Tail,27,111,Minnesota,MN
27159,27CS024,182,176,189,170,-19,-12,-6,-355.69570895571945,11,313.18955085771233,-8.300306530762317,-6.658401116983632,-4.930653480309806,-0.957110775246578,223,216,231,222,-9,-1,6,-8.715385044221064,29,204.70106585727396,-2.673198350893703,-2.1331389557695672,-1.6346275408815318,-123.5574669910585,14049,14167,Otter Tail+Wadena+Wilkin,Wadena,27,159,Minnesota,MN
27167,27CS024,71,70,72,76,4,5,6,313.8008580887365,12,746.0366801367734,-4.732863121164036,-4.332301675534424,-3.92615415915829,1.9842953597389197,87,86,87,89,2,2,3,38.82602825990988,11,171.66042446941324,-1.4501076702172095,-1.327290994072779,-1.1975645931781693,3.1536951397785957,6434,6408,Otter Tail+Wadena+Wilkin,Wilkin,27,167,Minnesota,MN
27123,27CS025,3669,3432,3905,4354,449,685,922,498.0591374290035,630,457.8871053903488,-1.1585742353426716,0.45134853868418157,2.0908339096110904,0.9180032284501014,4478,4197,4760,4976,216,498,779,91.39083344093798,357,65.57003688084988,-0.2959974230114709,0.2387314171694024,0.7677412780634982,0.716029404737627,550354,544456,Ramsey,Ramsey,27,123,Minnesota,MN
27131,27CS026,446,417,474,508,34,62,91,372.82567318424293,52,310.2070035196564,-0.9463249403968735,0.5753139400889224,2.275167995107992,0.8189393250842963,553,518,587,615,28,62,97,92.77890225373292,73,108.58570833581246,-0.6715765279234235,-0.1579037547445109,0.3287751901897528,1.1519028414289714,67052,67228,Rice,Rice,27,131,Minnesota,MN
27017,27CS027,326,310,341,367,26,41,57,459.0892306899092,41,453.7029352366725,-1.616740172210198,0.0705667408391998,1.6151705024193908,0.9650068270121751,401,382,419,472,53,71,90,196.16570168673508,34,93.47849994501264,0.5008938813286002,1.0124661751929958,1.5042835699273387,0.46994177092188516,36147,36372,St. Louis and Nearby Counties,Carlton,27,17,Minnesota,MN
27031,27CS027,45,45,46,48,2,3,3,203.89346920851472,1,71.82618064284432,0.9029836919669729,1.3192559541573696,1.7575734521544235,0.26050439524918134,56,55,57,49,-8,-7,-6,-123.54322390055752,4,71.26313914127917,-2.0679445711614806,-1.9493801719116652,-1.8194776452760857,-0.6740269104939338,5569,5613,St. Louis and Nearby Counties,Cook,27,31,Minnesota,MN
27071,27CS027,124,123,125,147,22,23,24,768.9257228329345,3,99.60986137627626,6.305571666092308,6.692567518642134,7.0863480007373765,0.1241818462362397,151,149,152,186,34,35,37,295.46217052177,22,184.03881545926052,0.9869161743223933,1.1067117771522004,1.2329402423534628,0.6057344128367307,12047,11954,St. Louis and Nearby Counties,Koochiching,27,71,Minnesota,MN
27075,27CS027,121,120,122,135,13,14,15,515.9141721916658,12,442.0703628660895,0.35698284218111687,0.734086386360145,1.1416858229290685,0.7997605941111399,150,148,151,169,18,19,21,174.86236651186297,6,54.68963631391851,1.0794986160488214,1.2022958792473755,1.3329429809623659,0.2972629479876349,10858,10971,St. Louis and Nearby Counties,Lake,27,75,Minnesota,MN
27137,27CS027,1766,1680,1852,2079,227,313,399,627.4516076629643,220,440.50437751225155,0.19787367983891455,1.8685951863407166,3.614135999026671,0.6998199189975459,2156,2054,2259,2371,112,215,317,107.65565040225032,185,92.82675016056518,-0.3774009634939911,0.1419502936699685,0.6913891928990246,0.8582559852300622,199771,199296,St. Louis and Nearby Counties,St. Louis,27,137,Minnesota,MN
27139,27CS028,629,564,694,740,46,111,176,293.3771365241432,64,169.3749007568941,-0.48502110431499806,1.2092634784288625,2.9820480459153225,0.5721668464485303,795,716,874,911,37,116,195,75.85306608786506,109,71.25300700763518,-0.45277307733423433,0.0433729747065371,0.5513983866078529,0.93132951704194,151144,152976,Scott,Scott,27,139,Minnesota,MN
27141,27CS029,486,444,528,595,67,109,151,445.94688920331583,57,233.51803107428537,0.43552536398010794,2.156472877969646,4.00243465493181,0.5188785727971015,612,561,663,727,64,115,166,116.4485147866671,87,88.02015357999211,-0.19078105119983027,0.2745331155748714,0.7708991920197937,0.749361256736907,97637,98841,Sherburne,Sherburne,27,141,Minnesota,MN
27033,27CS030,136,131,141,150,9,14,19,503.31930872203463,16,558.4642233856894,-2.505360101019645,-0.5322444754991551,1.1224733536031857,1.0376068814727792,167,161,173,166,-7,-1,5,-8.429352497610227,16,138.4442329324219,-1.9617168831278249,-1.470939674126412,-0.9573379513196479,619.6811063808541,11460,11557,Southwest Minnesota,Cottonwood,27,33,Minnesota,MN
27063,27CS030,91,90,92,96,4,5,6,186.6191772676336,11,442.38890006032574,-2.971124967550775,-2.553855515028509,-2.1422512886586502,1.9502557683526658,113,112,114,106,-8,-7,-6,-69.97208979680258,8,80.10413537598879,-1.6244886136845025,-1.5021583110170886,-1.3727255706560098,-1.335980220095267,9946,9987,Southwest Minnesota,Jackson,27,63,Minnesota,MN
27101,27CS030,82,81,83,58,-25,-24,-23,-1167.2113630760343,5,244.79804161566705,-14.532238015235688,-14.115837771633707,-13.694782078097068,-0.21891138607670674,100,99,101,109,8,9,10,105.23427636500075,1,12.272950417280313,0.8079457080806088,0.9269242055617686,1.0624145093139228,0.10444421805664597,8170,8148,Southwest Minnesota,Murray,27,101,Minnesota,MN
27105,27CS030,161,152,171,201,30,40,49,719.481526113028,43,778.809146479511,-2.3563448138333674,-0.5712741476291969,1.194504763357451,1.0558787288631257,199,187,210,184,-26,-15,-3,-66.88748053225338,18,81.74758163404333,-1.9912839140717449,-1.478527727219485,-0.9354107339010396,-1.3111931724346058,22085,22019,Southwest Minnesota,Nobles,27,105,Minnesota,MN
27117,27CS030,103,102,104,106,2,3,4,131.51720192576008,17,726.5733518538306,-6.329702146308409,-5.958999004099958,-5.549278553014376,4.169554970476859,126,125,127,128,1,2,3,20.6220649934482,11,117.9498177139181,-1.1033101427977525,-0.9705568215369886,-0.8531763363063258,3.762981712254242,9359,9326,Southwest Minnesota,Pipestone,27,117,Minnesota,MN
27133,27CS030,102,101,103,119,16,17,18,708.2174174805817,13,538.9718076285241,1.2945636119818724,1.6864509815601951,2.1139077755190607,0.7189389037520844,126,125,127,122,-5,-4,-3,-39.121837107196846,16,165.22098306484924,-2.1760669268101074,-2.048788275719377,-1.9147465925292733,-5.737731096952191,9648,9684,Southwest Minnesota,Rock,27,133,Minnesota,MN
27011,27CS031,68,67,68,67,-1,-1,-0,-50.70714915637885,3,234.32923257176333,-3.235233385804473,-2.8563699458272276,-2.4533752941429903,8.551351880332165,84,83,84,76,-8,-8,-7,-145.87496165815938,1,19.436345966958214,-1.7764550850429188,-1.6519822744087207,-1.5214422925483722,-0.1537215973198193,5121,5145,Stevens and Nearby Counties,Big Stone,27,11,Minnesota,MN
27023,27CS031,151,145,156,155,-1,4,10,135.34563365843405,28,899.8875140607425,-9.312913850571764,-7.6290995943845505,-5.828925595854755,5.372960821644015,183,177,190,172,-18,-11,-5,-91.89904897171719,4,32.28149463320152,-1.713302749683559,-1.250268065495878,-0.730042994784566,-0.385088927058768,12446,12391,Stevens and Nearby Counties,Chippewa,27,23,Minnesota,MN
27051,27CS031,60,59,61,73,12,13,14,862.7022565942452,6,395.19183270212415,4.286424035890819,4.66929472216185,5.089364036098179,0.4255929765971548,75,74,75,78,3,3,4,54.03153987588102,1,16.281341582546403,0.25297769305890605,0.379144790358456,0.49855264026531276,0.23155560183055168,6073,6142,Stevens and Nearby Counties,Grant,27,51,Minnesota,MN
27121,27CS031,113,112,114,109,-5,-4,-3,-140.8768175346821,8,283.0605926581159,-4.656665006388,-4.236304732153121,-3.8259545424520836,-2.683185199444444,140,139,142,148,6,8,9,67.88558810638034,8,70.24321713934498,-0.14613625221334173,-0.023768713504817504,0.10288447944849022,0.9162239594295967,11305,11389,Stevens and Nearby Counties,Pope,27,121,Minnesota,MN
27149,27CS031,74,73,75,80,5,6,7,244.82989266478472,7,289.3458716544383,-0.84746288970041594,-0.44983784691123346,-0.016343850726387586,1.0111154553371353,92,91,93,74,-19,-18,-17,-183.57788844093676,4,41.27115146512588,-2.370065564072621,-2.251752151215224,-2.124492068714688,-0.23820343707663222,9677,9692,Stevens and Nearby Counties,Stevens,27,149,Minnesota,MN
27151,27CS031,106,105,107,123,16,17,18,719.1086716715778,17,700.0205888408483,-0.19667728239816973,0.18532160573645334,0.5601903493033344,0.920732807763456,130,129,132,94,-38,-36,-35,-373.8672949919314,15,153.76729882111738,-5.41271584786505,-5.275738703527077,-5.150656858832757,-0.42288358840861173,9714,9755,Stevens and Nearby Counties,Swift,27,151,Minnesota,MN
27155,27CS031,48,48,48,56,8,8,8,950.5951902564761,9,1082.0559062218215,-1.694999775302431,-1.300650617286867,-0.94439922243728,1.0104893856336417,58,58,59,62,3,4,4,107.6082920042251,6,182.09408194233689,-0.8812265609263557,-0.7477283344837087,-0.6097592478518308,1.3199306921042815,3327,3295,Stevens and Nearby Counties,Traverse,27,155,Minnesota,MN
27163,27CS032,1492,1376,1607,1715,108,223,339,333.35450814448643,172,256.91773404533404,-0.9217023416597636,0.7591318211221162,2.4628707394999876,0.7672662473484044,1875,1735,2015,2018,3,143,283,52.64680134227394,182,66.99476925455436,-0.665263076867229,-0.15059486090133453,0.3383441773593045,1.2636968777790945,267790,271663,Washington,Washington,27,163,Minnesota,MN
27171,27CS033,751,690,812,824,12,73,134,207.1576046570793,92,259.866818255644,-2.1553338225387946,-0.5381820732928638,1.0977505695809233,1.2375656785201228,951,877,1026,1097,71,146,220,100.87929299233312,146,101.11153433290626,-0.5209968567982732,-0.0010251230081878174,0.5262667198974221,0.9954681984166367,141611,144395,Wright,Wright,27,171,Minnesota,MN
27073,27CS034,71,70,72,94,22,23,24,1365.4868949219676,16,956.794737628943,3.695596857708919,4.085531849444275,4.471804233174296,0.6712999058836158,87,86,88,102,14,15,16,223.91051954576855,2,29.91325157044571,1.8156691134190959,1.9414543884431734,2.06758177756566,0.12522966073461364,6689,6686,Yellow Medicine and Nearby Counties,Lac Qui Parle,27,73,Minnesota,MN
27081,27CS034,68,67,69,65,-4,-3,-2,-213.1363180299177,5,355.8718861209964,-6.08739432254594,-5.702183919119308,-5.269165703247474,-2.5068119250921197,82,82,83,101,18,19,19,332.4389792342545,6,107.60401721664275,2.116754945065581,2.2531376027840753,2.3748093914145265,0.30711277042702084,5620,5576,Yellow Medicine and Nearby Counties,Lincoln,27,81,Minnesota,MN
27083,27CS034,188,177,199,226,27,38,49,600.8531533786056,25,396.212211260351,0.2669255049374484,2.0787669719052135,3.879295436734575,0.6424698499022332,231,218,244,247,3,16,29,64.06137512954909,37,146.69151171549777,-1.3415336740635884,-0.8287024412286836,-0.32035580449613565,2.156403270777441,25239,25223,Yellow Medicine and Nearby Counties,Lyon,27,83,Minnesota,MN
27127,27CS034,157,150,163,178,15,21,28,550.764541632432,21,547.0887065259867,-1.6049052766381975,0.04611368838117996,1.742714369191974,0.9484624933380842,191,183,199,187,-12,-4,4,-28.296547457280752,18,117.11125569290827,-1.9654951715842544,-1.4452847516214125,-0.9403523596806379,-5.374450917732289,15354,15370,Yellow Medicine and Nearby Counties,Redwood,27,127,Minnesota,MN
27173,27CS034,89,89,90,91,1,2,2,64.33820207046061,14,588.2970900304654,-5.648089150684673,-5.2386946909968195,-4.818324812419884,5.5312174005404655,108,107,110,109,-1,1,2,6.144261458537506,16,169.79730446779158,-1.7643392527175041,-1.6358303551155788,-1.5071517613417147,10.133163978600829,9519,9423,Yellow Medicine and Nearby Counties,Yellow Medicine,27,173,Minnesota,MN
28001,28CS001,329,317,342,414,72,85,97,1145.8166491221434,61,826.2783609888248,1.4492945816593887,3.166333620956331,4.927164882074898,0.7127007968888487,394,379,409,467,58,73,88,253.29278178982915,60,208.05159679600538,-0.05497694645351175,0.4455249188933685,0.9811114870769513,0.8102950105098753,29530,28839,Adams+Amite+Wilkinson,Adams,28,1,Mississippi,MS
28005,28CS001,151,146,157,167,10,16,21,504.6823982305296,23,728.3090563647878,-3.9973809268564415,-2.216858726063097,-0.5684588727412668,1.3579039049869879,184,178,191,224,33,40,46,315.95935018922194,31,245.13680215087777,0.17348485658317433,0.705740462013294,1.2201048420454672,0.7569057992967753,12632,12646,Adams+Amite+Wilkinson,Amite,28,5,Mississippi,MS
28157,28CS001,104,103,105,119,14,15,16,704.0614743118407,19,892.2282225874618,-2.2639520763417704,-1.8761273956848645,-1.4833845331372855,1.1880205686741176,125,124,126,123,-3,-2,-1,-23.924321864771233,15,179.72681524083393,-2.1709089381772797,-2.038853692466458,-1.904303737435328,-15.049302978842164,8518,8346,Adams+Amite+Wilkinson,Wilkinson,28,157,Mississippi,MS
28003,28CS002,378,363,393,463,70,85,100,968.4181275494424,41,468.70534438410976,3.1343466781936544,5.028179581541845,6.760833762024792,0.4783439924704624,456,438,474,541,67,85,103,246.89223826013952,67,194.78442887461117,0.008166069061325342,0.5272289000607873,1.0347748408148751,0.7797631836913935,34990,34397,Alcorn+Prentiss+Tishomingo,Alcorn,28,3,Mississippi,MS
28117,28CS002,267,256,278,342,64,75,86,1204.1205456592756,45,721.0960660203509,3.176853308558662,4.832780528810707,6.623689195543146,0.5909921554688623,326,313,339,367,28,41,54,162.6633477913658,40,160.08324328650897,-0.5364497658943541,-0.0018623398934372979,0.5329826503497123,0.9605065931698749,24962,24987,Alcorn+Prentiss+Tishomingo,Prentiss,28,117,Mississippi,MS
28141,28CS002,240,232,249,308,59,68,76,1431.0783477968412,44,931.5126495183656,3.2368573269434506,4.963771588079709,6.573717244846472,0.6414276008439728,291,282,301,394,93,103,112,547.6087614375147,39,207.88912579957358,2.872017083405798,3.410442422286608,3.9166527590088087,0.37597100424105795,18894,18760,Alcorn+Prentiss+Tishomingo,Tishomingo,28,141,Mississippi,MS
28007,28CS003,221,213,229,272,43,51,59,1141.8749889112512,33,738.7094968940623,2.2526701975131274,4.005514713535975,5.623334262996958,0.6344883595316528,268,258,277,305,28,37,47,211.02089764975835,33,185.86313714446635,-0.26580399380512487,0.260118574916897,0.7585934343070493,0.857883525307691,17869,17755,Attala+Choctaw+Leake+Webster,Attala,28,7,Mississippi,MS
28019,28CS003,92,92,93,108,15,16,16,758.2063849336345,10,488.3408619216213,2.3028570188311317,2.714476686097059,3.0869519188421006,0.6051008337170511,112,111,113,115,2,3,4,33.704321482105435,13,160.0985221674877,-1.3847074003090716,-1.2616567285166969,-1.141304067514545,3.478920906405886,8191,8120,Attala+Choctaw+Leake+Webster,Choctaw,28,19,Mississippi,MS
28079,28CS003,188,179,198,270,72,82,91,1521.1489981974114,62,1154.9387603036373,2.000558810534886,3.6565429161946703,5.3910257547256695,0.7500688270196714,229,218,240,317,77,88,99,416.85658381714256,38,179.2199217091921,1.8721208895583414,2.372252333732036,2.864147715664629,0.42512201982693976,21473,21203,Attala+Choctaw+Leake+Webster,Leake,28,79,Mississippi,MS
28155,28CS003,135,131,139,152,13,17,21,686.3262581371068,20,808.4074373484236,-2.936160826238134,-1.207853365844839,0.49255567166881536,1.1123648930348486,165,160,170,203,33,38,43,379.5634851135292,23,230.59955885301784,0.9369738073319586,1.4825097998843384,1.9993976423477522,0.5919038566167014,9896,9974,Attala+Choctaw+Leake+Webster,Webster,28,155,Mississippi,MS
28009,28CS004,88,87,89,119,30,31,32,1609.7135867595684,18,929.1521486643438,6.405035540140907,6.800947927427267,7.227723209077782,0.5592810498864568,106,105,107,132,25,26,27,337.75787409770686,24,313.8075313807531,0.11012223228468065,0.23989049466431386,0.3710682039324595,0.8944636431189459,7749,7648,Benton+Marshall+Tippah,Benton,28,9,Mississippi,MS
28093,28CS004,339,324,353,437,84,98,113,1157.3277903898738,46,541.5428083703682,4.438706898842705,6.131093588891842,7.956907482121311,0.4632132368734866,413,395,430,580,150,167,185,495.9120410836921,72,213.46615671973672,2.3245639998932757,2.827046553855736,3.340487692685836,0.42789349160298945,33977,33729,Benton+Marshall+Tippah,Marshall,28,93,Mississippi,MS
28139,28CS004,231,221,240,285,45,54,64,1000.4030998553986,43,790.2959014886969,0.41414600498493087,2.1283631187608165,3.823455312332449,0.7757261551986132,281,270,292,334,42,53,64,246.2041902759369,45,207.8617950020786,-0.12442613455541485,0.36438000163893,0.8555398383843719,0.8287179093646093,21764,21649,Benton+Marshall+Tippah,Tippah,28,139,Mississippi,MS
28011,28CS005,337,324,350,473,123,136,149,1764.409435116108,87,1130.86146946999,4.826860573700622,6.358583798088917,8.031366462925398,0.6362419711625715,409,393,425,492,67,83,99,273.40722121558804,50,164.54404844176787,0.5769732933975041,1.0758304830526497,1.6188716375012298,0.5946699566883795,30773,30387,Bolivar+Sunflower,Bolivar,28,11,Mississippi,MS
28133,28CS005,267,256,278,367,89,100,111,1559.1329939994569,55,856.6978193146417,5.33415115216464,7.039309069783828,8.72690111874245,0.5440355305763909,325,312,338,397,59,72,85,283.0821181028844,43,168.86584982720703,0.6312471855372709,1.140024256061618,1.6414837697062616,0.5883638282428059,25680,25464,Bolivar+Sunflower,Sunflower,28,133,Mississippi,MS
28013,28CS006,143,137,149,209,60,66,72,1978.5723933655331,19,567.9695090053061,12.389057314599595,14.076250184129456,15.901140368381125,0.2827877809289135,171,164,178,231,53,60,67,459.7067712967297,32,245.21072796934865,1.624454499589025,2.119482045501147,2.6366627197497836,0.5246612628100666,13381,13050,Calhoun+Chickasaw+Grenada,Calhoun,28,13,Mississippi,MS
28017,28CS006,171,164,179,210,31,39,46,908.4692583746295,34,797.4201114042803,-0.5631202120582135,1.127777315456424,2.6811271019460317,0.8556718636473191,209,200,218,248,30,39,48,229.7652305269906,33,193.90093424995592,-0.15679470311040236,0.3622326452039998,0.8628578374991793,0.8228658032514252,17055,17019,Calhoun+Chickasaw+Grenada,Chickasaw,28,17,Mississippi,MS
28043,28CS006,262,252,271,329,58,67,77,1257.1483701265413,48,895.7312806158153,1.9059000331462972,3.640313824500598,5.2933320230890875,0.7020886141805882,318,306,329,350,21,32,44,151.72606304379826,39,182.27706113292203,-0.8278229672706467,-0.3167865521959495,0.22886674979834634,1.1654555932391382,21435,21396,Calhoun+Chickasaw+Grenada,Grenada,28,43,Mississippi,MS
28015,28CS007,96,95,97,141,44,45,46,1826.29256321837,20,805.3961542333635,9.809497250639527,10.197755595498188,10.625499133221714,0.43148633379556706,117,116,119,156,37,39,40,391.61952076440406,24,242.71844660194174,1.3620532162965846,1.4872701352427238,1.6213594307222006,0.6041788298656717,9933,9888,Carroll+Leflore+Montgomery,Carroll,28,15,Mississippi,MS
28083,28CS007,306,294,318,477,159,171,183,2432.9735922078376,91,1293.992179168148,9.652908626964072,11.362211481634487,13.034245580242812,0.5287658258604785,369,354,383,442,59,73,88,265.5389929145859,39,141.0488245931284,0.7383011280026078,1.2378964784183644,1.7502487645915554,0.5240418893902445,28130,27650,Carroll+Leflore+Montgomery,Leflore,28,83,Mississippi,MS
28097,28CS007,133,129,137,184,47,51,55,2081.1142849521602,35,1431.200163565733,4.8337979473770485,6.45828123948212,8.271489057430765,0.6744563180451033,162,157,167,169,2,7,12,75.3714597431769,26,266.99527623742046,-2.4454777673665236,-1.9080369122185448,-1.4331288257546642,3.117628326681396,9782,9738,Carroll+Leflore+Montgomery,Montgomery,28,97,Mississippi,MS
28021,28CS008,91,90,92,113,21,22,23,977.8219108420803,20,883.0022075055188,0.5276114160931743,0.9591942107013129,1.355798828598879,0.8640179859852729,110,109,111,130,19,20,21,227.7530554651082,20,223.83883603805262,-0.07936225981145437,0.03742318570540601,0.16403794520670298,0.9367797551665092,9060,8935,Claiborne+Jefferson+Warren,Claiborne,28,21,Mississippi,MS
28063,28CS008,73,73,74,97,23,24,24,1304.1136036902947,17,942.4809424809425,3.2224394642024623,3.6036899692179585,4.02733674382542,0.6932282048240805,90,89,91,104,13,14,15,195.8570423170834,20,277.31558513588465,-0.9434221973781307,-0.81787601706852,-0.6886579137354722,1.3222956998897544,7215,7212,Claiborne+Jefferson+Warren,Jefferson,28,63,Mississippi,MS
28149,28CS008,427,408,446,581,135,154,173,1382.079617349505,87,780.5665836753919,4.250197496030058,6.0085442822675885,7.689015022885254,0.5611341500744881,511,489,534,653,119,142,164,323.66832079127903,98,224.15370539798718,0.47900831863657817,0.9984833298225246,1.5054905427509202,0.6876817057031659,44583,43720,Claiborne+Jefferson+Warren,Warren,28,149,Mississippi,MS
28023,28CS009,183,176,189,237,48,54,61,1404.8987004511987,45,1160.0180447251403,0.8621909936956846,2.396771947025173,4.2062998783348124,0.8108176357440348,220,212,228,254,26,34,42,217.5556348724102,35,226.72799118999805,-0.6035450216114501,-0.08263907229001617,0.42787894321704584,1.0120268298283364,15517,15437,Clarke+Jasper+Wayne,Clarke,28,23,Mississippi,MS
28061,28CS009,166,159,173,209,36,43,50,1044.6611253981816,22,538.3909452431936,3.442221936042276,5.097367140922778,6.84492211634622,0.5035769386221461,202,193,210,317,107,115,124,707.2934721012687,37,227.00779188907296,4.270723378116922,4.810770611412249,5.312746018589007,0.3181926300372716,16345,16299,Clarke+Jasper+Wayne,Jasper,28,61,Mississippi,MS
28153,28CS009,185,176,193,224,31,39,48,790.706609096546,29,584.9722642460918,0.37373102047472295,2.142982445966392,3.765247682562391,0.7214059529101684,224,214,234,301,67,77,87,390.28611587774816,39,197.7787920279933,1.4463887442460097,1.9457236468348782,2.4078851714932323,0.5002532102818008,19830,19719,Clarke+Jasper+Wayne,Wayne,28,153,Mississippi,MS
28025,28CS010,185,177,193,241,48,56,64,1186.3495345886322,29,619.128949615713,3.9121860759190623,5.716166885690578,7.336955798689877,0.5126517846575803,224,215,234,287,53,63,72,338.4625845096512,41,221.01234434801358,0.681375254780979,1.145695988574389,1.6919776955362418,0.6427521676868477,18736,18551,Clay+Oktibbeha,Clay,28,25,Mississippi,MS
28105,28CS010,284,262,306,397,91,113,135,877.9959335669832,73,568.0049797696856,1.3303271674176245,3.0643077594669745,4.887741676535398,0.6412506678561941,352,325,379,428,49,76,103,146.21101102408417,61,117.70835343380352,-0.20031480669780838,0.2818693157734267,0.8150004363805207,0.7945715678807996,51408,51823,Clay+Oktibbeha,Oktibbeha,28,105,Mississippi,MS
28027,28CS011,234,225,243,333,90,99,108,1864.663958239324,58,1088.4864408370086,6.18344371042691,7.733479271385282,9.47043166809941,0.5779274423002657,282,271,293,390,97,108,119,516.5046396800598,53,253.92870831736298,2.1058979769841066,2.6364091996310237,3.1547678237020076,0.4871106460997735,21314,20872,Coahoma+Quitman+Tallahatchie+Tunica,Coahoma,28,27,Mississippi,MS
28119,28CS011,72,72,73,123,50,51,51,3263.878830641572,13,835.2071956312238,23.87638596596069,24.275907584594304,24.703916018067268,0.25095423417641854,85,84,86,130,44,45,46,751.8629117508835,19,318.417965476789,4.2022962823149275,4.336983099920076,4.462622122454347,0.4142713430006808,6226,5967,Coahoma+Quitman+Tallahatchie+Tunica,Quitman,28,119,Mississippi,MS
28135,28CS011,131,125,136,181,45,50,56,1572.0294711967217,31,967.0878178131337,4.505450294048741,6.063914094033819,7.6257189783498935,0.603213712126378,157,150,163,192,29,35,42,283.9539416939919,24,193.39242546333602,0.3942527172301532,0.9126870113907474,1.417600303924113,0.6622757021540344,12822,12410,Coahoma+Quitman+Tallahatchie+Tunica,Tallahatchie,28,135,Mississippi,MS
28143,28CS011,94,93,95,117,22,23,24,960.4219878031497,15,618.5567010309278,2.9620687326114705,3.4117805277419224,3.8092123509548474,0.6175321526921393,116,114,117,163,46,47,49,489.11819333095957,21,216.49484536082477,2.5910443047045737,2.7294648302320237,2.843911636070327,0.4334860568080662,9700,9700,Coahoma+Quitman+Tallahatchie+Tunica,Tunica,28,143,Mississippi,MS
28029,28CS012,273,261,285,364,79,91,103,1285.6537021094234,42,595.0272720833038,5.205579662236008,6.858033524660171,8.585119888575477,0.45777631211707676,331,316,345,399,54,68,83,243.46597517098763,46,164.0630572794065,0.2835901021044942,0.7993902216260629,1.294022384883613,0.6641353473382944,28234,28038,Copiah+Franklin+Lincoln,Copiah,28,29,Mississippi,MS
28037,28CS012,84,83,84,103,19,19,20,1017.8888635696135,14,730.9750685289127,2.4878653964709048,2.8606480302926065,3.291396876490893,0.6830895558780308,103,102,104,143,39,40,41,527.0761153677603,16,208.52339371823277,3.0523397937694696,3.1855180747156555,3.3070212446862084,0.38607662587745206,7661,7673,Copiah+Franklin+Lincoln,Franklin,28,37,Mississippi,MS
28085,28CS012,362,347,377,474,97,112,127,1291.520799710812,74,852.3872602660831,2.6664323960611647,4.435354315157015,6.222891256606744,0.6541530244223834,443,425,461,536,75,93,111,267.5687399684992,54,154.62146374985682,0.6195030275753837,1.1107629874115807,1.6315069531781903,0.5717570640334558,34726,34924,Copiah+Franklin+Lincoln,Lincoln,28,85,Mississippi,MS
28031,28CS013,218,210,226,298,72,80,88,1742.2731791344827,50,1090.1558922925979,4.795037091600318,6.526099820700619,8.260774771130889,0.6179754776812527,264,255,273,302,29,38,47,207.89771672521294,30,164.07788230146576,-0.07609980083437187,0.42055604623535836,0.9336612253689965,0.768993790464264,18346,18284,Covington+Simpson+Smith,Covington,28,31,Mississippi,MS
28127,28CS013,252,241,263,350,87,98,109,1507.769451817165,58,891.9303371650456,4.385972049447633,6.183915445681539,7.746142505829557,0.585583668947621,304,291,318,400,82,96,109,371.0722871541774,58,225.05917504171356,0.9414164802178143,1.464852687108751,1.958996205033276,0.6002336412190702,26011,25771,Covington+Simpson+Smith,Simpson,28,127,Mississippi,MS
28129,28CS013,140,134,146,164,18,24,30,670.7242559416352,16,443.1826050827505,0.6448267881482991,2.343062636568409,4.038171576354299,0.6345473989215291,168,161,176,221,45,53,60,371.47603047567515,32,225.4632565349116,0.9491954908654214,1.4601632726885359,1.9499807240831877,0.5956414716487047,14441,14193,Covington+Simpson+Smith,Smith,28,129,Mississippi,MS
28033,28CS014,1250,1170,1330,1497,167,247,327,531.7914362193468,152,326.68676220105203,0.3702832300635839,2.0884217687243223,3.6782544437675564,0.6118409170991369,1558,1461,1655,2083,428,525,622,278.966484909052,275,146.09397827184105,0.8124741145684352,1.3235398408366328,1.8515106950119657,0.5227018311454141,186111,188235,De Soto,De Soto,28,33,Mississippi,MS
28035,28CS015,682,649,716,780,64,98,131,504.3188437937999,92,473.8787231028755,-1.3709038281547523,0.2823007865919426,2.1038913656704668,0.9301411322141968,839,798,879,1029,150,190,231,244.274427342818,141,180.9710831311848,0.14826901755892066,0.629174992065289,1.1383610215577538,0.7369792444575921,77657,77913,Forrest,Forrest,28,35,Mississippi,MS
28039,28CS016,245,235,256,269,13,24,34,389.04138408821177,37,606.706567188653,-3.803320101607237,-2.1970803417283356,-0.5843450250646935,1.496419383354104,303,290,316,382,66,79,92,320.74614977091875,42,170.04048582995952,1.0025347675564946,1.5157414582796431,2.01360661057609,0.5235321533123829,24394,24700,George+Greene+Perry+Stone,George,28,39,Mississippi,MS
28041,28CS016,118,117,119,141,22,23,24,677.2509549278203,22,650.6950606329489,-0.12971639383199393,0.2639304977405259,0.6586588071377389,0.9205847218047072,146,144,147,143,-4,-3,-1,-20.205491534581586,17,124.8989787671736,-1.5766698949677347,-1.451896665028925,-1.3332408692816924,-9.713345169563771,13524,13611,George+Greene+Perry+Stone,Greene,28,41,Mississippi,MS
28111,28CS016,126,121,131,177,46,51,56,1749.5683829173076,25,865.2015919709293,7.210190389151777,8.877285157453272,10.54460124750733,0.48493050876305566,154,148,160,195,35,41,47,351.6328461322721,26,224.9913464866736,0.7644925904564083,1.2664194530616384,1.7776741938653948,0.6244792248718909,11558,11556,George+Greene+Perry+Stone,Perry,28,111,Mississippi,MS
28131,28CS016,168,160,176,217,41,49,57,1070.4831439228192,14,305.0275069448227,5.936523042934042,7.656620058979323,9.470745921907088,0.27925996055607327,208,198,217,282,65,74,84,400.1326080156988,47,252.70175815904082,0.9430158693188827,1.485390480463079,1.998598114127682,0.6231713916831215,18359,18599,George+Greene+Perry+Stone,Stone,28,131,Mississippi,MS
28045,28CS017,428,408,448,522,74,94,114,812.5820670878616,54,466.4622295166933,1.6849388659078222,3.4980747696668097,5.214344643477015,0.5680111100662151,522,498,546,658,112,136,160,295.22639519460927,78,169.3516870033436,0.7304185472201984,1.2637303810528588,1.7443967891261412,0.5694454282944487,46306,46058,Hancock+Harrison,Hancock,28,45,Mississippi,MS
28047,28CS017,1808,1719,1898,2084,186,276,365,528.6566238200469,145,278.0640985689287,0.7867799375490996,2.4988434054559923,4.234291744059463,0.5240813487666266,2223,2115,2331,2856,525,633,741,302.5581226014519,348,166.2828145755488,0.8463325172924732,1.3569120135028356,1.8801566049875464,0.5487230684733676,208585,209282,Hancock+Harrison,Harrison,28,47,Mississippi,MS
28049,28CS018,1812,1715,1910,2460,550,648,745,1141.1215406122758,268,472.2591786567046,5.145599842960663,6.70321449315167,8.49330055509512,0.4132171785661274,2200,2084,2315,2878,563,678,794,303.8951549110728,329,147.36446052961622,1.0112508864330711,1.5677553247390479,2.0690280009066475,0.4842050779943926,226994,223256,Hinds,Hinds,28,49,Mississippi,MS
28057,28CS019,259,248,269,301,32,42,53,712.3359498030551,43,724.0276140764439,-1.8082749266691562,-0.1503485994429776,1.5822192326798843,0.992942440872623,318,305,330,358,28,40,53,169.6952822244306,56,234.93874811209935,-1.1720082324060086,-0.6655737200261614,-0.10771437328600127,1.351072025327786,23756,23836,Itawamba+Monroe,Itawamba,28,57,Mississippi,MS
28095,28CS019,368,353,382,495,113,127,142,1486.0993426083005,76,887.694913274543,4.259405182919665,5.935511820401296,7.634612210917317,0.5926739485069039,447,430,465,554,89,107,124,314.8010517619627,84,247.68532169605473,0.17145383465040695,0.6886733045757419,1.1822877146046094,0.7794982408636023,34246,33914,Itawamba+Monroe,Monroe,28,95,Mississippi,MS
28059,28CS020,1217,1155,1279,1424,145,207,269,577.7396679765292,142,396.155616621797,-0.007667771322005691,1.8056391653007267,3.3445829127680184,0.6824039418706795,1502,1428,1576,1824,248,322,396,223.8512680325857,207,143.86389224802969,0.2878402723038582,0.8106818334927773,1.3069063774743233,0.6406870928523427,143378,143886,Jackson,Jackson,28,59,Mississippi,MS
28065,28CS021,143,138,148,145,-3,2,7,67.64127648438287,21,748.663101604278,-8.597272665152357,-6.820601215455432,-5.1654997782160255,7.248032991167023,173,168,179,197,18,24,29,211.87454923075026,17,152.4390243902439,0.0851039293827349,0.6020459260520429,1.1077247313329244,0.6902642366479198,11220,11152,Jefferson Davis+Lawrence+Marion,Jefferson Davis,28,65,Mississippi,MS
28077,28CS021,142,136,147,176,29,34,40,1139.2131843526536,17,563.9877249730447,4.1690096501957035,5.770125151891868,7.4026100936552615,0.4810585541671443,170,164,177,202,25,32,38,266.46240883953413,27,228.09833572695783,-0.18389852167855575,0.38032646608933424,0.9161110968296802,0.8297185432599276,12057,11837,Jefferson Davis+Lawrence+Marion,Lawrence,28,77,Mississippi,MS
28091,28CS021,275,264,285,397,112,122,133,2003.57815230197,66,1081.435359659184,7.495158045434819,9.208634083674827,11.001637134532615,0.535373703582783,335,323,348,408,60,73,85,297.5128630384305,39,159.96062507690417,0.8811913824568997,1.3685749047872473,1.8459340572909921,0.5303480728412996,24412,24381,Jefferson Davis+Lawrence+Marion,Marion,28,91,Mississippi,MS
28067,28CS022,658,629,687,763,76,105,134,626.4300836314202,86,511.39488902433584,-0.5455623473917934,1.161886178532333,2.8708997815274713,0.8086873247971301,800,765,834,1048,214,248,283,371.9752583544434,138,206.58064129816475,1.1549937462423612,1.6615615340348076,2.154733782364147,0.5531352280013236,67267,66802,Jones,Jones,28,67,Mississippi,MS
28069,28CS023,83,82,84,106,22,23,24,1005.8290245774601,20,880.7662666519873,0.8449234540535133,1.2469463261020275,1.6636023947948044,0.8389310104696686,100,98,101,133,32,33,35,378.48664351285095,19,214.6650096034346,1.5176455258123966,1.643062655692246,1.7676359253016536,0.5507269871731183,9083,8851,Kemper+Neshoba+Noxubee+Winston,Kemper,28,69,Mississippi,MS
28099,28CS023,336,324,349,497,148,161,173,2218.583336434555,121,1668.1027054971566,3.8062285586563616,5.540642403091493,7.126555924650608,0.747234204760466,410,395,425,470,45,60,75,207.53575731828587,65,224.19204635601696,-0.721578278674902,-0.1658470758874248,0.3357041175411752,1.0625977630525676,29015,28993,Kemper+Neshoba+Noxubee+Winston,Neshoba,28,99,Mississippi,MS
28103,28CS023,103,102,104,143,39,40,41,1555.2315931187245,18,702.576112412178,8.10771543877706,8.53855276982883,8.940152429163513,0.44069005445054693,125,124,126,151,25,26,27,254.48124001142023,19,187.39520662787257,0.5364068740402285,0.6755060895665124,0.7965220205586925,0.7089062108257812,10248,10139,Kemper+Neshoba+Noxubee+Winston,Noxubee,28,103,Mississippi,MS
28159,28CS023,191,184,199,258,59,67,74,1502.4273850358372,49,1106.5943992773261,2.123409838182089,3.8973930779618042,5.690281925152499,0.7256304641501277,233,224,242,299,57,66,75,376.14854856682433,39,221.50281138183678,1.0491781704370984,1.555254511185921,2.041218622321171,0.5801113297785314,17712,17607,Kemper+Neshoba+Noxubee+Winston,Winston,28,159,Mississippi,MS
28071,28CS024,342,318,366,409,43,67,91,482.54745129072137,56,401.69284843268053,-0.817333287937604,0.8047814519115816,2.5424932491387757,0.8202491367421767,428,398,457,523,66,95,125,168.19989189138494,46,81.07012565869476,0.37521958941902234,0.8853194252240427,1.4170785985228793,0.4769889109005242,55764,56741,Lafayette+Yalobusha,Lafayette,28,71,Mississippi,MS
28161,28CS024,165,160,171,212,41,47,52,1507.6380247528477,25,806.9071249899137,5.382685707178869,7.010667483971895,8.719185398871401,0.5239948222311354,201,195,207,196,-11,-5,1,-39.631227665112924,16,128.8244766505636,-2.2284057580751933,-1.6880013958618247,-1.1424413039721861,-4.079344810793135,12393,12420,Lafayette+Yalobusha,Yalobusha,28,161,Mississippi,MS
28073,28CS025,387,359,415,484,69,97,125,603.6284772381563,53,329.5200198955484,0.9919847420781279,2.69871700234691,4.429250672499874,0.5403333111210983,482,448,516,577,61,95,129,145.88274321302254,86,131.88363569445934,-0.3559570041744495,0.14427985282158157,0.6726602738697176,0.8946341692175874,64336,65209,Lamar,Lamar,28,73,Mississippi,MS
28075,28CS026,702,671,733,1032,299,330,361,1809.436155341035,151,828.2936328355344,8.135695886288213,9.850904411238437,11.596315350661177,0.4563798560544073,852,815,889,1071,182,219,256,303.6504158732996,140,193.96492005874364,0.5894511858849256,1.0982074421315193,1.5997002127795361,0.6358757544218121,72921,72178,Lauderdale+Newton,Lauderdale,28,75,Mississippi,MS
28101,28CS026,224,215,233,276,43,52,61,988.8107298541265,39,736.3353157745681,0.7957752839811313,2.5550503386304895,4.231080472398723,0.7307152948805753,272,261,283,324,41,52,63,248.13161222723951,45,213.442109756676,-0.14316475165748252,0.3547349586927899,0.8359727268300029,0.8440624961099744,21186,21083,Lauderdale+Newton,Newton,28,101,Mississippi,MS
28081,28CS027,762,726,797,969,172,207,243,993.2018549307937,116,555.3627212773342,2.7134013022918526,4.387023633330737,6.182519745569822,0.5564815471289657,927,884,970,1168,198,241,284,290.8644510884729,141,170.0167605175262,0.7091701547905372,1.1931479250277977,1.6988836331614097,0.5821091472868277,83549,82933,Lee,Lee,28,81,Mississippi,MS
28087,28CS028,550,524,575,694,119,144,170,984.185466658564,88,600.1602700721215,2.0627389262750553,3.834222089453156,5.699520689322358,0.6056074243839541,671,641,701,753,52,82,112,141.03486323454567,87,149.39725933303566,-0.5718290359479803,-0.0889854657782688,0.44003167707110175,1.0465505409220088,58651,58234,Lowndes,Lowndes,28,87,Mississippi,MS
28089,28CS029,900,853,947,1018,71,118,165,433.57310991309186,121,444.59958479542905,-1.7627955553744488,-0.11278496842473594,1.5661528292552873,1.0168145006501257,1112,1056,1169,1176,7,64,120,58.181408219442766,131,119.38720643050479,-1.1305776467153597,-0.6426915654568998,-0.1286066593705959,2.0203355627797874,108862,109727,Madison,Madison,28,89,Mississippi,MS
28107,28CS030,327,313,342,403,61,76,90,910.9618057292072,67,806.4758809545305,-0.575369223519695,1.0263754035972295,2.757651117172099,0.873756191908917,397,380,414,499,85,102,119,311.27635154120645,61,185.4723463772082,0.7602490345822137,1.2603556509146079,1.7924316782660639,0.5900807659752404,33231,32889,Panola+Tate,Panola,28,107,Mississippi,MS
28137,28CS030,254,242,266,377,111,123,135,1752.054363706154,55,781.1945174348413,7.935160759446431,9.720160247487915,11.465162601088275,0.44228791121827105,311,297,326,413,87,102,116,360.9547381273971,62,219.71791055354737,0.8931565724329859,1.409669959895713,1.9026176770711596,0.602794977499737,28162,28218,Panola+Tate,Tate,28,137,Mississippi,MS
28109,28CS031,592,568,616,712,96,120,144,853.302921168209,84,598.7063666007376,0.8041471223288467,2.5609419909989817,4.3805490409312045,0.6958219769652961,729,700,758,932,174,203,232,359.7050969316011,154,272.80779450841453,0.360759360845747,0.8668439023180587,1.3763524830426912,0.7547039352843847,56121,56450,Pearl River,Pearl River,28,109,Mississippi,MS
28113,28CS032,448,431,465,543,78,95,112,950.5759825355682,59,589.2634207240949,2.026994606026057,3.5855255717612025,5.298287238184961,0.6134559785630745,545,524,565,640,75,95,116,238.05810931525713,78,194.9658809708301,-0.11846341220857332,0.4229564962112332,1.0268084654519323,0.8104745919661145,40050,40007,Pike+Walthall,Pike,28,113,Mississippi,MS
28147,28CS032,153,147,159,200,41,47,53,1336.9135095337283,33,947.8672985781991,2.187752013492011,3.882504469827209,5.514686893299502,0.6940844927754379,186,179,193,229,36,43,50,308.1418767526484,30,216.7630057803468,0.41956065550533284,0.9241048140749842,1.4472037987366033,0.6873350493708877,13926,13840,Pike+Walthall,Walthall,28,147,Mississippi,MS
28115,28CS033,257,243,270,386,116,129,143,1647.1282575301598,38,484.26150121065376,9.87270351425353,11.64498458571054,13.393203572069439,0.2917462953059012,316,300,332,458,126,142,158,452.3847806436033,63,200.57306590257878,2.014210265099012,2.5124313430852405,3.039578893800704,0.44026984890944704,31388,31410,Pontotoc+Union,Pontotoc,28,115,Mississippi,MS
28145,28CS033,260,248,272,294,22,34,46,487.339946067309,40,572.778692632634,-2.605085484878201,-0.8363077331312379,0.9522453583166895,1.1417680548838707,319,304,333,379,46,60,75,215.88757038777214,46,164.7092523632197,0.01624073021453835,0.5008308733220714,1.0526723158931246,0.7504925434690702,27934,27928,Pontotoc+Union,Union,28,145,Mississippi,MS
28121,28CS034,1054,986,1122,1391,269,337,405,859.1435933027325,140,356.8902116486416,3.3388974917966014,5.0595300100125336,6.70993511604834,0.4141733665171296,1312,1230,1393,1608,215,296,378,187.51293104322775,209,132.32538114774857,0.035083623396663835,0.5565253068112914,1.0408691461447868,0.7033119712332297,156911,157944,Rankin+Scott,Rankin,28,121,Mississippi,MS
28123,28CS034,257,245,269,302,33,45,57,649.5698586793493,43,615.2525397052511,-1.2692163920340862,0.3072906090327579,2.049728387597542,0.9267553475538426,312,298,326,398,72,86,100,311.7344819563195,51,184.44846292947557,0.743294761700087,1.28394042314969,1.7619793111873896,0.5848987116835933,27956,27650,Rankin+Scott,Scott,28,123,Mississippi,MS
28151,28CS035,492,473,511,687,176,195,214,1753.5070339966271,97,873.4214258379669,7.106700873785714,8.775287365121544,10.595322118466505,0.49555505652126053,596,573,618,713,95,117,140,267.4310988660086,45,102.68814750581899,1.1072180851872346,1.6255989868880276,2.1715243875905075,0.3807310939325735,44423,43822,Washington,Washington,28,151,Mississippi,MS
28051,28CS036,179,172,187,260,73,81,88,1911.4444937851042,62,1468.5853023035472,2.7920693273121566,4.403052963875957,6.116646097921904,0.7589072956973263,215,207,224,299,75,84,92,505.6296321076927,27,163.07302047472368,2.9232768149589794,3.4301711140348483,3.961772933495155,0.31870780016638917,16887,16557,Yazoo and Nearby Counties,Holmes,28,51,Mississippi,MS
28053,28CS036,82,81,83,117,34,35,36,1809.8848287195146,25,1290.6556530717605,4.80110416102843,5.194681260522353,5.5997804036749095,0.6933376246755841,99,98,100,144,44,45,46,593.884308239142,14,184.8184818481848,3.9555204835921156,4.091912669106088,4.206718324602044,0.3044356071219528,7748,7575,Yazoo and Nearby Counties,Humphreys,28,53,Mississippi,MS
28055,28CS036,13,13,13,13,-0,-0,-0,-49.37199689040092,1,302.8009084027252,-3.9246028090638645,-3.518146099849779,-3.1533841114476755,1.1948159607985371,16,16,16,13,-3,-3,-3,-222.37938458362973,1,77.7000777000777,-3.1260304687859,-2.9959394303426294,-2.871668407700308,-0.5370503866362598,1321,1287,Yazoo and Nearby Counties,Issaquena,28,55,Mississippi,MS
28125,28CS036,46,46,47,75,28,29,29,2991.378283417704,14,1459.85401459854,14.940606694262884,15.336518569119832,15.694277385992251,0.4715818425755356,55,54,55,76,21,21,22,576.9667703533327,7,190.32082653616095,3.736916660334353,3.8701569818579107,3.9942358387944052,0.315019625214902,3836,3678,Yazoo and Nearby Counties,Sharkey,28,125,Mississippi,MS
28163,28CS036,244,232,256,307,51,63,75,931.5524780001489,38,562.0886029139857,1.9949929885315654,3.674874946444403,5.506295668706494,0.5939578362857247,295,281,308,361,53,66,80,251.63809254410964,33,124.95740088606156,0.7716823285254246,1.253523169922819,1.7718000393616886,0.48921427900404335,27042,26409,Yazoo and Nearby Counties,Yazoo,28,163,Mississippi,MS
29003,29CS001,159,151,167,175,8,16,24,358.9832195734067,18,399.5782229868472,-2.057350625440041,-0.4296381035802427,1.167692587452095,1.04826096924166,194,185,204,191,-13,-3,6,-18.89282165835561,16,88.81980681692018,-1.632504930374715,-1.074653267558031,-0.565246275697119,-6.657366066811085,18019,18014,Andrew+Atchison+Holt+Nodaway,Andrew,29,3,Missouri,MO
29005,29CS001,64,64,65,87,22,23,23,1708.298358306109,11,834.9146110056926,8.318819700239255,8.737991380817677,9.132977253268042,0.4679490851197159,79,78,79,95,16,16,17,313.785715201569,3,57.20823798627002,2.442312902437415,2.5647988005299385,2.6896813156695263,0.1718712833221038,5270,5244,Andrew+Atchison+Holt+Nodaway,Atchison,29,5,Missouri,MO
29087,29CS001,47,46,47,64,17,17,18,1652.1594790714325,18,1706.5655368570754,-0.9524258885875531,-0.5503195002586249,-0.1472528059346939,0.9768724309304602,57,57,58,83,25,26,26,615.1258105676883,5,118.48341232227489,4.843225205230888,4.963405319377143,5.08778793032554,0.18547157248627627,4219,4220,Andrew+Atchison+Holt+Nodaway,Holt,29,87,Missouri,MO
29147,29CS001,162,153,171,156,-15,-6,3,-112.67109182928127,20,374.900417076714,-6.585618767167356,-4.939549028994922,-3.1425852964105623,-3.9914414941802647,198,187,209,168,-41,-30,-19,-142.3930994402853,15,70.86167800453515,-2.6521279948460785,-2.1270644301816097,-1.5968692723852453,-0.5147250608405717,21339,21168,Andrew+Atchison+Holt+Nodaway,Nodaway,29,147,Missouri,MO
29007,29CS002,258,247,269,325,56,67,78,1073.6330442844041,42,673.7247353224253,2.33357034361816,3.993168303026276,5.637177877445607,0.6182809424429782,317,304,330,330,0,13,26,52.61977462982026,38,152.15824457435733,-1.5015929253559057,-0.9893506559390322,-0.47571517652889955,2.6871716692103953,24936,24974,Audrain+Callaway,Audrain,29,7,Missouri,MO
29027,29CS002,353,333,372,452,80,99,119,896.1274860709415,38,342.3886110735685,3.847407510207498,5.485913003808121,7.327770646342627,0.37827239576671906,437,414,460,503,43,66,89,147.95104052727484,57,127.83995334963106,-0.33484543764943364,0.22061127698661118,0.7161538416142877,0.8511663835504373,44394,44587,Audrain+Callaway,Callaway,29,27,Missouri,MO
29009,29CS003,362,348,377,437,60,75,89,858.8937531155593,52,598.7506836696508,0.8275401422282022,2.662514649773089,4.325154324865329,0.6878964272196004,444,426,462,501,39,57,75,164.06394091477674,51,147.02914636607375,-0.3434922954392246,0.17755371839155057,0.6770230718182588,0.8806942619431667,34739,34687,Barry+Lawrence+McDonald,Barry,29,9,Missouri,MO
29109,29CS003,412,395,428,453,25,41,58,434.5619111953434,56,588.7300252312868,-3.219000254035791,-1.563461442615011,0.1895709820416065,1.3227660391202443,507,487,527,581,54,74,94,193.64687370518322,59,154.171783950456,-0.16965721179915585,0.39057734282779694,0.8997302382745589,0.7855488610304465,38048,38269,Barry+Lawrence+McDonald,Lawrence,29,109,Missouri,MO
29119,29CS003,210,200,220,260,40,50,60,858.0038504729001,29,499.11793812658664,1.8484500505548922,3.592668800146621,5.383648151788412,0.5702804959701914,259,247,271,304,33,45,57,191.14005159326823,39,166.88775728529248,-0.27800809854551267,0.24537416062084233,0.7694475467636065,0.8539986657270783,23241,23369,Barry+Lawrence+McDonald,McDonald,29,119,Missouri,MO
29015,29CS004,262,254,271,308,37,46,54,941.2844268532164,24,493.04093266909763,2.8473045041723486,4.488468446967027,6.239644401038461,0.5126083204885767,323,313,333,365,32,42,52,210.8564784462836,42,211.74691202419964,-0.575184421366431,-0.0030476987330845073,0.5027823098694035,0.9807725954430665,19471,19835,Benton+Henry+St. Clair,Benton,29,15,Missouri,MO
29083,29CS004,254,244,263,301,38,47,57,856.96552616513,33,600.5732744892852,0.829472419254176,2.6642387399119816,4.339907052608365,0.6862402737482061,310,299,322,340,18,30,41,133.53866955603206,34,153.3673147187514,-0.7434648521235704,-0.19914022753460128,0.3295834335666376,1.1109590747687461,21979,22169,Benton+Henry+St. Clair,Henry,29,83,Missouri,MO
29185,29CS004,130,126,134,140,6,10,14,443.9168525592669,16,683.7606837606837,-4.024300887660444,-2.3748762318616814,-0.7045344687286441,1.4050303520284655,157,152,162,153,-9,-4,1,-44.24480718322603,12,128.05463664496853,-2.2703655048360227,-1.7325341866277628,-1.1845424783867868,-3.814148154015686,9360,9371,Benton+Henry+St. Clair,St. Clair,29,185,Missouri,MO
29017,29CS005,113,109,118,166,48,53,57,1956.6753928457715,15,557.4136008918618,12.344866780871078,13.96719131761685,15.594152283484231,0.27956838834338915,136,131,142,163,21,27,32,253.62459701698893,15,142.1666192777936,0.6029265793878744,1.1216997876004322,1.6067379935001582,0.5403471599060519,10764,10551,Bollinger+Madison+Stoddard+Wayne,Bollinger,29,17,Missouri,MO
29123,29CS005,153,148,159,174,15,21,26,655.2244373471999,22,702.034303948943,-2.098532009178597,-0.4325604063960419,1.2522725406648305,1.0216830965158168,187,181,194,215,21,28,34,218.7425020855892,26,205.6311293894337,-0.3631070176311884,0.14837506938857753,0.6494915977467252,0.9072572988302353,12535,12644,Bollinger+Madison+Stoddard+Wayne,Madison,29,123,Missouri,MO
29207,29CS005,325,313,338,380,42,55,67,760.235937154037,49,682.950625457333,-0.9295926128061753,0.7646756226978317,2.523844938335527,0.8821671687224729,393,378,408,450,42,57,72,200.29372378900234,65,228.03817008139208,-0.7475465382944686,-0.29308292448317663,0.25509875681204824,1.1189201595510572,28699,28504,Bollinger+Madison+Stoddard+Wayne,Stoddard,29,207,Missouri,MO
29223,29CS005,138,134,143,188,45,50,54,1769.2970936754764,21,749.7991609390342,8.61301617885322,10.184874180888402,11.905030641942513,0.4154007793501458,165,160,171,242,71,77,82,702.1553769041138,17,155.76323987538942,4.911951678234278,5.464394431016406,5.990261064867861,0.21897837155861585,11203,10914,Bollinger+Madison+Stoddard+Wayne,Wayne,29,223,Missouri,MO
29019,29CS006,1002,923,1081,1164,83,162,241,353.2786322680525,83,180.74224087714427,0.038794105877379026,1.7927820810677582,3.37996833878601,0.5084795697537727,1258,1162,1354,1381,27,123,219,66.31189415983766,94,50.658561296859176,-0.33531015260691965,0.16584062454269263,0.6560031625824884,0.7577852458215131,183687,185556,Boone,Boone,29,19,Missouri,MO
29021,29CS007,766,729,802,954,152,188,225,887.6760746733148,105,494.6180841792873,2.1175245302488066,3.930045070140088,5.7359407726499185,0.5542642795764092,929,886,973,1119,146,190,233,225.73204033920365,89,105.99780858463151,0.6800773482904738,1.2081442698602465,1.719648838560417,0.4671090898448689,84914,83964,Buchanan,Buchanan,29,21,Missouri,MO
29023,29CS008,484,466,502,575,73,91,109,863.5835304104463,53,503.5749067673816,1.8253319341312946,3.624836046912697,5.176729953027932,0.5767765328846027,592,570,614,707,93,115,137,273.7239951597719,76,180.57832584883695,0.4194350759591136,0.9544039132401758,1.4367006198696597,0.6540322672907406,42099,42087,Butler+Carter+Ripley,Butler,29,23,Missouri,MO
29035,29CS008,63,62,63,79,16,16,17,1218.7217610539267,2,150.03750937734435,10.245596521408785,10.673610232337905,11.08926803915056,0.11597187191066961,77,76,77,102,25,25,26,478.51849445488426,13,245.09803921568627,2.2099999396150474,2.333698576097164,2.465175148202358,0.49278597447217404,5332,5304,Butler+Carter+Ripley,Carter,29,35,Missouri,MO
29181,29CS008,133,128,137,185,48,52,57,1893.2470267696458,18,650.8768757909962,10.743359049433941,12.385217161476016,14.034616985465506,0.3373455809544027,158,152,163,236,73,78,84,735.1975644513944,38,357.61340109166196,3.2637051754367694,3.773311730816318,4.303268147364983,0.4802704082236021,11062,10626,Butler+Carter+Ripley,Ripley,29,181,Missouri,MO
29029,29CS009,401,383,420,549,129,148,166,1362.618671986293,73,673.5560066432921,5.093964159657998,6.925610515495246,8.55729003712119,0.4909853354792944,492,470,515,664,149,172,194,396.39019349730034,74,170.73902309591378,1.7344279376750231,2.25967211048991,2.79251392666133,0.42824204488729295,43352,43341,Camden+Miller+Moniteau+Morgan,Camden,29,29,Missouri,MO
29131,29CS009,240,229,251,298,47,58,69,930.2640651670441,38,610.9570320350496,1.5259144445287784,3.1445624460719728,4.9199861289086355,0.645598640179874,294,281,307,365,58,71,84,286.40035434507206,36,144.6770887754692,0.9108804653431304,1.4052393907168994,1.9108184923038958,0.4981664694454113,24879,24883,Camden+Miller+Moniteau+Morgan,Miller,29,131,Missouri,MO
29135,29CS009,137,130,144,165,21,28,35,721.2495702002772,21,541.3417542050654,-0.010783664751946842,1.793526846825971,3.5217483369471525,0.7246608374990825,167,159,175,172,-3,5,13,30.07485925373307,14,90.43343453265294,-1.1081651567596729,-0.6165069932448635,-0.12329504260275129,2.4752961199136414,15517,15481,Camden+Miller+Moniteau+Morgan,Moniteau,29,135,Missouri,MO
29141,29CS009,257,248,266,305,39,48,57,907.2009092559114,31,590.5886835587731,1.444471111080079,3.185087625826249,4.949410313785013,0.637611128917402,318,307,329,325,-4,7,18,35.12815252879945,36,168.83177789241665,-1.8737062445103656,-1.3255555960119676,-0.7879060915212366,4.240094920866638,20996,21323,Camden+Miller+Moniteau+Morgan,Morgan,29,141,Missouri,MO
29031,29CS010,711,676,746,943,197,232,267,1138.2078423797989,113,555.2075272383339,4.1069104975785,5.879406867026326,7.495678951435873,0.4856943737334561,876,834,919,926,7,50,92,60.46619004787159,70,85.29719981478321,-0.7838462774751352,-0.24402050974781983,0.22520316813809452,1.3827929797983516,81411,82066,Cape Girardeau+Perry,Cape Girardeau,29,31,Missouri,MO
29157,29CS010,174,166,182,213,31,39,47,818.8078732837341,22,463.4994206257242,1.92137839589061,3.543325094020616,5.3010747065514865,0.5518664716581199,213,203,222,225,3,12,22,65.6533857255345,11,58.1149619611158,-0.46227629468201914,0.07336827101144351,0.6053354163641083,0.8192525633319135,18986,18928,Cape Girardeau+Perry,Perry,29,157,Missouri,MO
29033,29CS011,92,91,93,123,30,31,32,1472.1022294224988,30,1413.9271827500884,0.1420182801867371,0.5860420226357265,0.9706286906898518,0.9306847972819916,111,110,112,110,-2,-1,-0,-13.918342418582213,10,119.21793037672865,-1.4596197313363606,-1.3321616238094127,-1.1996479557247492,-59.71198684924575,8487,8388,Carroll+Lafayette+Ray,Carroll,29,33,Missouri,MO
29107,29CS011,339,325,353,383,30,44,58,535.1668623554096,42,509.8789037603569,-1.4090676113767324,0.26337154977956634,2.0170874405044747,0.9316143522886546,412,395,429,470,41,58,75,175.70552715005851,40,121.78784557301181,0.03004342273503485,0.5277888126217389,1.0202697999863652,0.6813297535066348,32949,32844,Carroll+Lafayette+Ray,Lafayette,29,107,Missouri,MO
29177,29CS011,225,215,235,284,49,59,69,1020.3318057187774,23,398.630789895576,4.4356619992391595,6.2242632046016,7.903416101058333,0.3841618785597038,274,262,286,353,67,79,91,341.6243823844808,53,230.2245775596195,0.6139097729852985,1.1184979442627379,1.6478894938570927,0.6654500309147084,23079,23021,Carroll+Lafayette+Ray,Ray,29,177,Missouri,MO
29037,29CS012,868,821,914,956,42,88,135,327.85753280545526,69,255.73551758644973,-1.0717932194374498,0.7681026065662624,2.458881734372035,0.771300977803861,1081,1025,1138,1255,117,174,230,159.0010303902607,151,138.0054105432478,-0.27267877455546824,0.20295516497397276,0.7186211077431873,0.8629924235186716,107924,109416,Cass,Cass,29,37,Missouri,MO
29043,29CS013,603,565,642,708,66,105,143,469.1019271205755,82,366.8247293549253,-0.6548237038615627,0.9689515429699869,2.773295765359043,0.7745856938443342,758,711,805,952,147,194,241,212.8482941352537,135,148.07989733127118,0.12297416529993041,0.6342824813893686,1.1605453327206858,0.6921394338704953,89416,91167,Christian,Christian,29,43,Missouri,MO
29047,29CS014,1610,1501,1719,1878,159,268,377,422.66636447555186,209,329.66209635124,-0.8642718405360642,0.8879158915208841,2.660526924982888,0.7770583279711324,1998,1866,2130,2220,90,222,354,86.96818578814445,265,103.80555065906732,-0.6913986570776036,-0.16668998723229633,0.3420896847884098,1.1882516451979916,253593,255285,Clay,Clay,29,47,Missouri,MO
29051,29CS015,580,547,613,751,138,171,204,887.0872413777457,125,648.1973631331268,0.7007510088124345,2.421006973522703,4.070109233856826,0.7264564698134335,715,675,755,775,20,60,100,77.36902289070929,88,113.98373141288016,-0.8662380883796085,-0.37006793367744706,0.15304510568621582,1.4489894677112365,77137,77204,Cole,Cole,29,51,Missouri,MO
29055,29CS016,253,243,263,306,43,53,63,914.2374243505974,27,467.047223663726,2.704132191391768,4.4840999406070505,6.220420237527059,0.5013735266875443,306,295,318,382,64,76,87,331.470476273932,55,240.81614781733003,0.41572212118934554,0.8885134366680458,1.4278114552008718,0.7170370686179104,23124,22839,Crawford+Iron+Reynolds+Washington,Crawford,29,55,Missouri,MO
29093,29CS016,129,125,134,155,21,26,30,1067.268996309181,12,500.1562988433885,3.9304948249508818,5.713202384923082,7.412702113179096,0.4510184324216026,155,151,160,190,30,35,39,366.94584450317,19,201.61290322580643,1.13890228606272,1.6637377010126102,2.19170581875946,0.5339932157535524,9597,9424,Crawford+Iron+Reynolds+Washington,Iron,29,93,Missouri,MO
29179,29CS016,72,71,73,79,6,7,8,451.2449869042507,6,392.79869067103107,0.17633254311417418,0.5784536374874116,0.9830042233872395,0.7601896606089309,88,87,89,112,23,24,25,391.7923223084272,13,213.60499507065396,1.6653838372835645,1.7793116391382744,1.9086086754160319,0.5232550496144831,6110,6086,Crawford+Iron+Reynolds+Washington,Reynolds,29,179,Missouri,MO
29221,29CS016,240,229,250,322,72,82,93,1393.123463795711,44,743.21185760736455,4.947497690831275,6.567644829821379,8.151027869475687,0.527095134525761,292,280,304,401,97,109,121,464.40863808526893,55,234.02263637137267,1.80975380201345,2.2952569112094325,2.8166643542053613,0.4993403345449605,23681,23502,Crawford+Iron+Reynolds+Washington,Washington,29,221,Missouri,MO
29059,29CS017,185,177,192,265,73,80,88,1876.556305546911,27,631.320512071082,10.757985071090618,12.438531987605561,14.20501806563466,0.3322847010794542,228,219,237,302,65,74,83,428.72894664986825,31,179.12862591008897,1.9736576521140734,2.4944872648268785,2.992648962866516,0.41225689481232686,17107,17306,Dallas+Hickory+Polk,Dallas,29,59,Missouri,MO
29085,29CS017,130,126,133,149,16,19,23,911.6068381478049,27,1269.2443295334351,-5.308755019220037,-3.6220086057671868,-1.8149932743886676,1.3240384873960953,160,155,164,197,33,37,42,437.14299168511917,12,140.13780217213593,2.431825258238828,2.9803707615667117,3.49206687317675,0.31223529620165424,8509,8563,Dallas+Hickory+Polk,Hickory,29,85,Missouri,MO
29167,29CS017,309,295,323,364,41,55,69,693.4821604932471,41,517.0239596469105,0.11808472113091337,1.7673986441292302,3.510032701945538,0.7322326167391074,381,364,397,429,32,48,65,150.2196548244358,44,137.60750586395622,-0.3614748582180706,0.14060466837074645,0.6296499046143452,0.8973596992279012,31720,31975,Dallas+Hickory+Polk,Polk,29,167,Missouri,MO
29025,29CS018,85,84,86,92,6,7,8,307.29520351381393,5,226.01423889705052,0.38413509145294766,0.8141481768768472,1.209290804215962,0.6411786904008769,105,104,106,136,30,31,32,352.0712748166239,17,191.35524538496173,1.4815338150681945,1.6103377137939154,1.7432755279205654,0.5266743184551218,8849,8884,DeKalb and Nearby Counties,Caldwell,29,25,Missouri,MO
29049,29CS018,220,211,230,270,40,50,59,939.0822933287494,43,815.1658767772511,-0.392744363131498,1.2283036205067364,3.0410956177791064,0.8508686314614211,271,260,282,246,-36,-25,-14,-118.26537345915195,26,122.20916568742655,-2.896595555150079,-2.4197920210544157,-1.8586616637005644,-1.0761162608320725,21100,21275,DeKalb and Nearby Counties,Clinton,29,49,Missouri,MO
29061,29CS018,78,77,79,99,20,21,22,1009.8477288848227,14,666.5079742918352,3.0273551639743514,3.420726038080621,3.852434532159982,0.6302941459650271,95,94,96,107,11,12,13,139.44539918167888,11,130.9056289420445,-0.046080915492032276,0.08616615930932595,0.2174071661970351,0.8649432823153929,8402,8403,DeKalb and Nearby Counties,Daviess,29,61,Missouri,MO
29063,29CS018,95,94,96,139,43,44,45,1599.6152500147996,22,800.5822416302766,7.601548239995051,7.994934555841465,8.396776854832757,0.48935184759453326,117,116,119,130,11,13,14,113.2209043788846,12,108.24463287028685,-0.07707078282700204,0.05002853926261915,0.16658416780336835,0.8854997560199563,10992,11086,DeKalb and Nearby Counties,DeKalb,29,63,Missouri,MO
29075,29CS018,71,70,72,92,20,21,22,1354.2632082395075,13,840.4719573298853,4.764349415543577,5.134855936113031,5.582244086036782,0.5923342964049421,87,86,87,105,18,18,19,298.5652310047606,2,32.441200324412,2.540406796627811,2.659279703122794,2.7930186044061576,0.10305800678558735,6187,6165,DeKalb and Nearby Counties,Gentry,29,75,Missouri,MO
29081,29CS018,92,92,93,105,12,13,13,614.0948274443213,15,733.1378299120234,-1.5971382646852645,-1.2005326875485505,-0.7783011748743317,1.105837481149053,113,112,114,111,-3,-2,-1,-21.72585622551909,2,24.50079627587897,-0.5857389328552239,-0.4629578498554798,-0.3361127621504711,-2.5857110072593223,8184,8163,DeKalb and Nearby Counties,Harrison,29,81,Missouri,MO
29227,29CS018,25,25,26,25,-1,-0,-0,-88.03638123929913,6,1219.5121951219512,-13.460988259037832,-13.075050012763548,-12.677429761611393,10.5846053167499,31,31,32,32,0,1,1,36.67480464996235,5,252.52525252525254,-2.2882615675719102,-2.1585061863286836,-2.032000463461881,2.896600964480179,1968,1980,DeKalb and Nearby Counties,Worth,29,227,Missouri,MO
29065,29CS019,159,153,165,232,67,73,79,1995.9363667332266,28,767.9648930334613,10.498122585473627,12.25953843936451,14.01543679531892,0.3795486194481985,193,186,200,269,69,76,83,527.0050770848476,45,311.85031185031187,1.6429708179351838,2.150812102568493,2.6404097429700752,0.5840603496316341,14584,14430,Dent+Phelps,Dent,29,65,Missouri,MO
29161,29CS019,397,378,416,509,93,112,131,1005.6102719381898,73,655.1198061563313,1.7618978345118186,3.5350717019591515,5.196960176224798,0.6457025471182442,489,466,512,602,90,113,136,252.10722516965768,80,178.26900793297085,0.21192178938105838,0.7170059006151992,1.2790661018159266,0.7009204236687858,44572,44876,Dent+Phelps,Phelps,29,161,Missouri,MO
29067,29CS020,149,144,154,177,23,28,33,951.2024509080869,24,810.2633355840649,-0.2740976351128853,1.4223953370774232,3.155443271661099,0.8226329186233359,182,176,188,229,41,47,53,399.2670042294728,40,341.53005464480873,0.061872878210760186,0.5452009110668313,1.1133093577898607,0.8374832103279531,11848,11712,Douglas+Ozark+Texas+Wright,Douglas,29,67,Missouri,MO
29153,29CS020,122,118,125,140,15,18,22,845.816943423748,11,509.5541401273885,1.687009609625465,3.3557248631011336,5.029024373325883,0.5711593620305678,152,147,156,188,32,36,41,415.9946128758436,39,446.07114262838843,-0.8123939806868745,-0.30423504905550175,0.17900965358106768,1.0436064533332274,8635,8743,Douglas+Ozark+Texas+Wright,Ozark,29,153,Missouri,MO
29215,29CS020,265,255,276,346,70,81,91,1309.8302234799717,19,308.76736816445924,8.231647917785883,10.040487310056152,11.819844934938786,0.23284198787768184,332,319,345,441,96,109,122,438.4741619534415,47,188.73228125125488,2.0118844049875033,2.498680056675674,3.017398591842859,0.42652351718982606,24614,24903,Douglas+Ozark+Texas+Wright,Texas,29,215,Missouri,MO
29229,29CS020,220,212,228,204,-24,-16,-8,-356.36022622889624,27,591.8781169507316,-11.0911611956897,-9.418655474219236,-7.741279832122073,-1.7697650251910702,275,266,285,290,5,15,24,79.00148768894279,43,231.84342481263818,-1.9939892121819807,-1.5285413073590841,-1.0004218717588798,2.747181501373758,18247,18547,Douglas+Ozark+Texas+Wright,Wright,29,229,Missouri,MO
29069,29CS021,354,342,366,455,89,101,113,1426.7346583368833,55,778.0725022104333,4.853498631648265,6.527670146517593,8.125142149992532,0.5399975913452429,426,412,441,519,78,93,107,333.66651757711134,47,169.16210768787792,1.1377289532378911,1.6276700903152788,2.1237597800314214,0.5015692434516842,28275,27784,Dunklin+Pemiscot,Dunklin,29,69,Missouri,MO
29155,29CS021,188,182,195,261,66,73,79,1860.4384250028056,32,821.0917954968247,8.829057051323051,10.429036594876331,12.058663387758983,0.4353389877833916,226,218,234,292,58,66,74,429.3161643221896,27,176.62065807548896,2.033326617596797,2.5182224469739576,3.0237582654280284,0.40522553613391726,15589,15287,Dunklin+Pemiscot,Pemiscot,29,155,Missouri,MO
29071,29CS022,918,873,963,1087,124,169,214,646.1909618115537,134,512.0122271576635,-0.30403497755469205,1.3410680342478332,3.0362558262099655,0.7876966389234846,1132,1078,1186,1329,143,197,251,187.38623720832385,144,136.92898710585374,0.001966966739848571,0.5071667085149556,1.026364803224718,0.7270419006573096,104685,105164,Franklin,Franklin,29,71,Missouri,MO
29073,29CS023,182,176,189,240,51,58,64,1562.0752736594607,37,1004.1386796933307,3.7410973617509424,5.551840123258345,7.32641000905571,0.6318460450009972,223,215,231,247,16,24,32,162.613560913294,42,284.0909090909091,-1.722917717177773,-1.2062782014391216,-0.674997327254907,1.6772634544090865,14739,14784,Gasconade+Montgomery+Warren,Gasconade,29,73,Missouri,MO
29139,29CS023,150,145,155,162,7,12,17,413.80131835327404,15,530.5508886727386,-2.8555530251977195,-1.1659496283350732,0.543390074530797,1.181176974164694,184,179,190,185,-5,1,6,4.42210450167877,17,149.21442991310454,-1.9555061453011384,-1.452253690692786,-0.8989091971989503,11.304616849142539,11309,11393,Gasconade+Montgomery+Warren,Montgomery,29,139,Missouri,MO
29219,29CS023,271,256,287,315,28,44,59,486.3799829628584,18,201.15665074176516,1.2100594505961404,2.81894342012031,4.502603956297399,0.404289994574184,340,321,358,463,105,123,142,339.1592834261037,65,178.57142857142856,1.1229291305330302,1.5805142248461004,2.111114292841682,0.5222814122538088,35793,36400,Gasconade+Montgomery+Warren,Warren,29,219,Missouri,MO
29077,29CS024,2556,2428,2685,2927,242,371,499,497.1576197156435,359,481.1735810238007,-1.6371256850431706,0.198337915958057,1.9618657307335805,0.9652468870600452,3153,2998,3309,3571,262,418,573,138.93075574945036,388,129.07432418945982,-0.4549688640706337,0.09112937918908386,0.6237870088425963,0.9268357962788017,298437,300602,Greene,Greene,29,77,Missouri,MO
29079,29CS025,108,107,109,137,28,29,30,1206.4263784932011,31,1273.6236647493838,-1.0875040683393045,-0.6755909212683681,-0.2589203532312186,1.020931800714114,132,130,133,152,19,20,22,209.82400102834532,26,267.4621952474025,-0.7041507240818257,-0.576604207986838,-0.453434337611254,1.2151241186167068,9736,9721,Grundy and Nearby Counties,Grundy,29,79,Missouri,MO
29115,29CS025,145,140,150,162,12,17,22,583.494033910617,14,472.2948469258666,-0.5809452328947381,1.1588931304797947,2.871309382232013,0.7651852976187633,175,169,181,186,5,11,17,90.95386465656009,38,320.8375548801081,-2.8210810884341875,-2.3072105306835464,-1.793003550878831,3.2278407777334057,11857,11844,Grundy and Nearby Counties,Linn,29,115,Missouri,MO
29117,29CS025,156,149,162,169,7,13,20,368.75715974059796,30,819.5041999590247,-6.138861604239381,-4.528496412783887,-2.916042674488767,2.0690685817991694,190,182,198,220,22,30,38,203.31369623627413,40,271.6099680858287,-1.224824383484145,-0.6725667016972225,-0.13432267265489709,1.2927409217331234,14643,14727,Grundy and Nearby Counties,Livingston,29,117,Missouri,MO
29129,29CS025,37,37,37,59,22,22,22,2483.112654705757,10,1134.1083073433513,13.097045640590661,13.492485771273287,13.880832767127595,0.4367795298994293,45,45,45,52,7,7,7,200.66703555366772,5,143.184421534937,0.4423895118194769,0.5800202191825037,0.6979877785722177,0.6244307625528086,3527,3492,Grundy and Nearby Counties,Mercer,29,129,Missouri,MO
29171,29CS025,59,59,60,59,-1,-0,0,-18.851686206394227,5,427.1678769756515,-4.899606081616067,-4.4598001726468945,-4.050825423675612,6.415676728018063,73,72,73,88,15,15,16,322.00565519143254,6,127.46972594008922,1.8242389826729788,1.9487713918382252,2.083484562753423,0.371360523205714,4682,4707,Grundy and Nearby Counties,Putnam,29,171,Missouri,MO
29211,29CS025,57,57,58,72,14,15,15,974.4594932201933,12,802.1390374331552,1.3213753125345375,1.7022968709085498,2.0963479388480497,0.7703213656008102,70,69,71,86,15,16,17,271.622565765048,11,185.1851851851852,0.7395125943719603,0.8621252239190182,0.9998577249943628,0.6419841125893965,5984,5940,Grundy and Nearby Counties,Sullivan,29,211,Missouri,MO
29091,29CS026,437,419,454,539,85,102,120,1028.460028788245,80,803.5759128120134,0.5052628730011717,2.2226797976013617,3.9895215269487756,0.7737816606699066,535,514,555,638,83,103,124,258.1828405112257,83,207.80131190225828,0.015862576796424964,0.513744921760723,1.0376530775104216,0.7971311717266925,39822,39942,Howell+Oregon+Shannon,Howell,29,91,Missouri,MO
29149,29CS026,115,111,119,140,21,25,29,1121.3592502491958,10,449.64028776978415,5.088081785749531,6.70372905744111,8.432127665977172,0.38551943175241515,138,133,142,179,37,41,46,478.8317926218902,14,162.24359717232588,2.6595135720932985,3.1669419123407776,3.6554272759168938,0.3308253980926918,8896,8629,Howell+Oregon+Shannon,Oregon,29,149,Missouri,MO
29203,29CS026,74,73,74,121,47,47,48,2628.964658224357,13,720.9205600998198,18.668168419756892,19.073261449885997,19.49780157084267,0.26855728128393164,89,88,90,120,30,31,32,435.72881261458593,15,211.35691137100184,2.1192265162180743,2.2397325356377524,2.365400420914062,0.4698707322749669,7213,7097,Howell+Oregon+Shannon,Shannon,29,203,Missouri,MO
29095,29CS027,5534,5226,5842,6353,511,819,1127,458.0834718995702,518,289.6593566822261,-0.18794769998960717,1.7011168556329208,3.228814528064857,0.631557816228782,6804,6434,7174,7829,655,1025,1395,142.97995031216595,862,120.23690296519267,-0.2665235013503242,0.21612877237229333,0.7643795410426624,0.840115822781993,715323,716918,Jackson,Jackson,29,95,Missouri,MO
29097,29CS028,1064,1011,1116,1291,175,227,280,741.7426346761554,175,571.0463200143578,0.06475994893617491,1.6180154515741123,3.4009302408305384,0.7664992049100653,1311,1248,1375,1536,161,225,288,182.6541334159742,214,173.84522900453297,-0.38803350524755026,0.10021864236939929,0.6191336175828633,0.9475584611163339,122582,123098,Jasper,Jasper,29,97,Missouri,MO
29099,29CS029,1817,1720,1915,2088,173,271,368,477.2422709153304,200,352.74301789288955,-0.37435214569604364,1.2766029600008881,2.9575061562984857,0.7364062834266096,2243,2126,2361,2501,140,258,375,113.2722743970223,265,116.40778746134382,-0.542248873887813,-0.029839200618728454,0.4728153043192616,1.0237112097828764,226794,227648,Jefferson,Jefferson,29,99,Missouri,MO
29101,29CS030,355,332,378,420,42,65,88,479.324415345129,46,340.46332617866926,-0.3120130890328841,1.4284171169714572,2.967099670341465,0.6994971948760811,437,409,465,565,100,128,156,236.52589596811126,57,105.30594147206622,0.8220129954492653,1.3064019888897531,1.8526074513899158,0.4417689026222624,54044,54128,Johnson,Johnson,29,101,Missouri,MO
29105,29CS031,380,364,395,408,13,28,44,314.6313275958314,52,577.5692111182072,-4.209307395930957,-2.666390793468294,-0.9897116856406624,1.773107382515306,466,448,485,567,82,101,119,278.91741602278483,74,204.88966414707755,0.22176783074962766,0.7466717684960736,1.2271181734251875,0.7273684958261141,36013,36117,Laclede+Webster,Laclede,29,105,Missouri,MO
29225,29CS031,314,297,331,362,31,48,65,492.2748933230329,50,508.957654723127,-1.8560845717132601,-0.1548353094649657,1.5006355145159895,1.012943687789963,390,370,411,508,97,118,138,296.81301771888525,63,158.88227579945527,0.8657413234730517,1.3837152206311902,1.8856138337809505,0.5307842309502252,39296,39652,Laclede+Webster,Webster,29,225,Missouri,MO
29113,29CS032,447,421,473,480,7,33,59,220.60733957238168,51,340.5846703507688,-2.8844387634348334,-1.229325006672277,0.4601798970330134,1.4984885298913235,559,528,591,606,15,47,78,75.853656869158,54,88.04826349258111,-0.6327782502476245,-0.13099954730472668,0.3727284645493007,1.1363385814883367,59897,61330,Lincoln+Pike,Lincoln,29,113,Missouri,MO
29163,29CS032,167,160,175,204,29,37,44,831.72120364669,23,521.6010885587935,1.3885311351409146,3.1080010968217904,4.707858829241741,0.6104885142461097,205,196,214,212,-2,7,16,38.40282371963983,27,152.20700152207002,-1.6588157978630236,-1.1447928612553495,-0.5860326381339066,3.45609869528427,17638,17739,Lincoln+Pike,Pike,29,163,Missouri,MO
29125,29CS033,84,84,85,125,40,41,41,1914.2429156977555,13,613.7865911237016,12.61163075682842,13.003115195632766,13.394875796866154,0.31292376380959097,103,102,104,133,29,30,31,357.2367899784799,11,130.812224997027,2.139974160206,2.26241314434028,2.4010125057732785,0.35438096756432214,8472,8409,Maries+Osage+Pulaski,Maries,29,125,Missouri,MO
29151,29CS033,111,110,113,119,6,8,9,234.5662225518675,10,300.36795073965607,-1.0677567638760126,-0.6465077151519856,-0.2762091968707215,1.1351644944745,137,136,139,165,26,28,29,207.5738844215623,21,157.18562874251495,0.3739686197181744,0.5009327051171873,0.6231056846312187,0.7308956673991348,13317,13360,Maries+Osage+Pulaski,Osage,29,151,Missouri,MO
29169,29CS033,293,270,316,342,26,49,72,366.34122528813515,39,290.20556227327694,-0.963694307012775,0.7078200430081355,2.616498013595724,0.7764024397078816,365,337,393,459,66,94,122,174.81917083592054,50,92.87120621122628,0.31115418136213485,0.8195246724890886,1.3227903523578683,0.5256565321070189,53755,53838,Maries+Osage+Pulaski,Pulaski,29,169,Missouri,MO
29127,29CS034,295,283,308,310,2,15,27,204.659433716728,39,547.637435933441,-5.274750846762069,-3.3793670860909706,-1.7752421447569262,2.504041527497859,363,348,377,396,19,33,48,117.30691682199533,50,175.37090947353653,-1.0774610346425564,-0.5769207912100442,-0.07923554006589564,1.4515736850009786,28486,28511,Marion+Monroe+Ralls+Shelby,Marion,29,127,Missouri,MO
29137,29CS034,88,87,89,114,25,26,27,1189.7504544061972,16,738.603577611079,4.112753030424187,4.505482882964596,4.913534180233374,0.5976176892961017,108,107,110,122,12,14,15,155.66620277417573,17,195.29006318207925,-0.5219634443507333,-0.3974722601596142,-0.2665494471871269,1.1683252227513827,8665,8705,Marion+Monroe+Ralls+Shelby,Monroe,29,137,Missouri,MO
29173,29CS034,84,83,85,128,43,44,45,1692.0969765494947,14,541.4289857874891,11.090951492686166,11.498144255434623,11.902292459805686,0.3128254112494851,103,102,105,136,31,33,34,314.75819221626136,12,115.83011583011583,1.8564526337494627,1.988475456362512,2.1191589174605885,0.3570477643396945,10343,10360,Marion+Monroe+Ralls+Shelby,Ralls,29,173,Missouri,MO
29205,29CS034,69,68,70,84,14,15,16,989.9832586782073,7,461.8937644341801,4.858694140575943,5.281811477118858,5.691416613456586,0.43741261903060336,83,83,84,88,4,5,5,76.34499805910573,6,100.1001001001001,-0.3574908946876017,-0.23727323642416212,-0.12123368637997733,1.0760171729433456,6062,5994,Marion+Monroe+Ralls+Shelby,Shelby,29,205,Missouri,MO
29133,29CS035,149,144,155,185,30,36,41,1133.1307803150119,24,759.7942223981006,2.02527925782798,3.762268183001445,5.516223686820284,0.6523020953116455,183,176,189,221,32,38,45,306.1195795130708,26,207.36959642686233,0.4957684420036838,1.0004413893863295,1.485148427662288,0.6602122810924724,12635,12538,Mississippi+New Madrid+Scott,Mississippi,29,133,Missouri,MO
29143,29CS035,200,193,207,289,82,89,96,2178.232266458166,37,902.2189709826871,10.998719072204992,12.762755304340725,14.439766417973468,0.4096123611118415,241,233,249,296,47,55,63,340.8655587902787,24,149.27229754944645,1.4157506387293706,1.910647315982774,2.403248672089836,0.4300738875327115,16404,16078,Mississippi+New Madrid+Scott,New Madrid,29,143,Missouri,MO
29201,29CS035,383,367,399,469,70,86,102,905.1817706605873,60,630.7324380436783,1.080813015170689,2.754655639285991,4.4775003212383355,0.6888026493828535,471,451,490,585,95,114,134,301.66116682685384,49,129.40710418592369,1.172166241142589,1.7276494308256998,2.1952173597963913,0.4252586236523485,38051,37865,Mississippi+New Madrid+Scott,Scott,29,201,Missouri,MO
29145,29CS036,565,540,590,642,52,77,102,526.9085476690847,80,545.5909431903431,-1.9025358865445186,-0.17156529103372672,1.381840673170759,1.022225738719362,698,668,729,818,89,120,150,201.73865623299912,115,194.0175121893611,-0.4329569563441592,0.09698984934307403,0.6032278829298636,0.9537509280415768,58652,59273,Newton,Newton,29,145,Missouri,MO
29159,29CS037,396,378,415,492,77,96,114,893.3623707218264,51,475.5466455312602,2.5821628454085293,4.268795064355561,5.792890666103841,0.5268124423219674,488,466,511,514,3,26,48,59.224555894109464,47,108.91479155562766,-1.024473200724412,-0.481843884995056,0.023474808821116952,1.7697667104508563,42898,43153,Pettis+Saline,Pettis,29,159,Missouri,MO
29195,29CS037,219,209,229,255,26,36,46,612.4033527654066,42,722.7671657201859,-2.7301572842753483,-1.156934719718834,0.6883638032819058,1.1479562919490487,269,257,281,325,44,56,68,239.3126218165536,36,154.55286996093247,0.34619952702471046,0.8457898380804209,1.3680650571423951,0.6344384952354535,23244,23293,Pettis+Saline,Saline,29,195,Missouri,MO
29165,29CS038,648,602,694,740,46,92,138,344.17659005306615,67,250.68517496515662,-0.7134952257779623,0.93830118512227,2.69246436985054,0.720529147109217,811,755,867,902,35,91,147,84.34503623860499,96,88.59766508236814,-0.5709094130670113,-0.04651797405075029,0.4518946287355254,1.0390502801519994,106907,108355,Platte,Platte,29,165,Missouri,MO
29041,29CS039,80,79,81,115,34,35,36,1905.1268406930826,17,920.1623815967523,9.467930245470178,9.855206388173631,10.24958110241229,0.46964934765665334,98,97,98,117,19,19,20,264.31235685801573,12,163.04347826086956,0.8895448834439016,1.0124969027087842,1.1348793731923439,0.5866998240404697,7390,7360,Randolph and Nearby Counties,Chariton,29,41,Missouri,MO
29053,29CS039,166,159,173,173,-0,7,14,162.07250112715698,18,419.5559699318221,-4.309671918830176,-2.6014241444049286,-0.8890967516837746,2.2632070922059677,203,194,212,227,15,24,33,138.5255840880599,36,210.39097656478287,-1.2203913955521541,-0.7309476862114447,-0.22438895216015814,1.4573062288523826,17161,17111,Randolph and Nearby Counties,Cooper,29,53,Missouri,MO
29089,29CS039,92,91,93,92,-1,0,1,1.5924584891315372,1,39.51397806974217,-0.7634452998330026,-0.37939239746284603,0.03627595633092895,0.9612601183065145,114,112,115,145,30,31,33,309.69462770738335,14,137.7410468319559,1.5867311331831009,1.7218618164324446,1.8414690190277554,0.4310694944117031,10123,10164,Randolph and Nearby Counties,Howard,29,89,Missouri,MO
29121,29CS039,175,168,181,235,54,60,67,1582.6145643832817,15,395.46533087266016,10.216877781129972,11.902449282922708,13.677495313402451,0.24578652088742914,214,206,222,226,4,12,20,79.90220953040763,17,111.96733188434432,-0.78429139544459,-0.33940486057671154,0.19235167239841133,1.294591788362546,15172,15183,Randolph and Nearby Counties,Macon,29,121,Missouri,MO
29175,29CS039,246,235,256,280,24,34,45,557.4716603184708,41,664.532598565582,-2.7442403843767025,-1.0733530259449366,0.7846093038972828,1.1583685366741132,302,289,315,355,40,53,66,215.0351375475168,38,153.5849971708027,0.08901008236424486,0.617068435988531,1.1560652697571294,0.7010553537416118,24679,24742,Randolph and Nearby Counties,Randolph,29,175,Missouri,MO
29183,29CS040,2589,2415,2764,3221,457,632,806,622.4134425997634,396,390.17661403551983,0.5498591576394852,2.3344956388770015,4.017678431713596,0.625886115623727,3215,3004,3427,3655,228,440,651,107.34389632931129,298,72.78269237344848,-0.19230769450345572,0.348141739253795,0.8624897299236002,0.676493679837313,405970,409438,St. Charles,St. Charles,29,183,Missouri,MO
29186,29CS040,172,164,180,176,-4,4,12,81.27225694091338,10,217.24961981316534,-3.0255947834700554,-1.377832605942923,0.3379721745348717,2.1092765618963356,212,202,222,246,24,34,44,183.27811307912216,26,139.9956924402326,-0.07579528827411117,0.43526110315483973,0.9145847369730824,0.7420427792941472,18412,18572,St. Charles,Ste. Genevieve,29,186,Missouri,MO
29187,29CS040,661,632,690,827,137,166,195,990.02530440032,103,615.1732787839876,2.194958382541497,3.730879164277113,5.457519784350376,0.6176451809565786,813,778,848,1027,179,214,249,317.4299809415694,123,182.36270904993475,0.8763866514929559,1.3510760594227065,1.8817833502440973,0.5718265958255919,66973,67448,St. Charles,St. Francois,29,187,Missouri,MO
29510,29CS042,2506,2377,2635,3132,497,626,755,835.1167202596316,330,440.25241138252596,2.1526855355580126,3.992139629726963,5.728562963259403,0.5263338879680807,3025,2873,3177,3392,215,367,519,124.60034701406279,265,90.0249012273961,-0.15498664226199507,0.33759493036461824,0.8474448654788643,0.7205447045346859,299828,294363,St. Louis (city),St. Louis (city),29,510,Missouri,MO
29189,29CS043,8783,8352,9213,10649,1436,1866,2297,745.6863515157588,1364,544.9602167055876,0.2516257783088739,2.000559427752592,3.7212841081982133,0.7304255843898954,10743,10228,11258,11421,163,678,1193,67.93432146091,933,93.48594354170444,-0.7551034510783672,-0.25441609741810217,0.2433626754238686,1.3740957164258274,1001174,998011,St. Louis (county),St. Louis (county),29,189,Missouri,MO
29001,29CS044,193,182,204,196,-8,3,14,44.928193004106085,11,174.06440382941688,-2.879995527028903,-1.2745458491010822,0.326688892304367,2.8651525161049904,238,225,251,291,40,53,66,209.79780748133302,35,138.92196554735253,0.2355571726926856,0.7031180753963844,1.221303990991664,0.6498756184309508,25278,25194,Scotland and Nearby Counties,Adair,29,1,Missouri,MO
29045,29CS044,66,65,67,82,15,16,17,967.6939780713915,17,1019.7960407918417,-0.8993687112531077,-0.5173776918839567,-0.12680532852929877,0.9923264785907248,81,80,82,102,20,21,22,317.33457899079315,12,178.54485939592323,1.2619815174225817,1.3890425474963346,1.5223530786240311,0.5374404038378123,6668,6721,Scotland and Nearby Counties,Clark,29,45,Missouri,MO
29103,29CS044,36,36,37,45,8,9,9,933.7540449893336,3,318.0492976411344,5.789627440114883,6.145627294101714,6.582624248982114,0.30588413934844266,44,44,45,67,22,23,23,598.9489124022267,6,158.01948907031868,4.28408627493811,4.406739679172902,4.5369713220498875,0.2527157444213247,3773,3797,Scotland and Nearby Counties,Knox,29,103,Missouri,MO
29111,29CS044,101,100,102,109,7,8,9,325.3848048397204,7,280.22417934347476,0.05884633791865029,0.45302589287205064,0.8716239179635915,0.7668617206015172,123,121,124,155,31,32,34,322.60644206955135,14,139.93003498250874,1.7018726964600333,1.8318406260849898,1.9560663294968865,0.42071385217262086,9992,10005,Scotland and Nearby Counties,Lewis,29,111,Missouri,MO
29197,29CS044,39,39,40,51,11,12,12,1160.1828195234502,5,487.8048780487805,6.289906331745875,6.7162331709407805,7.140152138059656,0.3878412121262881,47,46,47,64,17,17,18,432.1576133620799,23,571.8547986076579,-1.520965636738727,-1.3939173947968868,-1.2543296745943364,1.2512662808354176,4100,4022,Scotland and Nearby Counties,Schuyler,29,197,Missouri,MO
29199,29CS044,45,45,45,51,6,6,6,505.97662972599454,6,507.185122569738,-0.44170671948927265,-0.012843268204753663,0.37373661995483987,0.8588970279838515,54,54,55,69,14,15,15,314.2269886137555,11,234.34171282488282,0.673331214633153,0.7967828964031455,0.9246365941812172,0.698420908936727,4732,4694,Scotland and Nearby Counties,Scotland,29,199,Missouri,MO
29209,29CS045,342,329,356,386,30,44,57,558.1771606812275,47,599.9872343141635,-1.9357411142527194,-0.38310710825083855,1.3926190320295244,1.0508709198715989,421,405,437,499,62,78,94,247.2134724293459,66,209.56372642408076,-0.13833671699982103,0.36510980262867376,0.8812971996924396,0.8369536757201747,31334,31494,Stone+Taney,Stone,29,209,Missouri,MO
29213,29CS045,527,502,551,622,71,95,120,680.7398396526113,72,513.6986301369863,-0.15773678316778136,1.638689054645705,3.355791453265013,0.7467911634139117,649,620,678,795,117,146,175,259.520339089916,103,182.84131858768396,0.2876652949456186,0.7529785501308259,1.3049790609255985,0.6997492123710451,56064,56333,Stone+Taney,Taney,29,213,Missouri,MO
29011,29CS046,129,124,134,132,-2,3,8,87.15156056631922,16,550.3955968352253,-6.509892767283565,-4.6887422543297435,-2.9201647327197184,4.52809359577341,157,151,163,168,5,11,17,91.58711289456792,26,223.15681057419965,-1.8216099030055333,-1.3177579304290334,-0.7822247015532583,2.227779384891262,11628,11651,Vernon and Nearby Counties,Barton,29,11,Missouri,MO
29013,29CS046,174,167,181,191,10,17,24,428.123425846864,16,398.13374805598755,-1.4448416789727578,0.2675289309201885,2.069847966205864,0.878869282206847,211,203,219,244,25,33,41,203.98769715143277,42,260.93439363817095,-1.1047352564047455,-0.5804837915687309,-0.06004799868539037,1.2413599964895852,16075,16096,Vernon and Nearby Counties,Bates,29,13,Missouri,MO
29039,29CS046,180,174,186,157,-29,-23,-17,-653.9768715830447,13,365.04036504036503,-11.825807532394785,-10.178781867934475,-8.424520478293985,-0.5832276817331571,221,214,229,236,7,15,22,100.47907309905847,34,235.24527779699716,-1.883576931485657,-1.3397034469005342,-0.8195063143778756,2.190405447097743,14245,14453,Vernon and Nearby Counties,Cedar,29,39,Missouri,MO
29057,29CS046,91,90,92,111,19,20,21,1054.908352901332,28,1477.1828013716697,-4.610899866670695,-4.227000601692842,-3.820657769882682,1.3336008264000068,112,111,113,119,6,7,8,97.70630560988359,10,131.63090693694878,-0.4624608059483345,-0.3430855191396764,-0.20716168385120118,1.1872609694430185,7582,7597,Vernon and Nearby Counties,Dade,29,57,Missouri,MO
29217,29CS046,197,189,206,251,45,54,62,1088.0566741734626,37,748.0414455395502,1.7693613930495509,3.415761933229098,5.066921461520737,0.6749607393351025,238,228,248,340,92,102,112,520.921314033388,44,224.46689113355782,2.4460497535029257,2.9710130477400383,3.4723110271842934,0.426724614413476,19785,19602,Vernon and Nearby Counties,Vernon,29,217,Missouri,MO
30001,30CS001,75,74,76,94,18,19,20,796.1982832603692,4,170.1584600659364,5.819975660469582,6.273388228886579,6.664549758523843,0.20287441454060773,93,92,95,122,27,29,30,301.54993340426057,18,189.43380340980846,0.995067376137518,1.118546584548602,1.2486483566555922,0.6070155893086648,9403,9502,Beaverhead+Gallatin+Madison,Beaverhead,30,1,Montana,MT
30031,30CS001,675,616,734,705,-29,30,89,87.90211327078886,40,117.43981209630064,-2.095430858628789,-0.32090539023368503,1.4837128056363162,1.2928473956684037,853,781,925,876,-49,23,95,16.232818001875422,80,57.27499874710941,-0.9365782590166503,-0.4148391397955974,0.1197282541238397,3.3793040907160123,136240,139677,Beaverhead+Gallatin+Madison,Gallatin,30,31,Montana,MT
30057,30CS001,76,75,77,91,14,15,16,687.1183516057349,5,229.93791676247412,4.152705065738092,4.558029592748921,4.9616877978617655,0.3136489636734087,95,94,96,105,9,10,11,110.34452299321666,14,157.67541389796148,-0.5927413349427205,-0.4744076006073628,-0.34978749615779764,1.296597611586654,8698,8879,Beaverhead+Gallatin+Madison,Madison,30,57,Montana,MT
30013,30CS002,781,745,817,908,91,127,163,604.2843453264078,137,653.0106412135511,-2.3629704234289868,-0.468957036074693,1.171523479392734,1.0721775449772684,961,918,1005,1029,24,68,111,79.9484270556456,114,134.93679276549406,-1.07221290302822,-0.5531371766661659,-0.013472577461255951,1.6631742654143833,83919,84484,Cascade,Cascade,30,13,Montana,MT
30023,30CS003,106,105,107,133,26,27,28,1159.0050139007328,3,127.78191885848152,9.927793146923543,10.304137859055395,10.699247967798593,0.1063432311915343,131,129,132,125,-7,-6,-4,-58.59188851940873,14,147.67932489451476,-2.180968142912292,-2.0654562564700303,-1.9380821919436466,-3.073875527524852,9391,9480,Deer Lodge and Nearby Counties,Deer Lodge,30,23,Montana,MT
30039,30CS003,28,27,28,25,-3,-3,-2,-315.6817039760199,5,603.1363088057901,-9.611111227262962,-9.188454183136614,-8.759515222950313,-3.092143413690658,34,34,34,39,5,5,5,147.95358842339692,4,119.79634621144056,0.1533951704979619,0.2811959937306654,0.41588397762321044,0.6733813655552319,3316,3339,Deer Lodge and Nearby Counties,Granite,30,39,Montana,MT
30077,30CS003,67,67,68,81,13,14,14,784.2615559728356,2,115.45677586953383,6.2869188503430316,6.690911913492364,7.062334571427756,0.1371236992851826,83,82,84,82,-2,-1,-0,-17.236911995477865,14,200.28612303290413,-2.3063883602379827,-2.1746386441464285,-2.0580859532628546,-68.33930417218305,6929,6990,Deer Lodge and Nearby Counties,Powell,30,77,Montana,MT
30081,30CS003,415,395,434,478,44,63,83,569.656777991706,35,314.6845287599182,0.7934461383064537,2.5525549574582396,4.217789536833945,0.5438274336318674,522,498,545,665,120,143,167,313.671316769764,106,231.82573703088093,0.30598601962021094,0.7990963663319015,1.3390620371484734,0.7339547475784308,44489,45724,Deer Lodge and Nearby Counties,Ravalli,30,81,Montana,MT
30093,30CS003,363,348,378,402,24,39,54,441.1527155504688,54,614.4393241167435,-3.418475727315654,-1.74748342154484,0.10997915334540286,1.3577832751707328,447,428,465,536,71,89,108,252.33055627221276,51,144.16553595658073,0.587215825084677,1.086057027506325,1.6361186068728217,0.5650064417760964,35154,35376,Deer Lodge and Nearby Counties,Silver Bow,30,93,Montana,MT
30003,30CS004,134,128,139,197,58,63,69,1934.3995149652947,61,1866.8706962509566,-1.0164205823447712,0.6440048736682512,2.4784328558549933,0.9500595119783275,163,156,169,165,-4,2,9,18.1273443077105,24,185.02813969624546,-2.165396041055889,-1.6911295457865883,-1.177350053817311,7.1614046904638675,13070,12971,Eastern Montana,Big Horn,30,3,Montana,MT
30011,30CS004,16,15,16,17,1,1,2,424.70479896361485,3,863.3093525179855,-4.793104328438169,-4.372782860695739,-3.970361562634435,1.2117054740644106,20,19,20,12,-8,-8,-7,-527.7466307964335,6,420.7573632538569,-9.601221558997251,-9.489085705396697,-9.360544801454974,-0.9194462483652012,1390,1426,Eastern Montana,Carter,30,11,Montana,MT
30017,30CS004,120,119,121,119,-2,-1,0,-26.66989417331403,12,407.05563093622794,-4.733029716465439,-4.319845927629467,-3.9343253480918885,56.13469938779287,148,147,150,158,8,10,11,80.27392085964321,28,235.13604299630504,-1.6698752953333689,-1.547625752294726,-1.4145569804781315,2.651761620712794,11792,11908,Eastern Montana,Custer,30,17,Montana,MT
30019,30CS004,17,17,18,25,7,8,8,1816.2134487367473,6,1446.6546112115732,3.3104238214619093,3.6938532624292724,4.104364061288684,0.7031734575533196,22,22,22,20,-2,-2,-2,-102.44490246383384,4,237.81212841854932,-3.537674846357363,-3.4040813221154576,-3.2782887321324936,-5.531560419019507,1659,1682,Eastern Montana,Daniels,30,19,Montana,MT
30021,30CS004,79,78,80,115,35,36,37,1630.2201204854164,20,901.0023651312085,6.871928276545897,7.299204726352378,7.687257282171494,0.5378250889288196,97,96,98,141,43,44,45,492.32520542241576,22,246.99674413382732,2.326836079883745,2.4516333842958615,2.5772983409019674,0.490508591346246,8879,8907,Eastern Montana,Dawson,30,21,Montana,MT
30025,30CS004,26,26,27,29,2,3,3,343.98415844222677,4,531.738118976404,-2.2920090609224184,-1.8709825460421075,-1.4636732925813158,1.1149450255316036,33,32,33,34,1,1,2,47.26443557520068,4,132.49420337860218,-0.973031887216468,-0.8496692914264437,-0.7214307470771606,1.6481841289892505,3009,3019,Eastern Montana,Fallon,30,25,Montana,MT
30033,30CS004,12,12,12,12,-0,-0,-0,-82.73620936449191,3,1008.4033613445379,-11.348274901611294,-10.930448876980424,-10.50295138144192,3.979519919976224,15,15,15,19,4,4,4,316.1875890770651,5,415.2823920265781,-1.1191684817788454,-0.9929293768125694,-0.8592328466947619,1.0401717291513797,1190,1204,Eastern Montana,Garfield,30,33,Montana,MT
30055,30CS004,17,17,17,13,-4,-4,-4,-875.5323250604449,4,930.7737056428156,-18.445510507811914,-18.07185158148747,-17.64813582434096,-1.4479113003240327,21,20,21,25,4,4,5,256.34816506313985,3,174.41860465116278,0.7050165395664258,0.8206721057110462,0.9519851590586174,0.5546118486689128,1719,1720,Eastern Montana,McCone,30,55,Montana,MT
30071,30CS004,46,46,47,46,-1,-0,0,-28.5930968128093,12,1154.9566891241577,-12.261924154320557,-11.839795480407963,-11.426229180051727,17.071699273353744,57,57,58,67,9,10,10,232.33769087826565,13,310.1145038167939,-0.8976859610829757,-0.7779019613910851,-0.6617218883794003,1.2104738388709213,4156,4192,Eastern Montana,Phillips,30,71,Montana,MT
30075,30CS004,17,17,17,15,-2,-2,-2,-399.7079483958802,2,472.53396337861784,-9.104663111911133,-8.711367165716519,-8.307333131449672,-2.8911598658552196,21,20,21,22,1,1,2,83.46175670935412,1,58.78894767783657,0.12420357804565144,0.24587846899794588,0.37341057653274423,0.41327702334478117,1693,1701,Eastern Montana,Powder River,30,75,Montana,MT
30079,30CS004,15,14,15,18,3,3,4,1171.2460244145789,3,1115.2416356877322,-1.1695324982039048,0.5060683868814269,2.344972033272935,0.7227780455826426,18,18,19,12,-7,-6,-6,-576.5821239144104,5,459.1368227731864,-10.892567663255877,-10.354060326315505,-9.819649676986364,-0.9471527899583266,1076,1089,Eastern Montana,Prairie,30,79,Montana,MT
30083,30CS004,80,79,81,95,14,15,16,536.4185328000989,15,526.454330086865,-0.2918096486655081,0.10163155365432847,0.5169850884158393,0.9211549660726234,98,96,99,128,29,30,32,269.43857428461826,16,141.40521431727794,1.1520292778303343,1.2761142688409481,1.4045094399013145,0.5081466276913601,11397,11315,Eastern Montana,Richland,30,83,Montana,MT
30085,30CS004,123,119,128,167,39,44,48,1609.8866241379974,45,1663.5859519408502,-2.12489323138144,-0.5499858144465972,1.3517213794800673,1.0101592119844192,151,145,156,193,37,42,48,389.48664522736425,22,203.4211742949607,1.3684984549932668,1.8526691483458446,2.397389206699185,0.5101688160790804,10820,10815,Eastern Montana,Roosevelt,30,85,Montana,MT
30087,30CS004,73,72,74,123,49,50,51,2403.5488665380367,35,1671.4422158548234,6.910298517846865,7.3232511204967246,7.7385557385647505,0.6818582972423833,87,86,88,126,38,39,40,479.780887261489,21,257.70033132899744,2.0972023126659862,2.214878621441042,2.3477009897665644,0.5237254551473081,8376,8149,Eastern Montana,Rosebud,30,87,Montana,MT
30091,30CS004,40,39,40,29,-11,-11,-10,-1236.9821963813365,6,687.6790830945558,-19.680478478190732,-19.23969992943368,-18.847465004715325,-0.6127031959842671,49,49,50,61,11,12,12,332.14007442076024,2,56.72149744753262,2.612447599078197,2.7493412104349995,2.8892779955778964,0.15734082644463945,3490,3526,Eastern Montana,Sheridan,30,91,Montana,MT
30103,30CS004,10,10,11,5,-6,-5,-5,-2888.848424420885,5,2659.574468085106,-57.252491359784415,-55.470114682697435,-53.87832579654946,-1.1284045278858685,13,12,13,4,-9,-9,-8,-1157.2721176099503,4,521.5123859191656,-17.34198226590851,-16.783861456007262,-16.24764594511987,-0.5078541457912178,752,767,Eastern Montana,Treasure,30,103,Montana,MT
30105,30CS004,77,76,78,91,13,14,15,756.8646245575361,17,903.5344140313579,-1.8683650557023932,-1.4661935029257427,-1.051304446223,1.11545570822118,94,93,95,102,7,8,9,101.35130987343089,13,172.43666268735907,-0.8448410157148399,-0.7089101602707096,-0.5878415912998541,1.5044772227161813,7526,7539,Eastern Montana,Valley,30,105,Montana,MT
30109,30CS004,13,12,13,19,6,6,7,2644.967066753241,6,2575.107296137339,-1.0304376112794227,0.6960675829251631,2.3549523717984577,0.8376643762926379,16,15,16,20,4,4,5,464.5499708211702,3,321.54340836012864,0.9171310601347827,1.4554860555442493,1.9354149520991037,0.5624032074805239,932,933,Eastern Montana,Wibaux,30,109,Montana,MT
30029,30CS005,815,770,860,941,81,126,171,479.20262194430455,62,236.13200540818463,0.6928958671277784,2.4317383120778526,4.129934693142438,0.48887480062494626,1026,970,1081,1249,168,223,279,206.86134493536403,150,138.99570966576164,0.18511928972231725,0.6883203037635137,1.1975364440549539,0.6689304533356668,105026,107917,Flathead,Flathead,30,29,Montana,MT
30043,30CS006,89,88,90,136,46,47,48,1539.4843506744946,7,229.90393299942525,12.685736926028513,13.094053430346102,13.50173877998549,0.14621883390575252,112,110,113,177,64,65,67,525.645498482747,18,144.9158682875775,3.679309791214497,3.8046056713656116,3.9369257491393825,0.271532417500825,12179,12421,Jefferson+Lewis and Clark,Jefferson,30,43,Montana,MT
30049,30CS006,552,521,583,604,21,52,83,293.23741203789257,49,276.09522467953235,-1.543679033759455,0.15826233103157306,1.8329412404105292,0.9237908431178972,686,648,723,782,59,96,134,133.831167955858,99,137.38932526575815,-0.5457101174267684,-0.054100581740798466,0.48799856132443853,1.0160509050358228,70990,72058,Jefferson+Lewis and Clark,Lewis and Clark,30,49,Montana,MT
30047,30CS007,274,260,287,319,32,45,59,582.1028489111277,23,294.48481162574825,1.1247559215691396,2.834464206132889,4.55919187699421,0.49501021357252606,339,323,356,397,41,58,74,180.1525336756101,62,194.23558897243106,-0.6750800913493025,-0.15252566806960305,0.3823599909864079,1.05974412180408,31241,31920,Lake+Lincoln+Mineral+Sanders,Lake,30,47,Montana,MT
30053,30CS007,210,202,219,239,20,29,37,579.0297516384798,12,241.60668445160314,1.7670937407336496,3.4209499288388043,4.97828605051547,0.4032398956006644,262,252,273,331,58,69,79,336.9043577942768,50,244.9899554118281,0.3684318154126422,0.9295574481561623,1.4424938262800908,0.7167553420998979,19867,20409,Lake+Lincoln+Mineral+Sanders,Lincoln,30,53,Montana,MT
30061,30CS007,50,49,50,54,4,4,5,390.47988724437386,5,437.1584699453552,-0.8779428740916466,-0.46773658768778575,-0.08926984406957228,0.9147266714422159,64,63,64,84,20,20,21,423.48462341517563,13,269.87751712684246,1.409944328658814,1.5315617018901666,1.6630334007937961,0.6074978039762955,4575,4817,Lake+Lincoln+Mineral+Sanders,Mineral,30,61,Montana,MT
30089,30CS007,146,141,152,163,11,17,22,541.8004285223948,14,450.52292839903464,-0.841978558967375,0.8530939914114194,2.795884807105783,0.784909627281556,183,176,190,233,43,50,57,387.27400701722735,39,302.67753201396977,0.3538750567891789,0.842668569265613,1.3147430411553316,0.7662044008196345,12430,12885,Lake+Lincoln+Mineral+Sanders,Sanders,30,89,Montana,MT
30063,30CS008,771,720,822,835,13,64,115,216.4179619464089,56,188.8080648016251,-1.4641477068299562,0.31012486021755886,1.9866494405138315,0.8590402868977597,955,893,1017,1090,73,135,197,113.16156317687056,94,78.76390937122939,-0.1881916100791822,0.34098331703874596,0.8641933737679889,0.6909146547904726,118639,119344,Missoula,Missoula,30,63,Montana,MT
30005,30CS009,60,59,60,89,29,29,30,1688.2240415523431,24,1380.1035077630822,2.6630780314436273,3.0840012491283755,3.5046533403706754,0.7905602863720146,73,72,74,76,2,3,4,38.34257519134272,7,100.2434483746241,-0.7392826972881957,-0.6159184730292414,-0.498165860885694,1.9034866849063088,6956,6983,North Central Montana,Blaine,30,5,Montana,MT
30015,30CS009,51,50,51,64,13,13,14,916.409019638413,1,68.15471119441132,8.056209027221723,8.476409050383067,8.856111543460147,0.06922326006947309,62,62,63,72,9,10,10,162.69642980430908,4,67.63611768684477,0.8258197158084012,0.9507888044054023,1.0661455228046899,0.3765816360945337,5869,5914,North Central Montana,Chouteau,30,15,Montana,MT
30027,30CS009,132,130,133,150,17,18,20,647.7039491947841,15,525.7623554153523,0.795643940480616,1.2214790081656335,1.6111979337737874,0.7700603149071219,163,162,165,172,7,9,10,74.61295904049135,23,198.3784716232534,-1.3636033258354354,-1.2376728766742,-1.113694892615547,2.3832649692479873,11412,11594,North Central Montana,Fergus,30,27,Montana,MT
30035,30CS009,135,129,141,160,19,25,31,722.3450896196555,42,1222.351571594878,-6.540631678535796,-4.984981855724647,-3.280790297553287,1.6266600422467954,165,158,173,183,10,18,25,127.7862770045213,21,152.405834966253,-0.7580978095301641,-0.24615287051524987,0.24918589196560334,1.1285668086889302,13744,13779,North Central Montana,Glacier,30,35,Montana,MT
30041,30CS009,141,134,148,158,10,17,24,408.797405831896,34,835.4834746283327,-5.968246295885695,-4.190095490970691,-2.593424627766142,1.9278736613542427,172,164,181,205,24,33,41,202.71338742222116,29,179.13397986286984,-0.27578275088519516,0.21776582990584503,0.7672556995622465,0.857549995948705,16278,16189,North Central Montana,Hill,30,41,Montana,MT
30045,30CS009,16,16,17,16,-1,-0,-0,-67.58471534610355,8,1584.94304110946,-16.933573050292715,-16.52843923151109,-16.12661333169263,12.14207166146612,20,20,20,24,4,4,4,184.75854043300336,2,98.0392156862745,0.7414515376028075,0.8633887337343498,0.9879877017924144,0.4193686039914638,2019,2040,North Central Montana,Judith Basin,30,45,Montana,MT
30051,30CS009,13,13,13,18,5,5,5,953.001972025037,5,989.6091044037604,-0.7301887817572977,-0.37220023888148257,0.027365162315621673,0.8598389489413976,16,15,16,15,-1,-1,-0,-30.781446393750148,5,256.6735112936345,-3.004214119680319,-2.873532343425493,-2.7514559579204403,12.488216610537721,2021,1948,North Central Montana,Liberty,30,51,Montana,MT
30069,30CS009,7,7,7,3,-4,-4,-4,-2975.2125809464756,3,2400,-55.464137609574145,-53.84120396195646,-52.16233144088277,-1.103340437170382,8,8,9,8,-1,-0,-0,-80.22497287190703,8,1550.3875968992247,-16.814585035146106,-16.315282364057985,-15.754408611194103,13.650965360880024,500,516,North Central Montana,Petroleum,30,69,Montana,MT
30073,30CS009,62,61,62,67,5,5,6,348.01157334795204,1,67.91171477079797,2.392040830699169,2.810861102814799,3.1789317720846144,0.1632794236599912,77,76,78,69,-9,-8,-7,-130.55699753882806,6,100.36801605888257,-2.440148068061568,-2.311011984446958,-2.196732026503149,-0.8817438490101464,5890,5978,North Central Montana,Pondera,30,73,Montana,MT
30099,30CS009,56,56,57,65,8,9,9,564.0479790488623,2,128.39030653185682,3.9756441136471823,4.341109699807796,4.7628524821625815,0.2043640430398289,69,68,70,92,22,23,24,364.0898375614444,14,223.46368715083798,1.2826103784837515,1.4084653965622784,1.5245403710313097,0.587982601844452,6231,6265,North Central Montana,Teton,30,99,Montana,MT
30101,30CS009,45,44,45,48,3,3,4,268.9075802046609,2,162.20600162206003,0.6798574730334467,1.0768030618450937,1.439681057453644,0.46343170869679606,56,55,56,75,19,19,20,389.576270773194,9,179.85611510791367,1.9704162198923378,2.0945958273519114,2.221816398998218,0.4391444247065626,4932,5004,North Central Montana,Toole,30,101,Montana,MT
30007,30CS010,58,57,59,43,-16,-15,-14,-889.5755136392743,9,529.567519858782,-14.584403222499468,-14.193368083748503,-13.783823450270475,-0.6374688980967416,75,74,76,92,16,17,18,231.55981074504595,20,276.85492801771875,-0.5896671661082701,-0.45214351094318295,-0.3289123270508633,1.1281664349287253,6798,7224,South Central Montana,Broadwater,30,7,Montana,MT
30009,30CS010,89,88,90,104,14,15,16,573.0279471060142,7,264.7754137115839,2.6895973727474254,3.0960517263566483,3.4514209256260586,0.43345192873057486,111,109,112,109,-3,-2,-0,-14.745659742240736,18,166.69753658084832,-1.9250599451681536,-1.820163907314631,-1.683489548850575,-30.39327176611883,10575,10798,South Central Montana,Carbon,30,9,Montana,MT
30037,30CS010,11,11,12,12,0,1,1,355.7586200315853,4,1946.4720194647202,-17.526259606683904,-15.92062960504672,-14.193411574800729,2.310690921297766,14,13,14,17,3,3,4,383.54794212783656,4,482.50904704463204,-1.508854106555283,-0.976846786948726,-0.48055703177950654,0.9570265322902853,822,829,South Central Montana,Golden Valley,30,37,Montana,MT
30059,30CS010,20,20,20,18,-2,-2,-2,-454.0450248552196,5,1043.2968179447053,-15.400398397692861,-14.9718235233449,-14.563743610593969,-4.251661700854554,25,25,25,19,-6,-6,-6,-312.3114233340068,3,153.21756894790602,-4.782469868395664,-4.657137325431672,-4.531446086246624,-0.5865036514157171,1917,1958,South Central Montana,Meagher,30,59,Montana,MT
30065,30CS010,51,50,51,60,9,9,10,768.4436791459971,5,421.4963119072708,3.0525496499722373,3.466985699383478,3.8772843696836796,0.4942829677983352,64,63,64,92,28,28,29,580.8959063045812,17,348.7894952810833,2.205184106703224,2.318005167955278,2.4492629608785186,0.5799501053741435,4745,4874,South Central Montana,Musselshell,30,65,Montana,MT
30095,30CS010,71,70,72,95,23,24,25,1060.7501521921752,7,307.35455543358944,7.111417952628887,7.539633020840466,7.9367949771464685,0.27823504696188456,86,85,87,133,46,47,48,523.3446941354134,20,221.26341409447946,2.902643194465198,3.0212351151397705,3.1448477246921116,0.41403472638013694,9110,9039,South Central Montana,Stillwater,30,95,Montana,MT
30097,30CS010,31,31,32,46,14,15,15,1603.9366169165621,4,434.42845506380667,11.293226378149273,11.689403743438643,12.086761213821497,0.25367437180168845,38,38,39,42,3,4,4,96.82594338381031,8,215.34320323014802,-1.307863876204325,-1.1844036502227413,-1.0515120199251737,1.7402336685113042,3683,3715,South Central Montana,Sweet Grass,30,97,Montana,MT
30107,30CS010,23,23,23,32,9,9,9,1770.906724442262,2,382.5920612147298,13.482228317921427,13.887528455763237,14.245997431107844,0.194980901046107,27,27,28,31,3,4,4,176.69053146868183,2,96.89922480620154,0.6694658354383121,0.7995671485920555,0.9198035642361898,0.43039514472987855,2091,2064,South Central Montana,Wheatland,30,107,Montana,MT
30111,30CS011,1375,1304,1445,1579,134,204,275,496.48664988898463,173,420.09409622097434,-0.9111447246885097,0.7577525025306109,2.4278270095248766,0.8420154679544051,1706,1620,1793,1942,149,236,322,141.1763855239488,238,142.6516422920163,-0.5208703893077253,-0.02221577329338756,0.5422548636028396,1.0061779256648797,164725,166840,Yellowstone,Yellowstone,30,111,Montana,MT
31007,31CS001,9,9,10,3,-7,-6,-6,-3737.901950404328,3,1726.618705035971,-56.37729627090159,-54.59655221904319,-53.03119109635652,-0.5459901480082037,12,11,12,4,-8,-8,-7,-1096.375162850835,4,578.8712011577423,-17.28132570596437,-16.764472087255697,-16.267122412567776,-0.6082769113451739,695,691,Banner and Nearby Counties,Banner,31,7,Nebraska,NE
31033,31CS001,84,83,85,107,22,23,24,983.8334245763823,13,552.134211085156,3.94362537095539,4.318926889640516,4.7164267010723835,0.5379824289092009,105,103,106,136,30,31,33,330.518697151218,15,157.52993068683048,1.6105782282975145,1.7272246311136557,1.853746782190422,0.46193657492738605,9418,9522,Banner and Nearby Counties,Cheyenne,31,33,Nebraska,NE
31105,31CS001,47,46,48,56,8,9,10,1047.0935128900776,3,349.75225881667154,5.171883102238388,6.997338167678966,8.661256193718982,0.3005576966235736,57,55,59,50,-9,-7,-5,-209.9876581168972,6,175.95307917888562,-4.398257450407258,-3.8516125185276087,-3.3917581328091018,-0.9739344080985809,3431,3410,Banner and Nearby Counties,Kimball,31,105,Nebraska,NE
31123,31CS001,49,48,49,69,20,20,21,1785.4090352331557,12,1053.7870472008783,6.927713994006413,7.31640643085236,7.743286794283235,0.5625524213933063,60,59,61,73,12,13,14,283.13232302840925,14,306.4127817903261,-0.3615633093679195,-0.23393465560280455,-0.10752076820755514,1.0045696553929266,4555,4569,Banner and Nearby Counties,Morrill,31,123,Nebraska,NE
31157,31CS001,364,349,380,460,80,96,111,1068.3010681508113,96,1069.2209166341815,-1.779470164639732,-0.04554534684685226,1.6754150083800656,0.9905340909272007,444,426,463,465,2,21,39,57.78529378285289,48,134.14565982896428,-1.3046011134048991,-0.7668836080550265,-0.23462120598456024,2.2143557417610644,35914,35782,Banner and Nearby Counties,Scotts Bluff,31,157,Nebraska,NE
31019,31CS002,316,294,337,385,48,69,91,552.695569644373,58,463.01840098990135,-0.9009397809303413,0.9006742487728251,2.644753955584086,0.8258177918611082,391,365,417,424,7,33,59,65.84800064411502,35,69.571439930031,-0.5256986571757812,-0.036103096440258754,0.4364768006567559,1.0255865631914685,50106,50308,Buffalo+Kearney+Sherman,Buffalo,31,19,Nebraska,NE
31099,31CS002,64,63,65,61,-4,-3,-2,-180.5110795363533,3,179.64071856287424,-4.011528055416764,-3.6003009572851377,-3.203451900723788,-1.4891773823339707,78,77,79,63,-16,-15,-14,-226.25903947174172,5,74.8839299086416,-3.1322783107899403,-3.0165244771693702,-2.885592192048943,-0.35442602808181956,6680,6677,Buffalo+Kearney+Sherman,Kearney,31,99,Nebraska,NE
31163,31CS002,34,33,34,43,9,9,10,1250.3003718438013,1,135.08949679162447,10.740292524791123,11.151665048469013,11.55786849594595,0.0975100943423848,41,41,42,39,-3,-2,-2,-74.07174771867365,5,168.74789065136687,-2.5463007319126243,-2.4306481244090055,-2.30790921359944,-4.184990350814644,2961,2963,Buffalo+Kearney+Sherman,Sherman,31,163,Nebraska,NE
31021,31CS003,81,80,81,94,13,13,14,800.2884385567199,11,657.9931209810079,1.0586613174810091,1.4280077001757214,1.8223775686842716,0.7650139922274469,99,98,100,72,-28,-27,-26,-404.5414123368101,5,74.5045447772314,-4.9105527767469725,-4.788383678103026,-4.66743468992921,-0.1912135523146819,6687,6711,Burt+Dakota+Thurston+Washington,Burt,31,21,Nebraska,NE
31043,31CS003,155,146,165,210,45,55,64,1026.8011141961404,68,1278.7964268923367,-4.136180378890151,-2.5011570298379797,-0.8104784262141953,1.2230182997791972,190,179,201,157,-44,-33,-22,-154.32903227207385,11,51.69415856008271,-2.581808421759981,-2.067410921126868,-1.5267129630621263,-0.3454809157751116,21270,21279,Burt+Dakota+Thurston+Washington,Dakota,31,43,Nebraska,NE
31173,31CS003,67,66,68,84,16,17,18,992.1567945171822,10,586.4242779651078,3.6692887933873966,4.066977675584151,4.450748761339522,0.5580745260487485,80,79,81,104,23,24,25,358.76264609153793,18,271.00271002710025,0.7510266217491386,0.8720453510880823,0.9963129977208923,0.7249582810185218,6821,6642,Burt+Dakota+Thurston+Washington,Thurston,31,173,Nebraska,NE
31177,31CS003,163,154,172,177,5,14,23,260.619301425588,19,364.0021073806217,-2.672395067709767,-1.010658120382033,0.695996451461926,1.3010422867505178,201,190,211,201,-10,0,11,2.0112615832738023,17,81.10687022900763,-1.2948310962598237,-0.7806942472314142,-0.276530240810452,11.958689667284203,20879,20960,Burt+Dakota+Thurston+Washington,Washington,31,177,Nebraska,NE
31027,31CS004,86,85,87,95,8,9,10,442.39481684681954,20,955.223880597015,-5.534255628779385,-5.115151059892094,-4.713981861164782,1.9488160083736317,104,103,105,87,-18,-17,-16,-208.6465094382655,12,143.95393474088291,-3.648674284411838,-3.527725311099018,-3.395024333108298,-0.7320299000297735,8375,8336,Cuming and Nearby Counties,Cedar,31,27,Nebraska,NE
31037,31CS004,66,65,67,65,-2,-1,0,-35.64708953253149,21,795.4545454545454,-8.693201338602204,-8.312166254661332,-7.919174825529762,356.43461706592075,81,79,82,65,-17,-16,-14,-147.90471650743524,4,38.07710613993336,-1.9918081684929707,-1.858678256219284,-1.7313458897094907,-0.2751525460157752,10560,10505,Cuming and Nearby Counties,Colfax,31,37,Nebraska,NE
31039,31CS004,81,80,82,104,22,23,24,1012.7146758425092,12,534.5806882726362,4.38666799374802,4.78235664927213,5.20418796176423,0.5056269392122087,100,98,101,121,20,21,23,238.21614527653745,5,55.62972852692479,1.7033300339779096,1.8241205329658028,1.952546478303038,0.22310604803164988,8979,8988,Cuming and Nearby Counties,Cuming,31,39,Nebraska,NE
31051,31CS004,51,51,52,64,12,13,13,902.5409909731474,14,1002.6857654431512,-1.4151119491046065,-0.9940701697980633,-0.58986627476697,1.0292809410955177,63,62,63,64,1,1,2,26.522695515823287,4,72.07207207207207,-0.5837302510319029,-0.4543936143420761,-0.3306741652541707,1.6181166926594674,5585,5550,Cuming and Nearby Counties,Dixon,31,51,Nebraska,NE
31167,31CS004,37,36,37,55,18,18,19,1245.620602106869,6,411.0292858366158,7.92915510935484,8.35252138385037,8.754667317009059,0.31277780632742413,45,44,46,43,-3,-2,-1,-34.899003484259545,4,68.7639676809352,-1.162334967741775,-1.0360001398950207,-0.912910293887123,-3.8832122642516715,5839,5817,Cuming and Nearby Counties,Stanton,31,167,Nebraska,NE
31179,31CS004,61,60,62,67,5,6,7,234.17422341379051,3,124.26219322771047,0.7276353991507541,1.0972174132550427,1.4816277458116875,0.4508870398509321,76,75,77,72,-5,-4,-3,-42.842437234879526,2,20.470829068577277,-0.7584629018867715,-0.6313245866793251,-0.5015849443020823,-0.6278043002131046,9657,9770,Cuming and Nearby Counties,Wayne,31,179,Nebraska,NE
31053,31CS005,380,364,396,451,55,71,87,771.0039943463711,57,616.1163054639788,-0.11363757660156869,1.5305747596870125,3.2829525476284447,0.7880609099864812,462,443,481,488,7,26,45,69.63253093169838,41,110.50319381182113,-0.9200638656886363,-0.407765937668807,0.10889364830511633,1.5278122598200643,37006,37103,Dodge+Saunders,Dodge,31,53,Nebraska,NE
31155,31CS005,196,186,205,234,29,38,48,687.3879124819193,18,323.0292969626273,1.7775568491479998,3.6641998464271155,5.51303666137445,0.45798062201044476,242,231,254,252,-2,10,21,42.37945926965096,23,101.2101210121012,-1.0792881759937185,-0.5801466545644254,-0.05577715825238152,2.1635386671847177,22289,22725,Dodge+Saunders,Saunders,31,155,Nebraska,NE
31055,31CS006,3658,3407,3910,4168,258,510,761,349.60773522170945,488,334.85091243442787,-1.5648142293632494,0.12199689473467253,1.716013588355394,0.955914183878438,4520,4218,4822,4695,-127,175,477,29.956728089625805,384,65.6401279982496,-0.9066970683049459,-0.37084561713432623,0.16962701234126734,2.1787326029872665,582946,585008,Douglas,Douglas,31,55,Nebraska,NE
31029,31CS007,44,44,45,46,1,2,2,177.49121616803453,7,722.0216606498195,-5.858695011803471,-5.435157432534218,-5.0365832623345534,2.5727941405424724,54,53,54,60,6,6,7,157.59932127427837,5,130.41210224308816,0.15049759020111841,0.27109133791315765,0.3970390094497913,0.7099894688489456,3878,3834,Frontier and Nearby Counties,Chase,31,29,Nebraska,NE
31047,31CS007,191,181,201,228,27,37,47,620.1919494761609,36,601.1020203706796,-1.6278457499977466,0.18031530757123868,1.9230186921814514,0.9438093692185396,235,223,248,241,-7,6,18,24.061653184915087,29,121.24252686149086,-1.5052414383807307,-0.9857489029009535,-0.4852453241551795,4.292921217344234,23956,23919,Frontier and Nearby Counties,Dawson,31,47,Nebraska,NE
31057,31CS007,20,20,21,20,-1,-0,-0,-114.70820384431418,3,726.8322228952151,-8.777964323785405,-8.421416618963809,-8.026825716506702,5.6975523975706315,25,25,25,25,-0,0,0,0.8972289376160668,3,183.26206475259622,-1.954069845216983,-1.8192760229906713,-1.695555723052422,2.9565748990242735,1651,1637,Frontier and Nearby Counties,Dundy,31,57,Nebraska,NE
31063,31CS007,17,17,17,19,2,2,2,296.89995448929915,1,157.9778830963665,0.9744759674043113,1.3905548968272592,1.7729460115718698,0.34729738413913175,21,21,22,32,10,11,11,414.8085372334658,7,274.72527472527474,1.2774328774560153,1.398187421957489,1.5303698436454258,0.6050484449437973,2532,2548,Frontier and Nearby Counties,Frontier,31,63,Nebraska,NE
31073,31CS007,20,20,20,29,9,9,9,1941.892520548786,4,843.4370057986295,10.576291805672314,10.989636952796294,11.370669816664662,0.3917948259383615,24,23,24,22,-2,-2,-1,-88.0082386981785,9,490.73064340239915,-5.904953116577188,-5.786660901250947,-5.660565618224131,-14.656283341373658,1897,1834,Frontier and Nearby Counties,Gosper,31,73,Nebraska,NE
31085,31CS007,8,8,8,5,-3,-3,-3,-1435.1859831237564,5,2320.185614849188,-37.982094858869175,-37.56154049547901,-37.159169711392416,-2.3891142851997564,10,10,10,2,-8,-8,-8,-923.6179101579985,2,236.68639053254438,-11.72554671113547,-11.604544455039585,-11.471218907228554,-0.2939200575351086,862,845,Frontier and Nearby Counties,Hayes,31,85,Nebraska,NE
31087,31CS007,31,31,32,44,12,13,13,1909.0198816171348,4,608.5964244960061,12.604023397143944,12.999848065548262,13.419158689951722,0.2952676020819503,38,38,38,45,7,7,7,264.071322776722,6,231.66023166023166,0.19505931978466703,0.323545914115877,0.4577389027444856,0.7653600822953234,2629,2590,Frontier and Nearby Counties,Hitchcock,31,87,Nebraska,NE
31145,31CS007,114,113,115,119,4,5,6,188.43214497023564,4,149.91099034948,-0.006474977644818831,0.38149305034348796,0.7723540784823034,0.6635875421491496,140,139,141,171,30,31,32,291.21496655457344,12,112.88805268109125,1.658011755668905,1.7794166890113225,1.9080379882664786,0.37551456121066473,10673,10630,Frontier and Nearby Counties,Red Willow,31,145,Nebraska,NE
31079,31CS008,488,462,515,549,34,61,87,387.98669637798497,111,710.7866679473634,-4.948214544556624,-3.1858006377994137,-1.4071497053941975,1.8022423077984264,594,562,626,625,-1,31,63,49.2276036086722,53,85.36133614649938,-0.8367698524081085,-0.35373385306094485,0.1255676409318667,1.6790788183388272,62466,62089,Hall,Hall,31,79,Nebraska,NE
31093,31CS009,64,63,65,70,5,6,7,371.3050945407028,14,862.9989212513484,-5.325220952933918,-4.916595130133339,-4.52513266608734,1.9933090605623223,79,79,80,93,13,14,14,208.04010898504802,6,91.93993257738278,1.038524962061262,1.160433356049229,1.2781958311345631,0.4116158680600105,6489,6526,Howard+Merrick+Nance+Platte,Howard,31,93,Nebraska,NE
31121,31CS009,73,72,74,90,16,17,18,893.8013489405784,17,885.0709358323572,-0.2928183276746383,0.0838272717802031,0.4500915297053013,0.9357271371477862,90,89,91,95,4,5,6,68.63195796492997,4,52.192066805845506,0.045437456148437146,0.1663228643014781,0.2983475832113713,0.6389824068753152,7683,7664,Howard+Merrick+Nance+Platte,Merrick,31,121,Nebraska,NE
31125,31CS009,44,44,45,52,7,8,8,903.3138306020202,3,353.2528701795702,5.115691176106023,5.499180569776083,5.907224785094706,0.3459651870904305,54,54,55,49,-6,-5,-5,-158.94140396443194,4,118.02891708468574,-2.886257769897745,-2.766608497677135,-2.639449571619949,-0.9118837228606471,3397,3389,Howard+Merrick+Nance+Platte,Nance,31,125,Nebraska,NE
31141,31CS009,264,249,278,305,27,41,56,482.98951427514356,51,597.3645680819913,-2.8324305505561167,-1.165673225239663,0.5376476655189407,1.2075227307666423,326,309,344,344,-0,18,35,51.39730242616922,32,93.43884135836716,-0.9266706892490852,-0.41527287964849136,0.06702818044851463,1.7202419757704843,34150,34247,Howard+Merrick+Nance+Platte,Platte,31,141,Nebraska,NE
31109,31CS010,1974,1835,2113,2179,66,205,344,254.32191008503082,148,183.6114384963712,-0.946548742066784,0.6889724345785081,2.420109654760129,0.7184599401015719,2451,2284,2619,2552,-67,101,268,31.068980304714703,179,55.199210558776365,-0.7431128060601226,-0.2569392592041016,0.2966307038184185,1.759205298912295,322420,324280,Lancaster,Lancaster,31,109,Nebraska,NE
31049,31CS011,20,19,20,18,-2,-2,-1,-364.5923566946111,7,1529.2190060076462,-19.353253181720675,-18.931229392519512,-18.547693689999484,-10.464605886298097,24,24,25,35,10,11,11,564.8761723216971,3,161.29032258064515,3.9049455225581062,4.034557239374515,4.164201185690059,0.26071774122427144,1831,1860,Lincoln and Nearby Counties,Deuel,31,49,Nebraska,NE
31101,31CS011,82,81,83,78,-5,-4,-3,-188.21089480796627,1,48.344210780759006,-2.7790502559438175,-2.3538362675745463,-1.95385334389412,-0.3456449340813353,101,100,102,132,30,31,32,378.95094313036157,15,181.05009052504525,1.8491504981043787,1.9835359508311992,2.0953468372950916,0.46301890195780365,8274,8285,Lincoln and Nearby Counties,Keith,31,101,Nebraska,NE
31111,31CS011,316,301,331,406,75,90,105,1040.4690367981489,55,636.7214633016903,2.315682235219629,4.046024699004213,5.725452919167083,0.6052221955969629,383,366,401,501,100,118,135,344.19379702386686,60,175.4693805930865,1.1777747713247169,1.6982741389090763,2.1953866761392513,0.5055031305352288,34552,34194,Lincoln and Nearby Counties,Lincoln,31,111,Nebraska,NE
31113,31CS011,9,9,9,12,3,3,3,1622.7345309347916,6,3351.95530726257,-19.07008538318546,-17.350642198412746,-15.638267783576694,1.5366117690069658,11,10,11,6,-5,-5,-4,-683.3122070021251,6,868.3068017366137,-16.002543724277096,-15.52066418754887,-15.013185246429739,-1.6121719626394257,716,691,Lincoln and Nearby Counties,Logan,31,113,Nebraska,NE
31117,31CS011,5,5,5,2,-3,-3,-3,-3063.2101340425843,2,1960.7843137254902,-51.93501957520726,-50.237030315175375,-48.67809263356353,-0.9414093479164299,6,6,6,8,2,2,2,545.9904942484042,8,2099.737532808399,-16.078972496071138,-15.526727293186074,-14.9980507965618,2.597213892032191,408,381,Lincoln and Nearby Counties,McPherson,31,117,Nebraska,NE
31135,31CS011,29,29,29,28,-1,-1,-1,-116.35582143690283,11,1541.6958654519972,-16.993472098210226,-16.581101728312163,-16.198872384908423,64.78163340404636,35,35,35,36,1,1,1,30.857078515168773,3,105.82010582010582,-0.8816811050619345,-0.7501682898401294,-0.6241583496187509,1.6001722417677244,2854,2835,Lincoln and Nearby Counties,Perkins,31,135,Nebraska,NE
31005,31CS012,6,6,6,8,2,2,2,1704.2477790823966,8,7322.654462242563,-57.97635233946163,-56.1852282155159,-54.367482764525114,2.7953548344039367,8,7,8,6,-2,-2,-1,-345.70724200418,6,1369.86301369863,-17.677574309793567,-17.157235179553705,-16.608855078239355,-11.668663175428147,437,438,Northwest Nebraska,Arthur,31,5,Nebraska,NE
31009,31CS012,6,6,6,4,-2,-2,-2,-1974.3006325991787,4,3652.9680365296804,-57.97499471403046,-56.26053199238392,-54.68429131131629,-3.4427579737248353,8,8,8,3,-5,-5,-5,-1058.048471044154,3,656.4551422319474,-17.678818077434638,-17.142628029338262,-16.668286263871405,-0.7822111597513741,438,457,Northwest Nebraska,Blaine,31,9,Nebraska,NE
31013,31CS012,98,97,99,112,13,14,15,512.3138593202888,5,185.2537977028529,2.8889669326576226,3.266726154337346,3.682959207423574,0.3372146500569837,117,116,119,130,11,13,14,117.92395137567675,15,141.03046257991727,-0.35795617203745694,-0.2356631305759319,-0.1025890618420623,1.1076330229482112,10796,10636,Northwest Nebraska,Box Butte,31,13,Nebraska,NE
31017,31CS012,30,30,30,40,10,10,10,1355.7017514982292,7,961.2083762444216,3.568393237878334,3.9522184493526424,4.346373532465299,0.6438025995090686,37,36,37,50,13,13,14,463.5564348919414,4,137.59889920880633,3.1361048602905526,3.2596814632429982,3.3838558567893715,0.27632733631274486,2913,2907,Northwest Nebraska,Brown,31,17,Nebraska,NE
31031,31CS012,52,51,52,70,18,18,19,1341.554135380037,10,726.6121707538601,5.7233750490957345,6.142790626878003,6.552918682493981,0.5137917428857521,62,61,63,79,16,17,18,310.2258996928291,10,183.18373328448433,1.147580264029541,1.2688154650769574,1.3872791628964727,0.5575617909876665,5505,5459,Northwest Nebraska,Cherry,31,31,Nebraska,NE
31041,31CS012,100,99,101,126,25,26,27,991.0732416971069,15,569.5301376364499,3.7712825442022155,4.204430218397266,4.613584627816134,0.5534566939685117,121,119,122,144,22,23,25,224.42916126191744,14,133.7792642140468,0.780552337324437,0.9027355310087752,1.0443219907191255,0.571743340032405,10535,10465,Northwest Nebraska,Custer,31,41,Nebraska,NE
31045,31CS012,70,70,71,90,19,20,20,950.1273865709701,16,779.537149817296,1.311142709781296,1.699650594802008,2.142669801957127,0.7804358541425077,85,84,86,107,21,22,23,270.4593854347983,4,49.09180166912125,2.0866484132687475,2.2107581329988863,2.340407479543396,0.17363348808749401,8210,8148,Northwest Nebraska,Dawes,31,45,Nebraska,NE
31069,31CS012,26,26,27,24,-3,-2,-2,-518.5414460622501,2,427.80748663101605,-11.105552056190238,-9.470886591475294,-7.720765828460807,-1.4043156272966981,32,31,33,36,3,4,5,227.14168230053843,6,323.97408207343415,-1.5186595511764929,-0.974478967438296,-0.4620747514755891,1.1523693578972825,1870,1852,Northwest Nebraska,Garden,31,69,Nebraska,NE
31075,31CS012,9,9,9,14,5,5,5,3267.947967067616,4,2618.657937806874,6.0824290990301435,6.490612236569107,6.9061892074893105,0.667580080920968,10,10,11,7,-4,-3,-3,-593.0719679811766,7,1198.6301369863013,-18.046784362259164,-17.91665050178303,-17.788396929324925,-2.8414392165053917,611,584,Northwest Nebraska,Grant,31,75,Nebraska,NE
31091,31CS012,13,13,13,10,-3,-3,-3,-1741.574011523633,2,1136.3636363636365,-29.18892809637209,-28.781500286149484,-28.372261537189413,-0.9684431537994802,16,16,17,15,-2,-1,-1,-200.5377903659875,7,958.9041095890411,-11.717463968458798,-11.598364799131211,-11.464620347529987,-15.088617508985786,704,730,Northwest Nebraska,Hooker,31,91,Nebraska,NE
31103,31CS012,11,11,11,6,-5,-5,-5,-2512.721604520409,6,3120.936280884265,-58.1922235505157,-56.41750720701237,-54.60171128379483,-1.5662903881951888,13,13,14,3,-11,-10,-10,-1332.39454520402,3,382.65306122448976,-17.672525114791252,-17.158543111837727,-16.614198232679676,-0.3175956490195063,769,784,Northwest Nebraska,Keya Paha,31,103,Nebraska,NE
31115,31CS012,10,10,10,8,-2,-2,-2,-1336.5799343599583,8,5211.726384364821,-65.89043838058846,-65.47489361412379,-65.07534648605642,-7.607092173578344,12,12,12,1,-11,-11,-11,-1826.3970119563694,1,165.56291390728478,-20.052464660909116,-19.92243377310368,-19.796716799357053,-0.09968660572525871,614,604,Northwest Nebraska,Loup,31,115,Nebraska,NE
31149,31CS012,18,17,19,15,-4,-3,-2,-932.8584538880332,6,1872.07488299532,-29.85463229768243,-28.067527581406466,-26.31667213960707,-3.0153612381132535,22,21,22,24,2,2,3,181.78113143773368,3,237.34177215189874,-1.0441973867699808,-0.5561516897730577,-0.08278976450767621,0.9097212352592167,1282,1264,Northwest Nebraska,Rock,31,149,Nebraska,NE
31161,31CS012,62,62,63,86,23,24,24,1844.786567885981,16,1250.9773260359657,5.533745075194881,5.937549805001496,6.356306461152218,0.6505434830492529,76,75,76,71,-5,-5,-4,-88.45520747303354,13,255.15210991167814,-3.5608826740765984,-3.437623996977248,-3.3087887294386493,-3.707090970151968,5116,5095,Northwest Nebraska,Sheridan,31,161,Nebraska,NE
31165,31CS012,9,9,9,10,1,1,1,477.5221906888027,6,2094.2408376963353,-16.565041350284574,-16.168875108445267,-15.783758588734477,2.5336756357187515,10,10,11,13,2,3,3,222.8026447867582,8,699.912510936133,-4.898072282615678,-4.77003288330638,-4.641732742599241,2.25565972733451,1146,1143,Northwest Nebraska,Sioux,31,165,Nebraska,NE
31171,31CS012,10,9,10,7,-3,-3,-2,-1490.8522719666787,7,4123.711340206186,-57.803296371449875,-56.13721117623685,-54.37833495543118,-4.573006220009101,12,11,12,6,-6,-6,-5,-824.0495587078261,6,891.5304606240712,-17.67812823378444,-17.172977126832468,-16.65027923839175,-1.3198841450272523,679,673,Northwest Nebraska,Thomas,31,171,Nebraska,NE
31059,31CS013,69,68,69,71,2,2,3,176.52559588744876,13,936.4307581487484,-8.007577398214043,-7.600697842215241,-7.184789605305432,3.76744262369227,84,83,85,82,-3,-2,-1,-37.91266993027085,2,36.04253018561903,-0.8629990034150119,-0.7429336051866955,-0.623502599143716,-1.8119650411890664,5553,5549,Saline and Nearby Counties,Fillmore,31,59,Nebraska,NE
31067,31CS013,234,225,243,252,9,18,27,335.9161780654086,25,462.10720887245844,-3.010753450660953,-1.2526093237460638,0.5155484998190528,1.3039125301951915,286,274,297,330,33,44,56,205.1525323338355,30,138.74115525135272,0.16074279180877143,0.6399764717989722,1.1808920819183406,0.6613737357728307,21640,21623,Saline and Nearby Counties,Gage,31,67,Nebraska,NE
31095,31CS013,91,90,92,96,4,5,6,275.443896281046,3,166.29711751662973,0.7054945206641601,1.1006066702612791,1.5099249499643639,0.5025960856198155,111,110,112,123,11,12,13,162.71141698440402,10,139.12075681691707,0.10554033770193216,0.23437274321045576,0.3640441690990789,0.7876684732982998,7216,7188,Saline and Nearby Counties,Jefferson,31,95,Nebraska,NE
31129,31CS013,52,51,52,70,18,18,19,1787.062289486006,12,1173.881144534116,5.72694155517316,6.128813930739179,6.575830697770169,0.6227863754291089,63,63,64,62,-2,-1,-1,-26.881709855291522,5,123.06177701206006,-1.6294128769330412,-1.4966612821677425,-1.384913936528509,-54.227657938543274,4089,4063,Saline and Nearby Counties,Nuckolls,31,129,Nebraska,NE
31151,31CS013,125,124,127,102,-25,-23,-22,-650.9808182925248,2,56.19950825430278,-7.490748073038699,-7.054372213240147,-6.683541376623485,-0.09022510313362479,154,152,156,133,-23,-21,-19,-146.96289919247204,8,56.33802816901409,-2.1490706278888205,-2.030690872370105,-1.9037494671301936,-0.40264271150766784,14235,14200,Saline and Nearby Counties,Saline,31,151,Nebraska,NE
31169,31CS013,67,66,67,65,-2,-2,-1,-155.73294711632735,3,240.14408645187112,-4.361154853606193,-3.9581379343235783,-3.5342055426751235,-3.1729450443884097,81,80,82,95,13,14,15,284.3729873712572,8,162.33766233766235,1.085451942046411,1.2165192577142583,1.3467023619596528,0.5328395396479789,4997,4928,Saline and Nearby Counties,Thayer,31,169,Nebraska,NE
31153,31CS014,916,834,998,1136,138,220,302,461.92096876434897,116,243.2656313896549,0.3738383735364154,2.2117266135584095,3.7912207361629253,0.5242589428826425,1155,1055,1254,1298,44,143,243,74.2967902403145,105,54.38104017981997,-0.34245731193984036,0.18688012167343762,0.7162372972842429,0.7268763573442995,190738,193082,Sarpy,Sarpy,31,153,Nebraska,NE
31001,31CS015,265,252,278,337,59,72,85,925.2904859279097,47,603.3763399447975,1.474679047669436,3.2116936295285097,4.946023223472935,0.6431703984990845,323,307,339,364,25,41,57,131.733750642803,32,103.07950006442469,-0.2347207809871801,0.27558410919409726,0.8144971418946467,0.7638065392641028,31158,31044,South Central Nebraska,Adams,31,1,Nebraska,NE
31035,31CS015,58,57,59,74,15,16,17,1039.0176463642313,12,784.8266841072597,2.1225982320285772,2.5439498857558247,2.9609619367723865,0.7106234733706402,70,70,71,83,12,13,13,207.78221244615457,11,180.8913007728992,0.15300381206131694,0.27073892312826264,0.39618941925702655,0.8067333580906021,6116,6081,South Central Nebraska,Clay,31,35,Nebraska,NE
31061,31CS015,32,32,33,40,7,8,8,1065.175161017947,6,828.7292817679557,1.9779316991532565,2.358573059083223,2.7490658663525096,0.6887156561407554,39,39,40,65,25,26,26,883.6352751760363,7,241.3793103448276,6.2801231596113665,6.422247743415395,6.544971604713529,0.2629066214358553,2896,2900,South Central Nebraska,Franklin,31,61,Nebraska,NE
31065,31CS015,52,52,52,57,5,5,5,432.64672325281333,7,605.4054054054054,-2.1130514602568793,-1.738010987455311,-1.323730895224008,1.1661850832263843,63,62,64,79,15,16,17,346.4458308911667,10,217.10811984368218,1.1792098376398155,1.2928860533717994,1.4226267034246591,0.5897166981639425,4625,4606,South Central Nebraska,Furnas,31,65,Nebraska,NE
31083,31CS015,32,32,32,37,5,5,5,656.8079732190715,3,386.59793814432993,2.3072019584691286,2.7070785308018,3.0775944787242357,0.49205899834749917,39,38,39,62,23,23,24,757.8911008041829,2,64.80881399870383,6.812875189337185,6.928736373526792,7.062375341746751,0.08200579828528534,3104,3086,South Central Nebraska,Harlan,31,83,Nebraska,NE
31137,31CS015,94,93,95,98,3,4,5,181.73230492306635,12,535.236396074933,-3.937671546326408,-3.5356180788560447,-3.1329317552694684,2.364793765620897,114,113,115,141,26,27,28,301.72128367877775,11,123.01498546186535,1.653331756119226,1.787874334583633,1.9238049713165237,0.3931391192710621,8968,8942,South Central Nebraska,Phelps,31,137,Nebraska,NE
31181,31CS015,48,48,48,54,6,6,6,699.1212377310428,7,823.2872684504557,-1.6344164853757939,-1.2442426704286946,-0.8385797119540769,1.008024113319417,59,58,59,63,4,4,5,128.8431329656881,7,205.39906103286387,-0.8884784157898445,-0.76503401302536,-0.6505022478380583,1.2984666661431514,3401,3408,South Central Nebraska,Webster,31,181,Nebraska,NE
31025,31CS016,202,190,213,266,53,64,76,965.6865805672411,17,255.8507035894349,5.316615920900343,7.110272832250394,8.902774407432439,0.26087605771206956,250,236,264,267,3,17,31,62.59862836469426,22,81.61751066592468,-0.680019992711376,-0.1776033471888755,0.30195928735976335,1.230875256421733,26578,26955,Southeast Nebraska,Cass,31,25,Nebraska,NE
31097,31CS016,59,58,59,51,-8,-8,-7,-586.2544831135693,4,304.41400304414003,-9.318629931963708,-8.908406485233826,-8.507195952476902,-0.5967135486838641,73,72,73,67,-6,-6,-5,-108.50505647930034,6,112.95180722891565,-2.3386454342831526,-2.2142003687508436,-2.087961528110217,-1.2595017335094896,5256,5312,Southeast Nebraska,Johnson,31,97,Nebraska,NE
31127,31CS016,72,71,72,81,9,9,10,533.1809655279369,14,792.7519818799547,-2.9676138476031153,-2.6057548641801116,-2.2048736574480796,1.3440891376832147,88,87,89,90,1,2,3,29.53180960916931,10,141.48273910582907,-1.245201806531008,-1.1202988271044536,-0.986944952463551,3.239067504114325,7064,7068,Southeast Nebraska,Nemaha,31,127,Nebraska,NE
31131,31CS016,153,146,160,148,-12,-5,2,-131.45158516658122,4,100.5593614480548,-4.061797159424093,-2.32420974440543,-0.6544303189428431,-0.9458913653699569,187,179,195,193,-2,6,14,38.01569032281408,14,87.91760864104496,-0.983556561482415,-0.5041408707784631,0.026855471795370692,1.9847968736047648,15911,15924,Southeast Nebraska,Otoe,31,131,Nebraska,NE
31133,31CS016,34,33,35,43,8,9,10,1465.2350780254692,4,626.9592476489028,6.818868398890416,8.329667425467626,10.075835014839775,0.3865406619660963,41,40,42,41,-1,0,1,6.371976845799001,6,235.6637863315004,-2.8010866446211464,-2.2848275100598516,-1.7550580862666312,5.162486995974466,2552,2546,Southeast Nebraska,Pawnee,31,133,Nebraska,NE
31147,31CS016,98,97,98,129,31,31,32,1608.3162700687787,18,919.422806793513,6.486066761331472,6.886830261583387,7.283556993995195,0.5540709911273348,119,118,120,131,11,12,13,159.87553326837582,12,154.44015444015443,-0.06984416448161072,0.05996730486722373,0.17704385685074167,0.8940326271360446,7831,7770,Southeast Nebraska,Richardson,31,147,Nebraska,NE
31003,31CS017,62,61,63,75,12,13,14,835.1904956346964,10,636.7398917542184,1.6073151459852197,1.9859569483700228,2.3804614597944074,0.708382523188384,75,75,76,83,7,8,8,120.96019697570222,7,111.48272017837235,-0.03682770927752585,0.08793263620679666,0.22261301444951237,0.8144183917145367,6282,6279,Wheeler and Nearby Counties,Antelope,31,3,Nebraska,NE
31011,31CS017,56,56,57,62,5,6,6,421.8024109687517,5,375.3049352598986,0.07902246617679735,0.4612045678838084,0.8788273145606974,0.7553483246198771,69,69,70,82,12,13,13,234.21380732811724,5,92.9195316855603,1.2805261728372266,1.415419510769337,1.5457907570406404,0.36756476290212897,5329,5381,Wheeler and Nearby Counties,Boone,31,11,Nebraska,NE
31015,31CS017,26,26,27,33,6,7,7,1452.5618296634539,6,1320.8585580627407,-0.41789740460715885,1.358872680333989,2.9203466534045237,0.7896542541115237,32,31,33,38,5,6,7,347.6956516332444,2,111.66945840312674,1.826984979653319,2.3530841780917098,2.818659659312271,0.2767312294358342,1817,1791,Wheeler and Nearby Counties,Boyd,31,15,Nebraska,NE
31071,31CS017,27,26,27,23,-4,-4,-3,-782.9175749335252,1,218.2214948172395,-11.624409601601098,-10.076884182561814,-8.291058921018436,-0.3864406049574524,33,32,33,40,7,7,8,407.4748122055891,4,218.10250817884406,1.3900790166074726,1.902699725750703,2.37548528992241,0.47208290219975674,1833,1834,Wheeler and Nearby Counties,Garfield,31,71,Nebraska,NE
31077,31CS017,23,23,23,27,4,4,4,694.9133936919607,7,1269.2656391659111,-6.139791993472378,-5.761470272855242,-5.322744939483288,1.44854138483629,28,28,28,28,-0,0,0,9.869886038067044,5,230.30861354214645,-2.339980295067217,-2.204984038455846,-2.080958842851988,4.117682625328982,2206,2171,Wheeler and Nearby Counties,Greeley,31,77,Nebraska,NE
31089,31CS017,105,104,106,112,6,7,8,261.37186670740937,17,674.6031746031746,-4.528314581422382,-4.141431411757734,-3.75331197160642,2.2408015305026834,128,127,129,125,-4,-3,-2,-31.608648334293104,5,49.731450169086926,-0.9395528006603086,-0.8105890352749631,-0.6831282233990561,-2.295754205487165,10080,10054,Wheeler and Nearby Counties,Holt,31,89,Nebraska,NE
31107,31CS017,89,88,90,104,14,15,16,710.4379767033772,12,572.929100023872,0.9715414477733667,1.3932805792285525,1.8117848200217048,0.7556616331669042,109,108,110,122,12,13,14,155.98865632027093,12,142.89116456299118,0.0035744181049139354,0.13214853675811544,0.2646767005665244,0.8510682144317427,8378,8398,Wheeler and Nearby Counties,Knox,31,107,Nebraska,NE
31119,31CS017,320,305,336,327,-9,7,22,74.75129436972948,41,463.3030114695746,-5.556545159666658,-3.827802129024164,-2.2065493038532007,5.38402843796261,392,374,411,357,-54,-35,-17,-100.09735877055809,24,67.8790621376248,-2.2211784438398134,-1.6722228836568422,-1.100199442476399,-0.6978484112724256,35398,35357,Wheeler and Nearby Counties,Madison,31,119,Nebraska,NE
31139,31CS017,62,62,63,64,1,2,2,91.04440465797305,17,931.7621266100301,-8.814627929671175,-8.400514321723477,-7.9940177497030716,6.388323256241649,76,75,77,82,5,6,7,79.18859701565783,4,54.682159945317835,0.1241202809460792,0.2488832324323619,0.3631517814089961,0.5888721531425344,7298,7315,Wheeler and Nearby Counties,Pierce,31,139,Nebraska,NE
31175,31CS017,44,43,44,41,-3,-3,-2,-277.4274227039136,6,591.1330049261085,-9.108601350166564,-8.67624091066379,-8.283975105524094,-3.304167919559725,53,53,54,73,19,20,20,481.0351334149479,4,98.44942160964804,3.7000806721712114,3.8280076696735836,3.9561191192847254,0.1946997143007824,4060,4063,Wheeler and Nearby Counties,Valley,31,175,Nebraska,NE
31183,31CS017,11,11,12,6,-6,-5,-5,-2740.499252834469,6,3092.7835051546394,-60.131918379888305,-58.30865570914828,-56.61761159854489,-1.3899929839656027,14,14,14,5,-9,-9,-9,-1141.5250162302198,5,631.3131313131313,-18.20952780984991,-17.72666195387893,-17.223353565071502,-0.621822631815685,776,792,Wheeler and Nearby Counties,Wheeler,31,183,Nebraska,NE
31023,31CS018,94,94,95,90,-5,-4,-4,-212.47874710299106,11,529.6737691103889,-7.838090822650656,-7.403843141629176,-7.026765540720705,-3.2232992914774625,117,116,118,109,-9,-8,-7,-97.67128302810612,6,71.17437722419929,-1.815536184942968,-1.688818858607308,-1.5585043687053795,-0.8294522847047581,8307,8430,York and Nearby Counties,Butler,31,23,Nebraska,NE
31081,31CS018,72,71,73,101,28,29,30,1218.0589478245793,20,852.5149190110827,3.247386687873049,3.656214374503979,4.049206826408665,0.6762316725351983,89,88,90,112,22,23,24,246.05724299654395,1,10.651896037494673,2.2282247276662432,2.3537973365457456,2.4841205235529187,0.04149402735553671,9384,9388,York and Nearby Counties,Hamilton,31,81,Nebraska,NE
31143,31CS018,50,50,51,90,39,40,40,3034.006246349665,10,767.9017085813016,22.264766209499683,22.65657398309671,23.055359377567626,0.24685051851466344,62,61,62,63,1,1,2,28.833944071296735,3,57.90387955993051,-0.41910893646128,-0.2897401940635645,-0.1655247374538886,1.2029416049129138,5209,5181,York and Nearby Counties,Polk,31,143,Nebraska,NE
31159,31CS018,156,149,164,155,-9,-1,6,-33.72086704391747,23,523.8285031031145,-7.343239121465242,-5.524938483500399,-3.8728088310911666,-47.85694820128887,190,181,200,177,-23,-13,-4,-76.38052495960395,19,107.93614724762826,-2.340410996822991,-1.8430122880887096,-1.3559976465447359,-1.526685194636922,17563,17603,York and Nearby Counties,Seward,31,159,Nebraska,NE
31185,31CS018,145,139,151,137,-14,-8,-2,-234.16355105468773,10,285.06271379703537,-6.78494680662287,-5.1840094950419395,-3.488380120300265,-1.3861056328642565,178,171,185,179,-6,1,8,6.02785721907649,11,77.35039729976795,-1.1991199852053631,-0.7240707589783223,-0.20880197641384488,5.922825874591958,14032,14221,York and Nearby Counties,York,31,185,Nebraska,NE
32005,32CS001,451,429,472,522,50,71,93,576.8472360298977,43,347.889403531482,0.6456400643290563,2.277013484043605,4.136197522042849,0.5947460919337829,555,530,581,660,79,105,130,210.1780383581861,53,106.40220031719902,0.5712883297857818,1.0302103490033103,1.591277615820059,0.5014580949699651,49441,49811,Carson City (city)+Douglas,Douglas,32,5,Nevada,NV
32510,32CS001,708,683,734,786,52,78,103,532.3437019456368,68,466.52030735455537,-1.0003180517078232,0.6590303399022515,2.48140499225416,0.8652013938675687,870,839,900,985,85,115,146,195.60587122662622,110,186.6083091590751,-0.4344317330210783,0.08537309004498864,0.6002304236615715,0.9457989051420597,58304,58947,Carson City (city)+Douglas,Carson City (city),32,510,Nevada,NV
32003,32CS002,15108,14130,16087,18083,1996,2975,3953,522.8678304114646,2428,426.7624714433422,-0.8236434326848913,0.9308568138108838,2.7156971850754688,0.8159214136062567,18894,17712,20076,22834,2758,3940,5122,172.06139710594803,3895,170.11021569713307,-0.5071009669289708,0.022705267326806316,0.5804475746366332,0.9884090840998091,2275739,2289692,Clark+Nye,Clark,32,3,Nevada,NV
32023,32CS002,753,731,776,783,7,30,52,230.38680158791615,66,513.8686131386861,-4.656411295354106,-2.882825446364111,-1.0892517791823382,2.1575463327041904,946,918,973,1088,115,142,170,267.31006602146647,187,351.2792576173122,-1.3471592936549612,-0.8517661803944239,-0.3053301294544948,1.3049560926771928,51375,53234,Clark+Nye,Nye,32,23,Nevada,NV
32001,32CS003,252,241,263,325,62,73,84,1151.0452270431626,46,721.936673598305,2.543769265720631,4.2962720541356685,5.9875007726794935,0.6187642331614203,310,296,323,388,65,78,92,304.95384059442864,50,194.58281444582815,0.6115306122509688,1.0829607589073655,1.616208120534368,0.6300328688921261,25487,25696,Lyon and Nearby Counties,Churchill,32,1,Nevada,NV
32009,32CS003,9,9,9,6,-3,-3,-3,-1529.6609528414626,6,3191.4893617021276,-48.94400292506042,-47.21336978803177,-45.50448281548008,-3.198699039896892,11,10,11,12,1,1,2,165.1571608848595,8,1079.6221322537112,-9.625751325604389,-9.154636953148893,-8.654656311206947,3.5974222563958063,752,741,Lyon and Nearby Counties,Esmeralda,32,9,Nevada,NV
32019,32CS003,576,550,601,699,98,123,149,831.2431513091325,61,411.44630119892753,2.643540752338455,4.219536078950911,5.902306234141447,0.49099296939069825,718,687,750,893,143,175,206,287.77864770993006,108,177.95939889269707,0.6090629463108084,1.1066474261948702,1.5992624985902995,0.6148692263156856,59303,60688,Lyon and Nearby Counties,Lyon,32,19,Nevada,NV
32021,32CS003,63,62,63,78,15,15,16,1344.754953894971,2,175.78554163920018,11.292827282195045,11.705777057457595,12.09644458118604,0.1226997667372991,77,77,78,87,9,10,10,211.7093652375962,14,305.61012879284,-1.068478348682988,-0.9399692289405185,-0.8102731946905014,1.3086061579472779,4551,4581,Lyon and Nearby Counties,Mineral,32,21,Nevada,NV
32029,32CS003,33,33,34,36,2,3,3,245.9807325564236,5,485.0836769342712,-2.798242328974212,-2.386335575456435,-1.9570847372203295,1.4142485652823842,41,41,42,48,6,7,7,161.09825486703312,1,24.16626389560174,1.2455382013482705,1.369605586392101,1.502629880483027,0.13044194353568644,4123,4138,Lyon and Nearby Counties,Storey,32,29,Nevada,NV
32007,32CS004,283,260,306,340,34,57,80,426.98012884417176,42,313.1991051454139,-0.591542298258219,1.1297151918745156,2.92318709764908,0.7209305943734425,354,326,382,505,123,151,179,280.455425464276,101,187.41533836818763,0.4153226821401841,0.9406616750261918,1.4762875571945075,0.6638612139913707,53640,53891,"Northern Nevada, excluding Washoe",Elko,32,7,Nevada,NV
32011,32CS004,12,12,13,11,-2,-1,-1,-307.31704936814623,6,1271.8600953895073,-16.22047943137731,-15.792361596352853,-15.384015257987244,-13.340205602674898,15,15,16,28,12,13,13,662.2494312038526,1,52.770448548812666,5.961605305749634,6.097958817530321,6.217882621962445,0.07380277114402281,1887,1895,"Northern Nevada, excluding Washoe",Eureka,32,11,Nevada,NV
32013,32CS004,130,123,138,124,-14,-6,1,-150.20470558738478,10,231.70943636679604,-5.448729041106344,-3.8240444656266304,-2.1483795725091688,-1.823998855176073,164,155,173,207,34,43,52,246.5341963846963,36,204.60358056265983,-0.11824687745390564,0.42394889433689853,0.942533106965218,0.8112183959122817,17263,17595,"Northern Nevada, excluding Washoe",Humboldt,32,13,Nevada,NV
32015,32CS004,43,43,44,55,11,12,12,810.9308098915158,4,280.60329708874076,4.881023435225755,5.315387197411554,5.744518335272704,0.31847593481514563,54,54,55,70,15,16,16,270.2222389881141,12,207.3613271124935,0.5009847341086029,0.6249782085261615,0.7475504546958585,0.721250895565988,5702,5787,"Northern Nevada, excluding Washoe",Lander,32,15,Nevada,NV
32017,32CS004,40,39,40,51,11,11,12,997.5144262522488,3,260.6995437757984,6.961656344248602,7.355373600694158,7.760921759620265,0.24040585778302173,48,47,48,63,15,15,16,336.26843750765096,1,22.114108801415306,3.011145254348602,3.1404358447000584,3.2646254482128074,0.06170531748592542,4603,4522,"Northern Nevada, excluding Washoe",Lincoln,32,17,Nevada,NV
32027,32CS004,47,46,48,54,6,7,8,417.7321180218608,11,661.8531889290011,-2.809834171900722,-2.4377685203624546,-2.0587885407755055,1.3849181255151193,59,58,60,86,26,27,28,404.93956839765895,19,282.4858757062147,1.1008585667670963,1.2246856269757296,1.3425998837834097,0.6728942350402636,6648,6726,"Northern Nevada, excluding Washoe",Pershing,32,27,Nevada,NV
32033,32CS004,74,73,75,79,4,5,6,202.80730146091736,0,0,1.6226501304589016,2.0184393166090615,2.423286791038969,0,92,91,93,105,12,13,14,143.9843036858994,18,196.35649612741355,-0.6505901733459782,-0.5231109053912624,-0.39631108393287123,1.2676912369848607,9148,9167,"Northern Nevada, excluding Washoe",White Pine,32,33,Nevada,NV
32031,32CS005,3511,3302,3720,3998,278,487,696,401.0533963165426,441,363.09370658158804,-1.2172352173444838,0.37928147190200706,2.049816980482765,0.9034952068613034,4362,4108,4617,4849,232,487,741,98.82297285039377,522,105.98640450259485,-0.5566692972336027,-0.06739778865429054,0.461699935977315,1.070288527496892,485825,492516,Washoe,Washoe,32,31,Nevada,NV
33001,33CS001,660,632,687,697,10,37,65,235.4885470119785,44,277.270149347785,-2.178825056600244,-0.3795130745674834,1.3281668121556263,1.146738853120465,818,785,851,823,-28,5,38,7.612699234167569,80,124.3104653873048,-1.7063562680449977,-1.165977965214654,-0.6333122705473038,13.56126981805417,63476,64355,Belknap+Carroll,Belknap,33,1,New Hampshire,NH
33003,33CS001,505,483,526,489,-37,-16,6,-124.00952982221666,3,23.936806829968884,-3.1667830770814493,-1.4555424144211304,0.16018532058310267,-0.2062973734857119,632,606,659,611,-48,-21,5,-41.325246218420105,36,70.15902712815715,-1.6208879421006643,-1.115907162086818,-0.5992813720267013,-1.7817539187413287,50132,51312,Belknap+Carroll,Carroll,33,3,New Hampshire,NH
33005,33CS002,646,613,679,631,-48,-15,18,-78.75818134678529,6,31.373779363896624,-2.861885491065338,-1.0581050659987887,0.6393600972665666,-0.4266845230547803,800,761,840,900,60,100,139,128.88866825953014,76,98.43539529582426,-0.18979029648521584,0.301352547619158,0.8143003478196682,0.7561258907792154,76497,77208,Cheshire,Cheshire,33,5,New Hampshire,NH
33007,33CS003,382,368,395,402,7,20,34,258.3613433499756,20,256.23778866788376,-1.6350304004458573,0.023645804564378845,1.6963657299990655,0.944922867341345,467,451,483,573,90,106,122,337.99416142910025,62,198.26042466103866,0.8724376777893282,1.3983151724516951,1.8705695227331967,0.5810818449262553,31221,31272,Coos+Grafton,Coos,33,7,New Hampshire,NH
33009,33CS003,744,704,783,734,-49,-10,30,-41.89523611983779,11,48.28532235939644,-2.4456170798315506,-0.9274066881132935,0.7527948683309468,-1.2874142358420373,925,877,972,935,-37,10,58,11.35257427712124,44,47.80322454478293,-0.8957561923301034,-0.3466965409242843,0.15725700556591,3.843008401679694,91125,92044,Coos+Grafton,Grafton,33,9,New Hampshire,NH
33011,33CS004,3003,2822,3185,3420,235,417,598,394.7340803451376,412,390.4066103798884,-1.7230406811255554,0.048956719239563906,1.6774844175537167,0.9866684275872838,3712,3493,3931,3963,32,251,470,59.281456686731445,297,70.06716539389778,-0.6103404619021396,-0.11862834567343243,0.419618049646433,1.1772556781567214,422124,423879,Hillsborough,Hillsborough,33,11,New Hampshire,NH
33013,33CS005,1236,1170,1302,1280,-22,44,110,113.91152343783062,58,150.92277567801406,-2.109874744736316,-0.3484570565120667,1.2752659528962835,1.2953228080541002,1530,1450,1610,1560,-50,30,110,19.617669603481218,101,65.14195787056744,-0.9341082746942889,-0.45227790442586036,0.061336087351626496,3.2148801701759333,153721,155046,Merrimack+Sullivan,Merrimack,33,13,New Hampshire,NH
33019,33CS005,390,371,408,405,-3,15,34,141.42577959239398,3,27.82995895081055,-0.6871987635198149,1.1026574973476195,2.8151254438979,0.18466827956991486,481,459,504,518,14,37,59,84.60148042858926,45,103.54348826507133,-0.6884915125851004,-0.19553687196245845,0.34762198827336954,1.1914910573494812,43119,43460,Merrimack+Sullivan,Sullivan,33,19,New Hampshire,NH
33015,33CS006,2224,2089,2359,2461,102,237,372,301.9697667655827,183,233.12473128553,-1.0165805881088503,0.6697624011117522,2.4561632705143803,0.7687703075209946,2760,2597,2923,2970,47,210,373,66.33527448495238,256,80.86423652789185,-0.6709805859521552,-0.14759113287913492,0.399043286767093,1.2132459234658124,313995,316580,Rockingham,Rockingham,33,15,New Hampshire,NH
33017,33CS007,1001,945,1058,1019,-39,18,74,54.549597778610035,26,79.32210112042468,-1.915300699243453,-0.2635562475110003,1.4005049329277872,1.3771091045326367,1243,1175,1312,1338,26,95,163,71.6623995303759,114,86.22645790787384,-0.6557795942970905,-0.16133055622951997,0.3625087634819829,1.1906644584608468,131111,132210,Strafford,Strafford,33,17,New Hampshire,NH
34001,34CS001,2421,2303,2538,2830,292,409,527,600.3476293527519,286,419.45478211450677,0.08464222391994568,1.8854022767566376,3.470959032785839,0.6969837935915376,2988,2846,3130,3403,273,415,557,151.05479965145813,413,150.2621401258127,-0.5437807808911217,-9.023577763372472e-4,0.5003711624514092,0.9923622980237321,272735,274853,Atlantic,Atlantic,34,1,New Jersey,NJ
34003,34CS002,6316,5906,6726,8114,1388,1798,2208,755.994611254474,1962,824.8974396436377,-2.4291860636142832,-0.6875657862300658,0.9809018611266866,1.0905354692794988,7806,7313,8298,7617,-681,-189,304,-19.778071926332732,626,65.62133762702342,-1.3528123686694955,-0.8563090834007366,-0.3766911190543272,-3.3355623808491957,951391,953958,Bergen,Bergen,34,3,New Jersey,NJ
34005,34CS003,3622,3423,3820,4075,255,453,652,394.42929601689957,523,454.95766849418146,-2.22672391452938,-0.6201145227868137,0.9422124962831019,1.1509197922680912,4479,4240,4719,4560,-159,81,320,17.37052071550511,341,73.5043693066447,-1.0458252961030239,-0.5535029251554535,-0.015814186452460046,4.179691313438585,459823,463918,Burlington,Burlington,34,5,New Jersey,NJ
34007,34CS004,4264,4040,4489,5018,529,754,978,578.9245933065081,700,537.605505080372,-1.2281108099321112,0.4070974440493868,2.147008064504473,0.9273975620776843,5265,4995,5536,5644,108,379,649,72.30396632190657,516,98.5319503215655,-0.7369946641982709,-0.24967539057005003,0.26822993665398104,1.3591566238059265,520828,523688,Camden,Camden,34,7,New Jersey,NJ
34009,34CS005,1129,1088,1170,1224,54,95,136,400.41966224311244,112,472.9480073898126,-2.2872687193384293,-0.7710509986210521,1.0319704360420847,1.1688048336083545,1389,1340,1439,1434,-5,45,94,46.83616780013944,97,101.48991378588768,-1.0685375293586483,-0.5595297981186097,-0.02992918989020536,2.1195636810047764,94725,95576,Cape May,Cape May,34,9,New Jersey,NJ
34011,34CS006,1369,1303,1435,1630,195,261,327,682.9181984009224,180,470.22864868042086,0.48431982042228233,2.143915097625965,3.8418891491484475,0.6859338774203552,1684,1604,1763,1922,159,238,318,155.14779681565733,239,155.5392134531658,-0.4912163186831745,-0.006401535897437051,0.5191117630609282,0.9983351899842542,153117,153659,Cumberland,Cumberland,34,11,New Jersey,NJ
34013,34CS007,5450,5081,5818,7733,1915,2283,2652,1071.292268458437,2055,964.1550154827812,-0.7030037383757354,1.100796905700145,2.7400929950064996,0.8995985265159738,6727,6286,7169,6771,-398,44,485,5.0841246873115,721,84.23340012033343,-1.3247303440635183,-0.7967930669961103,-0.26872451202858466,16.195761801181018,852560,855955,Essex,Essex,34,13,New Jersey,NJ
34015,34CS008,2401,2271,2531,2802,271,401,531,532.9099954221812,343,455.4628990279917,-0.9895867260073152,0.8244482369482965,2.5308432003975665,0.8525470016916058,2978,2821,3135,3186,51,208,365,68.35714912329851,321,105.52129492051385,-0.9004981707417803,-0.35320317561684117,0.10215517843481454,1.5362881165854279,301232,304204,Gloucester,Gloucester,34,15,New Jersey,NJ
34017,34CS009,3422,3114,3730,5136,1406,1714,2022,960.7714250800793,1511,847.1381056567914,-0.6842500774974771,1.1381595672381954,2.8808239911795095,0.88121277753567,4200,3835,4564,4532,-32,332,697,47.13508765149912,635,90.01882598439485,-0.9475634304034695,-0.4317123626922585,0.06374402811873683,1.9040783550501095,713461,705408,Hudson,Hudson,34,17,New Jersey,NJ
34019,34CS010,793,738,848,925,77,132,187,410.9805742074689,144,448.5247739855631,-2.079117990230555,-0.36555057552370984,1.3867844607146416,1.0831437641132486,989,922,1056,996,-60,7,74,5.7456962314025946,66,50.860780173543155,-0.9463529298365511,-0.453684487688788,0.04439159566112864,7.805145561273949,128421,129766,Hunterdon,Hunterdon,34,19,New Jersey,NJ
34021,34CS011,2595,2429,2760,3247,487,652,818,679.5406842622649,607,632.390477678804,-1.1885896870140855,0.5174250655989271,2.0941265643309355,0.9291900172795569,3209,3009,3408,3441,33,232,432,60.161353645946136,296,76.67917020703376,-0.6895619487415394,-0.16887339109447436,0.33817070324444715,1.2690939482812178,383940,386024,Mercer,Mercer,34,21,New Jersey,NJ
34023,34CS012,5282,4913,5651,6749,1098,1467,1836,685.250265525385,1445,674.9789506996776,-1.6596559560350685,0.10021714359472156,1.731457379190856,0.9843398627255482,6552,6107,6996,6782,-214,230,675,26.738307913628958,741,86.06591650328467,-1.13112145059535,-0.5954674377618168,-0.08222673173133843,3.204902594388533,856323,860968,Middlesex,Middlesex,34,23,New Jersey,NJ
34025,34CS013,4894,4618,5170,5879,709,985,1261,615.4843101150174,937,585.6542827141358,-1.4011949363902239,0.2685339169924702,2.044179702730317,0.9505687438776818,6065,5732,6398,6325,-73,260,593,40.34054820172414,647,100.30479013509365,-1.0751154695308875,-0.5864052067206638,-0.10183359605938429,2.4769318808130785,639968,645034,Monmouth,Monmouth,34,25,New Jersey,NJ
34027,34CS014,3392,3173,3610,4288,678,896,1115,707.6503208060525,829,654.4745453612438,-1.1926596903532893,0.5595614980451538,2.14340316006391,0.9238252135066725,4213,3950,4477,4198,-279,-15,248,-3.0191146358035903,314,61.48520047308358,-1.15413646673561,-0.649544984537833,-0.14272877993273997,-21.77776332467846,506666,510692,Morris,Morris,34,27,New Jersey,NJ
34029,34CS015,6582,6308,6856,7343,487,761,1035,478.94112557844255,1136,715.2357491952811,-3.992761087222947,-2.3794926148412974,-0.6019167856627708,1.491408248508332,8164,7829,8498,8288,-210,124,459,19.22279807505381,891,137.60320240180135,-1.700592581911304,-1.2025303686578628,-0.6605603235258674,7.101281642126594,635315,647514,Ocean,Ocean,34,29,New Jersey,NJ
34031,34CS016,3297,3073,3521,4800,1279,1503,1727,1157.2800749801847,1352,1041.0410410410411,-0.4440761403833851,1.1934696543450938,2.87508664959863,0.8989602978667862,4061,3793,4329,4216,-113,155,423,29.857292633806672,514,99.06638604281827,-1.194898824902569,-0.6916588378198607,-0.18598447300237392,3.296715178672328,519480,518844,Passaic,Passaic,34,31,New Jersey,NJ
34033,34CS017,651,623,679,789,110,138,166,854.0319249388225,94,582.8463362837346,0.893973553862559,2.6835706382436366,4.433538954714374,0.6775451891495533,802,768,835,913,78,111,145,171.31429308161455,98,150.72517264184316,-0.29444092534803523,0.1993491675163358,0.6818509478736507,0.8719882132931729,64511,65019,Salem,Salem,34,33,New Jersey,NJ
34035,34CS018,2146,1998,2293,2624,331,478,626,558.1409435635607,525,612.4413077080113,-2.4384634973010026,-0.5899510409020167,1.1561671249334133,1.09499927932535,2667,2489,2845,2637,-208,-30,148,-8.659642814176607,218,63.086918146170646,-1.2304024790920387,-0.7327927907425794,-0.15616034264180745,-7.537038130780302,342890,345555,Somerset,Somerset,34,35,New Jersey,NJ
34037,34CS019,1081,1019,1143,1321,178,240,302,666.9393448984666,217,603.8596930611791,-1.0521196411852693,0.6041443284784214,2.4927977611903005,0.9016570984178272,1347,1272,1422,1478,56,131,206,90.20509066825429,122,83.94687951558522,-0.45473616886562035,0.05069978010431476,0.5786958197903397,0.9235773207527614,143742,145330,Sussex,Sussex,34,37,New Jersey,NJ
34039,34CS020,3498,3251,3744,5073,1329,1575,1822,1102.5528930935889,1389,972.1155410760807,-0.4598861252851514,1.3292328433482432,2.8645552443604387,0.8811358340197708,4322,4027,4618,4420,-198,98,393,17.08557942668384,480,83.85158269862343,-1.2056584352508672,-0.6543898289859211,-0.19892603315527016,4.858068941595289,571537,572440,Union,Union,34,39,New Jersey,NJ
34041,34CS021,901,854,948,1062,114,161,208,590.5150388845996,150,549.9037668408029,-1.3465295440823724,0.3963431098560737,2.170786176246239,0.9254818104464166,1118,1061,1175,1190,15,72,129,65.33111909009799,106,95.87120698231809,-0.8341931203053904,-0.3038908770093646,0.21874909491198558,1.4474279459130885,109110,110565,Warren,Warren,34,41,New Jersey,NJ
35001,35CS001,4930,4639,5221,6092,871,1162,1453,686.7617127874694,602,355.8087852853563,1.567377994065404,3.3004950204615775,5.041315420758374,0.5176509172563655,6064,5715,6412,7401,989,1337,1686,198.19104464469999,797,118.12447384958324,0.29958496536748735,0.7845970770950237,1.3292497331058195,0.5955677973900005,676768,674712,Bernalillo,Bernalillo,35,1,New Mexico,NM
35003,35CS002,37,36,39,38,-1,1,2,69.58386813348957,4,443.3361041839845,-5.4895918126854,-3.8127165436290085,-2.0853142918811556,2.4572734661393345,47,45,49,73,24,26,28,705.1649001206051,10,269.25148088314484,3.8271535438705473,4.34355148653045,4.886273585513993,0.36778464827090157,3609,3714,Catron+Cibola+Sierra+Socorro,Catron,35,3,New Mexico,NM
35006,35CS002,220,208,232,321,89,101,113,1493.7372951665595,69,1021.087680355161,2.989670151697696,4.761326759337643,6.464778148044416,0.6768734093982943,271,257,285,396,111,125,139,460.3650925759685,85,312.8680800942285,0.9341052630690793,1.463431460506216,1.9751966940573644,0.6742179695248648,27030,27168,Catron+Cibola+Sierra+Socorro,Cibola,35,6,New Mexico,NM
35051,35CS002,219,214,224,264,40,45,50,1585.6988044564152,42,1469.8162729658793,-0.5281204880694684,1.2080907578513467,2.9311244803482004,0.906905241207596,266,260,272,278,6,12,18,106.85606545102466,29,252.04241265426734,-1.9411706569710996,-1.449906723687619,-0.9739961362260228,2.1812943061831995,11430,11506,Catron+Cibola+Sierra+Socorro,Sierra,35,51,New Mexico,NM
35053,35CS002,150,143,157,194,37,44,51,1054.8095203532646,48,1160.4013054514685,-2.775881008402083,-1.0582259537601635,0.7230297721118444,1.075456834007637,182,173,190,224,34,42,51,257.7142460487512,30,183.50868607780768,0.2337765308933473,0.7357399672052395,1.2604137275743417,0.6955533860736607,16546,16348,Catron+Cibola+Sierra+Socorro,Socorro,35,53,New Mexico,NM
35005,35CS003,570,542,598,734,136,164,192,1011.7003278503503,106,652.0368462331031,1.9026377241252046,3.5894448868024904,5.229204248674145,0.6406010799178776,696,663,730,846,116,150,183,231.5377012506145,142,219.44736354082957,-0.3961499373405859,0.1252433662969075,0.6476984432600261,0.9414983695812785,65027,64708,Chaves,Chaves,35,5,New Mexico,NM
35009,35CS004,348,328,369,400,31,52,72,426.57137024344684,57,471.05491508615347,-2.1498454611892566,-0.46296257252440404,1.3424682042967675,1.0832945429440544,427,402,452,560,108,133,158,277.084828513341,102,212.2921306220992,0.1360737062643887,0.654954914924871,1.1770853988578782,0.7604509015905004,48402,48047,Curry+Roosevelt,Curry,35,9,New Mexico,NM
35041,35CS004,145,137,154,162,8,17,25,349.7153322311494,40,841.3082343043433,-6.6579863492263485,-4.922948917868619,-3.149410905428765,2.269218304273082,179,169,189,220,31,41,51,216.4871044741472,47,246.93952608627123,-0.8072905596411446,-0.3182965772253215,0.16811369693067943,1.1136387658576832,19018,19033,Curry+Roosevelt,Roosevelt,35,41,New Mexico,NM
35013,35CS005,1391,1296,1486,1984,498,593,688,1078.4626851890134,329,598.4103021153531,3.0126554488441135,4.759842829943925,6.603782752051418,0.5539391983063328,1732,1617,1846,2317,471,585,700,264.54774662866504,323,145.97352591594998,0.7053434410520665,1.2043518902208052,1.7323339246861298,0.5508441653259322,219916,221273,Do�a Ana,Do�a Ana,35,13,New Mexico,NM
35015,35CS006,530,504,557,534,-23,4,30,23.427021422911498,77,500.3817848033402,-6.417860255279751,-4.730519709197385,-2.9825113771328398,16.720924168705963,645,614,677,787,110,142,173,231.76453230828142,149,243.83458523573404,-0.651620580724589,-0.12694720836178375,0.4011430966475115,1.044702374588254,61553,61107,Eddy,Eddy,35,15,New Mexico,NM
35017,35CS007,303,291,315,374,59,71,83,1014.2778411243107,23,328.6770747740345,5.128533658934346,6.843218034433044,8.75052172738882,0.31954817498679056,370,356,385,426,41,56,70,199.91203863967445,58,207.61741122565866,-0.6063967914616809,-0.06575813206410963,0.3893394902615897,1.0202748469741914,27991,27936,Grant+Hidalgo+Luna,Grant,35,17,New Mexico,NM
35023,35CS007,45,45,46,47,1,2,2,164.26404973041113,6,578.4526391901663,-4.548572655331067,-4.142008318143774,-3.74270816875968,2.2190753630969278,55,54,55,61,6,6,7,149.74701289551285,7,171.35862913096696,-0.3386905325597136,-0.21567395188827843,-0.08988514485244561,0.9835376208177359,4149,4085,Grant+Hidalgo+Luna,Hidalgo,35,23,New Mexico,NM
35029,35CS007,274,263,285,337,52,63,74,999.2608846999703,59,936.8053350269927,-1.095017324351729,0.62725803656292,2.4389147633559563,0.9228345963122393,339,326,352,423,71,84,97,328.5455427357858,57,223.38924596331714,0.5021108776318344,1.0359471424513924,1.5661820202991645,0.6719187871806428,25192,25516,Grant+Hidalgo+Luna,Luna,35,29,New Mexico,NM
35011,35CS008,21,21,21,28,7,7,7,1666.8242120627779,7,1659.7510373443984,-0.3270069797369154,0.05691875903719181,0.48065208304386625,0.8717493432045922,26,25,26,38,12,12,13,738.6595544340748,6,357.1428571428571,3.6870245139151674,3.8143670278851776,3.9450985676132233,0.447444626472698,1687,1680,Guadalupe and Nearby Counties,De Baca,35,11,New Mexico,NM
35019,35CS008,42,42,42,55,13,13,13,1174.3316703159142,5,452.18177707438394,6.822303496844173,7.226553719578402,7.615869744557153,0.3575215121469492,52,51,52,59,7,7,8,158.77672746039363,4,89.90784445942909,0.559962879622819,0.6934539692623558,0.8051135458274238,0.49603318512385547,4423,4449,Guadalupe and Nearby Counties,Guadalupe,35,19,New Mexico,NM
35027,35CS008,205,197,214,208,-6,3,11,52.285452005986876,18,355.9422582558829,-4.824564250399974,-3.027868125217585,-1.249676608492636,4.939524702128564,254,244,265,319,54,65,75,317.968307756018,40,195.92476489028212,0.7484242250984178,1.2278871076082762,1.7387700204547907,0.6068291670479209,20228,20416,Guadalupe and Nearby Counties,Lincoln,35,27,New Mexico,NM
35037,35CS008,104,103,105,140,35,36,37,1649.388697638709,10,462.69519953730475,11.463307296177812,11.866620484856284,12.271361394337333,0.27287055536124327,128,127,129,175,46,47,48,539.3292279568143,39,450.08655510675135,0.7691351244443048,0.8918994897940009,1.0166958909116623,0.8170469068471106,8645,8665,Guadalupe and Nearby Counties,Quay,35,37,New Mexico,NM
35057,35CS008,142,136,149,151,2,9,15,231.05437469634268,10,264.2880740006607,-1.9708363082600386,-0.376647124299952,1.3843383960936437,1.0264284907808232,177,169,185,235,50,58,66,381.23457637061017,45,294.6954813359529,0.40038902373519836,0.863390880682805,1.3918229850527473,0.7599487447171455,15135,15270,Guadalupe and Nearby Counties,Torrance,35,57,New Mexico,NM
35025,35CS009,502,470,533,604,71,102,134,554.0889590386681,134,725.1474646896477,-3.3952905212231332,-1.6893472715353839,-0.10866157001324578,1.2960622112954647,614,576,652,742,90,128,166,174.5694026617551,163,222.5711749846385,-0.960436982273564,-0.48851634029396407,0.055815983917773426,1.2650770992331326,73916,73235,Lea,Lea,35,25,New Mexico,NM
35028,35CS010,117,115,119,116,-3,-1,1,-26.04973722444459,5,103.05028854080791,-1.7007775098837739,-1.2827724762580015,-0.9086309610201561,-18.944183794714306,144,141,146,140,-6,-4,-1,-19.849309602045928,10,51.69561621174525,-0.8457443343209367,-0.7143793535652238,-0.5928415900801943,-3.521560198384042,19408,19344,Los Alamos+Santa Fe,Los Alamos,35,28,New Mexico,NM
35049,35CS010,1071,1005,1138,1215,77,144,210,372.20506880053597,87,225.36962561442363,-0.2060272212576071,1.4573454093126732,3.1867507064219542,0.6013135457125987,1324,1244,1404,1591,187,267,347,171.98028889754656,133,85.71354918539906,0.3619806026291981,0.8648069710281139,1.331329472378957,0.49653104989009744,154413,155168,Los Alamos+Santa Fe,Santa Fe,35,49,New Mexico,NM
35031,35CS011,569,562,577,1056,479,487,494,2689.4834761404954,374,2067.0692108935655,5.822637631002322,6.239459530404711,6.635437702443806,0.76699860287536,696,687,705,1029,324,333,342,462.82896116491736,179,248.94303515798845,2.0115029584603277,2.1403454347312154,2.26121088402052,0.5362612418434378,72373,71904,McKinley,McKinley,35,31,New Mexico,NM
35007,35CS012,123,122,124,150,26,27,28,871.5958011347453,30,975.8477677482313,-1.452370453436356,-1.0395113205209439,-0.6805781783520187,1.0793294978609573,152,151,154,178,24,26,27,207.59645243285144,32,258.81591717890655,-0.638447880353369,-0.5122178839450798,-0.382569007346779,1.1999748584808587,12297,12364,Northeast New Mexico,Colfax,35,7,New Mexico,NM
35021,35CS012,9,9,10,12,2,3,3,1553.164853154381,5,3058.103975535168,-15.471728172687309,-15.056502845553588,-14.635134283358452,1.412659021456095,11,11,11,14,3,3,3,408.3611294359372,2,311.52647975077883,0.8443936512393445,0.9683289298444372,1.0948290103668834,0.552230140546995,654,642,Northeast New Mexico,Harding,35,21,New Mexico,NM
35033,35CS012,41,39,43,43,0,2,4,200.31970680142166,4,378.25059101654847,-3.435758050741169,-1.7803982590424297,-0.014072744813045022,1.2827169383757828,50,48,52,56,4,6,8,148.6490398471613,8,190.74868860276584,-0.9335214591451471,-0.391713079877777,0.09314718589661296,1.1058367717612485,4230,4194,Northeast New Mexico,Mora,35,33,New Mexico,NM
35047,35CS012,243,232,255,264,9,21,32,302.33027431469463,10,147.32422378549592,-0.042908759630793145,1.5496453570371838,3.248009809629512,0.4646532856813206,298,284,312,391,79,93,107,342.0990549922977,45,165.77638607478357,1.2612979320024928,1.7635421288254038,2.269552473575757,0.4794232169089106,27151,27145,Northeast New Mexico,San Miguel,35,47,New Mexico,NM
35059,35CS012,40,38,41,48,7,8,10,835.0774509653569,3,294.9852507374631,3.685406629523971,5.391961046722645,7.081325864607986,0.3160310652515289,49,47,51,55,4,6,8,154.61232882108953,6,146.3057790782736,-0.42276271876844135,0.10592799248220512,0.5827524660778832,0.8173661308148288,4068,4101,Northeast New Mexico,Union,35,59,New Mexico,NM
35035,35CS013,542,512,571,640,69,98,128,579.7344330958672,45,265.13868226074914,1.5399591926493439,3.1521351716043866,4.831851179984861,0.45274372967909277,670,634,705,855,150,185,221,270.93198234424705,122,178.26353780063707,0.3906647222975097,0.898816295445518,1.4473723755888255,0.6544347094884844,67889,68438,Otero,Otero,35,35,New Mexico,NM
35039,35CS014,367,350,385,438,53,71,88,704.3927217136768,45,449.3933190193239,0.9039923250490742,2.5339149985413996,4.314984234213344,0.6290682790185181,451,430,471,604,133,153,174,381.8298867474133,70,174.16834614714736,1.5373081235379986,2.086702750187753,2.61767976705966,0.45318809797602394,40054,40191,Rio Arriba+Taos,Rio Arriba,35,39,New Mexico,NM
35055,35CS014,282,267,296,344,48,62,77,729.0634290049136,44,514.9662053427744,0.4965159037110473,2.193345613104906,3.8740625330489777,0.6951795393941221,349,331,367,425,58,76,94,220.3536207592042,36,104.07933157940386,0.6586527784548543,1.1634600884025996,1.687498932251288,0.46621185352822214,34177,34589,Rio Arriba+Taos,Taos,35,55,New Mexico,NM
35043,35CS015,1029,965,1093,1237,144,208,272,558.0616450985517,153,410.3939647946354,-0.1391992501180717,1.491459436854318,3.2763687390770024,0.7318740728365458,1288,1210,1366,1557,191,269,347,178.12496745108893,177,117.17586309622322,0.11908485171944776,0.5994673733385607,1.1059356083699516,0.6553937228653218,149125,151055,Sandoval,Sandoval,35,43,New Mexico,NM
35045,35CS016,905,853,958,1336,378,431,483,1414.6298672832215,327,1074.2267702567303,1.72009124228336,3.3277620648821857,5.192116869693469,0.7576101509592394,1115,1052,1177,1705,528,590,653,487.4720770049675,369,304.81508710772613,1.2742433337859675,1.8241390342627086,2.329345056454022,0.6242397129723433,121762,121057,San Juan,San Juan,35,45,New Mexico,NM
35061,35CS017,598,565,631,740,109,142,175,740.8439570797411,73,381.6494575872435,1.906981474041027,3.5531470155138076,5.20457281650332,0.5115450536932493,743,703,783,961,178,218,258,283.0182593254748,142,184.262431225994,0.47377277374416144,0.999010664981773,1.518127393972245,0.6480905318323583,76510,77064,Valencia,Valencia,35,61,New Mexico,NM
36001,36CS001,2389,2255,2524,2634,110,245,379,312.56025260655,209,267.1771582705073,-1.2668279185060451,0.5313978154511669,2.315830511956682,0.8513202259734948,2939,2777,3101,3188,87,249,411,79.28152406853953,256,81.57178635839328,-0.5417423093558633,-0.01812304815060433,0.521599097714719,1.0247690758888848,312901,313834,Albany+Greene,Albany,36,1,New York,NY
36039,36CS001,449,428,469,461,-8,12,33,101.68147590821403,28,234.04522088017723,-2.9850723160863026,-1.2645819620184509,0.4105350083737256,2.1269058852817593,555,530,580,653,73,98,123,202.98880618597744,67,138.40115678578806,0.14755022144888363,0.6440294725755566,1.144490391792317,0.6749481727911597,47854,48410,Albany+Greene,Greene,36,39,New York,NY
36003,36CS002,418,398,438,474,36,56,76,482.8920602009926,69,596.3956955788927,-2.869900679355934,-1.1066667291712273,0.6241350186201802,1.2133319457151517,512,488,536,562,26,50,74,107.67084013180553,81,175.53364394842345,-1.1711814848113207,-0.6630754509282599,-0.19770862106071324,1.598115118195162,46278,46145,Allegany+Steuben,Allegany,36,3,New York,NY
36101,36CS002,852,811,892,972,80,120,161,514.9073277065377,123,525.607332863278,-1.9047725977169772,-0.0672049732542699,1.599957139304986,1.0123786892797655,1041,993,1089,1267,178,226,274,242.63574669738634,145,155.89889150512317,0.35517074333762727,0.8761262157251846,1.3978328300713028,0.6396877783070655,93606,93009,Allegany+Steuben,Steuben,36,101,New York,NY
36005,36CS003,8329,7702,8955,14136,5181,5807,6434,1596.3730887269346,4277,1175.742914478929,2.5803632183547665,4.203968230047409,6.054166040536014,0.7363820475992693,10144,9405,10882,11765,883,1621,2360,113.30056623402905,1456,101.74710115101408,-0.37456311144097565,0.09855129256059109,0.6348561329675485,0.8974746365417506,1455080,1430999,Bronx,Bronx,36,5,New York,NY
36007,36CS004,1842,1757,1927,2054,127,212,297,430.1425629630339,211,428.4024749887062,-1.75958378272782,0.09282879475486736,1.7013653998710134,0.9912756412966989,2257,2155,2359,2511,152,254,356,128.54470272803488,298,150.9778093018543,-0.7418766134337011,-0.22580639340264647,0.30491367007771175,1.1699050136603169,197011,197380,Broome,Broome,36,7,New York,NY
36009,36CS005,722,689,755,789,34,67,100,350.0759162621948,53,276.1927095547044,-0.9985540975491476,0.7421279256260502,2.415387635386317,0.7773789421947692,880,841,920,1157,237,277,316,361.8520786178651,161,210.46852122986823,1.0014005082524609,1.5127924771153722,2.0435310815513166,0.5795486996158414,76758,76496,Cattaraugus+Wyoming,Cattaraugus,36,9,New York,NY
36121,36CS005,326,308,343,373,30,47,65,470.6863723249323,28,277.70201581909697,0.24190418736597616,1.9107977922738213,3.609412366592236,0.5778184152216582,401,380,422,428,6,27,48,67.0331428233057,54,133.40580068185187,-1.1866541883195472,-0.6598205485972657,-0.15397284611085565,1.9194079316140849,40331,40478,Cattaraugus+Wyoming,Wyoming,36,121,New York,NY
36011,36CS006,644,611,676,759,83,115,148,605.6508254791697,29,152.3829541274762,2.806121599322162,4.560597825867933,6.33006266056766,0.2494378861393142,787,748,826,940,114,153,192,201.91501100763446,111,146.22386742369355,0.056036326206305345,0.5487438547975433,1.0132280743681372,0.7194911260666109,76124,75911,Cayuga,Cayuga,36,11,New York,NY
36013,36CS007,1279,1224,1333,1291,-42,12,67,38.54660455159261,41,128.88522142323865,-2.600380808258723,-0.9261107113511444,0.9636110992726882,3.09150319985633,1559,1494,1625,1880,255,321,386,252.90100191861544,286,225.37963860453755,-0.2149125189681993,0.2962677325247684,0.784366623700706,0.888409039204421,127245,126897,Chautauqua,Chautauqua,36,13,New York,NY
36015,36CS008,864,828,900,942,42,78,114,374.8877035323372,100,477.754553598089,-2.727918551328291,-1.0500351280309985,0.7310314454800374,1.2583573418175031,1052,1009,1095,1138,43,86,129,103.51716912204537,123,147.89519881683842,-0.9541771774958793,-0.44642055949603543,0.07498137476162742,1.4122976256525577,83725,83167,Chemung,Chemung,36,15,New York,NY
36017,36CS009,487,467,507,519,12,32,52,270.7493752948791,29,246.59339724920812,-1.4974556771971492,0.26176936349726376,2.0914777856249103,0.8830478243669633,589,565,613,697,84,108,132,231.33247628352734,83,178.05427437520112,-0.012435633488747218,0.5177926471335238,1.0631113746812209,0.7626178769501355,47041,46615,Chenango+Cortland,Chenango,36,17,New York,NY
36023,36CS009,373,353,393,425,32,52,72,442.5552268951336,28,239.4185549380077,0.2779284390378164,2.021240461828492,3.740420884544282,0.5307369300042463,454,430,478,556,78,102,126,219.98766892848548,54,116.45209290289189,0.5569769804496174,1.0332132545207147,1.4983447621123933,0.5242184967310718,46780,46371,Chenango+Cortland,Cortland,36,23,New York,NY
36019,36CS010,619,585,654,676,22,57,91,283.7773511302226,10,50.15736874443567,0.5956192380257495,2.3394985362445024,3.9056864264972044,0.1736792562833957,763,722,805,866,61,103,144,128.86227210457915,57,71.5963473302099,0.07492273345309106,0.5771988979178815,1.0859538106777205,0.5502402099716064,79749,79613,Clinton,Clinton,36,19,New York,NY
36021,36CS011,588,561,614,579,-35,-9,18,-57.55394209559608,44,287.1734625613915,-5.126460467138356,-3.4327769218071396,-1.779657025807911,-5.627842691510093,723,691,755,763,8,40,72,65.39172248524369,65,105.27168191756418,-0.9294713721107235,-0.3901109140599642,0.13957674424278618,1.5709544900474393,61287,61745,Columbia,Columbia,36,21,New York,NY
36025,36CS012,452,433,471,476,5,24,43,216.76682643531424,23,207.99891478827064,-1.6596113693711034,0.07743427862230522,1.764530797722427,0.9211225259607,557,534,580,673,93,116,139,262.26485372503157,70,157.83540022547916,0.5076296120334924,1.06289521665609,1.5680217870026936,0.5966868741711197,44231,44350,Delaware+Schoharie,Delaware,36,25,New York,NY
36095,36CS012,246,233,259,258,-1,12,25,160.96004993417068,2,26.729927495071667,-0.5543571949386645,1.3479578065280768,3.100259367838519,0.15333386144960723,304,288,319,357,38,53,69,178.93766719889746,33,110.58240064338851,0.15527167315073845,0.6639877090572424,1.2080647121047907,0.6066334970818745,29929,29842,Delaware+Schoharie,Schoharie,36,95,New York,NY
36027,36CS013,2180,2053,2307,2497,190,317,444,428.79993856670586,264,357.21413566695196,-0.9739812553034415,0.784338366573358,2.4477812687156577,0.8304350244067578,2700,2547,2853,3137,284,437,590,147.15754019699241,335,112.82804332596864,-0.18397949437115038,0.33937884262161755,0.8675709346355653,0.7649652391837027,295621,296912,Dutchess,Dutchess,36,27,New York,NY
36029,36CS014,8523,8114,8931,9465,534,942,1351,397.6168085426372,1189,501.70681587064485,-2.7779960642116457,-1.0208768860465502,0.8102289981534083,1.2604471206397236,10445,9954,10936,10895,-41,450,941,47.35016019292407,1200,126.17527006765097,-1.2924235187554878,-0.7870875156631357,-0.24526933301713236,2.658823217775733,947964,951058,Erie,Erie,36,29,New York,NY
36031,36CS015,366,350,382,403,21,37,53,400.85277782950817,3,32.190568163528084,1.9622154911489538,3.6784454858380786,5.421773914682771,0.07821161400619556,447,428,466,490,24,43,62,114.72161868399644,33,88.52406244970224,-0.2739929605825374,0.2650632396639224,0.786003689499474,0.754011253964874,37278,37278,Essex+Franklin,Essex,36,31,New York,NY
36033,36CS015,380,360,401,413,12,33,53,273.8831571745041,11,91.86762710095,0.001289989402806615,1.8176514958652494,3.5501291214932866,0.3255007541193985,465,440,489,547,58,82,107,173.35800596238127,37,77.95053301310412,0.4116037049405128,0.966982278908714,1.455441363097763,0.44425174265954326,47895,47466,Essex+Franklin,Franklin,36,33,New York,NY
36035,36CS016,514,491,537,565,28,51,74,384.92273755448446,48,361.03119535172334,-1.465111249334637,0.20799550462789798,1.8819739823703343,0.9199554388240403,630,602,657,803,146,173,201,325.8539689032548,117,220.2477316366101,0.5506845750780801,1.0731628678667553,1.5794352831389071,0.6720270092683805,53181,53122,Fulton+Hamilton,Fulton,36,35,New York,NY
36041,36CS016,57,56,57,64,7,7,8,562.1872223918795,2,160.35277610743637,3.6207377797076816,4.007742878801814,4.392150373091278,0.24962929639834697,72,71,72,79,7,7,8,141.46508584413343,4,78.23195775474281,0.5122155337032139,0.6321048950056865,0.755234247025393,0.48584314774349624,4989,5113,Fulton+Hamilton,Hamilton,36,41,New York,NY
36037,36CS017,539,514,564,607,43,68,93,465.90704196034756,57,392.47413629869345,-0.9969448359578672,0.6799186727474279,2.407170647591569,0.8301191161024659,661,631,691,734,43,73,103,126.66466589047224,121,208.9376985771515,-1.3538418158739365,-0.8272409421712487,-0.3214163996671998,1.627349339287744,58093,57912,Genesee+Orleans,Genesee,36,37,New York,NY
36073,36CS017,356,339,373,418,45,62,79,615.5971189365795,49,486.9807195388591,-0.28236458826376876,1.300810840746027,2.9134074061319666,0.7785021294319522,438,417,459,488,29,50,71,124.7517146871826,52,129.35966963530524,-0.5497684214584806,-0.04547395796106613,0.434740195353539,1.0166636197821144,40248,40198,Genesee+Orleans,Orleans,36,73,New York,NY
36043,36CS018,559,533,585,609,24,50,76,334.0604511473474,35,232.57359292976278,-0.7081728156107847,0.9739255049177424,2.6945214197096146,0.6826237137955949,680,649,711,834,123,154,185,256.9280232109283,139,231.87148647972376,-0.2661327358267974,0.2530538730909193,0.7694732906995907,0.8966547818413675,60196,59947,Herkimer,Herkimer,36,43,New York,NY
36045,36CS019,814,765,864,793,-71,-21,28,-74.15535602962176,13,45.10873808305213,-2.966088512104111,-1.1528366747515983,0.4326137718134018,-0.638161546749036,1015,955,1075,1081,6,66,126,56.479530489141204,119,102.34622265033714,-0.9555174534305226,-0.44708927817313443,0.06116581090319376,1.7849139754372847,115277,116272,Jefferson+Lewis,Jefferson,36,45,New York,NY
36049,36CS019,223,211,234,205,-29,-18,-6,-267.71401393446325,6,90.52845988457622,-5.269988918109275,-3.5792305634746593,-1.9417385165731196,-0.3583498228913751,275,261,289,304,15,29,43,108.3637329965136,40,150.55706112616681,-0.9353586190422205,-0.4126831416015401,0.03975164186341834,1.3427290087424386,26511,26568,Jefferson+Lewis,Lewis,36,49,New York,NY
36047,36CS020,14153,12990,15315,22012,6697,7859,9022,1166.8174288202708,6645,986.5172267508732,0.14088999544475733,1.7756181891019935,3.5990671990462215,0.8453693772327548,17265,15895,18636,18747,111,1482,2852,55.82944639406066,2754,103.7818576198833,-1.0108463328782482,-0.46549910566029484,0.007798298123160036,1.8576550613181364,2694327,2653643,Kings,Kings,36,47,New York,NY
36051,36CS021,482,456,509,482,-27,-0,26,-2.551693280739558,33,213.3816136176266,-3.8186725215044635,-2.193552511897067,-0.4319809676907651,54.51173341593124,593,561,625,678,53,85,117,137.54925328995526,74,120.13767127735566,-0.35249633524956886,0.1513259342206954,0.6755393362472176,0.8632270608810506,61861,61596,Livingston,Livingston,36,51,New York,NY
36053,36CS022,486,457,516,612,96,126,155,736.6404779643897,70,409.95007393742407,1.4249547818332018,3.192283510395234,4.929421008166438,0.5521236112173189,594,559,629,716,87,122,157,179.80687635712266,71,104.88684039472906,0.22762555379936733,0.7483162940730241,1.2437342622918728,0.5785769855742293,68301,67692,Madison,Madison,36,53,New York,NY
36055,36CS023,5834,5508,6159,6541,382,707,1033,374.1858626362141,654,346.0889697370597,-1.5412000236481957,0.2244625921239305,2.022207276118114,0.9236057348761404,7167,6777,7557,8105,548,938,1328,124.08465516270189,896,118.57262904367734,-0.445155598130765,0.04523839448074949,0.5661644478189337,0.9545604702598999,755875,755655,Monroe,Monroe,36,55,New York,NY
36057,36CS024,492,471,513,560,47,68,89,550.2479651675632,33,267.01729543845454,1.0622554863200795,2.854081611246233,4.615222720327068,0.4782347371893935,601,576,627,737,110,136,161,273.59685542909307,116,234.15421881308032,-0.13202593114064887,0.3889493252930492,0.9061866876436243,0.8495686252859121,49435,49540,Montgomery,Montgomery,36,57,New York,NY
36059,36CS025,9511,8913,10109,12307,2198,2796,3394,805.7231759291564,2755,793.8737726293647,-1.4662356604613545,0.17037864193285676,1.883316505304326,0.9849412033722311,11722,11003,12440,12165,-275,443,1162,31.856367600326113,1300,93.43409841485459,-1.1271581302319889,-0.6287155356790061,-0.10900610259326386,2.9263779795719937,1388130,1391355,Nassau,Nassau,36,59,New York,NY
36061,36CS026,8712,7994,9429,12306,2877,3594,4312,861.8583385065192,2787,668.2728073272625,0.2179360031300663,1.9318050240487956,3.532077326506743,0.7751702402863231,10331,9508,11153,11301,148,970,1793,60.90276946993465,1124,70.55616967879995,-0.6122960147359672,-0.10150460961856621,0.4254959414285437,1.1573122705524728,1668181,1593057,New York (county),New York (county),36,61,New York,NY
36063,36CS027,2043,1952,2134,2390,256,347,438,655.0222069518887,234,441.93260527769513,0.37655622446420506,2.16862894176275,3.816717628451671,0.6727436967251688,2498,2389,2607,2968,361,470,579,222.04085839440694,372,175.68716350240862,-0.01643635000879415,0.458875394994342,0.9801279050696238,0.7895586161120826,211797,211740,Niagara,Niagara,36,63,New York,NY
36065,36CS028,2204,2104,2303,2455,152,251,351,435.1039006232347,246,425.8947468653022,-1.5653487557865156,0.10459379492279228,1.7430692932765515,0.9749552377748513,2691,2572,2810,3040,230,349,468,151.52034989759628,471,204.35523969437827,-1.019658250625658,-0.532911557213044,-0.004654302254230969,1.344847367716222,231043,230481,Oneida,Oneida,36,65,New York,NY
36067,36CS029,3786,3582,3990,4339,349,553,757,467.3663954909594,474,400.63814725987595,-1.0867448842202072,0.6799602931628362,2.4032370141941604,0.8556774907399339,4643,4399,4888,5173,285,530,774,111.89933184314134,514,108.53315540089699,-0.4620926381166792,0.040216435973571996,0.5514037779273875,0.9680910272200481,473245,473588,Onondaga,Onondaga,36,67,New York,NY
36069,36CS030,944,896,993,935,-58,-9,39,-33.58977733596873,74,264.0146278374883,-4.828723782414768,-3.00261741843381,-1.2547220828128138,-8.794035090078056,1161,1103,1219,1194,-25,33,91,29.18715669654065,103,91.55311413917852,-1.1193182434287423,-0.6220136443492652,-0.10755806855680003,3.0440566407780816,112115,112503,Ontario,Ontario,36,69,New York,NY
36071,36CS031,2455,2283,2627,3006,379,551,723,552.0734297221144,594,595.0890128935953,-2.1477235402639194,-0.4808405720125309,1.2732714560540448,1.0759638924776505,3060,2851,3269,3163,-106,103,312,25.48102279426828,393,97.26326418484476,-1.2394964208533445,-0.7217012235824602,-0.19929518347119918,3.7803688034478213,399268,404058,Orange,Orange,36,71,New York,NY
36075,36CS032,932,882,983,981,-2,49,99,166.09420546826692,48,163.69123740344776,-1.690055331644066,0.06091289313779747,1.7704014091811324,0.9657047202317164,1149,1088,1210,1329,119,180,241,153.34206116494823,138,117.5648736603568,-0.17392128964383816,0.3554561121501247,0.8353094760161017,0.7624478805798364,117294,117382,Oswego,Oswego,36,75,New York,NY
36077,36CS033,515,490,540,571,31,56,81,383.5353090345696,19,129.97674100424135,0.9490966402471047,2.537360311353448,4.125524857846316,0.3329525321654718,630,600,660,735,75,105,135,179.92208279515924,85,146.15860788224774,-0.21250311643572883,0.3382170868382264,0.8266058786656265,0.8046538416222064,58472,58156,Otsego,Otsego,36,77,New York,NY
36079,36CS034,601,559,643,777,134,176,218,721.1011430284353,116,474.37457188717246,0.6456195675113875,2.503965065594534,4.223084607026649,0.6541378027082237,742,691,792,753,-39,11,62,11.289922610182579,53,54.139086377380075,-0.9148677404248677,-0.4251248124382173,0.1641413849048751,4.397470740005732,97813,97896,Putnam,Putnam,36,79,New York,NY
36081,36CS035,12854,11833,13876,20419,6543,7565,8586,1277.5876238344429,6559,1107.7656330025995,0.05353573043545122,1.6820910920631258,3.3936984520104887,0.8669614428708055,15723,14514,16931,17202,271,1479,2688,63.196203364161924,2511,107.28151378445686,-0.9474970201718192,-0.46598511307346296,0.08099151423464762,1.6964473815254837,2368371,2340571,Queens,Queens,36,81,New York,NY
36083,36CS036,1267,1198,1336,1393,57,126,195,314.46483613903496,78,194.31019879428032,-0.5034044320901467,1.2249288820145172,3.125828695063562,0.6130510334917827,1552,1470,1635,1786,151,234,316,145.7103798330105,167,104.15822070316155,-0.1009551641504769,0.4291231983598588,0.9165849341744071,0.7117837448059123,160568,160333,Rensselaer,Rensselaer,36,83,New York,NY
36085,36CS037,3289,3077,3501,4420,919,1131,1343,918.6315833568267,1125,913.7352685569481,-1.5766074646264938,0.05685690178531172,1.7606137416569854,0.993791329090319,4058,3803,4313,4367,54,309,564,62.53293597077682,594,120.29405212742259,-1.0964786170093586,-0.5728642216035729,-0.07414567802392569,1.9174812615064867,492484,493790,Richmond,Richmond,36,85,New York,NY
36087,36CS038,1979,1833,2124,2791,667,812,958,965.7602598455816,819,973.4934030666826,-1.842336648967475,-0.10578326706912657,1.6640439040951744,1.0067682031709724,2464,2289,2639,2477,-162,13,188,3.933728919751694,273,80.51529790660226,-1.2746031039928676,-0.7682644245920144,-0.2795291837338816,19.040395721229597,336520,339066,Rockland,Rockland,36,87,New York,NY
36089,36CS039,855,809,902,939,37,84,130,309.2459289016605,47,173.74588739787808,-0.4205021254774681,1.334904378370155,3.0341618763323104,0.5552004095567548,1054,998,1110,1261,151,207,263,191.53072815146666,139,128.59772964871541,0.10489269957102164,0.6075757797096805,1.1423122335528708,0.6681932599209106,108204,108089,St. Lawrence,St. Lawrence,36,89,New York,NY
36091,36CS040,1671,1570,1772,1689,-83,18,119,30.471744137440005,64,108.94544216529067,-2.4420174836055137,-0.7872021637560919,0.9144782340822557,3.386131215085904,2074,1952,2196,2364,168,290,412,122.2795492769418,252,106.27754465132952,-0.34569159203905064,0.1660843923683907,0.7024216617578414,0.8661485832177477,234980,237115,Saratoga,Saratoga,36,91,New York,NY
36093,36CS041,1341,1274,1409,1453,44,112,179,283.55035224303543,88,223.425390518385,-1.1764235931618772,0.5967660300881127,2.409051286844805,0.7809638751777772,1648,1566,1729,1851,122,203,285,128.6846023555168,188,118.94518398542289,-0.44484723645881147,0.11196183277271905,0.6102852943062306,0.9197933581912755,157547,158056,Schenectady,Schenectady,36,93,New York,NY
36097,36CS042,176,169,184,192,8,16,23,353.12640869856125,11,246.6367713004484,-0.6399204824108697,1.0393499441762548,2.758022332769629,0.6567384597016344,215,206,224,259,35,44,53,245.9904767412542,17,95.68300782349299,0.9580106736791039,1.488698533071697,1.9964625524420787,0.3802695744211763,17840,17767,Schuyler+Seneca+Yates,Schuyler,36,97,New York,NY
36099,36CS042,310,295,324,324,-0,14,29,167.34482203079972,30,355.2292708919215,-3.540787759133243,-1.8698996275729665,-0.14403782314428132,1.982463316834648,380,363,397,410,13,30,47,89.06625332586033,52,154.3393090347857,-1.1833282910305738,-0.6481345445466014,-0.14789135181951568,1.6769756557213886,33781,33692,Schuyler+Seneca+Yates,Seneca,36,99,New York,NY
36123,36CS042,231,221,242,256,14,25,35,398.2995864604007,16,258.82638411453064,-0.37342634623536314,1.3933749813322747,3.0402016946039856,0.6244661622699695,283,270,296,279,-17,-4,9,-16.777286027396368,25,101.51459779916352,-1.7098845012570014,-1.1626097101496713,-0.7142531169405982,-7.98277705003333,24727,24627,Schuyler+Seneca+Yates,Yates,36,123,New York,NY
36103,36CS043,10827,10173,11481,13547,2066,2720,3374,716.8589721612979,2804,739.0339187313076,-1.863945556655544,-0.2474507118398841,1.4590911808497622,1.030554586273682,13397,12609,14185,14328,143,931,1719,61.003948256912096,1770,115.98822293591749,-1.0478377758083135,-0.5528744079755303,-0.01775132757173754,1.8992830152576938,1517657,1526017,Suffolk,Suffolk,36,103,New York,NY
36105,36CS044,648,614,681,739,58,91,125,466.7121545249274,63,321.78565499980846,-0.3317599005759351,1.4027151443396648,3.2069119547435885,0.6820095549298898,807,766,848,876,28,69,110,86.90843872699193,81,101.7127932091014,-0.6561686206989957,-0.15233576450798536,0.34408865685836315,1.1536751689209201,78313,79636,Sullivan,Sullivan,36,105,New York,NY
36107,36CS045,403,382,423,492,69,89,110,739.8963614208825,57,472.08878582077193,0.8974682558381352,2.686472742605855,4.360919054272114,0.6309840627396948,492,467,517,559,42,67,92,139.19638622407226,59,122.8271052357656,-0.34925755186635216,0.15866444571861682,0.6620596339674405,0.8693988447854868,48296,48035,Tioga,Tioga,36,107,New York,NY
36109,36CS046,612,567,657,584,-73,-28,17,-106.30470369567111,22,83.90701577070502,-3.704688039433212,-1.8542620216044075,-0.12122427273950918,-0.8186789252032499,758,704,813,759,-54,1,55,0.6053374947623409,54,51.33226232687244,-1.013779340008344,-0.5049583016607638,-0.012388993130296242,32.99126514463329,104878,105197,Tompkins,Tompkins,36,109,New York,NY
36111,36CS047,1504,1426,1582,1664,82,160,238,352.55801684790094,149,328.78949197610206,-1.3453233590844331,0.24090147185448274,1.8929889518216338,0.9267819801344294,1858,1764,1953,2042,89,184,278,100.5160602972245,209,114.35324757751674,-0.652159100803821,-0.15143867583774717,0.3598808853682045,1.131502286634244,181271,182767,Ulster,Ulster,36,111,New York,NY
36113,36CS048,632,604,660,671,11,39,67,237.40528042132115,37,226.3204575343304,-1.4877252001660766,0.1378072313628807,1.8857016566590254,0.929363307997121,776,742,810,883,73,107,141,162.80257062599676,71,108.19707105956934,-0.008328326956164405,0.5376876509979729,1.103052219893399,0.658427513601754,65394,65621,Warren,Warren,36,113,New York,NY
36115,36CS049,552,526,578,627,49,75,101,491.434206500807,16,104.70005071408707,2.230186022396927,3.8846629982362266,5.48823911751237,0.2102503708866507,678,647,710,781,71,103,134,168.80564874877723,91,149.22191430398635,-0.3006380316802127,0.20225044337852455,0.7073531432597204,0.8754819462750524,61127,60983,Washington,Washington,36,115,New York,NY
36117,36CS050,768,729,807,832,25,64,103,283.00396214644815,50,220.02926389209765,-1.0583073255475663,0.6010843271694306,2.387277880923263,0.7655733559680684,943,896,990,1040,50,97,144,106.67473229986277,106,116.54883506140804,-0.6377076457403151,-0.09320193840664501,0.39105393030182395,1.081416344639411,90897,90949,Wayne,Wayne,36,117,New York,NY
36119,36CS051,6302,5872,6732,8319,1587,2017,2447,808.6160707175023,1925,771.8400667190582,-1.3027180576248796,0.3300502766166824,2.0337370275417603,0.9540467522251423,7779,7263,8294,8016,-278,237,753,23.749419266716817,930,93.12338848974892,-1.2170667255463148,-0.7148682619498328,-0.14782319741293626,3.904617944782218,997616,998675,Westchester,Westchester,36,119,New York,NY
37001,37CS001,1520,1446,1594,1726,132,206,280,480.93273222976865,149,347.1878367751143,-0.35411322515575694,1.3659185139107761,3.0511431462077185,0.7184244255100696,1880,1791,1970,1995,25,115,204,66.11777527150115,173,99.66586012213389,-0.8818036305004145,-0.3324565688863515,0.1632764878661586,1.4943779301781586,171665,173580,Alamance,Alamance,37,1,North Carolina,NC
37003,37CS002,335,319,351,440,89,105,121,1146.5374235651616,44,480.9268772543447,4.7250616290156495,6.6712986794486175,8.404269446331297,0.4154992205568789,410,391,429,614,185,204,223,556.1039358739837,97,264.93322044082703,2.392645251386233,2.9152817251683643,3.3809094103935466,0.47408111999262886,36596,36613,Alexander+Catawba,Alexander,37,3,North Carolina,NC
37035,37CS002,1454,1385,1524,1706,182,252,321,626.4405372142107,174,433.24805318493344,0.24122831396120717,1.897035238490179,3.6959207333785336,0.6888647868830207,1787,1704,1871,2319,448,532,615,329.0531399635451,320,198.04308674906085,0.8180326972131947,1.3142040274385505,1.8201412919471178,0.6007276079417515,160647,161581,Alexander+Catawba,Catawba,37,35,North Carolina,NC
37005,37CS003,121,120,123,129,6,8,9,276.43193127339975,4,146.1320668554206,0.87859963471081,1.2980885544870442,1.6800839978475304,0.46692790293362707,150,149,152,170,18,20,21,178.99450606140056,14,126.96109549288111,0.3959371674230525,0.5147175178562867,0.6445577870436912,0.6750981870620572,10949,11027,Alleghany+Ashe+Avery+Watauga,Alleghany,37,5,North Carolina,NC
37009,37CS003,289,277,300,343,43,54,66,812.564656359404,34,509.78334207961615,1.3559404596775486,2.983714563057297,4.65229606337114,0.6160089892084951,355,341,368,440,72,85,99,319.67316946385284,57,213.56313225927315,0.5211752765522198,1.0505861797427771,1.5831833012414693,0.6603277601278951,26678,26690,Alleghany+Ashe+Avery+Watauga,Ashe,37,9,North Carolina,NC
37011,37CS003,187,180,195,187,-8,-0,7,-4.221936820612133,19,427.90383424356736,-6.022388766025909,-4.350054891563699,-2.4563165358238006,23.383595131083183,231,221,240,247,7,16,26,92.05582189112381,32,179.23154475187633,-1.3529018931526955,-0.8684130204595973,-0.35340017639969235,1.835320537687513,17761,17854,Alleghany+Ashe+Avery+Watauga,Avery,37,11,North Carolina,NC
37189,37CS003,308,284,331,361,30,53,77,391.8096528071445,24,176.43815475096488,0.41651793905003537,2.1672316530098246,3.909839605328677,0.4420222604950799,384,356,412,457,45,73,101,134.74239101301288,39,71.94244604316548,0.10808300164098263,0.6398000392269364,1.1487124045301451,0.526714911656142,54410,54210,Alleghany+Ashe+Avery+Watauga,Watauga,37,189,North Carolina,NC
37007,37CS004,239,229,248,286,38,47,57,846.604235417951,34,611.1535523300229,0.6309428546984748,2.353987992218968,4.0462470466340745,0.7068796628912632,290,278,301,417,116,127,139,577.74460225919,73,330.97569822270583,1.9684817719481689,2.4694900259914334,2.981788695384067,0.5684147519887552,22253,22056,Anson+Richmond,Anson,37,7,North Carolina,NC
37153,37CS004,460,442,479,575,96,115,133,1066.046356721002,57,528.5363252816543,3.7709408882603883,5.379947633416098,7.235073010268931,0.4915158782833984,557,535,579,726,147,169,191,395.76663335284576,104,243.2919269188481,0.9877876850588903,1.5436883856937131,2.0504707708739662,0.6111235195456216,43138,42747,Anson+Richmond,Richmond,37,153,North Carolina,NC
37013,37CS005,489,470,508,571,63,82,101,731.0624498708569,65,578.2403700738369,-0.1582069570816805,1.469653188094794,3.266299051266433,0.7814497769781741,593,570,615,685,70,92,115,207.87267368424503,80,179.81568891885817,-0.24140333354988952,0.277311366009305,0.8098308619642344,0.8557746642729909,44964,44490,Beaufort+Martin+Pamlico,Beaufort,37,13,North Carolina,NC
37117,37CS005,254,244,263,341,78,87,97,1584.1019343020246,30,545.404963185165,8.69057798184695,10.408450165033747,12.062859073596172,0.34039259583137466,307,296,318,384,66,77,88,353.30039368558926,54,247.91111927279402,0.5295888860972184,1.073301269656348,1.5280933811398334,0.6926994071388121,22002,21782,Beaufort+Martin+Pamlico,Martin,37,117,North Carolina,NC
37137,37CS005,149,144,154,152,-2,3,8,93.86851891796441,1,32.41228425573292,-1.1131879208428888,0.6078044486277611,2.366707606838109,0.25666834103953484,182,176,188,207,19,25,31,203.13575639380608,21,170.24726388325902,-0.19612700601612562,0.3095571973188831,0.8231831265873109,0.805931794596755,12341,12335,Beaufort+Martin+Pamlico,Pamlico,37,137,North Carolina,NC
37017,37CS006,320,307,333,421,88,101,114,1348.1102242436205,27,359.19779159876276,8.182885667775027,9.887794869816817,11.598739417100415,0.2638417352763946,387,372,402,575,173,188,203,636.6882393740285,87,294.5557963163597,2.919227505450958,3.4191772857209455,3.927402397621583,0.46019026669460217,30067,29536,Bladen+Columbus,Bladen,37,17,North Carolina,NC
37047,37CS006,549,528,571,753,182,204,225,1590.7567407878353,85,664.2830627356739,7.703917308639317,9.285907054319944,11.022669619281407,0.4155478333372791,663,637,689,908,219,245,271,488.6510821749778,154,307.0665177859308,1.3042316252402957,1.8307888137178467,2.34882178814843,0.6258425233972087,51183,50152,Bladen+Columbus,Columbus,37,47,North Carolina,NC
37019,37CS007,1325,1265,1385,1530,145,205,265,588.5175936317863,84,240.9673116367131,1.8114739986101724,3.4408090158211406,5.244767596781737,0.4074618082168046,1669,1595,1743,2039,296,370,444,258.0732391975669,203,141.64009461279227,0.6514670614392588,1.1444586453815235,1.6487304667817024,0.5473569643954505,139438,143321,Brunswick,Brunswick,37,19,North Carolina,NC
37021,37CS008,2394,2279,2510,2542,32,148,263,219.66073011769447,158,235.19254528945058,-1.9026105445680532,-0.1202348478923533,1.4751065720255188,1.0635012426439068,2968,2828,3108,3154,46,186,326,68.42393998676475,264,97.32539492359588,-0.8196762917432704,-0.28465707523076184,0.21033815578414586,1.4147655339535299,268716,271255,Buncombe+Madison,Buncombe,37,21,North Carolina,NC
37115,37CS008,221,212,231,239,8,18,27,330.0866554378008,14,262.886113979908,-1.0299264331209286,0.6082323516440777,2.397971111349503,0.7535484798951508,274,263,285,296,11,22,33,103.91572008188265,40,186.40197586094413,-1.357669976776347,-0.8254169962060075,-0.3187501459562097,1.7167916631529474,21302,21459,Buncombe+Madison,Madison,37,115,North Carolina,NC
37023,37CS009,859,821,897,1016,119,157,195,714.1532135011845,85,386.4866093757105,1.5713338150548741,3.341722177919209,5.023579941946008,0.5377578233582695,1049,1003,1094,1317,223,268,314,306.44592843878996,178,203.19170795187327,0.5138614301735571,1.0385949106657562,1.5308405559876215,0.6605981639462121,87972,87602,Burke,Burke,37,23,North Carolina,NC
37025,37CS010,1467,1369,1564,1580,16,113,211,200.47724932858284,127,224.83845268655395,-1.9936998447193441,-0.23076621467748745,1.3019001521722366,1.1116988206303298,1835,1716,1954,1971,17,136,255,59.0762022562075,272,117.92043838657095,-1.1026532518870942,-0.5885370000952915,-0.060496150992017106,1.981531959357995,225940,230664,Cabarrus,Cabarrus,37,25,North Carolina,NC
37027,37CS011,820,785,855,976,121,156,191,772.7906582116182,108,534.8917834678817,0.5848636874857438,2.3487779434223746,4.138789210293282,0.6877484412461039,1002,961,1044,1322,278,320,361,397.2726470384214,173,214.98695165900338,1.3180834426571282,1.822785415623081,2.3379320384298596,0.539469693499285,80764,80470,Caldwell,Caldwell,37,27,North Carolina,NC
37029,37CS012,77,76,78,95,17,18,19,693.0106831012439,6,228.61497428081537,4.251702708967696,4.651757939556746,5.0298583698423585,0.31269436922399335,97,95,98,105,7,8,10,76.37551115657035,10,92.8418902608857,-0.29070464960253173,-0.16553157132196691,-0.04048301658374122,1.0838456130819,10498,10771,Camden+Currituck+Pasquotank,Camden,37,29,North Carolina,NC
37053,37CS012,207,194,219,262,43,55,68,776.7850197841847,13,182.7832261239411,4.297571504522109,5.962202985548748,7.567340938363312,0.23112387913543175,262,247,277,317,40,55,70,187.15421885377376,27,91.62481335686168,0.4886040609010598,0.9483080474588543,1.4438494967335025,0.4808496702420497,28449,29468,Camden+Currituck+Pasquotank,Currituck,37,53,North Carolina,NC
37139,37CS012,371,354,389,442,53,71,88,698.9691670668329,41,404.289412054727,1.3203794210158317,2.863420073976752,4.642991726036827,0.5703616917584386,455,434,476,537,61,82,103,201.1812652984113,56,137.27172447603874,0.1262505176504879,0.6329369183061082,1.180004173558027,0.6741148559503743,40565,40795,Camden+Currituck+Pasquotank,Pasquotank,37,139,North Carolina,NC
37031,37CS013,710,681,739,754,15,44,73,257.9421139903471,31,182.30200385186492,-0.8135015902763763,0.7936099581061953,2.5021658459208225,0.6910016397807164,878,842,913,1064,151,186,222,272.15637907353283,79,115.47681693270185,1.0670639994621922,1.5758532142442463,2.0680802570480736,0.42203645269955253,68019,68412,Carteret,Carteret,37,31,North Carolina,NC
37033,37CS014,238,229,248,279,31,41,50,716.9575720119433,16,282.1745072968564,2.7133017744499144,4.368129756738998,6.033252967602956,0.3841233491335967,293,281,305,362,57,69,81,303.79058915448263,44,193.73871692131564,0.5790228367248971,1.087748630971224,1.5804633868757032,0.6286263821659053,22681,22711,Caswell+Person,Caswell,37,33,North Carolina,NC
37145,37CS014,385,368,402,449,47,64,81,652.6882189290719,26,265.21816744446994,2.1337777889535112,3.873443887568407,5.514562264518119,0.40009443569205355,473,453,493,537,44,64,84,163.77028802192743,76,194.2243802708919,-0.7783448976387307,-0.29824016263039776,0.1927969070642685,1.1677340269863965,39213,39130,Caswell+Person,Person,37,145,North Carolina,NC
37037,37CS015,647,614,680,727,47,80,113,420.57085427966234,51,266.9318538678949,-0.3290941744768807,1.4911199381244118,3.1835028141325505,0.6268878279923465,806,766,846,833,-13,27,67,34.483188577143665,55,70.78233787627248,-0.9019691533212577,-0.34543919762213177,0.17939702575059457,1.978810749138533,76424,77703,Chatham,Chatham,37,37,North Carolina,NC
37039,37CS016,346,334,358,351,-7,5,17,70.11138873803526,28,388.2149046793761,-4.955978805566668,-3.173581352532889,-1.4450013756511646,4.6229154619742365,430,415,445,545,100,115,130,393.9203955952931,94,322.8243698056185,0.17706909743648977,0.7160665401115642,1.2330249674661127,0.8124337573370493,28850,29118,Cherokee+Clay+Graham+Swain,Cherokee,37,39,North Carolina,NC
37043,37CS016,136,134,137,111,-26,-25,-23,-878.35909176719,5,179.19541259743752,-10.989498373048914,-10.560541940136135,-10.155440123683315,-0.21268980039707722,169,167,170,191,21,22,24,198.14988409254082,42,372.307419555004,-1.8572469542929282,-1.7397893600074146,-1.625872990666171,1.79846192264617,11161,11281,Cherokee+Clay+Graham+Swain,Clay,37,43,North Carolina,NC
37075,37CS016,86,85,87,113,26,27,28,1323.6856858345568,10,494.74335188620904,7.9084494085383765,8.290593918014128,8.67203864995688,0.36029548218099355,106,105,107,130,23,24,25,301.43631061822225,15,186.59037193680805,1.028982993593953,1.1492563227476398,1.2771659108744078,0.5944722401754746,8085,8039,Cherokee+Clay+Graham+Swain,Graham,37,75,North Carolina,NC
37173,37CS016,173,167,179,211,32,38,44,1077.586603772794,10,283.245999150262,6.219491767036599,7.985993580010445,9.549531927969573,0.25612001958723035,213,206,221,249,28,36,43,251.80656245108707,30,212.34428086070213,-0.12661811182655625,0.4005667051635367,0.90213174503926,0.820227215588441,14122,14128,Cherokee+Clay+Graham+Swain,Swain,37,173,North Carolina,NC
37045,37CS017,1069,1026,1112,1263,151,194,237,780.3852499819469,162,651.0338175899692,-0.3671987010210329,1.297239666900529,3.1634370907837894,0.8299726116529224,1314,1262,1366,1480,114,166,218,165.67077578969528,218,217.419489961802,-1.0302179307325972,-0.525156794781763,0.016650835817251537,1.3045056200567826,99534,100267,Cleveland,Cleveland,37,45,North Carolina,NC
37049,37CS018,928,885,971,1121,150,193,236,766.6942120456836,102,404.8422306013098,1.891914839491337,3.613228029254522,5.2651960436292,0.5253166395972,1137,1085,1189,1292,103,155,207,154.20428430923965,108,107.29613733905579,-0.03072183453934048,0.4796157904218278,0.9666494697817802,0.6913510379046237,100780,100656,Craven,Craven,37,49,North Carolina,NC
37051,37CS019,2225,2081,2369,2594,225,369,513,441.1456888942817,148,176.82039886142,0.9570392372076314,2.5530563188517896,4.32780559223593,0.39973827925143446,2754,2581,2927,3572,645,818,991,243.84853423884135,444,132.40214467618134,0.5900696560913704,1.1286644445345482,1.647854103437611,0.5423056075132945,334803,335342,Cumberland,Cumberland,37,51,North Carolina,NC
37055,37CS020,314,298,330,324,-6,10,26,107.66250497950469,5,53.91271531390679,-1.077929509368524,0.5997775689310031,2.2901423976905604,0.455170699028797,394,375,414,414,0,20,39,52.914392624146814,26,68.95454304354745,-0.6498570248302897,-0.16804551597388284,0.3443674080904858,1.2409375237770754,37097,37706,Dare+Hyde+Tyrrell+Washington,Dare,37,55,North Carolina,NC
37095,37CS020,49,49,50,49,-1,-0,-0,-41.0584308027906,4,347.7504890241252,-4.310543213793145,-3.897746667404239,-3.4957433741418313,7.579699598205576,60,59,60,51,-9,-9,-8,-191.4301762815078,4,88.61320336730172,-2.935621323242148,-2.8038397194018945,-2.6810715206954034,-0.5234808542935142,4601,4514,Dare+Hyde+Tyrrell+Washington,Hyde,37,95,North Carolina,NC
37177,37CS020,36,35,38,39,1,3,4,349.42464006287105,2,241.03645676408556,-0.5547770775189438,1.0613487392038083,2.6335845012437,0.512905872072702,44,42,46,49,3,5,7,158.44170169816226,5,153.79883112888342,-0.4859550186563507,0.039352488524345725,0.5779962715101484,0.8128839211264061,3319,3251,Dare+Hyde+Tyrrell+Washington,Tyrrell,37,177,North Carolina,NC
37187,37CS020,134,129,139,167,28,33,38,1188.199818978455,12,434.46777697320783,5.971271249059086,7.519527584580632,9.180233999853664,0.35483978850290054,163,157,168,215,47,52,58,479.20029610438945,33,302.72452068617554,1.2585601294227884,1.768850081893229,2.276455523681289,0.6198623707825094,11048,10901,Dare+Hyde+Tyrrell+Washington,Washington,37,187,North Carolina,NC
37057,37CS021,1583,1510,1655,1849,194,266,339,629.9156394732107,137,323.9574835361023,1.364884243148392,3.1188248342638456,4.7054711860594365,0.5123637211348728,1951,1863,2039,2384,345,433,521,254.15912084415095,349,204.79177546840984,0.007550585484872058,0.4957798275143368,1.0089822264292558,0.8039060176945607,169158,170417,Davidson,Davidson,37,57,North Carolina,NC
37059,37CS022,411,393,429,438,9,27,45,252.07931588042834,34,317.26776466196986,-2.3572851659143077,-0.6688338602881138,1.2182650364309398,1.2136754138620014,508,486,531,579,48,71,93,162.39148239932766,84,193.42805167292238,-0.8154006549679312,-0.3203713119091456,0.21014528755135153,1.1744679220261298,42866,43427,Davie+Yadkin,Davie,37,59,North Carolina,NC
37197,37CS022,373,357,389,433,44,60,76,644.264361231175,40,429.576330344198,0.4813901421926671,2.176081134484542,3.8259423919964113,0.6558379514041877,455,436,474,507,33,52,71,139.55521494599208,66,177.46228926353152,-0.9052879305411421,-0.37983955308563305,0.11028978497941733,1.2475903550636926,37246,37191,Davie+Yadkin,Yadkin,37,197,North Carolina,NC
37061,37CS023,390,369,411,596,185,206,227,1643.1153194163282,74,590.4059040590406,8.855175117504995,10.539868315249945,12.210398221660679,0.3575847187339354,469,444,494,752,258,283,308,583.219963898361,107,220.44583625200872,3.0894279802527116,3.628828449719787,4.130398758172767,0.3766500801388275,50135,48538,Duplin,Duplin,37,61,North Carolina,NC
37063,37CS024,1829,1689,1969,2037,68,208,348,255.61162546372685,138,169.70360281978523,-0.8010468830634319,0.8800445714171147,2.531100709990747,0.6607331532816131,2270,2102,2439,2269,-170,-1,167,-0.38984295700302596,133,40.79128967949701,-0.9395494360281944,-0.4037964828185839,0.0960356382853912,-490.62471266391395,325273,326050,Durham,Durham,37,63,North Carolina,NC
37065,37CS025,546,525,567,680,113,134,155,1096.4404431181026,85,693.0289441500204,2.2601163383419336,4.025776705884481,5.681401942752701,0.6274061934099139,663,638,688,703,15,40,65,82.77367591674988,61,126.01222938357296,-0.9514117671150074,-0.43399414904202976,0.075779385212952,1.48530228723367,49060,48408,Edgecombe,Edgecombe,37,65,North Carolina,NC
37067,37CS026,2987,2822,3152,3325,173,338,503,352.89456230466686,244,254.87420808807784,-0.8515502005306302,0.8650279247826586,2.765483934678565,0.7201074631157874,3693,3494,3892,4133,241,440,639,114.1986071379386,409,106.20176777905877,-0.390034929964773,0.06361700731534296,0.6248923470298314,0.9278645270171394,382934,385116,Forsyth+Stokes,Forsyth,37,67,North Carolina,NC
37169,37CS026,469,450,488,554,66,85,104,758.5153766889961,35,313.3112523498344,2.7433394977348806,4.491343299728496,6.162816162560453,0.40824061569140063,573,550,596,671,75,98,121,220.9288030317497,76,170.60249618389153,-0.008761483396893335,0.4944662371038984,1.005775151753207,0.7644386120894917,44684,44548,Forsyth+Stokes,Stokes,37,169,North Carolina,NC
37069,37CS027,544,515,574,593,19,49,78,280.0447932703376,43,247.6958525345622,-1.1827167239996543,0.3542602994564177,2.057168755248784,0.8666598281798025,688,651,725,758,33,70,107,98.5932272084931,73,102.35845088196528,-0.5394895193619538,-0.04062993772078492,0.47373729238122214,1.0236316187162484,69440,71318,Franklin+Warren,Franklin,37,69,North Carolina,NC
37185,37CS027,205,197,214,262,48,57,65,1204.2631599534063,14,298.2689747003995,7.467358362410524,9.01843520929678,10.876431348040118,0.2433720149316342,251,242,261,302,41,51,60,270.02772418501826,29,154.7657167253709,0.6657943075328528,1.1547542119208942,1.677911897745654,0.562039521722283,18775,18738,Franklin+Warren,Warren,37,185,North Carolina,NC
37071,37CS028,2085,1987,2183,2346,163,261,359,457.45865064875545,226,396.47210003026174,-1.0885290341758453,0.6309503765644107,2.319807792517081,0.8633730784899635,2580,2461,2699,3062,363,482,601,209.1562684473627,452,196.11331184185977,-0.3987343740349315,0.11674508816641022,0.5952333932399069,0.9356990976074354,228011,230479,Gaston,Gaston,37,71,North Carolina,NC
37015,37CS029,200,192,207,261,54,61,69,1361.92544545107,38,845.5248372920955,3.4642527088194277,5.100876704375466,6.789878058566747,0.610850626494591,242,233,251,313,62,71,80,406.7873102113772,28,159.49871831387068,1.9797677638223448,2.4745254366218643,2.962984238637044,0.38667884577599726,17977,17555,Gates and Nearby Counties,Bertie,37,15,North Carolina,NC
37041,37CS029,167,161,173,194,21,27,33,786.1846873727922,22,641.9608987452583,-0.275118458794922,1.5165901076908805,3.0418836565689134,0.7873297391007912,206,199,213,237,24,31,38,227.5865801196859,21,153.12819017062856,0.23004929733079893,0.7485418203625089,1.2707744683117081,0.6519466712079738,13708,13714,Gates and Nearby Counties,Chowan,37,41,North Carolina,NC
37073,37CS029,105,104,106,126,20,21,22,779.4329991631223,18,679.1812093198755,0.5823043543137939,1.0185899570335402,1.395133631484814,0.8311429998557465,127,126,128,164,36,37,38,355.7203932220417,19,183.06195201849889,1.5992631578209433,1.7279378087660846,1.8426689711398463,0.5010519504936881,10601,10379,Gates and Nearby Counties,Gates,37,73,North Carolina,NC
37091,37CS029,215,206,224,315,91,100,109,1839.4033106693707,47,864.2883413019492,8.025007755156588,9.75612159143303,11.427604358130147,0.4652233101989579,262,251,273,304,31,42,53,196.79340369888723,30,140.8252358822701,0.06402929078794842,0.5723347691951713,1.1575139318891898,0.6989276317704686,21752,21303,Gates and Nearby Counties,Hertford,37,91,North Carolina,NC
37143,37CS029,151,145,156,182,26,31,37,951.7726268614472,15,458.1551618814905,3.0720232586381386,5.039525838709058,6.591362312747584,0.4664028886281645,186,180,193,196,3,10,16,72.67502782641031,26,198.30676531157044,-1.7709902722803523,-1.254095778273009,-0.7519642299840918,2.4695056658625623,13096,13111,Gates and Nearby Counties,Perquimans,37,143,North Carolina,NC
37077,37CS030,483,457,510,594,84,111,137,724.2878131072389,48,314.5478374836173,2.4521459904099783,4.109889194956767,5.681127535479173,0.4303916768653306,601,569,633,706,73,105,137,169.46407489079948,67,108.33009959901693,0.06414951070658255,0.6276197383074489,1.0957950611457872,0.6332096275691165,61040,61848,Granville+Vance,Granville,37,77,North Carolina,NC
37181,37CS030,430,411,448,566,118,136,155,1273.1553843963397,71,663.4738932367713,4.376343224107758,6.071914179863455,7.8680483541531014,0.5173285365833544,520,498,542,629,87,109,131,257.9153487876409,60,142.06227062862555,0.6542181413968218,1.156790129780559,1.6898020156429774,0.5457991552984934,42805,42235,Granville+Vance,Vance,37,181,North Carolina,NC
37079,37CS031,173,164,182,206,24,33,42,643.3756818605333,26,507.0697220867869,-0.2959229414565586,1.3589374392847877,3.049266964021261,0.7649513847839676,212,202,223,266,43,54,64,261.99510244282936,21,102.8353165858675,1.054040848693984,1.5695233190896376,2.103200540511998,0.3853068207407287,20510,20421,Greene+Jones+Lenoir,Greene,37,79,North Carolina,NC
37103,37CS031,98,97,99,135,36,37,38,1610.8983827766301,17,739.6932448602197,8.336751536620149,8.726578617905954,9.116227140664748,0.44710401688938556,121,120,122,169,47,48,49,521.1942814081069,16,173.14143490964182,3.3577842998696292,3.4803835961079987,3.601195477147395,0.32544426901398255,9193,9241,Greene+Jones+Lenoir,Jones,37,103,North Carolina,NC
37107,37CS031,607,584,631,733,102,126,149,911.4352963243042,78,566.0171982148688,1.736818948083513,3.4963674288123014,5.260179592452955,0.6161120845152929,740,711,768,944,176,204,233,373.30823872910867,111,202.74713231533573,1.1903233953065817,1.7062284399230083,2.209211150160898,0.5404647556186672,55122,54748,Greene+Jones+Lenoir,Lenoir,37,107,North Carolina,NC
37081,37CS032,3938,3705,4171,4378,207,440,673,325.3002815370154,346,255.84572354982242,-1.1591185540321634,0.687833367383323,2.43757334188471,0.7847072237548032,4862,4583,5142,5761,619,899,1178,165.7000899113104,547,100.87504956155314,0.14525374777153904,0.6618158038350161,1.1327181004135414,0.608104111748992,540951,542255,Guilford,Guilford,37,81,North Carolina,NC
37083,37CS033,541,520,562,696,134,155,176,1270.625061802983,53,435.30039834093054,6.605419503387916,8.43197675479531,10.065338508072156,0.3403873704872972,659,634,683,863,180,204,229,423.32135065440616,92,190.45647448504295,1.8188931138127482,2.343301388643075,2.8608110014590893,0.44772042031070236,48702,48305,Halifax+Northampton,Halifax,37,83,North Carolina,NC
37131,37CS033,202,194,209,305,96,103,111,2337.370755179191,43,971.4221167965661,12.02417635810342,13.698153487363182,15.341698725179938,0.41162617461588147,241,232,250,323,73,82,91,477.75104381429156,45,262.02398975195064,1.6511750192926922,2.14345107704951,2.679210115866015,0.5418490212182628,17706,17174,Halifax+Northampton,Northampton,37,131,North Carolina,NC
37085,37CS034,878,820,935,1068,133,190,248,566.6813400943157,97,288.81511366512336,1.0303387265627597,2.76390291961298,4.456553405427158,0.5069966545066311,1094,1024,1164,1426,262,332,402,244.73121968934677,187,137.86087110377164,0.5036612182264567,1.0571253339720175,1.6128950322720021,0.5616236005023393,134342,135644,Harnett,Harnett,37,85,North Carolina,NC
37087,37CS035,696,669,722,806,84,110,137,708.8573040729912,72,462.85879592427113,0.7735094848674567,2.4281852574743086,3.9998702226344056,0.6470962127455097,853,821,886,959,73,106,138,169.32746683991877,107,171.40294108224137,-0.5572401216713266,-0.01657374235318414,0.4960863480457275,1.0027706041082534,62222,62426,Haywood,Haywood,37,87,North Carolina,NC
37089,37CS036,1215,1165,1265,1298,33,83,133,283.4788992272279,98,336.0393646112831,-2.1902657889501134,-0.5583186065210839,1.1290119188959675,1.1712448385463714,1485,1425,1545,1646,101,161,221,137.81008198682184,149,127.59034081178285,-0.3954758700642448,0.10670614852434095,0.5697717881289132,0.9201244660104487,116653,116780,Henderson,Henderson,37,89,North Carolina,NC
37093,37CS037,297,274,319,410,91,113,136,859.6105094776127,40,303.3462887477486,3.883583659088541,5.587639686072067,7.158048986747586,0.34980204018597977,373,346,400,499,99,126,153,237.64299940840107,77,145.326891136947,0.4598480994007165,0.9151112756512284,1.424187400127167,0.6067159509442489,52745,52984,Hoke+Scotland,Hoke,37,93,North Carolina,NC
37165,37CS037,337,322,352,484,132,147,162,1719.369397973283,56,654.6070896285689,8.737862834999198,10.609456166475663,12.430388621035174,0.37815415960341103,414,396,432,550,118,136,154,397.5552487515914,78,228.00350774627304,1.2127963622066218,1.7043675863991936,2.1836391005064852,0.5693278949837306,34219,34210,Hoke+Scotland,Scotland,37,165,North Carolina,NC
37097,37CS038,1422,1341,1503,1614,111,192,273,410.530966414693,134,286.26209003369985,-0.5952139207674839,1.2159025312349891,2.9321689565578346,0.6936874432605152,1779,1681,1878,2032,154,253,351,132.05146504463212,302,157.83834635586797,-0.7832389999062103,-0.26424020808294235,0.22816963378510227,1.1905669067037101,187241,191335,Iredell,Iredell,37,97,North Carolina,NC
37099,37CS039,339,320,357,381,24,42,61,392.25116255299196,31,286.69857344338857,-0.6380130161384182,1.0451301858519588,2.7607406351487946,0.7140695588662576,417,395,439,464,25,47,69,108.24844444745216,50,115.28706479133041,-0.6001034130629056,-0.06931477326268219,0.46529467757562526,1.0428104916718577,43251,43370,Jackson+Macon+Transylvania,Jackson,37,99,North Carolina,NC
37113,37CS039,422,406,438,463,25,41,57,443.28905137042904,16,173.39474397182337,0.9839412479401568,2.7079614748000265,4.438102405309643,0.38182059357089504,521,502,541,630,89,109,128,290.10970126394926,90,240.070420656726,-0.02696603907602797,0.5119393270800687,1.032743292789645,0.8199766284465911,36910,37489,Jackson+Macon+Transylvania,Macon,37,113,North Carolina,NC
37175,37CS039,353,339,368,369,1,16,30,187.87267060731304,14,168.62898611822095,-1.5567724713785993,0.17426436562133338,1.8705814222058748,0.8434924571289167,431,414,448,513,65,82,99,246.48852803084895,47,141.814012431356,0.5502816652532806,1.0283974838181436,1.5646741298699776,0.5683795144842243,33209,33142,Jackson+Macon+Transylvania,Transylvania,37,175,North Carolina,NC
37101,37CS040,1416,1322,1509,1536,27,120,214,221.58953135841577,121,222.634166984825,-1.8320204058113763,-0.011314080541080894,1.5929719341805046,0.9964404153129877,1801,1685,1917,2110,193,309,425,137.22548305997978,249,110.56494691550441,-0.2913713423653685,0.2631173108030225,0.7829140462399803,0.8031185677523682,217397,225207,Johnston,Johnston,37,101,North Carolina,NC
37105,37CS041,533,506,560,646,86,113,140,715.2807291169026,46,291.00110706942905,2.4334754565917995,4.248286184994701,5.922629660315181,0.40326822153308656,659,626,692,784,92,125,158,194.66193411825822,85,132.7544199412757,0.10008881679043799,0.6246828280317402,1.125233290650526,0.6765461336060186,63230,64028,Lee,Lee,37,105,North Carolina,NC
37109,37CS042,733,695,770,850,80,117,155,537.6352307535041,74,338.8045692832452,0.2980263955760538,2.014340322046921,3.7347854541982897,0.6248543470584712,915,869,962,1057,95,142,188,158.48067720931812,174,194.83137009002553,-0.854295303480911,-0.3541381452138131,0.13497679605050386,1.2207448907689755,87366,89308,Lincoln,Lincoln,37,109,North Carolina,NC
37111,37CS043,448,429,467,541,74,93,112,833.3567108279791,64,572.2332744707959,0.910208092888164,2.659009132847386,4.328630701110015,0.6793716386313058,551,528,574,685,111,134,157,300.5474970760321,110,246.13456848134973,0.007086481406474573,0.5656284731660208,1.0340265504262767,0.8129018945687759,44737,44691,McDowell+Mitchell+Yancey,McDowell,37,111,North Carolina,NC
37121,37CS043,200,194,206,214,8,14,20,374.1567037406487,26,698.1740064446832,-4.966817295504974,-3.202435400875369,-1.5763843904053731,1.741040846026774,245,238,253,271,18,26,33,171.67421665667757,36,240.78656946023676,-1.2151314476076975,-0.7005065128064552,-0.2107871567707903,1.3499825110268635,14896,14951,McDowell+Mitchell+Yancey,Mitchell,37,121,North Carolina,NC
37199,37CS043,207,199,215,234,19,27,35,590.7457622586103,19,412.05812188245505,0.02820473854360328,1.8084753802632114,3.5636059897443544,0.6728215175629393,257,247,266,306,40,49,59,262.96785990398934,50,267.1511006625347,-0.5660691551853153,-0.042647487621134225,0.47240870088895726,0.995677472168039,18444,18716,McDowell+Mitchell+Yancey,Yancey,37,199,North Carolina,NC
37119,37CS044,5557,5076,6038,6552,514,995,1476,355.9399797801006,611,218.6021092777991,-0.40150403974549703,1.3320226858996926,3.0889108607336246,0.6135377075891422,6926,6347,7505,7967,462,1041,1620,92.77636312953504,847,75.51025138584045,-0.3379287626065519,0.1828208685665972,0.7050049505961241,0.8131140253022098,1118013,1121702,Mecklenburg,Mecklenburg,37,119,North Carolina,NC
37123,37CS045,252,241,263,314,51,62,73,961.35993632406,38,585.8546926190018,1.9565270442084741,3.7910739348867493,5.386349879015337,0.5997833626390144,308,294,321,403,82,95,109,369.1860213748135,65,252.06499398921937,0.6454234650097642,1.169559177608354,1.7025005012912364,0.6756616333485155,25945,25787,Montgomery+Moore,Montgomery,37,123,North Carolina,NC
37125,37CS045,1005,962,1048,1118,70,113,156,448.96608862243323,97,385.74723614093693,-1.0277994323492812,0.6102472018188503,2.2283663707712087,0.8516465686623146,1254,1201,1307,1386,79,132,185,128.96141879023762,149,145.52913024368806,-0.6863642666680273,-0.1608038185982301,0.36406791984566456,1.119987924697669,100584,102385,Montgomery+Moore,Moore,37,125,North Carolina,NC
37127,37CS046,934,893,975,1058,83,124,165,523.3201240229561,115,484.56757610871165,-1.2998583108281305,0.4010526105363842,2.023235597754985,0.9185527398126314,1147,1098,1196,1240,44,93,142,97.86095032911477,133,139.77341992979802,-0.9067727864279267,-0.4438105996697537,0.1329327193274243,1.413110561989005,94930,95154,Nash,Nash,37,127,North Carolina,NC
37129,37CS047,1684,1586,1781,1952,171,268,366,471.5627104641423,88,154.68040041130925,1.5639515247060953,3.2092745193449628,4.765621797486251,0.32679847856120847,2084,1966,2202,2373,171,289,407,126.5257230735709,205,89.68139045527523,-0.11579792811321482,0.36883916826331575,0.88655715194564,0.7063573949649592,227566,228587,New Hanover,New Hanover,37,129,North Carolina,NC
37133,37CS048,1081,993,1169,1205,36,124,212,242.53880103036587,79,154.4469479621312,-0.8583305241426771,0.8719062979553112,2.6303194317034193,0.6317008109609671,1353,1247,1459,1649,190,296,402,143.69892106734042,220,106.82100683654444,-0.12195337911395314,0.37616108466737636,0.9132044467223855,0.740863464856988,204601,205952,Onslow,Onslow,37,133,North Carolina,NC
37135,37CS049,717,653,781,754,-27,37,101,100.48711566455616,52,139.86578264319434,-2.0784090708225573,-0.39281305269537137,1.4171515878885133,1.355592782138838,892,816,969,929,-40,37,113,24.543329273313734,51,34.2578473980829,-0.6087309723282391,-0.1017966213947376,0.41692233230635894,1.3586268911434332,148714,148871,Orange,Orange,37,135,North Carolina,NC
37141,37CS050,509,482,535,579,44,70,97,460.753680573644,31,202.7468933943754,0.9222658453929922,2.5493000404055395,4.3437029224734856,0.4338744676920924,639,606,671,770,99,131,164,210.34790652550333,88,140.82929249283853,0.18090706936771445,0.6959835201260716,1.1906629306298804,0.6644513438517076,61160,62487,Pender,Pender,37,141,North Carolina,NC
37147,37CS051,1074,1000,1148,1393,245,319,393,740.1303204223626,126,292.52154734612145,2.6373629633878544,4.446356138888208,6.313926952912875,0.39399392669677313,1330,1241,1419,1667,248,337,426,196.01547262030894,180,104.69011725293132,0.4603994965402371,0.9103493356014676,1.4308105508353723,0.5325110368832972,172295,171936,Pitt,Pitt,37,147,North Carolina,NC
37149,37CS052,244,236,253,275,22,31,39,627.9091767198274,17,346.95647737129445,1.1781612055035977,2.858281780252772,4.487038652364144,0.5351637210887936,299,289,309,358,49,59,69,300.3475655614173,53,270.2013764975784,-0.23695637203773953,0.31429009779606265,0.7826069387772668,0.8846134429260748,19599,19615,Polk+Rutherford,Polk,37,149,North Carolina,NC
37161,37CS052,713,685,741,889,148,176,204,1086.7153318745254,115,709.6684614079205,2.1082002743564434,3.818741286856767,5.425295619658507,0.6493524725903592,869,836,903,1122,219,253,286,391.24024537505863,210,325.26873393017564,0.1806186117856621,0.6558009338508733,1.1467617000362145,0.8281001112410877,64819,64562,Polk+Rutherford,Rutherford,37,161,North Carolina,NC
37151,37CS053,1345,1283,1407,1564,157,219,281,606.5811092282398,137,379.7670115524016,0.5102404569094514,2.262615323540598,3.972839867288821,0.623229769572301,1658,1583,1733,2047,314,389,464,268.35137141446114,294,202.68872802481903,0.09103868500913141,0.6517808324847001,1.1777661845896608,0.7533754598554975,144299,145050,Randolph,Randolph,37,151,North Carolina,NC
37155,37CS054,1083,1032,1133,1529,396,446,497,1507.1966845175643,194,655.3445203570614,6.840297137058502,8.570426215648443,10.28098148981349,0.4338378625531949,1317,1257,1377,1932,555,615,675,528.7976061995229,300,257.8803950727653,2.2149479180013314,2.7136333213740897,3.227643851749819,0.4868816876522251,118411,116333,Robeson,Robeson,37,155,North Carolina,NC
37157,37CS055,998,958,1037,1204,167,206,246,905.9484585689811,104,456.6159925360847,2.7833551698461787,4.474031133104699,6.120930233958343,0.5015889619817909,1222,1175,1269,1518,249,296,343,324.2785768319962,167,183.03576321529172,0.9197010617141693,1.4259017923159718,1.8874105437849882,0.5625385742212751,91105,91239,Rockingham,Rockingham,37,157,North Carolina,NC
37159,37CS056,1449,1386,1512,1687,175,238,301,651.2837833513486,157,429.00863482347796,0.7437995194575497,2.2581545853559972,3.876217475555336,0.6559601344989182,1785,1709,1862,2150,288,365,441,246.31124475756144,349,235.83311934912763,-0.4395167379816263,0.11476470162813747,0.5931696611976364,0.9548402721116214,146384,147986,Rowan,Rowan,37,159,North Carolina,NC
37163,37CS057,557,531,582,647,65,90,116,605.6362258054844,57,382.21685777509555,0.5768306423015198,2.227351366928828,3.946872907541585,0.6241887575150964,677,646,707,889,182,212,243,359.97660966575694,118,200.01695058903297,1.0944685271499766,1.6075832050592214,2.096964362665455,0.5530346111443999,59652,58995,Sampson,Sampson,37,163,North Carolina,NC
37167,37CS058,623,596,650,718,68,95,122,606.4552660944192,74,472.096843649819,-0.37556543274365545,1.323958841691925,3.035249291678435,0.7703490820933444,768,735,800,922,122,154,187,243.77524329999923,138,217.98881622595016,-0.24183085547314515,0.2501825798555905,0.7946321701248447,0.8884633677370921,62699,63306,Stanly,Stanly,37,167,North Carolina,NC
37171,37CS059,805,775,836,919,83,114,144,636.8159234476257,85,476.7647306279272,-0.20489767091190722,1.579624219069521,3.2046474280581485,0.7421329957455755,985,948,1021,1087,66,102,139,143.83136243397954,169,237.46961372546264,-1.4430050281211761,-0.9592567885401866,-0.4304656087108789,1.6350545525304925,71314,71167,Surry,Surry,37,171,North Carolina,NC
37179,37CS060,1303,1199,1406,1448,42,145,249,242.59308104983413,117,195.1227647394819,-1.1884952962438478,0.4805716265287303,2.1949300727971672,0.7988296408827523,1637,1511,1762,1997,235,360,486,148.26428492681828,292,120.15867529175513,-0.23851562832724865,0.28138436537928496,0.7890880503764799,0.8081926285564192,239849,243012,Union,Union,37,179,North Carolina,NC
37183,37CS061,5162,4674,5650,5693,43,531,1019,187.59578834882902,449,158.62081147439633,-1.5416515964112514,0.3468881749793631,2.02044904196346,0.8439563784766014,6523,5930,7115,6958,-157,435,1028,37.93103289985853,525,45.74063231850117,-0.5850726896222687,-0.08206404245509474,0.44060310481952464,1.2031259489797583,1132260,1147776,Wake,Wake,37,183,North Carolina,NC
37191,37CS062,1041,990,1091,1316,225,275,326,932.5853960109865,149,504.40508128877195,2.675839582784895,4.295450493419391,6.0545547491309435,0.5389112075235891,1273,1213,1334,1508,174,235,295,200.76091016392795,191,163.39869281045753,-0.14428172307434864,0.3643382254535387,0.8862186292566518,0.8104434571858341,118159,116892,Wayne,Wayne,37,191,North Carolina,NC
37193,37CS063,688,660,717,827,110,139,167,837.665930680464,77,465.13032710139237,1.9641783077018866,3.7698250670090503,5.331734451293655,0.5512939400594747,839,805,873,1055,182,216,250,328.7442504194598,157,238.54744359188632,0.34486678921432484,0.912494395316772,1.404882329636406,0.7222939482665043,66218,65815,Wilkes,Wilkes,37,193,North Carolina,NC
37195,37CS064,741,707,775,942,167,201,235,1016.2747002169332,110,555.5766001237421,2.8592976807223147,4.631475635604925,6.347483564900839,0.5439760941843007,904,864,945,1183,238,279,319,355.09114094405373,136,173.396402024658,1.315311476812728,1.81701963728771,2.300658072395366,0.4865681527369943,79197,78433,Wilson,Wilson,37,195,North Carolina,NC
38005,38CS001,51,50,51,91,40,40,41,2666.0478460138315,15,988.9566507334762,16.39202245364497,16.776753682357757,17.17976715001123,0.3619928659653064,60,59,60,101,41,41,42,709.411652187093,4,68.61063464837049,6.283526551705916,6.406808716571531,6.52916928949805,0.094431605879706,6067,5830,Benson and Nearby Counties,Benson,38,5,North Dakota,ND
38027,38CS001,39,38,40,32,-8,-7,-6,-1221.5337636590034,4,689.6551724137931,-20.95036942656412,-19.08385297401288,-17.373785148459838,-0.6573654031660368,48,47,49,49,0,1,2,52.63346478783025,5,214.04109589041096,-2.1382700957259178,-1.6106728825825267,-1.102723483587659,2.2426374619171328,2320,2336,Benson and Nearby Counties,Eddy,38,27,North Dakota,ND
38031,38CS001,37,37,38,52,14,15,15,1733.5073289003483,21,2499.2561737578103,-8.04152690967829,-7.653339584718668,-7.270073424124989,1.3491119183651745,46,46,46,45,-1,-1,-1,-27.646823958139898,3,89.07363420427554,-1.301772363395254,-1.169992361780025,-1.0404595819326483,43.5698401967957,3361,3368,Benson and Nearby Counties,Foster,38,31,North Dakota,ND
38039,38CS001,33,33,33,30,-3,-3,-3,-509.68738978238935,5,876.0402978537012,-14.291350272300878,-13.859041813020632,-13.48876633547595,-2.6191163959200936,40,40,41,24,-17,-16,-16,-711.4586139489768,1,43.802014892685065,-7.680511380341415,-7.547383483719043,-7.42455897662238,-0.06560560466952264,2283,2283,Benson and Nearby Counties,Griggs,38,39,North Dakota,ND
38069,38CS001,43,43,43,53,10,10,10,999.7244998424812,21,2115.336187358348,-11.56663054486512,-11.150440627753035,-10.76406566884132,1.9222381491468865,53,52,53,58,5,5,6,137.62134920479497,4,101.1378002528445,0.23299396566450487,0.36685756920373835,0.49210963049260464,0.6208360948922182,3971,3955,Benson and Nearby Counties,Pierce,38,69,North Dakota,ND
38071,38CS001,115,114,117,150,33,35,36,1197.103730854654,20,692.8206460552524,4.641932598138504,5.035147477392541,5.423283439135254,0.5624709491593837,142,140,143,126,-17,-16,-14,-136.2627949839583,16,138.2886776145203,-2.8759014247392622,-2.746440465947394,-2.6283308864114177,-1.0835993234695123,11547,11570,Benson and Nearby Counties,Ramsey,38,71,North Dakota,ND
38079,38CS001,110,105,115,159,44,49,54,1573.7467413229028,21,674.2655321881522,7.368483282433142,9.006149859126719,10.693132804100765,0.4198795595763386,133,126,139,194,55,61,68,509.3452191428967,13,107.74968918358888,3.5186218280793806,4.002252907326228,4.555008556738123,0.208158197933727,12458,12065,Benson and Nearby Counties,Rolette,38,79,North Dakota,ND
38095,38CS001,23,23,23,35,12,12,12,2224.4722205885505,4,746.9654528478059,14.373465663929514,14.781307422196562,15.158382147905662,0.30978817383338364,28,28,29,30,1,2,2,81.88851217884844,4,186.9158878504673,-1.1778089607219449,-1.0517425350072838,-0.9168549510819086,1.453269663126672,2142,2140,Benson and Nearby Counties,Towner,38,95,North Dakota,ND
38103,38CS001,55,54,55,60,5,5,6,553.8039935590268,8,815.078960774325,-3.0518020979531353,-2.616877182626252,-2.209389312581985,1.2430880040112655,66,66,67,57,-10,-9,-9,-242.711662822034,3,76.68711656441718,-3.3158624097511207,-3.1940172483479867,-3.075170950437034,-0.3531538893843711,3926,3912,Benson and Nearby Counties,Wells,38,103,North Dakota,ND
38017,38CS002,1012,933,1092,1197,105,185,264,399.9557460354006,153,331.41811210813324,-1.0087849091489598,0.627070599791607,2.529121412736081,0.8241732933786355,1267,1171,1363,1289,-74,22,118,11.888590022504712,104,55.81944556262244,-0.9719836557446062,-0.43592015927588673,0.05065537636939177,4.492396650981788,184661,186315,Cass,Cass,38,17,North Dakota,ND
38003,38CS003,111,110,112,151,39,40,41,1483.1438537616755,26,965.5556587132114,4.7704018707804385,5.17556554302126,5.570007082011887,0.6351167359809307,136,135,138,158,20,22,23,200.43050297799715,12,111.00832562442183,0.7811277189635145,0.8892421351636307,1.0169146399533133,0.52941478458307345,10771,10810,LaMoure and Nearby Counties,Barnes,38,3,North Dakota,ND
38021,38CS003,58,58,59,82,23,24,24,1913.280434791972,35,2835.7302005266356,-9.614995216354172,-9.235073617989139,-8.851577164133023,1.4219166401024774,71,70,72,66,-6,-5,-4,-100.20541168897999,5,101.9160211985324,-2.1422554783530647,-2.0189070290249522,-1.896583100933254,-1.276787806993428,4937,4906,LaMoure and Nearby Counties,Dickey,38,21,North Dakota,ND
38045,38CS003,36,36,37,50,13,14,14,1339.542082371095,14,1373.8959764474976,-0.7260278392887746,-0.34873319497955463,0.040648756985803745,0.9556357163537148,44,44,45,36,-9,-8,-8,-206.81780309263448,2,49.164208456243855,-2.6870060833646194,-2.5590822338130312,-2.441942926025024,-0.2697836305541657,4076,4068,LaMoure and Nearby Counties,LaMoure,38,45,North Dakota,ND
38073,38CS003,72,71,72,73,1,1,2,90.05597699692603,5,355.3028957186001,-3.016573752712424,-2.6479015190569815,-2.244587148197944,2.2052537878754053,88,88,89,67,-22,-21,-21,-377.182332528977,4,70.43493572812115,-4.6074102419464715,-4.476219578975005,-4.347446957424291,-0.19588461445155514,5629,5679,LaMoure and Nearby Counties,Ransom,38,73,North Dakota,ND
38077,38CS003,128,126,129,136,7,8,10,204.66341473183348,20,485.46635111353845,-3.2511667637354913,-2.7974853885331012,-2.4171463986694355,2.120526253095397,157,155,159,121,-38,-36,-34,-217.69105400251897,3,18.12141347025068,-2.4891569093264945,-2.3551099512342506,-2.2228989669509773,-0.08561948295439319,16479,16555,LaMoure and Nearby Counties,Richland,38,77,North Dakota,ND
38081,38CS003,30,30,31,38,7,8,8,808.621628821625,5,518.6721991701245,2.498234261892009,2.9074808408970787,3.3158208888092706,0.5684975603158801,37,36,37,46,9,9,10,241.09112293067957,4,104.41138084051163,1.2383098419067269,1.3683711720281033,1.492776476605174,0.3907699772080494,3856,3831,LaMoure and Nearby Counties,Sargent,38,81,North Dakota,ND
38093,38CS003,211,201,220,244,24,33,43,622.4288126569676,65,1214.2723706332897,-7.68508542499901,-5.960707596604142,-4.184896738007775,1.8940158641937446,260,249,271,248,-23,-12,-1,-56.26114751370744,15,69.54425332653345,-1.7752235017216231,-1.2562079047680799,-0.7416184887935509,-1.3471077305365238,21412,21569,LaMoure and Nearby Counties,Stutsman,38,93,North Dakota,ND
38009,38CS004,70,69,71,68,-3,-2,-1,-117.99316704333113,21,1319.5098963242224,-14.789774591522995,-14.383978393562646,-13.958726859903324,-23.9217756979279,87,86,87,64,-23,-23,-22,-352.62791456491107,4,62.61740763932373,-4.2889503667835625,-4.153247494504648,-4.021577290670754,-0.1858229089129397,6366,6388,McHenry and Nearby Counties,Bottineau,38,9,North Dakota,ND
38049,38CS004,51,50,51,80,29,29,30,2168.281234633565,11,818.3001673795798,13.065725658221156,13.502831405426717,13.895174403262956,0.36487730233653853,62,61,62,75,13,13,14,256.30166299590604,4,76.04562737642586,1.6798906125969884,1.8032595666388989,1.9406469917945826,0.27621510094169094,5377,5260,McHenry and Nearby Counties,McHenry,38,49,North Dakota,ND
38055,38CS004,96,95,97,114,17,18,19,736.6440627081745,22,906.3755278607478,-2.080290401262244,-1.68389480850396,-1.3227172098148932,1.1652423249020294,120,119,121,113,-8,-7,-6,-69.20139286005251,10,102.15548064153641,-1.8438424235417907,-1.7125670706841907,-1.5857466956288475,-1.7318643310952295,9709,9789,McHenry and Nearby Counties,McLean,38,55,North Dakota,ND
38075,38CS004,24,23,24,30,6,6,7,1122.4338699796056,12,2106.186924089513,-10.255371886780805,-9.829928520125208,-9.41274997681866,1.6227033564200923,29,29,29,31,2,2,2,88.32597813702138,4,176.444640494045,-1.011685428906111,-0.8790263799404019,-0.7568036294885709,1.332289739959044,2279,2267,McHenry and Nearby Counties,Renville,38,75,North Dakota,ND
38083,38CS004,10,10,10,18,8,8,8,2525.723435571771,3,949.367088607595,15.369044844363644,15.77053202706702,16.149298448523965,0.3340278865586239,12,12,13,19,6,7,7,516.8619946664987,3,236.77979479084453,2.6748680320497713,2.8006375470370024,2.932999119597073,0.3974225045604708,1264,1267,McHenry and Nearby Counties,Sheridan,38,83,North Dakota,ND
38101,38CS004,412,382,442,638,196,226,256,1301.4706535148384,159,914.2922860182284,2.0902745905294386,3.86680872573084,5.6116094650039505,0.6994168104291576,509,473,545,569,24,60,96,86.4312231593412,50,72.27104532839962,-0.3936924012951573,0.13668375439317348,0.7014236941749451,0.8224147166361399,69562,69184,McHenry and Nearby Counties,Ward,38,101,North Dakota,ND
38019,38CS005,39,39,39,40,1,1,1,95.87873468160045,4,432.9004329004329,-3.7642324440533343,-3.3787552061364186,-2.965292049383053,2.120981294302734,48,47,48,57,9,9,10,254.14567337626636,3,81.81074447777475,1.6075420137252698,1.7247270843079834,1.8439308415863152,0.2907111439586667,3696,3667,Northeast North Dakota,Cavalier,38,19,North Dakota,ND
38035,38CS005,456,425,488,486,-2,30,61,163.04769103648457,66,363.9873155935475,-3.6936513478689315,-2.012229585463374,-0.27131488833667605,2.159359234138025,568,530,605,536,-69,-32,6,-43.40496501370352,37,50.85421334029716,-1.4263741524005913,-0.9279453395070713,-0.4298719326423733,-1.2099351874353486,72530,72757,Northeast North Dakota,Grand Forks,38,35,North Dakota,ND
38063,38CS005,47,47,47,52,5,5,5,677.4620252034164,11,1478.494623655914,-8.41938260843712,-8.00664906736279,-7.629330304302222,1.8210963346150588,59,58,59,42,-17,-17,-16,-552.5651908100109,6,197.04433497536945,-7.620437189008098,-7.493716136331825,-7.363583116597263,-0.37913230372728557,2976,3045,Northeast North Dakota,Nelson,38,63,North Dakota,ND
38067,38CS005,67,67,68,77,9,10,10,564.6298528465101,10,587.3715124816446,-0.6528228516446665,-0.22243120258614527,0.1858172935247718,0.9422563411656563,82,82,83,84,1,2,2,23.011979743536557,5,73.78984651711924,-0.6288843834041968,-0.511319273277785,-0.39378692148633004,1.9536655033707966,6810,6776,Northeast North Dakota,Pembina,38,67,North Dakota,ND
38091,38CS005,15,14,15,13,-2,-2,-1,-370.4062339962175,5,1103.1439602868174,-15.134797666164406,-14.741612169719133,-14.345101464269874,-7.365220997279223,18,18,18,26,8,8,8,440.2797965496556,1,55.309734513274336,3.7265404557885744,3.848517771443542,3.9773004076050857,0.1116039202737943,1813,1808,Northeast North Dakota,Steele,38,91,North Dakota,ND
38097,38CS005,81,80,81,87,6,6,7,324.38235281265463,14,701.2271475081392,-4.181074856714068,-3.7630092171172596,-3.3652432515529114,1.8725856167028025,99,98,100,95,-5,-4,-3,-51.84509489598686,2,25.003125390673837,-0.8952278415238883,-0.768414611204025,-0.6463720073895258,-0.6355078965243693,7986,7999,Northeast North Dakota,Traill,38,97,North Dakota,ND
38099,38CS005,121,120,122,128,6,7,8,269.21329383625095,22,836.2634229782382,-6.053006656872233,-5.662791032279547,-5.268874241890172,2.7219877762309808,148,146,149,121,-28,-27,-25,-255.87752803976812,11,105.00190912562047,-3.7366392411908955,-3.6078834923239307,-3.492486142070557,-0.4262619220340031,10523,10476,Northeast North Dakota,Walsh,38,99,North Dakota,ND
38007,38CS006,8,8,8,4,-4,-4,-4,-1687.3378982470263,4,1713.0620985010707,-34.40866861318446,-34.00481324775079,-33.59921187769944,-1.3605747647161832,10,10,10,3,-7,-7,-7,-721.3722660942085,3,315.1260504201681,-10.492322158673838,-10.36753886516295,-10.247531262406074,-0.5112941491748497,934,952,Northwest North Dakota,Billings,38,7,North Dakota,ND
38013,38CS006,16,15,16,19,3,3,4,613.2310548115006,3,551.2172714745062,0.18370568474406274,0.6214695530004922,1.0447467375389219,0.6916410542140661,19,19,19,21,2,2,2,92.64498770137342,5,231.16042533518262,-1.5086443824106164,-1.3862840182736247,-1.2569136137164498,1.6644966712443852,2177,2163,Northwest North Dakota,Burke,38,13,North Dakota,ND
38023,38CS006,22,22,23,18,-5,-4,-4,-813.8608094417316,3,544.464609800363,-13.989291634944882,-13.579466685122652,-13.19070604708936,-0.8609870264521523,27,27,28,30,2,3,3,125.73221664992815,4,182.7318410232983,-0.6972499559011255,-0.5693950626151777,-0.44284335598905733,1.0660190323973922,2204,2189,Northwest North Dakota,Divide,38,23,North Dakota,ND
38025,38CS006,27,27,28,34,6,7,7,637.9970047758969,4,386.3801014247766,2.141273704229626,2.5102378607859768,2.9081218712620203,0.5259791633667731,33,32,33,42,9,9,10,230.20083832784613,5,123.60939431396785,0.9427724244110685,1.062937010121397,1.1849338400924665,0.48488967823737983,4141,4045,Northwest North Dakota,Dunn,38,25,North Dakota,ND
38033,38CS006,10,10,10,12,2,2,2,447.07834890936897,1,230.01725129384704,1.7663986996738195,2.1722826177007764,2.5612248402903885,0.33971163189483466,12,12,13,19,6,7,7,370.12344737499103,3,170.06802721088434,1.8675075381244721,2.0023273939508615,2.118261453309991,0.3984604756082775,1739,1764,Northwest North Dakota,Golden Valley,38,33,North Dakota,ND
38053,38CS006,66,65,68,90,22,24,25,647.5426462144898,11,299.50309713429994,3.060468295972082,3.4676638810418505,3.8621975725938364,0.4438594011896568,77,75,79,94,15,17,19,121.92766651947129,17,121.82886627490326,-0.1295924499453591,0.002742576162359727,0.13465909359260464,0.9437216278054624,14691,13954,Northwest North Dakota,McKenzie,38,53,North Dakota,ND
38061,38CS006,77,76,78,108,30,31,32,1276.7274027522228,18,730.6677491374062,5.0616043213915605,5.442801227386456,5.8727130582296905,0.5546622827889881,91,90,92,96,4,5,6,51.255177055103616,16,166.5972511453561,-1.2792272584770346,-1.1595036287680118,-1.0361046525096467,2.701540308228942,9854,9604,Northwest North Dakota,Mountrail,38,61,North Dakota,ND
38089,38CS006,213,199,228,258,30,45,59,534.9585745495069,45,539.1319974840507,-1.7537733435231326,-0.026447132982021605,1.6500651302799911,0.9857254939878282,259,242,277,266,-11,7,24,19.856874109593008,28,84.44672316554573,-1.1223772295630758,-0.6366441235407955,-0.09585278396450957,3.692010506469338,33387,33157,Northwest North Dakota,Stark,38,89,North Dakota,ND
38105,38CS006,224,207,242,193,-49,-31,-14,-308.9650847430774,31,306.9534866450479,-7.78738003181959,-6.1787848636926705,-4.409951905283972,-1.0263827949177933,265,245,285,233,-52,-32,-12,-83.15707686815549,30,77.17438839297199,-2.1272879323834504,-1.609435740806665,-1.08504496525134,-0.9576816292660636,40397,38873,Northwest North Dakota,Williams,38,105,North Dakota,ND
38015,38CS007,662,620,704,871,167,209,251,852.5512227274617,161,656.2789797103812,0.20980365811832496,1.9306992892025185,3.757497440022285,0.7661194482024689,825,774,876,888,12,63,114,64.12064687948863,87,87.99878622363829,-0.7480114770872863,-0.24245021836630687,0.26594321297643475,1.3510811028667087,98129,98865,South Central North Dakota,Burleigh,38,15,North Dakota,ND
38029,38CS007,39,39,39,52,13,13,13,1598.6148521523226,11,1343.9218081857055,2.1562712988015833,2.5447847742966503,2.963665441075848,0.7809913762107981,48,47,48,45,-3,-3,-2,-82.32973350829394,7,213.87106630003055,-3.0865614756922306,-2.961014099050474,-2.834683075482379,-4.130641138048266,3274,3273,South Central North Dakota,Emmons,38,29,North Dakota,ND
38043,38CS007,18,18,19,24,5,6,6,926.9162276669223,3,500.6257822277847,3.864478161653012,4.271733756001308,4.663034167723891,0.4576976393880564,22,22,23,35,12,13,13,528.2959331618371,6,253.05778152678195,2.6276504159280525,2.7499338712155246,2.8803285738723488,0.44359351460452007,2397,2371,South Central North Dakota,Kidder,38,43,North Dakota,ND
38047,38CS007,22,22,22,25,3,3,3,602.8773208104128,4,851.0638297872341,-2.898992333076697,-2.495905473650548,-2.064330475154966,1.0434265229349964,27,27,27,25,-2,-2,-2,-118.4585085362889,2,106.21348911311736,-2.3688203047618765,-2.244455439590611,-2.110704497569486,-1.6252581819529923,1880,1883,South Central North Dakota,Logan,38,47,North Dakota,ND
38051,38CS007,39,39,40,51,11,12,12,1849.9859156994191,4,638.4676775738228,11.71991384267795,12.120418984173869,12.491531714582589,0.31770838815736224,48,48,49,43,-6,-5,-5,-212.92939772358582,3,119.3792280143255,-3.452466759023285,-3.32052880506624,-3.1923838319230566,-0.6895100163223311,2506,2513,South Central North Dakota,McIntosh,38,51,North Dakota,ND
38001,38CS008,28,27,29,24,-5,-4,-3,-715.1858701741475,3,547.4452554744526,-14.253241889374735,-12.670383238878507,-10.979542260954322,-1.0276722792585131,34,33,35,40,5,6,7,286.4250436916282,2,92.16589861751152,1.4246194053083292,1.9556088925521913,2.4596559800362496,0.2771840092800569,2192,2170,Southwest North Dakota,Adams,38,1,North Dakota,ND
38011,38CS008,28,28,29,41,12,13,13,1702.9217030910188,6,805.0989600805098,8.556029119382789,8.985446318421651,9.374690299622022,0.43824333398149684,34,34,34,36,2,2,2,67.69975873995178,5,171.58544955387782,-1.172252055956455,-1.0376507955771526,-0.9081027340604932,1.6819324633456465,2981,2914,Southwest North Dakota,Bowman,38,11,North Dakota,ND
38037,38CS008,29,28,30,37,7,8,9,1373.8222979218983,5,875.6567425569177,3.135573885282372,5.026633206034335,6.674087341616416,0.5653214636688838,36,35,37,46,9,10,11,428.7444656598295,4,172.63703064307293,2.0564167838515646,2.570987100036056,3.0924001921010347,0.36583104161224933,2284,2317,Southwest North Dakota,Grant,38,37,North Dakota,ND
38041,38CS008,24,24,24,38,14,14,14,2222.8377864334684,8,1292.4071082390954,8.907418165677111,9.310914063201551,9.723141797089628,0.542028706061925,29,29,30,24,-6,-5,-5,-218.11067442574344,6,246.30541871921181,-4.780357574173277,-4.645024554029721,-4.5048917107401,-1.3910862806532918,2476,2436,Southwest North Dakota,Hettinger,38,41,North Dakota,ND
38057,38CS008,66,65,67,60,-7,-6,-5,-297.3796799077086,6,288.6697137358672,-6.278447142439432,-5.848372647806586,-5.449311640325949,-1.1580693998007487,82,81,83,91,8,9,10,112.60407403480782,10,120.13455069678041,-0.20145399031853298,-0.0752551607253245,0.06295303722420743,0.9640261009833802,8314,8324,Southwest North Dakota,Mercer,38,57,North Dakota,ND
38059,38CS008,280,265,294,326,32,46,61,560.3819408924462,61,737.9181031875643,-3.4758634580226233,-1.7554581628836772,-0.0819933599961039,1.2889872922239254,348,331,365,369,4,21,38,62.17381063391863,32,95.3232052427763,-0.8342710526961155,-0.3247953572872701,0.1453091250397726,1.4630746323419583,33066,33570,Southwest North Dakota,Morton,38,59,North Dakota,ND
38065,38CS008,11,10,11,16,5,5,6,1153.067995592454,2,425.75838211814795,6.877893023753744,7.262494446384937,7.659299634467972,0.31169461475435856,13,13,13,13,-0,-0,0,-3.0435197932306894,5,267.0940170940171,-2.816971267054196,-2.701316934656184,-2.5697874569927297,5.30208463101195,1879,1872,Southwest North Dakota,Oliver,38,65,North Dakota,ND
38085,38CS008,33,32,33,53,20,20,21,2050.525492427045,3,305.88835075197557,17.031974681661225,17.439182398577195,17.8319953577783,0.1421091832002188,39,38,39,57,18,18,19,484.22229345847967,5,133.01409949454643,3.3868284093876104,3.5110735235773647,3.644598773668968,0.26039068169595975,3923,3759,Southwest North Dakota,Sioux,38,85,North Dakota,ND
38087,38CS008,9,9,9,4,-5,-5,-5,-2814.5734228445544,4,2259.8870056497176,-52.41141361050317,-50.78436677789207,-49.11095235632562,-1.0045720690681408,11,10,11,2,-9,-9,-8,-1266.9811128539488,2,289.01734104046244,-16.084390357346006,-15.556384240839206,-15.068935632101274,-0.2574827943566884,708,692,Southwest North Dakota,Slope,38,87,North Dakota,ND
39001,39CS001,305,294,317,347,30,42,53,605.5028936027729,30,436.7606915377616,0.04219520654850509,1.7278864993663015,3.4239644163221814,0.70438276340024,375,360,389,515,126,140,155,509.68094248986506,95,345.128242389014,1.1637751700779326,1.6532967499799305,2.1501835023769087,0.6723532358020083,27475,27526,Adams+Brown,Adams,39,1,Ohio,OH
39015,39CS001,457,438,475,544,69,87,106,802.0927667471648,30,275.1662462737904,3.544820655223866,5.264204019643245,6.981948141280852,0.3391817159228594,560,538,583,681,98,121,143,276.98766900772296,118,270.28884256820214,-0.44465245801039105,0.06981863327065085,0.6003246838852425,0.9678119947642083,43610,43657,Adams+Brown,Brown,39,15,Ohio,OH
39003,39CS002,969,925,1013,1178,165,209,253,820.3986039490939,172,674.0076021787687,-0.12708620201221116,1.4556254208878996,3.192263524783403,0.8176555808945828,1184,1132,1237,1359,122,175,227,171.79919823980603,215,211.34998574616372,-0.8971144982588853,-0.40516063197346863,0.12725336295780706,1.2232160461753114,102076,101727,Allen,Allen,39,3,Ohio,OH
39005,39CS003,489,467,512,570,58,81,103,614.6012791630573,69,525.164113785558,-0.7819758700092662,0.9010414120872443,2.5593138083197693,0.8440271412494733,598,571,625,725,100,127,154,242.45639813264813,104,198.73497544476504,-0.030695598471446692,0.43329273593682577,0.9709417144117548,0.8132633384567255,52555,52331,Ashland,Ashland,39,5,Ohio,OH
39007,39CS004,1034,992,1076,1111,35,77,119,315.40942521384915,125,513.5684792210193,-3.5907119312182365,-2.011171582453351,-0.2519906121579523,1.6073226627050583,1265,1215,1316,1543,227,278,328,285.2483141148286,229,235.23852570160662,0.0028220953352986024,0.48071910067671914,1.02860757015529,0.8217206125023959,97358,97348,Ashtabula,Ashtabula,39,7,Ohio,OH
39009,39CS005,415,388,442,494,52,79,106,501.43254268705977,25,159.25849245911039,1.8371220748667227,3.3765138017977527,5.003851382679272,0.3136226634062952,514,482,546,648,102,134,166,216.48503420787372,77,123.99555548398526,0.4178692062950889,0.9113252718999866,1.4196470668041008,0.5685382394996877,62791,62099,Athens+Hocking,Athens,39,9,Ohio,OH
39073,39CS005,273,261,285,328,43,55,67,790.0421392771865,42,599.058622165169,0.1462294941592836,1.9429594007108588,3.571123358116223,0.7448148334175895,336,322,351,434,83,98,112,347.6711512495493,68,242.1393725741552,0.5261439134097032,1.0527846688076574,1.5638603278870131,0.6894000426202282,28044,28083,Athens+Hocking,Hocking,39,73,Ohio,OH
39011,39CS006,416,396,436,541,105,125,145,1080.9725781943032,66,570.6134094151213,3.4683904428500534,5.188747103896978,6.843801185687284,0.5236819563111931,507,483,531,609,78,102,126,220.93174571912556,86,186.2278042442616,-0.19753354621466687,0.35097529428217783,0.8584521052423191,0.8347384750329071,46266,46180,Auglaize+Mercer,Auglaize,39,11,Ohio,OH
39107,39CS006,355,337,373,456,83,101,119,953.9002745346852,75,709.6056957683847,0.8260006526500246,2.4415328620085286,4.027279836979819,0.736593231485799,434,413,456,460,4,26,47,60.24714362364057,37,87.40226300994496,-0.755832384013088,-0.28275727368653697,0.28778238895102337,1.3959933995533034,42277,42333,Auglaize+Mercer,Mercer,39,107,Ohio,OH
39013,39CS007,741,712,769,879,110,138,167,833.1534103183209,98,591.2251331010663,0.6270469715058484,2.4281519720050206,4.017756045128186,0.7045218911742493,901,867,935,1119,184,218,252,330.7518866421504,166,251.87770275396406,0.29130285730254046,0.7795987639736647,1.2943983292746217,0.75805306638261,66303,65905,Belmont,Belmont,39,13,Ohio,OH
39017,39CS008,3004,2837,3172,3648,476,644,811,660.8055210505784,399,409.7129698799356,0.7651684389256663,2.4846918332901224,4.235591251561462,0.619058523095549,3699,3498,3901,4220,319,521,722,133.44839153934285,547,140.15327182304304,-0.5758270978825012,-0.04735239153099857,0.45326164117694895,1.04823063635412,389541,390287,Butler,Butler,39,17,Ohio,OH
39019,39CS009,275,263,286,331,45,56,68,843.3087206608166,27,404.0101750710758,2.5957749388591407,4.400989068922511,6.181972094585704,0.4707250692116729,338,324,351,398,47,60,74,226.65279269500041,81,303.47308081375746,-1.272057059754014,-0.7689416141831971,-0.2483543915436269,1.3171610478997857,26732,26691,Carroll+Harrison+Tuscarawas,Carroll,39,19,Ohio,OH
39067,39CS009,169,163,175,198,23,29,35,790.1192881873917,17,466.6163452960955,1.4626755820905393,3.2458469692616605,4.954864320525133,0.5707375288192654,207,199,214,288,74,81,89,561.5488856942643,46,317.70149872228745,1.927206338196348,2.444203821480915,2.9296882873815417,0.5588854927912864,14573,14479,Carroll+Harrison+Tuscarawas,Harrison,39,67,Ohio,OH
39157,39CS009,949,909,989,1157,168,208,248,897.246915702329,178,766.8447354816474,-0.5537326108693507,1.3302976222290805,2.975573069595741,0.8505800623347926,1163,1115,1211,1374,163,211,259,227.74362153665044,266,287.3128685921669,-1.1118721883274905,-0.6058099282009834,-0.11350904248120862,1.2556077537456067,92848,92582,Carroll+Harrison+Tuscarawas,Tuscarawas,39,157,Ohio,OH
39021,39CS010,350,334,367,432,65,82,98,843.8881362835889,36,371.7376151999381,3.07500952826892,4.72818344584738,6.448603196451477,0.43518080523946545,428,408,448,502,54,74,94,190.94500975887254,77,198.96640826873386,-0.5986413473783406,-0.07895088742808937,0.46426656142394,1.0280961483204487,38737,38700,Champaign+Logan+Madison+Shelby,Champaign,39,21,Ohio,OH
39091,39CS010,440,420,459,473,14,33,53,291.1439912220216,43,373.96995194920964,-2.5245729295661246,-0.8039934786926615,0.8505661879680257,1.2472276749889755,537,513,561,624,63,87,111,188.5517427933367,98,212.8630074502053,-0.744897077100277,-0.24932608049728067,0.2562726248226664,1.1160798573254773,45993,46039,Champaign+Logan+Madison+Shelby,Logan,39,91,Ohio,OH
39097,39CS010,362,343,381,395,14,33,52,299.3182590228481,45,408.84931631308774,-2.867319055327668,-1.1187765655885358,0.7668682616783045,1.3256948102711807,447,424,470,557,87,110,133,248.67991185923026,68,153.4850126399422,0.453798114588398,0.9641475501726521,1.460811219783175,0.6116474871540852,44026,44304,Champaign+Logan+Madison+Shelby,Madison,39,97,Ohio,OH
39149,39CS010,396,375,416,518,102,122,143,1015.2717012667086,54,448.38394951528863,3.91619190502332,5.672870890675965,7.464183770190124,0.4380567152572136,483,459,508,597,89,114,138,236.6264430442177,104,216.6756948206175,-0.3502340913939887,0.20856328416938538,0.6780122868297348,0.907694771921215,48173,47998,Champaign+Logan+Madison+Shelby,Shelby,39,149,Ohio,OH
39023,39CS011,1505,1447,1563,1775,212,270,328,796.8371947138413,209,616.9514040072322,-0.0037039030311174378,1.8166878339613253,3.55040028317925,0.7713925986230482,1836,1766,1906,2135,229,299,369,220.5867298065159,235,173.2450643586984,-0.05344703500063869,0.4887620512426731,0.9957505920496121,0.7827669348859297,135505,135646,Clark,Clark,39,23,Ohio,OH
39025,39CS012,1600,1510,1690,1865,175,265,355,508.4343448244005,147,282.0414428242517,0.5260639274247018,2.316430828081498,3.8710627299420253,0.5526399297886307,1977,1869,2086,2409,323,432,540,205.9855552252235,288,137.47344805365285,0.1528703207174829,0.6646298491765553,1.197104768577104,0.6658506313922353,208480,209495,Clermont,Clermont,39,25,Ohio,OH
39027,39CS013,388,370,406,475,69,87,105,831.6175695284948,45,428.8573334604022,2.2622047965058174,4.019245403322108,5.825636359494777,0.5098478149476766,475,454,497,574,77,99,120,235.1202132551293,85,202.39059002809657,-0.1905264195006023,0.3190127351999722,0.8234093546358536,0.8521663161692364,41972,41998,Clinton+Fayette+Highland,Clinton,39,27,Ohio,OH
39047,39CS013,321,309,333,336,3,15,27,207.1555246619238,31,429.5116037409075,-3.8723619514782537,-2.206615570464366,-0.5890765135488983,1.9433969961743491,392,377,407,441,34,49,64,169.10106305640554,65,224.82792016879387,-1.0355117185931364,-0.5608561810901191,-0.061814636543623,1.3028974265471638,28870,28911,Clinton+Fayette+Highland,Fayette,39,47,Ohio,OH
39071,39CS013,431,413,450,486,36,55,73,505.5917390059542,41,378.7878787878788,-0.4351872450419564,1.274094204445283,2.991765081542005,0.7357526457947636,528,506,550,642,92,114,136,262.9876502126531,102,235.29954554891694,-0.24135379106705163,0.2680946602198317,0.7642897055522672,0.8869371133131997,43296,43349,Clinton+Fayette+Highland,Highland,39,71,Ohio,OH
39029,39CS014,1105,1061,1148,1284,136,179,223,706.3159750765452,161,633.8395519817328,-0.9800554491860781,0.694129319141655,2.4740516327083375,0.892413929877316,1348,1295,1400,1625,225,277,330,273.661315622917,251,247.64930490464022,-0.2297578919118166,0.2615953552748046,0.7709249115165696,0.9016972100502375,101603,101353,Columbiana,Columbiana,39,29,Ohio,OH
39031,39CS015,360,345,376,426,50,66,81,718.8916699329777,37,404.8693749145123,1.392148740088588,3.152531769515702,4.849607628802185,0.5547416638579079,444,425,463,550,87,106,125,290.4987674806583,98,267.70104895104896,-0.2995772643331739,0.24805732215017587,0.7689743442230473,0.9129375366853828,36555,36608,Coshocton+Holmes,Coshocton,39,31,Ohio,OH
39075,39CS015,295,276,314,372,58,77,96,694.557674100927,75,679.086402426602,-1.4704711563990527,0.1739777407348024,1.866507605579929,0.9651430739079252,368,345,391,418,27,50,73,113.32324952272113,77,173.97198373248983,-1.087418572256325,-0.6280842557002363,-0.052547731754345496,1.5051741758365997,44177,44260,Coshocton+Holmes,Holmes,39,75,Ohio,OH
39033,39CS016,488,470,506,584,78,96,114,918.5158988496506,75,717.154331612163,0.47084217038542414,2.0185425184195074,3.8019339277083284,0.7727307027482756,596,574,617,722,105,126,148,302.41603733891975,100,239.3546997295292,0.10999677157661654,0.6265231513029565,1.1307678873782454,0.7852597556955854,41832,41779,Crawford+Richland,Crawford,39,33,Ohio,OH
39139,39CS016,1292,1238,1346,1455,109,163,217,524.2745213053242,141,453.47462873774856,-1.0870544959713149,0.7147313093227142,2.3515830990038076,0.8596827750296,1591,1526,1656,1784,128,193,258,154.27784783417246,281,224.54312266766817,-1.2238089653855786,-0.7046064068093799,-0.15705024516066352,1.4479466245512822,124373,125143,Crawford+Richland,Richland,39,139,Ohio,OH
39035,39CS017,11937,11396,12478,13820,1342,1883,2424,599.4698273039852,1496,476.20411840166037,-0.5493085355739628,1.217839270881595,2.9983193945483992,0.7939538684165174,14539,13893,15185,15985,800,1446,2092,115.57378445642321,1677,134.03325815109233,-0.7019253357992143,-0.18224809533613473,0.32527393975479585,1.1589188055377622,1256604,1251182,Cuyahoga,Cuyahoga,39,35,Ohio,OH
39037,39CS018,542,520,564,607,43,65,87,502.3519368741093,98,757.487922705314,-4.236579973749144,-2.539862721218417,-0.7542872937337579,1.4850333977626193,663,637,690,727,37,64,90,123.45711003437239,106,205.2712097445729,-1.3379580615528177,-0.820353634407912,-0.31799481261918383,1.63701464183094,51750,51639,Darke+Preble,Darke,39,37,Ohio,OH
39135,39CS018,414,396,431,486,55,72,90,705.3201971009399,70,683.9778195764222,-1.5300898955295872,0.23126610033560244,2.0658157140712268,0.9564901868482153,507,486,529,631,102,124,145,302.18080489918555,92,225.04341870306502,0.26103140369324773,0.770583140433172,1.2873220379125667,0.7387509023918144,40937,40881,Darke+Preble,Preble,39,135,Ohio,OH
39039,39CS019,352,335,368,409,41,57,74,599.4432854713284,70,733.3298412864701,-3.0561913197340576,-1.2651134082111892,0.328790337125524,1.2023388827313148,432,412,452,486,34,54,74,141.32451035398265,65,170.35328650801972,-0.8362014345732767,-0.28106698868598634,0.21223583406338906,1.1834582360868893,38182,38156,Defiance+Williams,Defiance,39,39,Ohio,OH
39171,39CS019,368,353,384,368,-16,-0,15,-4.734115854507817,51,552.0227303477202,-7.234885691661969,-5.635372862853299,-3.9085630447173316,90.64622147318832,450,431,469,517,48,67,86,183.0452238010791,87,236.66385571665623,-1.044150283172928,-0.5464033427055744,-0.0588132006679623,1.2739925242234407,36955,36761,Defiance+Williams,Williams,39,171,Ohio,OH
39041,39CS020,1050,957,1142,1241,99,191,284,356.2384802617447,89,165.67309347964687,0.17392298777474186,1.9357460350878335,3.633032033037111,0.46264480515120104,1339,1225,1452,1526,74,187,301,85.20184828977885,132,60.024009603841534,-0.27038051036790484,0.2584637705760744,0.7296938405120217,0.7007519172775718,214881,219912,Delaware,Delaware,39,41,Ohio,OH
39043,39CS021,827,795,859,1025,166,198,230,1053.6623986269635,114,606.4878236929256,2.8243241847874616,4.499221376686078,6.138439977760839,0.5727080876650614,1006,967,1044,1136,92,130,169,174.07170014899134,111,148.12640119568698,-0.2644444612572693,0.2569002546049621,0.7790515378463805,0.844476561519782,75187,74936,Erie,Erie,39,43,Ohio,OH
39045,39CS022,1214,1146,1283,1439,156,225,293,564.1432342472235,136,341.50689919268774,0.5141742286950574,2.200482184792556,3.784869673836175,0.6026723710050891,1511,1428,1594,1816,222,305,388,189.44943524077752,221,137.42499144980255,0.017601117531575252,0.5141071124830033,1.0082116953068376,0.7230182291830934,159294,160815,Fairfield,Fairfield,39,45,Ohio,OH
39049,39CS023,8660,8091,9229,10063,834,1403,1972,424.3238459394807,1033,312.3259134512542,-0.5325621440552493,1.1461366183856008,2.6734824116155216,0.7355314335365379,10669,9987,11352,11859,507,1190,1872,90.01834347984489,1056,79.89148073866332,-0.35946247111490837,0.10458853130170331,0.6191775853278683,0.886756967766972,1322977,1321793,Franklin,Franklin,39,49,Ohio,OH
39051,39CS024,378,360,396,450,54,72,90,678.6899600825013,47,441.968168888262,0.7387205007466916,2.393274854665823,3.955996945897121,0.6423082682630852,463,441,485,545,60,82,104,192.81140107933868,103,242.49558563861095,-1.0259648769671523,-0.5073933781303519,0.015366825987465832,1.2425111169641254,42537,42475,Fulton+Henry,Fulton,39,51,Ohio,OH
39069,39CS024,255,244,267,315,48,60,71,865.2887043315759,50,726.7705948617319,-0.22979402769627905,1.410080829113751,3.1278817333240156,0.8260407750322737,313,299,328,370,42,57,71,205.56104627458947,45,163.33345432107728,-0.08471182043828408,0.41738270650334974,0.9157238416287523,0.7807874395731852,27519,27551,Fulton+Henry,Henry,39,69,Ohio,OH
39053,39CS025,324,311,336,381,45,57,70,784.7292507071257,30,409.766091855899,1.874562781033455,3.7444988028077675,5.505258751585046,0.5132417196191524,395,380,410,439,29,44,59,150.07783281499957,63,216.02715769982512,-1.1696953631717595,-0.6401355268657385,-0.17581923725832807,1.4072803810466732,29285,29163,Gallia+Meigs,Gallia,39,53,Ohio,OH
39105,39CS025,251,242,261,299,38,48,57,857.1358166030233,22,396.03960396039605,2.9801892695668286,4.628579774782756,6.256073150973995,0.4525455155455622,306,295,318,380,62,74,85,334.51749553496836,49,222.1315562808831,0.5757477855218681,1.1125044111245062,1.640107818042148,0.6551571656158452,22220,22059,Gallia+Meigs,Meigs,39,105,Ohio,OH
39055,39CS026,732,691,773,887,114,155,196,653.3529675905988,118,496.3718582395625,-0.2798502430367973,1.5622903950951057,3.140097837550411,0.754869865959357,904,855,953,1095,142,191,240,200.11493531685733,109,114.09908825407459,0.33928074681107645,0.8814276990992953,1.3816153673356737,0.567200810150086,95090,95531,Geauga,Geauga,39,55,Ohio,OH
39057,39CS027,1320,1248,1393,1595,202,275,347,652.8430166702757,169,401.7615699605965,0.7643134501212128,2.5349636552922337,4.178768255406399,0.6131702077410369,1629,1542,1716,1913,197,284,371,168.8622413728048,255,151.46475326094705,-0.3629489340154475,0.18220978850449177,0.6922980568605356,0.8938282262418362,168259,168356,Greene,Greene,39,57,Ohio,OH
39059,39CS028,407,391,424,458,34,51,67,528.1830195696242,38,395.3185955786736,-0.3761302854411796,1.2959715742769005,2.9464759109507153,0.7339932572482141,497,477,517,656,139,159,179,414.83062057370023,74,193.20139940473084,1.685245638866014,2.212521803824742,2.693565407423707,0.46282274859868267,38450,38302,Guernsey+Monroe+Noble,Guernsey,39,59,Ohio,OH
39111,39CS028,146,140,152,163,11,17,23,511.9055901225644,27,805.7897485637544,-4.523142100253777,-2.953043414785637,-1.2375577725490838,1.4873839628675276,178,171,185,235,50,57,64,428.73960124355455,37,277.5069376734418,1.00953616034596,1.5038502806739857,1.9975961289615332,0.6361339447502656,13403,13333,Guernsey+Monroe+Noble,Monroe,39,111,Ohio,OH
39121,39CS028,120,118,121,135,14,15,17,435.7113898793016,32,904.4657998869417,-5.096069310353864,-4.677713358703027,-4.297430693844792,1.9493807975161086,148,146,149,162,13,14,16,102.15539092460209,19,134.15236884840783,-0.44868826804950224,-0.31966899937889326,-0.19180345515905367,1.2283211009498116,14152,14163,Guernsey+Monroe+Noble,Noble,39,121,Ohio,OH
39061,39CS029,6946,6590,7302,7950,648,1004,1360,485.03382544878707,802,387.49811263777747,-0.8944870643997249,0.9577788139169736,2.6931953212551796,0.7981144233405778,8496,8069,8923,9038,115,542,969,65.56270944653211,928,112.25503181970487,-0.9632428712943316,-0.46704317355680997,0.01694401494981145,1.7090248629456046,827875,826689,Hamilton,Hamilton,39,61,Ohio,OH
39063,39CS030,663,631,695,766,71,103,135,548.2077721319421,96,512.4304415709196,-1.324549630339612,0.29960185611976387,2.039242413074784,0.9257240081746647,811,772,849,920,71,109,148,146.05800098648456,136,182.1078989301161,-0.8728715319790847,-0.369248760245412,0.16298883649610407,1.235492325430518,74937,74681,Hancock,Hancock,39,63,Ohio,OH
39065,39CS031,267,254,280,340,60,73,86,944.5669319213063,47,610.2311088029084,1.6200682107093796,3.342013499712963,5.018389730819212,0.6372834253421693,327,311,343,486,143,159,175,519.7303417043878,80,261.13069591330463,2.125413337314127,2.5657165467382215,3.0856713833814595,0.4992991478771075,30808,30636,Hardin+Wyandot,Hardin,39,65,Ohio,OH
39175,39CS031,218,209,227,274,47,56,65,1028.1220622347644,34,622.9958772331653,2.3891815012395137,4.006247237381758,5.638528682110088,0.5953448076006924,266,254,277,304,27,38,50,177.0142677088231,49,225.5050853697823,-0.9778724115025192,-0.4755112375503187,0.022677369224362594,1.241655875170004,21830,21729,Hardin+Wyandot,Wyandot,39,175,Ohio,OH
39077,39CS032,527,502,553,652,99,125,150,852.8579838266857,79,541.0310407999042,1.4902758834554735,3.0961610439172595,4.753493603083758,0.6293206514503863,649,619,679,733,54,84,114,144.16510014066256,107,183.28822501627326,-0.9091548937524869,-0.3882264647106331,0.08878541226894827,1.2564480715391775,58407,58378,Huron,Huron,39,77,Ohio,OH
39079,39CS033,373,359,387,405,18,32,46,393.60058815592254,36,441.8668876001105,-2.0328881047820873,-0.4632155209741408,1.2539507117963116,1.0886781611128429,458,441,475,519,44,61,78,187.7809025448363,80,245.92683676606208,-1.115942437113039,-0.5816503342977707,-0.05720603929233127,1.2885533636688442,32589,32530,Jackson+Pike+Vinton,Jackson,39,79,Ohio,OH
39131,39CS033,315,304,327,363,36,48,59,704.4982828331598,14,206.17797577408786,3.10029381499888,5.028004860411511,6.644081058016477,0.2866667526730563,387,373,401,481,80,94,108,346.36844783282794,74,273.23413211239523,0.19767449275104354,0.7436215363784998,1.2820910177587377,0.7805333569359445,27161,27083,Jackson+Pike+Vinton,Pike,39,131,Ohio,OH
39163,39CS033,137,132,143,163,20,26,31,798.9805546222717,10,312.25604996096797,3.1618883139626073,4.901187891794165,6.636634708899011,0.376118686115876,168,162,175,226,51,58,64,454.3666843512014,35,275.3953890943426,1.2664169142571702,1.7961224260460038,2.3027924367920494,0.59579070211623,12810,12709,Jackson+Pike+Vinton,Vinton,39,163,Ohio,OH
39081,39CS034,783,755,811,867,56,84,112,512.889883859646,91,558.8822355289421,-2.0823901361327275,-0.5203135024335013,1.3206853110377994,1.0767791409951852,951,918,985,1178,193,227,260,349.9135370604555,170,262.20405645099095,0.38768564130892563,0.8762414581399541,1.374524118660621,0.7460510582078841,65130,64835,Jefferson,Jefferson,39,81,Ohio,OH
39083,39CS035,532,505,559,642,83,110,137,699.3039866953256,73,465.6948741666933,0.5699463477796517,2.2979880038399707,4.108878219570012,0.6599204330614277,650,618,683,816,133,166,198,263.2159906851139,125,198.79767168166927,0.08828291862416275,0.6409484243680801,1.177190425522612,0.7507284289884881,62702,62878,Knox+Morrow,Knox,39,83,Ohio,OH
39117,39CS035,276,261,291,320,29,44,59,501.41376236209084,26,296.81212363366535,0.19971156996508777,2.058864547199665,3.7276269855515842,0.578773370243681,338,320,356,416,60,78,96,222.1748938144104,58,165.1292563489352,0.07082906042674951,0.5733042214506949,1.132875866633937,0.7338362163313132,35039,35124,Knox+Morrow,Morrow,39,117,Ohio,OH
39085,39CS036,2183,2083,2283,2476,193,293,393,504.9565598680317,246,424.17449780153464,-0.8232491343031811,0.8649748924022657,2.403207685990555,0.8371630796350422,2675,2555,2795,3088,293,413,533,177.981932719236,359,154.6887051391983,-0.2976251242569806,0.23701169068123007,0.7535049996910836,0.8670268466435334,231980,232079,Lake,Lake,39,85,Ohio,OH
39087,39CS037,703,678,728,814,86,111,136,764.5668151103996,59,405.02505663485965,1.8202091092588102,3.6277149440358545,5.4001074885429325,0.5250303878912673,851,821,880,1088,208,237,267,412.29440297188785,137,238.07455035189852,1.2106890556098626,1.7509969971520485,2.2487988675945467,0.5750146139361861,58268,57545,Lawrence,Lawrence,39,87,Ohio,OH
39089,39CS038,1477,1401,1554,1618,64,141,217,314.6442533124044,156,349.30586654724584,-2.026303849927416,-0.3169470633451545,1.2956746614316912,1.1023167314271056,1830,1737,1923,2179,256,349,442,193.70098356036948,247,137.10796558423536,0.05277021888208473,0.5651786890409009,1.1044444316988604,0.7058104334620475,178640,180150,Licking,Licking,39,89,Ohio,OH
39093,39CS039,2763,2628,2898,3103,205,340,475,434.07305403055693,314,401.1203265170556,-1.4777847532039106,0.3282853700457128,2.03867728085485,0.9213732838053225,3412,3249,3575,4045,470,633,796,200.70885694115358,497,157.6426555016335,-0.11421448077023828,0.4236955938252768,0.9993373691734491,0.7841902038188145,313123,315270,Lorain,Lorain,39,93,Ohio,OH
39095,39CS040,3935,3750,4120,4860,740,925,1110,860.1298742465954,591,549.3841505926098,1.4301104492504864,3.0711095195220937,4.831246277506426,0.6380327691936887,4823,4601,5045,5498,453,675,897,157.19289651721041,602,140.19072459043116,-0.30168672481734216,0.17563378195258475,0.6611768426004961,0.8905195335993162,430300,429415,Lucas+Ottawa,Lucas,39,95,Ohio,OH
39123,39CS040,429,412,446,506,60,77,94,766.1445325847246,54,536.2063401434848,0.6812226828941981,2.3233843841150907,4.073321421288831,0.6909214159281016,523,503,544,626,82,103,123,255.8867865696742,72,179.43030876965634,0.23574616775427099,0.7578538633132573,1.2719910368979932,0.694446515146154,40283,40127,Lucas+Ottawa,Ottawa,39,123,Ohio,OH
39099,39CS041,2566,2468,2664,3285,621,719,817,1263.2424599906203,476,835.9640149103665,2.532059397922534,4.288431433267629,5.89409721493772,0.6608418044690488,3118,3001,3235,3624,389,506,623,222.83604680251204,459,202.26055919095776,-0.30072993701310213,0.2154458058629243,0.7455195916748788,0.9058740017541469,227761,226935,Mahoning,Mahoning,39,99,Ohio,OH
39101,39CS042,665,637,693,709,16,44,72,270.78556907962445,111,679.8242256281484,-5.901353097935415,-4.069163602382265,-2.3312381389444576,2.455035757164446,814,780,847,934,87,120,154,184.24630214961994,120,183.7615999509969,-0.48839353325957274,-0.009573191244695967,0.4691137322999308,0.9891480547970579,65311,65302,Marion,Marion,39,101,Ohio,OH
39103,39CS043,1338,1259,1416,1593,177,255,334,559.824429503109,182,399.44691964971577,-0.0967763997702209,1.5777523918444194,3.266442840655602,0.7107353712622484,1653,1559,1748,2004,256,351,445,191.59073543985068,245,133.870271510767,0.07563937263814657,0.5723875303161011,1.0968501069079133,0.6967433169255254,182252,183013,Medina,Medina,39,103,Ohio,OH
39109,39CS044,989,943,1036,1096,60,107,153,392.7568665233467,130,478.81695380337203,-2.618662891474248,-0.837428306660857,0.8573163157582789,1.2077915058912678,1219,1163,1275,1465,190,246,302,225.37586437023498,257,235.35014056905285,-0.6159565371668128,-0.09946747245804846,0.39759162886585964,1.0400302792918232,108601,109199,Miami,Miami,39,109,Ohio,OH
39113,39CS045,5413,5182,5643,6341,698,928,1159,692.9548795755654,692,516.5219857732528,0.13553506021711714,1.7971609556059553,3.4745472474097903,0.7445884659481343,6624,6347,6900,7364,464,740,1017,138.15608045636282,886,165.3123863010887,-0.792213904021192,-0.2678534837488393,0.20210458499491152,1.1949487047271525,535892,535955,Montgomery,Montgomery,39,113,Ohio,OH
39115,39CS046,149,144,155,188,33,39,44,1113.1463912604715,16,462.22735808175645,4.793662770610879,6.505742561042767,8.225224256898642,0.4047398851840676,182,175,189,267,78,85,92,622.459654570087,36,262.94646117887663,3.0762628891590844,3.584718206028215,4.073713983985698,0.41753192761395214,13846,13691,Morgan+Perry,Morgan,39,115,Ohio,OH
39127,39CS046,312,296,327,372,45,60,76,679.8264836390173,36,405.15446513983454,0.8917907394037163,2.752380276632074,4.551398327245507,0.5862620987081046,383,365,402,491,89,108,126,303.64960252209005,66,186.14095947203654,0.6720388442118767,1.1704847330262762,1.697486648561476,0.6073710575493523,35542,35457,Morgan+Perry,Perry,39,127,Ohio,OH
39119,39CS047,865,828,902,983,81,118,155,548.4483878967447,84,389.31695730258963,-0.1374293414951938,1.6074399842554687,3.2626259670946918,0.7039031706887191,1059,1015,1104,1181,77,122,166,140.99742315122427,165,190.97664297784672,-1.0179514568267896,-0.4973442731147354,0.017956517393372208,1.3434408541255687,86305,86398,Muskingum,Muskingum,39,119,Ohio,OH
39125,39CS048,182,173,190,204,14,22,31,477.56652860623547,28,595.9982971477224,-2.780657559199258,-1.2095731814962054,0.48465467746732405,1.1947392806175294,223,213,233,220,-13,-3,7,-16.3910555807208,42,222.68172419277874,-2.892264733883858,-2.4028543746770135,-1.9059815895274255,-20.081118221351463,18792,18861,Paulding+Putnam+Van Wert,Paulding,39,125,Ohio,OH
39137,39CS048,272,257,287,350,63,78,93,911.7831418384508,81,944.7441317976383,-2.051709389540146,-0.3224880648023961,1.3345551328248286,1.023063034737909,334,317,352,381,29,47,64,135.63923403168397,56,163.13688932909955,-0.8167837528512392,-0.2677555649777615,0.20436381337792695,1.1774382677046895,34295,34327,Paulding+Putnam+Van Wert,Putnam,39,137,Ohio,OH
39161,39CS048,282,269,294,342,48,60,73,837.2629181438925,56,778.642936596218,-1.2033922376859598,0.5319418680728274,2.2133151341993997,0.9147942790742897,344,330,359,402,43,58,72,200.15434014114385,66,229.54126525927728,-0.825691375875237,-0.2867233031864377,0.2505402864041521,1.1272344074860323,28768,28753,Paulding+Putnam+Van Wert,Van Wert,39,161,Ohio,OH
39129,39CS049,530,505,556,627,71,97,122,658.3428221637431,83,565.7226595780935,-0.7725872291897157,0.850434553020394,2.6808698344068245,0.8505077215416751,658,627,688,766,78,108,139,183.1774968175733,104,175.58669593111597,-0.43649130063241726,0.051132920879348495,0.5537265181464686,0.9498061135501298,58686,59230,Pickaway,Pickaway,39,129,Ohio,OH
39133,39CS050,1286,1217,1356,1453,97,167,236,411.9518988163882,125,308.76967634762525,-0.5443434190677678,1.0594908129923395,2.7602590420851176,0.7450609148523947,1584,1501,1668,1947,279,363,446,223.43371936423017,250,154.04238013962402,0.17210457519480551,0.6997488476894902,1.2154795428320122,0.6875360702313758,161933,162293,Portage,Portage,39,133,Ohio,OH
39141,39CS051,749,715,782,948,166,199,233,1037.332462143431,102,530.414321186672,3.3083014751531494,5.078672280350685,6.8812858977161175,0.5087748046350874,916,877,956,1146,190,230,269,298.5286023492922,154,200.2470580586438,0.45113591387015894,0.9752078145962072,1.501939899568468,0.6678710850367294,76921,76905,Ross,Ross,39,141,Ohio,OH
39143,39CS052,586,561,611,633,22,47,72,320.1823781090569,87,592.0985469765543,-4.467762258198644,-2.713512417255438,-0.9959663899104113,1.810764769492689,718,687,748,860,112,142,173,242.2035786449321,115,195.80467206974052,-0.08620057676014455,0.4486871246193524,0.9898419007747458,0.8027866844630535,58774,58732,Sandusky,Sandusky,39,143,Ohio,OH
39145,39CS053,876,845,908,1092,184,216,247,1167.2031189467139,66,357.3604060913706,6.437835399800423,8.089306455842658,9.869860647019745,0.30475440978344476,1068,1030,1106,1314,208,246,284,334.98315051314245,142,193.45785479761855,0.9079279701251806,1.4193012569184358,1.9338664551249438,0.5751759356772105,73875,73401,Scioto,Scioto,39,145,Ohio,OH
39147,39CS054,521,498,545,609,64,88,111,637.3958187219604,76,552.5765700263564,-0.8472859801892737,0.8857650343315723,2.5509197551732536,0.8571509702623513,638,610,666,774,108,136,164,247.87671078026793,129,234.89566262427618,-0.37814275911798523,0.11984272472818108,0.6508603422863585,0.9407205182291651,55015,54918,Seneca,Seneca,39,147,Ohio,OH
39151,39CS055,3753,3593,3914,4484,570,731,891,781.855275164758,643,688.1181893823256,-0.8390835130922076,0.8775759110371284,2.7155601346875184,0.878906408220355,4599,4406,4792,5406,614,807,1000,215.9258787126606,796,212.88545371880934,-0.46679590693344997,0.039625585536965276,0.5842677687161392,0.9846994856774016,373773,373910,Stark,Stark,39,151,Ohio,OH
39153,39CS056,5004,4772,5236,5794,558,790,1022,585.5473656552917,651,482.65124555160145,-0.6526319485963145,1.0512393100555832,2.6300662701826307,0.823231271040056,6112,5835,6390,7035,645,923,1200,171.51398317828938,805,149.6532877247123,-0.30834942456588726,0.22902325214932628,0.750947423021121,0.871598051515449,539520,537910,Summit,Summit,39,153,Ohio,OH
39155,39CS057,2225,2138,2311,2647,336,422,509,840.9282295538736,353,702.79875168607,-0.3375649163362076,1.3176327104474757,3.0451931738207003,0.833767678228547,2721,2617,2825,3260,435,539,643,267.81549252719554,435,216.0470833643746,-0.003924175528871783,0.5283093284859,1.0426400822194375,0.8052079690027084,200911,201345,Trumbull,Trumbull,39,155,Ohio,OH
39159,39CS058,377,350,404,412,8,35,62,225.06714159179288,27,172.28177641653903,-1.2773656746345252,0.5587198972422405,2.2230343667639474,0.7443651058982104,479,446,512,493,-19,14,47,21.673707340866898,56,86.56001236571605,-1.1920767576855797,-0.6439515007118705,-0.11640395539792,3.727914197631833,62688,64695,Union,Union,39,159,Ohio,OH
39165,39CS059,1615,1510,1719,1888,169,273,378,450.85217012241696,208,343.38448331366027,-0.6261545152043866,1.0898182227151265,2.9120790666467045,0.7588556098241953,2024,1897,2151,2351,200,327,454,132.7350069254544,291,118.27585506127177,-0.363017894692896,0.14000717816893607,0.6741495134164746,0.8883473347453107,242294,246035,Warren,Warren,39,165,Ohio,OH
39167,39CS060,636,610,662,696,34,60,86,403.25334845059757,80,536.4447126668008,-3.0200518075772496,-1.30381003020692,0.4495720067109714,1.3085328871684345,774,743,804,877,73,103,134,174.0042080274758,88,148.0210593598089,-0.2947571706582067,0.25631484134972804,0.8269315897093515,0.8425306265206544,59652,59451,Washington,Washington,39,167,Ohio,OH
39169,39CS061,1009,959,1060,1153,93,144,194,492.2705894544692,156,534.8051903529372,-2.204980128962658,-0.3737338703224729,1.3254577488921546,1.0788913757735867,1242,1182,1303,1494,191,252,312,215.50841988029865,208,178.19050964199127,-0.14058620796116852,0.3733811312738169,0.9362587743514668,0.8235639920920116,116678,116729,Wayne,Wayne,39,169,Ohio,OH
39173,39CS062,1013,956,1070,1197,127,184,241,557.3579266453764,145,439.1444255158054,-0.6082704420620911,1.2280300535760114,2.8758762717544144,0.7836456062894998,1250,1181,1318,1361,43,111,180,84.160521127135425,152,114.77415165289881,-0.8299429741460171,-0.29993828948522305,0.21283631836967704,1.3516259959195414,132075,132434,Wood,Wood,39,173,Ohio,OH
40001,40CS001,191,182,199,241,42,50,59,1011.9826360969014,28,564.9432534678436,2.803417037889327,4.425675634759601,6.099410025148787,0.5473412085480402,230,220,240,345,105,115,125,591.9394952316342,61,314.2062429174822,2.3065371515505455,2.7775705121965535,3.3132596697338568,0.5262289158254482,19825,19414,Adair+Cherokee+Sequoyah,Adair,40,1,Oklahoma,OK
40021,40CS001,405,384,425,514,89,109,130,922.5375043566929,52,438.90190120487017,3.076508390357345,4.805825924488895,6.474012232757567,0.47144179165500316,498,473,522,636,114,138,163,291.0260054772369,72,151.42911224682945,0.8858824085295457,1.391862226149494,1.9356347690747968,0.5165951350355321,47391,47547,Adair+Cherokee+Sequoyah,Cherokee,40,21,Oklahoma,OK
40135,40CS001,420,403,437,560,123,140,157,1411.3387766723552,54,545.1379249425838,6.928194700443127,8.582023447271624,10.374721003139344,0.3835126740375831,512,492,532,693,161,181,201,458.8538759188944,108,273.6186060652124,1.3252978882791335,1.8617934025866945,2.3989781415024756,0.5930344370440049,39623,39471,Adair+Cherokee+Sequoyah,Sequoyah,40,135,Oklahoma,OK
40005,40CS002,150,144,156,180,24,30,36,843.5639612533109,20,566.331587144273,1.0616026835518688,2.810369717612043,4.456434851995793,0.6495518144580972,185,177,192,195,3,10,18,73.01572015566315,33,230.73695986575302,-2.1202159649009515,-1.5751652652582298,-1.0736088744090788,2.88393264465405,14126,14302,Atoka+Bryan+Coal,Atoka,40,5,Oklahoma,OK
40013,40CS002,436,416,456,524,68,88,108,758.6280319330997,68,583.1903945111492,0.18995664346304403,1.7383444045749736,3.410315766908057,0.7601499990826547,536,511,560,716,156,180,205,384.00595152118177,110,234.10730627620407,0.9838542819781513,1.4953963759548086,1.9874023345077176,0.60628482641961845,46640,46987,Atoka+Bryan+Coal,Bryan,40,13,Oklahoma,OK
40029,40CS002,70,70,71,93,22,23,23,1709.8119084822163,10,752.8703180877094,9.183490359491937,9.56086870225852,9.987723974628992,0.4217527113455038,85,85,86,93,7,8,8,146.32931672490704,6,113.72251705837756,0.20530676200262435,0.3253184513580503,0.4591220624227387,0.6880469811919304,5313,5276,Atoka+Bryan+Coal,Coal,40,29,Oklahoma,OK
40009,40CS003,206,196,215,249,34,43,53,776.072565119096,49,882.6045841401359,-2.7632172144186096,-1.0072930366535535,0.6304131877431052,1.1114738237323674,252,240,263,301,38,49,61,222.42389678618343,46,208.30503101933613,-0.4141529197760628,0.1423753309205583,0.6878520431994298,0.9178363087059022,22207,22083,Beckham+Custer+Roger Mills+Washita,Beckham,40,9,Oklahoma,OK
40039,40CS003,261,248,273,341,68,80,93,1130.694110584988,72,1011.6977552956055,-0.5825414785801548,1.2093908210684596,2.8138358310323,0.8837752874447256,318,304,333,333,0,15,29,52.199307258888055,55,195.02854508705366,-1.9385089357685006,-1.4317689132352291,-0.8899798606403623,3.4985660179206284,28467,28201,Beckham+Custer+Roger Mills+Washita,Custer,40,39,Oklahoma,OK
40129,40CS003,30,30,30,47,17,17,17,1972.5672330295974,11,1276.472294749057,6.561729185495868,6.949489536278055,7.372890808666794,0.6111587091485001,36,36,37,52,15,16,16,460.64114045422957,3,88.4433962264151,3.5894178472540594,3.72451293423446,3.8458339745942975,0.18045169783843162,3447,3392,Beckham+Custer+Roger Mills+Washita,Roger Mills,40,129,Oklahoma,OK
40149,40CS003,119,118,120,138,18,19,20,695.327038100638,20,733.2722273143905,-0.7825587722472931,-0.376710292796749,0.024001871371392144,1.0017508117746685,146,145,148,163,15,17,18,152.80322565511304,27,247.41134426830388,-1.0712808281190476,-0.9485449443874054,-0.8225249562356647,1.5275453757893245,10910,10913,Beckham+Custer+Roger Mills+Washita,Washita,40,149,Oklahoma,OK
40015,40CS004,298,286,309,413,104,115,127,1703.0453952459561,81,1195.1750341215095,3.300239167753677,5.136882234448286,6.733943216206973,0.6957588700897808,358,344,371,438,67,80,94,303.89812733331985,73,276.10726578161047,-0.24487391763229577,0.25632240222779323,0.7989441703881481,0.8973832881442662,27109,26439,Caddo+Grady,Caddo,40,15,Oklahoma,OK
40051,40CS004,482,458,505,608,103,126,150,919.2097955589512,92,668.8720055254644,0.8259568617198824,2.51173986122621,4.098854049758625,0.7219496394583024,598,570,627,750,123,152,180,273.9678459798626,114,205.75760310441296,0.18910321969203575,0.6880608574725994,1.1929640974485554,0.7461129231529283,55018,55405,Caddo+Grady,Grady,40,51,Oklahoma,OK
40017,40CS005,984,917,1051,1086,35,102,169,262.2931639698179,157,404.759142529358,-3.093244390440293,-1.5382765916852268,0.24613594882221895,1.5281354472194801,1257,1174,1340,1358,18,101,184,62.91828588622029,186,115.6515034695451,-1.073632826336434,-0.5144201610688601,0.012283247186416687,1.8201350236668845,155154,160828,Canadian,Canadian,40,17,Oklahoma,OK
40019,40CS006,482,461,503,590,87,108,129,898.6352980612445,51,424.2928452579035,3.0434713518558416,4.734178083778939,6.417719248768254,0.46782139677059104,587,562,612,817,205,230,255,477.4594561585748,153,317.1050177205745,1.0705691779734843,1.5971354480647788,2.1426810140484807,0.6612801494150395,48080,48249,Carter+Johnston+Love+Marshall,Carter,40,19,Oklahoma,OK
40069,40CS006,121,117,126,125,-1,4,8,148.95104474109087,19,734.1576506955178,-7.420410605140197,-5.8205301854808695,-4.1077968588015805,3.9136097121120694,146,141,152,177,25,31,36,296.64414013413773,34,330.4499951404413,-0.7962953917653854,-0.33419549825835443,0.18217673886617838,1.0786214955665892,10352,10289,Carter+Johnston+Love+Marshall,Johnston,40,69,Oklahoma,OK
40085,40CS006,100,99,101,119,18,19,20,748.7971079601405,17,669.554942890902,0.38892035988839885,0.7864379922824154,1.1698767804382098,0.8494920644370887,123,122,125,148,23,25,26,242.7946932501539,25,244.9779519843214,-0.15327161359662864,-0.018213006325895603,0.1134658018574739,0.9698493826704649,10156,10205,Carter+Johnston+Love+Marshall,Love,40,85,Oklahoma,OK
40095,40CS006,159,153,166,220,54,61,67,1556.7271148779685,19,487.11703627740036,8.940260221438011,10.698207134711073,12.550312155836759,0.30784116264976336,194,186,202,267,65,73,81,471.4648491806325,34,218.55113453750724,1.9742715380371068,2.5290381863713933,3.0621841739662083,0.4573224867316289,15602,15557,Carter+Johnston+Love+Marshall,Marshall,40,95,Oklahoma,OK
40023,40CS007,170,164,176,232,56,62,68,1731.7873431971618,22,616.5487283682478,9.456637693538907,11.163048923918756,12.895335858682712,0.3503491443291113,206,199,214,295,81,89,96,619.6303556274593,54,377.86019172906026,1.9177014391709546,2.4312647137955694,2.9356526092563633,0.6030058224008824,14273,14291,Choctaw+McCurtain+Pushmataha,Choctaw,40,23,Oklahoma,OK
40089,40CS007,325,312,338,476,138,151,164,1945.248094174385,84,1081.0115179203397,6.9424820486912315,8.667731533792452,10.343873725419472,0.552066788625269,392,376,408,602,194,210,226,680.1227049422982,114,369.29057337220604,2.5824288200709176,3.0960436455582916,3.6305428981345593,0.540402482912023,31082,30870,Choctaw+McCurtain+Pushmataha,McCurtain,40,89,Oklahoma,OK
40127,40CS007,138,133,143,159,16,21,26,778.7479264249741,10,369.24213052709314,2.3776047003320615,4.106457831781973,5.80782521846671,0.4526844949780162,167,161,172,253,81,86,92,799.157999068949,45,416.20421753607104,3.3442620235290716,3.838736624536392,4.378143870030391,0.5148449072899988,10833,10812,Choctaw+McCurtain+Pushmataha,Pushmataha,40,127,Oklahoma,OK
40027,40CS008,1824,1697,1951,2071,120,247,374,335.0380242810442,238,323.2498837047425,-1.6430140725732285,0.0748115376746183,1.7900254322708051,0.9609200915530732,2274,2121,2428,2571,143,297,450,99.71160883774759,309,103.91200099540299,-0.5778263346544996,-0.0413159490326603,0.4478415871344624,1.0386225758940684,294509,297367,Cleveland,Cleveland,40,27,Oklahoma,OK
40031,40CS009,883,831,935,1077,142,194,246,639.8732470598793,92,303.53018805674697,1.6964605233546475,3.378679907805666,5.241863940420741,0.471926572745635,1092,1029,1155,1431,276,339,402,278.3233479733122,224,183.7164860941383,0.4101330942906114,0.9403013922643247,1.4376354844533328,0.6581434959017113,121240,121927,Comanche,Comanche,40,31,Oklahoma,OK
40033,40CS010,62,61,62,84,22,22,23,1591.869953196149,13,936.5994236311238,6.162776684200528,6.554698323466661,6.926703226130878,0.5628886243863856,75,74,76,107,31,32,33,582.0113754319121,15,273.2738203680087,2.9663981506646375,3.0844465158057495,3.216199851509768,0.4552821231300389,5552,5489,Cotton+Jefferson+Stephens,Cotton,40,33,Oklahoma,OK
40067,40CS010,65,64,65,88,23,23,24,1711.6964415653836,5,368.052999631947,13.051764557292374,13.428206886299254,13.847047710816673,0.20615669522280491,79,78,80,97,17,18,19,328.7890057382029,12,221.32054592401326,0.9479647351943377,1.073018958976607,1.195867250948903,0.6373845175793309,5434,5422,Cotton+Jefferson+Stephens,Jefferson,40,67,Oklahoma,OK
40137,40CS010,484,465,502,541,39,57,76,534.1343885553672,56,522.5586712079504,-1.6178062179567931,0.10276907506078106,1.7337059735109466,0.9615300126624698,597,574,619,698,79,101,124,235.39410878406778,110,255.3744718391605,-0.6891841534272798,-0.1977173548361934,0.3187833573771101,1.0742852799665135,42866,43074,Cotton+Jefferson+Stephens,Stephens,40,137,Oklahoma,OK
40035,40CS011,172,166,178,196,18,24,30,689.6413340110165,19,537.558353373886,-0.197733485397175,1.5191334599309785,3.228160255242183,0.7487574679975781,209,201,216,225,9,16,24,116.10585742577722,27,191.21813031161474,-1.2544068411768567,-0.7561876765903647,-0.26810291771134553,1.5522462753500061,14138,14120,Craig+Mayes,Craig,40,35,Oklahoma,OK
40097,40CS011,402,385,419,470,51,68,85,690.1049889784969,53,538.3716796180609,-0.06252970763561566,1.4668742686334262,3.259463603671279,0.7688136053894186,489,469,509,652,143,163,183,415.6899668637239,86,219.69600204368376,1.4178597429916078,1.954490099563408,2.483756773790483,0.5252811799456467,39378,39145,Craig+Mayes,Mayes,40,97,Oklahoma,OK
40037,40CS012,733,703,764,801,37,68,98,376.88471031662607,100,557.55345543754,-3.5300237235272243,-1.822896465077649,-0.039487611578196795,1.4578076098486918,898,861,935,1072,137,174,211,241.50437323257864,188,261.1401266807423,-0.6864139737496436,-0.18092906267362185,0.3264938173846309,1.075122292267535,71742,71992,Creek,Creek,40,37,Oklahoma,OK
40041,40CS013,450,433,468,612,144,162,179,1586.1753802764215,88,861.8367896579585,5.578477320033331,7.219873845464411,8.96708313119786,0.540008484107349,551,530,573,751,178,200,221,487.6470842480752,118,288.42393429800546,1.4909351386633982,1.9797373909109925,2.5002969480739177,0.5885105530375433,40843,40912,Delaware+Ottawa,Delaware,40,41,Oklahoma,OK
40115,40CS013,360,347,373,408,35,48,61,634.7084807365204,53,698.195231194836,-2.370749370965735,-0.6605201587824403,1.0149547552418228,1.0776580572078578,438,423,454,566,112,128,143,420.9536998588386,74,244.05527522179347,1.2613276110506086,1.7874088702678133,2.2638650951992227,0.5752605112533653,30364,30321,Delaware+Ottawa,Ottawa,40,115,Oklahoma,OK
40047,40CS014,600,573,627,709,82,109,136,698.584637189158,128,820.9469751631472,-3.0927144890844773,-1.2277119368353613,0.54739243828867,1.1644666265526809,730,698,762,862,100,132,164,213.28686523436636,92,148.31772235567234,0.1539094076296228,0.6581938999105698,1.1524942402462193,0.690174046523192,62367,62029,Garfield,Garfield,40,47,Oklahoma,OK
40049,40CS015,285,274,296,361,65,76,87,1169.9833887058683,47,724.581823787867,2.700256555150066,4.423217032390021,6.191069761019112,0.6112551118385412,349,336,362,454,92,105,118,407.3822729871764,72,279.3079370005431,0.765109479692896,1.2879750477165834,1.7635465234192136,0.6791491620728354,25946,25778,Garvin+McClain+Murray,Garvin,40,49,Oklahoma,OK
40087,40CS015,349,331,367,389,22,40,58,383.84752675427745,62,592.6067528495305,-3.9015976219132726,-2.0449367179700797,-0.38992581426855044,1.5063501941312474,444,422,466,438,-28,-6,16,-14.049482289657268,51,117.84278386247054,-1.878298136284544,-1.314518058219248,-0.8126239285941143,-10.038708185373194,41849,43278,Garvin+McClain+Murray,McClain,40,87,Oklahoma,OK
40099,40CS015,165,159,171,183,12,18,24,508.6361781908993,16,460.96225871506766,-1.1988272839218626,0.47663731956571964,2.1543610607856176,0.8576898605678095,201,193,208,242,34,41,49,301.43088834549053,42,305.6768558951965,-0.5494622155854473,-0.05758035027530088,0.49494940588192265,0.990178278815198,13884,13740,Garvin+McClain+Murray,Murray,40,99,Oklahoma,OK
40053,40CS016,50,50,51,66,15,16,16,1492.1472501887656,5,477.6689754000477,9.725245983168415,10.139500965837815,10.549693527714544,0.30085953146791156,61,61,62,70,8,9,9,214.00888458377554,4,96.71179883945841,1.049185771352871,1.174749343937763,1.3058305007334472,0.4060333524573853,4187,4136,Grant+Kay,Grant,40,53,Oklahoma,OK
40071,40CS016,500,481,518,606,88,106,125,977.2665980061448,102,936.2307533445007,-1.334109035393354,0.43822300397937214,2.1398430552465135,0.9490954278300764,614,591,637,681,44,67,90,153.44285121376035,90,205.9308072487644,-1.021262441055863,-0.5294188718210885,-0.034879996638305225,1.3223497261799904,43579,43704,Grant+Kay,Kay,40,71,Oklahoma,OK
40061,40CS017,137,132,142,152,10,15,20,502.33919679156054,13,443.76173408431475,-1.1860516527847922,0.5567171408773532,2.3279029271422695,0.8271810801956752,166,160,172,197,25,31,37,264.1591956603083,34,293.2551319648094,-0.8203672026841952,-0.297366095039404,0.2755357551565013,1.0750438418460406,11718,11594,Haskell+Latimer+Pittsburg,Haskell,40,61,Oklahoma,OK
40077,40CS017,116,115,117,100,-17,-16,-15,-679.4944329089936,10,419.1993292810731,-11.390600991513892,-10.991937397835851,-10.589941956434862,-0.6574907391899146,140,139,142,168,26,28,29,291.7481314743917,27,286.25954198473283,-0.06849824507703448,0.05652275372434629,0.17688774709476096,0.9467809597230328,9542,9432,Haskell+Latimer+Pittsburg,Latimer,40,77,Oklahoma,OK
40121,40CS017,509,490,528,586,58,77,96,703.5426613493877,52,475.8745338488641,0.5803818258222495,2.2623557751978156,3.930579536535664,0.6677121887113368,619,597,642,810,168,191,213,437.0561944749659,136,311.59071642953694,0.7653223945437321,1.2589992444523088,1.7816686019786125,0.7092127674985262,43709,43647,Haskell+Latimer+Pittsburg,Pittsburg,40,121,Oklahoma,OK
40063,40CS018,167,161,173,183,10,16,22,477.4492702145977,26,780.31212484994,-4.713876949344118,-3.007888991183145,-1.333741777396488,1.5376781702693272,205,198,212,229,17,24,31,176.79484847227727,29,216.49869354236654,-0.9256476133455745,-0.39128394956218776,0.12244028138583328,1.1749610158221,13328,13395,Hughes+Okfuskee+Pontotoc+Seminole,Hughes,40,63,Oklahoma,OK
40107,40CS018,153,149,158,174,16,21,25,727.6862345739747,28,987.8285411889223,-4.32129118601533,-2.643938849704583,-0.7613019573322055,1.2947218714032562,186,180,192,191,-1,5,11,45.97473779858197,30,267.78541462108365,-2.744785668532582,-2.2142821123223855,-1.713334291267402,4.8776126699069655,11338,11203,Hughes+Okfuskee+Pontotoc+Seminole,Okfuskee,40,107,Oklahoma,OK
40123,40CS018,376,360,393,429,36,53,69,554.7328750289283,43,451.13570791585795,-0.6454642393309672,1.0341100539480959,2.7540602454838936,0.7981532740370443,463,443,483,599,116,136,156,356.58287536560414,79,207.0773263433814,0.9773030578004674,1.4828566163245593,1.977595265461931,0.5764893054095938,38126,38150,Hughes+Okfuskee+Pontotoc+Seminole,Pontotoc,40,123,Oklahoma,OK
40133,40CS018,282,272,292,353,61,71,81,1197.6935461502483,41,693.9449075445351,3.457709867412086,5.014064199950659,6.758243806427044,0.5713272140756869,345,333,357,428,71,83,95,351.4968082097689,62,263.18023601324387,0.4143849183637372,0.8747491404527876,1.3981868317238488,0.7398072041214778,23633,23558,Hughes+Okfuskee+Pontotoc+Seminole,Seminole,40,133,Oklahoma,OK
40079,40CS019,524,503,545,630,85,106,127,874.0119594858178,59,487.49251203238936,2.063526116601603,3.869160971147564,5.653401177333112,0.552540606670555,643,618,668,798,130,155,180,320.4329035984127,104,214.76066575806385,0.5589590351935687,1.0457471561890639,1.609303357422871,0.6659288606183797,48411,48426,Le Flore,Le Flore,40,79,Oklahoma,OK
40081,40CS020,321,307,335,382,47,61,75,723.5338385153867,50,593.1022211678182,-0.2945760451601937,1.3203575780571446,3.067463975596006,0.8065073995216022,393,376,411,485,74,92,109,271.22129855625127,69,204.2870677404074,0.13878631584029716,0.6546137047934822,1.2165657417334925,0.745078386335883,33721,33776,Lincoln+Logan,Lincoln,40,81,Oklahoma,OK
40083,40CS020,343,322,365,366,1,23,44,183.21825353828737,31,249.96472272058378,-2.5627690261724934,-0.696244913377117,0.9869775570298749,1.3067889504672932,430,404,456,509,53,79,105,155.8012449817006,84,165.62820411704394,-0.6088371935473871,-0.1119614543045609,0.4016561300149107,1.0497879506428274,49607,50716,Lincoln+Logan,Logan,40,83,Oklahoma,OK
40091,40CS021,249,241,258,306,48,57,65,1187.9030291602282,34,713.0872483221476,2.937402390555188,4.760794727647245,6.42604859660812,0.5898761660141436,308,298,318,416,98,108,118,563.9923410633824,67,348.9401593666997,1.6623799354791458,2.152780887274712,2.64102909143166,0.6130356855680931,19072,19201,McIntosh+Okmulgee,McIntosh,40,91,Oklahoma,OK
40111,40CS021,426,410,442,538,96,112,128,1211.5265606928488,57,617.0500676589986,4.190581261065816,5.994700617783082,7.715969293809301,0.5048055448991285,522,503,541,670,129,148,167,401.18280328272033,103,279.7468698226459,0.6916213909275499,1.2092167343975706,1.7475320309655,0.6926162572128925,36950,36819,McIntosh+Okmulgee,Okmulgee,40,111,Oklahoma,OK
40003,40CS022,51,51,52,66,14,15,15,1018.3755753243132,5,350.5082369435682,6.248934138121242,6.668426045481794,7.0810324763489545,0.32201706166154515,64,63,64,53,-11,-11,-10,-186.69531443847825,2,35.02626970227671,-2.3464481352334747,-2.215345288347807,-2.096257415744592,-0.20703285527891238,5706,5710,Major and Nearby Counties,Alfalfa,40,3,Oklahoma,OK
40011,40CS022,104,103,105,135,30,31,32,1406.3607427690035,17,772.3761926397092,5.9410306222398495,6.34320247639407,6.731356639842375,0.5320147720936601,125,124,126,162,36,37,38,432.37404794290734,21,244.64119291705498,1.7549417803030427,1.8783938195365228,2.013108088336122,0.5509643568103407,8804,8584,Major and Nearby Counties,Blaine,40,11,Oklahoma,OK
40043,40CS022,54,53,54,61,7,7,8,658.3912871348607,13,1149.4252873563219,-5.293012874361538,-4.91517461211377,-4.497199846199585,1.5391162625829076,64,64,65,85,20,21,21,463.82867182829324,10,226.03978300180833,2.250646454116076,2.379618690464969,2.515224549334893,0.464688755868069,4524,4424,Major and Nearby Counties,Dewey,40,43,Oklahoma,OK
40073,40CS022,138,132,145,152,7,14,20,361.336715140251,33,864.666579326608,-6.721318781093656,-5.056144633227679,-3.2716728176205105,2.231174606244511,170,162,177,173,-4,3,11,22.717072701930757,19,125.03290339563043,-1.54863489587016,-1.0186491657779861,-0.4776266230926741,4.267662042111544,15266,15196,Major and Nearby Counties,Kingfisher,40,73,Oklahoma,OK
40093,40CS022,89,88,90,99,9,10,11,518.5399398112617,20,1035.732780942517,-5.569167868402417,-5.1650338252092025,-4.777426102588893,1.816034565696946,109,108,110,120,10,11,12,143.7003695395591,14,182.29166666666666,-0.5057751363029969,-0.3852290253951064,-0.2610555292348728,1.1631589301577336,7724,7680,Major and Nearby Counties,Major,40,93,Oklahoma,OK
40151,40CS022,84,84,85,93,8,9,9,396.6222546513672,3,139.2757660167131,2.1790907860699984,2.573553849153411,2.9607349292450746,0.3143585346406107,104,103,105,100,-5,-4,-3,-44.728744648457436,21,244.64119291705498,-3.017422884718853,-2.896526433666986,-2.7759859789464536,-7.395628035531368,8616,8584,Major and Nearby Counties,Woods,40,151,Oklahoma,OK
40101,40CS023,751,723,780,896,116,145,173,871.9019116878026,108,650.2009301485529,0.5133506826783129,2.174006189056282,3.8970394989579167,0.740613306049962,912,878,947,1150,203,238,272,359.0938386758515,185,279.6758783334341,0.2953386556523838,0.781880066328978,1.2968744632241245,0.7755727537053071,66441,66148,Muskogee,Muskogee,40,101,Oklahoma,OK
40103,40CS024,118,117,119,123,4,5,6,186.37958374707742,12,438.63657132413414,-2.9223433234218246,-2.519557977697565,-2.1134773930543935,1.9675745477604838,145,143,146,178,32,33,35,305.88531610324213,23,210.46852122986823,0.8369008495481097,0.9548047956303568,1.0906421112947462,0.6680774265244857,10943,10928,Noble+Osage+Pawnee,Noble,40,103,Oklahoma,OK
40113,40CS024,388,368,407,442,35,54,74,473.2235077998398,43,374.57261699949913,-0.7567791068543408,0.9532979985836395,2.6082620073139546,0.7772272328708676,477,453,500,616,116,139,163,304.7662568467043,99,216.3130639980772,0.3619981495001956,0.8722188123635389,1.386895502853639,0.7047147485283275,45919,45767,Noble+Osage+Pawnee,Osage,40,113,Oklahoma,OK
40117,40CS024,174,167,181,211,30,37,44,946.4375254971567,26,663.0116027030473,1.1094772891259526,2.8582743325868885,4.594918971919024,0.6821542340874795,214,206,222,258,36,44,52,281.4692134767991,31,197.30142566191446,0.34616097520567723,0.8351160165502441,1.342013047008921,0.685470026073594,15686,15712,Noble+Osage+Pawnee,Pawnee,40,117,Oklahoma,OK
40105,40CS025,106,105,107,120,13,14,15,607.5876079036718,14,594.6692152490177,-0.25310968540750584,0.13356088825746218,0.5200810055735678,0.9147856721171865,128,127,129,164,35,36,37,388.2102086687855,21,225.75790152655344,1.4988561923684371,1.627004560246895,1.7463657816924303,0.565865175791884,9417,9302,Nowata+Washington,Nowata,40,105,Oklahoma,OK
40147,40CS025,556,534,579,598,19,42,64,316.47526648373116,70,533.5772543638997,-3.8690055152462985,-2.189132745234517,-0.45083855608859547,1.6463464316091487,683,656,711,786,75,103,130,194.36824885737542,135,255.94357865999316,-1.1201340801507471,-0.6145469018088553,-0.11121958675350631,1.3040772263794256,52476,52746,Nowata+Washington,Washington,40,147,Oklahoma,OK
40109,40CS026,6263,5920,6606,7521,915,1258,1601,630.8994181721248,864,433.37162118103794,0.1345383561822353,1.9542066082617764,3.7412817790553397,0.6863651107157941,7705,7293,8117,8951,834,1246,1658,156.06937042064624,1058,132.51702179892482,-0.30552973283020435,0.22640150689241875,0.7343406346116957,0.8484096278080213,797468,798388,Oklahoma (county),Oklahoma (county),40,109,Oklahoma,OK
40007,40CS027,44,43,44,56,12,12,13,980.7743981332438,10,791.765637371338,1.4891781551206098,1.8905454345735628,2.290520640557343,0.7469832717300404,52,52,53,63,10,11,11,212.38662298683187,8,160.481444332999,0.38941578589451825,0.523784303162284,0.642849586054105,0.6904007364134497,5052,4985,Oklahoma Panhandle,Beaver,40,7,Oklahoma,OK
40025,40CS027,24,24,24,22,-2,-2,-2,-368.7428199852994,0,0,-4.071424807362382,-3.6882225474450205,-3.2484482831407697,-0,29,29,29,31,2,2,2,80.25320205047035,4,177.46228926353152,-1.105755343968203,-0.9754537156709582,-0.848862367425725,1.4240413626748514,2265,2254,Oklahoma Panhandle,Cimarron,40,25,Oklahoma,OK
40045,40CS027,42,42,42,44,2,2,2,208.78764858703832,6,637.6195536663124,-4.727140917767463,-4.28513944949723,-3.8536943031208244,2.0238191552424425,51,51,52,50,-2,-1,-1,-29.712577217932495,5,132.9787234042553,-1.7518050475107956,-1.6251309054942893,-1.5030791223545616,-42.66469944156037,3764,3760,Oklahoma Panhandle,Ellis,40,45,Oklahoma,OK
40059,40CS027,29,29,30,51,21,22,22,2595.9465655308977,7,845.1554482342287,17.11773229533958,17.50112650489455,17.909554341216374,0.31109828792990746,35,34,35,38,3,3,4,106.47096907136222,7,219.36696960200564,-1.253892825837387,-1.130658032094048,-1.0026883594507532,1.591817648664575,3313,3191,Oklahoma Panhandle,Harper,40,59,Oklahoma,OK
40139,40CS027,157,154,159,159,0,2,5,47.164562313258145,38,720.9258205274142,-7.14367209683704,-6.749492645817586,-6.323942518427532,10.900608005250255,189,187,192,162,-30,-27,-25,-130.18253440315652,25,119.46860365096053,-2.6268530913490347,-2.493767662309789,-2.3755552571166976,-0.9526713937912997,21084,20926,Oklahoma Panhandle,Texas,40,139,Oklahoma,OK
40153,40CS027,171,162,180,215,35,44,53,866.286050326075,28,550.9099852434825,1.3815840296118702,3.22459297344764,4.8740240630929215,0.6218216515153486,209,199,219,251,32,42,52,207.36887567151513,34,168.05891948000593,-0.13164964867199158,0.3838780903691891,0.9421641673513408,0.7915666076953316,20330,20231,Oklahoma Panhandle,Woodward,40,153,Oklahoma,OK
40119,40CS028,512,477,547,568,21,56,91,272.86453731041917,55,269.4526436978701,-1.819587832503631,0.012658075930298503,1.803989304587161,0.970078763717491,638,595,680,764,84,126,169,154.22285311134306,82,100.08421720716213,0.05278561931791965,0.5319869619571167,1.0540294741935992,0.6438627959473382,81647,81931,Payne,Payne,40,119,Oklahoma,OK
40125,40CS029,732,701,764,850,86,118,149,648.8664820958629,79,435.6277312893754,0.4964108247974586,2.1401287782683855,3.9113208337467396,0.6657098738197764,900,863,938,1142,204,242,279,331.37358797880677,146,200.178240899431,0.8039518376566235,1.32439621430609,1.8739187009543838,0.6015971339350773,72539,72935,Pottawatomie,Pottawatomie,40,125,Oklahoma,OK
40131,40CS030,792,751,833,929,96,137,178,575.5424002621934,114,479.6718035028665,-0.8735574992133331,0.9196846504704961,2.6859983157156124,0.8273769108563572,983,933,1033,1125,92,142,192,146.88380841414363,167,173.06775550811452,-0.7545325041946306,-0.25644948745544155,0.2363141842856267,1.170008038399139,95065,96494,Rogers,Rogers,40,131,Oklahoma,OK
40055,40CS031,57,56,57,73,16,16,17,1163.8752460512276,19,1377.0610617865555,-2.5253751142595178,-2.1325981484262275,-1.725531361744807,1.1138097413628216,70,69,70,97,27,27,28,499.3261971562944,4,72.89958082741025,4.131809619956604,4.262041151736972,4.392077917207993,0.14085484873493267,5519,5487,Southwest Oklahoma,Greer,40,55,Oklahoma,OK
40057,40CS031,25,24,25,39,14,14,15,2332.2539161692716,6,965.4062751407884,13.270126654708184,13.672913803708289,14.08119085139986,0.3872227317776702,29,29,30,45,15,16,16,643.5342948745263,7,288.659793814433,3.4210410279791863,3.546633019586756,3.683091535029428,0.42154183180767313,2486,2425,Southwest Oklahoma,Harmon,40,57,Oklahoma,OK
40065,40CS031,220,210,231,281,50,61,71,985.0491917636298,55,890.9768346023004,-0.6220664113858256,0.9435742770736034,2.5880315538569327,0.8898655966298973,272,259,285,287,2,15,28,61.32352587426938,35,141.29995962858297,-1.3058633882204689,-0.8188182376930695,-0.29658345668077535,2.161850006505541,24692,24770,Southwest Oklahoma,Jackson,40,65,Oklahoma,OK
40075,40CS031,126,122,129,160,31,34,38,1611.8487584287157,27,1268.4989429175475,1.7076325800444903,3.4721739162295977,5.249523026298629,0.764694868912531,152,147,156,140,-16,-12,-7,-140.6720816039276,20,237.50148438427738,-4.307461415162574,-3.772852613112422,-3.288613613644469,-1.8439984686512618,8514,8421,Southwest Oklahoma,Kiowa,40,75,Oklahoma,OK
40141,40CS031,77,76,77,106,29,29,30,1666.7807494424455,18,1026.6647654356195,5.987085308837013,6.39702300687891,6.75756330648857,0.5955761893137579,95,94,96,123,27,28,29,397.54260969075165,18,255.02975347123834,1.3059047242144664,1.4183827943807317,1.556972283224642,0.6194388715584374,7013,7058,Southwest Oklahoma,Tillman,40,141,Oklahoma,OK
40143,40CS032,5207,4919,5495,5987,492,780,1068,467.14815003684765,621,371.95930010556816,-0.6773405197556117,0.9268348939891947,2.681972064351128,0.7952145198591658,6434,6086,6781,7801,1020,1367,1715,203.34636429405967,1169,173.8383021247234,-0.26999416586415453,0.2906272910208061,0.7801850805238733,0.8542629615126955,667815,672464,Tulsa,Tulsa,40,143,Oklahoma,OK
40145,40CS033,556,521,592,648,56,92,127,448.44497227576096,64,313.4642699711025,-0.4443234154496553,1.312368505256515,3.003528559060808,0.6914507837457543,703,659,746,907,161,204,248,244.36536831564638,169,202.0081281377002,-0.10050853293589557,0.4125754030918897,0.9401840410301134,0.8226403589136856,81668,83660,Wagoner,Wagoner,40,145,Oklahoma,OK
41001,41CS001,188,180,195,206,11,18,26,443.21318655810296,1,24.06304517836732,2.4945701591242893,4.235123357661567,5.79326964287309,0.05149640307820783,231,222,240,274,34,43,52,254.90743021272638,31,184.2605801236329,0.1316068825167899,0.7103785475592281,1.2300286532848295,0.7063816284250153,16623,16824,Baker+Harney+Lake+Malheur,Baker,41,1,Oregon,OR
41025,41CS001,75,75,76,78,2,3,3,134.79236401461094,5,267.2724842977415,-1.7272772074008431,-1.3170786138238357,-0.9079270976887464,1.4197978285354251,94,93,94,124,30,30,31,403.22968474403325,30,396.6679888932963,-0.0653570700940642,0.06524219303180004,0.18954751392340496,0.9524940101787223,7483,7563,Baker+Harney+Lake+Malheur,Harney,41,25,Oregon,OR
41037,41CS001,87,86,88,98,10,11,12,555.6067714343626,4,196.7535661583866,3.198168054556865,3.5946968730971345,3.9968687180755103,0.3253226517072165,108,107,109,144,35,36,37,437.4924841106177,16,193.7749788058617,2.3120736981453565,2.4385853130599497,2.5559504199835548,0.43099089122276957,8132,8257,Baker+Harney+Lake+Malheur,Lake,41,37,Oregon,OR
41045,41CS001,269,255,282,326,44,57,71,730.2075266163891,42,533.6043704738915,0.260568865737969,1.9424235061470125,3.678639824794394,0.7182601553067948,331,314,347,392,45,61,78,193.00600859814173,46,145.19743694959124,-0.028697953052810827,0.4824429222811035,0.9941227619152616,0.7401896679360446,31484,31681,Baker+Harney+Lake+Malheur,Malheur,41,45,Oregon,OR
41003,41CS002,519,478,560,504,-56,-15,26,-64.41156243863242,10,42.12477357934201,-2.708771478801515,-1.046597540666455,0.6491558994495985,-0.69975770433841,649,600,699,741,42,92,141,95.71635908350666,23,23.985066688913687,0.20009568247711432,0.7162198572448714,1.253915198680935,0.24788412519094788,94956,95893,Benton,Benton,41,3,Oregon,OR
41005,41CS003,2989,2807,3170,3188,18,199,381,189.0521643225099,116,110.05118328739961,-0.8698452728569103,0.7917783293162814,2.6226891044518417,0.5792140671402298,3680,3462,3898,4005,107,325,543,76.95192605577996,302,71.48233534209741,-0.42384550901697365,0.058872586681554755,0.5931265180072441,0.9260734678083392,421622,422482,Clackamas,Clackamas,41,5,Oregon,OR
41007,41CS004,350,333,368,348,-20,-2,15,-23.639102523948175,5,48.73769373233259,-2.544122706104552,-0.7379194055037478,1.009313794780955,-3.508438251662984,433,412,455,542,87,109,130,260.36843492331286,29,69.53602685529313,1.3563050511875976,1.9115905540851448,2.4280095490065006,0.26463075994359303,41036,41705,Clatsop+Lincoln+Tillamook,Clatsop,41,7,Oregon,OR
41041,41CS004,538,517,560,592,32,54,75,424.78178096504195,14,110.97459474456025,1.4519228380405347,3.1278212342442195,4.970486303098744,0.25646499911023696,658,632,685,729,44,71,97,138.99551868074394,34,66.92254699340616,0.18302663588071819,0.7033829694983661,1.2279794155225663,0.47474978171401955,50462,50805,Clatsop+Lincoln+Tillamook,Lincoln,41,41,Oregon,OR
41057,41CS004,266,254,278,303,25,37,49,535.9334066335374,1,14.571948998178506,3.545534889485253,5.20763171116645,6.923479812392182,0.02647013121508492,327,312,341,412,71,85,100,308.0118728446693,42,151.580770896492,1.0381655631957596,1.5682245238470591,2.055891819445009,0.48642678335819206,27450,27708,Clatsop+Lincoln+Tillamook,Tillamook,41,57,Oregon,OR
41009,41CS005,402,380,425,447,22,45,67,338.6626552100532,22,167.062173706692,-0.11914615537008304,1.7126060985048894,3.3785975574937757,0.4824811277101745,497,469,524,629,105,132,160,249.5613029536571,58,109.41538229357279,0.9125057055549137,1.3875079541859918,1.9418855702608897,0.43514158065833497,52675,53009,Columbia+Washington,Columbia,41,9,Oregon,OR
41067,41CS005,2960,2701,3218,3194,-24,234,493,156.04088121639202,131,87.2261904960074,-1.0966821469541554,0.7334376832451434,2.3345266801116615,0.5566205771550012,3675,3365,3986,4156,170,481,791,79.98729596451068,243,40.44654315213393,-0.09068258275568984,0.40034863256158393,0.9047040950399747,0.5046120345459173,600737,600793,Columbia+Washington,Washington,41,67,Oregon,OR
41011,41CS006,783,755,811,777,-34,-6,22,-37.51121859547725,10,61.663686255164336,-2.6701343524598964,-1.0463058817534696,0.7989388987959439,-1.9672669135203842,953,919,986,1139,153,186,220,286.5185799853895,98,150.80867303756366,0.8422419674974442,1.352268879136684,1.8755379559735226,0.5235368020542108,64868,64983,Coos+Curry,Coos,41,11,Oregon,OR
41015,41CS006,336,326,346,393,47,57,67,978.921096191725,5,85.30239699735563,7.263020662844879,8.945729949704269,10.731083595119935,0.08564656122953047,410,398,422,512,90,102,114,431.20554844562133,36,152.17483197362304,2.3235495864629443,2.788665659527521,3.312939078925291,0.3494796266946637,23446,23657,Coos+Curry,Curry,41,15,Oregon,OR
41017,41CS007,1368,1282,1454,1333,-121,-35,51,-69.23442415003693,24,48.08655580044079,-2.9439292965838395,-1.1704013739719843,0.5558237268478632,-0.7152457381197287,1713,1608,1818,1824,6,111,216,54.40715857780534,167,81.85993617866053,-0.7527737537249092,-0.2741966122178324,0.21468091106131537,1.4911458260994612,199640,204007,Deschutes,Deschutes,41,17,Oregon,OR
41019,41CS008,1302,1254,1350,1421,71,119,167,427.686047141534,35,125.82346967205012,1.349477475017707,3.0669218994876934,4.724659749170672,0.2917435933298847,1596,1539,1654,2054,400,458,515,408.9772537050084,244,218.11030660588185,1.3803335551379374,1.9051958528043156,2.4170880798415433,0.5321435955057333,111267,111870,Douglas,Douglas,41,19,Oregon,OR
41027,41CS009,166,155,176,156,-20,-10,1,-161.7377897426051,12,201.1060834590246,-5.374425706757483,-3.6714739408517945,-1.915574389348412,-1.3871398862794446,204,192,217,200,-17,-4,8,-17.132308298314385,17,70.71547420965058,-1.4035349832781334,-0.8673540684737272,-0.3551677862289971,-5.451151896924642,23868,24040,Hood River+Jefferson+Sherman+Wasco,Hood River,41,27,Oregon,OR
41031,41CS009,182,171,192,272,80,90,101,1465.2788061199146,19,309.0184597869399,9.840196183565492,11.558764828151977,13.25262584038634,0.20857880819057512,226,213,239,327,88,101,114,403.81267073392655,37,148.07107411557547,2.0601536685952238,2.5366359558127614,3.054970806117661,0.3630842965042498,24594,24988,Hood River+Jefferson+Sherman+Wasco,Jefferson,41,31,Oregon,OR
41055,41CS009,17,16,17,16,-1,-1,0,-147.85337223602102,2,429.18454935622316,-7.514386402851657,-5.822239918772246,-4.049133865819813,6.430800232722243,21,20,22,26,4,5,6,278.3013783586351,5,262.88117770767616,-0.34593624242517657,0.16543971909437008,0.6671851515140372,0.7944967161996958,1864,1902,Hood River+Jefferson+Sherman+Wasco,Sherman,41,55,Oregon,OR
41065,41CS009,278,266,289,295,6,17,29,260.6414619864764,27,405.84720604261395,-3.1135767972904276,-1.480983766538383,0.30851786057107145,1.4722059890274282,339,325,353,374,21,35,49,130.984857554456,28,104.83357669699353,-0.25870594099722644,0.252914903915888,0.7519314048486089,0.7781074877660565,26611,26709,Hood River+Jefferson+Sherman+Wasco,Wasco,41,65,Oregon,OR
41029,41CS010,2084,1988,2180,2242,62,158,254,283.65474599423277,68,121.94411193752158,-0.026761582806730713,1.5806991348532957,3.3989091503813946,0.4272024820576492,2551,2435,2666,2929,263,378,494,169.02229628209386,292,130.5412993329876,-0.10697397431868874,0.381757546680957,0.9266548204558434,0.7702944224194177,223053,223684,Jackson,Jackson,41,29,Oregon,OR
41033,41CS011,1068,1030,1106,1112,6,44,82,198.71198551888895,25,113.54862151973475,-0.8990768694999687,0.8206427991950833,2.5791895854146465,0.5586540014632234,1305,1259,1350,1583,233,278,324,315.0422681034353,224,253.64903579395545,0.10535198349429101,0.6045766242074513,1.1253467395448176,0.8022434813885864,88068,88311,Josephine,Josephine,41,33,Oregon,OR
41035,41CS012,719,689,748,779,31,60,90,348.2702323371873,25,144.08599051914183,0.4644552663332538,2.0294752066375343,3.8788157257090705,0.40698386038335443,887,851,924,1074,150,187,223,266.2847333693582,150,214.0777530399041,-0.010309034793756123,0.5219391785731109,1.0303077735395398,0.7996571625486553,69403,70068,Klamath,Klamath,41,35,Oregon,OR
41039,41CS013,3182,3017,3346,3372,26,190,355,198.6969934055542,76,79.406955422397985,-0.5064605929989247,1.14411924081494,2.9464118176765335,0.39754796827313926,3910,3712,4108,4528,420,618,816,161.2653554348974,233,60.81121640702278,0.4646638035572796,1.0148677289966503,1.508973874056205,0.3764786193881578,382838,383153,Lane,Lane,41,39,Oregon,OR
41043,41CS014,1155,1099,1210,1247,37,92,148,286.5360315200181,35,108.42039232693394,0.06586705348762477,1.7928223702397084,3.497921779098607,0.3743361735327399,1420,1353,1487,1726,239,306,373,235.85129830060114,152,117.18719884046351,0.6767499811823102,1.1766070346492847,1.6898390091971864,0.4952500898070279,129127,129707,Linn,Linn,41,43,Oregon,OR
41047,41CS015,2445,2296,2594,2685,91,240,389,277.0434185401327,182,210.10404190536661,-0.9966881099747658,0.6813879497502785,2.2713063914034746,0.7552324800934862,3013,2834,3192,3458,266,445,624,128.27503035381184,304,87.61185642030635,-0.13553818131682743,0.42041056960039924,0.9077729886330912,0.6814690195197568,346495,346985,Marion,Marion,41,47,Oregon,OR
41051,41CS016,4978,4628,5328,5449,121,471,821,231.5666789354534,389,191.13858898938543,-1.2916250085024188,0.41356516914802033,2.0660860804347125,0.8236671774922589,6081,5665,6497,6896,399,815,1231,101.226361120992,422,52.40940438326426,-0.007057668737574758,0.48007853467498535,1.0100073528672089,0.5171101913433485,814069,805199,Multnomah,Multnomah,41,51,Oregon,OR
41053,41CS017,631,593,668,669,1,38,76,175.46053524151918,25,114.01858502935978,-1.0658590521150053,0.6623131492755451,2.281437606252872,0.6333617108434386,786,740,832,842,10,56,102,62.77184913270274,68,76.42682131858746,-0.6597222684301913,-0.13099412391577733,0.3439427130712993,1.1961170161873622,87705,88974,Polk,Polk,41,53,Oregon,OR
41013,41CS018,245,234,256,211,-45,-34,-23,-544.7124334141307,2,32.08985158443642,-7.521550694017779,-5.797784829584072,-4.021372833456253,-0.06069949660569293,308,295,321,321,0,13,26,51.66855739033317,46,179.5472287275566,-1.7991862216555579,-1.2585119814110426,-0.717456249002697,3.2309078413461907,24930,25620,Umatilla and Nearby Counties,Crook,41,13,Oregon,OR
41021,41CS018,18,18,18,14,-4,-4,-4,-798.7303165059288,5,1000,-18.401705396870312,-17.993933908350307,-17.590945350294092,-1.6702010444966298,22,22,22,37,15,15,15,747.3595367930144,5,249.1280518186348,4.855670037291671,4.981519706431523,5.100787200520299,0.31250965062154074,2000,2007,Umatilla and Nearby Counties,Gilliam,41,21,Oregon,OR
41023,41CS018,77,77,78,85,7,8,8,417.7764245391591,5,277.0083102493075,0.9969126394368817,1.4198359043054374,1.8249579140337027,0.5854208343547054,95,94,96,115,19,20,21,276.15027002122895,14,192.70474879559532,0.7092374078133851,0.8364451391398067,0.960950051663477,0.6646941987532841,7220,7265,Umatilla and Nearby Counties,Grant,41,23,Oregon,OR
41049,41CS018,77,75,78,96,18,19,21,642.0742882427669,11,363.0962204984321,2.381945609292234,2.7936068100080718,3.2097873918657087,0.5378541621873228,95,93,96,122,26,27,29,222.71880020050338,14,113.94156425490357,0.9580892033551185,1.0915720026285596,1.2066980560508762,0.49355802807764654,12118,12287,Umatilla and Nearby Counties,Morrow,41,49,Oregon,OR
41059,41CS018,593,559,627,709,82,116,150,581.6862328099191,60,301.2123798288109,0.9150345574601213,2.794722066460123,4.470222758789624,0.5133953877685848,733,692,775,885,110,152,193,189.76266660961056,101,126.26420472303134,0.1031937206444304,0.6441651533751819,1.18576275621991,0.6610248105379088,79678,79991,Umatilla and Nearby Counties,Umatilla,41,59,Oregon,OR
41061,41CS018,242,231,254,247,-7,5,16,71.8464389817069,5,76.21660759879578,-1.8051356125560578,-0.03664654477847998,1.6003777418919913,0.8751500424382584,297,284,311,374,63,77,90,293.0954299878469,49,187.0014883791932,0.5006921787417924,1.0575372308010054,1.5533173928585144,0.6298217067624905,26241,26203,Umatilla and Nearby Counties,Union,41,61,Oregon,OR
41063,41CS018,77,76,78,61,-17,-16,-15,-868.2677861034451,3,162.7780792186652,-10.721662291558347,-10.325302700355241,-9.900304692976174,-0.19997100023372208,96,95,97,103,6,7,8,96.94116796647172,1,13.294336612603033,0.7037085552703128,0.8376894778340538,0.966454118950641,0.12059940817948235,7372,7522,Umatilla and Nearby Counties,Wallowa,41,63,Oregon,OR
41069,41CS018,16,15,16,17,1,1,2,401.07386414618963,6,1666.6666666666667,-14.400831767177522,-12.668791521297836,-10.928642456451314,2.455126516219484,19,18,20,21,1,2,3,131.43010877004602,1,68.87052341597796,0.13311541228102053,0.6333850857960226,1.1523329092820858,0.3438357765741661,1440,1452,Umatilla and Nearby Counties,Wheeler,41,69,Oregon,OR
41071,41CS019,828,781,874,883,9,55,102,205.47067310312246,37,137.36518720647473,-1.0542594550200657,0.7205096446338494,2.4187127516457663,0.6566739450231287,1018,962,1074,1251,177,233,289,215.2730186186624,102,94.28729894620078,0.6961003257677765,1.197810505125948,1.6828976789490866,0.4361167028108466,107742,108180,Yamhill,Yamhill,41,71,Oregon,OR
42001,42CS001,907,862,952,996,44,89,134,343.00054546733463,81,312.49698594728056,-1.3555973936186265,0.31352352771531217,1.8978227948808262,0.9009349814495708,1114,1060,1168,1234,66,120,174,115.14120606176876,172,165.25908204344776,-0.9938645482771994,-0.5131073831511536,0.02346387807086945,1.423395472519176,103681,104079,Adams,Adams,42,1,Pennsylvania,PA
42003,42CS002,11874,11339,12410,12850,440,976,1511,313.97847462501505,1108,356.61495803417614,-2.0658568417877894,-0.4614312013461665,1.3237000294915287,1.1346311944718364,14463,13823,15103,15249,146,786,1426,63.37353628625279,1390,112.12932786938143,-1.0036784612039704,-0.49434193985393743,0.00600998585074261,1.7670905829424957,1242797,1239640,Allegheny,Allegheny,42,3,Pennsylvania,PA
42005,42CS003,727,699,755,785,30,58,86,353.06459390654464,43,263.3996937212864,-0.8284430926894726,0.8956446172472893,2.658136382008661,0.733315433038038,885,851,919,1101,182,216,250,331.5437283595405,185,283.9862458553359,-0.025256118593954897,0.4721116930700214,1.0281735210977478,0.8526098181808693,65300,65144,Armstrong,Armstrong,42,5,Pennsylvania,PA
42007,42CS004,1872,1800,1944,2109,165,237,309,567.6018008383207,243,581.8059928411526,-1.8662149751290862,-0.16479596347269262,1.5887475359450642,1.020719316149537,2279,2193,2366,2444,78,165,251,98.64343682932366,310,185.86691928579137,-1.401975734589185,-0.8684261605643464,-0.36006452609699324,1.8728464997099485,167066,166786,Beaver,Beaver,42,7,Pennsylvania,PA
42009,42CS005,479,459,500,635,135,156,176,1307.8020257282556,98,823.9968049103484,3.060539747416384,4.915415271241928,6.445183785236326,0.6260374157649443,582,558,607,709,102,127,151,267.1425579825802,138,290.7099220560354,-0.7580053745771389,-0.2280756518278038,0.31524433078165354,1.0797059909239866,47573,47470,Bedford+Fulton,Bedford,42,9,Pennsylvania,PA
42057,42CS005,146,139,152,146,-6,0,7,8.284257592433526,13,357.6587110530298,-5.119017350823352,-3.4567834428621746,-1.808855082892505,9.991453058646645,177,170,185,237,52,60,67,412.73577472690033,44,302.88428443587804,0.5835282612978296,1.1082874212400664,1.6191107951535364,0.7218069663741712,14539,14527,Bedford+Fulton,Fulton,42,57,Pennsylvania,PA
42011,42CS006,3470,3286,3654,3927,273,457,641,427.32699937798486,575,537.9512943575926,-2.7472568262006316,-1.1079027183175287,0.47215899586594484,1.2561249476433742,4268,4046,4489,4822,333,554,776,129.1229290070497,678,157.9506485761145,-0.8086640647627358,-0.2665784820997966,0.21977889939340683,1.2210548974730426,427548,429248,Berks,Berks,42,11,Pennsylvania,PA
42013,42CS007,1353,1300,1406,1613,207,260,313,849.7716905256702,193,630.945764817418,0.35735071126038376,2.1557808584954876,3.8029768250039346,0.7396430927484009,1643,1580,1706,1874,168,231,294,189.28296588144065,302,247.79080548421769,-1.0945848718485662,-0.606381962001419,-0.07517078600256791,1.3034523341005122,122356,121877,Blair,Blair,42,13,Pennsylvania,PA
42015,42CS008,587,562,613,592,-21,5,30,30.955752299542603,57,380.3486529318542,-5.026610289974099,-3.5366030763809446,-1.8064619962924067,10.107984432953327,720,689,751,841,90,121,152,202.42157418464404,106,177.00001669811476,-0.3144892434851949,0.2634675273832447,0.743137301194449,0.8672586357488076,59945,59887,Bradford+Sullivan,Bradford,42,15,Pennsylvania,PA
42113,42CS008,80,79,80,88,8,8,9,574.0806023206745,3,204.8131080389145,3.2763288017779235,3.6959917323110703,4.105559415751359,0.31884889181606135,98,97,98,131,33,33,34,569.6530259576218,23,392.22373806275584,1.643168000278013,1.7780239712300991,1.9042299037815658,0.6685181044561707,5859,5864,Bradford+Sullivan,Sullivan,42,113,Pennsylvania,PA
42017,42CS009,5337,5060,5614,6046,432,709,986,440.68861525925433,875,543.930973605361,-2.7079621897262167,-1.0737288663931082,0.5447885768824562,1.232536458862604,6569,6235,6902,6909,7,340,674,52.68767171229475,589,91.16447526254285,-0.9273030177261242,-0.37805238510096134,0.15469872473589025,1.7252128747939781,643464,646085,Bucks,Bucks,42,17,Pennsylvania,PA
42019,42CS010,1774,1691,1857,1973,116,199,282,412.4653194739313,226,468.18273627950094,-2.260673036616957,-0.5394182888373232,1.055420179537812,1.1294114193621418,2184,2084,2284,2421,137,237,337,122.13236837428653,332,170.94809253852767,-0.9649629041915149,-0.4923816686370363,0.03468300701327249,1.3938189523344322,193087,194211,Butler,Butler,42,19,Pennsylvania,PA
42021,42CS011,1594,1537,1651,1844,193,250,307,755.1553537050922,280,845.5446591020618,-2.6913909849194844,-0.926396861213608,0.8212887227593739,1.1152365681529024,1938,1869,2006,2071,65,133,202,100.76810757409065,297,224.52034290379643,-1.7416120690936434,-1.2302798269158672,-0.6964783394957941,2.2114986781846175,132459,132282,Cambria,Cambria,42,21,Pennsylvania,PA
42025,42CS012,685,657,712,827,115,142,170,879.9489626046812,93,574.7037649276214,1.2689943193357132,3.0235298029567113,4.782934976451769,0.6485557315850509,839,805,873,996,123,157,191,240.34356801030205,143,218.93563598505725,-0.281120633398766,0.22636592937859823,0.7635062332326488,0.9051617997741153,64729,65316,Carbon,Carbon,42,25,Pennsylvania,PA
42027,42CS013,826,758,894,1047,153,221,289,558.4801637269301,141,355.8471876084419,0.23307453210043766,2.0410705877891755,3.72146471469006,0.6343042997205273,1021,940,1102,1222,120,201,282,127.58762039976925,127,80.59091543665046,-0.03229488142819849,0.4674767318609939,0.9756596068509891,0.6285254727359523,158495,157586,Centre,Centre,42,27,Pennsylvania,PA
42029,42CS014,3516,3286,3745,3919,174,403,633,302.2832848085099,555,415.9920849073575,-2.8571658737625683,-1.158392891653127,0.5545776569810693,1.3727624775913896,4368,4090,4645,4407,-238,39,317,7.314592800736435,351,65.2337542861922,-1.0817014897787147,-0.5725251362862361,-0.08231142018994948,8.697319078562433,533664,538065,Chester,Chester,42,29,Pennsylvania,PA
42031,42CS015,341,325,357,451,94,110,126,1175.8958287018693,48,513.8086062941554,4.88399141299467,6.611575425081111,8.323390416196228,0.43300904320078765,416,397,436,599,163,183,202,491.52080576211796,116,312.17201754622033,1.2938388872159945,1.7990087291792474,2.2834851008226673,0.6316561577162082,37368,37159,Clarion+Jefferson,Clarion,42,31,Pennsylvania,PA
42065,42CS015,475,456,494,526,32,51,70,461.8312915023541,58,524.4952863246897,-2.310894564131715,-0.5836492046442067,1.0136638283586055,1.1138753401629,578,555,601,656,55,78,101,176.21893885203494,123,278.5326086956522,-1.5278267205839011,-1.0264383648547963,-0.5251707298215029,1.5605516220185807,44233,44160,Clarion+Jefferson,Jefferson,42,65,Pennsylvania,PA
42033,42CS016,826,792,861,878,17,52,86,259.3032507157655,54,269.37706553594813,-1.7266105870189894,-0.15350871379025743,1.645136257373862,1.0192414304234327,1011,969,1052,1231,179,220,262,275.1596131718087,206,257.08865814696486,-0.3450819827892171,0.17915157043636964,0.6853520505837591,0.9301069975072522,80185,80128,Clearfield,Clearfield,42,33,Pennsylvania,PA
42035,42CS017,346,330,362,371,9,25,41,263.8337574220044,29,309.32508466440896,-2.0140967884872087,-0.46632863418331827,1.2072237590281019,1.126866766103547,426,407,445,491,46,65,84,173.73183634292508,74,197.60734885708183,-0.7310951199940943,-0.25976130061194663,0.29039176863944516,1.120209057614474,37501,37448,Clinton+Potter+Tioga,Clinton,42,35,Pennsylvania,PA
42105,42CS017,181,174,188,188,0,7,14,180.01344077315775,15,366.45697184388933,-3.598518428252475,-1.8808123787550577,-0.2157560545644003,1.7924573042917729,220,212,229,298,69,78,86,478.4712629287557,63,387.14434953604126,0.4371262214075093,0.9078107659783569,1.401848015439788,0.7988676001918306,16373,16273,Clinton+Potter+Tioga,Potter,42,105,Pennsylvania,PA
42117,42CS017,396,379,414,463,49,67,84,653.4078412985481,79,772.238514173998,-2.8728434243609846,-1.1639152996579292,0.5197606195551375,1.1644425441797843,487,466,508,596,88,109,130,266.94049499715845,103,251.61841944546234,-0.33399940991970917,0.14429984864558174,0.6669696954775134,0.9340531995014728,40920,40935,Clinton+Potter+Tioga,Tioga,42,117,Pennsylvania,PA
42037,42CS018,592,564,620,659,39,67,95,413.17902264497735,83,512.8205128205128,-2.6451512057820437,-0.9870892291860631,0.6187082937768907,1.2228716817339687,727,693,760,871,111,144,178,222.6368288897686,113,174.26976342494063,-0.03344514761545154,0.4705692687906733,0.963927320993234,0.7773686784369193,64740,64842,Columbia,Columbia,42,37,Pennsylvania,PA
42039,42CS019,836,800,872,921,49,85,121,405.26859480515395,90,429.6660539947008,-1.922540079625473,-0.2515520793362272,1.5142847440629954,1.0478569518200638,1018,975,1061,1217,156,199,242,238.34152845150547,153,183.44223967388047,0.030914433056473307,0.543833596212878,1.0244011958667547,0.7658088787168033,83786,83405,Crawford,Crawford,42,39,Pennsylvania,PA
42041,42CS020,2098,1986,2209,2361,152,263,375,406.281842778917,321,495.17932896259157,-2.6272284956427283,-0.8804268583113232,0.7866955513985735,1.2141972357049524,2593,2458,2729,2793,64,200,335,76.16149637506558,365,139.05132708300792,-1.1094914243292056,-0.6242796688302001,-0.07524601800174509,1.816656128559825,259300,262493,Cumberland+Perry,Cumberland,42,41,Pennsylvania,PA
42099,42CS020,386,367,406,450,44,64,83,553.7341167850618,42,365.91740721380035,0.11155122644857177,1.8794444671237205,3.562955032301255,0.6505817866199672,473,449,497,580,83,107,131,232.31631872219802,102,221.92245768243333,-0.3792259386957978,0.12582152286620055,0.6291849091449238,0.9463965941277754,45912,45962,Cumberland+Perry,Perry,42,99,Pennsylvania,PA
42043,42CS021,2247,2124,2370,2589,219,342,465,478.9349813081898,329,461.028064557942,-1.6533853372749638,0.13537341137751802,1.89477174544254,0.9598027078837369,2770,2622,2919,3175,256,405,553,140.86581322812646,386,134.36602558524064,-0.46128634265350743,0.07261549681733989,0.5575876827911092,0.9515070004761811,285449,287275,Dauphin,Dauphin,42,43,Pennsylvania,PA
42045,42CS022,4758,4511,5006,5578,572,820,1067,570.4619395887055,979,681.4203333321733,-2.808533486700495,-1.0952832389539733,0.5582517109001782,1.1930505414063628,5828,5531,6124,5923,-201,95,392,16.614376929616245,544,94.73737371978287,-1.2796885823733557,-0.7768913237120716,-0.22822509287812515,5.642983238743431,574682,574219,Delaware,Delaware,42,45,Pennsylvania,PA
42049,42CS023,2451,2335,2567,2777,210,326,442,482.7370085721481,259,383.49207289310715,-0.6364894903771737,0.97186968039094,2.7510795039500517,0.7919828092182707,2994,2855,3133,3389,256,395,534,146.5445225880453,358,132.9777355154559,-0.38253210869028914,0.14271256041996377,0.6949729265879565,0.9051278538524895,270149,269218,Erie,Erie,42,49,Pennsylvania,PA
42051,42CS024,1507,1452,1562,1679,117,172,227,536.3420976381116,164,510.93924028942837,-1.4906378780370761,0.2954261836947158,1.8889748451345403,0.9471351566172691,1821,1756,1887,2307,420,486,551,382.01968375213846,378,297.3006984206883,0.33358440744516804,0.8416084972043115,1.3465985536894296,0.7766350269159917,128391,127144,Fayette+Greene,Fayette,42,51,Pennsylvania,PA
42059,42CS024,375,359,390,401,11,26,42,295.04979907364503,34,379.8564366114571,-2.5375445324191785,-0.8187433753197152,0.8297705604933088,1.240460770454775,453,435,472,540,68,87,105,244.53518681775478,68,191.9060789072642,0.03813310057300778,0.5290765588778564,1.0347931280444076,0.775825300990467,35803,35434,Fayette+Greene,Greene,42,59,Pennsylvania,PA
42055,42CS025,1363,1296,1430,1699,269,336,403,863.3449729934089,235,603.082134654126,0.9238975802334247,2.603007071050369,4.251119371261342,0.6964710457281243,1673,1592,1754,2038,284,365,446,233.72430632107523,289,184.9860460352818,-0.01653193716688159,0.47586825406156397,0.966818504782236,0.7893095062248081,155866,156228,Franklin,Franklin,42,55,Pennsylvania,PA
42061,42CS026,395,376,414,489,75,94,113,849.0724737262558,75,679.6402437643007,-0.013637975008933427,1.695382549006489,3.4841294665695632,0.7919974871055321,482,459,504,593,89,111,134,253.82076893576252,101,230.01594169892962,-0.26521284227935765,0.24312773333617557,0.7636302378396521,0.8981554051046474,44141,43910,Huntingdon+Juniata+Mifflin,Huntingdon,42,61,Pennsylvania,PA
42067,42CS026,208,198,218,295,77,87,97,1476.4009709942682,64,1083.5520189621602,2.233107350330132,3.9412625504480143,5.663392388806145,0.725593774586257,252,240,264,354,90,102,114,438.21342947431873,73,313.0494446588619,0.7740473208238292,1.2542335280612986,1.8074567879910501,0.7074535294561597,23626,23319,Huntingdon+Juniata+Mifflin,Juniata,42,67,Pennsylvania,PA
42087,42CS026,474,454,494,614,120,140,160,1214.6443038099092,126,1093.7025302721236,-0.44713603954355113,1.2671159161821985,2.901848820042778,0.8940412342016664,579,555,603,658,55,79,103,171.36691567904077,105,227.63240618292974,-1.07600943961412,-0.5450481203744969,-0.07863285107558544,1.3117389094861702,46082,46127,Huntingdon+Juniata+Mifflin,Mifflin,42,87,Pennsylvania,PA
42063,42CS027,761,725,797,935,138,174,210,837.3164877041742,116,557.5314813034702,0.9686299106443346,2.692271773744466,4.528320970682339,0.6620548518049039,929,886,972,1115,143,186,229,224.4261731597902,159,191.75108538350216,-0.17152048814255005,0.32188161233701595,0.8408815891892372,0.8498393570230988,83224,82920,Indiana,Indiana,42,63,Pennsylvania,PA
42069,42CS028,2323,2231,2415,2524,109,201,293,374.4680765561774,267,497.4406028905584,-2.859408834489806,-1.2110666659496123,0.43663412059452095,1.3218161795091434,2853,2741,2964,2941,-23,88,200,41.0008174590066,315,146.07543984938,-1.5625491257845474,-1.0406398761455693,-0.5545179960782757,3.522899520739114,214699,215642,Lackawanna+Wyoming,Lackawanna,42,69,Pennsylvania,PA
42131,42CS028,269,258,280,278,-2,9,20,137.37208068872602,30,459.41807044410416,-5.046666790536427,-3.197981776888658,-1.6228409457785211,3.008907307727633,329,316,343,394,51,65,78,248.89418661794934,54,207.46090898613085,-0.07745629912746664,0.3966345342799455,0.939998313060528,0.8208599629265824,26120,26029,Lackawanna+Wyoming,Wyoming,42,131,Pennsylvania,PA
42071,42CS029,4410,4172,4647,5188,541,778,1016,564.4748714947408,748,542.3601002786121,-1.4015287025817877,0.24333945342068194,1.873312975969125,0.9595897850139045,5424,5138,5710,5904,194,480,766,86.74244883941535,739,133.51448424384552,-0.9887597304352342,-0.47240906132830623,0.04785562036914167,1.5360066156013625,551663,553498,Lancaster,Lancaster,42,71,Pennsylvania,PA
42073,42CS030,994,957,1031,1217,186,223,260,1040.8130150177178,140,652.8784946487281,2.172739940476685,3.8812940973498753,5.583922427594473,0.6244793991934439,1210,1166,1254,1387,133,177,221,207.1482893754295,196,229.10310808757347,-0.7475479464279441,-0.20027292696258972,0.28467292447087816,1.0997801766793405,85774,85551,Lawrence,Lawrence,42,73,Pennsylvania,PA
42075,42CS031,1321,1260,1383,1523,140,202,263,564.2030601144363,156,436.40025736425434,-0.3577294066118973,1.274644247662315,3.14800460580033,0.7696646813609601,1622,1548,1696,1877,181,255,329,177.71890368712792,226,157.53959402186035,-0.3425530507777434,0.18809797707128695,0.7036389564202611,0.8829903726386868,142988,143456,Lebanon,Lebanon,42,75,Pennsylvania,PA
42077,42CS032,2961,2800,3122,3397,275,436,597,466.7677336014589,518,554.2270512018061,-2.743790094124594,-0.8610494094099879,0.9767257760083616,1.1846567447405882,3646,3452,3840,3976,136,330,524,87.86041636471437,472,125.73657122763647,-0.8874741018545453,-0.371502663260063,0.1256408983787537,1.4267687089712877,373854,375388,Lehigh,Lehigh,42,77,Pennsylvania,PA
42079,42CS033,3543,3404,3683,3970,287,427,566,526.4674816927968,463,571.5167412436352,-2.113560563780049,-0.4794110346990207,1.2614398695533413,1.0830296148934653,4351,4183,4519,4602,83,251,419,76.99177077394057,534,163.8499208365551,-1.3774048724360621,-0.8754971830851291,-0.35430539339332184,2.1197008545448863,324050,325908,Luzerne,Luzerne,42,79,Pennsylvania,PA
42081,42CS034,1096,1047,1145,1268,123,172,221,604.1364926112694,130,456.60897587875274,-0.25316375352668835,1.424706313015124,3.2361092634078577,0.7514355722706914,1341,1282,1399,1563,164,222,281,195.56034666007267,261,229.6322364948091,-0.8715594045066559,-0.32954460298421645,0.15189708301229796,1.1689678537146602,113883,113660,Lycoming,Lycoming,42,81,Pennsylvania,PA
42023,42CS035,53,52,53,57,4,4,5,376.00565318379813,5,444.5432318292954,-1.1041205648754946,-0.6934656417496667,-0.2601812112595261,0.9561831766841881,64,64,65,77,12,13,13,283.9514318491641,3,67.14413607878245,2.0407930622121375,2.1652642559322643,2.282621200336196,0.2191868901015307,4499,4468,McKean and Nearby Counties,Cameron,42,23,Pennsylvania,PA
42047,42CS035,334,321,347,317,-30,-17,-4,-220.15620945466802,21,273.0730470400832,-6.625201831535966,-4.840623465907122,-3.088131559941744,-1.3182208397155928,408,392,424,468,44,60,76,195.0729676891477,57,185.04090377873004,-0.39318973613495806,0.09426352541862235,0.5880300722260238,0.9330453687552128,30761,30804,McKean and Nearby Counties,Elk,42,47,Pennsylvania,PA
42053,42CS035,71,70,72,87,15,16,17,923.65382352766,4,229.48938611589213,6.529284955889983,6.917502702164838,7.359292475764031,0.23392789419944227,88,87,89,109,20,21,22,302.84751801036134,21,299.1452991452992,-0.08234465986759411,0.036635429145114466,0.16558641805524893,0.9434006440251883,6972,7020,McKean and Nearby Counties,Forest,42,53,Pennsylvania,PA
42083,42CS035,435,418,452,444,-8,9,26,90.94071227955679,26,257.96849807763857,-3.3815136647057735,-1.7012711568987056,-0.05264173297699472,2.5576234936773345,528,507,548,631,83,103,124,258.439171652442,97,242.53638045706856,-0.3395904097812056,0.16420656785087176,0.678025117325898,0.9294734489894082,40315,39994,McKean and Nearby Counties,McKean,42,83,Pennsylvania,PA
42123,42CS035,414,398,431,501,70,87,103,898.205882308364,40,415.09923466078607,3.1583237270129008,4.827920958397798,6.558260665539648,0.4568642256559655,503,483,522,683,161,180,200,472.6480912825522,90,235.7008170961659,1.8300281847711173,2.360411125571234,2.890000858102138,0.49593349091628164,38545,38184,McKean and Nearby Counties,Warren,42,123,Pennsylvania,PA
42085,42CS036,1251,1204,1298,1446,148,195,242,708.4967440164243,170,617.3736199883788,-0.7847677198148771,0.9301237198825005,2.6683887460862237,0.8669414957491943,1526,1470,1583,1842,259,316,372,286.9116851308984,244,221.76778004998863,0.13131117205777035,0.6428370841077203,1.1986214591728248,0.7705070574150527,110144,110025,Mercer,Mercer,42,85,Pennsylvania,PA
42089,42CS037,1281,1209,1354,1540,186,259,331,614.2885666915797,213,505.2721471694085,-0.5842718222831008,1.0566623471481764,2.8932820919993985,0.8193681182329188,1579,1492,1667,1808,141,229,316,135.17791231350304,202,119.43899150918853,-0.3794616846606225,0.1600658460051445,0.6680084316451655,0.8797208526817164,168622,169124,Monroe,Monroe,42,89,Pennsylvania,PA
42091,42CS038,6737,6369,7105,7627,522,890,1258,417.09620434881214,1168,547.4232324451375,-2.970003288520423,-1.307427095813002,0.41052677792835796,1.3109896146923483,8327,7883,8771,8373,-398,46,490,5.307586979490341,715,83.1348947965695,-1.3147486332026117,-0.7915037329065886,-0.2554599933260266,15.327626735658175,853453,860048,Montgomery,Montgomery,42,91,Pennsylvania,PA
42093,42CS039,197,189,205,217,12,20,28,445.406666585223,28,618.0333296545635,-3.4881075375552517,-1.7438683941155444,-0.20980966672721885,1.3220550061199168,240,231,249,253,4,13,22,71.36999158165888,48,265.32529987286495,-2.42508264459773,-1.967024683773383,-1.4026300550453943,3.4503715718961074,18122,18091,Montour+Northumberland,Montour,42,93,Pennsylvania,PA
42097,42CS039,996,957,1035,1265,230,269,308,1178.8276938529777,239,1046.696228171019,-0.48641064138845636,1.3709968346345232,2.9871499780004687,0.8846263354553933,1215,1168,1262,1308,46,93,140,101.50136524860405,206,225.639677532422,-1.7435337068158157,-1.2629791035772593,-0.7492977332293461,2.1992877924825165,91335,91296,Montour+Northumberland,Northumberland,42,97,Pennsylvania,PA
42095,42CS040,2661,2527,2795,3032,237,371,505,475.9522579501498,417,534.8468087153095,-2.1657543314484107,-0.554527939408509,1.1217980727654142,1.120720317877639,3275,3113,3437,3550,113,275,437,87.80103991840376,381,121.52528587148942,-0.8342864248844357,-0.33903391620342277,0.1845767100180323,1.3790885208907127,311865,313515,Northampton,Northampton,42,95,Pennsylvania,PA
42101,42CS041,12228,11541,12914,15527,2613,3299,3986,826.8963810545366,2461,616.7877289066304,0.40305498582311283,2.1372250767793783,3.7812023681378966,0.7456809061894608,14859,14044,15675,16427,752,1568,2383,99.22426083651844,1576,99.75561141138365,-0.520075297102807,-0.026678742595202455,0.5128372716184205,1.0047141240926205,1596011,1579861,Philadelphia,Philadelphia,42,101,Pennsylvania,PA
42103,42CS042,477,452,502,525,23,48,73,331.4032087538614,45,308.58906223212756,-1.4906914385115215,0.26112191606983653,2.008463572613328,0.9122816294506743,597,566,628,684,56,87,118,145.59274971114118,77,128.86166616460824,-0.3661255479823962,0.1657844753001621,0.6720602730883747,0.8750249415677952,58330,59754,Pike,Pike,42,103,Pennsylvania,PA
42107,42CS043,1647,1585,1708,1916,208,269,331,755.7368911492565,239,670.4396428997215,-0.8097654582781566,0.8792312582026225,2.592264192681534,0.8838529363074807,2014,1940,2088,2133,45,119,193,83.19777877273246,261,182.27147975110515,-1.5002076432157014,-0.984993778126662,-0.5070287279965152,2.1725848938351433,142593,143193,Schuylkill,Schuylkill,42,107,Pennsylvania,PA
42109,42CS044,304,287,321,361,40,57,74,572.7532766836637,42,422.04692759885444,-0.23678634666596984,1.491101289622066,3.197518775793393,0.724168616691065,374,354,394,435,41,61,81,153.9312986208531,79,199.31878390311593,-0.942594369676799,-0.4506188346644046,0.006723116617393297,1.27397429723845,39806,39635,Snyder+Union,Snyder,42,109,Pennsylvania,PA
42119,42CS044,306,288,325,390,65,84,102,779.9705405090465,42,391.6814324349529,2.095305722318891,3.840268973012059,5.689887671070941,0.49624132020263545,377,355,399,484,85,107,129,251.26708616244616,78,183.20180383314542,0.18807216359156093,0.6780757777941895,1.2035601595064946,0.7223595066162019,42892,42576,Snyder+Union,Union,42,119,Pennsylvania,PA
42111,42CS045,824,793,856,950,94,126,157,680.7313648412413,103,558.1294535208215,-0.3778066467860618,1.2213836871051855,3.0100059831562755,0.813421809070589,1003,965,1041,1190,149,187,225,253.57250940063344,212,287.7736904260951,-0.8372000630788972,-0.34326804542849765,0.14691570743529572,1.1288344512524005,73818,73669,Somerset,Somerset,42,111,Pennsylvania,PA
42115,42CS046,394,378,411,465,54,71,87,732.4623068194478,37,383.09217508347785,1.9175681557744366,3.5478909076711673,5.224756327429296,0.515729464684429,480,460,500,577,77,97,117,253.4468875184789,56,145.89412255106294,0.56429681634959306,1.0620306316105341,1.5501166921250493,0.5697828681223737,38633,38384,Susquehanna+Wayne,Susquehanna,42,115,Pennsylvania,PA
42127,42CS046,517,495,539,594,55,77,99,603.787903283081,29,226.73964034401877,2.203963149428269,3.7573664557626096,5.402267963145097,0.37072796978841366,634,607,660,833,173,199,226,387.4506612739115,109,212.13241733647314,1.205953840126788,1.7567142788792678,2.285346525797517,0.5447718133852395,51160,51383,Susquehanna+Wayne,Wayne,42,127,Pennsylvania,PA
42121,42CS047,538,516,559,635,76,97,119,773.7778191833355,58,460.98515707274424,1.5927804664687335,3.049931053243861,4.828845483798849,0.5897018289482345,654,628,680,870,190,216,242,432.5573770723086,136,272.07073839198193,1.0588116356131725,1.6020025640657756,2.1228594777293592,0.6260862824960736,50327,49987,Venango,Venango,42,121,Pennsylvania,PA
42125,42CS048,2203,2113,2293,2308,15,105,195,201.02150462625153,135,258.5513463821963,-2.305305105994271,-0.5519601707262979,1.1998382819125346,1.27404923139372,2696,2588,2804,2991,187,295,403,140.91232349869617,354,169.03506761402704,-0.8210714502355301,-0.2882937050142469,0.2546324325119097,1.1955249904335614,208856,209424,Washington,Washington,42,125,Pennsylvania,PA
42129,42CS049,3880,3728,4032,4253,221,373,525,422.33820264385247,425,481.3654923236362,-2.3391733962467645,-0.6466939125797828,1.1372699109238473,1.1367146477521552,4736,4554,4918,5235,317,499,681,141.2765934978429,589,166.76387481101037,-0.7785944909274722,-0.25376532716960865,0.2208977814131431,1.1780460577397616,353162,353194,Westmoreland,Westmoreland,42,129,Pennsylvania,PA
42133,42CS050,3645,3449,3841,4231,390,586,782,514.339066108345,424,372.2555481660488,-0.3041025879024838,1.4100294373996687,3.0813882268536372,0.7225218275721758,4495,4259,4732,5253,521,758,994,165.32433860178065,684,149.22768129854262,-0.3554648013935603,0.14922160670352153,0.7043294057778927,0.9014463013034737,455601,458360,York,York,42,133,Pennsylvania,PA
44001,44CS001,460,438,481,495,14,35,57,280.2868175694942,63,499.6728332639343,-3.832884839619661,-2.1855631435495138,-0.48730011719229027,1.7336620327536583,564,537,590,594,4,30,57,59.581850598273036,66,129.90080302314595,-1.241975051438228,-0.703840167500317,-0.18076320668207,2.1104908030891614,50433,50808,Bristol+Providence,Bristol,44,1,Rhode Island,RI
44007,44CS001,4959,4676,5242,5966,724,1007,1290,613.5643795135227,1192,726.2989372089587,-2.985265112057339,-1.13466843071665,0.6381137132620742,1.182562763928002,6080,5741,6420,6267,-153,187,526,28.324960110347927,626,95.06699489584393,-1.164272749126218,-0.6570991721105729,-0.14597185412844774,3.338398756455544,656479,658483,Bristol+Providence,Providence,44,7,Rhode Island,RI
44003,44CS002,1556,1483,1629,1691,62,135,208,319.4673260271238,205,483.8443201397248,-3.4047384118627804,-1.6899268831111962,0.15734574832874318,1.503427322589344,1917,1828,2005,2106,101,189,278,110.9985992623872,163,95.51266275240539,-0.36241733322889225,0.1337281701457588,0.6516756495015052,0.8559666066053894,169476,170658,Kent,Kent,44,3,Rhode Island,RI
44005,44CS003,721,684,757,719,-38,-2,35,-7.211039698201403,38,178.92878163625662,-3.5224174628750196,-1.934698508534506,-0.18622280321305584,-71.50322564740961,885,841,929,887,-42,2,46,1.9976790552501318,52,60.97417978002392,-1.105280339964759,-0.5912313121738338,-0.07157321140805392,19.233182967502742,84950,85282,Newport,Newport,44,5,Rhode Island,RI
44009,44CS004,1055,999,1111,1163,52,108,164,334.2901032829242,87,269.1935795784181,-1.1579839720282445,0.6338163148399312,2.465180018486549,0.7978841743799617,1307,1239,1374,1380,6,73,141,56.32656164260612,71,54.41864030045221,-0.4800219896954756,0.028416381532984893,0.5227185270379673,0.9531574787820205,129275,130470,Washington,Washington,44,9,Rhode Island,RI
45001,45CS001,262,251,272,301,29,39,50,645.1483427084133,34,560.2471678681771,-0.8309864938315352,0.8374045101401579,2.628139369219874,0.8467729472793177,322,310,335,418,83,96,108,393.9553824517126,41,168.82154327596146,1.7196773505538283,2.257009499538125,2.7656185076504096,0.4240969653929822,24275,24286,Abbeville+Edgefield+Greenwood+McCormick,Abbeville,45,1,South Carolina,SC
45037,45CS001,196,185,207,275,68,79,90,1211.3010482712039,27,415.8804728715006,6.22857427471645,7.948565704627556,9.676308646607767,0.33902266816224785,246,232,259,370,111,124,138,476.4593408202405,56,214.69922938312308,2.101840852425694,2.6195608745853893,3.116121205335846,0.44701695654920315,25969,26083,Abbeville+Edgefield+Greenwood+McCormick,Edgefield,45,37,South Carolina,SC
45047,45CS001,687,657,717,838,121,151,181,868.2460509439634,84,482.7863670325881,2.043932650047258,3.8841778018850306,5.532660842367246,0.5523912509444243,843,808,879,1014,135,171,206,246.17176697588505,131,189.13963124990977,0.04911774513851458,0.5749831131130895,1.1081298059296179,0.7638438200072929,69596,69261,Abbeville+Edgefield+Greenwood+McCormick,Greenwood,45,47,South Carolina,SC
45065,45CS001,138,134,142,136,-6,-2,2,-81.79261211072506,13,545.5880809988458,-8.020027218763731,-6.260824173074962,-4.653970437437261,-13.699879365779976,172,167,177,180,3,8,13,84.324292766969,19,195.39284245166598,-1.601944044123398,-1.1300721152619448,-0.6321017952465064,2.0652860331823604,9531,9724,Abbeville+Edgefield+Greenwood+McCormick,McCormick,45,65,South Carolina,SC
45003,45CS002,1553,1480,1625,1928,303,375,448,885.8728544666945,157,370.40532251215024,3.435674817594105,5.159472946018539,6.994096750312538,0.4170141030575801,1919,1831,2007,2501,494,582,670,341.2628494994344,390,228.70949203035386,0.6163406178679068,1.1318162496424091,1.651344390114996,0.6690360421150028,169544,170522,Aiken,Aiken,45,3,South Carolina,SC
45007,45CS003,1947,1860,2035,2446,411,499,586,977.0058475076092,295,578.1564648181992,2.304433402132819,3.9352404076798537,5.636909554421365,0.5905788781559083,2405,2298,2512,3032,520,627,734,303.6906019764075,504,244.0807984928979,0.06313093378934329,0.6035904851377096,1.085666294048933,0.8024357272707824,204097,206489,Anderson,Anderson,45,7,South Carolina,SC
45013,45CS004,1381,1300,1462,1638,176,257,338,545.1914041348906,100,211.82513834829348,1.6465081235111194,3.3682757020453797,5.254323714367589,0.3870297850814773,1723,1624,1821,2109,288,386,485,202.1725251308714,184,96.25646069179099,0.5362815590674811,1.05883514299344,1.545715145073791,0.4748817098925113,188835,191156,Beaufort,Beaufort,45,13,South Carolina,SC
45015,45CS005,1399,1299,1499,1617,118,218,318,375.8736007902676,126,217.50294535238498,-0.04377376979603427,1.5526702620176518,3.2523662800626973,0.5760144388800674,1760,1638,1882,2139,257,379,501,160.50139599085915,282,119.51583372889401,-0.1266233047860022,0.41484448118198575,0.9104681545930091,0.7426793662918502,231721,235952,Berkeley,Berkeley,45,15,South Carolina,SC
45017,45CS006,149,143,156,193,37,44,50,1227.6999710675148,15,422.95220640067674,6.422884112145647,7.996471159626664,9.762626854965768,0.3367730624923528,183,175,190,235,45,52,60,369.395098416461,39,275.44318101560845,0.4350476688223771,0.9316815625485045,1.447909785981359,0.7316709121927203,14186,14159,Calhoun+Richland,Calhoun,45,17,South Carolina,SC
45079,45CS006,2673,2494,2852,3272,420,599,778,574.8779035720452,304,291.75714097196396,1.1914607450497094,2.8599607100410225,4.561256818040517,0.5066656384726174,3317,3102,3533,3987,454,670,885,160.16597355521773,429,102.62004033039346,0.023497098874445618,0.5658014510177528,1.0764439330485196,0.6397551476907802,416785,418047,Calhoun+Richland,Richland,45,79,South Carolina,SC
45019,45CS007,2865,2688,3041,3276,235,411,588,400.9418822489574,274,267.1476624579535,-0.40043686965406267,1.342054140521885,3.1170163032982705,0.6646838685492442,3549,3336,3762,3835,73,286,499,69.28612726890942,378,91.63680793603848,-0.7591012343816197,-0.22480054886732664,0.2918174620674014,1.3179737589091003,410260,412498,Charleston,Charleston,45,19,South Carolina,SC
45021,45CS008,561,537,585,680,95,119,143,845.707893169953,85,603.5431533354634,0.6599009297241673,2.3934581472247194,4.106681712521195,0.7077124858637448,685,656,714,935,221,250,279,446.4529881715489,187,333.505733801787,0.6135903405670953,1.1262335615727466,1.612064575264155,0.7440397591043331,56334,56071,Cherokee,Cherokee,45,21,South Carolina,SC
45023,45CS009,365,351,379,474,95,109,123,1352.4091571982246,46,570.436507936508,6.071240122609717,7.871464721014906,9.595916099907097,0.41796039630400694,447,430,463,546,83,99,116,307.80105292087364,85,263.81948539681554,-0.07016408756105744,0.4479201332650555,0.9549964714817042,0.8485538839440244,32256,32219,Chester+Fairfield,Chester,45,23,South Carolina,SC
45039,45CS009,236,227,245,329,84,93,102,1761.1342966222344,41,778.9493682910611,8.093852608949538,9.838060602209552,11.601417207722575,0.4375792939579924,286,276,297,392,95,106,116,510.21075965256716,50,241.38263976054841,2.160096557227808,2.703756710374404,3.172651940137489,0.46866919811543806,21054,20714,Chester+Fairfield,Fairfield,45,39,South Carolina,SC
45025,45CS010,432,413,450,597,147,165,184,1517.9446135720168,67,614.6084164660016,7.381414872880872,9.056869993799195,10.736876688092446,0.4024629841111253,526,504,549,694,145,168,190,387.2221606681767,113,261.16902026948947,0.7590650510085978,1.2827038154729786,1.7674300487046961,0.6704663229046953,43605,43267,Chesterfield+Marlboro,Chesterfield,45,25,South Carolina,SC
45069,45CS010,300,289,312,356,44,56,67,843.5145211527818,38,574.3434725108634,0.8347202717795152,2.656041938612307,4.43616639960873,0.6689077481272547,366,352,379,458,79,92,106,349.05741673741215,73,276.462791138042,0.22721944255912432,0.7230637518927961,1.2423915512744275,0.7835256885666019,26465,26405,Chesterfield+Marlboro,Marlboro,45,69,South Carolina,SC
45027,45CS011,321,308,335,501,166,180,193,2282.122460572729,77,978.3679044503033,11.29686088568778,12.974708555516292,14.773786797065199,0.426335949970826,391,375,407,563,156,172,188,553.6396842933742,70,225.55906425211057,2.7401129707742324,3.285779659805703,3.8102018987180113,0.40505382269810475,31481,31034,Clarendon+Williamsburg,Clarendon,45,27,South Carolina,SC
45089,45CS011,357,344,370,469,99,112,125,1456.7960508126496,79,1027.1746196853467,2.5955660261605686,4.320266599343552,6.09101941432798,0.6988541535318042,434,418,450,540,90,106,122,347.8758008561843,72,235.71779341954496,0.5950193074915426,1.1496099187905922,1.6094130226113044,0.6712744475530812,30764,30545,Clarendon+Williamsburg,Williamsburg,45,89,South Carolina,SC
45031,45CS012,690,663,717,879,162,189,216,1191.2690009826265,101,637.4049414660313,3.9266750564649993,5.490256299463288,7.31472172060776,0.5322441698007304,840,807,872,1099,227,259,292,413.37308841928507,154,245.35576586049774,1.1692801993070427,1.6823868234735453,2.1619342744511876,0.591266715684337,63382,62766,Darlington,Darlington,45,31,South Carolina,SC
45033,45CS013,304,292,316,461,145,157,169,2198.0685552039286,48,672.1512340276562,13.567637674826623,15.255340187712937,16.969261983434883,0.30385598813592024,368,354,383,503,120,135,149,478.71720560678995,65,231.1850903400199,2.0023251702232407,2.4561391004017925,2.993951598537782,0.4793647150996564,28565,28116,Dillon+Marion,Dillon,45,33,South Carolina,SC
45067,45CS013,340,328,353,468,115,128,140,1750.006440568596,80,1094.4661057527874,4.965476467015631,6.544040923827984,8.15769261839519,0.6205556542245733,412,397,426,517,91,105,120,366.0028972165573,80,277.5657483866491,0.3948488530651972,0.8851237728818723,1.388170359347971,0.7512487982778958,29238,28822,Dillon+Marion,Marion,45,67,South Carolina,SC
45035,45CS014,1037,967,1107,1252,145,215,285,529.0619396975716,103,253.78678214375913,0.9979992603373145,2.748931917601018,4.386623191478201,0.4774683366838717,1288,1204,1372,1589,217,301,385,184.38074815432242,229,140.3788389627904,-0.054288790383614366,0.44053817129650275,0.9828920218843832,0.7588301457191535,162341,163130,Dorchester,Dorchester,45,35,South Carolina,SC
45041,45CS015,1317,1259,1376,1751,375,434,492,1266.2129679837176,240,700.8987566348098,4.003823108914652,5.714827424667331,7.403531657983784,0.5522656388784594,1616,1546,1687,2061,374,445,515,325.7389921152107,275,201.39438146292878,0.741454521041482,1.2316252798944545,1.7241740483269663,0.6168822793131264,136967,136548,Florence,Florence,45,41,South Carolina,SC
45043,45CS016,687,660,714,885,171,198,225,1248.9658183528559,91,573.8609490777235,4.9818381515119725,6.824584195548836,8.479004912068241,0.4571606448796111,845,812,878,1053,175,208,241,326.16310427365227,126,197.33441919468765,0.7741143623301289,1.2910905132226713,1.8192020294925597,0.6021263555787958,63430,63851,Georgetown,Georgetown,45,43,South Carolina,SC
45045,45CS017,3872,3645,4099,4546,447,674,901,511.29456369616855,449,340.55915413904523,-0.020993118929825333,1.6970722335014448,3.396444606584612,0.665085689678147,4801,4526,5076,5780,704,979,1254,183.72794349106977,881,165.34230172999472,-0.3070659898645592,0.1809321203858448,0.7532666268394416,0.8990117448806004,527368,532834,Greenville,Greenville,45,45,South Carolina,SC
45005,45CS018,91,90,92,119,27,28,29,1372.4217989735691,14,694.0141281447515,6.396166899184301,6.795006603408635,7.202976079370497,0.48805692050920024,110,109,111,155,44,45,46,572.7277574155777,17,215.81820490034278,3.4436278477750912,3.5679260460402547,3.697655960517345,0.36865347762228595,8069,7877,Hampton and Nearby Counties,Allendale,45,5,South Carolina,SC
45009,45CS018,160,154,166,205,39,45,51,1352.35767205443,31,927.4495138369483,2.6829311055461074,4.266901430679189,5.956025325608598,0.6709585622175752,195,188,201,237,36,42,49,321.4144729400869,24,181.84573420215185,0.9110375187968801,1.3903924614877412,1.9322599041729147,0.5527370808732329,13370,13198,Hampton and Nearby Counties,Bamberg,45,9,South Carolina,SC
45011,45CS018,219,210,228,296,68,77,86,1487.2735854093094,34,659.5538312318138,6.510435931597024,8.321197462253354,10.023007535071823,0.437755351954879,270,259,281,317,36,47,58,228.5430031254046,51,247.83749635533093,-0.7175650940887501,-0.1985098515523762,0.3028448382410716,1.0618456556849576,20620,20578,Hampton and Nearby Counties,Barnwell,45,11,South Carolina,SC
45029,45CS018,474,458,491,558,67,84,100,870.481691442926,59,614.3913360408205,0.7865369115988182,2.5750389093349115,4.320517403493321,0.6974625393057889,583,563,603,729,126,146,166,380.41125324691154,122,317.097260487602,0.09907755563474961,0.6483364029989979,1.162364254745937,0.8279076789598055,38412,38474,Hampton and Nearby Counties,Colleton,45,29,South Carolina,SC
45049,45CS018,199,191,207,250,43,51,59,1097.7927124374332,31,666.8459263242808,2.722747952502365,4.35188137964229,6.026055840491696,0.5957684444701565,241,232,250,294,44,53,62,290.60456942247345,36,197.49835418038185,0.40628512711385356,0.9432953480748247,1.408307109217262,0.6670199288905735,18595,18228,Hampton and Nearby Counties,Hampton,45,49,South Carolina,SC
45053,45CS018,227,214,240,269,29,42,55,570.7240655429437,24,326.7417718934005,0.6998335303209303,2.4432078400753476,4.081758865215228,0.5591654158505083,290,275,306,387,81,97,112,321.17103678826174,68,225.5988321942804,0.4773580022601838,0.9507195698393883,1.443603530642607,0.6952441036139398,29381,30142,Hampton and Nearby Counties,Jasper,45,53,South Carolina,SC
45051,45CS019,3289,3137,3442,4023,581,734,886,826.739358670617,353,397.86864135748726,2.596636360683984,4.335076805626804,6.001827120568709,0.48059519020582014,4129,3941,4317,5256,939,1127,1315,309.82477919052866,639,175.63775194672047,0.8222610621627815,1.3486749428379512,1.904596274480012,0.5663913393920471,354891,363817,Horry,Horry,45,51,South Carolina,SC
45055,45CS020,598,569,626,716,90,118,147,719.9891219319984,73,443.93766628658307,1.0029937072782855,2.7570704059785793,4.430551886664228,0.6114250487380606,739,705,773,985,212,246,280,372.33733145501463,124,187.756461699196,1.3262989121499107,1.836306811809307,2.3295024206762593,0.502222041298975,65775,66043,Kershaw+Lee,Kershaw,45,55,South Carolina,SC
45061,45CS020,202,195,209,267,58,65,72,1566.385646244718,51,1236.513516789914,1.543865475143104,3.331123685562734,4.945536238908002,0.7773729479342175,245,237,253,296,43,51,59,312.6018385395444,53,325.03372991536855,-0.6661185746962678,-0.11295640571800454,0.3954467190933337,1.0197630896375505,16498,16306,Kershaw+Lee,Lee,45,61,South Carolina,SC
45057,45CS021,816,774,858,968,110,152,194,624.3669806907171,94,386.5409723150309,0.6302694040536524,2.36077092008044,4.068868757371334,0.6150418698368746,1026,975,1078,1295,217,269,320,269.1087827086174,174,174.3504443932304,0.4338656016015764,0.9381737606523795,1.442094022371716,0.6454775095501845,97273,99799,Lancaster,Lancaster,45,57,South Carolina,SC
45059,45CS022,745,716,774,851,77,106,135,628.1735640192206,79,467.7185400076967,-0.12263005817954309,1.5841461832690946,3.251557965244358,0.7376169806833173,915,880,950,1127,177,212,247,312.5657537649736,180,265.61992739721984,-0.039326198989837025,0.47384264429158324,0.9846077013802826,0.8458117638536042,67562,67766,Laurens,Laurens,45,59,South Carolina,SC
45063,45CS023,2200,2073,2327,2618,291,418,545,564.763836938438,235,317.4624617525279,0.8460117259571429,2.4414915758716758,4.204761221207924,0.5607740599977467,2740,2585,2894,3290,396,550,705,183.76361074481292,405,135.28319281696352,-0.05182170518854152,0.46603774573597134,1.0152696245334212,0.7348447833308543,296098,299372,Lexington,Lexington,45,63,South Carolina,SC
45071,45CS024,364,348,381,488,107,124,140,1305.9023362032901,67,708.1516712907913,4.179028494635717,5.989590531955965,7.654920049304641,0.5379163386441205,444,425,464,562,98,118,137,310.18002964995395,71,187.0636279805032,0.7425443318225516,1.242331879313042,1.7372199560905597,0.5980013434674875,37845,37955,Newberry+Saluda,Newberry,45,71,South Carolina,SC
45081,45CS024,168,160,177,267,90,99,107,2069.034120196959,30,629.7559695617948,12.706423390155996,14.383731798600547,16.061098313368124,0.30131489934847516,203,194,213,285,72,82,91,434.29008574545884,44,233.76899373074062,1.4878346286432838,2.00309983924754,2.541095375440102,0.5317729507456507,19055,18822,Newberry+Saluda,Saluda,45,81,South Carolina,SC
45073,45CS025,801,767,835,869,34,68,102,346.64130249660775,75,380.63820338768005,-1.96439316432423,-0.3311946688713759,1.4273389291600453,1.0822302240879165,985,944,1025,1193,168,208,249,263.46249969090974,205,259.0968263798486,-0.4316220872079441,0.06104631600418259,0.5652124311629326,0.9787344195632496,78815,79121,Oconee,Oconee,45,73,South Carolina,SC
45075,45CS026,881,845,918,1155,237,274,310,1299.6056911333935,132,627.1826669517498,4.938518474045985,6.718866704479517,8.363673510563583,0.48083663514017566,1069,1026,1112,1417,305,348,391,418.51177659894006,190,228.6209344579879,1.403516347120089,1.8915043023731144,2.4211962805299687,0.5447051216260264,84186,83107,Orangeburg,Orangeburg,45,75,South Carolina,SC
45077,45CS027,1108,1052,1165,1319,154,211,267,643.8270762319893,145,442.77513130572856,0.160400532077637,1.9840260656232602,3.6546218433487883,0.6844772657353357,1370,1302,1438,1697,259,327,395,247.5161054967665,296,224.0082338161619,-0.2872862674187901,0.2510403072382514,0.7645449711784256,0.9022661868260342,130992,132138,Pickens,Pickens,45,77,South Carolina,SC
45083,45CS028,2833,2691,2975,3356,381,523,665,636.5402098200047,382,464.84319147706356,-0.12881185685058194,1.739402344625445,3.4937583825108733,0.7288718673255442,3518,3345,3691,4304,613,786,959,234.5997693436643,803,239.76161186685616,-0.5438660477836202,-0.04286203348709453,0.4909898100337642,1.020703679516805,328713,334916,Spartanburg+Union,Spartanburg,45,83,South Carolina,SC
45087,45CS028,328,317,340,409,69,81,92,1187.3097191674215,43,633.6341867747284,3.7636868159300088,5.599089877581689,7.303602846911991,0.5271299968088438,398,384,412,516,104,118,132,437.66625704386354,71,262.6225263547254,1.210568545678451,1.7386362076164705,2.2753096083677593,0.5950232294376413,27145,27035,Spartanburg+Union,Union,45,87,South Carolina,SC
45085,45CS029,963,917,1008,1223,215,260,306,987.1356386754798,127,481.39794932054656,3.298793380412709,5.064984887869762,6.788084339835071,0.48580606920336866,1173,1119,1227,1514,287,341,395,325.22767955176687,206,196.46365422396855,0.7790637672354614,1.2772083605595164,1.8231971690884146,0.6023141181204328,105526,104854,Sumter,Sumter,45,85,South Carolina,SC
45091,45CS030,1932,1810,2055,2240,185,308,430,433.1284224569673,224,315.45074954759576,-0.5645201288825888,1.1209689966382992,2.958084755388529,0.7259473380074761,2408,2259,2556,2837,281,429,578,149.17263246737488,370,128.512382341704,-0.30676923137824647,0.21352934948234237,0.7343129139051146,0.8594998257431563,284038,287910,York,York,45,91,South Carolina,SC
46005,46CS001,174,166,182,195,13,21,29,441.68909007659977,36,756.5806756685756,-4.731312741893027,-3.0953483473960652,-1.4873980748711757,1.6351245739999631,213,204,223,184,-39,-29,-20,-153.70874749229571,13,67.97385620915033,-2.7597012726714953,-2.242841012419153,-1.7287712144245064,-0.45779809467506116,19033,19125,Clark and Nearby Counties,Beadle,46,5,South Dakota,SD
46025,46CS001,35,35,36,34,-2,-1,-1,-138.44346904763432,0,0,-1.7871250345449727,-1.3732040453423544,-0.9947162087578323,-0,43,43,44,31,-13,-12,-12,-319.2007972672459,6,155.68240788790868,-4.880092535502364,-4.747709956146657,-4.60662299570181,-0.5308795501663185,3834,3854,Clark and Nearby Counties,Clark,46,25,South Dakota,SD
46029,46CS001,210,198,223,300,77,90,102,1266.6154636308015,68,961.4704842700601,1.378446839387292,3.062873558254695,4.720112652220226,0.7507061716434018,260,245,274,280,6,20,35,72.06915009477835,17,59.8380851812742,-0.38836381684173504,0.11446103652016744,0.601213955803563,0.7916238543746432,28290,28410,Clark and Nearby Counties,Codington,46,29,South Dakota,SD
46039,46CS001,40,40,40,40,-0,-0,0,-2.5169111921067175,4,372.006510113927,-4.135563463389994,-3.740877556003613,-3.320025656690876,4.111263483779964,49,48,49,41,-8,-8,-7,-175.9171252065025,4,93.54536950420955,-2.810536650491805,-2.690351829679866,-2.5765113522165617,-0.61328846393054,4301,4276,Clark and Nearby Counties,Deuel,46,39,South Dakota,SD
46057,46CS001,54,54,55,90,35,36,36,2297.5717198178572,28,1811.1254851228975,4.475615100522047,4.875116131748639,5.266915714964545,0.7666935446305471,67,66,68,53,-15,-14,-13,-225.2949228519024,5,80.10253123998719,-3.1822650656272704,-3.0546648181545972,-2.9249821593821563,-0.38276313244536597,6184,6242,Clark and Nearby Counties,Hamlin,46,57,South Dakota,SD
46077,46CS001,56,56,57,57,0,1,1,56.072846051962486,12,929.3320425943853,-9.137634989818347,-8.75526949390824,-8.32364763084145,6.9603928285995105,69,68,70,72,2,3,4,57.78029967928361,8,153.99422521655438,-1.082767331902641,-0.9655040681366562,-0.8269675495407784,1.9991570712448459,5165,5195,Clark and Nearby Counties,Kingsbury,46,77,South Dakota,SD
46115,46CS001,61,60,61,95,34,34,35,2155.078626656043,20,1261.8296529968454,8.503595496414398,8.921619637888039,9.291057896020607,0.5688606332323628,73,73,74,68,-6,-5,-5,-87.16969401153202,10,159.26102882624622,-2.586149729879825,-2.463257854613655,-2.336195482988297,-2.2354435859090964,6340,6279,Clark and Nearby Counties,Spink,46,115,South Dakota,SD
46027,46CS002,94,93,96,98,2,4,5,104.00454865795587,12,322.53729337454644,-2.6017775355031674,-2.189179980469503,-1.8063143557882317,2.4643241675374767,118,116,119,115,-4,-3,-1,-16.536486286980672,5,33.051295610787946,-0.6246568217566195,-0.49718443518922745,-0.3538875994020398,-3.3296936552002667,14882,15128,Clay+Turner+Union+Yankton,Clay,46,27,South Dakota,SD
46125,46CS002,92,92,93,127,34,35,35,1604.9918545300332,37,1715.9420289855072,-1.5115745177642725,-1.0996670467511351,-0.676292955661398,1.0391029357562083,114,113,115,109,-6,-5,-4,-57.950141010109874,4,45.96116281741928,-1.1660241748483693,-1.0411470841854567,-0.9038268069939415,-0.9892662700147787,8625,8703,Clay+Turner+Union+Yankton,Turner,46,125,South Dakota,SD
46127,46CS002,119,117,121,142,21,23,25,553.2015806694648,26,622.1956326652708,-1.0920219601639785,-0.6895166522678556,-0.30123800623388086,1.078081680680287,147,145,149,129,-20,-18,-16,-107.63524878779143,8,47.43270484999407,-1.683887990562499,-1.546226554344839,-1.4267863611145848,-0.4663700264776807,16715,16866,Clay+Turner+Union+Yankton,Union,46,127,South Dakota,SD
46135,46CS002,215,205,225,228,3,13,23,225.09766543061903,27,465.79832657638235,-4.113674175311749,-2.456290197297031,-0.5871312136337848,1.9220110315182677,263,251,275,268,-7,5,17,19.763091764751362,13,55.8227413260048,-0.8617876373177122,-0.34218810434500485,0.15153934086290918,2.3204221669696214,23186,23288,Clay+Turner+Union+Yankton,Yankton,46,135,South Dakota,SD
46003,46CS003,25,24,25,41,16,16,17,2380.085909635769,11,1607.5995615637562,7.344208521919021,7.725859339913203,8.119218817039044,0.6363627693494497,31,30,31,46,15,15,16,563.4220724148414,6,218.49963583394026,3.3234105444903546,3.4528091227620985,3.5804889245234164,0.3642639991496348,2737,2746,Douglas and Nearby Counties,Aurora,46,3,South Dakota,SD
46009,46CS003,69,68,69,95,26,26,27,1506.839866047911,21,1204.6464936182417,2.605056059053074,3.0362133283813795,3.3888493219959552,0.7701338862007242,85,84,86,106,20,21,22,299.9240444975466,2,28.534741047224998,2.5892747373156904,2.709221122606344,2.846664187635447,0.09081960767547813,6973,7009,Douglas and Nearby Counties,Bon Homme,46,9,South Dakota,SD
46015,46CS003,47,46,47,48,1,1,2,111.20719791208029,4,304.4719314938154,-2.3291892312945137,-1.9263793482243854,-1.5191067874785276,1.6253657421657628,57,57,58,49,-9,-8,-8,-156.49070022939856,5,95.32888465204957,-2.6386591138708466,-2.5185343731361334,-2.3953033085340825,-0.6936797370055444,5255,5245,Douglas and Nearby Counties,Brule,46,15,South Dakota,SD
46023,46CS003,97,96,98,130,32,33,34,1415.1323765727127,16,686.5479510834584,6.8992880372937915,7.284054430393932,7.718518650896815,0.47086992580372894,118,116,119,117,-2,-1,1,-6.326739649027179,13,141.45810663764962,-1.6036471048487384,-1.4785768053002646,-1.3626587312024647,31.057931609934737,9322,9190,Douglas and Nearby Counties,Charles Mix,46,23,South Dakota,SD
46035,46CS003,193,184,201,221,20,28,37,568.8074624340663,52,1044.1767068273093,-6.555648471415547,-4.742383677222255,-2.968266878894574,1.7731335845220946,236,225,246,235,-11,-1,10,-3.3070383765539333,14,70.40128733782561,-1.2032036552317267,-0.7253662687312343,-0.19448397694317834,40.89234713996449,19920,19886,Douglas and Nearby Counties,Davison,46,35,South Dakota,SD
46043,46CS003,38,37,39,44,5,6,7,871.4630129926504,10,1410.4372355430185,-6.958200517946109,-5.389714850557616,-3.5620210541591915,1.3930151619071358,46,44,47,47,-0,1,3,38.18618913633315,7,248.13895781637717,-2.6152284343794467,-2.093015688637987,-1.5981018342294206,3.3698684918660202,2836,2821,Douglas and Nearby Counties,Douglas,46,43,South Dakota,SD
46067,46CS003,96,95,97,103,6,7,8,381.7980486153624,16,865.6837549032869,-5.22960275651367,-4.841877478949628,-4.442580776330466,1.9859537380768486,118,117,119,109,-10,-9,-8,-121.20048493165338,5,67.46727836999055,-2.017220506842545,-1.8840612522627933,-1.7559289353820011,-0.6263962420558111,7393,7411,Douglas and Nearby Counties,Hutchinson,46,67,South Dakota,SD
46083,46CS004,267,239,295,323,28,56,84,342.6360380128922,66,404.8458825333538,-2.3646518277632307,-0.6481589869472582,1.2614168788763618,1.1607816191170202,345,310,380,310,-70,-35,-0,-52.344488334272455,14,20.72815030870138,-1.2550145817854574,-0.7205726172999475,-0.21184647144467925,-0.40752179432860236,65210,67541,Lincoln+Minnehaha,Lincoln,46,83,South Dakota,SD
46099,46CS004,1301,1216,1386,1619,233,318,403,644.6825959984541,267,541.4503569110967,-0.7249958410243416,0.9294398122397052,2.812178970105178,0.8372376155129114,1620,1517,1723,1681,-42,61,164,30.409699975928405,124,62.1965410697805,-0.803992382158464,-0.31944349706216835,0.2057120850772645,2.012098206232967,197248,199368,Lincoln+Minnehaha,Minnehaha,46,99,South Dakota,SD
46011,46CS005,166,152,181,221,40,55,69,632.2392792645825,29,335.9008513349163,1.138438810264691,2.9579596458115343,4.668702848966529,0.5217293230939243,208,190,226,203,-23,-5,13,-15.351956438054605,5,14.452955629426219,-0.8167371862495133,-0.2819651518205764,0.22824599733574927,-1.1598211967441427,34534,34595,Miner and Nearby Counties,Brookings,46,11,South Dakota,SD
46061,46CS005,21,21,22,19,-3,-2,-2,-261.8856305885541,4,461.62723600692436,-7.631624774568681,-7.242445458040668,-6.8126188315135146,-3.151494741738499,27,26,27,34,7,7,8,213.53016068476182,2,57.15918833952558,1.4376428832829955,1.5661175049392615,1.6845606112504306,0.236087919604357,3466,3499,Miner and Nearby Counties,Hanson,46,61,South Dakota,SD
46073,46CS005,20,19,21,32,11,12,13,2773.254367799277,15,3514.9384885764503,-9.036171051876124,-7.372005807561282,-5.752492698475552,1.168691865503861,24,23,25,12,-13,-12,-11,-727.3263142231323,2,122.02562538133007,-9.033786960649131,-8.497291539323406,-7.979974537779706,-0.18313545365759662,1707,1639,Miner and Nearby Counties,Jerauld,46,73,South Dakota,SD
46079,46CS005,89,88,90,91,1,2,3,80.3150163589357,14,497.77777777777783,-4.547527150427678,-4.175967093016248,-3.795250156777533,4.29598102048829,106,104,107,118,11,12,14,113.85090643275474,4,36.78499172337686,0.646780044292326,0.7666851168324312,0.8975793066423375,0.29895036511513967,11250,10874,Miner and Nearby Counties,Lake,46,79,South Dakota,SD
46087,46CS005,63,63,64,80,16,17,17,1183.4730481196777,23,1628.3185840707963,-4.842738111502215,-4.453727017136358,-4.067635924360836,1.2982206561667087,78,77,79,74,-5,-4,-3,-73.72185356323587,2,35.149384885764505,-1.20479590056084,-1.0898884672502556,-0.9654609333449287,-0.6260224770833993,5650,5690,Miner and Nearby Counties,McCook,46,87,South Dakota,SD
46097,46CS005,27,26,28,26,-2,-1,-0,-247.71248253051596,2,350.109409190372,-7.692797738862862,-5.958426043808166,-4.113302815955567,-4.818608814351461,34,33,35,40,5,6,7,271.5164749035338,3,129.81393336218088,0.8677783271172865,1.4128389401957155,1.9103931816895197,0.41238554710688835,2285,2311,Miner and Nearby Counties,Miner,46,97,South Dakota,SD
46101,46CS005,49,48,49,67,18,18,19,1141.7768627561568,15,943.8414346389807,1.5726789694806085,1.9799925784589754,2.371448599389436,0.7834661977152393,60,59,61,71,10,11,12,177.4485594386474,11,174.16086130462318,-0.09070742621431063,0.03602495929683544,0.15414100327668404,0.9010742514882126,6357,6316,Miner and Nearby Counties,Moody,46,101,South Dakota,SD
46111,46CS005,22,22,22,18,-4,-4,-4,-698.7908317516964,3,515.4639175257732,-12.538598893725354,-12.130839293845511,-11.716967858090532,-0.9781664634892591,28,27,28,30,2,2,3,101.54424699861666,6,253.2714225411566,-1.6421671268484042,-1.5167902093765053,-1.39935044600172,1.7618127726024186,2328,2369,Miner and Nearby Counties,Sanborn,46,111,South Dakota,SD
46017,46CS006,26,25,27,31,4,5,6,1079.3959389362453,12,2465.331278890601,-15.604186290986542,-13.798631707175938,-12.04103775226173,1.918784340282408,31,30,32,53,21,22,23,1136.2313621478643,3,155.76323987538942,9.347806422712106,9.796589473890602,10.319438438963706,0.13109701613646155,1947,1926,North Central South Dakota,Buffalo,46,17,South Dakota,SD
46021,46CS006,13,12,13,16,3,3,4,993.9546356515114,8,2325.5813953488373,-13.724766936410129,-13.333485486439608,-12.911772594362425,1.8102807873532005,15,15,15,26,11,11,11,778.3265124459231,8,580.1305293691081,1.8517765025491666,1.9826255366925853,2.1056193463840858,0.681830427262386,1376,1379,North Central South Dakota,Campbell,46,21,South Dakota,SD
46045,46CS006,34,34,35,42,7,8,8,757.2580600115778,10,1008.827238335435,-2.9317315198147043,-2.5225581061517492,-2.089678384178668,1.175596425816198,42,42,43,59,16,17,17,413.3193359558581,4,99.37888198757764,3.011779230800593,3.1361277567424097,3.2705743072261644,0.226807472050811,3965,4025,North Central South Dakota,Edmunds,46,45,South Dakota,SD
46049,46CS006,28,27,29,38,9,10,11,1783.6120636661506,4,742.4593967517401,8.845683667553878,10.432250213753855,12.064474263173635,0.37703090075874585,35,33,36,30,-6,-5,-3,-210.70338523511973,6,280.8988764044944,-5.445555343744257,-4.911790488792423,-4.401694912226958,-1.7139799850049018,2155,2136,North Central South Dakota,Faulk,46,49,South Dakota,SD
46059,46CS006,41,40,43,42,-1,1,2,73.11961706355578,3,383.1417624521073,-4.78421145017852,-3.1424544371456498,-1.233660232526311,1.9077578699991522,50,48,52,58,6,8,10,255.37746362634985,4,129.03225806451613,0.7750226273070269,1.278101892506341,1.8245353532343316,0.44859638479917063,3132,3100,North Central South Dakota,Hand,46,59,South Dakota,SD
46065,46CS006,156,148,163,175,12,19,27,436.8713988680345,28,633.806802105144,-3.6999114243214644,-1.8853681344405182,-0.043308735423470295,1.3793180755661696,192,183,201,209,8,17,26,97.89508977642244,20,113.02627860977678,-0.6736221322869067,-0.15435811720840623,0.3118892675971362,1.0915519473732602,17671,17695,North Central South Dakota,Hughes,46,65,South Dakota,SD
46069,46CS006,18,18,18,20,2,2,2,542.3923799671891,5,1586.042823156225,-10.830803790894477,-10.448387823240674,-10.02470271505013,1.8450919966091373,22,22,22,36,14,14,14,1146.7035633836429,8,645.682001614205,4.8817519264333145,5.009810264214117,5.138624187813837,0.5260507861876613,1261,1239,North Central South Dakota,Hyde,46,69,South Dakota,SD
46085,46CS006,30,29,30,51,21,21,22,2272.6451511441805,3,321.71581769436995,19.09605220447964,19.516041794003552,19.906568969911255,0.13518131578585804,36,36,37,50,13,14,14,364.3781858555416,1,26.616981634282673,3.244676428492957,3.3794308022431165,3.5140205091554586,0.06807496318985934,3730,3757,North Central South Dakota,Lyman,46,85,South Dakota,SD
46089,46CS006,32,31,33,30,-3,-2,-1,-294.38086019616935,2,333.6113427856547,-7.929977055886391,-6.31808376988868,-4.549626889135596,-2.615017433365659,39,38,40,37,-3,-2,-1,-84.33921583377109,1,41.37360364087712,-1.7687265120406894,-1.2551091617093482,-0.7128206323235903,-0.9629469133392179,2398,2417,North Central South Dakota,McPherson,46,89,South Dakota,SD
46107,46CS006,32,31,33,34,1,2,3,270.40027135148813,5,825.082508250825,-7.2864203219913595,-5.5366491022484015,-3.802545964025226,1.894925871970698,40,39,41,32,-9,-8,-7,-322.2713492355454,1,40.42037186742118,-4.174145479028224,-3.611429407720088,-3.1127610695253938,-0.14341043712127466,2424,2474,North Central South Dakota,Potter,46,107,South Dakota,SD
46117,46CS006,17,16,17,18,1,1,2,191.31195746845717,6,798.9347536617843,-6.509393803914749,-6.075076344293506,-5.682137498242783,2.4622932611596435,20,20,20,34,14,14,14,459.2533434654943,2,66.13756613756614,3.7976995053882723,3.9274280967511066,4.059556462258741,0.13433799249110406,3004,3024,North Central South Dakota,Stanley,46,117,South Dakota,SD
46119,46CS006,11,11,11,10,-1,-1,-1,-302.1148497340602,3,833.9124391938846,-11.75620859658131,-11.366092190789004,-10.947701759459132,-34.539064474238224,14,14,14,15,1,1,1,87.67011757675095,8,543.4782608695652,-4.685577715481036,-4.552291716948721,-4.42903108655041,3.4926808874390165,1439,1472,North Central South Dakota,Sully,46,119,South Dakota,SD
46129,46CS006,61,61,62,69,7,8,8,595.6471611432909,14,1055.8069381598793,-5.023193751009477,-4.607060827961425,-4.170548793333869,1.5733375287537048,73,73,74,86,12,13,13,241.1459664175537,5,95.1655881233346,1.3361449619003505,1.4621762644277647,1.5811439384357873,0.36576955627951857,5304,5254,North Central South Dakota,Walworth,46,129,South Dakota,SD
46013,46CS007,299,283,316,390,74,91,107,946.84342102063,58,605.7915763636838,1.867387502217666,3.3609963467853925,5.16747826557412,0.6328205419350613,366,346,385,372,-13,6,26,16.94247843140542,38,99.69305034499043,-1.382878322783804,-0.8178921945153902,-0.2651893005601661,5.0952240361500465,38297,38117,Northeast South Dakota,Brown,46,13,South Dakota,SD
46037,46CS007,63,63,64,93,29,30,30,2180.874593871421,25,1844.3378827001106,2.9914073175903733,3.3818848774062404,3.7685730764256657,0.8180158469923511,77,77,78,71,-7,-6,-6,-119.75836117003558,6,110.78286558345643,-2.4361786845068623,-2.3103389515491055,-2.181305027302719,-1.0936705412242476,5422,5416,Northeast South Dakota,Day,46,37,South Dakota,SD
46051,46CS007,78,77,78,94,16,16,17,878.2522935101763,33,1767.5415104445635,-9.289059361267753,-8.900490238243314,-8.49751080334729,1.896882008379089,96,95,97,96,-1,0,1,4.759932449298238,2,26.592208482914504,-0.3431024011865186,-0.21442250826106443,-0.09182733772426555,1.4727599936994729,7468,7521,Northeast South Dakota,Grant,46,51,South Dakota,SD
46091,46CS007,33,33,34,41,7,8,8,685.1504687174514,7,637.8132118451025,0.07520606957740071,0.4632473795290887,0.8648834994021543,0.8216419171829624,40,40,41,53,12,13,13,296.1935285722187,5,116.19800139437602,1.672307968837721,1.8008559258973855,1.9165162305667782,0.36376315071735266,4390,4303,Northeast South Dakota,Marshall,46,91,South Dakota,SD
46109,46CS007,95,94,96,108,12,13,14,498.6656558505202,29,1129.7234125438256,-6.7416540724910625,-6.31233370902374,-5.8884430903187095,2.1013354704314873,116,114,117,121,4,5,7,53.52863246900132,10,98.26078412105728,-0.5566957890764717,-0.4479389216468369,-0.32584350034326837,1.5509625528156192,10268,10177,Northeast South Dakota,Roberts,46,109,South Dakota,SD
46019,46CS008,95,94,96,101,5,6,7,248.30329988112788,19,738.2224380767362,-5.305769756452222,-4.9094196985077065,-4.510701051099595,2.5707962859680062,117,116,119,141,22,24,25,226.30937747903297,22,211.01093420295416,0.019865306201030452,0.1533353339216518,0.2780091445806952,0.8944901793093867,10295,10426,Northwest South Dakota,Butte,46,19,South Dakota,SD
46031,46CS008,40,40,40,56,16,16,16,1624.416339173461,14,1429.3006636038795,1.5757940258417815,1.9409705060165092,2.360220891712324,0.827855784036855,49,48,49,57,8,8,9,217.9095549747721,4,103.22580645161291,1.0166848930680903,1.1479779780925086,1.2683148103828739,0.4235495562925944,3918,3875,Northwest South Dakota,Corson,46,31,South Dakota,SD
46041,46CS008,46,45,47,82,35,36,37,2704.7353442081217,16,1202.555430289365,14.617648684697297,15.028989455477772,15.39975651072037,0.43259022550817766,56,55,56,92,36,36,37,694.7985859620205,11,209.8035475872592,4.730471409353065,4.848639305388527,4.979059865134305,0.29389534067842443,5322,5243,Northwest South Dakota,Dewey,46,41,South Dakota,SD
46063,46CS008,11,11,11,11,0,0,0,61.775853558920815,6,1822.3234624145784,-17.996113507745648,-17.607894295032402,-17.216838856454245,4.985885797252127,13,13,14,11,-3,-2,-2,-175.873589810919,5,377.0739064856712,-5.658405290075459,-5.535249964852707,-5.399849926031199,-3.753517606511627,1317,1326,Northwest South Dakota,Harding,46,63,South Dakota,SD
46081,46CS008,210,199,221,248,27,38,49,593.0130925802699,36,556.7799559215869,-1.2959533772457108,0.3430786069264692,1.9897229179403861,0.9150353104333103,261,247,274,305,31,44,58,170.3270261563732,36,137.85708815194914,-0.247574570813375,0.320398218080126,0.7958072171031373,0.7915706588580347,25863,26114,Northwest South Dakota,Lawrence,46,81,South Dakota,SD
46093,46CS008,195,182,208,193,-15,-2,11,-30.216304762199183,18,242.55491173696265,-4.3077407314669065,-2.7037982297840357,-0.9126091874182128,-14.488647615081309,245,229,260,246,-14,1,17,4.704099092543606,28,92.94297284737436,-1.4476121854433779,-0.8819121086748138,-0.3548688484115597,11.583857086601409,29684,30126,Northwest South Dakota,Meade,46,93,South Dakota,SD
46105,46CS008,32,32,32,45,13,13,13,1832.5133066625194,11,1557.5221238938054,2.3250098944409725,2.744382813516608,3.154652541010677,0.7889758426261151,39,39,40,34,-6,-5,-5,-182.90984135345582,2,70.92198581560284,-2.6680324321801345,-2.5404893623464835,-2.4191820568877476,-0.480993826423424,2825,2820,Northwest South Dakota,Perkins,46,105,South Dakota,SD
46137,46CS008,14,13,14,23,9,9,10,1524.3260216050878,3,490.3964037597058,9.956186771107848,10.35303895341407,10.742959924498258,0.29055508740461916,16,16,17,41,24,25,25,1033.949506503992,4,167.99664006719865,8.53423605272986,8.659453278731146,8.78905564631501,0.15613815537356054,2447,2381,Northwest South Dakota,Ziebach,46,137,South Dakota,SD
46103,46CS009,815,768,862,1003,141,188,235,680.7787262063715,129,467.234713003794,0.4537496697125873,2.0948963795436746,3.8581683439473835,0.6826917513502097,1017,960,1075,1252,177,235,292,210.6145361982208,130,116.62749179121884,0.4206267739664419,0.9573337517872698,1.4279705237297693,0.5513997945239373,110437,111466,Pennington,Pennington,46,103,South Dakota,SD
46007,46CS010,32,31,32,32,0,0,1,42.56072093037445,2,236.3367799113737,-2.329195857050503,-1.9350040858470843,-1.5078734608089586,1.4704043256912536,39,38,39,50,11,11,12,328.02504028496423,3,88.15750808110491,2.272970757000353,2.4029538381273827,2.5312801266032454,0.2466559187867256,3385,3403,Southwest Central South Dakota,Bennett,46,7,South Dakota,SD
46033,46CS010,82,81,83,91,8,9,10,413.2449305418774,11,521.0183540556542,-1.4851528464282346,-1.072660750493092,-0.6735335382870056,1.1311480161525704,102,101,103,96,-7,-6,-5,-68.85968121674505,5,58.356676003734826,-1.4006169832489965,-1.2736975658400649,-1.1491016015477165,-1.0204295117646858,8445,8568,Southwest Central South Dakota,Custer,46,33,South Dakota,SD
46047,46CS010,100,100,101,109,8,9,9,503.2483901605467,3,172.68671751331127,2.920608686503599,3.3089245127317395,3.717487923354368,0.3079234031621543,126,125,127,149,22,23,24,319.6338986180605,18,251.15110925073253,0.5532326162204404,0.685216909445033,0.8077712867012845,0.7528809770459552,6949,7167,Southwest Central South Dakota,Fall River,46,47,South Dakota,SD
46053,46CS010,48,47,48,76,28,28,29,2803.2853516751043,26,2587.064676616915,1.7657153938605836,2.1719093430952108,2.5611343789559147,0.891234502793241,58,57,58,75,17,17,18,433.2637834094947,3,75.39582809751194,3.4432328790119238,3.5779665766581434,3.7113575265090373,0.16447759829165362,4020,3979,Southwest Central South Dakota,Gregory,46,53,South Dakota,SD
46055,46CS010,22,21,22,24,2,2,3,512.7712236203042,5,1072.3860589812332,-5.997388884565687,-5.614110113101569,-5.224959104854609,1.474580083994262,26,26,26,28,2,2,2,108.1782055015452,7,380.4347826086957,-2.8377318677727916,-2.721361751460785,-2.6113209321234327,2.3407621467797557,1865,1840,Southwest Central South Dakota,Haakon,46,55,South Dakota,SD
46071,46CS010,25,25,25,42,17,17,17,2374.1438811299226,13,1796.821008984105,5.385849728427649,5.775472146845014,6.173216730479344,0.7151922408860842,30,30,30,70,40,40,40,1392.9838042297367,3,104.60251046025104,12.74764893139859,12.883893171716537,13.013490620475178,0.07325868589743999,2894,2868,Southwest Central South Dakota,Jackson,46,71,South Dakota,SD
46075,46CS010,10,10,11,4,-7,-6,-6,-2794.047823775738,4,1742.9193899782138,-45.759848605394,-45.366553016447,-44.949310257849824,-0.7390519037329356,12,12,12,13,1,1,1,84.07898835639153,2,225.7336343115124,-1.5448622965985832,-1.4156551738950696,-1.2893592672190362,1.1461713222300083,918,886,Southwest Central South Dakota,Jones,46,75,South Dakota,SD
46095,46CS010,23,23,23,27,4,4,4,785.6149915180957,3,619.514713474445,1.2714372863642567,1.6606664360837184,2.0717127086461953,0.6244353288006882,28,28,28,30,2,2,2,110.78328657244506,4,209.53378732320587,-1.1153759971650805,-0.9906247930170128,-0.8677617735283272,1.2841697750078067,1937,1909,Southwest Central South Dakota,Mellette,46,95,South Dakota,SD
46102,46CS010,134,128,140,191,51,57,63,1663.6783522963844,33,960.978450786255,5.239374792886353,7.047234966586536,8.675769678342707,0.5676861228515218,162,155,169,194,25,32,39,232.90205400192335,6,44.12089124200309,1.3333184180536788,1.8939787794544733,2.411089538562136,0.1836415176916041,13736,13599,Southwest Central South Dakota,Southwest Central South Dakota,46,102,South Dakota,SD
46121,46CS010,72,71,73,118,45,46,47,1929.628255038895,23,972.618670049688,9.16601031062331,9.574338459593402,9.94078728516433,0.49323533992135327,87,86,88,140,52,53,54,571.9812458625056,15,161.44656118824668,3.9816034295203893,4.107152883228979,4.223528630185622,0.2770452621366339,9459,9291,Southwest Central South Dakota,Todd,46,121,South Dakota,SD
46123,46CS010,65,64,66,81,15,16,17,1149.3566950594281,13,933.0701596985465,1.7737280136370461,2.174004418497306,2.5942788439995437,0.7641030430811122,79,79,80,68,-12,-11,-11,-202.67586837350694,2,35.88087549336204,-2.5078655604340256,-2.3865421811257814,-2.259376429497279,-0.19422844535893635,5573,5574,Southwest Central South Dakota,Tripp,46,123,South Dakota,SD
47001,47CS001,863,830,897,928,31,65,98,334.78303077839456,69,357.4435019102506,-1.890829757562927,-0.27812440645392505,1.3411801347454964,1.0514176878915131,1062,1022,1102,1271,169,209,249,270.111657243561,140,180.59389592631769,0.39541311870385903,0.8843184789230809,1.4395331874055286,0.6654120198557356,77215,77522,Anderson,Anderson,47,1,Tennessee,TN
47003,47CS002,450,428,472,514,42,64,86,508.4111549043359,68,540.7877209376304,-1.9542867628396403,-0.3497471627534177,1.4259441322466047,1.0472995976245163,560,533,586,668,82,108,135,212.35068370463713,112,219.6078431372549,-0.5890154449991079,-0.05740749857627046,0.42800194765185817,1.0247134470584582,50297,51000,Bedford+Lincoln+Moore,Bedford,47,3,Tennessee,TN
47103,47CS002,385,369,400,461,61,76,92,868.3726704011052,42,477.3405313254724,2.226150582331382,3.8846786205411727,5.625966442067763,0.5425940156167695,473,454,491,550,59,77,96,218.83091902833428,94,265.424255259071,-0.9831974070280743,-0.4593884172178402,0.07859733566365723,1.1974679416974818,35195,35415,Bedford+Lincoln+Moore,Lincoln,47,103,Tennessee,TN
47127,47CS002,59,58,60,68,8,9,10,549.7352997199866,4,247.14241581711462,2.6135345048617866,3.0374272229970987,3.427026105759937,0.40414385564284533,74,73,75,95,20,21,22,314.1233205321792,17,256.91400936980506,0.4481500706654013,0.5728644629113195,0.7103483592175279,0.7803341072408986,6474,6617,Bedford+Lincoln+Moore,Moore,47,127,Tennessee,TN
47005,47CS003,215,208,222,264,42,49,56,1240.996410402415,34,856.6929133858267,2.194545767828085,3.889483432323577,5.623219626208912,0.6765893800818236,261,253,269,331,62,70,78,440.8157158008669,56,353.02275735989406,0.36694545788045635,0.8731667221723806,1.4015093871479292,0.7895486653896644,15875,15863,Benton+Carroll+Henry,Benton,47,5,Tennessee,TN
47017,47CS003,367,355,379,459,80,92,104,1301.608018411077,53,748.7462032916578,3.8519949429825933,5.498531449606374,7.132166013112767,0.5690705419966609,447,432,462,484,22,37,52,129.79650065903516,73,256.7710165318326,-1.800854282304765,-1.2600309269503682,-0.7760181953737649,1.9260631765987237,28314,28430,Benton+Carroll+Henry,Carroll,47,17,Tennessee,TN
47079,47CS003,401,387,415,473,58,72,86,895.449917360806,46,572.2104739395447,1.4247539872844976,3.2169890173281415,4.928883820192396,0.630264603170647,489,472,505,567,62,78,95,242.63736649007382,71,220.35318581049623,-0.3191340014505032,0.2336603033587179,0.7336988609629325,0.8966889788366466,32156,32221,Benton+Carroll+Henry,Henry,47,79,Tennessee,TN
47007,47CS004,141,135,148,150,2,9,15,230.15022384700345,6,160.17084890549918,-1.0239226250171067,0.6989081091900347,2.4193494619729576,0.6236080946951367,174,167,182,184,2,10,17,62.891219777861416,37,243.5813034891376,-2.3092247180278824,-1.7997817007131343,-1.3286679209893175,3.506053438640581,14984,15190,Bledsoe+Rhea+Van Buren+White,Bledsoe,47,7,Tennessee,TN
47143,47CS004,360,346,374,431,57,71,85,860.2800735812652,46,558.0661793697492,1.2774565361838035,2.950834356720655,4.840858260765126,0.6396819544476455,439,422,456,552,96,113,130,340.3520392074738,66,199.3837230378829,0.9017729111979454,1.4225056986369735,1.9404820436731562,0.5806621962242154,32971,33102,Bledsoe+Rhea+Van Buren+White,Rhea,47,143,Tennessee,TN
47175,47CS004,78,77,79,77,-2,-1,-0,-68.75841728957813,7,455.7291666666667,-5.6515851616532435,-5.248929858006671,-4.838488873367628,-124.7120719660906,98,97,99,146,47,48,49,758.8123009388287,36,571.2472231037766,1.7492477990253685,1.8763613072089078,2.0004335663730752,0.737397399062368,6144,6302,Bledsoe+Rhea+Van Buren+White,Van Buren,47,175,Tennessee,TN
47185,47CS004,320,308,332,346,14,26,38,379.76263799925385,32,466.45530410699325,-2.724315430846009,-0.8837682358234586,0.9163670025867308,1.1828778560449411,391,376,405,483,78,92,107,334.03768637787323,73,264.3299417025745,0.18103373164302367,0.7061673855035131,1.2136554042354704,0.782831851105115,27441,27617,Bledsoe+Rhea+Van Buren+White,White,47,185,Tennessee,TN
47009,47CS005,1284,1226,1342,1417,75,133,191,392.28313632510543,105,310.0500509367941,-0.8728133522922662,0.8255620717157177,2.553927324505866,0.7844681549262068,1594,1523,1665,1917,252,323,394,235.0875256924672,192,139.83161942494246,0.4418692789156827,0.9427544155944235,1.4297400689609352,0.5929696411642682,135462,137308,Blount+Loudon,Blount,47,9,Tennessee,TN
47105,47CS005,596,572,620,600,-20,4,28,28.831526873744064,47,341.142100201419,-4.827713374820406,-3.1791748502975357,-1.382360686674061,9.45257230291611,745,716,775,834,59,89,118,156.83803597031434,94,166.4954479436041,-0.6631839883062826,-0.10242638175426197,0.4533580187570463,1.0497208271310032,55109,56458,Blount+Loudon,Loudon,47,105,Tennessee,TN
47011,47CS006,970,923,1017,1194,177,224,271,823.1779907626398,72,264.6693930064789,3.8713767678934525,5.578244459840958,7.200941395095463,0.3200920689181599,1204,1147,1261,1597,336,393,450,357.23649820268287,219,199.17238870447002,1.0341985389302997,1.5637270197193402,2.062732323329661,0.5561207169744383,108815,109955,Bradley+Polk,Bradley,47,11,Tennessee,TN
47139,47CS006,216,209,224,246,22,30,37,684.7513509979922,13,297.6020145367138,2.260920226525876,3.8401456837008734,5.636011477458776,0.4205534038370703,267,258,276,347,71,80,89,449.8770173973569,41,231.03798038994705,1.6810398858949738,2.1985976204502875,2.6585885760422534,0.5072049357557178,17473,17746,Bradley+Polk,Polk,47,139,Tennessee,TN
47013,47CS007,505,488,522,548,26,43,60,438.75707821571666,41,416.4444783017191,-1.513583113354369,0.1913198426524421,1.9882589066783571,0.9276704146862269,616,596,637,779,142,163,183,411.8370411736783,80,202.3574644609703,1.598853413774453,2.1010694686082454,2.6106058765154523,0.48835381197961086,39381,39534,Campbell+Claiborne+Hancock+Scott,Campbell,47,13,Tennessee,TN
47025,47CS007,368,354,382,409,27,41,55,510.7369285829404,24,299.588066408688,0.38915193299778517,2.1888301393631027,3.838303667367684,0.5725855302695312,450,434,467,598,131,148,164,457.84367005785185,111,344.3568902401191,0.6229327707592281,1.135854480828661,1.6543660955455173,0.7470656040101054,32044,32234,Campbell+Claiborne+Hancock+Scott,Claiborne,47,25,Tennessee,TN
47067,47CS007,85,85,86,94,8,9,9,514.3552442253159,5,301.34096730450506,1.7274164838472934,2.1369392344574116,2.5243002254046454,0.5244146819313303,106,106,107,126,19,20,20,289.40575778216834,18,266.1540736359604,0.1015399887807693,0.22928054614697715,0.36059350610189234,0.8749539446624346,6637,6763,Campbell+Claiborne+Hancock+Scott,Hancock,47,67,Tennessee,TN
47151,47CS007,232,223,242,242,0,10,19,177.3942611264971,28,511.69590643274853,-5.057001433394288,-3.3614454929694935,-1.6392362157283848,2.615108197437843,283,272,295,377,82,94,105,427.09967790246895,56,255.63772482424906,1.181185596461905,1.707782355870734,2.2131082249533214,0.5922137297102398,21888,21906,Campbell+Claiborne+Hancock+Scott,Scott,47,151,Tennessee,TN
47015,47CS008,159,152,165,181,16,22,29,613.0228784859291,16,439.77186834329694,0.06910215466720798,1.7731741728276469,3.307150987969866,0.6865978917919586,193,186,201,215,14,22,29,150.07134575248253,27,185.54150632215504,-0.9016899310637415,-0.3590774782624925,0.1753063685573081,1.1822203395790987,14553,14552,Cannon+DeKalb+Warren,Cannon,47,15,Tennessee,TN
47041,47CS008,215,206,224,274,50,59,68,1166.7772625241043,30,592.943966795138,4.002340295408503,5.724615765767977,7.440419845195449,0.4997243553986538,264,254,275,335,60,71,81,345.85355956791904,45,220.23197768315958,0.7402792314329855,1.2601411493588623,1.7954895851880144,0.6278930361183237,20238,20433,Cannon+DeKalb+Warren,DeKalb,47,41,Tennessee,TN
47177,47CS008,434,416,451,503,52,69,87,673.329757551238,51,496.2175573447496,0.0553892331760364,1.8525648162856325,3.4101714277426805,0.7264631375174778,533,511,554,612,58,79,101,191.60964854738276,90,217.12907117008442,-0.7846241282599051,-0.25095655589335575,0.21625688948502544,1.1190939909347115,41111,41450,Cannon+DeKalb+Warren,Warren,47,177,Tennessee,TN
47019,47CS009,654,630,678,786,108,132,156,937.0212116953287,87,618.029409675357,1.5398444373869564,3.1894967894242785,4.982788896531294,0.6546054928910605,804,775,833,955,122,151,180,269.2671789519842,128,227.92022792022792,-0.10466719524330267,0.4217761031233351,0.9715846328086236,0.8408857149910726,56308,56160,Carter+Johnson+Unicoi,Carter,47,19,Tennessee,TN
47091,47CS009,224,216,232,258,26,34,42,753.1279101662377,33,735.0075171223342,-1.7175131081149981,0.13326110647721112,1.9340661436290363,0.9479064959565057,278,269,288,303,15,25,34,136.7712373290827,44,242.55788313120178,-1.6003860666969905,-1.0615250653318427,-0.497336122695744,1.7047456178666507,17959,18140,Carter+Johnson+Unicoi,Johnson,47,91,Tennessee,TN
47171,47CS009,251,244,259,291,32,40,47,890.6402182237958,26,582.4372759856631,1.463638119332807,3.114455427486624,4.751059869784289,0.637908768744247,306,297,315,375,60,69,78,389.79820683393325,34,191.8411104214862,1.449979548569134,1.9766027291028518,2.4701629313165694,0.48513256881494976,17856,17723,Carter+Johnson+Unicoi,Unicoi,47,171,Tennessee,TN
47021,47CS010,374,356,392,434,42,60,78,583.387819936129,29,282.2727825769558,1.2800868452109766,3.007511189543565,4.6477491448073565,0.47591066454895087,461,440,483,565,82,104,125,249.9766862679688,64,154.3693769748426,0.4086803159275559,0.9441619909428688,1.4571276610380435,0.6116334535356641,41095,41459,Cheatham+Dickson,Cheatham,47,21,Tennessee,TN
47043,47CS010,516,492,539,565,26,49,73,362.51610429371584,68,499.65097909548473,-3.086646615761908,-1.3235107456035067,0.2886942367685286,1.350904918783985,638,610,667,771,104,133,161,240.8629664749403,140,253.77490166222563,-0.6636655330766893,-0.12454972211395479,0.45001387580565,1.0457370056573863,54438,55167,Cheatham+Dickson,Dickson,47,43,Tennessee,TN
47023,47CS011,167,160,174,195,21,28,35,645.5152365592845,27,622.2273434349254,-1.4895117497537131,0.23068472102521356,1.8995733446801164,0.9306968675789739,206,197,215,263,48,57,66,324.57686765643916,41,234.54035810308335,0.3825958831726823,0.898382277967859,1.3982167945035293,0.7100884945731312,17357,17481,Chester+Madison,Chester,47,23,Tennessee,TN
47113,47CS011,909,867,952,1128,176,219,261,886.0332990739286,155,628.3571500962805,0.9148806251366858,2.595310560824202,4.387145832519727,0.705950089699226,1118,1067,1169,1300,131,182,233,184.6874109108627,171,173.12072892938497,-0.3564142549278925,0.1330702209266152,0.5967156801926063,0.9322611923348725,98670,98775,Chester+Madison,Madison,47,113,Tennessee,TN
47029,47CS012,461,445,476,571,95,110,126,1225.4315469735816,65,720.960541274991,3.3895506000206024,5.090058745512348,6.757785060544148,0.5830545787710166,566,547,585,737,152,171,190,470.95482906992345,97,266.77667766776676,1.5193011300906623,2.03897026731455,2.5671203041050896,0.5631703677250208,36063,36360,Cocke+Jefferson,Cocke,47,29,Tennessee,TN
47089,47CS012,565,541,589,642,53,77,101,560.9191585433296,61,444.41206469473997,-0.5599648154282325,1.068489723431414,2.9067219632656522,0.7821338703576937,698,670,727,891,164,193,221,346.9389044247001,132,237.77785783766257,0.6003039949255055,1.0779059094188304,1.6421517301788038,0.6818193672459283,54904,55514,Cocke+Jefferson,Jefferson,47,89,Tennessee,TN
47031,47CS013,604,579,629,669,40,65,90,449.46183230087087,70,482.7835922547718,-2.161893135834472,-0.3795644182064282,1.1956087632727948,1.0579036821975096,745,715,776,875,99,130,160,220.16416319180493,129,219.03015484922577,-0.4848891219688297,0.015613878716561799,0.5331021026935656,0.9872356888122809,57997,58896,Coffee+Franklin,Coffee,47,31,Tennessee,TN
47051,47CS013,436,418,455,546,91,110,128,1026.76054308764,51,477.1929824561404,3.721604985232973,5.479263876933594,7.110265227614507,0.46055885476125835,536,514,558,650,92,114,136,264.4645737200463,81,187.70856507230255,0.24307789556578585,0.7622385905928463,1.3458480048805774,0.7036029073007803,42750,43152,Coffee+Franklin,Franklin,47,51,Tennessee,TN
47033,47CS014,167,161,173,208,35,41,47,1171.8596939301124,27,774.8600947051227,2.2607517120308693,4.011804097867973,5.811602024525777,0.6454165107586701,205,198,212,212,-0,7,14,49.58832447557468,23,164.69745793054065,-1.6679747598175818,-1.1593755926974303,-0.6000978401684386,2.902204718143328,13938,13965,Crockett+Gibson+Haywood,Crockett,47,33,Tennessee,TN
47053,47CS014,597,575,618,724,106,127,149,1015.1841526752763,87,693.1166347992352,1.5066540198227307,3.2224820718844165,4.877663705050751,0.6774333677577039,733,707,759,919,160,186,212,368.03263584608777,102,201.91222756695765,1.1186936568139765,1.6793394871422316,2.165776706947677,0.5456907780553304,50208,50517,Crockett+Gibson+Haywood,Gibson,47,53,Tennessee,TN
47075,47CS014,190,182,197,230,33,40,48,909.0384026107225,40,903.750564844103,-1.6509925640784242,0.10046078713190273,1.7288338419404863,0.9700723065568561,232,223,241,286,45,54,63,303.3565377176277,41,231.52069569145635,0.24620084875859793,0.7289784938172186,1.2551515165907574,0.7492497095951489,17704,17709,Crockett+Gibson+Haywood,Haywood,47,75,Tennessee,TN
47035,47CS015,738,712,765,865,100,127,153,825.7226205343738,64,417.4071839689554,2.4616791312494337,4.08739642524434,5.762989073207748,0.5015438731173427,912,880,944,1248,304,336,368,539.8592223057997,182,292.2333370799146,1.9638174730452593,2.4908596153382323,3.010901157885233,0.539708736595106,61331,62279,Cumberland+Fentress,Cumberland,47,35,Tennessee,TN
47049,47CS015,222,214,230,273,43,51,59,1100.4796007421933,32,689.543715994182,2.33470985659906,4.170147148441886,5.671319224548976,0.614551342011984,274,264,283,378,95,104,114,555.555751924239,62,329.75215402616743,1.750487483890162,2.239008100202327,2.798789628200424,0.5879251971738015,18563,18802,Cumberland+Fentress,Fentress,47,49,Tennessee,TN
47037,47CS016,4782,4476,5088,5572,484,790,1096,444.522202453695,539,303.23274801161733,-0.27757945057124545,1.4396152267690854,3.175834477918381,0.6812920982158568,5843,5478,6207,5938,-269,95,460,13.491890649853104,687,97.35911625698839,-1.3292722661084504,-0.840050933924078,-0.33817875320275836,7.141112137555218,711005,705635,Davidson,Davidson,47,37,Tennessee,TN
47039,47CS017,151,146,156,199,43,48,53,1665.6418641520322,22,769.8364097629254,7.314770634909976,8.950445845169998,10.797390817405537,0.45267601136546537,183,178,189,210,21,27,32,233.41178520455227,22,193.10102694637058,-0.10919039603811842,0.400141506394151,0.8722022068135554,0.7973150867226761,11431,11393,Decatur+Henderson+Lewis+Perry,Decatur,47,39,Tennessee,TN
47077,47CS017,293,281,305,366,61,73,85,1049.8313684137252,55,789.4925715926219,0.7827333723543454,2.5991218059117376,4.314873721993389,0.7418747622038175,358,343,372,436,64,78,93,280.5169408414662,74,264.91962911251926,-0.361802925180593,0.1635208781576358,0.6844397102354258,0.9324973123664207,27866,27933,Decatur+Henderson+Lewis+Perry,Henderson,47,77,Tennessee,TN
47101,47CS017,152,147,158,171,13,19,24,597.4302555940237,15,476.94753577106513,-0.3273307582310456,1.1563506086225457,2.8706885507334525,0.7579899133710455,188,182,195,224,29,36,42,279.76171304957353,27,210.60842433697348,0.16599471246394354,0.6807570195676537,1.2177467339613124,0.7323930351774562,12580,12820,Decatur+Henderson+Lewis+Perry,Lewis,47,101,Tennessee,TN
47135,47CS017,109,108,110,112,2,3,4,149.31016698979454,17,816.2285439923178,-7.05636195827706,-6.684581610185684,-6.226297524078424,4.136497101756847,135,134,136,145,9,10,11,114.85245840089581,21,248.34437086092717,-1.4610389843865532,-1.339759395186004,-1.2164766858533809,1.9604321530461306,8331,8456,Decatur+Henderson+Lewis+Perry,Perry,47,135,Tennessee,TN
47045,47CS018,407,392,423,533,110,126,141,1367.845888843789,63,686.4240575288734,5.160069503566675,6.795017559002803,8.545909834260803,0.4978627633573142,498,480,517,627,110,129,147,351.0464196197044,85,232.11359912616055,0.658002021624416,1.187772106821516,1.7285833185436943,0.6561011286857303,36712,36620,Dyer+Lake+Lauderdale,Dyer,47,45,Tennessee,TN
47095,47CS018,80,79,81,93,12,13,14,736.2901693040385,12,685.7142857142857,0.1278337352095124,0.49620982322454815,0.9062628648624861,0.8642371351555789,100,99,101,137,36,37,38,524.0763343634636,16,225.1618350689558,2.866620534152646,2.9872032136487774,3.116617990471625,0.4184005849388538,7000,7106,Dyer+Lake+Lauderdale,Lake,47,95,Tennessee,TN
47097,47CS018,255,244,265,296,31,41,52,656.8296731911479,32,508.4409136047666,-0.25892407139248036,1.530691103145979,3.133470783097969,0.7558004575148692,312,299,325,358,33,46,59,182.33148097312676,51,203.13060102760187,-0.6934373665578152,-0.2042735856591163,0.29894613266592396,1.090256920722877,25175,25107,Dyer+Lake+Lauderdale,Lauderdale,47,97,Tennessee,TN
47047,47CS019,378,360,396,461,65,83,101,792.7268836625865,41,389.993341577095,2.3365093774294974,3.9961335443563306,5.8290949240542975,0.4861311681748818,468,446,491,565,74,97,119,225.88908460950853,83,194.2383749502703,-0.19698896332866517,0.3263144837293375,0.8087575142192379,0.8510667554454747,42052,42731,Fayette+Hardeman,Fayette,47,47,Tennessee,TN
47069,47CS019,259,248,270,333,63,74,85,1162.2455818952112,50,788.6746322804527,2.0051980533832157,3.7211508843688077,5.468453909871937,0.6694922428041923,317,304,330,383,53,66,79,259.61052210978625,42,165.19823788546256,0.42820393535706053,0.9484426057126373,1.4542743596612777,0.6268340573017371,25359,25424,Fayette+Hardeman,Hardeman,47,69,Tennessee,TN
47055,47CS020,343,330,356,413,57,70,83,932.9570364299458,43,569.4987086947884,2.0445982739836315,3.628871950193447,5.25218911827745,0.6018790858025974,423,407,439,526,87,103,119,338.03041653268065,79,258.96544941978624,0.2861351350107224,0.7744648910612594,1.3075493254743635,0.7587431301026175,30202,30506,Giles+Marshall,Giles,47,55,Tennessee,TN
47117,47CS020,325,310,340,369,29,44,59,513.2219457895867,31,359.3473787927087,-0.13971924655943088,1.5163041801214143,3.159897136027586,0.6847140472290886,404,386,422,466,44,62,80,178.50531636592146,67,191.94957742443776,-0.6072127762638511,-0.13923241072420167,0.36752020851516987,1.0583300890980474,34507,34905,Giles+Marshall,Marshall,47,117,Tennessee,TN
47057,47CS021,258,248,269,332,63,74,84,1251.2727930417484,27,458.94951555328913,6.194502921220892,7.8368544072047674,9.605958940355388,0.36187024959788744,319,306,331,394,63,75,88,317.8571254223581,59,248.65138233310856,0.17777721584343392,0.6770311408791096,1.2132687234925639,0.7720376977893895,23532,23728,Grainger+Hamblen,Grainger,47,57,Tennessee,TN
47063,47CS021,664,636,692,859,167,195,223,1209.6549283682064,79,489.9072896964435,5.467320449711046,7.2001919531887175,8.865599070904699,0.4029319049873518,813,780,846,1111,265,298,331,462.0077586650865,169,262.1658936133906,1.4951206068084488,2.011238804600648,2.4922669135827973,0.5655501741379759,64502,64463,Grainger+Hamblen,Hamblen,47,63,Tennessee,TN
47059,47CS022,837,807,867,931,64,94,124,535.1812724122077,88,502.1254743088642,-1.35673012449075,0.38043813482888816,2.1436444991780284,0.9283366915138302,1030,993,1066,1286,220,256,293,363.155997695362,167,236.6679421226422,0.7562757440399123,1.2668415302190956,1.7450852637961591,0.6491644502323453,70102,70563,Greene,Greene,47,59,Tennessee,TN
47061,47CS023,181,175,186,197,11,16,22,487.34586437338777,17,502.8470014050137,-1.8562501304269017,-0.23474560349682116,1.4927754733205871,0.9727656901320055,220,213,227,246,19,26,33,192.41904362410742,42,308.6192960540819,-1.6966623800697946,-1.1464489744097481,-0.6407818661580941,1.5448953401708556,13523,13609,Grundy+Marion+Sequatchie,Grundy,47,61,Tennessee,TN
47115,47CS023,314,301,326,359,33,45,58,630.4218973931877,36,499.21996879875195,-0.4270510405152226,1.23871899445192,3.0340422816520394,0.7748384293192793,381,366,396,476,80,95,110,329.8385453165163,72,249.38519621765784,0.27438939657222483,0.8072444376918653,1.308110737161775,0.7482254087144297,28845,28871,Grundy+Marion+Sequatchie,Marion,47,115,Tennessee,TN
47153,47CS023,155,148,162,165,3,10,17,255.9157797056524,12,303.73979624122,-2.2555083519059527,-0.5075722127523972,1.3416342231446272,1.0800503951461502,194,185,202,229,27,35,44,217.42846754925893,48,294.15369530579727,-1.2870695399862415,-0.7805985985462435,-0.2329984522547716,1.3157902911951036,15803,16318,Grundy+Marion+Sequatchie,Sequatchie,47,153,Tennessee,TN
47065,47CS024,3189,3031,3347,3584,237,395,553,429.6457172946763,257,279.85811084885756,-0.19805635641079347,1.475163230908399,3.2224199085619145,0.649722758007277,3932,3741,4122,4514,392,582,773,157.87878082554053,527,142.88735487579376,-0.3869960771448883,0.15327567713805454,0.6879218448893726,0.9034930906192326,367329,368822,Hamilton,Hamilton,47,65,Tennessee,TN
47071,47CS025,348,336,359,404,45,56,68,844.7215996624343,36,540.560831863058,1.3815218131568887,3.0450103867020175,4.787956464771314,0.6287512573505656,427,413,441,530,89,103,117,382.40855272325985,71,264.1467316492429,0.6785101128140071,1.192242295167215,1.6969025339519843,0.6840894624993903,26639,26879,Hardin+McNairy,Hardin,47,71,Tennessee,TN
47109,47CS025,329,318,340,404,64,75,86,1165.9661473126416,35,542.3203563819485,4.490017531293592,6.274750792312815,7.91420046445236,0.4590251812483114,402,389,415,464,49,62,75,239.73705072423195,50,193.37123409521598,-0.015112918431614716,0.46149057299142693,0.9983356260747495,0.7937917962009046,25815,25857,Hardin+McNairy,McNairy,47,109,Tennessee,TN
47073,47CS026,639,614,663,767,104,128,153,904.6268037932354,55,387.5900706470992,3.4923580214081995,5.119795498498725,6.922860960918601,0.42514113034635254,787,758,817,1039,222,252,281,440.0050314618305,155,270.9884961012623,1.167059806958563,1.6885147498296589,2.2130464463652584,0.6134384709779415,56761,57198,Hawkins,Hawkins,47,73,Tennessee,TN
47081,47CS027,252,241,262,326,64,74,85,1187.842257996303,34,543.7607452720803,4.682402526967942,6.469530991576177,8.13129178202545,0.4516903441141971,311,298,324,378,54,67,80,264.4169124773827,60,237.58612497030174,-0.27313906666567067,0.2757156872343637,0.8238997528722588,0.8852711192499044,25011,25254,Hickman+Houston+Humphreys+Stewart,Hickman,47,81,Tennessee,TN
47083,47CS027,102,101,103,128,25,26,27,1267.325737177965,17,821.5537030324996,4.074169762947851,4.4619790343709695,4.849903642663611,0.6244458544307792,125,124,126,141,15,16,17,188.16104408657432,23,276.7083734359961,-1.010700483013928,-0.885023236934317,-0.7471713093479081,1.382216025307861,8277,8312,Hickman+Houston+Humphreys+Stewart,Houston,47,83,Tennessee,TN
47085,47CS027,223,215,231,241,10,18,26,381.8629155158383,19,401.1824324324324,-1.8988708617720336,-0.2170971183714581,1.53243288582217,0.9955447966719787,275,265,285,350,65,75,85,390.7721095151844,43,224.2386316228619,1.1654458591500572,1.6603132631713051,2.157321536175639,0.5662778158717404,18944,19176,Hickman+Houston+Humphreys+Stewart,Humphreys,47,85,Tennessee,TN
47161,47CS027,151,146,157,158,1,7,12,190.98277786557802,20,583.8137634094724,-5.7721367493475,-3.9234078447771927,-2.25081240489785,2.6516081793156565,187,180,194,208,14,21,28,153.52375312920879,25,180.76644974692695,-0.8159915526410042,-0.28761763298050685,0.25053037007878437,1.1244882705770127,13703,13830,Hickman+Houston+Humphreys+Stewart,Stewart,47,161,Tennessee,TN
47087,47CS028,146,141,151,170,19,24,29,810.9997280971695,23,788.8193432221556,-1.4616321665612015,0.19706139293099156,1.9759702096227068,0.9331868797745061,179,173,185,182,-3,3,9,23.551303871856835,21,179.01287187793028,-2.073986606698353,-1.531030599045109,-1.028914093794459,5.580945228424088,11663,11731,Jackson+Putnam+Smith,Jackson,47,87,Tennessee,TN
47141,47CS028,734,700,769,924,155,190,224,947.9920901500724,118,589.2339958054529,1.79268294902728,3.564322582536323,5.422724016831284,0.6183031482089717,907,866,949,1043,94,136,177,167.305959512273,91,112.32903767343109,0.0461383147206267,0.5594317316199686,1.043956787439828,0.666481595127339,80104,81012,Jackson+Putnam+Smith,Putnam,47,141,Tennessee,TN
47159,47CS028,184,175,193,217,24,33,42,660.1066616279891,21,420.231127119916,0.716325755438975,2.4249008207169522,4.121589190358558,0.6178800332486333,227,216,237,286,49,59,70,294.44286461146714,39,193.6637203297249,0.466661038355178,1.0071796710682188,1.5450988175301394,0.6468208316774611,19989,20138,Jackson+Putnam+Smith,Smith,47,159,Tennessee,TN
47093,47CS029,3993,3787,4200,4556,356,563,769,469.5680475738383,287,239.4899781371518,0.706780684181296,2.3711875110805933,4.019442224188356,0.5091171376755919,4946,4696,5197,5783,586,837,1087,172.25792733028834,606,124.76272435673081,-0.057661538709541604,0.45488557219885406,0.9804426719096366,0.7234139553761334,479352,485722,Knox+Union,Knox,47,93,Tennessee,TN
47173,47CS029,194,185,202,247,45,53,62,1073.0669582236853,17,342.3967774420947,5.620855769820355,7.2743690588865055,8.989203849758525,0.31320370380288265,238,228,249,349,100,111,121,553.3955226741846,48,239.90403838464613,2.6267179817812987,3.1507996126271363,3.6500996621381328,0.4296325589382928,19860,20008,Knox+Union,Union,47,173,Tennessee,TN
47099,47CS030,484,465,503,595,92,111,130,1001.3229105815924,62,560.4266473831691,2.7137482660760894,4.365854117790557,6.075840572544041,0.5546790354530601,597,574,620,694,74,97,120,216.97664025652807,102,228.00938862188443,-0.6301469263117473,-0.10665974049441394,0.3643449241231131,1.0401317498227125,44252,44735,Lawrence+Wayne,Lawrence,47,99,Tennessee,TN
47181,47CS030,176,169,183,196,13,20,27,494.7484203525525,19,466.6011787819254,-1.550573108744593,0.27400893250535113,2.075514931655089,0.8985084707801043,216,208,225,264,39,48,56,292.71111576119404,32,195.37212284022223,0.5279316380476116,0.9708753686455266,1.4681442094947472,0.6538197401110075,16288,16379,Lawrence+Wayne,Wayne,47,181,Tennessee,TN
47107,47CS031,600,577,623,708,85,108,131,809.5336603707519,61,456.3733283456467,1.801764787844084,3.488085668544713,5.184484009284038,0.5585860994257634,743,715,771,948,177,205,233,379.58834385927366,123,227.98887859128823,0.9738228381600835,1.5174238140935372,2.0251992772818745,0.5977027469506189,53465,53950,McMinn+Meigs+Monroe,McMinn,47,107,Tennessee,TN
47121,47CS031,162,157,168,156,-12,-6,-1,-191.44029431949556,17,533.3333333333334,-8.849516716699032,-7.2912039258107635,-5.502142269096097,-3.3319225702475577,202,195,209,211,2,9,16,68.96624778661155,29,222.9054573405073,-2.069480796946405,-1.5347470679635689,-1.04463623651619,2.9079944148350343,12750,13010,McMinn+Meigs+Monroe,Meigs,47,121,Tennessee,TN
47123,47CS031,516,496,536,606,70,90,110,776.5458797465598,53,456.34578956431886,1.482437856816651,3.2325939694217745,4.810118674435158,0.5812165815503089,636,612,660,824,164,188,212,402.52980132098196,127,272.2284146446026,0.8164166210678795,1.297674290309815,1.8288328935369222,0.6727115256191123,46456,46652,McMinn+Meigs+Monroe,Monroe,47,123,Tennessee,TN
47119,47CS032,894,850,938,909,-29,15,59,58.752282208511,105,414.5977907860577,-5.227583645103566,-3.568787678847395,-1.8978729923681403,6.612317151371091,1124,1070,1178,1199,21,75,129,72.19540024502436,143,137.08610541250454,-1.1741886275075346,-0.6724352793582742,-0.12079512335727674,1.8739374788026841,101303,104314,Maury,Maury,47,119,Tennessee,TN
47125,47CS033,1274,1179,1369,1493,124,219,314,398.2811728012432,112,203.4458643270392,0.20540435312221741,1.946528361690604,3.670657400351887,0.5084905208240514,1621,1504,1739,1949,210,328,445,144.34384574514058,304,133.9696893577828,-0.4324272555332533,0.11062296991273841,0.5914826018222321,0.9253038584771467,220206,226917,Montgomery,Montgomery,47,125,Tennessee,TN
47129,47CS034,214,205,223,227,4,13,22,244.5135137539974,11,208.55057351407717,-1.3520066036071243,0.41300359432239847,2.179484162020775,0.7915454151730329,265,254,276,335,59,70,81,330.8638564253585,42,197.92648444863337,0.8123025551886918,1.3178397377683078,1.8297576376018683,0.5898105149919463,21098,21220,Morgan+Roane,Morgan,47,129,Tennessee,TN
47145,47CS034,659,636,682,750,68,91,114,677.1393633931629,54,403.30109414093135,0.9294873363497007,2.714844536362656,4.461447568202165,0.589097924316236,812,784,840,923,83,111,139,205.6921132419112,114,211.41649048625794,-0.5855842228206702,-0.06608687030276944,0.428011508457334,1.0186456719032888,53558,53922,Morgan+Roane,Roane,47,145,Tennessee,TN
47027,47CS035,96,95,97,137,40,41,42,2173.6628626318084,19,1005.2910052910053,11.261243944892904,11.68065724072646,12.115350444119658,0.4514970061271749,117,116,118,139,21,22,23,291.43392313834295,16,211.78027796161484,0.664381226902861,0.7946116551287893,0.9164332497568798,0.6951132226177131,7560,7555,North Central Tennessee,Clay,47,27,Tennessee,TN
47111,47CS035,241,230,252,301,49,60,71,950.5534025047355,41,650.7936507936507,1.1590081998560169,3.0405090941547472,4.834976701106359,0.6734021736347776,298,285,312,342,30,44,57,170.5654614424361,59,230.18102372034957,-1.1106492613176118,-0.5892877235329897,-0.10096311239834785,1.3193397133734355,25200,25632,North Central Tennessee,Macon,47,111,Tennessee,TN
47133,47CS035,268,259,278,343,65,75,84,1325.4641920708966,42,744.4168734491315,4.142643347434365,5.82221811557078,7.642138958469771,0.5542162749440899,329,317,341,404,63,75,87,329.3878243769684,55,241.20691167441453,0.3698538815118158,0.8992341803957518,1.4218668827366696,0.7226666605485358,22568,22802,North Central Tennessee,Overton,47,133,Tennessee,TN
47137,47CS035,63,63,64,79,15,16,16,1254.599891818857,18,1435.9792580773833,-2.237475782500113,-1.8084253937961157,-1.4027448538822216,1.0761424826463781,78,77,79,80,1,2,3,38.81647537014649,1,19.73554371422933,0.06702855063717666,0.1890019516264214,0.32301376637577445,0.3370600027607863,5014,5067,North Central Tennessee,Pickett,47,137,Tennessee,TN
47169,47CS035,98,96,99,107,8,9,11,323.87288422536886,13,446.5819306080384,-1.6345797792104644,-1.2349699348250893,-0.8128746201975764,1.2466508652821189,123,121,124,152,28,29,31,244.20869825225034,20,166.9449081803005,0.6475702023460711,0.7720755617442938,0.89546840584204,0.6610214978912211,11644,11980,North Central Tennessee,Trousdale,47,169,Tennessee,TN
47131,47CS036,336,323,349,455,106,119,132,1556.4160436124757,72,940.5002939063418,4.470311718231809,6.200485465835578,7.858380518741289,0.5992438031650024,410,395,426,497,71,87,102,284.1754699072711,74,242.60704216116977,-0.13588807469441183,0.41278086099403294,0.9559817956060551,0.8439857851641467,30622,30502,Obion+Weakley,Obion,47,131,Tennessee,TN
47183,47CS036,338,323,352,380,28,42,57,514.8094766665167,35,425.0022767979114,-0.8084487255743535,0.8216786324807657,2.476781268441628,0.8065287827074232,416,399,433,496,63,80,97,241.9346019823873,59,178.7283026869831,0.1630161871872623,0.6369667065352488,1.085139357102886,0.7296107963414112,32941,33011,Obion+Weakley,Weakley,47,183,Tennessee,TN
47147,47CS037,608,576,639,769,130,161,193,886.5995477109105,73,400.99424600722335,3.204959336776757,4.865614984890019,6.560889071021428,0.4494984457989343,755,717,794,959,165,204,242,275.38105526185035,116,156.93277595140495,0.6299366706404277,1.1848095568860348,1.7126124957476048,0.5670890423251239,72819,73917,Robertson,Robertson,47,147,Tennessee,TN
47149,47CS038,1913,1766,2061,2287,226,374,521,436.29387082715215,235,274.47900089643673,-0.04635655186683642,1.6314549693292093,3.411425879718258,0.6274352620606596,2426,2245,2607,2886,279,460,641,131.1798436810614,432,123.12533132684646,-0.44222410199247,0.08417629427610958,0.5987161581032591,0.9365646078534656,342467,350862,Rutherford,Rutherford,47,149,Tennessee,TN
47155,47CS039,942,899,984,1105,121,163,206,662.6724937320968,86,348.92330787410356,1.4793400231874498,3.136060237929782,4.885643149280507,0.5233354478684392,1164,1112,1215,1479,264,315,367,317.43887202939703,219,220.39288302069076,0.449722109285586,0.9577549740846462,1.4580984552955765,0.6920903838949302,98589,99368,Sevier,Sevier,47,155,Tennessee,TN
47157,47CS040,7068,6669,7468,9054,1586,1986,2385,854.6457642203429,955,411.00194096204575,2.7292925344626324,4.4361142534228275,6.113855299297991,0.48066122444872106,8666,8188,9143,12568,3425,3902,4380,421.8398794129341,1620,175.1228292065963,2.010341315581726,2.4742973316662504,2.9872028540542828,0.41503416899355927,929436,925065,Shelby,Shelby,47,157,Tennessee,TN
47163,47CS041,1807,1739,1875,2145,270,338,406,853.4502461178789,184,465.0310547232876,2.1644204760391923,3.902248286365836,5.461839418510229,0.5432748015887142,2218,2136,2300,2690,390,472,554,296.6520102858802,319,200.51039008384979,0.45743543779553714,0.9687718066177906,1.44274560825542,0.674481989924341,158269,159094,Sullivan,Sullivan,47,163,Tennessee,TN
47165,47CS042,1486,1402,1571,1729,158,243,327,493.12830195931224,188,382.1681946618421,-0.5502332863058956,1.1571138679008146,2.9497609878768563,0.7718057532829601,1855,1752,1959,2298,339,443,546,221.2839067459041,337,168.43431061885863,0.03037957269708231,0.5245258660187294,1.0424679573367794,0.7594530240079067,196772,200078,Sumner,Sumner,47,165,Tennessee,TN
47167,47CS043,519,492,545,598,53,79,106,519.9884225222614,64,419.15677445763407,-0.6939604259839692,1.0185774072783869,2.8119269772800908,0.7960621565078211,635,603,666,804,138,169,201,277.31458340536045,126,206.56414964425065,0.15592857294410795,0.7121871805130894,1.283431976674929,0.7404954343864333,61075,60998,Tipton,Tipton,47,167,Tennessee,TN
47179,47CS044,1297,1240,1354,1539,185,242,299,730.290385578196,151,455.151729802642,1.083302103617276,2.7175950533217965,4.436006497085494,0.6206857393268559,1602,1532,1671,1902,231,300,370,224.10365142848934,199,148.4332460635354,0.2627982051611749,0.7641409263766968,1.2549137615093402,0.660144741020375,132703,134067,Washington,Washington,47,179,Tennessee,TN
47187,47CS045,1254,1147,1362,1390,28,136,243,218.13377324771486,138,222.1363724164574,-1.7085335213842578,-0.012202485155337311,1.5723537476895801,1.0108895861663818,1598,1466,1729,1670,-59,72,204,28.316507216699097,173,67.89239252006357,-0.9178701138553823,-0.39711007645744045,0.14456660299056978,2.3648512180661236,248496,254815,Williamson,Williamson,47,187,Tennessee,TN
47189,47CS046,1045,981,1109,1283,174,238,302,642.5244851411392,144,388.344277989779,0.7828194737676046,2.5908460462409364,4.25259936849612,0.6018776282005752,1312,1234,1390,1558,168,246,324,162.6140033289099,244,161.13268351956046,-0.4899950251949981,0.017954838559976535,0.5779136784309827,0.9868828188590599,148322,151428,Wilson,Wilson,47,189,Tennessee,TN
48001,48CS001,566,541,591,612,21,46,71,316.33884204895116,76,524.8075130338708,-3.8545590317818577,-2.1257811355288703,-0.33237464992693133,1.623563567228909,697,667,727,884,157,187,217,320.8659358044977,138,236.6011727188561,0.30915217501208253,0.8368163198044953,1.3799936626443006,0.7334641086053235,57926,58326,Anderson+Houston,Anderson,48,1,Texas,TX
48225,48CS001,237,227,246,308,62,71,81,1280.0409938975579,27,486.39884705458473,6.216170749952496,7.949469717953791,9.616608369613104,0.37471336732275556,290,279,301,394,93,104,115,468.191526149244,70,315.0882247029168,0.9795725514096011,1.537468039511228,2.0670673864643483,0.6665814112259326,22204,22216,Anderson+Houston,Houston,48,225,Texas,TX
48005,48CS002,769,732,807,990,183,221,258,1020.7437804529842,163,754.4375274814283,0.7946369920128756,2.6136131427287244,4.3131819533899645,0.7357694155097207,945,901,990,1257,267,312,356,360.33933002030517,262,302.9497126602916,0.05922163233975704,0.5594908736476519,1.0770092083172749,0.8380453049503274,86422,86483,Angelina,Angelina,48,5,Texas,TX
48007,48CS003,285,274,295,380,85,95,106,1597.086994065527,23,384.98556304138594,10.337394349505994,12.157255245204578,13.773465047565354,0.23855464162836718,354,341,366,429,63,75,88,307.877169284426,46,188.34704991196824,0.6904635960591861,1.1860543987245618,1.6808489964890572,0.6037312608831064,23897,24423,Aransas+Calhoun+Refugio,Aransas,48,7,Texas,TX
48057,48CS003,163,154,172,216,44,53,62,1048.3668651505893,11,217.9620547877347,6.651897079877576,8.34422696943831,9.901666253762626,0.20404962537965776,197,187,207,268,61,71,81,359.3653328302688,29,146.65722666127238,1.6281211928599977,2.130921326956507,2.641197795868561,0.4024373777212003,20187,19774,Aransas+Calhoun+Refugio,Calhoun,48,57,Texas,TX
48391,48CS003,72,71,73,100,27,28,29,1653.2189345505183,17,1006.0659860926172,6.0614067627384784,6.473494814427632,6.850058700416453,0.5875183398650734,88,87,89,112,23,24,25,353.8145441155961,13,192.4500370096225,1.4928814699891237,1.6065736978097904,1.7306672062781592,0.5220847375049056,6759,6755,Aransas+Calhoun+Refugio,Refugio,48,391,Texas,TX
48009,48CS004,76,75,77,76,-1,0,1,1.7272041871622503,4,186.26309662398137,-2.2488136824132425,-1.8465920530436222,-1.4557658291162239,3.8569395182140824,94,93,95,112,17,18,19,207.41042956211757,22,253.95359575204895,-0.5980208741972612,-0.46688130653472276,-0.33712478363144993,1.1598502741351515,8590,8663,Archer+Wichita,Archer,48,9,Texas,TX
48485,48CS004,1163,1107,1219,1403,184,240,296,737.5235758226605,240,738.4274571942833,-1.7295731895339321,-0.044884246401127204,1.6613399217196103,0.9970660293641607,1430,1362,1497,1775,278,345,413,265.72178063682446,306,235.39729062334126,-0.20928582608733337,0.3060184133372863,0.8324174736947528,0.8833215529187604,130006,129993,Archer+Wichita,Wichita,48,485,Texas,TX
48013,48CS005,350,328,371,485,114,135,157,1095.1673416083906,89,719.5262445176546,2.08859458152793,3.7683442442665234,5.4770153161910375,0.6521867222747609,434,409,460,627,167,193,218,386.4972818290539,136,273.01013750878246,0.6314760201920117,1.1436102623878701,1.6262305556832601,0.7027202784572217,49477,49815,Atascosa+Live Oak+McMullen,Atascosa,48,13,Texas,TX
48297,48CS005,101,100,102,131,29,30,31,1049.5472606078567,17,592.4893264790451,4.131766038961142,4.576406843019236,4.988031471929646,0.5463754696358886,122,121,124,155,31,33,34,286.3745299178454,30,263.8058389025677,0.09808686855635071,0.22374773658455593,0.3476123663770744,0.8937479237969832,11477,11372,Atascosa+Live Oak+McMullen,Live Oak,48,297,Texas,TX
48311,48CS005,8,8,8,17,9,9,9,6075.349141199918,6,3877.221324717286,21.5922596226323,21.97787512981966,22.381433513552363,0.5768341781233343,9,9,9,14,5,5,5,807.8647943061889,3,494.23393739703454,3.0065697396781115,3.134021500794358,3.2662004949416974,0.508152519415786,619,607,Atascosa+Live Oak+McMullen,McMullen,48,311,Texas,TX
48015,48CS006,241,228,254,271,17,30,43,393.70680777129303,19,252.18170355377111,-0.23053985629915572,1.4326999744823463,3.2496532530509232,0.6196422315555253,297,282,313,365,52,68,83,223.50364254956702,42,138.43111404087014,0.3280579137429483,0.845828099939174,1.3507266328227767,0.6103674827700377,30137,30340,Austin+Waller+Washington,Austin,48,15,Texas,TX
48473,48CS006,305,280,329,395,66,90,115,631.1371118383464,27,188.46522991013,2.6947113723839653,4.415274106523972,6.236337759081993,0.2953457432893485,389,358,420,501,81,112,143,188.7095560093396,78,131.2556793322788,0.09689095988795049,0.5733752343546531,1.1228601274342487,0.6893958671965432,57305,59426,Austin+Waller+Washington,Waller,48,473,Texas,TX
48477,48CS006,320,305,336,416,80,96,111,1068.1715323388976,65,726.0136267173015,1.7068420864192535,3.450517197704484,5.099831473873995,0.6726452947186577,392,373,410,522,112,130,149,362.83673603429094,76,211.79945935401165,0.9769370676262412,1.4971921519169382,2.0319967312797464,0.5792828366064816,35812,35883,Austin+Waller+Washington,Washington,48,477,Texas,TX
48019,48CS007,204,194,213,264,51,60,70,1132.5632098385847,15,280.80685168718117,6.670265032415344,8.518832833976685,10.257782281103733,0.24390761358765956,251,240,262,329,67,78,89,362.70920310542897,49,228.10856105395465,0.8171748195942362,1.3456696486739412,1.8779746739092267,0.6209325439951945,21367,21481,Bandera+Kendall+Kerr,Bandera,48,19,Texas,TX
48259,48CS007,329,310,349,379,30,50,69,440.7859672514776,38,336.40226628895186,-0.5947326589735912,1.0533560026684763,2.7234943661653443,0.7481613512368622,416,392,440,457,17,41,65,87.60753710422622,58,124.84394506866417,-0.8770408400191015,-0.3667978136077929,0.159715813153747,1.3908636225426556,45184,46458,Bandera+Kendall+Kerr,Kendall,48,259,Texas,TX
48265,48CS007,635,612,657,699,42,64,87,487.3605229353264,51,387.1775892501281,-0.7421613736969286,0.9989108612658082,2.662250393919258,0.7822524228993093,778,750,805,863,58,85,113,160.79106707727263,92,173.29063853833114,-0.6521720167647159,-0.11022935409187769,0.3881484948613033,1.0652589499822072,52689,53090,Bandera+Kendall+Kerr,Kerr,48,265,Texas,TX
48021,48CS008,680,638,722,697,-25,17,59,68.64463530225156,53,218.42384528997826,-3.211029539699313,-1.4903150047756515,-0.016644542212106442,3.001736054981377,870,817,922,945,23,75,128,74.16020573378704,144,141.9222581408184,-1.1670019371206644,-0.6761990352087358,-0.20114411259767934,1.8886258664385447,97059,101464,Bastrop+Caldwell,Bastrop,48,21,Texas,TX
48055,48CS008,332,312,352,414,62,82,102,719.0759566393341,50,437.5888852423148,1.0932533828748494,2.874688286735178,4.486247252662388,0.6012259008467308,415,391,439,489,50,74,98,157.79229203061038,102,218.55113453750724,-1.0914596044130385,-0.6214767056197253,-0.05903502299035133,1.366500156765798,45705,46671,Bastrop+Caldwell,Caldwell,48,55,Texas,TX
48025,48CS009,224,211,238,276,38,52,65,663.1841826029885,49,627.7825822363153,-1.3064962842393717,0.35120847814015993,2.129802552168431,0.9286778551022817,276,260,292,398,106,122,138,394.8531044369357,90,290.942005560225,0.5281696542456787,1.044488229762956,1.5189172514526499,0.730852520720183,31221,30934,Bee+Goliad+Karnes,Bee,48,25,Texas,TX
48175,48CS009,67,67,68,64,-4,-3,-3,-189.3801981737654,4,225.06681671121115,-4.559194648444618,-4.153500763966443,-3.792221609518872,-1.6907888896525962,83,82,84,98,14,15,16,210.35844143649385,19,266.1064425770308,-0.6835831769882323,-0.5546079704817433,-0.42657997338109055,1.1860476314095203,7109,7140,Bee+Goliad+Karnes,Goliad,48,175,Texas,TX
48255,48CS009,133,127,140,156,16,23,29,611.1606974284769,24,647.9044340959708,-2.109091328182668,-0.34198251142529834,1.3308674851300677,1.015274803732627,164,156,171,175,4,11,19,76.58340115404424,30,203.40362058444643,-1.724005611565296,-1.2612633597793959,-0.7463496710710356,2.439959542188853,14817,14749,Bee+Goliad+Karnes,Karnes,48,255,Texas,TX
48027,48CS010,2089,1929,2249,2385,136,296,456,318.2514512062533,202,217.4568315893726,-0.823770114933751,0.9878737078674472,2.7296084728248204,0.6809827259119493,2632,2437,2828,3353,525,721,916,190.4413667453453,551,145.5734829050232,-0.06638384995183236,0.4396871239146135,0.9649145631357712,0.7633415551673806,371568,378503,Bell,Bell,48,27,Texas,TX
48029,48CS011,11851,10985,12718,14275,1557,2424,3290,481.3983855896184,1952,387.7175759507845,-0.7480395669426971,0.9779318672611613,2.824190111152616,0.8050664077547547,14736,13690,15782,18960,3178,4224,5270,208.46118632598547,3396,167.60702962439444,-0.07387685365194716,0.4093863729124111,0.9768633302304065,0.8038300086038769,2013837,2026168,Bexar+Wilson,Bexar,48,29,Texas,TX
48493,48CS011,356,334,377,382,5,26,48,210.28976087992353,37,294.4394708047349,-2.5673384437209865,-0.8708703423372975,0.9826173773313902,1.3491075816197968,445,418,471,641,170,196,223,384.3882994720323,115,225.16789693184268,1.1140738822850285,1.5931460729846154,2.107998619005328,0.5828136775162159,50265,51073,Bexar+Wilson,Wilson,48,493,Texas,TX
48035,48CS012,209,201,217,274,57,65,73,1424.2750954411256,20,436.7289005349929,8.124555040899047,9.883483644396815,11.519999400572003,0.3020022234202581,255,246,265,305,40,50,59,269.03208895966367,36,194.97400346620452,0.23272613044077176,0.7428244818717322,1.2362317118167079,0.7104223010070367,18318,18464,Bosque+Hamilton+Hill,Bosque,48,35,Texas,TX
48193,48CS012,115,115,116,105,-11,-10,-10,-504.7894579690067,16,774.4433688286545,-13.23007917511436,-12.791020528065962,-12.416928763886435,-1.6969015275123231,140,139,141,157,16,17,18,201.518617048507,6,72.91286912139992,1.1630729059536233,1.2855586828004777,1.4115833847344488,0.3412393369702882,8264,8229,Bosque+Hamilton+Hill,Hamilton,48,193,Texas,TX
48217,48CS012,381,365,396,451,55,70,86,776.5706648678656,40,443.20101936234454,1.5787967649857504,3.2913729944824155,5.018541527274232,0.562687273421066,466,447,485,673,188,207,226,568.101292861037,139,381.8996071104761,1.3595692931261534,1.8539410843939943,2.3778370952888346,0.6690031157284749,36101,36397,Bosque+Hamilton+Hill,Hill,48,217,Texas,TX
48037,48CS013,891,851,931,1063,132,172,212,739.9899805096037,126,542.6707151624781,0.3296992922068097,2.0243618764208446,3.6820362945799334,0.7291051753175043,1089,1042,1137,1381,244,292,339,314.83363966915556,228,246.18839891158814,0.1604766513324136,0.6850794757939302,1.22162249237371,0.7792907439480365,92874,92612,Bowie,Bowie,48,37,Texas,TX
48039,48CS014,2077,1916,2238,2443,205,366,527,391.0636273746488,239,255.4640172518378,-0.4099751588556723,1.3607009114673763,3.0845063756424054,0.6514736927467779,2603,2408,2799,3459,660,856,1051,225.94318808536585,605,159.72880425169035,0.09797494493413023,0.6516671340566548,1.1553339848987216,0.7061172340626666,374221,378767,Brazoria,Brazoria,48,39,Texas,TX
48041,48CS015,931,830,1032,1141,109,210,311,358.9918954275715,146,249.56411746606955,-0.6160692713512925,1.00383443038697,2.7558193323648106,0.6918859451855037,1172,1050,1294,1414,120,242,364,102.3132578014149,216,91.27017662469365,-0.4011789554059738,0.11327354296983524,0.6142006167678977,0.8883969585855285,234008,236660,Brazos+Burleson+Grimes+Robertson,Brazos,48,41,Texas,TX
48051,48CS015,193,186,201,211,10,18,25,400.4595101112128,20,449.43820224719104,-2.1118981676595583,-0.5236275043545343,1.1721535671724201,1.0626739484373293,238,229,247,297,50,59,68,327.2398078842647,41,227.87905735882612,0.46597105694998464,0.9823191980603907,1.4619450172515787,0.6847372016922137,17800,17992,Brazos+Burleson+Grimes+Robertson,Burleson,48,51,Texas,TX
48185,48CS015,252,240,265,314,49,62,74,837.7688708059246,47,638.6737328441365,0.16687111572570937,1.9476623178731576,3.7967010948194777,0.7501826231496528,315,300,331,396,65,81,96,267.60724422075197,64,212.20159151193633,0.04023066189297412,0.5668691259866662,1.0641728041387748,0.7832545574495128,29436,30160,Brazos+Burleson+Grimes+Robertson,Grimes,48,185,Texas,TX
48395,48CS015,162,154,169,202,33,40,48,960.7508236824405,23,547.0980019029496,2.4588573210288063,4.132615948242044,5.818168194353818,0.5556902550396843,199,190,207,267,60,68,77,404.5255492238781,48,283.58738036157393,0.6993207262738387,1.2086585714005875,1.7293624979935491,0.6909457870550011,16816,16926,Brazos+Burleson+Grimes+Robertson,Robertson,48,395,Texas,TX
48049,48CS016,432,416,448,584,136,152,168,1600.5189390075866,73,768.6637885648099,6.676043678208033,8.29271664612308,10.04013856418214,0.47712018006941675,531,512,551,647,96,116,135,302.8982443740924,107,280.36893407399646,-0.2447305529114919,0.20631624735769688,0.726296948728043,0.9176823023978806,37988,38164,Brown+Coleman+Mills,Brown,48,49,Texas,TX
48083,48CS016,127,124,130,124,-6,-3,0,-157.40921247845162,16,826.4462809917355,-11.604838784977582,-9.807079686609592,-8.137774613771953,-7.814627831646428,155,151,159,214,55,59,63,766.0630388157782,42,543.6189490033653,1.7130803356431377,2.2265499556506363,2.723900322555956,0.6978363539775743,7744,7726,Brown+Coleman+Mills,Coleman,48,83,Texas,TX
48333,48CS016,57,57,58,74,16,17,17,1482.3867099545434,14,1242.7873945849976,1.9642394762979762,2.3816380947914335,2.80109783988587,0.7910012851781174,70,70,71,92,21,22,22,488.86457996311646,14,312.9190880643719,1.628259723390156,1.7632636639025596,1.8828430438611827,0.6121074510812007,4506,4474,Brown+Coleman+Mills,Mills,48,333,Texas,TX
48053,48CS017,473,452,495,498,3,25,46,198.3255425175294,30,242.82158683907002,-2.3153844284216825,-0.4345995431456458,1.3145326273835256,1.1763494950865485,596,570,622,692,70,96,122,189.7794363926049,114,224.71467150263152,-0.8512916222915926,-0.36001000633634817,0.11269188024017607,1.1719110695586934,49419,50731,Burnet+Lampasas+Llano,Burnet,48,53,Texas,TX
48281,48CS017,197,187,206,252,46,55,65,1021.6908894446415,13,239.37761819269898,6.173210876467951,7.757516328436768,9.71044896701676,0.23014764971883134,246,235,258,331,73,85,96,381.7672071572128,54,243.5394398592883,0.8686148007404613,1.362564145738787,1.8646718287040625,0.6304784281514875,21723,22173,Burnet+Lampasas+Llano,Lampasas,48,281,Texas,TX
48299,48CS017,283,274,292,302,10,19,28,354.9031446708908,17,317.653104124819,-1.2798496053131396,0.3153069903857176,2.0977282535325217,0.8502751046001884,353,342,364,412,48,59,70,269.0121398884532,67,306.32772494513534,-0.877654749635703,-0.36611892978661553,0.10065395190465394,1.119683556290529,21407,21872,Burnet+Lampasas+Llano,Llano,48,299,Texas,TX
48059,48CS018,146,140,152,196,44,50,56,1439.4813956612968,26,752.7504342790967,5.25934379170834,6.826681230089012,8.571342473830692,0.5126214558816838,181,173,188,231,43,50,58,358.7815035041578,36,256.0091025458683,0.5287504781740865,1.0198162295180748,1.5468501690613172,0.6996832278268478,13816,14062,Callahan and Nearby Counties,Callahan,48,59,Texas,TX
48133,48CS018,210,202,217,230,13,20,28,458.4867735978472,18,403.5874439461884,-1.2804088445657622,0.5912738043588037,2.30957095825741,0.8392191305601304,254,245,264,383,119,129,138,720.8537759060877,70,392.2008068130883,2.7925815756429686,3.2975788289393573,3.8018348603739147,0.5398819182700452,17840,17848,Callahan and Nearby Counties,Eastland,48,133,Texas,TX
48253,48CS018,153,145,162,221,59,68,76,1373.0812823816268,39,790.9146217805718,4.123080030327091,5.839844711373749,7.512526782608572,0.5676307430523009,188,178,198,261,63,73,83,369.0794317424479,62,312.43700866760736,0.03088447487373466,0.5630548947638492,1.0981098118002635,0.8351279330702509,19724,19844,Callahan and Nearby Counties,Jones,48,253,Texas,TX
48417,48CS018,25,24,25,38,13,13,14,1711.9408798931809,8,1014.906438312718,6.554260941729326,6.984020896514129,7.359878890657551,0.5519382905298778,30,30,31,42,11,12,12,361.5099214033948,6,187.5586120662707,1.6118143773415798,1.7354661603107722,1.8577281109266708,0.47752822277997076,3153,3199,Callahan and Nearby Counties,Shackelford,48,417,Texas,TX
48429,48CS018,91,90,92,123,31,32,33,1396.7126591920328,17,744.7973713033954,6.094427645060055,6.52285799646974,6.920345701072786,0.5170321578000899,112,111,113,144,31,32,33,352.1403952247411,24,262.0373403209957,0.7685108727923377,0.8965547222179422,1.0257796199091684,0.7217494022136405,9130,9159,Callahan and Nearby Counties,Stephens,48,429,Texas,TX
48061,48CS019,2342,2161,2523,3734,1211,1392,1573,1320.7306345424904,1075,1019.9361946892159,1.3986781997826132,3.0199427939943093,4.725196702914971,0.7716971189243801,2911,2693,3130,3808,678,897,1115,212.1150305940382,740,175.0397978999955,-0.1634206553319657,0.37054339196286545,0.85367930460560415,0.824292456090114,421595,422761,Cameron,Cameron,48,61,Texas,TX
48067,48CS020,331,319,343,455,112,124,136,1728.2314006033305,60,837.6963350785342,7.140971204868803,8.890113908541746,10.518309570257253,0.48082866370326327,403,388,418,589,171,186,201,651.4182389656651,111,388.9687072922872,2.082533711290205,2.643195560158967,3.1329558016605876,0.593915661969222,28650,28537,Cass+Marion+Morris,Cass,48,67,Texas,TX
48315,48CS020,144,140,148,163,15,19,23,773.5794777166909,21,861.0968733982572,-2.5447360072897682,-0.8866094552018914,0.9047738980090567,1.0571000381563993,173,168,178,212,34,39,44,399.0519023434427,40,414.03581409791946,-0.6902052524057303,-0.1532826745698779,0.3806368361612714,1.0113165235511414,9755,9661,Cass+Marion+Morris,Marion,48,315,Texas,TX
48343,48CS020,155,150,160,168,8,13,18,431.0962820868223,15,498.96049896049897,-2.3975592552558056,-0.7411651481067578,1.0427045179860626,1.0745114999405163,189,183,195,228,33,39,45,326.1673086678394,43,357.73710482529117,-0.8241834493364976,-0.31151381397385663,0.19613022213759623,1.069510456783947,12025,12020,Cass+Marion+Morris,Morris,48,343,Texas,TX
48071,48CS021,277,257,297,334,37,57,77,489.8989573380653,28,239.54657255908458,0.760736982379308,2.537233949536494,4.088894982981462,0.48057891049761686,352,327,377,418,41,66,91,136.08370851768981,86,176.95473251028807,-0.9100182155634471,-0.40667659470384154,0.08421961599675533,1.2809688683302294,46755,48600,Chambers+Liberty,Chambers,48,71,Texas,TX
48291,48CS021,764,724,804,768,-36,4,44,17.947301654210303,92,398.561712082485,-5.515967681857822,-3.823523489550061,-1.9735822614587997,17.889172389590904,975,925,1025,1155,130,180,230,186.3510480952099,240,247.80076818238135,-1.1365718162715315,-0.6245126783241349,-0.08158106668207793,1.3224254021687494,92332,96852,Chambers+Liberty,Liberty,48,291,Texas,TX
48073,48CS022,464,442,486,601,115,137,159,1079.9024523679561,97,763.0885418715336,1.463999665781918,3.127324494192325,4.872560926508958,0.701516866322128,570,544,597,794,197,224,250,438.53675458427074,148,290.15625306330503,0.9596461067030383,1.4692979884337645,1.9493299653227365,0.6587015923844254,50846,51007,Cherokee,Cherokee,48,73,Texas,TX
48077,48CS023,108,107,109,128,19,20,21,777.1362465052296,13,505.88578655511236,2.2934420315971833,2.714248172579036,3.115810373407194,0.6199196779309037,132,131,134,151,17,19,20,180.33361796143453,16,155.94541910331384,0.12228421819598666,0.24023575133602854,0.3742418402213162,0.8204190317723986,10279,10260,Clay+Cooke+Montague,Clay,48,77,Texas,TX
48097,48CS023,373,355,391,424,33,51,69,492.88280368471385,39,374.4329500996088,-0.5233442614120736,1.2251672356649281,2.8486723773711504,0.7451644469891585,463,442,485,520,35,57,78,134.32881098499405,85,201.59377668152925,-1.2224719109813342,-0.6731615318702319,-0.16445173159896057,1.4747113070623776,41663,42164,Clay+Cooke+Montague,Cooke,48,97,Texas,TX
48337,48CS023,245,237,254,325,71,80,88,1592.2285581760198,41,820.123018452768,5.9001312888229895,7.706941641295098,9.319923648733521,0.5086881062864574,305,294,315,368,53,63,74,310.65164723800456,55,270.33669206193167,-0.10675320072985967,0.3942155411309024,0.8915311991827225,0.8566700958881407,19997,20345,Clay+Cooke+Montague,Montague,48,337,Texas,TX
48085,48CS024,4222,3759,4684,4832,148,610,1073,227.92117224215303,443,165.39431891048827,-1.2082490028924648,0.6497562363206447,2.4279093679613695,0.7244778229732565,5448,4878,6018,6213,195,765,1335,69.25467802348268,819,74.17362968973868,-0.5815122645516644,-0.05251680921977067,0.4559277806962545,1.0696282151054053,1071379,1104166,Collin,Collin,48,85,Texas,TX
48091,48CS025,1215,1144,1285,1357,72,142,213,347.7665070852529,137,334.7157664563495,-1.605426285698187,0.13188382385306222,1.8667669165410967,0.9557581587747257,1574,1484,1663,1784,121,210,300,121.25960643037308,289,166.74167157083346,-0.9728594791836231,-0.4598139580477232,0.048171439862176896,1.3685683646502949,163721,173322,Comal,Comal,48,91,Texas,TX
48093,48CS026,158,152,164,194,30,36,42,1062.1979594447196,36,1057.1134928791662,-1.581842079358109,0.06897294355468483,1.7202789290383473,0.9684408918461118,193,186,200,220,20,27,34,194.8642837519125,32,232.74419957815115,-0.8888115947724686,-0.3769662141265086,0.1844629590075754,1.151415019650125,13622,13749,Comanche+Erath+Somervell,Comanche,48,93,Texas,TX
48143,48CS026,288,270,307,315,8,27,45,251.30254680531226,37,346.13405678469525,-2.53092496385713,-0.8937708061716583,0.7194965092887465,1.327926602850816,356,334,379,462,83,106,128,244.16784657487267,79,182.5281301263834,0.10679829406960947,0.6044861448681057,1.0920316704519597,0.7405443338289487,42758,43281,Comanche+Erath+Somervell,Erath,48,143,Texas,TX
48425,48CS026,82,82,83,99,16,17,17,717.3440830432086,3,130.0531050178823,5.455885341092003,5.86906774174187,6.291917005565357,0.1709661360143973,103,102,104,123,19,20,21,209.19015906160624,17,180.23748939779475,0.15696391305217935,0.29007738225048313,0.4203406266397357,0.8200352635323465,9227,9432,Comanche+Erath+Somervell,Somervell,48,425,Texas,TX
48099,48CS027,464,429,500,534,34,70,105,339.2610826576043,40,194.50759187444535,-0.16237071782536033,1.457719592291067,3.2112189213493894,0.5652256758872497,585,542,628,705,77,120,163,142.83982938827583,130,154.6404015892275,-0.5954504812617125,-0.11153655040691697,0.39812647146488206,1.0736726862103851,82259,84066,Coryell,Coryell,48,99,Texas,TX
48105,48CS028,30,29,32,56,24,26,27,3248.399685840329,10,1266.2234884457107,18.162204939964138,19.856550775452202,21.62509512744121,0.3751748804697592,37,35,38,55,17,18,20,601.222286416351,6,195.1854261548471,3.5461022644820814,4.079424021664567,4.545314680841358,0.3079833427205446,3159,3074,Crockett+Kinney+Terrell+Val Verde,Crockett,48,105,Texas,TX
48271,48CS028,31,29,32,45,13,14,16,1783.0132682671547,4,499.06425452276983,11.076615627910323,12.771345935240799,14.47879448371207,0.26159432916505276,37,36,39,53,14,16,17,505.6821769636308,2,63.89776357827476,3.9070498308814305,4.41165084632241,4.935574878007727,0.11885058078026403,3206,3130,Crockett+Kinney+Terrell+Val Verde,Kinney,48,271,Texas,TX
48443,48CS028,9,9,9,12,3,3,3,1402.5411400016446,3,1615.0740242261104,-2.5403246843972798,-2.133513840245903,-1.7091002177929793,0.8321267108732969,11,11,11,20,9,9,9,1199.3788585403315,4,550.2063273727648,6.363261005844403,6.493022231013477,6.611034381075565,0.4115444683980179,743,727,Crockett+Kinney+Terrell+Val Verde,Terrell,48,443,Texas,TX
48465,48CS028,328,308,349,498,149,170,190,1419.130454379737,162,1355.847090578118,-1.053274222037945,0.6462722254215069,2.356775581491253,0.949805396660866,406,381,430,503,73,97,122,204.70699531465073,99,208.12748333928982,-0.542551073660221,-0.026496134674609567,0.47119084643756365,1.0063739409056778,47793,47567,Crockett+Kinney+Terrell+Val Verde,Val Verde,48,465,Texas,TX
48107,48CS029,55,54,55,83,28,28,29,2181.950391136611,23,1773.6649315596685,3.6835580081462673,4.0823602993374015,4.488039184339674,0.7851318771610228,66,65,67,99,32,33,34,645.2190738072621,20,391.77277179236046,2.4143648708380705,2.5373715880477987,2.666749308101336,0.589302386971224,5187,5105,Crosby+Floyd+Hale+Swisher,Crosby,48,107,Texas,TX
48153,48CS029,50,50,51,93,42,43,43,3150.09560699855,27,1988.9502762430939,11.192623788204227,11.611248764401044,12.001315236895875,0.6169659061736331,61,60,62,93,31,32,33,600.4358740386898,15,280.1643630930146,3.0691812256627693,3.1978176758803616,3.327166225046904,0.4525250440948961,5430,5354,Crosby+Floyd+Hale+Swisher,Floyd,48,153,Texas,TX
48189,48CS029,265,251,279,392,113,127,141,1562.7063384238588,129,1587.1062992125983,-2.1163290587849763,-0.26844737869722424,1.468497086971028,1.0076804687682037,326,309,342,395,53,69,86,215.23368634357112,76,235.6443011286122,-0.7253773986797389,-0.2181218199161783,0.2988882917036661,1.0792822488868345,32512,32252,Crosby+Floyd+Hale+Swisher,Hale,48,189,Texas,TX
48437,48CS029,69,69,70,99,29,30,30,1681.5554673035783,12,683.0795503059628,9.562439298194455,9.985469643506807,10.370471538529197,0.3929179721835633,85,84,86,96,10,11,12,157.75290910253136,13,185.68775889158692,-0.4140018438498358,-0.27960056653670595,-0.14969933521236115,1.0793504253627366,7027,7001,Crosby+Floyd+Hale+Swisher,Swisher,48,437,Texas,TX
48113,48CS030,13906,12784,15028,17173,2145,3267,4389,500.29547661588833,2301,352.3794610707604,-0.19122863262774412,1.4975240471384268,3.1004340224801705,0.7041271532156845,17124,15787,18461,20576,2115,3452,4789,133.31263324689357,3389,130.86548850399393,-0.5218815624595906,0.028843615826339368,0.5572565718509457,0.9813593081473592,2611957,2589682,Dallas,Dallas,48,113,Texas,TX
48121,48CS031,3553,3160,3947,4109,162,556,949,243.35632132502357,405,177.4127310061602,-1.0586869196153736,0.7256972401884041,2.387198532912504,0.727714612868149,4571,4087,5056,5340,284,769,1253,81.9660488584603,693,73.91203720985793,-0.44613664685628135,0.08771093929808826,0.6265372049250542,0.9005678328632841,913125,937601,Denton,Denton,48,121,Texas,TX
48127,48CS032,67,66,68,91,23,24,25,1088.459943377841,13,592.3900660742767,4.555652416599876,4.955816023315416,5.361901918139322,0.5223767419326212,79,78,81,156,75,77,78,901.4892504358038,35,412.4440254536885,4.762872173121897,4.892029508903899,5.008653881604857,0.45161070174319684,8778,8486,Dimmit+La Salle+Maverick,Dimmit,48,127,Texas,TX
48283,48CS032,44,43,45,68,23,24,25,1409.7541802954313,19,1121.4401652648664,2.489170123130639,2.885399075911315,3.2889638830733943,0.7635195134515763,53,52,54,86,32,33,34,491.4426122409608,25,375.03750375037504,1.035881729836248,1.168885661041757,1.2908816768360347,0.7405308790732774,6777,6666,Dimmit+La Salle+Maverick,La Salle,48,283,Texas,TX
48323,48CS032,344,338,350,611,261,267,273,1842.1815814743218,216,1491.1720543311299,3.1072961620603636,3.5034930552907615,3.9427620728421098,0.8064377401191332,423,416,431,614,183,191,198,328.8007511814193,201,346.40241275312366,-0.30468255911963815,-0.17277515661687112,-0.04238075731009122,1.0480396565956847,57941,58025,Dimmit+La Salle+Maverick,Maverick,48,323,Texas,TX
48047,48CS033,67,67,68,101,33,34,34,1914.5869353549097,28,1592.0398009950247,2.836914097923294,3.212812979407882,3.632017566138593,0.807549486534901,82,81,83,97,14,15,16,211.48541663093874,20,285.7551078725532,-0.875474644623824,-0.7454309070104718,-0.626178173584211,1.2656734425534855,7035,6999,Duval and Nearby Counties,Brooks,48,47,Texas,TX
48131,48CS033,98,97,99,123,24,25,26,1007.8723354451989,25,1000.3000900270081,-0.3676455468796847,0.06605105290372867,0.4879017227223496,0.95459017064557,117,116,118,172,54,55,56,561.1382510005349,31,317.4928308070463,2.3081152458869982,2.4372023910201324,2.5574043243802342,0.5556597285334172,9997,9764,Duval and Nearby Counties,Duval,48,131,Texas,TX
48247,48CS033,40,39,40,54,14,14,15,1153.8836142569755,12,983.2036050798854,1.3336655582407888,1.7133603357959342,2.111243559622796,0.7955898063894309,48,48,49,69,20,21,21,430.59917507756893,4,83.21198252548366,3.351606327195874,3.4774318274537057,3.6016764270024635,0.18434112178680245,4882,4807,Duval and Nearby Counties,Jim Hogg,48,247,Texas,TX
48249,48CS033,330,313,346,429,83,99,116,1016.8353363379379,68,696.1328794819952,1.409008558152851,3.229806349468638,4.951427516824386,0.6777835276134985,403,383,423,594,171,191,211,492.0389747567492,109,280.6240667318882,1.610002385512854,2.1067878634210984,2.6526045980178385,0.5673602974616876,39073,38842,Duval and Nearby Counties,Jim Wells,48,249,Texas,TX
48505,48CS033,82,81,84,115,31,33,34,937.2549360409122,22,631.4580941446612,2.644085610131517,3.0657509588622243,3.4435657816941068,0.6537120360010712,101,100,103,141,38,40,41,284.9450349934457,23,165.42002301495972,1.0628452839506422,1.1954377044440665,1.3248119031855494,0.5662408532878818,13936,13904,Duval and Nearby Counties,Zapata,48,505,Texas,TX
48011,48CS034,24,24,24,34,10,10,10,2147.3155319499515,7,1515.9718462371413,5.931381919701552,6.310133965866904,6.7259765657309085,0.6413058030545553,29,29,29,31,2,2,2,99.79828638251018,4,217.3913043478261,-1.301632789998643,-1.1784783807713188,-1.0377060014750017,1.4102937846770998,1847,1840,Eastern Central Panhandle,Armstrong,48,11,Texas,TX
48023,48CS034,51,51,52,57,5,6,6,637.5363533088912,6,690.8462867012089,-0.9619606758485324,-0.5357817050161218,-0.1329559334817533,0.9178517724838342,63,62,63,81,18,18,19,530.3809719268269,17,489.2086330935252,0.2830856448938456,0.41328290257707717,0.5419914069931507,0.8749024006409591,3474,3475,Eastern Central Panhandle,Baylor,48,23,Texas,TX
48045,48CS034,15,15,15,22,7,7,7,1927.6202847619352,3,835.0730688935281,10.550407190297715,10.908497557527406,11.329390470974445,0.37855004836268413,18,18,18,16,-2,-2,-2,-136.6806076965785,5,355.6187766714083,-5.045186408306532,-4.92671023423031,-4.790791786460337,-5.424585895401107,1437,1406,Eastern Central Panhandle,Briscoe,48,45,Texas,TX
48075,48CS034,61,61,62,72,10,11,11,635.4283380246671,13,771.3989022400237,-1.7654541194563353,-1.3630956647030863,-0.9350893392462725,1.1102991629452605,74,73,75,84,9,10,11,144.67364489097284,13,193.36605681987209,-0.6145169281281273,-0.48207559057371446,-0.3617595010768196,1.2119619737629983,6741,6723,Eastern Central Panhandle,Childress,48,75,Texas,TX
48101,48CS034,21,21,22,27,5,6,6,1634.4600903786886,6,1744.1860465116279,-2.7174157756211637,-1.1202607643700835,0.5457773773846089,0.9059964219063779,26,26,27,21,-6,-5,-5,-378.0438589217558,8,579.7101449275362,-10.071910007786565,-9.563068864648733,-9.058693616406453,-1.897080871331775,1376,1380,Eastern Central Panhandle,Cottle,48,101,Texas,TX
48125,48CS034,19,19,19,38,19,19,19,4124.717954442214,7,1538.4615384615386,25.48552070905779,25.862966999314125,26.269584886980624,0.3541172022098704,22,22,23,30,7,8,8,437.0313422796771,4,229.48938611589213,1.9476017191708317,2.075955610345623,2.207300847951,0.4641740976263463,1820,1743,Eastern Central Panhandle,Dickens,48,125,Texas,TX
48129,48CS034,41,40,41,47,6,6,7,770.3374668102439,5,611.9951040391677,1.1957938817003786,1.5731806298445514,2.000293596512357,0.6855271544596999,49,49,50,64,14,15,15,444.4708863800705,12,367.1970624235006,0.6561478636783158,0.7683205879623798,0.8942790385844761,0.772931497515192,3268,3268,Eastern Central Panhandle,Donley,48,129,Texas,TX
48155,48CS034,17,16,17,27,10,10,11,3666.244169539699,4,1459.85401459854,20.438436385853947,22.080765590347383,23.73012162773384,0.3621381315350495,21,20,21,25,4,4,5,413.0116574968797,3,277.5208140610546,0.8341036354929512,1.3366161714776732,1.9045627000932617,0.54898240444964,1096,1081,Eastern Central Panhandle,Foard,48,155,Texas,TX
48191,48CS034,35,34,35,47,12,12,13,1764.4561747550326,7,988.3515707730321,7.355744334448363,7.75391969075289,8.133530432104505,0.5186429598776764,42,42,42,52,10,10,10,351.9127180844093,5,176.11835153222964,1.638465343733553,1.7637013180033498,1.8866782123074546,0.45492585252518175,2833,2839,Eastern Central Panhandle,Hall,48,191,Texas,TX
48197,48CS034,37,37,37,68,31,31,31,3432.2819702396855,10,1107.419712070875,22.84544540469211,23.254024630812204,23.68300530683072,0.31256342897267203,44,44,45,46,1,2,2,49.67771394426149,4,112.5809175344779,-0.7509025408462117,-0.6336849764371417,-0.5000425376947825,1.446628882438381,3612,3553,Eastern Central Panhandle,Hardeman,48,197,Texas,TX
48207,48CS034,59,58,59,71,12,12,13,891.9878449299116,15,1099.3037742762915,-2.473303997387565,-2.0633725390914366,-1.683481245746888,1.1388506321401064,71,70,72,111,39,40,41,740.7866560666233,20,369.48087936449286,3.587848957103375,3.7156001492534267,3.83804934218555,0.4866324298722886,5458,5413,Eastern Central Panhandle,Haskell,48,207,Texas,TX
48269,48CS034,4,4,4,4,-0,-0,-0,-250.37654675854515,4,5970.149253731343,-63.92318046544401,-62.214671015538016,-60.486473852473516,4.806261326153113,5,5,5,8,3,3,3,1178.6015456213543,8,3076.923076923077,-19.45433736365053,-18.972854823280297,-18.48295579622104,1.9683276309303388,268,260,Eastern Central Panhandle,King,48,269,Texas,TX
48275,48CS034,41,40,41,66,25,25,26,2986.416402403252,12,1410.105757931845,15.365374692487137,15.765621277464316,16.18428666982737,0.4542975941756098,49,48,49,71,22,22,23,668.9303110377571,10,298.32935560859187,3.5808317182064466,3.7092301182914516,3.836766564137534,0.4269391057139534,3404,3352,Eastern Central Panhandle,Knox,48,275,Texas,TX
48345,48CS034,17,16,17,18,1,1,2,532.1146976257745,5,1860.4651162790697,-14.905555401313752,-13.258176252028425,-11.60824383046955,2.057563846574043,20,20,21,31,10,11,11,1011.3801540568871,2,187.79342723004694,7.677938952288868,8.240755172268926,8.72671564180127,0.1699062313912385,1075,1065,Eastern Central Panhandle,Motley,48,345,Texas,TX
48433,48CS034,19,19,20,25,5,6,6,1781.860537713063,6,1912.3505976095616,-2.891280882966197,-1.2748378690556124,0.36808845054411815,0.9103892569951443,23,23,24,24,0,1,1,65.47659839691556,6,491.4004914004914,-4.790334711401503,-4.255596248251173,-3.739322324231217,3.3343164631623394,1255,1221,Eastern Central Panhandle,Stonewall,48,433,Texas,TX
48447,48CS034,18,18,18,15,-3,-3,-3,-869.7735967332164,6,1651.7549896765315,-25.612424426339015,-25.21995362042418,-24.825675425067754,-2.7784819298252463,23,22,23,23,0,0,1,27.147481773876603,8,537.9959650302623,-5.2378984446984225,-5.109646454071344,-4.981064119356155,5.699292284914894,1453,1487,Eastern Central Panhandle,Throckmorton,48,447,Texas,TX
48487,48CS034,151,146,157,182,25,31,36,966.9828576342144,38,1186.3877614736186,-3.939981741683079,-2.2116209063360697,-0.5226569205999222,1.1885228379250572,185,178,191,198,7,13,20,104.0391257849927,37,290.241606526514,-2.3775233167304886,-1.8665393938248056,-1.3363833428394225,2.5941414356301538,12812,12748,Eastern Central Panhandle,Wilbarger,48,487,Texas,TX
48135,48CS035,1070,999,1141,1393,252,323,394,781.6444861369296,268,649.2287380616405,-0.4198134250169076,1.3325146818873659,2.933782854450283,0.828027137272186,1295,1212,1379,1614,235,319,402,197.1253193309787,317,196.0069004322045,-0.48066555782569526,-0.017616319706723133,0.4877955774233594,0.9912172284403551,165119,161729,Ector,Ector,48,135,Texas,TX
48139,48CS036,1211,1127,1294,1420,126,209,293,431.9888349687367,184,379.8494020984615,-1.2025686162963038,0.5161251675379173,2.1861263623422724,0.8751216957686296,1545,1441,1649,1822,173,277,381,137.30382047089608,283,140.48011436967616,-0.5717747848347233,-0.03766707901414152,0.49080773601241695,1.019447703351824,193761,201452,Ellis,Ellis,48,139,Texas,TX
48141,48CS037,4833,4462,5205,7370,2165,2537,2908,1177.0590089124905,2091,970.171067466559,0.3745341828866196,2.0862806737193504,3.859127337138195,0.8239083915815472,6026,5578,6474,7301,827,1275,1723,146.92922045831816,1193,137.49356039171258,-0.4839464086937289,0.11047424578689621,0.6097895582486329,0.9350474704685262,862116,867677,El Paso,El Paso,48,141,Texas,TX
48145,48CS038,157,150,165,168,3,11,18,247.18709572183047,22,516.3107251818822,-4.334516074654433,-2.6866705617827873,-0.788622249913079,1.9076287737295472,195,186,204,245,41,50,59,291.75692284366346,38,220.13671648708146,0.19416730888570774,0.7081034240917637,1.2126406967533747,0.7398310222880216,17044,17262,Falls+Lee+Milam,Falls,48,145,Texas,TX
48287,48CS038,163,155,170,196,26,33,41,759.7312388945209,29,663.1982162254874,-0.9040739366729149,0.9901561741727591,2.743732902470294,0.8474292040964838,200,191,210,209,-1,9,18,48.45462973669616,27,152.74949083503054,-1.5626200065462368,-1.0508462027225616,-0.5463878638393697,2.8228385425821414,17491,17676,Falls+Lee+Milam,Lee,48,287,Texas,TX
48331,48CS038,249,238,259,256,-3,7,18,116.14106278996714,19,306.9095020797157,-3.5626171752556584,-1.922161322866621,-0.20537426416223684,2.3199015141203922,306,294,319,415,96,109,121,433.17141175339225,74,295.40918163672654,0.8489535613400288,1.3683027973601503,1.9069148889240934,0.6757408394760552,24763,25050,Falls+Lee+Milam,Milam,48,331,Texas,TX
48147,48CS039,395,380,411,427,16,32,47,353.99013943422426,65,726.3990165674853,-5.49880084267254,-3.7536779464737373,-1.9244275002505842,1.989232276389134,492,473,511,597,86,105,124,288.37215782616425,103,282.6021346064148,-0.44298705910519076,0.057009968078627064,0.5781606789690973,0.970754829248099,35793,36447,Fannin+Lamar+Red River,Fannin,48,147,Texas,TX
48277,48CS039,535,514,557,675,118,140,161,1116.237091615177,97,775.441681988968,1.5752843576162665,3.4956084229470106,5.064194226538736,0.689752773583005,656,630,682,824,142,168,194,335.8653179771215,126,251.52210799480986,0.3350051596033697,0.8444095743754773,1.337608632797359,0.7444532426657791,50036,50095,Fannin+Lamar+Red River,Lamar,48,277,Texas,TX
48387,48CS039,156,151,161,213,52,57,62,1949.804435566628,28,963.0266552020636,8.050263793635787,9.816693715055333,11.617751722762728,0.4853480027933881,190,184,196,231,35,41,47,356.3105353480809,29,250.99532629392417,0.5016772340439916,1.0417142782929603,1.5893539287215868,0.6877233443881531,11630,11554,Fannin+Lamar+Red River,Red River,48,387,Texas,TX
48157,48CS040,3118,2761,3476,3864,388,746,1103,359.60561931751425,429,206.88956726804497,-0.09611548055071768,1.532696080991716,3.2649651745089496,0.5745529886305797,4031,3590,4472,4860,388,829,1270,97.01451376938918,640,74.92680002856584,-0.28062141843665195,0.23270088133664263,0.6983198276687237,0.7713947895240201,829428,854167,Fort Bend,Fort Bend,48,157,Texas,TX
48161,48CS041,187,179,196,245,49,58,66,1181.0239958795644,31,635.1157549682442,3.8236753573247055,5.380654488718986,7.369437741515368,0.5285972723890892,232,222,242,256,14,24,34,120.3219730422375,46,233.1947683260671,-1.6020130957690597,-1.1237843995273342,-0.6225354501953092,1.8597345807708165,19524,19726,Freestone+Leon+Limestone+Navarro,Freestone,48,161,Texas,TX
48289,48CS041,172,165,179,217,38,45,52,1127.8160108804675,22,550.0687585948243,3.998897827307204,5.740424848747805,7.524858347039843,0.4771509608819063,211,202,219,274,55,63,72,397.9988754861518,38,238.61852433281007,1.0778328789685347,1.591980151719382,2.1054420614972367,0.5902333076782983,15998,15925,Freestone+Leon+Limestone+Navarro,Leon,48,289,Texas,TX
48293,48CS041,226,217,236,297,61,71,80,1265.871102628402,28,502.4223936838328,5.811067182090437,7.632418871599576,9.500150829008053,0.3913511586840073,276,265,288,400,112,124,135,559.9272730594744,78,352.669891938328,1.5732710853309781,2.0601829992676053,2.5604052205163663,0.624804173042192,22292,22117,Freestone+Leon+Limestone+Navarro,Limestone,48,293,Texas,TX
48349,48CS041,512,490,535,527,-8,15,37,111.60775730047138,74,564.2501763281801,-6.2573055988664334,-4.553522563426027,-2.803255051265866,4.73234183144788,638,610,666,685,19,47,75,87.88048150930666,136,254.3339629345651,-2.1820769593482856,-1.6558038213208186,-1.1650556187229066,2.8337861559799125,52459,53473,Freestone+Leon+Limestone+Navarro,Navarro,48,349,Texas,TX
48163,48CS042,129,121,137,157,20,28,36,592.4362065202043,21,450.61960195268495,-0.26938686238228965,1.461878686444983,3.0414350060364823,0.7340345309858526,159,150,169,222,53,63,72,341.54945693406006,57,309.34549006838165,-0.16929052100527678,0.32123762449833515,0.8316879544616249,0.891545758722798,18641,18426,Frio+Medina+Uvalde+Zavala,Frio,48,163,Texas,TX
48325,48CS042,386,364,408,447,39,61,83,475.97646419652835,57,445.9134380317225,-1.4636355619056454,0.2622134195478528,1.7991191619790468,0.9216905590196917,483,456,510,587,77,104,131,200.70722714970046,120,231.5440126577394,-0.8219582243917598,-0.29667066610162923,0.22475911727611025,1.1426555181067322,51131,51826,Frio+Medina+Uvalde+Zavala,Medina,48,325,Texas,TX
48463,48CS042,202,192,213,281,68,79,89,1265.1100604204294,40,642.8801028608165,4.47835562582827,6.155585379632858,7.855472794097153,0.5017866870220583,248,236,261,350,89,102,114,410.9967385289636,72,291.48617464879965,0.687117212261281,1.2016687678100473,1.699077833150272,0.7022999047124289,24888,24701,Frio+Medina+Uvalde+Zavala,Uvalde,48,463,Texas,TX
48507,48CS042,79,78,80,140,60,61,62,2452.9873037287,27,1084.99095840868,13.294428211581106,13.685751920826897,14.09774399672321,0.4351849336398511,93,92,94,151,57,58,59,604.8712382107364,26,272.22280389488014,3.205435321197745,3.3324893490027914,3.4507373523550093,0.4423931621710024,9954,9551,Frio+Medina+Uvalde+Zavala,Zavala,48,507,Texas,TX
48003,48CS043,117,116,119,128,9,11,12,227.13881027123583,32,687.248322147651,-4.97269334138826,-4.606544032860631,-4.174973215807789,2.7643039906484805,143,141,146,158,12,15,17,78.74750082266414,35,189.54779312212293,-1.228551124639794,-1.10481792026541,-0.9780584664900538,2.2521470322175507,18625,18465,Gaines and Nearby Counties,Andrews,48,3,Texas,TX
48115,48CS043,124,119,129,169,40,45,50,1439.1636030764,52,1661.8728028124003,-3.9184065742128746,-2.245011154764219,-0.5838891343285734,1.1296629492330739,151,145,157,166,9,15,21,120.31468445697882,31,249.65772730933398,-1.8021420336025722,-1.29708421100164,-0.7664971760847414,1.9448571064705698,12516,12417,Gaines and Nearby Counties,Dawson,48,115,Texas,TX
48165,48CS043,112,110,114,147,33,35,37,642.7823354521313,33,608.3510000921744,-0.053741981811169286,0.34238315533212665,0.7254513674518673,0.9200471297300252,140,137,142,176,34,36,39,166.23095359783647,40,182.92404079206108,-0.2825158813473019,-0.1718184813408912,-0.046977201792224386,1.070958421927131,21698,21867,Gaines and Nearby Counties,Gaines,48,165,Texas,TX
48305,48CS043,50,49,50,82,32,32,33,2268.3254442354523,16,1129.5446523120368,11.001825187654172,11.39466405450058,11.769851069757069,0.4829338727643129,61,61,62,85,23,24,24,416.8465699056256,14,246.65257223396756,1.5900857593022062,1.6998913091911843,1.8218610506863995,0.567716141002702,5666,5676,Gaines and Nearby Counties,Lynn,48,305,Texas,TX
48317,48CS043,41,40,41,56,15,15,16,1154.1643641129422,17,1278.6761940579165,-1.64929789932412,-1.2501463749966273,-0.8734518399741557,1.0400979019855499,49,48,50,53,3,4,5,76.01795032042976,2,38.336208548974504,0.24612909651583634,0.3737725671513097,0.4976665680569108,0.40275026328301755,5318,5217,Gaines and Nearby Counties,Martin,48,317,Texas,TX
48445,48CS043,123,118,129,155,26,32,37,1063.9437769877118,44,1482.7295703454085,-5.8901410483954315,-4.184710019613116,-2.4533475629569996,1.3508314479359016,150,144,156,148,-8,-2,4,-17.724731482903852,26,221.08843537414967,-2.8900302396174573,-2.406745903144213,-1.8992892218239423,-23.975764064455333,11870,11760,Gaines and Nearby Counties,Terry,48,445,Texas,TX
48501,48CS043,50,49,50,81,31,31,32,1604.5084129585396,22,1126.6163103315837,4.402826947717523,4.784362099648538,5.173214441871657,0.680439630091752,60,59,61,79,18,19,20,253.78898035779736,13,170.69327731092437,0.713242518836165,0.8362240602036518,0.9586931909214882,0.6394941111535503,7811,7616,Gaines and Nearby Counties,Yoakum,48,501,Texas,TX
48167,48CS044,2504,2353,2655,2863,208,359,510,410.2784281442289,220,251.1508703233853,-0.07709168304729844,1.5851872516148502,3.246476849135313,0.6104488266913705,3110,2927,3293,3693,400,583,766,164.46884884658027,474,133.69587291558545,-0.20443693909011676,0.31769680640296516,0.841547853242444,0.8115031038217373,350387,354536,Galveston,Galveston,48,167,Texas,TX
48181,48CS045,1290,1232,1349,1533,184,243,301,711.777863854888,192,563.1365532816635,-0.13232189914840578,1.4946255244617193,3.2674718688713384,0.787922192722489,1605,1534,1677,1971,294,366,437,263.44264222500004,339,244.14484487079767,-0.31865441224054525,0.18505812536674388,0.6961996725455015,0.9242210254516533,136379,138852,Grayson,Grayson,48,181,Texas,TX
48183,48CS046,1128,1074,1181,1404,223,276,330,890.5546338522586,175,563.7614161686774,1.6806122396261358,3.258722826244934,4.946811972229827,0.630763564524077,1384,1320,1448,1828,380,444,508,357.30306248548686,325,261.6810389945007,0.43728306179589066,0.9535464454900716,1.491570338981567,0.7307316991969083,124166,124197,Gregg,Gregg,48,183,Texas,TX
48187,48CS047,1041,967,1116,1169,53,128,202,295.7282362255365,119,275.2288273286036,-1.470031263755886,0.1654820999879152,1.8903566011549389,0.9234593569569542,1311,1220,1402,1617,215,306,397,173.46617671146137,249,141.05570850752864,-0.19518797416973419,0.332224368585781,0.8237224588338196,0.8105128316097832,172947,176526,Guadalupe,Guadalupe,48,187,Texas,TX
48199,48CS048,504,480,528,574,46,70,94,495.20010780934496,54,381.8210744020788,-0.687775154310875,1.1521279025146245,2.820453134100005,0.7601895677985342,623,594,653,806,153,183,212,321.42024730726774,162,284.8501899001266,-0.15346879196925278,0.3572508004206909,0.925965072025776,0.8814018190880724,56571,56872,Hardin,Hardin,48,199,Texas,TX
48201,48CS049,22991,20958,25025,28388,3363,5397,7430,456.49702858270916,3653,309.010886014487,-0.1772248322842189,1.4600163849434602,3.1250084750744827,0.6767922158227888,28606,26165,31047,36243,5196,7637,10078,161.50573568142045,6096,128.91544174792082,-0.17754200594167377,0.3174766684674072,0.8334844426296709,0.798105177119285,4728636,4728681,Harris,Harris,48,201,Texas,TX
48203,48CS050,585,556,615,669,54,84,113,488.8876872030487,84,490.6398761718408,-1.8589229465728005,-0.07874527242052637,1.7102229712164099,0.9917353441400987,721,685,756,951,195,230,266,333.5819410656217,159,230.1146231330323,0.5003584188510749,1.050184941153483,1.5371923156951697,0.6868494482810165,68482,69096,Harrison+Upshur,Harrison,48,203,Texas,TX
48459,48CS050,403,385,421,474,53,71,89,691.1115044276327,49,476.13263694886433,0.6131450018289923,2.1837329629411375,3.84166259498616,0.679385383120838,498,476,519,659,140,161,183,387.52294045909713,137,328.87629930143794,0.060477646476186656,0.5966958756423636,1.127338056417524,0.8434380115695541,41165,41657,Harrison+Upshur,Upshur,48,459,Texas,TX
48209,48CS051,1093,988,1198,1140,-58,47,152,77.33657382467231,102,167.8590970990821,-2.717922328438538,-0.8964067606395569,0.6999060064273808,2.12527617848835,1415,1284,1546,1649,103,234,365,92.20068722650795,238,93.80900014583753,-0.5401868419451836,-0.006524575580052272,0.5358867895629561,1.013112581881109,243061,253707,Hays,Hays,48,209,Texas,TX
48213,48CS052,953,917,988,1130,142,177,213,857.9871660748755,99,479.6802131912059,2.0149202799470314,3.8401691848809545,5.539164191250665,0.5559367052669001,1175,1132,1218,1570,352,395,438,473.0962291115283,288,345.0134770889488,0.7740111973666803,1.2729965319882242,1.792300789337381,0.727425050719716,82555,83475,Henderson,Henderson,48,213,Texas,TX
48215,48CS053,3904,3529,4280,6443,2163,2539,2914,1164.0596923262221,2012,922.5908662587151,0.6910368330249217,2.4696155738690906,4.227215560352744,0.7922511106705173,4917,4464,5371,6410,1039,1493,1946,169.7649538081507,1202,136.72032730982852,-0.15591182645760013,0.3249242916678804,0.8537903103047808,0.8048114863578171,872326,879167,Hidalgo,Hidalgo,48,215,Texas,TX
48221,48CS054,651,624,678,767,89,116,143,746.5787662513529,74,476.1751552395354,0.9743310004572688,2.7258231386572866,4.393039927567164,0.6323593318411557,814,781,847,991,144,177,210,276.4143319117523,128,200.34120611666745,0.2594206338038266,0.752999428587036,1.2474262012731028,0.7207049723360981,62162,63891,Hood,Hood,48,221,Texas,TX
48063,48CS055,136,131,142,173,31,37,42,1164.2733728386388,23,732.5423998726013,2.6452917735086685,4.318628309530792,6.085001019134408,0.6124306395801876,168,162,175,232,57,64,70,507.41683865141067,41,325.6035578144854,1.3162334404684715,1.8247199728901682,2.3857593349000497,0.6318002478743096,12559,12592,Hopkins and Nearby Counties,Camp,48,63,Texas,TX
48119,48CS055,59,59,60,79,19,20,20,1496.9973335159614,1,76.00228006840206,13.788982355496952,14.214800681869603,14.641145455286557,0.048316782414979206,74,73,75,91,16,17,18,315.68401645140904,17,316.6325200223505,-0.13338064479790768,-0.015096927616511088,0.1244601960622199,0.9471240244100001,5263,5369,Hopkins and Nearby Counties,Delta,48,119,Texas,TX
48159,48CS055,100,99,102,137,35,37,38,1399.8612528407348,14,536.8098159509203,8.210868914978528,8.633016796147745,9.028418935519682,0.3732499097480989,123,122,125,128,3,5,6,44.432002105729296,23,220.09569377990428,-1.8866167873733817,-1.7501192997400354,-1.6305752656930075,4.075742015999985,10432,10450,Hopkins and Nearby Counties,Franklin,48,159,Texas,TX
48223,48CS055,357,341,373,448,75,91,107,989.3897125950901,87,943.67763104374,-1.296577226547316,0.41104258236140556,2.1544409857900506,0.9434544267864413,442,423,461,524,63,82,101,221.5368508627517,67,180.349932705249,-0.12395109719571452,0.4178805534253022,0.9021967898882436,0.8043126514920274,36877,37150,Hopkins and Nearby Counties,Hopkins,48,223,Texas,TX
48449,48CS055,250,236,263,288,25,38,52,484.9030448769893,57,724.476502176607,-4.171398533065623,-2.419291832361281,-0.843836492912491,1.4559030225505332,307,291,323,358,35,51,67,164.35233032092137,60,192.3385157877865,-0.8495704711702504,-0.27046889219873,0.20112982135113036,1.1478923575178472,31471,31195,Hopkins and Nearby Counties,Titus,48,449,Texas,TX
48499,48CS055,550,531,570,644,74,94,113,829.647114391523,77,681.5818008807454,-0.06412145438338152,1.486964756782153,3.3226059709970484,0.8128595767485943,681,658,705,912,207,231,254,503.96800598438716,155,338.8052197862248,1.118684752186791,1.651576997742979,2.176937193200197,0.6693720148305032,45189,45749,Hopkins and Nearby Counties,Wood,48,499,Texas,TX
48231,48CS056,863,819,906,981,75,118,162,472.2321009816426,97,386.77392665251153,-0.8413899591714388,0.914923389779764,2.5421135072716403,0.8121758102861736,1080,1027,1133,1303,170,223,276,216.56754859133508,244,237.04739976489563,-0.744652648383383,-0.2108862333475805,0.3504644764241413,1.089677439745592,100317,102933,Hunt,Hunt,48,231,Texas,TX
48237,48CS057,81,80,81,97,16,16,17,765.8516647014272,12,559.3753641766693,1.6443822631211342,2.063097446374557,2.468467852133781,0.6884905614668525,100,99,101,108,7,8,9,93.48829277814866,10,115.2073732718894,-0.33999408215752985,-0.21650368282176288,-0.101696285523841,1.0971187254688624,8581,8680,Jack+Palo Pinto+Young,Jack,48,237,Texas,TX
48363,48CS057,283,270,295,389,94,106,119,1489.3087219985646,49,686.418715416404,6.388795012058884,8.021857509708637,9.692310867678895,0.45660269484551524,346,331,361,457,96,111,126,387.8295277905217,83,289.7235409103602,0.48893153501362646,0.9706223958732165,1.4719361945400191,0.7403746624959486,28554,28648,Jack+Palo Pinto+Young,Palo Pinto,48,363,Texas,TX
48503,48CS057,212,204,220,272,52,60,68,1346.2861867053064,30,671.591672263264,5.089855144690332,6.750710196859186,8.479789883221848,0.4906883385751773,259,249,268,323,55,64,74,357.7433666977654,39,217.18549869131814,0.8752609569686446,1.401563411509407,1.9158768747928028,0.5977929818067268,17868,17957,Jack+Palo Pinto+Young,Young,48,503,Texas,TX
48239,48CS058,147,141,153,158,5,11,17,293.023251290583,23,614.2342101749233,-4.997661415770212,-3.204680530910285,-1.493694687197941,1.9211083260171045,181,173,189,171,-18,-10,-2,-65.92853125549286,28,185.3936304045554,-3.008447484702974,-2.5280714859634696,-1.982310807219129,-3.1259817272896835,14978,15103,Jackson+Matagorda+Wharton,Jackson,48,239,Texas,TX
48321,48CS058,340,325,356,408,52,68,83,745.4694479385519,67,737.6214460683125,-1.6640499650356828,0.06033225369364405,1.6288830971385173,0.9750722966753093,416,398,435,468,33,52,70,141.9782403541878,95,261.4702887182451,-1.7224296168251947,-1.1891821472556297,-0.6996716203329495,1.806600418008452,36333,36333,Jackson+Matagorda+Wharton,Matagorda,48,321,Texas,TX
48481,48CS058,367,349,385,465,80,98,116,941.590059573412,77,740.6516772874835,0.12645593550434225,1.9922155774423493,3.858964256386057,0.7786424911865654,451,429,472,569,97,118,140,283.68019145214487,116,278.20414428242515,-0.4631392567600278,0.07190366202702611,0.5884681754577415,0.9724748323461456,41585,41696,Jackson+Matagorda+Wharton,Wharton,48,481,Texas,TX
48241,48CS059,348,333,362,447,85,99,114,1192.8225273617045,53,636.5792871513078,3.953142275915463,5.532686091325881,7.325184145446146,0.5283545898315787,422,405,440,606,166,184,201,556.7005781873237,122,370.10071593253247,1.3340553435431526,1.8606695242474962,2.3589018594363957,0.6612079843241518,33303,32964,Jasper+Newton,Jasper,48,241,Texas,TX
48351,48CS059,128,123,133,174,41,46,51,1490.2535784450326,19,613.3483980308288,7.087027804918656,8.779692941104392,10.486420710802793,0.4028468104782454,155,149,162,232,70,77,83,627.3215351748183,45,367.9476696647588,2.091500760806289,2.5931706183354013,3.1057207272967142,0.5789909374750914,12391,12230,Jasper+Newton,Newton,48,351,Texas,TX
48245,48CS060,2130,2021,2240,2570,330,440,549,689.4327874881342,271,424.9947071692373,0.9506687192509999,2.6491850930772656,4.297687322435461,0.615042071544312,2598,2467,2729,3184,455,586,717,230.64780973222327,474,186.5877277236297,-0.10928696014126245,0.4306110237611026,0.9949921827949839,0.8075941520700823,255062,254036,Jefferson,Jefferson,48,245,Texas,TX
48251,48CS061,1325,1247,1403,1556,153,231,309,511.5250323217673,175,387.33095770345943,-0.451355430636773,1.2506354080144848,2.8600097420006154,0.7539459651692285,1677,1581,1773,2034,261,357,453,191.65291402561206,388,208.23829330470952,-0.6957335358669419,-0.1553108431120055,0.33236883396754097,1.0835044235322409,180724,186325,Johnson,Johnson,48,251,Texas,TX
48257,48CS062,999,936,1062,1078,16,79,142,215.55480562021043,132,360.22759834622786,-3.2321618780597507,-1.4631770975110063,0.3471950553045272,1.650271775060047,1305,1224,1385,1469,84,164,245,105.20276727538685,261,167.09774898204822,-1.1588652300759714,-0.616706927759394,-0.08615731578048484,1.5787323401723825,146574,156196,Kaufman,Kaufman,48,257,Texas,TX
48261,48CS063,3,3,4,5,1,2,2,1861.6739370883508,5,5698.005698005698,-40.02161570195816,-38.37763732080138,-36.617251746428146,1.8985283096045946,4,4,4,5,1,1,1,278.33161943535816,5,1466.275659824047,-12.38370558858589,-11.875707777480565,-11.34795148421549,2.565272298968155,351,341,Kenedy+Kleberg+Willacy,Kenedy,48,261,Texas,TX
48273,48CS063,243,230,257,295,38,52,65,668.2397621524052,62,803.6813792209475,-3.097175321493811,-1.4257024986215538,0.47690395844885813,1.1797982808972467,299,283,315,335,20,36,52,116.33621432811938,69,224.88755622188904,-1.6026330993203874,-1.0795273301532857,-0.542026719552609,1.8804022074940618,30858,30682,Kenedy+Kleberg+Willacy,Kleberg,48,273,Texas,TX
48489,48CS063,149,140,158,222,64,73,82,1435.4742690676505,64,1260.0905690096477,0.07170943728899079,1.8319999023730937,3.2908503853360758,0.8659445089624821,185,175,196,228,32,43,53,211.08588211742344,46,226.72384050470697,-0.6482872466956837,-0.1488394407897932,0.3847699619948074,1.0495761685038827,20316,20289,Kenedy+Kleberg+Willacy,Willacy,48,489,Texas,TX
48089,48CS064,212,203,221,260,39,48,57,926.519979266743,16,309.1190108191654,4.412669582360874,6.1392706250660565,7.940582005037113,0.3268195866112972,258,247,269,343,74,85,96,411.9040245255173,41,198.82643906697058,1.6075278481753892,2.1360583371676296,2.6167336644703036,0.4770840868375599,20704,20621,Lavaca and Nearby Counties,Colorado,48,89,Texas,TX
48123,48CS064,220,211,228,259,31,39,48,790.0731094007124,50,1006.8465565847765,-3.8392927435204705,-2.1724378550931265,-0.38538443542687645,1.2426981970294444,268,258,279,289,10,21,31,104.12770717342308,38,190.93558436338054,-1.3854115272010827,-0.8587016394144228,-0.369439136801163,1.7492580157131856,19864,19902,Lavaca and Nearby Counties,DeWitt,48,123,Texas,TX
48149,48CS064,260,249,271,323,52,63,74,1023.8096677029492,39,634.1205642047072,2.200749391250146,3.894791350715911,5.618043870681406,0.609690761818735,318,305,331,391,60,73,86,295.9684699569303,52,210.9276761448911,0.36127213932643654,0.8622539548215633,1.3891835936845265,0.7030342032949484,24601,24653,Lavaca and Nearby Counties,Fayette,48,149,Texas,TX
48177,48CS064,170,162,179,222,43,52,60,1040.4372377961774,24,484.04174860081685,3.7883612404792113,5.563087747905588,7.216742803760186,0.45638239938156405,207,197,217,272,55,65,75,330.4012785690291,63,320.72494018225325,-0.44706358207435437,0.07681821064969675,0.603600080866103,0.9559834397758871,19833,19643,Lavaca and Nearby Counties,Gonzales,48,177,Texas,TX
48285,48CS064,221,212,230,274,44,53,62,1037.8884871210828,48,944.2777750454925,-0.8508766670810864,0.9676236199599644,2.7071324712125624,0.8928826119087568,272,261,282,296,14,24,35,118.95274195844658,38,185.23934873744759,-1.1653455945321256,-0.6763042037107608,-0.13325157853566036,1.495947233764531,20333,20514,Lavaca and Nearby Counties,Lavaca,48,285,Texas,TX
48303,48CS065,2220,2086,2354,3014,660,794,928,1018.567143599843,616,790.5391964990406,0.48236004507114916,2.2833041313371303,3.92235176403075,0.7751520512088207,2756,2594,2918,3349,431,593,755,188.8545317855167,519,165.28188682489994,-0.31271189596430093,0.2346997828695928,0.7637829325496203,0.8737076225007833,311686,314009,Lubbock,Lubbock,48,303,Texas,TX
48309,48CS066,1922,1809,2034,2338,304,416,529,638.9580436530492,304,466.49735677073346,0.007479784408253068,1.7308381332872391,3.4576366111564383,0.7283415536620452,2382,2246,2518,2940,422,558,694,212.3154976575898,462,175.79239754956052,-0.14338281036915115,0.3833081979568597,0.9032113385779253,0.8264960177220237,260666,262810,McLennan,McLennan,48,309,Texas,TX
48313,48CS067,129,123,135,140,5,11,17,331.29554863723166,21,617.1932402645114,-4.600528168848828,-2.866233281685707,-0.9684615831705069,1.711166356862252,159,152,166,177,11,18,25,131.18166379941187,30,219.33031144904226,-1.3991697361147164,-0.8714026871156108,-0.40062048832873215,1.5836961250551018,13610,13678,Madison+Trinity+Walker,Madison,48,313,Texas,TX
48455,48CS067,194,188,200,216,16,22,28,637.2988215704349,12,347.8765038411364,1.178127699670323,2.873536002652089,4.5940357838769375,0.5221108994991331,237,230,244,326,82,89,96,644.3976357781459,48,347.9017177647314,2.4453591270426247,2.9713829409934904,3.4463632969783062,0.5338817971726931,13798,13797,Madison+Trinity+Walker,Trinity,48,455,Texas,TX
48471,48CS067,490,458,523,579,56,89,121,466.61024513248805,93,489.56386702813677,-1.913632857031507,-0.2198800300188638,1.505231242684983,1.03748771985787,618,578,658,712,54,94,134,120.77283738381784,105,135.01697356239072,-0.6644462521513825,-0.12275122302819136,0.3741110481063679,1.106164155652245,75986,77768,Madison+Trinity+Walker,Walker,48,471,Texas,TX
48031,48CS068,111,109,112,111,-1,0,2,13.53178822528459,7,241.92154829790908,-2.6957284358819456,-2.2966867912893068,-1.9047144988103193,5.030389689728437,139,138,141,157,16,18,19,150.30679476413218,22,186.0779835913051,-0.49161720514632806,-0.3567404203012188,-0.23179417752602774,1.172034884643579,11574,11823,Menard and Nearby Counties,Blanco,48,31,Texas,TX
48081,48CS068,45,44,46,55,9,10,11,1210.5614245200961,10,1213.5922330097087,-1.683117718537595,-0.08415308846721357,1.6990214298990027,0.9111595611908745,55,53,57,69,12,14,16,415.8742733069305,7,211.09770808202654,1.5069887837151787,2.0366306448142377,2.522322926751155,0.47328025648378585,3296,3316,Menard and Nearby Counties,Coke,48,81,Texas,TX
48095,48CS068,29,29,29,28,-1,-1,-1,-108.28811066974544,4,494.1321803582459,-6.462987926104739,-6.031580964320334,-5.62915249409646,32.412876746517945,37,36,37,34,-3,-3,-2,-81.28047623247095,7,209.7064110245656,-3.0385216507991357,-2.908656434522196,-2.780948994058779,-4.0860587084503415,3238,3338,Menard and Nearby Counties,Concho,48,95,Texas,TX
48137,48CS068,20,19,21,28,7,8,9,2162.114705167635,8,2147.651006711409,-1.4102249299941931,0.17197370273791296,1.8299640938079351,0.8835993415267711,24,23,25,31,6,7,8,496.3974356391828,0,0,4.465798858633301,4.978479302522764,5.484718310649112,0,1490,1434,Menard and Nearby Counties,Edwards,48,137,Texas,TX
48171,48CS068,306,295,318,329,11,23,34,335.60513464938094,25,372.86998023789107,-2.195608505523954,-0.38654053168842506,1.3303069830272405,1.0637625544799731,380,366,394,417,23,37,51,136.11971134148547,58,213.1177659379019,-1.2797537343605314,-0.7639593971096241,-0.25187213669918096,1.5245112719551843,26819,27215,Menard and Nearby Counties,Gillespie,48,171,Texas,TX
48173,48CS068,12,12,12,6,-6,-6,-6,-2034.916844763195,6,2061.855670103093,-41.36774095488837,-40.966835336426534,-40.5599321110762,-1.2191137485427301,14,14,15,12,-3,-2,-2,-212.23163662289832,2,174.82517482517483,-4.005757151965335,-3.873939133308111,-3.760589611602663,-1.4006289579293885,1164,1144,Menard and Nearby Counties,Glasscock,48,173,Texas,TX
48235,48CS068,12,11,12,14,2,2,3,613.9256409968781,2,522.5342913128675,0.5226036846406609,0.9152303150448229,1.313827427274113,0.59705050050859,15,14,15,24,9,9,10,610.0312109818263,5,322.99741602067184,2.740889842228117,2.871954121270081,2.987743898859567,0.47877663854357355,1531,1548,Menard and Nearby Counties,Irion,48,235,Texas,TX
48267,48CS068,50,49,50,51,1,1,2,126.74872154504325,4,371.4020427112349,-2.888498149436212,-2.454568547373328,-2.0508523650622785,1.6912720456797026,62,61,62,63,1,1,2,30.177394905732353,1,22.967386311437757,-0.057829537795502955,0.07571541526361117,0.20152376764691077,0.4321663535989384,4308,4354,Menard and Nearby Counties,Kimble,48,267,Texas,TX
48307,48CS068,87,87,88,109,21,22,22,1138.0992532108269,12,629.2606187729418,4.682855869622425,5.091299044616594,5.491372880900408,0.5285516380420019,106,105,107,166,59,60,61,794.9777631728023,28,371.45131334571505,4.10603949335741,4.236127754514382,4.368071410802768,0.459578255827096,7628,7538,Menard and Nearby Counties,McCulloch,48,307,Texas,TX
48319,48CS068,41,41,42,39,-3,-2,-2,-219.55926795442167,6,598.6530306809677,-8.595718055308335,-8.171503809931004,-7.765350014075376,-4.997781138967722,50,49,50,67,17,17,18,432.6016178721315,6,152.05271160669034,2.6793981483834375,2.806529265146202,2.9361337339887243,0.3320336091452871,4009,3946,Menard and Nearby Counties,Mason,48,319,Texas,TX
48327,48CS068,27,26,28,33,5,6,7,1184.545117288298,6,1205.4244098442994,-1.856141096008225,-0.1852991657920819,1.4904419635561792,0.8700603547043992,33,32,34,38,4,5,6,253.9783352661631,6,303.030303030303,-1.0290562811360862,-0.49137592047210615,0.03833713797445902,0.9952277109070167,1991,1980,Menard and Nearby Counties,Menard,48,327,Texas,TX
48383,48CS068,23,22,23,28,5,5,6,636.9475215796552,7,816.088603905567,-2.1792527116680893,-1.78276162823627,-1.3910509141707241,1.0830184101129101,27,26,27,32,5,5,6,164.1415760189402,5,152.85845307245492,-0.02235107866528992,0.10894808004300653,0.24204092316517486,0.7850438530222366,3431,3271,Menard and Nearby Counties,Reagan,48,383,Texas,TX
48385,48CS068,36,35,36,64,28,28,29,3957.6372525235734,12,1680.672268907563,22.383966107203328,22.773927371697837,23.16565473719743,0.41015082294934163,43,43,44,63,19,20,20,701.5036204551735,11,390.9026297085999,2.9807677871601257,3.1101955978043874,3.2306978894701657,0.5303681094022004,2856,2814,Menard and Nearby Counties,Real,48,385,Texas,TX
48399,48CS068,127,123,132,137,5,10,14,385.86796081158906,20,802.1658477890305,-5.9722957247386,-4.183129233602518,-2.507856070808607,1.8831233942293166,155,150,160,190,30,35,40,350.803416521881,36,362.1730382293763,-0.6167135395368352,-0.1176709018075085,0.4199816282735783,1.0036281267662608,9973,9940,Menard and Nearby Counties,Runnels,48,399,Texas,TX
48411,48CS068,58,57,59,83,24,25,26,1725.0647119527878,15,1037.8827192527244,6.504690017152352,6.87371505031688,7.257576983639878,0.5784471126543616,72,71,73,90,17,18,19,311.22106317668204,14,240.8394976776191,0.5710512463645908,0.7040594054716518,0.8327715624014259,0.7333190705320974,5781,5813,Menard and Nearby Counties,San Saba,48,411,Texas,TX
48413,48CS068,21,21,21,25,4,4,4,645.1034549984563,8,1283.594063377457,-6.786768944322598,-6.395706304382816,-5.9773743977115705,1.5934327360448155,25,25,26,33,7,8,8,318.67778712704785,2,82.27067050596463,2.233757985360019,2.3586200518954583,2.4964288272202655,0.22864833267273493,2493,2431,Menard and Nearby Counties,Schleicher,48,413,Texas,TX
48431,48CS068,13,13,13,13,0,0,0,62.432319866168115,7,2043.7956204379561,-20.17997094930876,-19.804894219389087,-19.40297018904337,5.7668668503036296,16,16,16,16,-0,0,0,7.854579682984977,3,217.23388848660392,-2.2147023220727626,-2.095599275685021,-1.9628692347004453,2.7064289300922377,1370,1381,Menard and Nearby Counties,Sterling,48,431,Texas,TX
48435,48CS068,25,25,25,38,13,13,13,1532.9170979496773,3,351.0825043885313,11.413883048022816,11.811983355589671,12.237901252665818,0.21278441986084726,30,30,30,47,17,17,17,512.1584804009996,4,120.30075187969925,3.7896376396195675,3.91433112207867,4.053618596497551,0.22186145733282908,3418,3325,Menard and Nearby Counties,Sutton,48,435,Texas,TX
48329,48CS069,967,894,1041,1106,65,139,212,324.72047510926393,200,468.12644095170106,-3.1224864340243,-1.4233838425562997,0.3539091558651709,1.4313118572739285,1182,1095,1269,1403,134,221,308,131.50306009321994,233,138.44572392853112,-0.579165723315631,-0.05631211746297723,0.4630315078789992,1.04805911014135,170894,168297,Midland,Midland,48,329,Texas,TX
48339,48CS070,3578,3308,3847,4026,179,448,718,286.8852272311336,290,185.62910664392177,-0.7160013366002318,1.0581518007906714,2.733471116070166,0.6456095822726765,4558,4224,4891,5408,517,850,1184,131.7726350077477,850,131.70249491008593,-0.5356679227923168,0.005566688049177428,0.535535678898493,0.9982938805455001,624902,645394,Montgomery,Montgomery,48,339,Texas,TX
48347,48CS071,492,465,520,635,115,143,170,882.3991879563725,103,637.1692364794853,0.6586201309205858,2.436684612049117,4.097450844247867,0.7170602964014325,606,573,640,792,152,186,219,287.39287470713316,128,197.95242955677213,0.41822812663943165,0.8810552399723184,1.426510766673096,0.6851002133519499,64661,64662,Nacogdoches,Nacogdoches,48,347,Texas,TX
48087,48CS072,30,29,31,43,12,13,14,1957.4716291535517,4,598.1308411214953,11.91471436745242,13.573677405845714,15.240280228483844,0.28387736556925697,36,35,37,42,5,6,7,225.9993513491761,8,305.57677616501144,-1.3226697531386626,-0.800503682262604,-0.27699264610621877,1.1566271161120525,2675,2618,Northeast Panhandle,Collingsworth,48,87,Texas,TX
48179,48CS072,218,209,227,245,18,27,36,506.0354100516061,41,771.3654108461502,-4.3704732672525095,-2.59304017238821,-0.942058539818708,1.4696895985038223,265,255,276,349,73,84,94,396.8809327211845,63,299.25897776933306,0.45722542790673876,0.9718881437756656,1.4947801761549355,0.7451091218510447,21261,21052,Northeast Panhandle,Gray,48,179,Texas,TX
48195,48CS072,41,41,42,50,8,9,9,669.7559522295667,19,1444.043321299639,-8.154192172783544,-7.761608849979635,-7.353467908082285,1.936342448208697,50,49,50,62,12,12,13,237.0489103347919,10,193.31142470520007,0.3145932512301196,0.43627548705504005,0.5606354946912875,0.7540033734683547,5263,5173,Northeast Panhandle,Hansford,48,195,Texas,TX
48211,48CS072,26,26,27,20,-7,-6,-6,-732.5695038635569,4,467.1532846715329,-12.372895359773697,-11.98555565701879,-11.601455203743727,-0.7586352064649002,31,31,31,24,-7,-7,-7,-211.99838789890052,6,182.64840182648402,-4.076155239036721,-3.9484791597137305,-3.824643447941372,-1.0060114140824765,3425,3285,Northeast Panhandle,Hemphill,48,211,Texas,TX
48295,48CS072,22,22,22,34,12,12,12,1553.513905559914,2,261.7801047120419,12.492350507905016,12.92119704612827,13.330357778397893,0.1554140878628277,26,26,27,40,13,14,14,466.63067493655456,2,67.86562606040042,3.864300003758085,3.986388237832544,4.112828007970597,0.13557845846101294,3056,2947,Northeast Panhandle,Lipscomb,48,295,Texas,TX
48357,48CS072,63,62,64,93,29,30,31,1207.7418038627527,20,806.4516129032257,3.580208079585932,3.999996532194473,4.437715002277738,0.6461618670588001,77,76,78,90,12,13,14,134.95233323724028,24,244.69820554649263,-1.2297555799785833,-1.0938092722019508,-0.9732729700311757,1.6858520322873765,9920,9808,Northeast Panhandle,Ochiltree,48,357,Texas,TX
48393,48CS072,9,9,10,12,2,3,3,1342.3950478179206,1,486.61800486618006,6.973850164234231,8.56952307672156,10.242213159008294,0.26605496562862785,11,11,11,1,-10,-10,-10,-1253.2832782964865,1,124.84394506866417,-14.296000536460541,-13.777876418155744,-13.241576717557733,-0.11063416649219122,822,801,Northeast Panhandle,Roberts,48,393,Texas,TX
48483,48CS072,52,51,52,62,10,10,11,808.0761899918302,11,883.3567556715519,-1.1486316334111237,-0.7526366266845562,-0.3560291192005527,0.9943441024183424,63,62,64,92,28,29,30,586.4380585355648,5,101.31712259371835,4.732195563429417,4.851539145617882,4.974761280411392,0.16699666215361633,4981,4935,Northeast Panhandle,Wheeler,48,483,Texas,TX
48065,48CS073,49,49,50,80,30,31,31,2110.775770743819,12,826.1617900172116,12.441653886807117,12.840345472499427,13.25642505875169,0.3790389194461691,60,59,60,85,25,25,26,439.1721417771871,13,225.89052997393568,2.008766645921603,2.1354262344326274,2.259466194890236,0.4947790014082791,5810,5755,Northwest Panhandle,Carson,48,65,Texas,TX
48111,48CS073,37,36,38,68,30,31,32,1726.094689591821,14,784.0940912909549,9.040613786000579,9.405189572292626,9.81057467836701,0.4399828689410565,46,45,47,79,32,33,34,464.6836995317126,2,27.917364600781685,4.229779920077926,4.370622697266938,4.49415108607659,0.058326144237211414,7142,7164,Northwest Panhandle,Dallam,48,111,Texas,TX
48205,48CS073,37,36,37,48,11,11,12,853.4739809608722,11,816.781139780954,-0.048203686247835574,0.36520273891182714,0.7642553426830324,0.8804112690805491,45,44,45,46,1,1,2,23.969875959712,4,74.1839762611276,-0.6270948058259559,-0.5027161266688717,-0.37755469364869076,1.7448537738382608,5387,5392,Northwest Panhandle,Hartley,48,205,Texas,TX
48233,48CS073,209,200,218,274,56,65,74,1263.8514991412344,56,1088.065283917035,-0.03296993677968321,1.783976204078285,3.4215362314733713,0.8478774980053193,255,244,265,348,83,93,104,454.44993640035653,64,312.1798936637237,0.927750878526168,1.4155287810921533,1.953142107076485,0.6796451891711844,20587,20501,Northwest Panhandle,Hutchinson,48,233,Texas,TX
48341,48CS073,145,136,154,175,21,30,39,570.3382406818147,63,1188.2868864054321,-7.947137301914764,-6.128105739114136,-4.474312089723978,2.0167804020279325,178,167,189,190,1,12,23,56.53808270912221,35,165.555082541034,-1.6392656241054475,-1.0877962218263608,-0.5953818610174264,2.7021359707812707,21207,21141,Northwest Panhandle,Moore,48,341,Texas,TX
48359,48CS073,12,12,12,17,5,5,5,1085.3459484789078,2,442.4778761061947,6.0183901602891154,6.422556063175475,6.820280255717759,0.3386522228040146,14,14,14,19,5,5,5,284.04499934196645,1,58.03830528148578,2.1292330449968593,2.2643504231797387,2.38878014249665,0.16966132078667615,1808,1723,Northwest Panhandle,Oldham,48,359,Texas,TX
48421,48CS073,21,20,21,27,6,6,7,891.983676943992,12,1704.5454545454545,-8.520550843136704,-8.126780260404828,-7.719837869362394,1.6484501283732462,25,25,26,33,7,8,8,280.84452586815496,7,250.44722719141325,0.18071283337705846,0.3003910958200234,0.4312552179166997,0.79099580117622,2816,2795,Northwest Panhandle,Sherman,48,421,Texas,TX
48355,48CS074,2465,2313,2617,3260,643,795,947,897.342366177843,510,575.5574301925014,1.3600105511899216,3.1976651249460457,4.9946203630287895,0.6405966221999271,3029,2846,3211,4057,846,1028,1211,291.24822204606255,621,175.88032207906966,0.5833213373940435,1.1633543371879078,1.6730106967631908,0.60329795017175,354439,353081,Nueces,Nueces,48,355,Texas,TX
48361,48CS075,840,804,877,977,100,137,173,647.1666135936664,75,355.1556765715639,1.179318688422867,2.9321292012700932,4.66264318329904,0.5447991634496251,1029,985,1073,1237,164,208,252,245.51316527486196,234,276.15181268882174,-0.7950648492841831,-0.29793091968740826,0.2003512175540961,1.119413503795339,84470,84736,Orange,Orange,48,361,Texas,TX
48365,48CS076,227,218,237,333,96,106,115,1870.1679378193287,45,795.8967102935975,9.039180837762972,10.737391631759857,12.370493733756351,0.42158794391388416,278,267,290,369,79,91,102,400.38673545453196,74,326.69639309522756,0.21759022874806205,0.7323086798209564,1.2455125519256438,0.8070532136602472,22616,22651,Panola+Sabine+San Augustine+Shelby,Panola,48,365,Texas,TX
48403,48CS076,142,138,146,156,10,14,18,554.5865491797429,16,640.8972561586221,-2.554434601497992,-0.8487859924790934,0.8339491371740944,1.0777855914041627,174,169,179,258,79,84,89,840.8490310605965,52,519.1693290734825,2.7233617483098422,3.2113984882162354,3.732242595114606,0.6101894196919246,9986,10016,Panola+Sabine+San Augustine+Shelby,Sabine,48,403,Texas,TX
48405,48CS076,104,103,105,149,44,45,46,2256.37855348841,28,1406.5050860228557,8.06678853741281,8.492565765729085,8.886476389493016,0.6097712880158477,127,126,128,190,62,63,64,799.6957237613522,13,164.09997475385003,6.230062588784914,6.358852029420124,6.472773974739925,0.20201425229589617,7963,7922,Panola+Sabine+San Augustine+Shelby,San Augustine,48,405,Texas,TX
48419,48CS076,237,227,247,295,48,58,68,959.5199849828713,44,729.4732042939445,0.7244834676078771,2.277358430257972,4.107692397312919,0.7473353245946831,288,276,301,386,85,98,110,407.9887068489359,75,313.3224714876551,0.455706481334416,0.9596338933933429,1.4758862915914992,0.760184520740078,24127,23937,Panola+Sabine+San Augustine+Shelby,Shelby,48,419,Texas,TX
48367,48CS077,1100,1036,1165,1222,57,122,186,326.4615089352326,109,292.0705524554693,-1.2909807501710744,0.3564909656207419,2.204071804105489,0.8873719876722004,1406,1325,1486,1615,129,209,290,134.3109191263747,287,184.3347570570667,-1.0194227457163059,-0.49613014700054,0.02499854876653911,1.3659161573097636,149279,155695,Parker,Parker,48,367,Texas,TX
48373,48CS078,580,558,602,719,117,139,161,1094.7930402899754,66,520.1048089993892,4.053328749697763,5.738670152779547,7.368459978150741,0.4716762020067104,719,692,745,963,218,244,271,472.5923226863479,163,315.3048591767255,1.1021224657961775,1.5529684834339417,2.0614193930132076,0.6644617755855878,50759,51696,Polk+San Jacinto+Tyler,Polk,48,373,Texas,TX
48407,48CS078,268,256,280,323,43,55,67,795.6826010469391,24,346.24540142826226,2.856145715924963,4.523471487059098,6.115877514888866,0.42740568345029073,329,314,343,484,141,155,170,558.7557144550898,79,283.9683680805176,2.292319233042381,2.7395297536910395,3.236281982085762,0.5049670871432703,27726,27820,Polk+San Jacinto+Tyler,San Jacinto,48,407,Texas,TX
48457,48CS078,218,209,226,272,46,54,63,1081.8982120641488,17,338.67915130989144,5.7206851463261055,7.410899135235278,9.006018617024425,0.307381417094571,266,255,276,410,134,144,155,720.2026869824005,60,299.4609702535436,3.675123758748656,4.195015493826571,4.69963564224376,0.4129392863609062,20078,20036,Polk+San Jacinto+Tyler,Tyler,48,457,Texas,TX
48375,48CS079,1049,998,1099,1402,303,353,404,1200.1533626945009,299,1015.228426395939,0.18006129416988184,1.8371388360621481,3.568043225224774,0.8435291091389975,1278,1218,1338,1581,243,303,363,259.52276607887484,269,230.33977257158514,-0.21903575942430745,0.3094255920709007,0.7878556278865673,0.8846325176776494,117806,116784,Potter,Potter,48,375,Texas,TX
48379,48CS080,147,142,152,170,18,23,28,754.166985588147,20,652.4753282766495,-0.5829208915831836,1.0400619336411863,2.694170787785516,0.8292869821060226,181,175,188,205,17,24,30,189.51352344307503,32,256.73940949935815,-1.1516691982831073,-0.6508080770614441,-0.15203382651692457,1.2997053230706945,12261,12464,Rains+Van Zandt,Rains,48,379,Texas,TX
48467,48CS080,590,564,615,698,83,108,134,728.0446599652931,71,477.9133361379891,0.7453188480646663,2.4582815195529966,4.1211345490352045,0.6504205966090528,735,703,766,986,220,251,283,411.4093281320246,174,285.04029880086495,0.7665234827243481,1.2784660748899874,1.7778410630939037,0.6900908616351001,59425,61044,Rains+Van Zandt,Van Zandt,48,467,Texas,TX
48381,48CS081,955,894,1016,1200,184,245,306,694.3789426042435,206,584.3971631205674,-0.6558965752923774,1.053936457866625,2.8745271583720586,0.8381868922786228,1195,1121,1269,1480,211,285,359,198.79756545154748,218,151.9470833827045,-0.013336245257575435,0.47185362651250395,1.0074472298009791,0.761660244997639,141000,143471,Randall,Randall,48,381,Texas,TX
48397,48CS082,583,536,630,632,2,49,96,179.68336900624087,54,197.74244047128616,-1.7478575676380326,-0.16471239051809933,1.4663945120708095,1.078524931291092,762,702,821,877,56,115,175,99.913484102978515,168,145.68410829185382,-0.9503402466497217,-0.45702274454831426,0.1005936597307451,1.44555632700812,109233,115318,Rockwall,Rockwall,48,397,Texas,TX
48401,48CS083,450,428,473,577,104,127,149,962.1548139363618,76,578.0127010685629,2.1529938295357787,3.849144712112864,5.463378026589645,0.5960367054820837,554,527,581,767,186,213,240,404.20344185845966,151,286.7070461579357,0.6486792133970646,1.1909601249151005,1.6935062428051897,0.7059973365345399,52594,52667,Rusk,Rusk,48,401,Texas,TX
48409,48CS084,557,527,586,661,75,104,134,608.4161370435099,98,571.7619603267211,-1.383278187923774,0.3431561707880201,2.0977534917389375,0.9308287312852106,692,656,728,883,155,191,227,275.001107673867,195,280.3174055545972,-0.535590210854436,-0.061926646675781925,0.47709704927111946,1.014031225246355,68560,69564,San Patricio,San Patricio,48,409,Texas,TX
48033,48CS085,8,8,8,7,-1,-1,-1,-814.4961364584072,7,4368.174726989079,-52.219611325150126,-51.82105873698602,-51.444840226973106,-22.9335211295904,10,10,10,3,-7,-7,-7,-1100.4078130624605,3,483.8709677419355,-15.968649394072807,-15.842346344272277,-15.706675400566139,-0.515240076610313,641,620,Scurry and Nearby Counties,Borden,48,33,Texas,TX
48151,48CS085,38,36,40,59,19,21,23,2273.9755362723254,12,1297.6480129764802,8.198119690457569,9.777113099896008,11.428309247116678,0.5447466528327105,47,45,49,66,17,19,21,523.3875339408249,13,351.16153430578066,1.1833026625945882,1.7246285899408604,2.230799926928945,0.6380115553148645,3699,3702,Scurry and Nearby Counties,Fisher,48,151,Texas,TX
48169,48CS085,38,38,39,53,14,15,15,1010.8679620748169,15,1022.8435049437436,-0.5334656503556116,-0.11936328668361822,0.269617098515581,0.9479045161051644,47,46,47,64,17,17,18,295.596343586748,11,187.93780967025455,0.9482677106937044,1.0779161128178365,1.2133897451122129,0.6010517096768867,5866,5853,Scurry and Nearby Counties,Garza,48,169,Texas,TX
48227,48CS085,311,296,326,414,88,103,118,1172.7915144445267,85,971.1510996858041,0.34197534237416494,2.0383356447778795,3.6761729326762906,0.8200787913618469,375,358,393,459,66,84,101,244.32483288390674,70,204.5228773447087,-0.11489493910692607,0.40289849249797494,0.9162619382609455,0.8272020203474119,35010,34226,Scurry and Nearby Counties,Howard,48,227,Texas,TX
48263,48CS085,12,11,12,16,4,4,5,2353.6546619205883,7,3693.9313984168866,-13.801685482122387,-13.40271598414753,-12.98609388355448,1.2820100547822857,14,14,14,20,6,6,6,807.0545309864983,3,400,3.9483570684987948,4.075588016586992,4.21150273918286,0.4253564036466102,758,750,Scurry and Nearby Counties,Kent,48,263,Texas,TX
48335,48CS085,84,83,85,76,-9,-8,-7,-351.08391194091973,16,721.2080234392607,-11.090469187545857,-10.71906487368686,-10.32310800545403,-2.35682418766691,105,103,106,109,3,4,6,48.6240361910526,27,298.07904614705234,-2.6339243921919326,-2.4969959744847805,-2.3605257325991085,4.995961414499699,8874,9058,Scurry and Nearby Counties,Mitchell,48,335,Texas,TX
48353,48CS085,162,156,168,202,34,40,46,1085.4575938894625,32,869.3289866883998,0.43900536892247694,2.1250026273793448,3.9118815104275657,0.7813321384743996,197,189,204,214,10,17,25,117.30896323906774,51,348.956551488197,-2.8396856347013575,-2.3053621806814757,-1.7542211158412402,2.8107373508443083,14724,14615,Scurry and Nearby Counties,Nolan,48,353,Texas,TX
48415,48CS085,150,143,157,201,44,51,58,1213.7017074731475,38,900.473933649289,1.4713727369848517,3.1016147746334726,4.862897446541459,0.7277154560502513,183,175,192,223,31,40,48,234.88532119604338,55,326.603325415677,-1.4112047051133243,-0.9273720987039693,-0.40570625542712274,1.3561933919634082,16880,16840,Scurry and Nearby Counties,Scurry,48,415,Texas,TX
48423,48CS086,1862,1762,1963,2318,355,456,556,778.1402006898027,286,488.427596159183,1.104552016363833,2.9177790273822826,4.733247764370405,0.6263112846904031,2310,2187,2432,2978,546,668,791,282.32920633017267,531,224.30522407289288,0.07563105444511538,0.5573834043111732,1.125779239975278,0.7932941949062091,234221,236731,Smith,Smith,48,423,Texas,TX
48427,48CS087,380,373,386,641,255,261,268,1593.3219868320039,210,1279.8439809242302,2.7354245889250652,3.1228134257178217,3.545225323077641,0.8001943179555309,471,462,479,632,153,161,170,244.12307882051752,126,190.85703898936654,0.40269377890888264,0.5342300389503574,0.6527351669896344,0.7769855682050507,65633,66018,Starr,Starr,48,427,Texas,TX
48439,48CS088,11529,10620,12439,13952,1513,2423,3332,458.425042599827,1732,327.72352773942197,-0.5608672945497136,1.2581694477155694,3.071961655849437,0.7145951548821609,14368,13271,15465,17744,2279,3376,4473,158.90056740229014,2929,137.8507982780181,-0.2845887643827857,0.2027249444589667,0.7507140036391777,0.8672717986452737,2113977,2124761,Tarrant,Tarrant,48,439,Texas,TX
48441,48CS089,1235,1174,1297,1390,93,155,216,433.51603579294226,218,611.4449594356756,-3.4974600877767386,-1.817601172836538,-0.05521087427914007,1.4013655056945138,1521,1447,1595,1838,243,317,391,220.9808487400718,391,272.78942888637727,-1.0218598721127188,-0.5154757199468821,-0.009464806739379349,1.2305632002260838,142613,143334,Taylor,Taylor,48,441,Texas,TX
48451,48CS090,928,876,979,1222,243,294,346,981.3563926056718,190,633.6818583554289,1.8639603905424613,3.4714683558358566,5.0794207408437595,0.6435333498486064,1139,1077,1201,1459,258,320,382,267.91231279057286,211,176.5513086551978,0.4100931532168665,0.9156685794185313,1.4245087420104987,0.6569374269799818,119934,119512,Tom Green,Tom Green,48,451,Texas,TX
48453,48CS091,5142,4585,5699,5943,244,801,1358,247.73015148972652,586,181.17776367586805,-1.06522016899229,0.6302442124179696,2.385913317420273,0.7304396634480643,6490,5817,7163,7406,243,916,1589,70.23386124101913,874,67.0330732286472,-0.4883842060609665,0.03353469300450349,0.5468179207677459,0.9533855941400834,1293757,1303834,Travis,Travis,48,453,Texas,TX
48469,48CS092,705,666,744,906,162,201,240,880.6194089664508,129,565.0336173101772,1.3677965346196537,3.148773573247817,4.872989492973866,0.6384564149870414,864,817,911,1119,208,255,302,280.32098556834507,231,253.8349962639005,-0.2352823865576276,0.2676583429642098,0.735235713043994,0.901979752876391,91322,91004,Victoria,Victoria,48,469,Texas,TX
48479,48CS093,1176,1061,1291,1897,606,721,836,1073.765132786317,526,783.195542039063,1.1434803403038811,2.900750616984247,4.636079161890898,0.7283818250196707,1467,1329,1605,1980,375,513,651,191.56590014570122,423,157.92951788561123,-0.1654461403168889,0.34352542588763907,0.8179101665388764,0.8228098888854282,268643,267841,Webb,Webb,48,479,Texas,TX
48017,48CS094,49,49,50,59,9,10,10,568.0873651131386,14,816.8028004667444,-2.9010994581987237,-2.4918280192148186,-2.072602541832629,1.303900275918402,60,60,61,82,21,22,22,314.73092445364756,19,277.85902310617143,0.23385637210822782,0.3641120630855078,0.49130844455879796,0.8436457700880069,6856,6838,Western Central Panhandle,Bailey,48,17,Texas,TX
48069,48CS094,51,51,52,75,23,24,24,1290.423507180995,24,1303.9934800325998,-0.5137908221179729,-0.13345776043236254,0.24285613577940018,0.9696873844971737,63,62,64,96,32,33,34,445.6298585230341,19,257.8368842448093,1.757386139131721,1.8768152312186206,2.008182508489077,0.5614912026100132,7362,7369,Western Central Panhandle,Castro,48,69,Texas,TX
48079,48CS094,21,21,22,34,12,13,13,1942.657769422546,10,1542.6147319706902,3.577220577337006,4.008513785735428,4.415782415838247,0.7356576737039956,26,25,26,46,20,20,21,809.3415021426233,10,396.51070578905626,4.007288861106213,4.127240631141369,4.270340141162056,0.4670367192000306,2593,2522,Western Central Panhandle,Cochran,48,79,Texas,TX
48117,48CS094,138,130,146,173,27,35,43,764.4672252503696,60,1297.7883523495377,-7.053241434864678,-5.3269629405699925,-3.690533367086156,1.6509264136206891,169,160,179,216,37,47,56,255.68010388380722,41,223.38454832734007,-0.18522555557508305,0.3141760863224791,0.8689704840654027,0.8554582970073327,18493,18354,Western Central Panhandle,Deaf Smith,48,117,Texas,TX
48219,48CS094,177,167,186,285,99,108,118,1999.0726132534878,91,1677.0329417184983,1.5587769035479886,3.246787758155323,4.801103619365931,0.8312424565319826,215,204,227,294,67,79,90,367.1456615363496,58,271.2561968010476,0.4737177239592182,0.9533160504076451,1.4606030892226203,0.7295314357283267,21705,21382,Western Central Panhandle,Hockley,48,219,Texas,TX
48279,48CS094,140,134,146,194,48,54,60,1664.648103648108,67,2067.422664506673,-5.612329548125988,-4.0414910526849015,-2.190777372789712,1.2193549835779172,171,164,178,174,-4,3,10,24.04472562004987,28,216.86933622492447,-2.4341336973632477,-1.938960953098368,-1.3993323634184323,6.821923036960488,12963,12911,Western Central Panhandle,Lamb,48,279,Texas,TX
48369,48CS094,67,66,68,105,37,38,39,1556.0421863747742,36,1468.7882496940024,0.448354919911406,0.8639997355056751,1.245471060072717,0.9198082080055214,82,81,84,103,19,21,22,209.0316460005485,10,101.84336490477645,0.9538937202877037,1.0685596280133207,1.1885793688646904,0.4645800171479081,9804,9819,Western Central Panhandle,Parmer,48,369,Texas,TX
48043,48CS095,77,76,78,81,3,4,5,187.6887909845066,12,505.68900126422255,-3.6033309177088455,-3.1722418836710418,-2.7846190026729514,2.2002785145296393,95,93,96,109,13,14,16,152.57155460750752,14,147.88211682687228,-0.08207086749713279,0.04702315729839904,0.17471765115882554,0.9065038956222105,9492,9467,"West Texas, excluding El Paso",Brewster,48,43,Texas,TX
48103,48CS095,32,32,33,39,6,7,7,566.6764387768759,4,341.6613282084134,1.8298841246038375,2.2350072774052,2.645613070367876,0.5239466950703464,40,40,41,48,7,8,8,167.3427799927663,10,213.76656690893546,-0.5818993484263897,-0.46245595667052763,-0.33572076543541046,1.1327215185962045,4683,4678,"West Texas, excluding El Paso",Crane,48,103,Texas,TX
48109,48CS095,18,17,18,27,9,9,10,1725.322560584128,2,365.9652333028362,13.195786214604267,13.593753145072998,13.987686418192364,0.19177500415996845,22,22,22,31,9,9,9,418.0040392666006,5,227.99817601459188,1.777718198463814,1.9023224404439978,2.0181751864634703,0.49179544634860806,2186,2193,"West Texas, excluding El Paso",Culberson,48,109,Texas,TX
48229,48CS095,18,17,18,35,17,17,18,2012.8939681916502,6,695.6521739130435,12.748081125216459,13.178936503750734,13.57964870920601,0.3267758412745182,21,21,21,39,18,18,18,551.4806962357213,5,152.71838729383018,3.8499933794360324,3.98917272355503,4.109379112366673,0.26239173855285,3450,3274,"West Texas, excluding El Paso",Hudspeth,48,229,Texas,TX
48243,48CS095,16,16,16,19,3,3,3,653.023666206164,5,991.0802775024777,-3.7706773831712965,-3.380190608289193,-2.956259250087018,1.1642787010872218,19,19,19,28,9,9,9,469.1202614216192,3,153.60983102918587,3.0357571361464126,3.1534303761252818,3.284123040841704,0.2952198385878969,2018,1953,"West Texas, excluding El Paso",Jeff Davis,48,243,Texas,TX
48301,48CS095,1,1,1,7,6,6,6,31211.24704583742,7,35000,-39.43627990927061,-37.941044398138814,-36.27369081394444,0.9665505293340442,1,1,1,5,4,4,4,7362.938580438852,5,8620.689655172415,-13.096669615735772,-12.569073835055924,-12.041927838669176,0.9486758083623417,80,58,"West Texas, excluding El Paso",Loving,48,301,Texas,TX
48371,48CS095,106,104,107,164,57,58,60,1532.26737607261,28,734.6189164370983,7.58041471478158,7.976298683258945,8.375402795919001,0.47136165628158755,130,128,132,176,44,46,48,303.2458921810575,33,218.1818181818182,0.7218869318324634,0.8508380862393348,0.9746118288604564,0.7041360775095674,15246,15125,"West Texas, excluding El Paso",Pecos,48,371,Texas,TX
48377,48CS095,37,36,38,55,17,18,19,1171.5938523329287,20,1294.4983818770227,-1.6288763703883082,-1.2405691332358713,-0.8311285608625653,1.047058745523293,46,45,46,70,24,24,25,396.96779069214665,14,228.23606129768504,1.5587098036112899,1.6883507735518333,1.809935648159139,0.5522681513100184,6180,6134,"West Texas, excluding El Paso",Presidio,48,377,Texas,TX
48389,48CS095,97,96,99,128,29,31,32,819.8930742592481,28,752.5364509843446,0.2782412697837565,0.666525503260788,1.0629741455804345,0.8887147696200375,118,116,120,158,38,40,42,273.2246522239432,32,220.35532295827022,0.4028621050225116,0.5271895556440318,0.6482629722000688,0.7866721223159446,14883,14522,"West Texas, excluding El Paso",Reeves,48,389,Texas,TX
48461,48CS095,25,25,25,34,9,9,9,1057.616881163069,5,598.0861244019138,4.208508717347087,4.589756030169626,4.981637279455166,0.5080434905271413,31,30,31,32,1,1,2,45.54074592873366,5,152.90519877675843,-1.1960641201839128,-1.0762461438806183,-0.9526061892799457,2.0086916958481975,3344,3270,"West Texas, excluding El Paso",Upton,48,461,Texas,TX
48475,48CS095,101,100,102,115,13,14,15,483.93109660666846,13,446.1221688400824,-0.025785018300390206,0.386906282028332,0.8041239478753998,0.8608272647087518,121,119,122,122,-0,1,3,12.479344868907328,24,213.12494449871235,-2.132659019833538,-2.001183581540133,-1.8806505082155658,9.977969368336067,11656,11261,"West Texas, excluding El Paso",Ward,48,475,Texas,TX
48495,48CS095,61,61,62,75,13,14,14,707.0685376160296,15,774.593338497289,-1.044823237801006,-0.6749655407031951,-0.2795752530984912,1.0209372288462457,73,72,74,88,14,15,16,198.42950896656595,17,227.7599142550911,-0.42065697874509766,-0.28984343023451914,-0.1616554222496325,1.0752158691635612,7746,7464,"West Texas, excluding El Paso",Winkler,48,495,Texas,TX
48491,48CS096,2781,2515,3046,3106,60,325,591,211.73206959524447,256,166.57475774271683,-1.2697912143839434,0.48029281955009195,2.30761681367729,0.7843139613916571,3594,3264,3924,4068,144,474,804,74.13309796150854,564,88.26594968840868,-0.6196698184622771,-0.1384076405014317,0.34597106360206076,1.1881333620910028,614739,638978,Williamson,Williamson,48,491,Texas,TX
48497,48CS097,552,523,582,665,83,113,142,649.6359067549545,78,450.1514932910114,0.21586981260162869,2.03990027789445,3.7727510922814513,0.686827327934203,698,661,734,833,99,135,172,189.94148207114927,153,214.58926492657682,-0.7724900900491741,-0.23163461473023123,0.26574493241156105,1.1214840049693193,69310,71299,Wise,Wise,48,497,Texas,TX
49001,49CS001,55,54,55,43,-12,-12,-11,-658.6927899747709,5,283.9698991906858,-9.835456161045908,-9.42470047498325,-9.006397238524812,-0.4717900989474017,69,68,69,90,21,21,22,296.93054687484874,13,179.95570321151718,1.040628838685067,1.1651126625713952,1.2996825304003188,0.5790578119331858,7043,7224,Beaver+Iron+Millard,Beaver,49,1,Utah,UT
49021,49CS001,307,282,332,337,5,30,55,207.9206889522796,16,111.1226863909435,-0.7910135685083005,0.9133554022144798,2.587530069788974,0.5171723791725232,393,362,424,447,23,54,85,89.55061706210469,65,108.1548777849881,-0.7314121154038934,-0.18208601296020527,0.32679498266479823,1.1857197311916179,57594,60099,Beaver+Iron+Millard,Iron,49,21,Utah,UT
49027,49CS001,90,88,91,111,20,21,23,653.9102865352139,7,214.67453806639577,3.9663703707886153,4.3876440728089845,4.807014822029146,0.313586638344522,111,109,112,154,42,43,45,329.48498589153047,31,235.88494901841426,0.8188376088702641,0.9370285849350142,1.0497192945743352,0.6997597839308275,13043,13142,Beaver+Iron+Millard,Millard,49,27,Utah,UT
49003,49CS002,357,332,382,417,35,60,85,414.6778354100164,29,200.66079676174988,0.2676992788638627,2.108685279829311,3.826008470460479,0.4759538476615265,452,421,483,511,28,59,90,99.30040815577097,77,129.56855354378408,-0.8266888747914876,-0.29774314983895295,0.22241387614792127,1.283071446501183,57809,59428,Box Elder+Cache+Rich,Box Elder,49,3,Utah,UT
49005,49CS002,525,468,582,529,-53,4,61,11.984432308583356,31,93.11336552252367,-2.6117853272519964,-0.8328542095848374,0.8807820771140459,6.212490725238089,675,604,745,732,-13,57,128,41.84001205987287,60,43.843624406284256,-0.5355984684655629,-0.01444788410277896,0.502228048634812,1.0299004738674435,133171,136850,Box Elder+Cache+Rich,Cache,49,5,Utah,UT
49033,49CS002,15,15,15,11,-4,-4,-4,-642.0316284808198,5,797.4481658692184,-14.792561281350237,-14.412727471047555,-13.980290774200387,-1.6525984756247178,19,19,19,20,1,1,1,39.06660110386055,2,77.42934572202864,-0.5022710711077646,-0.38353524316950477,-0.26234977534885234,0.9954754116909277,2508,2583,Box Elder+Cache+Rich,Rich,49,33,Utah,UT
49007,49CS003,191,182,199,220,21,29,38,575.6764301788272,6,117.3192550227306,2.8809501736693752,4.587359135685059,6.319296226202423,0.19709914840764062,233,222,243,292,49,59,70,291.8453783417838,30,147.15981555969785,0.8962351014049602,1.4331255784335266,1.8947944716494578,0.4959038439295483,20457,20386,Carbon+Daggett+Duchesne+Uintah,Carbon,49,7,Utah,UT
49009,49CS003,10,10,10,3,-7,-7,-7,-2840.488248945105,3,1255.2301255230125,-41.354766799889155,-40.9487113519751,-40.54202789443301,-0.5182450846720585,12,12,12,5,-7,-7,-7,-741.1598313035541,5,514.40329218107,-12.691192140405384,-12.551697299794398,-12.432178597359233,-0.8059221012495476,956,972,Carbon+Daggett+Duchesne+Uintah,Daggett,49,9,Utah,UT
49013,49CS003,135,127,144,137,-7,2,10,32.52594492922392,1,20.360378703043878,-1.7581648835204364,0.08747876750938831,1.804614923139548,0.38498381631922124,168,158,178,194,16,26,36,131.74527297882466,16,80.97165991902834,-0.021427408462535828,0.5224602589618188,1.0348391228037583,0.5918721320613168,19646,19760,Carbon+Daggett+Duchesne+Uintah,Duchesne,49,13,Utah,UT
49047,49CS003,213,198,228,254,26,41,56,458.3998585103554,15,168.03898504453034,1.1776898527479656,2.9160050517061533,4.618700733492463,0.35783242262901177,267,248,285,340,55,73,92,202.8680749899476,43,119.05091503087019,0.3118773654994413,0.8416873803315653,1.3790538565488322,0.5789380713546134,35706,36119,Carbon+Daggett+Duchesne+Uintah,Uintah,49,47,Utah,UT
49011,49CS004,1636,1480,1792,1840,48,204,360,225.12077700500305,92,101.46322096097802,-0.5265616008016654,1.2818446315157652,3.0132599805014797,0.44850848395890663,2061,1872,2250,2338,88,277,466,75.57231656892333,212,57.807881504750064,-0.33587952784792485,0.18188072898102078,0.7097140775962484,0.762184522659536,362693,366732,Davis,Davis,49,11,Utah,UT
49023,49CS005,67,66,68,72,4,5,6,165.70973269588168,7,235.61090541905082,-1.0833712322953117,-0.6983840776715368,-0.2954748252040121,1.1817864108084435,84,83,86,85,-1,1,2,5.464154638534581,3,24.779053440158588,-0.3236203906857512,-0.191234146360526,-0.06555297283495487,1.8055482307860968,11884,12107,Juab+Sanpete+Tooele,Juab,49,23,Utah,UT
49039,49CS005,161,149,174,208,34,47,59,643.5908441941772,14,193.55730678833126,2.8578789732680625,4.5369635108108755,6.195803849626243,0.2944211868869764,201,186,216,282,66,81,96,278.17941122988276,32,110.27258003377099,1.1285000842855342,1.6632530863997428,2.205311376183727,0.3915576099997728,28932,29019,Juab+Sanpete+Tooele,Sanpete,49,39,Utah,UT
49045,49CS005,351,319,382,352,-30,1,33,7.652278307600123,20,108.90280424720937,-2.657032172744242,-0.9942661640273726,0.676030368837887,8.314829680462639,451,412,490,526,36,75,114,98.48421975984577,64,84.0446487196323,-0.36570799865926235,0.16144377826874132,0.6522424471120889,0.8421525417442827,73460,76150,Juab+Sanpete+Tooele,Tooele,49,45,Utah,UT
49029,49CS006,59,57,60,72,12,13,15,431.02751651445317,8,258.5023022861297,1.2932713991106841,1.7379136946247191,2.1068550990424617,0.5579102441272501,74,72,75,65,-10,-9,-7,-69.08995743349405,2,15.850372483753368,-0.9855559687338697,-0.8491967781934402,-0.7307046647837533,-0.25914218552534474,12379,12618,Morgan+Summit+Wasatch,Morgan,49,29,Utah,UT
49043,49CS006,143,124,161,147,-14,4,23,41.1204584832111,5,47.09760979630284,-1.6236455447121132,-0.051698800825494155,1.5834491212941506,0.9318881682178886,181,159,203,207,4,26,48,59.87846060810252,13,30.232558139534884,-0.24426118661729887,0.2974517667388214,0.8216680488929192,0.4860224057121151,42465,43000,Morgan+Summit+Wasatch,Summit,49,43,Utah,UT
49051,49CS006,138,135,142,166,24,28,31,318.6040398741709,16,182.6953269960892,0.9339498079618713,1.3479177874073687,1.7257221240888798,0.5535844622946905,175,171,180,173,-7,-2,2,-6.862979567779383,12,33.326853111894906,-0.5270238459863337,-0.4022196246278847,-0.2716639969437505,-8.156867142933548,35031,36007,Morgan+Summit+Wasatch,Wasatch,49,51,Utah,UT
49035,49CS007,5972,5463,6482,6695,213,723,1232,244.4644520748437,576,194.8870898299221,-1.0656681543695352,0.5330209409189263,2.2461412525567654,0.7960982948213278,7437,6825,8050,7949,-101,512,1124,43.119378052912836,623,52.51206597470992,-0.58624914118333,-0.10128137447957739,0.4391732444663546,1.2154539074976605,1182223,1186394,Salt Lake,Salt Lake,49,35,Utah,UT
49049,49CS008,2406,2120,2691,2649,-42,243,529,147.07046387524827,223,134.86278618654305,-1.6047643847008526,0.09491194814089589,1.91335457587608,0.9132390478129271,3108,2756,3460,3248,-212,140,492,20.516507964912076,389,57.054771113565394,-0.8904794482184761,-0.38267480516128755,0.1845627507616165,2.7611807926546477,661413,681801,Utah (county),Utah (county),49,49,Utah,UT
49053,49CS009,1283,1204,1361,1478,117,195,274,428.5552105025247,111,243.53854930010093,0.20439199857140142,1.7936412014928047,3.5306656267309147,0.5653835693486562,1642,1543,1740,1889,149,247,346,130.34415381807878,249,131.14305126165937,-0.5189558471702305,-0.02255862589100757,0.49966251209961693,1.002080054945431,182312,189869,Washington,Washington,49,53,Utah,UT
49015,49CS010,84,83,85,96,11,12,13,477.0585668030513,7,283.3147829606395,1.5382278744565925,1.946978272757512,2.3363634183117274,0.5474342152011054,104,103,106,127,21,23,24,227.67312616585943,20,201.0454362685967,0.1373027634460081,0.26397494418949996,0.38819650873366274,0.845704489202756,9883,9948,Wayne and Nearby Counties,Emery,49,15,Utah,UT
49017,49CS010,43,42,43,51,8,8,9,644.3393701296674,4,314.8986419996064,2.8985139263366526,3.296712594397921,3.7528077888640365,0.43550588697577086,53,53,54,61,7,8,8,153.13890288677575,3,58.559437829396835,0.8226119352207623,0.9502391552423969,1.074007834971714,0.3391629415345591,5081,5123,Wayne and Nearby Counties,Garfield,49,17,Utah,UT
49019,49CS010,76,75,77,61,-16,-15,-14,-622.0177770059207,4,165.06757453832662,-8.237576868945455,-7.8821905214167876,-7.478788691716929,-0.28423129308058315,93,92,95,85,-10,-8,-7,-87.79046586200093,7,72.41878750258638,-1.7268925007511842,-1.603568545614926,-1.4750035958187315,-0.9351004949487365,9693,9666,Wayne and Nearby Counties,Grand,49,19,Utah,UT
49025,49CS010,67,67,68,57,-11,-10,-10,-535.2900324657396,4,206.85197155785391,-7.824352838277536,-7.415700099084046,-7.059817865019933,-0.4277539143279082,85,84,86,109,23,24,25,300.2758339897042,13,163.62492133417243,1.2422266001791957,1.3709247862102916,1.493202032349413,0.5229932996318323,7735,7945,Wayne and Nearby Counties,Kane,49,25,Utah,UT
49031,49CS010,15,15,16,15,-1,-0,0,-83.65254883284021,1,276.43400138217,-5.350343070332486,-3.6805525143378484,-1.9445901065935023,1.4339242584108802,19,18,20,23,3,4,5,255.59599092605168,2,135.13513513513513,0.704646953477561,1.2001319719479557,1.706520766194661,0.4181632847622061,1447,1480,Wayne and Nearby Counties,Piute,49,31,Utah,UT
49037,49CS010,99,97,100,147,47,48,50,1324.6061444471543,43,1176.1487964989058,1.045966553641124,1.490378091223009,1.9180869524951087,0.8699592827158626,121,119,122,160,38,39,41,271.46720462524513,27,186.28397957775633,0.7329159106504758,0.8483679955651651,0.9781721098353305,0.6692037479770635,14624,14494,Wayne and Nearby Counties,San Juan,49,37,Utah,UT
49041,49CS010,182,172,191,198,7,16,26,301.7537347986159,2,37.04218178450711,0.837976674231103,2.6635431543624826,4.40530868408347,0.11565748792338856,227,216,238,230,-8,3,14,13.764599381453998,14,64.0614990390775,-1.0052982994738904,-0.5081093543885875,0.006800672841608648,3.4929132729497554,21597,21854,Wayne and Nearby Counties,Sevier,49,41,Utah,UT
49055,49CS010,21,20,21,33,12,12,13,1961.879002785032,2,315.8310303987367,16.074348583310897,16.459036520258394,16.871933557011975,0.14899134218869647,26,25,26,33,7,7,8,294.1255792066137,1,39.23107100823852,2.4289452750185623,2.5486260061043198,2.6770152569941925,0.11768498088444806,2533,2549,Wayne and Nearby Counties,Wayne,49,55,Utah,UT
49057,49CS011,1592,1479,1705,1773,68,181,294,275.4495086289035,110,167.42133099958144,-0.7170536320945744,1.0783742238763234,2.7364086117562576,0.6044712848417864,1987,1850,2125,2141,16,154,291,57.66886819227862,213,79.94055125202667,-0.7161627953312824,-0.22166443762913654,0.26937633177704595,1.3772363885099617,262810,266448,Weber,Weber,49,57,Utah,UT
50001,50CS001,272,256,288,287,-1,15,31,162.86995207635445,3,32.219089810712845,-0.3788651402419186,1.3072283301386185,2.995929746352238,0.18558352059172367,334,315,353,370,17,36,55,96.0964978042026,7,18.784382128002147,0.28839244029692007,0.7744643358432421,1.2763331044357666,0.19016385652667955,37245,37265,Addison+Chittenden,Addison,50,1,Vermont,VT
50007,50CS001,1011,938,1083,1048,-35,37,110,89.25884637780021,62,147.87254340774663,-2.310480814528644,-0.6108385111465089,1.1629297140847377,1.6135559894083071,1254,1167,1342,1318,-24,64,151,37.63767371980447,42,24.884317547591255,-0.3776790534483406,0.13816370556685426,0.6433375829083151,0.6509080577684833,167712,168781,Addison+Chittenden,Chittenden,50,7,Vermont,VT
50003,50CS002,407,391,423,399,-24,-8,8,-83.006940666523107,2,21.608773161903734,-2.6655559494176133,-1.1093995509854948,0.6209474725038545,-0.29927989993669724,498,479,518,547,29,49,68,130.15977441555762,25,67.01334905913258,0.06989368987610678,0.6435170630278637,1.1466225291597891,0.5044654734501482,37022,37306,Bennington+Windham,Bennington,50,3,Vermont,VT
50025,50CS002,414,394,434,390,-44,-24,-4,-212.32306540329137,6,52.93105729786953,-4.428375493452645,-2.6599232364019847,-0.952873140243997,-0.26010191311055164,512,488,536,536,0,24,48,51.741440505217355,24,52.11273722152256,-0.512624006469384,-0.00605532706138819,0.5037013472137144,0.9666115063126052,45342,46054,Bennington+Windham,Windham,50,25,Vermont,VT
50005,50CS003,271,258,284,268,-16,-3,10,-45.75681993049462,2,26.52519893899204,-2.405045400157089,-0.6622154815441867,0.9775647820344535,-0.8163051325028425,336,320,351,387,36,51,67,169.50002270458936,14,46.09660531428007,0.7113073102987214,1.2370540342613705,1.7345287045378406,0.266774128897643,30160,30371,Caledonia+Essex+Orange,Caledonia,50,5,Vermont,VT
50009,50CS003,61,61,62,68,6,7,7,461.0604602127785,5,336.3605785401951,0.8724383588189922,1.2440931378884736,1.6527425160118319,0.6366455408394244,75,74,76,87,11,12,13,206.2348049937297,6,101.30001688333614,0.9174418551631405,1.0483267509916578,1.1767732201072663,0.45401963446504773,5946,5923,Caledonia+Essex+Orange,Essex,50,9,Vermont,VT
50017,50CS003,241,229,254,240,-14,-1,11,-19.521199407585016,7,95.81494028676042,-2.901510247100179,-1.1794570941275746,0.5151494891831006,-16.425369166166973,300,284,315,295,-20,-5,11,-15.79410783142174,3,10.169491525423728,-0.7923537261424795,-0.24219489304756123,0.26444688836019975,-0.8198374851399673,29223,29500,Caledonia+Essex+Orange,Orange,50,17,Vermont,VT
50011,50CS004,380,359,402,404,2,24,45,188.99133002057866,25,200.23627880899463,-1.7945201442363747,-0.11740065820645043,1.6158192511476996,1.0164237807423508,470,444,496,481,-15,11,37,21.010740089772444,24,47.735545080255385,-0.7691833071157214,-0.2818340884949933,0.25106575770470246,2.075483646106633,49941,50277,Franklin+Grand Isle,Franklin,50,11,Vermont,VT
50013,50CS004,53,52,54,57,3,4,5,207.23530874683863,4,219.6896883152547,-0.5105558820922004,-0.12071137876460783,0.2722596163819055,0.8380057594462438,66,65,67,95,28,29,30,388.1569455857015,5,67.56756756756756,3.081235558227443,3.2061684818209657,3.331364140916106,0.1682164222858071,7283,7400,Franklin+Grand Isle,Grand Isle,50,13,Vermont,VT
50015,50CS005,181,170,192,214,22,33,44,510.48572741028613,5,77.32755954222085,2.662026251588897,4.3003326243780915,6.0448178098726615,0.1470241987496483,223,210,237,246,9,23,36,86.54362682203853,6,22.99291051925656,0.11703349076995222,0.6468240281802932,1.1108404375642857,0.2544145221400487,25864,26095,Lamoille+Orleans,Lamoille,50,15,Vermont,VT
50019,50CS005,275,263,287,277,-10,2,14,26.137268488583576,4,58.578018598520906,-1.9574894332188277,-0.30957979373586964,1.3183629705536313,1.4363774326337828,337,323,351,428,77,91,105,329.9683243386861,24,87.21564067156044,1.8837266010918958,2.420002652854888,2.937269287241439,0.2614359619905997,27314,27518,Lamoille+Orleans,Orleans,50,19,Vermont,VT
50021,50CS006,612,586,638,650,12,38,64,250.27893895169635,2,13.304728167772621,0.7818247860085046,2.3211758100475786,3.9919594506340585,0.05178321212939179,754,722,785,803,18,49,81,81.39036268770661,34,56.132472635419596,-0.25682582715945373,0.24539830495853257,0.7508781337190992,0.6759583559851712,60129,60571,Rutland,Rutland,50,21,Vermont,VT
50023,50CS007,472,446,498,536,38,64,90,430.10144229311544,2,13.426648540691138,2.3258347089044737,4.140456636202838,5.819266135020917,0.030737625118130014,582,551,613,610,-3,28,59,46.091073476803615,20,33.36837012196139,-0.3855315455020084,0.13901623125533152,0.6030100404266332,0.6986751478409268,59583,59937,Washington,Washington,50,23,Vermont,VT
50027,50CS008,522,497,547,554,7,32,57,223.57462137302895,6,41.83881596150829,-0.09738985127780411,1.805859762887356,3.5506285303214793,0.181475701344502,645,615,675,675,0,30,60,52.25463192488372,27,46.45241208450898,-0.43943717146276406,0.06706337590250529,0.5718333664686035,0.8606268313810912,57363,58124,Windsor,Windsor,50,27,Vermont,VT
51001,51CS001,375,361,390,423,33,48,62,575.1642529534697,32,385.6815716524045,0.06983863078914335,1.8517524111143555,3.682831146402726,0.6567958721453618,459,441,476,555,79,96,114,289.86757474159396,50,150.32620787108024,0.8536166361337523,1.4027265001182432,1.8815445146893814,0.5132792842938066,33188,33261,Accomack+Northampton+Virginia Beach (city),Accomack,51,1,Virginia,VA
51131,51CS001,162,157,167,194,27,32,37,1052.2156088592458,23,756.9524436399539,1.2272406744456716,2.9374399099010042,4.790989367948903,0.6975706376877463,196,190,203,213,10,17,23,138.2850370884091,20,165.20733520568314,-0.8060629335169407,-0.266878261402194,0.20237600545422027,1.1273457294932165,12154,12106,Accomack+Northampton+Virginia Beach (city),Northampton,51,131,Virginia,VA
51810,51CS001,2761,2564,2958,3056,98,295,492,257.9189615488901,163,142.3764196697828,-0.5335691064807503,1.1320223136865706,2.8443010755293314,0.5501568036006961,3421,3184,3657,4058,401,637,874,139.19914871268728,403,88.00663871418588,-0.009261526178871627,0.5072810779643026,1.034706262743969,0.6312451548380783,457941,457920,Accomack+Northampton+Virginia Beach (city),Virginia Beach (city),51,810,Virginia,VA
51003,51CS002,746,697,794,852,58,106,155,378.6188303744233,46,163.9680262348842,0.48916234421113824,2.1800650374333985,3.9140219818366035,0.4290297447113303,925,866,983,1023,40,98,157,86.5679797134438,73,64.38354956210367,-0.30409585258770966,0.21489857623868988,0.7285259936136781,0.7362331527884517,112217,113383,Albemarle+Charlottesville (city),Albemarle,51,3,Virginia,VA
51540,51CS002,242,222,262,259,-3,17,37,147.02169984881695,26,223.80030126963632,-2.482582546704118,-0.8060827933418051,0.8404038574659577,1.4380335327767255,295,272,319,329,10,34,57,73.34050848777906,23,50.23808483683544,-0.30466852082606305,0.23224538371606127,0.7707411744156055,0.6651868361961419,46470,45782,Albemarle+Charlottesville (city),Charlottesville (city),51,540,Virginia,VA
51510,51CS003,629,560,697,705,8,76,145,192.70619637657055,87,219.37427899617356,-1.9139673960988022,-0.28980958266932083,1.4016435548157054,1.1236839560093057,774,693,854,798,-56,24,105,15.709587194985325,58,37.336011226552344,-0.7460017666702429,-0.22283078566119283,0.30303712407433064,2.2830856714312384,158633,155346,Alexandria (city),Alexandria (city),51,510,Virginia,VA
51005,51CS004,182,175,188,211,23,29,36,780.0497303320316,25,662.0762711864406,-0.6454342306093541,1.2038782706737141,2.9286947591369006,0.8208919545938449,220,213,228,318,90,98,105,649.700308067799,49,326.40554223288035,2.747000662393519,3.2303404572519607,3.6984676790576296,0.4972952706620802,15104,15012,Alleghany and Nearby Counties and Independent Cities,Alleghany,51,5,Virginia,VA
51017,51CS004,55,55,56,65,9,10,10,911.0675740001042,1,95.60229445506693,7.7364207916692695,8.151294245541747,8.54898020573118,0.09496886462070983,67,67,68,77,9,10,10,238.25955307208426,12,290.838584585555,-0.6546798866983189,-0.5260155899761733,-0.4003567711770249,1.1079729664745535,4184,4126,Alleghany and Nearby Counties and Independent Cities,Bath,51,17,Virginia,VA
51023,51CS004,308,293,322,321,-1,13,28,160.25329143597352,20,237.92529145848204,-2.501391510922572,-0.7878180175536655,0.8725154926141812,1.3820848393369356,380,363,398,484,86,104,121,306.2326918087813,56,165.5384433474238,0.9077643435572484,1.3934797603045723,1.9364876893054204,0.5353961007404019,33624,33829,Alleghany and Nearby Counties and Independent Cities,Botetourt,51,23,Virginia,VA
51091,51CS004,25,25,26,25,-1,-0,-0,-58.04839490169656,3,539.0835579514825,-6.375513606656824,-5.963360892820823,-5.57885931425285,4.431571992464986,31,31,31,33,2,2,2,82.7416669018507,7,314.3242029636282,-2.4496760872408245,-2.3130939543253306,-2.1909251401120056,2.4624849893285394,2226,2227,Alleghany and Nearby Counties and Independent Cities,Highland,51,91,Virginia,VA
51580,51CS004,97,96,97,88,-9,-9,-8,-623.2585648414006,4,280.4065895548546,-9.453890612184656,-9.031614242428148,-8.633739811001462,-0.5069205151517218,119,118,120,117,-3,-2,-1,-34.22515331303867,25,437.2158097236796,-4.831949916427808,-4.718335231101304,-4.586553951519549,-26.12345849574547,5706,5718,Alleghany and Nearby Counties and Independent Cities,Covington (city),51,580,Virginia,VA
51007,51CS005,144,138,150,156,6,12,18,368.17022950612676,3,90.76469253460404,1.0995391292207624,2.798134729125932,4.401544479027406,0.2278086555785439,177,170,184,224,40,47,54,353.7036852795803,29,218.6204297022239,0.8386576267364813,1.3526290266672454,1.904721671909801,0.605190524815058,13221,13265,Amelia+Brunswick+Lunenburg+Nottoway,Amelia,51,7,Virginia,VA
51025,51CS005,180,173,187,193,6,13,20,322.85797601504856,13,327.5796900592163,-1.8033719686782521,-0.07712420538675964,1.7336573953610974,0.9411683771767995,222,214,230,275,45,53,61,332.9236309965179,27,169.59798994974872,1.053575355857614,1.634752991262877,2.1424219149151074,0.4999866479987313,15874,15920,Amelia+Brunswick+Lunenburg+Nottoway,Brunswick,51,25,Virginia,VA
51111,51CS005,134,129,139,136,-3,2,7,59.326810958884145,2,66.8002672010688,-1.832593809055968,-0.07306834676044438,1.5797135548508086,0.7203975879768564,164,158,170,177,7,13,19,106.31722634673088,18,150.9180850171879,-0.9685941332809375,-0.4405888865039279,0.11114015511497989,1.3157456552782913,11976,11927,Amelia+Brunswick+Lunenburg+Nottoway,Lunenburg,51,111,Virginia,VA
51135,51CS005,180,173,186,184,-2,4,11,108.54071799573653,21,540.1234567901234,-6.087686079874214,-4.332707709584525,-2.5204098189911788,4.022939863877027,221,213,229,262,33,41,49,264.1574557244526,29,185.93319228056677,0.2585618793668428,0.7762811028909564,1.2995102626214006,0.6871933961327793,15552,15597,Amelia+Brunswick+Lunenburg+Nottoway,Nottoway,51,135,Virginia,VA
51009,51CS006,294,280,307,324,17,30,44,387.6087785654216,18,229.85570169837825,-0.11926584805227823,1.5777493167635686,3.3498497562523,0.5740959588641067,360,344,376,478,102,118,134,376.8794250563346,49,156.69470116081993,1.7045095839076567,2.222372355841805,2.775580329591762,0.4122706381410036,31324,31271,Amherst+Lynchburg (city)+Nelson,Amherst,51,9,Virginia,VA
51125,51CS006,166,159,172,186,14,20,27,551.1086180622602,4,108.41577449518904,2.863388676472248,4.443325213352164,6.1277071653267585,0.18750158969056396,203,195,211,206,-5,3,11,20.092878837989122,24,162.35962657285887,-1.9903044946143282,-1.4326289208881826,-0.8768193839452689,6.045143088604479,14758,14782,Amherst+Lynchburg (city)+Nelson,Nelson,51,125,Virginia,VA
51680,51CS006,674,640,708,779,71,105,139,527.7425372318613,56,282.4502559705445,0.6249327560274268,2.412668864947641,4.215473326850924,0.5301379940066229,828,787,869,976,107,148,189,187.1824023713475,116,146.8558913266404,-0.12832113843716686,0.4229130753681836,0.920603944453375,0.7792896634237436,79306,78989,Amherst+Lynchburg (city)+Nelson,Lynchburg (city),51,680,Virginia,VA
51011,51CS007,165,158,172,156,-16,-9,-2,-231.7129975550764,3,74.4324525493115,-4.881650714480458,-3.061026550535065,-1.4162016555585557,-0.35974706760175823,204,196,213,201,-12,-3,5,-20.867781096642283,24,147.04981312419582,-2.189158231058325,-1.6796377154120545,-1.1906169365542432,-9.975764906733591,16122,16321,Appomattox+Campbell,Appomattox,51,11,Virginia,VA
51031,51CS007,492,468,516,603,87,111,135,801.4825117824491,46,331.03051237766266,2.9515486129701776,4.685125587157497,6.3763800092506475,0.4093473220952537,602,573,631,767,136,165,194,297.1903909366883,105,189.14488498189613,0.5813256386904393,1.082454513968843,1.565337090942519,0.6326089995046367,55584,55513,Appomattox+Campbell,Campbell,51,31,Virginia,VA
51013,51CS008,779,677,882,986,104,207,309,347.36798038317187,152,255.34738583913955,-0.7787516311957525,0.869296908421545,2.6663422655474376,0.7315540008825125,965,844,1086,1017,-69,52,173,22.21523777833189,75,32.07719055134275,-0.6279287921868275,-0.09222692218394093,0.39040363668670847,1.416653470961079,238107,233811,Arlington,Arlington,51,13,Virginia,VA
51015,51CS009,602,568,635,715,80,113,147,586.1667532476788,50,258.68536099542126,1.5374910810200209,3.2629754836420695,5.06169427991142,0.4374558791239694,733,693,773,967,194,234,274,301.6031252728901,97,125.07091649904586,1.2390118626717683,1.7793727503760672,2.2800726653865384,0.41292177859906376,77314,77556,Augusta+Rockbridge and Independent Cities,Augusta,51,15,Virginia,VA
51163,51CS009,220,210,230,271,41,51,61,904.6658892308343,21,371.07390555285593,3.649980578232634,5.3824925766826865,6.981785564830331,0.40231962678956606,267,255,278,347,69,80,92,354.923199018862,63,278.3177239795017,0.2668664783348468,0.7723208497743129,1.2770831050949352,0.7745227233531758,22637,22636,Augusta+Rockbridge and Independent Cities,Rockbridge,51,163,Virginia,VA
51530,51CS009,69,68,69,89,20,20,21,1235.4066374769095,10,606.2443164595333,5.874569719009778,6.29405222219949,6.728699538065772,0.467769894490131,84,83,85,112,27,28,29,424.3580586891586,17,257.419745608722,1.5446860782934062,1.6674189269966881,1.792193027259735,0.585709927821216,6598,6604,Augusta+Rockbridge and Independent Cities,Buena Vista (city),51,530,Virginia,VA
51678,51CS009,74,73,75,67,-8,-7,-6,-375.2430405420247,1,54.65974309920743,-4.671131717233173,-4.305328536861665,-3.916970552444332,-0.17050090736232804,92,91,93,72,-21,-20,-19,-265.87312535761896,14,188.2985877605918,-4.662170824316698,-4.542546015596204,-4.412439930115691,-0.7459637948990907,7318,7435,Augusta+Rockbridge and Independent Cities,Lexington (city),51,678,Virginia,VA
51790,51CS009,330,319,341,345,4,15,26,236.50903747290613,36,561.2503410375335,-4.915988520364701,-3.2278176437029606,-1.5559116255571648,2.226306403843439,399,385,412,423,11,24,38,95.09839077382314,43,167.4389626572174,-1.2321885682737954,-0.6932331254310896,-0.1834074144809792,1.691433865009866,25657,25681,Augusta+Rockbridge and Independent Cities,Staunton (city),51,790,Virginia,VA
51820,51CS009,236,227,246,225,-21,-11,-2,-200.1652368634268,15,268.7329242621042,-6.359070419536789,-4.682786257877292,-2.936456268519311,-1.4745314346837144,289,277,300,317,17,28,40,126.49545140466839,28,124.38916037316748,-0.5134401339705463,0.028223096739195076,0.5425345501498526,0.9499857568082009,22327,22510,Augusta+Rockbridge and Independent Cities,Waynesboro (city),51,820,Virginia,VA
51019,51CS010,704,670,738,817,79,113,147,569.2659035628585,42,211.164041780314,1.8190322077212404,3.5611248316238773,5.345587519058789,0.36769351922385896,869,827,910,1067,157,198,240,247.8827642498508,126,157.42128935532233,0.35540164146884246,0.8858534558723162,1.4038465725786884,0.63187868747871,79559,80040,Bedford (county)+Bedford (city),Bedford (county),51,19,Virginia,VA
51021,51CS011,69,69,70,80,10,11,11,679.9731133436651,6,384.24591738712775,2.5446857916187455,2.952099759173472,3.316664068713113,0.5164497791193673,84,83,85,98,13,14,15,223.55499547833656,7,113.1953428201811,0.976556352131211,1.1071477180974558,1.2223609021854103,0.47218681636846094,6246,6184,Bland+Smyth+Wythe,Bland,51,21,Virginia,VA
51173,51CS011,376,363,388,441,53,65,78,878.0641190526549,46,618.0718844474303,0.8010238529246527,2.6342817497196505,4.365420607726307,0.693293956819723,456,440,471,604,133,148,164,503.04265397203955,77,260.8931354611371,1.9286782855903906,2.417148768462758,2.999882034825708,0.5151604050266276,29770,29514,Bland+Smyth+Wythe,Smyth,51,173,Virginia,VA
51197,51CS011,344,332,356,398,42,54,66,761.1046556190643,39,550.9641873278237,0.4395209765965962,2.121995484225104,3.8965288516123207,0.710708830662727,419,405,434,505,71,86,100,304.1486234665817,75,266.0329171396141,-0.12161197230814257,0.38851315942876635,0.9182874496311308,0.8645973669495495,28314,28192,Bland+Smyth+Wythe,Wythe,51,197,Virginia,VA
51191,51CS012,540,517,563,687,124,147,170,1094.6627985109812,65,483.0917874396135,4.46456399520098,6.179842223819187,7.81416476202112,0.4383395226994356,651,624,679,888,209,237,264,441.08032674768424,111,206.83872169943166,1.7923489912978439,2.3368475140620095,2.855233982240107,0.4669638684306751,53820,53665,Bristol (city)+Washington,Washington,51,191,Virginia,VA
51520,51CS012,232,225,240,249,9,17,24,390.7579561160582,20,464.9811101424005,-2.5076247282694677,-0.7440885863057675,1.0289192979772717,1.1231237565744852,278,269,287,306,19,28,37,162.35757120059637,38,222.43034418169046,-1.1034948028444544,-0.6068993694886601,-0.07119857178666897,1.3223293509258705,17205,17084,Bristol (city)+Washington,Bristol (city),51,520,Virginia,VA
51027,51CS013,254,246,263,333,70,79,87,1548.8271811746715,29,571.625683733307,7.971919098452832,9.735775656349283,11.35461143209449,0.364432059481819,306,295,316,395,79,89,100,449.3633643280523,64,322.0287813223307,0.7927867814681784,1.2598108021577774,1.7486405079205147,0.7086977980391664,20293,19874,Buchanan+Dickenson+Russell+Tazewell,Buchanan,51,27,Virginia,VA
51051,51CS013,179,173,185,195,10,16,22,467.6835575745894,16,455.3539665599431,-1.6755657594630806,0.15627160242636345,1.8034071583571627,0.9177874139380418,215,208,222,230,8,15,22,107.51192232556188,24,173.59855334538878,-1.186087687712361,-0.6603418453158965,-0.14029570568725686,1.5129047692849749,14055,13825,Buchanan+Dickenson+Russell+Tazewell,Dickenson,51,51,Virginia,VA
51167,51CS013,296,285,307,341,34,45,56,698.2610059863537,23,355.8305936956101,1.6400725672005567,3.360011429199094,5.103226684596998,0.4985493754943244,360,346,373,463,90,103,117,404.45344944822716,59,230.6850172036284,1.2585187226495105,1.7449409978927797,2.2610584587899094,0.5649013525172337,25855,25576,Buchanan+Dickenson+Russell+Tazewell,Russell,51,167,Virginia,VA
51185,51CS013,511,493,528,609,81,98,116,974.1785541822552,31,307.2653384874616,4.9776461074179155,6.669897016971265,8.344995847304745,0.3122328573082656,619,599,640,790,150,171,191,426.6163967690023,94,235.08227879757916,1.4170892459794093,1.9245609171166154,2.3963906533601538,0.5478275848945441,40356,39986,Buchanan+Dickenson+Russell+Tazewell,Tazewell,51,185,Virginia,VA
51035,51CS014,303,290,315,394,79,91,104,1249.4165950669997,49,670.0396554081773,3.991546660216363,5.821454712338663,7.523340142760323,0.5304762066877489,369,354,384,530,146,161,176,552.6758016065735,70,240.88093599449414,2.5573803120981533,3.1242603445028494,3.6138631804418817,0.433147978317782,29252,29060,Carroll+Galax (city)+Grayson,Carroll,51,35,Virginia,VA
51077,51CS014,171,165,178,214,36,43,49,1117.6108709530258,29,755.8973022285938,1.9587801448834032,3.618731950425549,5.420856039483627,0.6609364078125668,210,202,218,282,64,72,80,470.43421282275,41,267.1009771986971,1.547311549831017,2.0265155732877913,2.558738963921404,0.5600201479644674,15346,15350,Carroll+Galax (city)+Grayson,Grayson,51,77,Virginia,VA
51640,51CS014,140,139,141,123,-18,-17,-16,-1023.5824744055112,19,1145.6135061802834,-22.06442342394861,-21.693653052604443,-21.300694622411655,-1.1892753399688607,172,171,173,173,0,1,2,19.74846282225557,24,360.0900225056264,-3.5385404836356282,-3.404173549196854,-3.290061947553482,10.361642714116696,6634,6665,Carroll+Galax (city)+Grayson,Galax (city),51,640,Virginia,VA
51036,51CS015,71,70,72,89,17,18,19,1067.681430005841,2,118.46586702206427,9.092798415160813,9.499778889884299,9.889445029567282,0.1051241077914351,86,85,86,115,29,29,30,445.3007919696873,14,211.672210462655,2.2147422417475933,2.3358116627448697,2.4605905791858884,0.45973698397224266,6753,6614,Charles City+Goochland+Henrico+New Kent,Charles City,51,36,Virginia,VA
51075,51CS015,191,180,201,207,6,16,27,263.6412788309233,12,193.7906253784973,-1.0077388723218081,0.6493295281861978,2.396582655223262,0.6926276161348229,240,227,253,277,24,37,50,145.6281973155656,33,129.96219281663517,-0.36708123327074965,0.1608687884235857,0.6560111590497061,0.86892613052533485,24769,25392,Charles City+Goochland+Henrico+New Kent,Goochland,51,75,Virginia,VA
51087,51CS015,2453,2310,2597,2929,332,476,619,569.7927825295462,275,329.3807641633729,0.721122665271518,2.3741460323521477,4.061927335582768,0.5768585404092537,3021,2849,3194,3588,394,567,739,169.8353346627623,364,109.09243485922879,0.0949724348771039,0.601304920881576,1.094385119079269,0.6412108605117876,333960,333662,Charles City+Goochland+Henrico+New Kent,Henrico,51,87,Virginia,VA
51127,51CS015,170,160,180,178,-2,8,18,140.89890840212118,12,207.2896873380549,-2.311966096872558,-0.6875615758025374,0.982151630434035,1.3105246983017824,215,202,227,245,18,30,43,127.13706846600972,20,84.10782623323101,-0.06836080499310408,0.4196952303457802,0.9233193768522915,0.640370420773326,23156,23779,Charles City+Goochland+Henrico+New Kent,New Kent,51,127,Virginia,VA
51550,51CS016,1615,1508,1723,1810,87,195,302,312.26592593852564,138,221.49016334899545,-0.8132005537794209,0.9453279687702282,2.723143892971318,0.7056727597543699,2007,1878,2137,2391,254,384,513,152.7666585895222,237,94.40839398176364,0.06961172076530887,0.6050549358519659,1.0959345795551156,0.6163835741416208,249221,251037,Chesapeake (city),Chesapeake (city),51,550,Virginia,VA
51041,51CS017,2286,2129,2443,2583,140,297,454,326.19292181026674,185,203.11702285340988,-0.34578475060175595,1.2319639494650643,2.9186302462121456,0.6206009786739303,2851,2660,3042,3334,292,483,674,130.46284860884217,362,97.85344149472483,-0.19259918394496225,0.3401887738361751,0.8622832186694398,0.7484974738647165,364322,369941,Chesterfield+Colonial Heights (city)+Powhatan,Chesterfield,51,41,Virginia,VA
51145,51CS017,195,182,208,245,37,50,63,656.1020296467875,10,131.56163662675965,3.4194688393408623,5.230565407847085,6.987476578052119,0.19657829809477706,245,229,261,315,54,70,86,226.85268526630205,30,96.67128540585827,0.7879729860193798,1.308418888633084,1.7753679820052564,0.4201728114211051,30404,31033,Chesterfield+Colonial Heights (city)+Powhatan,Powhatan,51,145,Virginia,VA
51570,51CS017,229,221,236,229,-7,0,8,10.510571991572073,13,288.2643162037807,-4.472242189270837,-2.7309925790486975,-1.0881725012220798,8.819535556582485,280,271,290,320,30,40,49,218.2890371661212,38,208.09375171129727,-0.3946559217111901,0.10584600016613828,0.5708895455175637,0.9299648130309579,18039,18261,Chesterfield+Colonial Heights (city)+Powhatan,Colonial Heights (city),51,570,Virginia,VA
51043,51CS018,145,139,152,153,1,8,14,205.70630411969742,10,270.87424663100154,-2.3934370351502054,-0.6434722072140749,1.1386478608753814,1.1635805141629654,179,171,187,185,-2,6,14,40.011433226144014,19,127.79982511602879,-1.4037821910118666,-0.8967652166089566,-0.3486682422203506,2.734403196052893,14767,14867,Clarke+Warren,Clarke,51,43,Virginia,VA
51187,51CS018,340,323,358,351,-7,11,28,107.61603290534742,29,284.89328781589995,-3.594916088560706,-1.7644278360671806,-0.01603074882475066,2.4258637165147685,419,398,440,532,92,113,134,275.40904070906026,77,188.24564834734988,0.3400078000341068,0.8722003631244527,1.366523704500592,0.6774989420204498,40717,40904,Clarke+Warren,Warren,51,187,Virginia,VA
51045,51CS019,45,45,46,55,9,10,10,787.2498657587074,7,569.8005698005699,1.808539279157581,2.166430665885427,2.5891741256273493,0.6559610941833287,55,54,56,72,16,17,18,346.92951046689564,7,143.82576535853707,1.899673332870476,2.0315544361618643,2.157664183986509,0.3913881353477099,4914,4867,Craig+Franklin (county)+Roanoke (county)+Salem (city),Craig,51,45,Virginia,VA
51067,51CS019,503,480,527,618,91,115,138,837.3342520406158,41,299.44493134677185,3.705153218687277,5.33607870253042,7.109415382012997,0.35452466841145697,618,590,646,796,150,178,206,324.3777161730077,88,160.37907782030254,1.1445431585233439,1.6561739056268052,2.1693451348314174,0.49165842026139306,54768,54870,Craig+Franklin (county)+Roanoke (county)+Salem (city),Franklin (county),51,67,Virginia,VA
51161,51CS019,888,846,929,1003,74,115,157,478.373627657221,92,381.4855128803193,-0.7046672509923595,0.8920922322792338,2.511567071194903,0.790610435610052,1086,1036,1136,1352,216,266,316,274.9559048448424,113,116.94574959120735,1.1164173759020901,1.5912210768567825,2.121290315579555,0.4237305730940481,96465,96626,Craig+Franklin (county)+Roanoke (county)+Salem (city),Roanoke (county),51,161,Virginia,VA
51775,51CS019,301,291,312,348,36,47,57,733.864210887602,25,394.47731755424064,1.700626793579343,3.3175445748523544,5.1583880317577915,0.526220024463943,367,354,381,395,14,28,41,108.49736418733706,51,201.00106412328066,-1.4081570010451843,-0.9246615462373168,-0.4311910925633217,1.7876523979009458,25350,25373,Craig+Franklin (county)+Roanoke (county)+Salem (city),Salem (city),51,775,Virginia,VA
51047,51CS020,389,366,412,406,-6,17,40,128.35059241278557,33,249.95739362608646,-3.0533752214189076,-1.1914971765716216,0.4295768911633213,1.8389353344710873,484,457,512,557,45,73,100,135.6610736647703,56,104.73554275454477,-0.2024694388829593,0.30665114256560744,0.8265958362792314,0.761539400508084,52809,53468,Culpeper+Madison+Rappahannock,Culpeper,51,47,Virginia,VA
51113,51CS020,133,131,134,121,-13,-12,-10,-343.96294014403384,7,203.53274696518136,-5.879727213228172,-5.467337139171811,-5.076123273418337,-0.6463679181027898,165,163,167,177,10,12,14,84.69599681061318,27,193.86802613628205,-1.210160827739385,-1.0906085478701097,-0.968901958199224,2.1100984545392483,13757,13927,Culpeper+Madison+Rappahannock,Madison,51,113,Virginia,VA
51157,51CS020,59,58,59,63,4,4,5,245.06363143208984,7,381.9397080889374,-1.7401568057528172,-1.3605248963206635,-0.9358408790221882,1.2747196119518764,73,72,74,96,22,23,24,315.8879756834978,1,13.526308670363857,2.899256429461521,3.0168301742425196,3.1466360685120396,0.04106169438552245,7331,7393,Culpeper+Madison+Rappahannock,Rappahannock,51,157,Virginia,VA
51143,51CS021,615,589,641,694,53,79,105,523.8079729875128,55,364.8424543946932,-0.09806632462852327,1.5724516255686294,3.304550320086422,0.687809067624704,754,723,785,895,110,141,172,235.02017770523233,105,174.93585685248743,0.08242658895261455,0.5983773934525418,1.1302892668606537,0.7391044856173974,60300,60022,Danville (city)+Pittsylvania,Pittsylvania,51,143,Virginia,VA
51590,51CS021,612,594,630,669,39,57,75,544.5446986112424,69,655.8156112629202,-2.6873270701587946,-1.0104225953969534,0.6132300063450261,1.1836774156958414,748,726,770,890,120,142,164,336.3340533077098,109,257.9820595962226,0.26526792588706904,0.7936119916425745,1.3227993340132695,0.7616811444967723,42085,42251,Danville (city)+Pittsylvania,Danville (city),51,590,Virginia,VA
51053,51CS022,229,217,241,277,36,48,60,682.2255662833751,18,256.8401526772019,2.621361703538155,4.256519955805307,5.967798841800579,0.36876122651374194,283,269,298,371,73,88,102,314.20505546867594,42,150.48369759942673,1.1058268477656992,1.64501238691294,2.1568893697025397,0.47353486378280973,28033,27910,Dinwiddie+Petersburg (city),Dinwiddie,51,53,Virginia,VA
51730,51CS022,489,475,503,522,19,33,47,401.73365445196885,38,460.3967893381796,-2.407198379993526,-0.5433247526037974,1.1878704587500768,1.1124743311605592,602,584,619,668,49,66,84,198.65663893369702,73,218.3732687187771,-0.7253983758686035,-0.1945296065345679,0.29145710260650803,1.0829426064307912,33015,33429,Dinwiddie+Petersburg (city),Petersburg (city),51,730,Virginia,VA
51059,51CS023,4547,4053,5040,5343,303,796,1290,277.4761246428283,688,239.69473760307005,-1.3377922975222423,0.39612360400677654,2.1173297180262454,0.8627558834379109,5720,5131,6309,6034,-275,314,903,27.52422614323098,423,37.0728731739638,-0.5827680297488189,-0.10359906994101074,0.3995743951048491,1.3426426638956872,1148127,1140996,Fairfax (county)+Fairfax (city)+Falls Church (city),Fairfax (county),51,59,Virginia,VA
51600,51CS023,217,207,227,217,-10,0,10,0.7562183671677647,15,249.76064604753776,-4.332683009651534,-2.43603569625667,-0.8622948925841765,14.34834708111854,269,256,281,233,-48,-36,-23,-146.52080406072,19,78.33436404864976,-2.8030358067077574,-2.247710620798299,-1.7651494186728773,-0.5501088183655939,24023,24255,Fairfax (county)+Fairfax (city)+Falls Church (city),Fairfax (city),51,600,Virginia,VA
51610,51CS023,83,82,85,84,-1,1,2,18.05841466919665,10,273.5603884557516,-2.9634824123215453,-2.5559464916413854,-2.1444058609987584,6.02364153444611,102,101,104,99,-5,-3,-2,-23.831672826287505,3,20.666850372003307,-0.5770939306215095,-0.442944424909253,-0.31083929123031,-1.219806918590147,14622,14516,Fairfax (county)+Fairfax (city)+Falls Church (city),Falls Church (city),51,610,Virginia,VA
51061,51CS024,494,463,526,524,-2,30,61,163.79077117331985,23,126.39098777304575,-1.438364100302276,0.32638289138255094,1.9369641433365068,0.7466120308019931,615,577,653,708,55,93,131,125.82303853350635,58,78.71130592913268,-0.03848982830643265,0.46980875466287436,1.0015314786877165,0.6188962530532289,72790,73687,Fauquier,Fauquier,51,61,Virginia,VA
51063,51CS025,147,140,153,198,45,51,58,1324.186619320885,12,309.059300753332,8.506010738613186,10.20674276828964,11.935238170198032,0.22894272587093825,180,172,188,213,25,33,41,212.38577684496175,15,96.44441586832123,0.6552154100180894,1.1752566686391432,1.6961156088793945,0.44075697530555413,15531,15553,Floyd+Giles+Montgomery,Floyd,51,63,Virginia,VA
51071,51CS025,198,191,205,244,39,46,53,1093.4719457736285,13,310.9118086696562,6.17529014332089,7.843600198559207,9.479427197692095,0.2782486855400976,240,231,248,300,52,60,69,362.2572332950498,31,186.85955394816153,1.2711265960478968,1.7559734818767079,2.2767215984415556,0.5073776391006274,16725,16590,Floyd+Giles+Montgomery,Giles,51,71,Virginia,VA
51121,51CS025,554,511,597,604,7,50,93,201.56001003168805,54,217.50732576756926,-1.8913143464711537,-0.08778451986218289,1.6040322209373092,1.0579771520352672,683,632,734,799,65,116,167,117.46438483512557,74,75.03244646333549,-0.0724157282739588,0.4455171328734628,0.9471004195764463,0.6333009770461379,99307,98624,Floyd+Giles+Montgomery,Montgomery,51,121,Virginia,VA
51069,51CS026,661,621,700,762,62,101,141,441.0904162766399,53,231.3501244052556,0.3950245629975905,2.1380868454171944,3.7985685559459492,0.5193562941136968,830,782,879,1026,147,196,244,209.30719664070895,132,141.27921911122527,0.15500178905021042,0.6709045143716292,1.1768265196286258,0.6715510133209832,91636,93432,Frederick+Winchester (city),Frederick,51,69,Virginia,VA
51840,51CS026,221,209,233,269,36,48,60,679.6434798884345,25,356.8242640499554,1.5431857707810341,3.238004061630169,5.1792422925692785,0.5142179059429054,274,259,288,325,37,51,66,182.87978101400947,41,145.81925525482805,-0.13105660481382667,0.38870551202389514,0.892753715560844,0.7821396237948022,28025,28117,Frederick+Winchester (city),Winchester (city),51,840,Virginia,VA
51177,51CS027,849,788,909,982,73,133,194,380.4410700928929,71,202.53742306787143,0.2146703812106906,1.7306751441223673,3.4515040376491193,0.5284131146968258,1070,996,1144,1227,83,157,231,109.5823292706889,115,80.3022156428716,-0.21549682918414453,0.2867894850071873,0.8104218538845481,0.7281626033341708,140221,143209,Fredericksburg (city)+Spotsylvania,Spotsylvania,51,177,Virginia,VA
51630,51CS027,174,162,187,202,15,28,40,390.42028924306646,1,14.175851437076938,2.0519395624056362,3.7867263102657596,5.297495049199765,0.03503704067282186,217,202,232,257,25,40,55,141.41169180839432,11,38.85141101260905,0.5194699318241943,1.043585307882546,1.5415518046916057,0.2680449551143605,28217,28313,Fredericksburg (city)+Spotsylvania,Fredericksburg (city),51,630,Virginia,VA
51079,51CS028,149,140,158,154,-4,5,14,99.56861875272345,5,97.4184120798831,-1.8491494058098363,0.011342878440434724,1.6868716262030998,0.8182824785708155,187,176,198,236,38,49,60,234.69022642690027,37,176.9234447472864,0.10621130730781955,0.5742831610121552,1.102079320074091,0.7388065754084034,20530,20913,Greene+Louisa+Orange,Greene,51,79,Virginia,VA
51109,51CS028,314,297,330,341,11,27,44,289.22169599812787,14,148.030663494581,-0.4567822917468733,1.4366409767049577,3.258902195353926,0.49377243798446346,394,374,414,492,78,98,118,252.31538308490417,41,105.97327405722557,0.9791142384132306,1.4493123278320434,1.9779614775951886,0.41574434560276713,37830,38689,Greene+Louisa+Orange,Louisa,51,109,Virginia,VA
51137,51CS028,352,336,367,379,12,27,43,299.9082821776539,12,131.29821106187427,-0.14112214590872407,1.7183681490055012,3.3539794582551283,0.42238473745407495,438,418,457,472,15,34,54,93.03213344721213,52,140.26758739749675,-0.938564215308516,-0.44321186210069347,0.06732218033408749,1.4652480149397724,36558,37072,Greene+Louisa+Orange,Orange,51,137,Virginia,VA
51083,51CS029,403,388,418,494,76,91,106,1074.2204273722648,64,755.0731477111846,1.5489616561652226,3.1853337475949046,4.941700721144633,0.6952673326823217,492,475,510,613,103,121,138,357.8846185249565,70,207.33368876251407,1.0168113779107038,1.5042098645465483,2.0270737041666007,0.5745758167669734,33904,33762,Halifax+Mecklenburg,Halifax,51,83,Virginia,VA
51117,51CS029,393,380,406,443,37,50,63,662.2229131297257,51,672.2246021023495,-1.8185392556198368,-0.0658415298627935,1.5872622235261602,0.9952929112385945,480,464,495,557,62,77,93,255.55628824764608,49,161.96205460434985,0.405226087947412,0.939971777020724,1.4797622990715895,0.6256703655235751,30347,30254,Halifax+Mecklenburg,Mecklenburg,51,117,Virginia,VA
51650,51CS030,1105,1047,1164,1250,86,145,203,422.3820592757643,73,213.30839865294286,0.3541989526346049,2.0738793429484947,3.934123106680799,0.5015432548100763,1362,1291,1433,1624,191,262,333,190.03095377541933,179,130.0342883710118,0.09718016013657839,0.5982792811641042,1.1245811842565634,0.6816736168230016,136891,137656,Hampton (city)+Poquoson (city),Hampton (city),51,650,Virginia,VA
51735,51CS030,107,105,108,110,2,3,5,108.4952259901583,4,128.67942737654818,-0.6022488563738216,-0.1982632565238246,0.22144349922205997,0.9147929591605446,132,131,134,137,3,5,6,38.357016910199704,12,95.56422712431313,-0.6907111713276027,-0.5746679101786526,-0.4491348215697452,2.063099693194044,12434,12557,Hampton (city)+Poquoson (city),Poquoson (city),51,735,Virginia,VA
51085,51CS031,842,794,889,955,66,113,161,412.2846894124865,75,273.0151796439882,-0.18041935520116142,1.4025527730559604,3.0582695606141055,0.6564050024930677,1048,991,1106,1252,146,204,261,182.86628022700125,103,92.47288659053365,0.37038287218693583,0.9139902497984472,1.390417512245089,0.5032152583062411,109884,111384,Hanover,Hanover,51,85,Virginia,VA
51165,51CS032,641,605,677,788,111,147,183,703.6042292151038,76,363.6885677369957,1.6161852454963455,3.443750289052783,5.1418106676064275,0.5134018979321132,792,749,836,1018,182,226,269,267.9831742577162,145,172.00270459425155,0.45431116705564534,0.984141230401379,1.4898313553989015,0.6390128473660445,83588,84301,Harrisonburg (city)+Rockingham,Rockingham,51,165,Virginia,VA
51660,51CS032,261,239,283,292,9,31,53,240.0379246485236,37,285.17476588693205,-2.285717285573564,-0.46185323039307247,1.2494314777533475,1.1510801918966627,322,295,348,368,20,46,73,89.91477246862081,40,77.72121400536277,-0.40602445962817063,0.12091337158875896,0.6409117865551656,0.8461035602899724,51898,51466,Harrisonburg (city)+Rockingham,Harrisonburg (city),51,660,Virginia,VA
51089,51CS033,575,553,597,732,135,157,179,1236.2000069041553,76,599.392720533144,4.7741529482343426,6.355707918962003,8.094691221891457,0.4817933467890533,697,671,723,979,256,282,308,559.7249039847111,148,294.0825815681755,2.1191976231583016,2.652264375209349,3.1753999262632413,0.5235469574346386,50718,50326,Henry+Martinsville (city)+Patrick,Henry,51,89,Virginia,VA
51141,51CS033,221,214,229,273,44,52,59,1178.2532485758911,32,728.5559792816894,2.896498090177459,4.515245691462319,6.238046418454929,0.606614045898108,270,261,279,362,83,92,101,521.8361168231188,47,267.10616049102066,2.043613198849839,2.5561334418015935,3.0737117328336914,0.5063439340439931,17569,17596,Henry+Martinsville (city)+Patrick,Patrick,51,141,Virginia,VA
51690,51CS033,277,271,282,261,-21,-16,-10,-471.4497657466705,31,933.1025660320565,-15.716828632923892,-14.123169385192726,-12.396503302352901,-2.1142024159841353,339,332,346,295,-51,-44,-37,-326.0814550042558,57,422.1284159075761,-7.922344132942601,-7.464945934014792,-6.997435537388962,-1.324633239226958,13289,13503,Henry+Martinsville (city)+Patrick,Martinsville (city),51,690,Virginia,VA
51149,51CS034,231,213,250,243,-7,12,30,110.09439343392239,12,113.33317592614453,-1.686035179317293,-0.01597003303666195,1.6674887739788078,0.9480867504983542,289,267,311,364,53,75,97,174.15092145077261,48,111.88550383440946,0.11497207438128211,0.6237729239171512,1.1336437880062769,0.6339773268766602,42353,42901,Hopewell (city)+Prince George,Prince George,51,149,Virginia,VA
51670,51CS034,269,259,279,273,-6,4,14,68.44042140320444,19,331.5881326352531,-4.2678298428498955,-2.614461231115283,-1.0570901557372328,3.860504806696014,330,319,342,426,84,96,107,413.31195646953654,62,268.22409690677046,0.9349882104655421,1.4533701197211082,1.963060786681616,0.6422404080935362,22920,23115,Hopewell (city)+Prince George,Hopewell (city),51,670,Virginia,VA
51095,51CS035,682,649,716,762,46,80,113,407.20074872924926,35,178.7173202614379,0.5914190180787975,2.351946797969755,3.9148546985349317,0.4334569593017552,846,805,887,956,69,110,151,137.8534685436864,56,70.29171059898579,0.17108005141353452,0.6725928824140998,1.1881857056702496,0.5053006885021021,78336,79668,James City +Williamsburg (city),James City,51,95,Virginia,VA
51830,51CS035,69,68,71,84,13,15,16,380.138915124836,4,103.90959864917521,2.3515826103239763,2.7742346539030294,3.156614444215279,0.25586167032871,88,86,89,84,-5,-4,-2,-22.594644964087117,3,19.26906031215878,-0.5441922542078526,-0.41552363441773676,-0.2827453188553525,-1.191535203106241,15398,15569,James City +Williamsburg (city),Williamsburg (city),51,830,Virginia,VA
51033,51CS036,250,236,263,278,15,28,42,365.6633384243439,23,297.4843174028326,-1.1028867302802872,0.6185989541154424,2.3812204710997458,0.7857536438872211,311,294,327,377,50,66,83,212.29891589963484,38,121.52222577550367,0.38806792082943825,0.8967450917665347,1.4030437260722433,0.56391643285246,30926,31270,King and Queen and Nearby Counties,Caroline,51,33,Virginia,VA
51057,51CS036,111,110,112,132,20,21,22,777.3107176526815,5,187.98759281887394,5.478494820128496,5.892361943901924,6.308871313413122,0.23068559681232698,136,135,137,183,46,47,48,443.80322918875504,18,170.19667170953102,2.614955114898666,2.7336446581683327,2.8721347774266435,0.3754957363630364,10639,10576,King and Queen and Nearby Counties,Essex,51,57,Virginia,VA
51073,51CS036,362,345,378,417,39,55,72,575.5539819747485,13,134.87575867614257,2.6526714323362617,4.402882436532616,6.10451811439003,0.23019128493640575,448,428,468,497,29,49,69,126.04759806611769,56,143.54189629097993,-0.6883336831960292,-0.17811520132568873,0.32085213489702247,1.1160947969500559,38554,39013,King and Queen and Nearby Counties,Gloucester,51,73,Virginia,VA
51097,51CS036,74,74,75,93,18,19,19,1125.7517545766927,5,300.3453972067878,7.849894642687896,8.24596926372021,8.626985052787834,0.2532805872444437,91,90,92,102,10,11,12,163.17176088574018,5,75.1653638003608,0.7470012276547222,0.8815662188385882,1.0042660900788616,0.42179194729226194,6659,6652,King and Queen and Nearby Counties,King and Queen,51,97,Virginia,VA
51101,51CS036,148,141,156,152,-4,4,11,80.93008339409516,7,157.03869882220977,-2.398494441357281,-0.7873570948092246,1.0657301037988802,1.5192757676911877,185,176,194,221,27,36,45,197.86892385147414,17,93.75689388925656,0.5322084353532368,1.0414066560262116,1.5737502430622357,0.460984529935747,17830,18132,King and Queen and Nearby Counties,King William,51,101,Virginia,VA
51115,51CS036,122,118,126,119,-7,-3,1,-143.8246502634895,10,467.07146193367583,-7.848311100206883,-6.101249635265462,-4.429032703165711,-4.809343757397589,149,144,153,178,25,29,34,344.9244294818828,15,175.58234812126886,1.1591129861773497,1.70807439656178,2.202276508979254,0.49233768282263635,8564,8543,King and Queen and Nearby Counties,Mathews,51,115,Virginia,VA
51119,51CS036,141,137,146,162,16,21,25,778.870423319732,4,150.51740357478835,4.538424241018799,6.336187432824005,7.9348856319837315,0.18434469711861035,174,169,180,212,32,38,43,351.723318354716,24,223.0897936419409,0.786611331185656,1.286943529272422,1.7985780423241704,0.6179452125717977,10630,10758,King and Queen and Nearby Counties,Middlesex,51,119,Virginia,VA
51105,51CS037,244,234,254,315,61,71,81,1274.6954706190236,33,592.3000987166831,5.15241696787953,6.852081173825778,8.46405294306088,0.45820822883264567,296,285,308,412,104,116,127,525.5987449212547,53,240.9309937267024,2.337066721775656,2.835550972611886,3.3669133775639337,0.45446277853733547,22286,21998,Lee+Norton (city)+Scott+Wise,Lee,51,105,Virginia,VA
51169,51CS037,277,267,286,302,16,25,35,468.82253311677664,37,687.1575819481845,-4.0200423001583,-2.2220943199570518,-0.5676444180384189,1.4098595281925166,337,326,348,392,44,55,66,258.0466740081653,56,261.2183972385484,-0.5438547178330158,-0.0067724535785643565,0.480437427266269,0.9943173701594815,21538,21438,Lee+Norton (city)+Scott+Wise,Scott,51,169,Virginia,VA
51195,51CS037,414,398,429,490,61,76,92,843.5912871718244,43,475.335083598176,1.9070845455830607,3.668304327793495,5.356559803421664,0.5561780091750288,501,483,520,659,139,158,176,442.1456233969223,73,204.4760650962158,1.8517637927905652,2.3757781005111047,2.8875519229275532,0.45955185419694955,36185,35701,Lee+Norton (city)+Scott+Wise,Wise,51,195,Virginia,VA
51720,51CS037,43,43,43,58,15,15,15,1609.4891446810564,3,322.40730789897907,12.442246896368653,12.879615066379774,13.293642280336906,0.18777818761949627,52,52,53,95,42,43,43,1170.8059465704748,13,354.4165757906216,8.047171434808305,8.167033604141816,8.296281544618534,0.2958232345221657,3722,3668,Lee+Norton (city)+Scott+Wise,Norton (city),51,720,Virginia,VA
51107,51CS038,1324,1142,1505,1543,38,219,401,207.93192593659612,162,153.55777729856797,-1.1787135481454656,0.5776568574611782,2.216193183524396,0.7351489584451802,1697,1477,1918,1753,-165,56,276,13.062605582589361,130,30.454664717568125,-0.71894394128806,-0.16279864793484397,0.3346574216765627,2.2903630403466995,421991,426864,Loudoun,Loudoun,51,107,Virginia,VA
51683,51CS039,222,204,241,251,10,29,47,269.3288635415311,45,423.9284032030146,-3.32644123256535,-1.5245001838592978,0.17331272154132926,1.5208221404061548,278,256,300,288,-12,10,32,22.49963393766324,27,63.21556507691228,-0.88589865446473,-0.42314820830267613,0.11359442973759905,2.544812582367904,42460,42711,Manassas (city)+Manassas Park (city),Manassas (city),51,683,Virginia,VA
51685,51CS039,37,36,39,33,-6,-4,-3,-103.19237754668009,8,185.38902728694745,-3.30338568831526,-2.8833984764340648,-2.4967270803100345,-2.3168198614589226,47,44,49,49,0,2,5,13.782395073566015,5,29.37375161555634,-0.27583436145915213,-0.1570599098377466,-0.029132598245730223,1.4943040315773157,17261,17022,Manassas (city)+Manassas Park (city),Manassas Park (city),51,685,Virginia,VA
51700,51CS040,1376,1297,1456,1599,143,223,302,481.4475207486271,94,203.37956251757936,0.9403375849128724,2.745702801257353,4.414918319939221,0.4205435908955089,1690,1594,1785,1974,189,284,380,153.8661031334521,201,108.7774175916355,-0.06501444338837994,0.4355415015415687,0.934032715887077,0.7044837170335232,184876,184781,Newport News (city),Newport News (city),51,700,Virginia,VA
51710,51CS041,1663,1561,1765,1896,131,233,335,391.25932409599386,123,206.54564994710415,0.2421880466548994,1.8634606579062871,3.574025989912327,0.5256436311882048,2030,1909,2152,2450,298,420,541,178.20829699994746,216,91.73766425713728,0.36393770930410724,0.8717697641736151,1.3650029076061532,0.5135538222998924,238204,235454,Norfolk (city),Norfolk (city),51,710,Virginia,VA
51139,51CS042,252,242,262,319,57,67,77,1130.6912700968526,36,606.5711878685763,3.5214881944713943,5.226209390437091,6.944351751255915,0.528583700403617,309,297,321,358,37,49,61,205.1309792794798,53,222.78268179907525,-0.7577800675319227,-0.18501595914205624,0.38351519857992855,1.0642429243166909,23740,23790,Page+Shenandoah,Page,51,139,Virginia,VA
51171,51CS042,431,412,450,544,94,113,132,1019.3546502701934,62,561.0225087659768,2.7174134604758615,4.575152303034946,6.419158483361921,0.5455276679768352,534,511,557,639,82,105,128,234.9045954888709,103,230.5282005371531,-0.4907745090242579,0.06312617499480704,0.5632753039510954,0.9721073771591371,44205,44680,Page+Shenandoah,Shenandoah,51,171,Virginia,VA
51740,51CS043,914,872,956,1065,109,151,193,620.2828066160569,85,348.7322556822844,1.1753804400099837,2.70306977128152,4.457646485224993,0.5585207117717412,1116,1066,1167,1345,178,229,279,233.82193200048584,151,154.29260417305295,0.312031437369789,0.8123566662290189,1.3198499189555557,0.6570011443770448,97496,97866,Portsmouth (city),Portsmouth (city),51,740,Virginia,VA
51029,51CS044,146,139,153,174,21,28,35,657.8854028046907,23,545.0559867290716,-0.6076203436175094,1.2041604090386298,2.9352075947894476,0.7996907134318159,181,173,190,223,33,42,50,246.48316452644016,21,124.05482041587901,0.7222468788932772,1.2336462367391896,1.716507872326941,0.49151930150084605,16879,16928,Prince Edward and Nearby Counties,Buckingham,51,29,Virginia,VA
51037,51CS044,144,140,149,161,12,17,21,572.1646872055285,13,450.2164502164502,-0.5611667352975116,1.1965299081713947,2.9536069297775644,0.7419559697901124,176,170,182,236,54,60,66,525.7640109025546,32,279.3296089385475,1.9303574462358353,2.4655619839258565,2.957302214150905,0.5226066140519898,11550,11456,Prince Edward and Nearby Counties,Charlotte,51,37,Virginia,VA
51049,51CS044,83,82,84,102,18,19,20,775.1897910645054,8,329.76092333058534,4.053970044831857,4.45473592413626,4.856904279025093,0.4039158769545491,102,101,103,130,27,28,29,287.53785301783626,13,134.33915469670353,1.4007736536277602,1.52839099035637,1.657632454162435,0.45099680297116607,9704,9677,Prince Edward and Nearby Counties,Cumberland,51,49,Virginia,VA
51065,51CS044,209,197,221,223,2,14,26,205.1629004617586,14,204.94803103498754,-1.7342197643998043,0.05135077366463055,1.6274273930964465,0.9324209451076875,262,248,276,290,14,28,42,100.96517732893756,19,68.69621809241448,-0.22344016071989212,0.3401384133683437,0.8398323049750666,0.6568723826300841,27324,27658,Prince Edward and Nearby Counties,Fluvanna,51,65,Virginia,VA
51147,51CS044,199,190,209,222,13,23,32,409.81412550647275,17,309.0487660773531,-0.6774082690806351,1.025190314623398,2.7055904464991487,0.7220875821153253,246,234,257,273,16,27,39,124.60363845230148,25,114.05109489051094,-0.4163941935205594,0.1252132792267783,0.609391846058904,0.8829829479907838,22003,21920,Prince Edward and Nearby Counties,Prince Edward,51,147,Virginia,VA
51153,51CS045,1768,1561,1975,2300,325,532,739,441.9408119818069,324,269.2595362752431,0.04468242134028619,1.7645670811113379,3.4353695608419903,0.6081225132866864,2242,1992,2492,2644,152,402,652,83.0986081085675,274,56.585966267329454,-0.25206004108594066,0.26432746688760667,0.783909776181493,0.6792615151753456,481320,484219,Prince William,Prince William,51,153,Virginia,VA
51155,51CS046,385,370,399,452,53,67,82,793.8725251653692,47,556.2788495679962,0.6017119708745545,2.386270234605741,4.235342492541999,0.6904221878892022,471,454,489,580,91,109,126,322.1270149929631,60,177.7303830089754,0.9360936942292317,1.4359664086555115,1.9441528383486248,0.5467126854597364,33796,33759,Pulaski+Radford (city),Pulaski,51,155,Virginia,VA
51750,51CS046,102,100,103,103,-0,1,3,35.277287989726304,3,73.05491294289541,-0.7841863350084388,-0.3762025629940758,0.03143001712339486,1.2251589670957577,126,123,128,140,12,14,17,87.74582584826186,16,97.3295212604173,-0.21601864337351084,-0.09682870164679835,0.03839041555435947,1.0373083298709302,16426,16439,Pulaski+Radford (city),Radford (city),51,750,Virginia,VA
51760,51CS047,1575,1477,1673,1732,59,157,255,276.31776811406075,138,242.85192631731775,-1.354394622027581,0.36479953516259206,2.090904266423827,0.8733244143424653,1941,1824,2058,2299,241,358,475,157.88652969058634,224,98.84649668599468,0.06265769131383943,0.5928720856564027,1.142382729584517,0.6243154471824621,227299,226614,Richmond (city),Richmond (city),51,760,Virginia,VA
51770,51CS048,1042,1000,1085,1284,199,242,284,969.4646591545078,107,429.39984348977663,3.669714971215559,5.415314470437598,6.9335052304374605,0.4410987792017296,1269,1218,1320,1468,148,199,250,201.36632066425813,117,118.1674948491092,0.29594436483647624,0.8304787965177349,1.3429834515772028,0.583899870120417,99674,99012,Roanoke (city),Roanoke (city),51,770,Virginia,VA
51081,51CS049,128,126,129,138,9,10,12,368.47281391679513,21,738.0073800738007,-4.060120607256563,-3.712259397476224,-3.2739233050660332,1.8284888085405668,157,156,159,161,2,4,5,31.932613209031555,16,139.9702563205319,-1.2003623678422,-1.0761967097532057,-0.9544523173998931,3.4406996372876644,11382,11431,Southampton and Nearby Counties and Independent Cities,Greensville,51,81,Virginia,VA
51093,51CS049,314,297,330,352,22,38,55,397.2470600047572,27,280.23560549054207,-0.5900381398326067,1.148049184947602,2.7033336276514066,0.687481902274621,390,370,411,476,65,86,106,218.5849285487643,55,140.34908645503725,0.2649468061199545,0.7968217806163479,1.2660642063695833,0.634671076028161,38539,39188,Southampton and Nearby Counties and Independent Cities,Isle of Wight,51,93,Virginia,VA
51175,51CS049,159,151,167,194,27,35,43,781.7810133083176,33,736.0731612111749,-1.192779435749994,0.4944921699956261,2.2338152992171127,0.9154156677738524,195,186,204,258,54,63,72,348.8954058321291,29,161.1290143349261,1.372648327363136,1.8777593770121848,2.3668491412085984,0.4545868152360922,17933,17998,Southampton and Nearby Counties and Independent Cities,Southampton,51,175,Virginia,VA
51181,51CS049,69,68,69,74,5,5,6,318.20761738323205,6,367.8724708767627,-0.8761861845062564,-0.49209061555436445,-0.11012380941336916,0.9693106178338009,85,84,86,101,15,16,17,249.3537852884477,3,45.92774035517453,1.9051097537512949,2.0351408268405042,2.1641802777661607,0.173532888198828,6524,6532,Southampton and Nearby Counties and Independent Cities,Surry,51,181,Virginia,VA
51183,51CS049,127,123,132,125,-7,-2,2,-88.45654429011869,17,628.7563569116968,-8.754307350462408,-7.149099357470085,-5.296302083380097,-12.215769438678212,155,149,160,176,16,21,27,197.36567868945372,20,185.80453363062057,-0.3730757149517695,0.13025773954295128,0.628320047751232,0.8991010118828582,10815,10764,Southampton and Nearby Counties and Independent Cities,Sussex,51,183,Virginia,VA
51595,51CS049,51,50,51,110,59,59,60,4170.4306324771105,21,1482.5273561595482,26.465915849656444,26.87902736037774,27.277132515790225,0.34956799275224554,63,62,64,95,31,32,33,567.1275094622383,7,123.36975678533663,4.320300968738322,4.441073737792579,4.5547550805631065,0.21097799978282136,5666,5674,Southampton and Nearby Counties and Independent Cities,Emporia (city),51,595,Virginia,VA
51620,51CS049,118,117,119,132,13,14,15,687.0782151169587,20,983.8888205632763,-3.3537046306169116,-2.9587256967719755,-2.523795720997245,1.3363104175491036,146,145,147,180,33,34,35,412.8689730291767,18,219.2448233861145,1.8059415844886721,1.9389858020865862,2.064621885532246,0.5158104102782209,8131,8210,Southampton and Nearby Counties and Independent Cities,Franklin (city),51,620,Virginia,VA
51179,51CS050,719,651,787,751,-36,32,100,81.64332335436137,36,91.49421489703724,-1.7591553942594493,-0.1472571244981569,1.7094244531292986,1.0868254486233653,915,832,998,1028,30,113,196,70.52836474480287,87,54.239401496259354,-0.36427620705301816,0.15723371458461258,0.6780428797231476,0.762305336122273,157387,160400,Stafford,Stafford,51,179,Virginia,VA
51800,51CS051,685,644,725,838,113,153,194,648.9620210835864,83,351.35621381930554,1.2089043267469148,2.956760739581052,4.749186706408915,0.5379038279833388,855,805,905,1062,157,207,257,215.71062609801118,140,145.87284056098525,0.20836747376986287,0.690024910340733,1.2429373265682548,0.672992422758851,94491,95974,Suffolk (city),Suffolk (city),51,800,Virginia,VA
51099,51CS052,170,158,181,196,15,26,38,392.47853977712725,16,237.89168494219976,-0.2868556168146945,1.5218554288625814,3.4307180570434244,0.5840028752209497,216,202,230,201,-29,-15,-1,-54.93075620556498,17,62.06871371718573,-1.7285869751219693,-1.1782734688408965,-0.62661381163624,-1.2103964668762868,26903,27389,Westmoreland and Nearby Counties,King George,51,99,Virginia,VA
51103,51CS052,189,185,194,196,2,7,11,246.96409748702555,5,184.00956849756187,-1.0973386395850873,0.6137384559330857,2.400923915613915,0.6484552809131195,231,226,237,241,4,10,15,87.00247227006803,17,155.60640732265446,-1.188997495634323,-0.6879324258245061,-0.17219397416172327,1.6182739152754455,10869,10925,Westmoreland and Nearby Counties,Lancaster,51,103,Virginia,VA
51133,51CS052,154,149,160,177,17,23,28,758.2013402344809,12,403.6326942482341,1.8078174076840008,3.534067216291936,5.205115174665341,0.5097418929979887,191,185,197,245,48,54,60,449.1000997727103,28,233.3138905091242,1.6387522428605041,2.153767365029355,2.6449033527693144,0.510050704202463,11892,12001,Westmoreland and Nearby Counties,Northumberland,51,133,Virginia,VA
51159,51CS052,106,105,107,106,-1,-0,1,-3.0529472763329615,5,223.43872193051058,-2.634563540167297,-2.24908691346605,-1.8447597316283435,5.366634100351677,131,130,132,132,-0,1,2,11.256091853177834,10,111.07408641563923,-1.1335073615897768,-0.9976506494933928,-0.877619010070418,4.966757616579553,8951,9003,Westmoreland and Nearby Counties,Richmond (county),51,159,Virginia,VA
51193,51CS052,214,206,221,230,9,16,24,356.7281831163764,16,346.84587036635594,-1.6040033233052373,0.1313280838939431,1.7928325847508442,0.9165970532270105,265,256,275,257,-18,-8,1,-44.146565613115435,28,149.7566454511419,-2.434017414688523,-1.940963092483589,-1.4328018775003564,-3.859894980727151,18452,18697,Westmoreland and Nearby Counties,Westmoreland,51,193,Virginia,VA
51199,51CS053,401,371,431,453,22,52,82,298.87891601832297,21,119.9931432489572,0.0789983478559281,1.7444402897522706,3.60468868232659,0.39394599483665316,504,467,540,628,88,124,161,175.28940206426557,63,88.97802384046099,0.32973043398820656,0.8729348604389575,1.345630576503041,0.5035491895812625,70004,70804,York,York,51,199,Virginia,VA
53001,53CS001,110,108,112,110,-2,0,2,4.401272164748671,18,351.0140405616225,-3.8724037104264237,-3.466316867325887,-3.069686300789558,14.685518953937352,136,133,138,155,17,19,22,93.78627287429413,18,87.29812309035356,-0.06950946598216445,0.06669217930661275,0.19049484894151647,0.8850518458701987,20512,20619,Adams+Grant,Adams,53,1,Washington,WA
53025,53CS001,614,571,657,710,53,96,139,386.1164886830132,82,330.45528275083876,-1.0561534429110038,0.5182173793755306,2.212803211646791,0.8470032181815813,763,712,815,912,97,149,200,148.36304710752952,120,119.80711055201127,-0.20115616229973643,0.28487787433147105,0.8007200708876093,0.8021287876997517,99257,100161,Adams+Grant,Grant,53,25,Washington,WA
53003,53CS002,217,208,227,266,39,49,58,868.2577546988845,22,393.57753030099735,3.0335578618473953,4.698212583839689,6.546378667146092,0.444144419565747,266,255,278,290,12,24,35,106.01462290206703,29,129.57419239533533,-0.7565597574333374,-0.2231371284739775,0.28650653289801237,1.1728007566098664,22359,22381,Asotin+Columbia+Garfield+Whitman,Asotin,53,3,Washington,WA
53013,53CS002,48,47,48,52,4,4,5,440.19332678111823,3,302.34315948601665,0.9821597654319066,1.3726826295939591,1.7806330456691848,0.5588862813019057,59,59,60,74,14,15,15,371.4018273699727,1,24.826216484607745,3.335298656051087,3.465414652196743,3.5951025087806148,0.06265638404362718,3969,4028,Asotin+Columbia+Garfield+Whitman,Columbia,53,13,Washington,WA
53023,53CS002,24,23,25,24,-1,0,1,25.107275012186673,5,871.8395815170009,-10.201198714448008,-8.461034557690958,-6.74621725292035,4.370666726859662,30,28,31,32,1,2,4,100.8211099231112,5,213.85799828913602,-1.6474445051693847,-1.1226984785614726,-0.5659549714607641,1.4893374386015845,2294,2338,Asotin+Columbia+Garfield+Whitman,Garfield,53,23,Washington,WA
53075,53CS002,230,209,250,270,20,40,61,333.55195001053835,25,207.736092068636,-0.4002815347462543,1.2875990584859431,3.0502357090165364,0.6076617480095332,285,261,310,396,86,111,135,231.32689089844803,44,91.9348098620978,0.8647143367774096,1.3841843946447865,1.8761448453717329,0.39386624934421677,48138,47860,Asotin+Columbia+Garfield+Whitman,Whitman,53,75,Washington,WA
53005,53CS003,1299,1210,1388,1520,132,221,310,427.5549132710853,149,287.81842327659064,-0.2563724282036578,1.4128385581415,3.1275282727924014,0.6701453230826799,1618,1510,1726,1904,178,286,394,136.54022137724021,227,108.29274343206897,-0.21144679607914207,0.29711478171698985,0.8297971241206812,0.790358281187567,207075,209617,Benton,Benton,53,5,Washington,WA
53007,53CS004,616,582,650,653,3,37,71,185.39133185242807,40,202.73181115531793,-1.90395356393776,-0.21411492296955228,1.6402669979895064,1.0644345691989932,763,722,804,832,28,69,110,86.75773510183764,73,91.73274356300028,-0.5595438350816401,-0.07253296485161632,0.45699242959051284,1.0422476064298776,78922,79579,Chelan+Kittitas,Chelan,53,7,Washington,WA
53037,53CS004,268,249,288,302,14,34,53,297.4859584666961,29,256.86448184233836,-1.1447688293269729,0.3720451815830041,2.163715019238856,0.8384855690827409,335,312,359,384,25,49,72,107.45690315157046,30,66.12881893929374,-0.12171302808738804,0.41538631697869915,0.9289812238503109,0.6030284246232844,45160,45366,Chelan+Kittitas,Kittitas,53,37,Washington,WA
53009,53CS005,895,861,928,917,-11,22,56,115.09385102390264,6,31.00655013371575,-0.8781138641194975,0.8428998013383302,2.5413546500596933,0.2578258373032843,1105,1065,1145,1255,110,150,190,191.98273348470633,75,96.06270973691626,0.4743950541249077,0.9352278615510621,1.4867087705865791,0.497055445723761,77403,78074,Clallam+Jefferson,Clallam,53,9,Washington,WA
53031,53CS005,347,333,361,350,-11,3,17,33.529909674954986,3,36.359229184341295,-1.698526763689662,-0.008950869339036691,1.5673256653868737,0.7964842447826027,432,415,449,448,-1,16,33,47.454920270610025,18,53.6928767450185,-0.5621671343023342,-0.06734340155787905,0.4599579668477395,1.0645352323647514,33004,33524,Clallam+Jefferson,Jefferson,53,31,Washington,WA
53011,53CS006,3225,3008,3442,3577,135,352,569,279.9746990534415,137,108.86343003240079,0.05793373493638103,1.6561734747201775,3.45905250195075,0.3877326376419608,4033,3769,4296,4646,350,613,877,120.14655411853846,409,80.12192637402246,-0.08840457328736791,0.38850867401901323,0.9358584188217545,0.6657827353725557,503383,510472,Clark,Clark,53,11,Washington,WA
53015,53CS007,1055,1007,1103,1084,-19,29,77,104.213948566216,25,90.1648212933242,-1.5132104732974159,0.13690145400188417,1.8603024261861505,0.8362490125496104,1300,1242,1358,1588,230,288,346,258.4649464599244,229,205.49912057144908,0.043483086271568154,0.5173669309071085,1.0730233510508647,0.792324492490099,110908,111436,Cowlitz+Klickitat+Skamania+Wahkiakum,Cowlitz,53,15,Washington,WA
53039,53CS007,183,173,193,177,-16,-6,4,-102.07977818052454,5,87.8464444151623,-3.6241207416698105,-1.8667920617128828,-0.1997021157229569,-1.0394738587529302,228,216,240,296,56,68,80,295.38109934679824,26,112.70536217434653,1.3443680918099625,1.8312853321801368,2.3269767304722633,0.3760406247689649,22767,23069,Cowlitz+Klickitat+Skamania+Wahkiakum,Klickitat,53,39,Washington,WA
53059,53CS007,82,81,83,86,3,4,5,124.24065037870018,7,232.2302396947831,-1.4701559888197457,-1.0765524368468071,-0.6950589898115604,1.47526078164627,102,101,104,105,1,3,4,22.349286550277295,2,16.46090534979424,-0.06396529508533619,0.06449945060481896,0.1943650360007295,0.5382944971696486,12057,12150,Cowlitz+Klickitat+Skamania+Wahkiakum,Skamania,53,59,Washington,WA
53069,53CS007,43,43,44,41,-3,-2,-2,-215.8110808773399,2,179.61383026493039,-4.361304515321128,-3.956042267326177,-3.5684110392564965,-1.4254594616228895,55,54,55,68,13,13,14,293.3510533996224,2,43.84042086804033,2.3727510616063565,2.4907712217028326,2.616823034113504,0.13905619032622446,4454,4562,Cowlitz+Klickitat+Skamania+Wahkiakum,Wahkiakum,53,69,Washington,WA
53017,53CS008,267,249,286,283,-3,16,34,147.0936755200289,13,120.62726176115801,-1.4877463297247173,0.24281887795618587,2.083658298604174,0.7714087248767927,333,311,356,387,31,54,76,122.9209642647803,42,96.3435335137863,-0.2677922073132976,0.2467960037453901,0.7715690760094724,0.7694257304148365,43108,43594,Douglas+Okanogan,Douglas,53,17,Washington,WA
53047,53CS008,385,366,403,413,10,28,47,269.6034261405049,33,312.6998791841376,-2.1961941536491763,-0.4204469251550259,1.3999878672983872,1.1204701085989819,474,452,496,563,67,89,111,208.37940612412513,76,178.57562442726567,-0.26580779352964506,0.314803310009663,0.8538364397247264,0.8474180206036152,42213,42559,Douglas+Okanogan,Okanogan,53,47,Washington,WA
53019,53CS009,67,67,68,85,17,18,18,974.672058235263,6,330.5329844374053,6.03230261063018,6.453309178983753,6.860446926997322,0.3209803246329005,83,82,83,133,50,50,51,695.0488136234719,12,165.31202644992422,5.168395633827578,5.298745439442195,5.420570513405868,0.23321986301637018,7261,7259,Ferry+Lincoln+Pend Oreille+Stevens,Ferry,53,19,Washington,WA
53043,53CS009,100,99,101,102,1,2,3,60.30257421689767,9,328.61706983112737,-3.0712203419048922,-2.679897153215011,-2.2374089215639845,3.394258063881585,126,124,127,144,17,18,20,163.55895306852582,20,178.79492222420882,-0.27473981348734555,-0.15307648319580913,-0.025759268671517954,1.036500118982997,10955,11186,Ferry+Lincoln+Pend Oreille+Stevens,Lincoln,53,43,Washington,WA
53051,53CS009,141,135,146,144,-2,3,9,98.69931376624194,5,147.49262536873155,-2.1907271017472265,-0.5045514638160218,1.2019350931192754,1.1505078923586718,175,168,182,236,54,61,68,442.9728304559935,23,166.3412164605482,2.2410080193437567,2.7738189707016265,3.2559009213070707,0.36947878256505534,13560,13827,Ferry+Lincoln+Pend Oreille+Stevens,Pend Oreille,53,51,Washington,WA
53065,53CS009,408,388,428,432,4,24,44,206.36788072752034,21,180.46663515661925,-1.481779507487976,0.2550628034501195,2.0089724435557694,0.8395299156051185,506,481,530,631,101,125,150,265.0360604536644,101,213.52614109638276,-0.022921325598418835,0.5234105015533751,1.061416502214732,0.7992738038463321,46546,47301,Ferry+Lincoln+Pend Oreille+Stevens,Stevens,53,65,Washington,WA
53021,53CS010,366,324,408,454,46,88,130,363.717514387979,69,284.64759390276606,-0.8279999278456526,0.7779547196976613,2.6842947585929644,0.773829368221861,466,416,517,554,37,88,138,89.55015983698009,95,96.84588252084735,-0.5751329025297205,-0.08090486570068114,0.443033112098144,1.069298009730607,96962,98094,Franklin,Franklin,53,21,Washington,WA
53027,53CS011,756,723,788,800,12,44,77,234.64889968849164,28,147.74361206748716,-0.9082794020284348,0.872340157999145,2.6092178389293763,0.6157896446392797,935,895,974,1133,159,198,238,258.6468991920095,116,151.2563403789232,0.5606242192214946,1.0924887251724646,1.602172324448306,0.5818651878886772,75807,76691,Grays Harbor+Pacific,Grays Harbor,53,27,Washington,WA
53049,53CS011,298,288,308,268,-40,-30,-20,-513.0235388146762,4,68.43163252213336,-7.388279713125669,-5.834671154064651,-4.078708931364395,-0.13799047315312116,370,357,382,413,31,43,56,180.91347262859824,30,125.6386632046235,0.03892184245448021,0.5388342884355806,1.066889002306355,0.6787557746877968,23381,23878,Grays Harbor+Pacific,Pacific,53,49,Washington,WA
53029,53CS012,689,651,726,704,-22,15,53,70.901881431771,30,138.3062099488267,-2.461175039715942,-0.6607441211735536,0.969627102862134,1.8315770736087857,851,806,896,907,11,56,101,63.88296650168637,41,46.9316972104257,-0.35510404991501765,0.1631810362118007,0.6201365757735628,0.7217191910341784,86764,87361,Island,Island,53,29,Washington,WA
53033,53CS013,11600,10625,12576,12136,-440,536,1511,94.5130115591411,973,171.6716994880725,-2.4064351757194586,-0.7372079883440438,0.8746088007063499,1.8129971702034648,14326,13162,15491,15083,-408,757,1921,33.55270599256657,734,32.54613658735578,-0.4891589914648764,0.010034323085097384,0.5512129267277225,0.9687201616947794,2267118,2255260,King,King,53,33,Washington,WA
53035,53CS014,1972,1854,2091,2012,-79,40,158,57.858776941721224,41,59.629858560884266,-1.8018841748934227,0.005185785628783029,1.6352305827419165,1.0053393682792797,2423,2281,2565,2649,84,226,368,82.4093193131754,192,69.94280718370915,-0.33357540048949086,0.11231466005589272,0.6337942722951386,0.8449892617383803,275030,274510,Kitsap,Kitsap,53,35,Washington,WA
53041,53CS015,816,781,852,863,11,47,82,227.0356359733799,31,150.48361063579324,-1.0705442134545682,0.7913269116022384,2.3589343170250645,0.6489440928144367,1016,973,1060,1132,72,116,159,137.36114615292556,145,172.3789483695329,-0.8486123629761513,-0.3470982546578971,0.15944524677656263,1.2441644898291513,82401,84117,Lewis,Lewis,53,41,Washington,WA
53045,53CS016,604,576,633,623,-10,19,47,112.11405256692996,13,78.40062720501764,-1.3920579547353447,0.3367164635599932,2.106169391689509,0.663597388322157,751,716,786,875,89,124,159,184.31762287146051,75,111.30238632316278,0.23877744316656643,0.7266700563243976,1.2435175021945923,0.5990387249747711,66326,67384,Mason,Mason,53,45,Washington,WA
53053,53CS017,6022,5625,6418,6198,-220,176,573,76.53678602801044,304,132.08303417322648,-2.2995635038845568,-0.6159457264176387,1.3071315585876,1.7160043572094787,7454,6976,7932,8226,294,772,1250,83.41344664399818,627,67.76268577999498,-0.3902350441829604,0.13100300784836774,0.7015519097594145,0.8113200632020018,920633,925288,Pierce,Pierce,53,53,Washington,WA
53055,53CS018,131,130,133,124,-9,-7,-6,-164.25476942823485,7,157.06512593257418,-3.596042502494772,-3.2097118766919364,-2.8076719264270484,-1.1075205582054601,167,164,169,159,-10,-8,-5,-41.21062392951219,7,37.94243590438506,-0.9221161479402608,-0.7926911644733033,-0.6706123875101883,-1.0601325333347762,17827,18449,San Juan+Skagit,San Juan,53,55,Washington,WA
53057,53CS018,1063,1007,1119,1128,9,65,121,199.57891458539538,43,132.4686927188429,-1.2168199474921562,0.6580055230715125,2.500928610182175,0.6536512683210278,1305,1237,1372,1535,163,230,298,176.27054254228653,96,73.52209109080744,0.504651136861691,1.0297779365226467,1.5342200542028201,0.41529364618520065,129842,130573,San Juan+Skagit,Skagit,53,57,Washington,WA
53061,53CS019,4825,4468,5182,5226,44,401,758,193.5501923875819,366,176.64923904479096,-1.4808067852638922,0.22272491541805906,1.8933606820101423,0.910408972600783,5994,5564,6424,6384,-40,390,820,46.81845738816822,348,41.78042227040577,-0.4309968710397438,0.0352705782988336,0.5680038251397069,0.8901095681328818,828761,832926,Snohomish,Snohomish,53,61,Washington,WA
53063,53CS020,4176,3944,4408,4498,90,322,554,239.3618274759418,289,214.64526898431566,-1.489319077862459,0.24048035938960757,1.9933818263830476,0.8939658734058079,5174,4893,5456,5866,410,692,973,126.87188895347828,641,117.5583802986093,-0.4440369106873787,0.08264487751353448,0.6054086838786147,0.9252537437740613,538563,545261,Spokane,Spokane,53,63,Washington,WA
53067,53CS021,2063,1935,2190,2101,-89,38,166,52.12232822069785,57,77.26770548804045,-1.9709544768553264,-0.21023047618507867,1.5071511288234904,1.4448529691071534,2560,2406,2714,2910,196,350,504,117.59549479503876,201,67.52920386092343,0.005917371285745912,0.49927399169147496,0.9902111953696724,0.5726139852573177,295078,297649,Thurston,Thurston,53,67,Washington,WA
53071,53CS022,508,481,535,541,6,33,60,209.95345728941393,37,237.3125952056442,-1.9802930528808773,-0.2583372164116106,1.5306287713130924,1.096804290233324,624,591,656,711,55,87,120,139.1866807502189,63,100.53298439345099,-0.09665951379885633,0.3759646849056035,0.8872393149638402,0.7141017208852473,62365,62666,Walla Walla,Walla Walla,53,71,Washington,WA
53073,53CS023,1489,1391,1587,1570,-17,81,179,141.71053953218046,56,98.39104290113016,-1.3899352540519225,0.4610512047633804,1.9767248284973598,0.6858070818188429,1845,1727,1963,2082,119,237,355,103.87510016266192,129,56.428471444568864,0.01106022101126471,0.48521584398496775,0.9834650061370024,0.5409558310062867,227663,228608,Whatcom,Whatcom,53,73,Washington,WA
53077,53CS024,1765,1655,1875,2127,252,362,472,566.5672356225075,303,473.8910285233915,-0.690192306492148,0.882095812252892,2.5035232496948945,0.8341224729150863,2176,2043,2308,2537,229,361,494,141.07856680108563,308,120.26176456807285,-0.2699551101888999,0.20412388942630658,0.7256360280524154,0.8500925400706768,255755,256108,Yakima,Yakima,53,77,Washington,WA
54001,54CS001,155,149,162,211,49,56,62,1427.9587265216394,12,307.8304367344321,9.471470022791223,11.16680484356105,13.044253064463566,0.2117694356033506,189,181,197,266,69,77,85,495.9456447450047,35,226.33212622866012,2.191053495271065,2.702167966040157,3.2068232204288396,0.4504908351659628,15593,15464,Barbour+Pocahontas+Randolph+Tucker,Barbour,54,1,West Virginia,WV
54075,54CS001,84,83,85,99,14,15,16,763.1820199570888,3,151.72588190668858,5.731653604323037,6.112356267717901,6.493311807296556,0.18645102085127158,102,101,103,136,33,34,35,428.0923349999608,14,178.52588625350674,2.3714495098064594,2.4971421070785618,2.621653101762447,0.4049636872292041,7909,7842,Barbour+Pocahontas+Randolph+Tucker,Pocahontas,54,75,West Virginia,WV
54083,54CS001,300,288,312,323,11,23,35,325.14886318052504,4,57.21232925695488,0.9678119398003399,2.6525827617610025,4.381525810937416,0.16854323569589738,366,351,380,472,92,106,121,382.3001516027439,55,197.7492539459965,1.3674910844276673,1.8432707525254155,2.4208263287023395,0.5124423749492979,27966,27813,Barbour+Pocahontas+Randolph+Tucker,Randolph,54,83,West Virginia,WV
54093,54CS001,76,76,77,101,24,25,25,1460.8075251026587,4,236.5464222353637,11.851317145846869,12.245667703904676,12.655999799373697,0.15562836650608702,93,92,94,115,21,22,23,332.90124193463663,24,359.0664272890485,-0.38906905829553634,-0.2629930095111372,-0.14101593780595825,1.0322083848410677,6764,6684,Barbour+Pocahontas+Randolph+Tucker,Tucker,54,93,West Virginia,WV
54003,54CS002,958,905,1011,1158,147,200,253,653.4985125923318,65,212.1271457476666,2.778731924008945,4.3677540400459955,6.110626266921926,0.32298936820458696,1204,1139,1269,1515,246,311,376,247.73562910876024,186,148.1233724347182,0.47985486521724635,0.9778472107666064,1.5641084198173436,0.595993182384051,122568,125571,Berkeley+Morgan,Berkeley,54,3,West Virginia,WV
54065,54CS002,186,179,194,203,9,17,24,385.3259799248989,4,93.14239143089998,1.1390149732520884,2.913807493473603,4.733081321957637,0.22794848823508018,229,220,237,281,44,52,61,305.08376881881077,48,279.16715133185994,-0.24823510617030314,0.25114786339769846,0.7575203704309534,0.8979330163816812,17178,17194,Berkeley+Morgan,Morgan,54,65,West Virginia,WV
54005,54CS003,273,263,282,298,16,25,35,466.2527919140152,14,259.03140755816645,0.24894023344518143,2.013819504087499,3.7550417390700366,0.5343552695475715,331,320,342,396,54,65,76,304.56722577643984,35,163.77333770062233,0.8565320827832142,1.4218527193887027,1.9057490132767092,0.52958839232677,21619,21371,Boone+Lincoln+Logan,Boone,54,5,West Virginia,WV
54043,54CS003,242,233,251,271,20,29,38,569.5991273244719,11,216.40763328742867,1.7849494959291443,3.5827082999975977,5.209168280435666,0.36724540083598106,295,285,306,378,72,83,93,410.7970921504881,46,228.20856278216004,1.3145411752441187,1.8385651997364492,2.379326633253111,0.5488973913201096,20332,20157,Boone+Lincoln+Logan,Lincoln,54,43,West Virginia,WV
54045,54CS003,467,453,481,518,37,51,65,633.8890336304305,56,692.5550333910462,-2.174951610602721,-0.5943145589419108,1.164955243073966,1.0716417941232317,565,548,581,700,119,135,152,422.1807987724309,77,240.69269482041824,1.2837351365273826,1.819174599778116,2.3504211151937318,0.5659273820815229,32344,31991,Boone+Lincoln+Logan,Logan,54,45,West Virginia,WV
54007,54CS004,138,132,143,153,10,15,21,484.49973391084006,4,127.07489476610277,1.8227271762439328,3.5705771316813517,5.329585859656456,0.24614111688376075,165,158,171,209,38,44,51,360.601275545172,22,179.3429526371566,1.3193118915106734,1.8027230668590821,2.3667800973313815,0.4863495124913784,12591,12267,Braxton+Gilmer+Lewis+Upshur,Braxton,54,7,West Virginia,WV
54021,54CS004,69,68,70,80,10,11,12,590.2544740323358,1,53.676865271068166,4.945525318752814,5.3631252202360065,5.772882772277182,0.08335805697721602,84,83,85,90,5,6,7,82.28931262697765,13,176.2233970448692,-1.0670556337096198,-0.9438881407392499,-0.8160286527317525,1.8386298007160322,7452,7377,Braxton+Gilmer+Lewis+Upshur,Gilmer,54,21,West Virginia,WV
54041,54CS004,209,202,217,214,-3,5,12,109.80682557837882,5,118.8212927756654,-1.8172244581968728,-0.12473297917627409,1.5034096538672392,0.8895734697855469,255,246,264,344,80,89,98,527.1787233281274,59,348.9266071322964,1.2405565730527568,1.7886398184051795,2.2883964270301167,0.654532664071158,16832,16909,Braxton+Gilmer+Lewis+Upshur,Lewis,54,41,West Virginia,WV
54097,54CS004,224,213,234,255,21,31,42,525.5845855285202,8,134.11005406311554,2.2276630460054005,3.863834631832418,5.612404126588223,0.24727659993896164,273,260,285,345,60,72,85,303.65356101975294,61,256.4102564102564,-0.027942538529266894,0.4809518503932133,0.9543444587444315,0.8328875090554888,23861,23790,Braxton+Gilmer+Lewis+Upshur,Upshur,54,97,West Virginia,WV
54009,54CS005,275,266,285,350,65,75,84,1335.8878431306891,37,662.0442853947662,5.088651677551708,6.747843599064695,8.507022590198753,0.48903354285933626,333,321,344,427,83,94,106,424.8208514995632,57,256.89561925365064,1.1834720465988955,1.669339040602535,2.1832838739698213,0.598367084376927,22355,22188,Brooke+Hancock,Brooke,54,9,West Virginia,WV
54029,54CS005,362,350,374,452,78,90,102,1243.7400369847514,63,870.346066173931,1.9225855142881136,3.7872628700442035,5.479786293261596,0.6920938081153001,437,423,452,522,70,85,99,294.88411101695567,84,292.59117349959945,-0.48560751081821074,0.04449059560595649,0.5391817511577357,0.9806407571707416,28954,28709,Brooke+Hancock,Hancock,54,29,West Virginia,WV
54011,54CS006,1100,1059,1140,1171,31,71,112,304.75707730496805,95,405.3981970448605,-2.663246044590727,-1.0445962482163669,0.792528791767892,1.3118645710685084,1341,1293,1389,1559,170,218,266,233.0933476333692,154,164.66537643146606,0.18131622960917632,0.6730052629103987,1.2134947855768725,0.7032095394126054,93735,93523,Cabell,Cabell,54,11,West Virginia,WV
54015,54CS007,96,95,96,112,16,16,17,816.9203469684938,6,297.50836742283377,4.795839500760791,5.200390994246239,5.606138153484712,0.3433429024829183,115,114,116,155,39,40,41,504.82852619539,20,252.87646984448097,2.3994831283417732,2.5186618117799813,2.6354904303143685,0.4886762935201013,8067,7909,Clay+Fayette+Nicholas+Webster,Clay,54,15,West Virginia,WV
54019,54CS007,518,500,535,574,39,56,74,552.704495225592,39,384,-0.013906142401813336,1.6965560218521327,3.475970954855709,0.6826052029868441,627,607,648,787,139,160,180,399.16772663511136,82,205.05126281570395,1.4130447765327119,1.9503959974256477,2.4666102349134342,0.5104989275385923,40625,39990,Clay+Fayette+Nicholas+Webster,Fayette,54,19,West Virginia,WV
54067,54CS007,284,274,295,291,-4,7,17,111.75533757483032,4,65.29013302864605,-1.3588174414688912,0.5020799016691542,2.263667038703113,0.5097690381993577,347,334,359,427,68,80,93,329.1598791705672,70,287.6751736325155,-0.06052891305831908,0.427634942617011,0.9540243222857103,0.8631907584621027,24506,24333,Clay+Fayette+Nicholas+Webster,Nicholas,54,67,West Virginia,WV
54101,54CS007,105,104,106,103,-3,-2,-1,-89.06681034850445,8,385.5886251355585,-5.139415998997983,-4.7472800075388975,-4.321121899929131,-9.434923027418565,128,127,129,151,22,23,24,276.4706530340205,26,314.7318726546423,-0.5146628822701633,-0.38354246173958373,-0.2596530700353658,1.0906387659255732,8299,8261,Clay+Fayette+Nicholas+Webster,Webster,54,101,West Virginia,WV
54025,54CS008,408,394,422,472,50,64,78,771.6328379190645,41,495.51318850651114,1.0399216535407556,2.749988730121213,4.434140341464279,0.6322591241875167,495,478,512,641,129,146,163,447.03375931901456,78,238.92666789193163,1.5324018543471762,2.0670936017716985,2.581966304604543,0.5308338190243815,33097,32646,Greenbrier+Monroe+Summers,Greenbrier,54,25,West Virginia,WV
54063,54CS008,148,142,153,183,30,35,41,1132.3036971909128,16,513.1906021970972,4.422570021371451,6.201361735933606,7.839049399333629,0.4407422278599887,180,174,186,227,41,47,53,381.37450559964867,18,145.96172559195588,1.8657423095117998,2.3494592354963375,2.8704517980214943,0.3747571571236769,12471,12332,Greenbrier+Monroe+Summers,Monroe,54,63,West Virginia,WV
54089,54CS008,163,158,168,187,19,24,29,809.1567567709609,10,333.1945022907122,3.0189911104656626,4.80789044349259,6.456223178239993,0.39549425790573034,198,192,204,255,51,57,63,478.07987764603865,23,193.1312452766815,2.3581998460697013,2.8631782724483985,3.3699568373143145,0.39699983682167317,12005,11909,Greenbrier+Monroe+Summers,Summers,54,89,West Virginia,WV
54023,54CS009,129,125,134,143,9,14,18,496.4579124074965,22,797.4626189397371,-4.662019775292626,-3.02065982912133,-1.3632936546481136,1.4970026612735436,158,152,164,176,12,18,24,164.0576941883273,27,245.92403679752255,-1.3262978968477641,-0.8127069882926647,-0.28765103494625666,1.420163590863181,11035,10979,Hardy and Nearby Counties,Grant,54,23,West Virginia,WV
54027,54CS009,238,228,247,268,21,30,40,527.5165565859514,23,398.0443906026912,-0.5298535080988294,1.230968530150552,3.10482821187349,0.7305941774872707,294,282,306,349,43,55,67,237.7985422026478,46,197.69640708268867,-0.11626439463794291,0.3898292346786135,0.8928140870676026,0.8166023813644162,23113,23268,Hardy and Nearby Counties,Hampshire,54,27,West Virginia,WV
54031,54CS009,150,144,157,171,14,21,27,579.9552125988089,9,254.03994072401383,1.5036417350672056,3.194874812636486,4.8769936650218355,0.4177039009809329,184,177,192,207,15,23,30,159.8577248990917,36,254.0220152413209,-1.4411036323901494,-0.9522630987981214,-0.43237382178838957,1.5218746157921124,14171,14172,Hardy and Nearby Counties,Hardy,54,31,West Virginia,WV
54057,54CS009,287,276,299,353,54,66,77,980.9743697099277,70,1041.7054205885636,-2.2690862414094024,-0.6000938628594158,1.072608650535032,1.0460403417684867,352,338,366,429,63,77,91,286.5730355508684,69,256.88756515264333,-0.18076579556076755,0.2973719867035297,0.7970062397326235,0.8849158322715763,26879,26860,Hardy and Nearby Counties,Mineral,54,57,West Virginia,WV
54071,54CS009,73,73,74,100,26,27,27,1694.958527814902,0,0,16.53018959026172,16.950141277524253,17.37817154545932,0,89,88,89,114,25,25,26,413.55110218829725,10,162.83992835043153,2.3785075820974217,2.5079509618158604,2.6260941831523383,0.37884279398263,6255,6141,Hardy and Nearby Counties,Pendleton,54,71,West Virginia,WV
54033,54CS010,715,686,743,724,-19,9,38,57.14898622812446,27,163.7951953409367,-2.967774220123999,-1.0562457135062195,0.5266256112648633,2.591061689955759,865,831,898,1082,184,217,251,333.3106847006857,149,228.36298986926604,0.5716105261798388,1.0477704691158625,1.5749174970938415,0.6819995344615352,65936,65247,Harrison+Taylor,Harrison,54,33,West Virginia,WV
54091,54CS010,172,165,179,209,30,37,44,883.1690716255325,10,239.8081534772182,4.730334269229272,6.4355121262555235,8.146657233576985,0.264353396192716,208,200,217,257,40,49,57,294.0851521526816,35,211.8387604406246,0.2880797121806892,0.8078187451028751,1.3341722573600607,0.7058052646956339,16680,16522,Harrison+Taylor,Taylor,54,91,West Virginia,WV
54013,54CS011,70,69,71,86,15,16,17,1004.0676964373888,3,189.72332015810275,7.747627904348684,8.13775587023533,8.560569512803063,0.1777586014440827,84,83,85,125,40,41,42,660.3888889086567,5,80.9192425958893,5.672418182744445,5.7946107035196155,5.930728261873271,0.11960168969196815,6325,6179,Jackson and Nearby Counties,Calhoun,54,13,West Virginia,WV
54035,54CS011,305,293,317,347,30,42,54,599.1466255529407,28,401.8658055256548,0.24517300215284007,1.9593171072469249,3.7152152362062583,0.6550390814168655,375,360,389,452,63,77,92,278.88025536827917,62,223.52008075564208,0.026704725312271957,0.5584620371946764,1.037476867351881,0.7912623680504904,27870,27738,Jackson and Nearby Counties,Jackson,54,35,West Virginia,WV
54053,54CS011,297,286,308,332,24,35,46,546.652457543618,22,344.9221965272606,0.41816220152942135,2.01310562638066,3.7965702282079565,0.6133795869234228,362,349,375,483,108,121,134,482.07983892647866,54,214.40482807909157,2.135892073716628,2.6795252973374093,3.1750402618804183,0.4411165442136738,25513,25186,Jackson and Nearby Counties,Mason,54,53,West Virginia,WV
54087,54CS011,180,174,186,170,-16,-10,-4,-297.5786583290766,5,143.66783995402628,-6.19560477762218,-4.414782173123922,-2.729654100208216,-0.5343889292278236,221,213,228,228,0,7,15,52.78485262059381,22,158.15959741193387,-1.586764054793233,-1.0386523415212416,-0.5264222030369093,2.637139336883366,13921,13910,Jackson and Nearby Counties,Roane,54,87,West Virginia,WV
54105,54CS011,48,48,49,53,4,5,5,367.1831114610765,7,532.5218714340053,-2.0498398467908827,-1.6443321540101223,-1.259211408878919,1.201382207360073,57,57,58,86,28,29,29,564.4751952167167,13,255.90551181102362,2.9530663010506393,3.082250589271558,3.2088969094355075,0.43807417324809506,5258,5080,Jackson and Nearby Counties,Wirt,54,105,West Virginia,WV
54037,54CS012,430,405,455,505,50,75,100,518.9833885074335,36,249.38519621765784,1.0443306426680825,2.7538699989764552,4.398446696222337,0.47419679824749283,534,504,564,604,40,70,100,119.50147265336899,66,113.25222643581516,-0.4536599992076945,0.06974583249620055,0.5844889935434541,0.9342900604593868,57742,58277,Jefferson,Jefferson,54,37,West Virginia,WV
54039,54CS013,2135,2058,2213,2484,271,349,426,776.6955967668151,189,420.96353876651006,1.7684002810242427,3.5200452686212897,5.213838365468287,0.5404431292711486,2589,2497,2681,3092,411,503,595,282.3822012757456,303,169.97834599288672,0.6284263672135322,1.1051495003926814,1.6170230713601221,0.6007508024715537,179588,178258,Kanawha,Kanawha,54,39,West Virginia,WV
54047,54CS014,285,277,293,309,16,24,32,510.44176806390095,5,107.14668381013607,2.47464265133711,3.960695843892439,5.833255161298711,0.20145234971018638,342,333,352,420,68,78,87,421.6381373992421,60,325.3090435914118,0.47462387681966334,0.9803137009992067,1.4761424294215704,0.7617409217156046,18666,18444,McDowell+Mercer,McDowell,54,47,West Virginia,WV
54055,54CS014,754,729,780,884,104,130,155,875.2084025719366,50,337.0919081087458,3.645781985786842,5.3265990979553015,7.214296417791385,0.38221193502726375,919,888,949,1150,201,231,262,390.8501973280182,149,251.9019442096365,0.8736393383262399,1.3901408034666984,1.9286186897112425,0.6417216629883022,59331,59150,McDowell+Mercer,Mercer,54,55,West Virginia,WV
54049,54CS015,602,578,626,608,-18,6,30,42.47785575914978,18,128.27593579076768,-2.52955534190819,-0.8624865126609419,0.8344789213200337,2.5859843700837795,734,705,763,868,105,134,163,239.214479451084,118,210.6240182778809,-0.21411951266117785,0.3007869616790815,0.8266222595485553,0.8739606536118462,56129,56024,Marion,Marion,54,49,West Virginia,WV
54051,54CS016,331,318,344,398,54,67,80,877.902353936107,58,762.5057516597647,-0.46059332932450003,1.173355486156269,2.798248509916254,0.8557394122313003,402,386,417,501,84,99,115,328.56824350569207,76,251.9643271557869,0.24007807124515362,0.7696244660287768,1.2951325188282767,0.75919495507039,30426,30163,Marshall+Ohio,Marshall,54,51,West Virginia,WV
54069,54CS016,499,481,517,600,83,101,119,960.7725739702103,47,446.343779677113,3.3836900873730524,5.144470507010689,6.930402396539811,0.4600205351408136,605,583,627,715,88,110,132,262.901625734514,73,174.44500203120893,0.37744122064643626,0.9038465588805629,1.397826571996431,0.6575602479791474,42120,41847,Marshall+Ohio,Ohio,54,69,West Virginia,WV
54059,54CS017,294,284,304,337,33,43,53,728.4127160656669,25,427.3686909696995,1.2526967389402208,3.010417262956499,4.7042882499048995,0.5732587690619331,356,344,368,488,120,132,144,573.3015224422065,89,385.76567985783015,1.3977516582612508,1.8895966851667658,2.352562000373749,0.6678352821488924,23399,23071,Mingo+Wayne,Mingo,54,59,West Virginia,WV
54099,54CS017,438,421,455,527,72,89,106,916.4170610678863,29,298.1928485128917,4.543443479843862,6.222108760001545,8.070566455012417,0.3217794171632324,534,514,553,704,151,170,190,442.15158094948634,88,228.2986561510922,1.6078730848175953,2.1497056385758118,2.661368010429315,0.5133238202667807,38901,38546,Mingo+Wayne,Wayne,54,99,West Virginia,WV
54061,54CS018,606,560,652,671,19,65,111,244.94385121018266,33,124.50715916165178,-0.47808729521263504,1.2562612304814957,2.874840613298452,0.5005981158119823,749,694,804,827,23,78,133,73.12094525108519,99,93.11687578773115,-0.7054534512483465,-0.19347309240911253,0.30295667164442397,1.2572909129739078,106018,106318,Monongalia+Preston,Monongalia,54,61,West Virginia,WV
54077,54CS018,320,305,335,343,8,23,38,270.654805154429,36,422.37409438887744,-3.205056726642335,-1.512161786991248,0.1553519799577825,1.4957256100606107,392,375,410,481,71,89,106,257.8475123043192,78,227.19990678978183,-0.251234187530183,0.31613313630016493,0.804414053119783,0.8712978134995362,34093,34331,Monongalia+Preston,Preston,54,77,West Virginia,WV
54079,54CS019,528,504,553,595,42,67,91,465.2218656477601,54,377.2662172075314,-0.8281648074689396,0.9095271385131607,2.660209448369856,0.7989402886844995,648,619,678,733,55,85,114,147.61099572759747,62,108.24022346368714,-0.10219347527570595,0.389375904846951,0.8913455815308491,0.7247090140680512,57254,57280,Putnam,Putnam,54,79,West Virginia,WV
54081,54CS020,900,868,932,1019,87,119,151,640.9510954792967,28,150.9678115059039,3.3226109161312642,4.917668202115285,6.625599020850013,0.23357235633700962,1093,1055,1131,1351,220,258,296,349.57241277503744,140,189.56062555006432,1.0900474609614204,1.595960370472963,2.070299885267973,0.5401720025502278,74188,73855,Raleigh+Wyoming,Raleigh,54,81,West Virginia,WV
54109,54CS020,270,261,280,319,39,49,58,917.9183997144196,23,434.59776087675374,3.0830914808161496,4.887872032933561,6.491398124497018,0.46391042615542954,328,317,339,408,69,80,91,380.66004627606793,58,274.99881466028165,0.5652679593984077,1.073743038640734,1.5705282329671464,0.7135386923501033,21169,21091,Raleigh+Wyoming,Wyoming,54,109,West Virginia,WV
54017,54CS021,64,63,65,78,13,14,15,712.2175765159291,2,101.54861640010157,5.725987392279472,6.096617922427393,6.545574890459356,0.13309265594338862,77,76,78,94,16,17,18,214.64739166393733,12,154.99870834409714,0.4784746397491767,0.5949734751103148,0.7221019621286359,0.6811215391205159,7878,7742,Tyler and Nearby Counties,Doddridge,54,17,West Virginia,WV
54073,54CS021,83,82,84,88,4,5,6,249.2128155824472,7,367.9369250985545,-1.6013726205740557,-1.1861825909101233,-0.8122506683407791,1.2192416219439124,102,101,103,123,20,21,22,274.2782270909725,19,249.73711882229233,0.11655534441018227,0.24350317066850502,0.375969761312149,0.8688857162691831,7610,7608,Tyler and Nearby Counties,Pleasants,54,73,West Virginia,WV
54085,54CS021,90,89,91,113,22,23,24,1066.9138049457476,5,232.72050267628578,7.933756644195879,8.34773695475367,8.748249833083063,0.2090070055910667,108,107,109,146,37,38,39,453.7307000898166,16,190.72595064966026,2.508051452024457,2.6329523440929554,2.753646741606007,0.40958984552158434,8594,8389,Tyler and Nearby Counties,Ritchie,54,85,West Virginia,WV
54095,54CS021,92,91,93,86,-7,-6,-5,-294.47275161340895,9,432.9004329004329,-7.701098289013269,-7.267212061929718,-6.888339823992857,-1.7570957607199233,111,110,112,142,30,31,32,378.3237945543311,21,256.94359476324485,1.0856741747969962,1.2122268807048486,1.3374498424395247,0.6578864157964995,8316,8173,Tyler and Nearby Counties,Tyler,54,95,West Virginia,WV
54103,54CS021,178,172,184,195,11,17,23,469.8245564842326,14,387.0343492985002,-0.8287706514467781,0.8450982942133419,2.545191962986605,0.7780056137209924,214,207,222,317,95,103,110,721.843150318699,49,345.0461235124287,3.2136029082174224,3.774310793533083,4.274200871814471,0.473389035433518,14469,14201,Tyler and Nearby Counties,Wetzel,54,103,West Virginia,WV
54107,54CS022,928,892,964,1004,40,76,112,362.6825840659772,74,352.7631124194067,-1.7048041610199491,0.10753231192682171,1.7708184419832333,0.9600311481932059,1132,1088,1175,1338,163,206,250,246.68900498544437,167,199.57455962140588,-0.07248180348659797,0.4794415753569191,0.9954159579715688,0.8051125103690113,83909,83678,Wood,Wood,54,107,West Virginia,WV
55001,55CS001,229,221,238,241,3,12,20,223.90075522569654,16,310.1526532590259,-2.55153268521715,-0.8873168727411465,0.8511665694391535,1.2748516177882458,282,271,292,322,30,40,51,194.2438082321832,30,143.91250119927082,-0.027933253429683058,0.5019225971150023,1.0300349859917812,0.7230298258737292,20635,20846,Adams+Juneau+Monroe+Vernon,Adams,55,1,Wisconsin,WI
55057,55CS001,254,243,266,257,-9,3,14,38.582651000028015,18,269.1286958471947,-3.9364663849274324,-2.2703008668849955,-0.5746850870517242,5.027224999111686,311,297,324,382,58,71,85,266.5817801239662,37,138.0803104941036,0.7707067764222002,1.2560650062265308,1.785847552462614,0.5108151029792504,26753,26796,Adams+Juneau+Monroe+Vernon,Juneau,55,57,Wisconsin,WI
55081,55CS001,362,342,381,419,38,57,77,496.40543690466393,27,233.11532733277215,0.8969870624537978,2.622846776896337,4.351366092932337,0.46157855404738457,441,417,465,547,82,106,130,228.87947390216394,41,88.73306496991732,0.8967234994578293,1.396724678824004,1.9279690364787438,0.38405317647947407,46329,46206,Adams+Juneau+Monroe+Vernon,Monroe,55,81,Wisconsin,WI
55123,55CS001,253,240,266,318,52,65,78,846.0067722156128,22,286.24402302963273,3.751793570737067,5.601293572504636,7.362621456681773,0.3332224333957313,311,295,327,355,28,44,60,143.84958211182408,33,106.85490399248776,-0.17768595456043865,0.3668135869317343,0.888514154940569,0.7264711443180137,30743,30883,Adams+Juneau+Monroe+Vernon,Vernon,55,123,Wisconsin,WI
55003,55CS002,166,159,173,163,-10,-3,4,-79.0255114271801,11,276.3471925637483,-5.26455161650092,-3.5238832046061344,-1.8265333737304723,-5.126746019578771,205,196,213,206,-7,1,10,8.180904951043047,18,111.88463451019393,-1.5854069004518387,-1.0377344890520317,-0.4966970794798467,7.771537559490117,15922,16088,Ashland+Bayfield+Douglas+Price,Ashland,55,3,Wisconsin,WI
55007,55CS002,150,148,152,163,11,13,15,325.6557583518948,17,422.7804028848545,-1.3555752281339175,-0.9731888986290177,-0.5718585847470405,1.206134139125912,186,184,188,190,2,4,6,22.433587014828593,13,79.72036548721408,-0.6968744127416313,-0.5725177331008083,-0.4402045483856289,2.790750573165753,16084,16307,Ashland+Bayfield+Douglas+Price,Bayfield,55,7,Wisconsin,WI
55031,55CS002,363,344,382,466,84,103,122,937.2963176772867,53,480.12682595402555,2.9937621724307037,4.488151001998612,6.331282704309275,0.5073430863140233,445,422,468,498,30,53,76,119.4879897611356,36,81.42217397204506,-0.1554877769433861,0.3938584145532832,0.8940473000781373,0.6687668448145572,44155,44214,Ashland+Bayfield+Douglas+Price,Douglas,55,31,Wisconsin,WI
55099,55CS002,169,163,175,177,2,8,14,229.22571736287318,3,86.20070397241577,-0.22597603172776437,1.4634731526706863,3.1304605288020393,0.3341639896940681,207,200,214,213,-1,6,13,41.35416227340357,18,128.15948736205056,-1.346086838057469,-0.8738452869060949,-0.3592924220543351,2.6438736978357205,13921,14045,Ashland+Bayfield+Douglas+Price,Price,55,99,Wisconsin,WI
55005,55CS003,459,439,479,503,24,44,64,380.3791490114097,55,473.6887434329515,-2.7857113908604347,-0.9260821217870239,0.7734706727706746,1.2177349233753407,565,541,589,618,29,53,77,112.9185734497907,51,109.18900402500643,-0.4716212181578786,0.0457853297556146,0.5501964720644235,0.9489783239340376,46444,46708,Barron+Sawyer+Washburn,Barron,55,5,Wisconsin,WI
55113,55CS003,199,191,207,217,10,18,26,405.33289015882616,16,357.58185272097444,-1.2355695618910356,0.5314253699036395,2.198028278680486,0.8360933047598345,247,238,257,278,21,31,40,169.02108841776547,34,186.11780162031968,-0.7030560201556003,-0.1670861485072142,0.31408945742875777,1.0666073572022206,17898,18268,Barron+Sawyer+Washburn,Sawyer,55,113,Wisconsin,WI
55129,55CS003,184,177,191,203,12,19,26,468.9426633677993,13,315.30439000727625,-0.3056976782775385,1.5451504460654446,3.2674595539636218,0.6393073917403543,227,219,236,278,42,51,59,302.8346177520985,25,149.441090322195,1.0258855787973105,1.54439852739454,2.0864877034288924,0.48392213981934495,16492,16729,Barron+Sawyer+Washburn,Washburn,55,129,Wisconsin,WI
55009,55CS004,1802,1687,1918,2060,142,258,373,384.7588016042931,216,322.24016589401134,-1.0376951393606766,0.6394326807743018,2.264959864192584,0.8342773335653408,2232,2093,2371,2375,4,143,282,53.15137532443259,196,72.73617919819496,-0.6961687354430017,-0.17297754107312152,0.35591877492244256,1.3589837678727141,268123,269467,Brown,Brown,55,9,Wisconsin,WI
55011,55CS005,113,112,114,109,-5,-4,-3,-121.65013427138547,11,331.5000376704588,-4.9330896654999945,-4.520255776097192,-4.116759077922184,-3.6224061993664733,139,137,141,143,2,4,6,29.848785915140216,5,37.579857196542655,-0.20025760901282863,-0.07759478309153915,0.04205848503273772,1.00575675736506,13273,13305,Buffalo+Jackson+Pepin+Trempealeau,Buffalo,55,11,Wisconsin,WI
55053,55CS005,183,174,193,224,31,41,50,770.9798605816421,18,342.1727972626176,2.4725764178321894,4.2670524634824405,5.921812740482827,0.4331359016822294,225,214,236,236,0,11,22,51.862024913038915,15,71.02945354673737,-0.6778737827913996,-0.18195305817407115,0.33756921188805017,1.2549967254186085,21042,21118,Buffalo+Jackson+Pepin+Trempealeau,Jackson,55,53,Wisconsin,WI
55091,55CS005,60,59,60,61,1,1,2,76.76761710834022,3,163.75545851528383,-1.2733921094445042,-0.8784587472169056,-0.4633219637395729,1.2466844709985723,73,73,74,81,7,8,8,102.27137128748284,10,135.8695652173913,-0.4654530414715945,-0.33512761683273523,-0.2093497731765605,1.172721614290177,7328,7360,Buffalo+Jackson+Pepin+Trempealeau,Pepin,55,91,Wisconsin,WI
55121,55CS005,260,247,273,269,-4,9,22,118.3563892734102,33,431.41484459260715,-4.8759044446888185,-3.079736115480529,-1.3427372570850415,3.282479402981445,319,303,335,303,-32,-16,-0,-52.01868763568637,16,52.06299622543278,-1.56606305793737,-1.0352066217028337,-0.5390676032867473,-1.0676358605079015,30597,30732,Buffalo+Jackson+Pepin+Trempealeau,Trempealeau,55,121,Wisconsin,WI
55013,55CS006,178,171,185,170,-15,-8,-1,-185.22748528444657,27,657.334144856969,-10.08500870372717,-8.411728846297262,-6.519669631380147,-4.085821031561587,220,212,229,230,1,10,18,58.03865732415303,23,137.5515818431912,-1.2935333899452446,-0.7980484441432613,-0.2795375420738939,2.148600199486191,16430,16721,Burnett+Polk,Burnett,55,13,Wisconsin,WI
55095,55CS006,407,388,426,423,-3,16,35,143.86061853151037,29,258.5764918303203,-2.8509152169397343,-1.1370421296492101,0.6111198243909548,1.6925087442235769,505,481,528,580,52,75,99,165.9797911934849,83,182.944301174811,-0.6742212499175954,-0.1620351948754205,0.3732237897685271,1.0877632063264933,44861,45369,Burnett+Polk,Polk,55,95,Wisconsin,WI
55015,55CS007,323,300,345,353,8,30,53,230.40957438064206,34,260.84621581188384,-1.91918541868599,-0.3315720974663994,1.4253582577410926,1.0956172227279877,401,374,428,404,-24,3,30,5.6160007750603125,57,108.50942318675044,-1.5384757217388552,-1.018707219045544,-0.502335899910929,14.430068469657595,52138,52530,Calumet+Winnebago,Calumet,55,15,Wisconsin,WI
55139,55CS007,1306,1233,1380,1525,145,219,292,509.35724536545297,172,400.7782554495357,-0.5754849160788073,1.1483287061420802,2.7130412268827553,0.7832483141771303,1605,1517,1694,1730,36,125,213,72.57687993486616,137,79.82473517998439,-0.5851434928782709,-0.07918229171508187,0.45464249461105133,1.0911049022570938,171666,171626,Calumet+Winnebago,Winnebago,55,139,Wisconsin,WI
55017,55CS008,535,507,564,584,20,49,77,294.18228760317766,56,338.8343493321635,-2.1800978016474155,-0.3966781809113421,1.324008258581433,1.1285716795911636,662,628,697,674,-23,12,46,17.400358984330673,64,95.83707696915245,-1.2815651699415938,-0.7813105657454853,-0.27927228792115755,5.0713315549810165,66109,66780,Chippewa+Rusk,Chippewa,55,17,Wisconsin,WI
55107,55CS008,160,154,166,163,-3,3,9,90.35713193846632,17,480.4974561899378,-5.488164842556555,-3.8702123123760828,-2.187919239001617,4.0506712013812685,194,187,202,234,32,40,47,279.66781067732666,28,198.1599433828733,0.30268472736302443,0.811131526121708,1.295340071083962,0.6910668952938265,14152,14130,Chippewa+Rusk,Rusk,55,107,Wisconsin,WI
55019,55CS009,290,275,305,332,27,42,57,485.61401190693914,52,600.0634682514496,-2.990666559502132,-1.0825362692066576,0.6372135619399942,1.2069979073012609,355,338,373,389,16,34,51,96.65354273980431,45,129.57470701719024,-0.8192739906692484,-0.33178627440830377,0.17234674170021888,1.3018268531735337,34663,34729,Clark+Taylor,Clark,55,19,Wisconsin,WI
55119,55CS009,162,153,170,175,5,13,22,267.7818717821517,24,480.8655580044079,-3.922200189550376,-2.064467296400068,-0.28884331189134704,1.670728251058563,198,187,208,226,18,28,39,142.1612674864587,29,145.58963803403785,-0.5315108936900673,-0.024086226868682063,0.4899359487157289,0.9891836900792333,19964,19919,Clark+Taylor,Taylor,55,119,Wisconsin,WI
55021,55CS010,484,459,509,528,19,44,69,303.9418986958416,40,274.1322002535723,-1.624895487930465,0.3543242970407985,1.8522294013896843,0.8820348479903155,595,564,625,631,6,36,67,62.31170824197004,50,85.48323673727582,-0.7239020772923295,-0.23024956279194572,0.268541862637878,1.3352296703846995,58366,58491,Columbia,Columbia,55,21,Wisconsin,WI
55023,55CS011,155,148,162,165,3,10,17,249.09199019604728,11,273.4617775015538,-1.8609437867183634,-0.23695253090666896,1.5170945995230891,0.998210000241484,190,182,199,197,-2,7,15,42.29328009064938,11,68.42072525968774,-0.7718670988157895,-0.27505697565152726,0.27045335640142265,1.4103485095989576,16090,16077,Crawford+Grant+Richland,Crawford,55,23,Wisconsin,WI
55043,55CS011,436,413,458,503,45,67,90,518.7176324134908,51,393.1393332048564,-0.4806667538820845,1.1855153451088252,3.1347728091178944,0.746808001314653,539,512,565,578,13,39,66,75.67004603260771,35,67.1991398510099,-0.41077610235538237,0.09477376082721979,0.5906386073214508,0.8660796657765927,51890,52084,Crawford+Grant+Richland,Grant,55,43,Wisconsin,WI
55103,55CS011,167,160,174,191,17,24,31,554.8675030185948,11,254.73282000810514,1.3540860326663426,2.984033597918336,5.028103462010325,0.4406951357766156,205,196,213,227,14,22,31,130.36529800754735,24,139.3647291098078,-0.5967460040481253,-0.07556873403666532,0.40588208153149985,1.0234450812046718,17273,17221,Crawford+Grant+Richland,Richland,55,103,Wisconsin,WI
55025,55CS012,2977,2735,3218,3366,148,389,631,277.97807239026264,216,154.19264800888035,-0.39426565067752434,1.2527201795858294,2.966677233624782,0.5532727464864896,3713,3422,4004,3768,-236,55,346,9.816676176313383,147,26.07719203634486,-0.6944342755700642,-0.16733173718646566,0.3298522801207601,2.6092659659299433,560338,563711,Dane,Dane,55,25,Wisconsin,WI
55027,55CS013,818,780,856,1019,163,201,239,903.3247256066194,126,566.1076727807794,1.6860463634217526,3.4159002876593916,4.991726894497172,0.6235918377925109,1005,959,1051,1111,60,106,152,118.36734482228816,112,125.4115065057219,-0.595049287097718,-0.08310380535520745,0.42169905041379646,1.0495820600284274,89029,89306,Dodge,Dodge,55,27,Wisconsin,WI
55029,55CS014,311,298,324,325,1,14,27,185.82797060093347,25,335.7169234901131,-3.2513528776770064,-1.4335713808229773,0.16284729495756123,1.6848467924856199,384,368,400,381,-19,-3,13,-9.819106844787193,22,72.53544345532477,-1.3514974600970115,-0.831105824536337,-0.31040302974124,-11.121586151018732,29787,30330,Door+Kewaunee+Manitowoc,Door,55,29,Wisconsin,WI
55061,55CS014,163,154,172,191,19,28,37,543.0138342308351,26,506.649778340722,-1.2949830805737252,0.36894218219667585,2.062558181982312,0.9007101339231994,200,189,210,206,-4,6,17,30.62259572691342,15,73.02112744620777,-0.942902769579284,-0.4340701005013565,0.12792311194779274,2.0574738548206755,20527,20542,Door+Kewaunee+Manitowoc,Kewaunee,55,61,Wisconsin,WI
55071,55CS014,763,728,798,844,46,81,116,401.69346128602825,56,276.82687197993005,-0.4885802049414109,1.221438488485163,2.95373950273133,0.6807718168817916,935,893,977,949,-28,14,56,17.17705025555745,71,87.15078312957235,-1.1790970886839693,-0.7118442478685005,-0.20767467204116777,4.7352908071534605,80917,81468,Door+Kewaunee+Manitowoc,Manitowoc,55,71,Wisconsin,WI
55033,55CS015,302,283,322,306,-16,4,23,33.18877307718698,23,202.451422661356,-3.4157684864226425,-1.695302199938476,0.08900009537871918,4.821304089366152,373,349,396,414,18,41,65,91.1313838319557,33,72.47809184950913,-0.36882961574206474,0.19067313872207736,0.6852779209203992,0.7765979434908669,45443,45531,Dunn+Eau Claire,Dunn,55,33,Wisconsin,WI
55035,55CS015,758,712,803,846,43,88,134,334.7892166516832,81,306.5656135570127,-1.2149587308978151,0.29058779765252346,2.0236061621976416,0.9054612406721122,935,880,990,998,8,63,118,58.84760392799889,68,63.93380970289583,-0.5518345812499594,-0.05201980571025038,0.4146807273580406,1.0693452879147758,105687,106360,Dunn+Eau Claire,Eau Claire,55,35,Wisconsin,WI
55037,55CS016,59,58,59,63,4,4,5,375.0610086618983,13,1149.6794163166041,-8.1441243563955,-7.743850246819707,-7.332960142875391,2.4804415488375895,73,72,74,67,-7,-6,-5,-132.2925116277892,8,174.3679163034002,-3.1924613033474474,-3.0689368401349344,-2.945731403092017,-1.5780398604907302,4523,4588,Florence+Forest+Marinette+Oconto,Florence,55,37,Wisconsin,WI
55041,55CS016,107,106,108,99,-9,-8,-7,-338.80070257281835,21,917.8321678321678,-12.981080383652909,-12.552893527503537,-12.16042389354092,-3.110300094663319,132,131,133,152,19,20,21,213.1226247717112,15,162.26741670272608,0.3823786781295532,0.5116367966705329,0.6362844973680435,0.7246007358367932,9152,9244,Florence+Forest+Marinette+Oconto,Forest,55,41,Wisconsin,WI
55075,55CS016,475,457,492,538,46,63,81,609.8490103283087,63,605.2745352356247,-1.5879193823014934,0.0363367057199609,1.6616716821247375,0.9771057266782327,583,561,604,615,11,32,54,76.89272993634974,44,105.07713617041601,-0.7877431448664736,-0.27582605693463746,0.23127863496767553,1.3253785824350524,41634,41874,Florence+Forest+Marinette+Oconto,Marinette,55,75,Wisconsin,WI
55083,55CS016,332,315,348,396,48,64,81,662.5839745330663,49,503.4418986951608,-0.12807124710788026,1.5704579304712756,3.364608255693356,0.7482138504439839,412,391,432,414,-18,2,23,5.812102217194584,34,86.49198677181379,-1.3246615651299318,-0.8137544961030856,-0.25442317783749535,10.350903603640283,38932,39310,Florence+Forest+Marinette+Oconto,Oconto,55,83,Wisconsin,WI
55039,55CS017,836,792,881,999,118,163,207,626.0671116773206,108,415.54444016929585,0.43878501486484334,2.118244478182936,3.865766084929539,0.6596836210222485,1033,979,1087,1182,95,149,203,142.86874225795825,106,101.61042944785277,-0.10637606834258578,0.40712071645651005,0.9039227240045807,0.7064751086561644,103960,104320,Fond du Lac,Fond du Lac,55,39,Wisconsin,WI
55045,55CS018,296,280,312,340,28,44,60,472.0973906456984,14,151.47007113683696,1.4725260701334386,3.210596830405584,4.8776315090121365,0.31365673822821577,362,343,381,397,16,35,54,93.84035256584886,29,78.40168698802347,-0.3524660125473795,0.1609841673404702,0.6928928747168055,0.8120836248827425,36971,36989,Green+Iowa+Lafayette,Green,55,45,Wisconsin,WI
55049,55CS018,178,168,188,197,9,19,29,326.179637720779,3,50.67567567567568,1.1340657418031965,2.760615553569487,4.399473517187215,0.14771169071618595,218,206,230,212,-18,-6,6,-25.191434086777157,12,50.539083557951486,-1.2665054517049847,-0.7534173355495598,-0.26298310581712586,-2.4089351695441814,23680,23744,Green+Iowa+Lafayette,Iowa,55,49,Wisconsin,WI
55065,55CS018,121,120,123,142,19,21,22,494.108925406003,3,72.14573438345458,3.807101780447653,4.225375859245301,4.610095591955038,0.139235143545008,150,148,152,165,13,15,17,87.61270004411243,14,83.5421888053467,-0.08874233202767459,0.0392928623430664,0.16010295428911192,0.8927355148516076,16633,16758,Green+Iowa+Lafayette,Lafayette,55,65,Wisconsin,WI
55047,55CS019,203,195,212,221,9,18,26,369.94664111514805,19,399.8316498316498,-1.9926147730841437,-0.36430491341082916,1.3338418227974922,1.0226124155421417,251,241,260,286,26,35,45,184.58458096443556,31,161.50039072675176,-0.2949803803825665,0.22990999272589138,0.7237032453396968,0.8509234229576175,19008,19195,Green Lake+Marquette+Waushara,Green Lake,55,47,Wisconsin,WI
55077,55CS019,173,166,180,210,30,37,44,951.091271625409,24,615.4240656452337,1.6121485875302175,3.3930092272256798,4.983707831432297,0.6300836285037383,213,205,221,250,29,37,45,234.69527400698615,25,158.609313538891,0.24263528392662376,0.7506249299003376,1.302563906135038,0.6580216815367319,15599,15762,Green Lake+Marquette+Waushara,Marquette,55,77,Wisconsin,WI
55137,55CS019,246,235,257,289,32,43,54,701.2033553542857,25,407.73057163826144,1.180769056832704,2.8733500698544976,4.685162604057258,0.5682556431970307,304,291,316,331,15,27,40,110.83687417116458,41,165.44265999515778,-1.070231998033253,-0.5495878467398346,-0.01957460463332821,1.4402341052686818,24526,24782,Green Lake+Marquette+Waushara,Waushara,55,137,Wisconsin,WI
55051,55CS020,79,79,80,93,13,14,14,899.2275277226016,19,1252.2656121272037,-3.9260438247217326,-3.538388167642793,-3.1333038320981723,1.2975013835788822,99,98,100,109,9,10,11,164.91971316527818,5,81.02414519526819,0.7099677219173611,0.8417700181647197,0.9747619171242935,0.44733940640613196,6069,6171,Iron+Oneida+Vilas,Iron,55,51,Wisconsin,WI
55085,55CS020,424,408,441,499,58,75,91,793.9563835224264,46,489.92198524908804,1.3664465034451716,3.0132863805393555,4.748088364822822,0.6088961065513436,526,506,545,531,-14,5,25,13.813012567715717,45,117.80721503743652,-1.5548570406900681,-1.0617057713209854,-0.48336320688814033,7.169835594679249,37557,38198,Iron+Oneida+Vilas,Oneida,55,85,Wisconsin,WI
55125,55CS020,280,270,290,282,-8,2,12,41.00454494638113,29,504.6111014442318,-6.357051025032787,-4.6408526482096955,-2.9425552620443143,8.639872025228815,347,335,359,365,6,18,30,75.24556038950855,42,179.06629716478363,-1.577216595740885,-1.0457630809447882,-0.4948069406053164,2.252150056552271,22988,23455,Iron+Oneida+Vilas,Vilas,55,125,Wisconsin,WI
55055,55CS021,608,571,644,713,69,105,142,495.0322574294027,83,391.2187879287793,-0.6529019053745645,1.0238284123462618,2.814764079589325,0.7828356684586396,751,707,795,892,97,141,185,165.98778655979459,85,100.08124242031768,0.14683155306702603,0.6487626400486544,1.168076025901329,0.5986965868043072,84863,84931,Jefferson,Jefferson,55,55,Wisconsin,WI
55059,55CS022,1250,1177,1323,1488,165,238,311,562.7673044163749,229,541.5696058839527,-1.5198909585070075,0.16593783561055514,1.8527970403296645,0.9583059861772593,1538,1451,1625,1708,83,170,257,100.54437020490796,180,106.64644334111458,-0.5719964269633966,-0.04963569116359366,0.4776232545723519,1.0544766113552366,169138,168782,Kenosha,Kenosha,55,59,Wisconsin,WI
55063,55CS023,893,842,945,1004,59,111,162,367.1682536489507,68,225.887355290913,-0.32562867440133686,1.4482088231527712,3.235979670281432,0.6096987183224841,1101,1039,1163,1140,-23,39,101,32.19556798843751,68,56.43434527860308,-0.741335905348036,-0.24473667118082285,0.2855544823921784,1.7088120149571004,120414,120494,La Crosse,La Crosse,55,63,Wisconsin,WI
55067,55CS024,200,192,209,256,47,56,64,1146.3256370889644,35,721.2405337179949,2.5544179349990634,4.277562546523707,6.00579997078712,0.618065336133988,246,236,256,306,50,60,70,307.6284897020649,18,92.34084030164675,1.6639852542576605,2.1493789501180305,2.625201247333374,0.295246426744472,19411,19493,Langlade+Lincoln+Menominee+Shawano,Langlade,55,67,Wisconsin,WI
55069,55CS024,294,281,306,372,66,78,91,1108.2579562634082,68,961.8784921140109,-0.29626709190170786,1.4242839788300035,3.1057847034150234,0.8569812238077855,362,347,376,437,61,75,90,264.0902912164503,50,175.3340112915103,0.4116595767159767,0.892905398812922,1.3781040153319168,0.655216725161365,28278,28517,Langlade+Lincoln+Menominee+Shawano,Lincoln,55,69,Wisconsin,WI
55078,55CS024,41,39,43,59,16,18,20,1643.7410611591572,14,1301.7201301720131,1.7665196499241085,3.4149989547229223,5.025738392417019,0.7495274585626813,51,48,53,65,12,14,17,335.56081739503594,5,116.71335200746965,1.714980092785867,2.207941336786749,2.6921424051387426,0.32519425409885394,4302,4284,Langlade+Lincoln+Menominee+Shawano,Menominee,55,78,Wisconsin,WI
55115,55CS024,407,389,424,477,53,70,88,688.007136252088,63,617.132781505608,-0.9634216443224681,0.7056548998418596,2.519542217020539,0.8843941264831429,498,477,519,505,-14,7,28,16.27838224157487,39,95.45721558644996,-1.3296112563741584,-0.7955771674424573,-0.2909939899378144,5.097575537138328,40834,40856,Langlade+Lincoln+Menominee+Shawano,Shawano,55,115,Wisconsin,WI
55073,55CS025,1065,1006,1124,1209,85,144,203,418.99939988989723,156,453.5114431693472,-2.0680907584704453,-0.36997151201639844,1.3888610038046403,1.074909765093788,1309,1238,1381,1444,63,135,206,97.70509300655247,190,137.98813302056024,-0.9227469553877019,-0.4033726780577033,0.11849880754857967,1.4018718442231972,137593,137693,Marathon,Marathon,55,73,Wisconsin,WI
55079,55CS026,7061,6658,7464,8848,1384,1787,2190,761.6800556765269,898,382.7832777416639,2.041117053757094,3.8151525924597673,5.426087293149437,0.5022701805014568,8623,8143,9103,9500,397,877,1357,94.39189801128377,274,29.47726270265618,0.1618227402556789,0.6425957156865687,1.1502966164359283,0.31193042472671323,938390,929530,Milwaukee,Milwaukee,55,79,Wisconsin,WI
55087,55CS027,1295,1213,1377,1498,121,203,285,425.7485551864816,164,344.38768814014895,-0.8870616348595515,0.8515129069391161,2.4487012237002266,0.8049290908974455,1604,1505,1702,1674,-28,70,169,36.760670421557855,140,73.12958039291479,-0.8787628419072466,-0.36892925682468125,0.15025991780396689,1.961471239036996,190483,191441,Outagamie,Outagamie,55,87,Wisconsin,WI
55089,55CS028,703,664,742,781,39,78,117,341.68524197211474,85,372.0808071964806,-2.0281707411713716,-0.28459942690341516,1.3316199227932322,1.0751833315970705,872,824,920,906,-14,34,82,36.685950081751805,71,76.8714406357593,-0.9037848781118819,-0.41270744718948077,0.09892574799917558,2.035324214777144,91378,92362,Ozaukee,Ozaukee,55,89,Wisconsin,WI
55093,55CS029,247,229,265,287,22,40,58,379.0988007373448,25,236.31723225257585,-0.2280532909179316,1.4160020986392585,3.1235300987413157,0.6082005559569005,306,284,328,371,43,65,87,152.85274972751964,30,70.5401020480143,0.3030298415242239,0.8144126691666222,1.3423062508903503,0.45449899970951585,42316,42529,Pierce+St. Croix,Pierce,55,93,Wisconsin,WI
55109,55CS029,545,505,586,628,42,83,123,353.9220076700994,41,175.44985771444465,0.13574163820967228,1.8572426046115547,3.429049150566933,0.4898080246718436,680,632,729,812,83,132,180,138.62646064593898,90,94.87466003246821,-0.07155492962498818,0.4378643459639946,0.9639679383645108,0.6792256336725702,93474,94862,Pierce+St. Croix,St. Croix,55,109,Wisconsin,WI
55097,55CS030,455,425,486,520,34,65,95,367.58746217293117,45,255.4278416347382,-0.6634653568449768,1.0898937751845674,2.8045074159177723,0.6843094711199559,562,526,599,717,118,155,191,219.462996006057,76,107.87027180469804,0.5742224786587531,1.0893847708044764,1.5917223891182457,0.4883607760606513,70470,70455,Portage,Portage,55,97,Wisconsin,WI
55101,55CS031,1611,1526,1695,1934,239,323,408,656.1437477577792,267,541.5739111473963,-0.6397436175976337,1.1480653542635129,2.9702662798763155,0.8228454218037392,1977,1876,2079,2230,151,253,354,128.20477240688146,217,110.16626475441045,-0.3433945586584769,0.18380306983446354,0.6649773581340075,0.85590992836256,197203,196975,Racine,Racine,55,101,Wisconsin,WI
55105,55CS032,1326,1256,1397,1564,167,238,308,581.2762196895114,139,339.7619222214075,0.7718602473763958,2.382167258812543,4.105802997764594,0.5820626362793876,1636,1551,1720,1771,51,135,220,82.42563800245159,127,77.31033097344056,-0.46573719733565033,0.052248988428701904,0.5667336181664616,0.931064099716587,163644,164273,Rock,Rock,55,105,Wisconsin,WI
55111,55CS033,565,537,593,631,38,66,94,402.2581573293703,44,268.59157293939904,-0.32796503448396175,1.4405537498007177,3.1331977400308335,0.65772828193946,692,658,726,753,27,61,95,92.60144647267424,67,101.97869101978691,-0.6139902248542172,-0.1083083551054223,0.4449070428516811,1.0834560248596556,65527,65700,Sauk,Sauk,55,111,Wisconsin,WI
55117,55CS034,986,935,1037,1137,100,151,202,513.932632344385,127,432.2558137556053,-0.870255606694073,0.7925255744069951,2.5946177837583697,0.8355413672013033,1211,1150,1272,1251,-21,40,101,34.16531692459611,102,86.60581617490979,-1.0223767178497676,-0.5247542438980347,0.029577197228755906,2.47343470455752,117523,117775,Sheboygan,Sheboygan,55,117,Wisconsin,WI
55127,55CS035,835,790,881,998,117,163,208,613.3609251922408,116,437.1131689762697,-0.015333809180256234,1.7574479811175,3.3936293918049873,0.7083009683223943,1033,978,1088,1095,7,62,117,58.25198026778627,95,88.98880614491124,-0.8234516566373559,-0.3136179830911374,0.2057131767156822,1.5034761587030172,106151,106755,Walworth,Walworth,55,127,Wisconsin,WI
55131,55CS036,1017,958,1076,1188,112,171,230,499.50135893866997,117,342.31796072120835,-0.20409799815592658,1.5732026511853892,3.4099683379924546,0.6813285435585297,1258,1187,1329,1387,58,129,200,94.16022104176065,129,94.08504120778936,-0.4923124459160909,0.01124748171991943,0.5094383219762904,0.991521499120236,136715,137110,Washington,Washington,55,131,Wisconsin,WI
55133,55CS037,3024,2848,3199,3670,471,646,822,635.4659311385327,421,413.824286865748,0.41087078846305247,2.244131212791836,3.995343690227458,0.6502082029216886,3739,3528,3950,4148,198,409,620,100.18210124103598,329,80.53421847538199,-0.3770930305248752,0.20614959520974796,0.7244711715685742,0.8019189044205931,406936,408522,Waukesha,Waukesha,55,133,Wisconsin,WI
55135,55CS038,621,599,643,716,73,95,117,735.073387319007,118,915.1898243300889,-3.490087367787526,-1.7625873393519647,-0.1219375810131675,1.232032590154377,756,729,783,759,-24,3,30,5.580516451724988,71,137.62090287065573,-1.8605118818019566,-1.3344379210316104,-0.8186992643948043,18.303477753643303,51574,51591,Waupaca,Waupaca,55,135,Wisconsin,WI
55141,55CS039,721,689,753,824,71,103,135,557.8538846973494,52,281.4614343707713,1.076337259271275,2.754111247202196,4.510097137957996,0.49969487286770436,885,847,923,1051,128,166,204,224.43838719124852,122,164.7023881846287,0.0695385177933881,0.5874971445684525,1.1155836631105271,0.729454583356588,73900,74073,Wood,Wood,55,141,Wisconsin,WI
56003,56CS001,118,117,119,127,8,9,10,321.1067469048145,14,485.9002169197397,-2.0694214381371228,-1.644754946655881,-1.2510822972597617,1.3656021019466313,146,145,147,190,43,44,45,379.04824121762033,32,275.67195037904895,0.9061836820799728,1.0322407655472623,1.1625762682917893,0.7111123778307386,11525,11608,Big Horn+Hot Springs+Park+Washakie,Big Horn,56,3,Wyoming,WY
56017,56CS001,63,63,64,80,16,17,17,1453.2131706017935,2,174.3299193724123,12.404489054874647,12.791127048074982,13.194271373648926,0.1131734578313043,78,77,78,87,9,9,10,197.51957042474757,10,217.3440556400782,-0.33318220600259707,-0.20201644470965457,-0.07046064303718809,0.9912890047258476,4589,4601,Big Horn+Hot Springs+Park+Washakie,Hot Springs,56,17,Wyoming,WY
56029,56CS001,257,244,270,303,33,46,59,619.0992288790595,14,188.96574995782015,2.510322890546645,4.303807499244323,6.036761171660375,0.29871437098798403,322,307,338,440,102,118,133,391.7620029299309,103,342.8533386592104,-0.04296706803701945,0.5011519183852042,0.9947770855676322,0.8677839275416988,29635,30042,Big Horn+Hot Springs+Park+Washakie,Park,56,29,Wyoming,WY
56043,56CS001,72,71,73,87,14,15,16,768.8650218224091,21,1092.7540002601795,-3.6430641274493567,-3.2301197197952547,-2.8211990271217013,1.3311642913969248,89,88,90,113,23,24,25,310.0333840944091,18,233.82696804364772,0.6298351771025688,0.764672101998996,0.8869169921543059,0.7238692284758284,7687,7698,Big Horn+Hot Springs+Park+Washakie,Washakie,56,43,Wyoming,WY
56013,56CS002,362,345,379,486,107,124,141,1267.582610642308,64,652.4620246712203,4.4402807739792305,6.142702731338483,7.821512219991939,0.5106226331192484,445,425,466,579,113,134,154,340.0989244141069,91,231.47559331518835,0.5458617043627191,1.0782789643214379,1.5450652863564567,0.6755598546057386,39236,39313,Fremont+Lincoln+Sublette+Teton,Fremont,56,13,Wyoming,WY
56023,56CS002,123,121,125,155,30,32,34,646.1769413985634,10,202.4086630907803,4.043823366163963,4.426488514390671,4.811262542395829,0.30372637217938403,155,152,157,172,15,17,20,86.60055820683915,15,74.69003634915101,-0.011998898564624836,0.11696326308541372,0.2476154065334088,0.8155724266175808,19762,20083,Fremont+Lincoln+Sublette+Teton,Lincoln,56,23,Wyoming,WY
56035,56CS002,47,46,48,67,19,20,21,884.6186181201799,4,180.03825812985258,6.649000219745824,7.051195357148043,7.4774531666103865,0.19366695361593203,57,56,59,78,19,21,22,236.1512994453059,16,183.88690955062637,0.3935103947654813,0.5200319874250124,0.650632794704427,0.7425446924044838,8887,8701,Fremont+Lincoln+Sublette+Teton,Sublette,56,35,Wyoming,WY
56039,56CS002,87,85,90,79,-11,-8,-6,-141.58228255387627,8,136.89253935660506,-3.199932973773784,-2.786328146968229,-2.393558948138591,-1.099797162801721,110,107,113,89,-24,-21,-18,-88.37422221659283,5,21.23863732902897,-1.222943976098913,-1.0986924171420043,-0.9698180880677719,-0.25246074250383854,23376,23542,Fremont+Lincoln+Sublette+Teton,Teton,56,39,Wyoming,WY
56021,56CS003,744,700,787,821,34,77,121,307.46483186091064,63,250.52690181731418,-1.187768188057743,0.5722472831349387,2.2354470683410748,0.8044109168516955,919,867,971,1259,288,340,392,337.30781675577566,173,171.56230786013208,1.1228092964959158,1.6576919200519977,2.154175318697526,0.507131416440824,100588,100838,Laramie,Laramie,56,21,Wyoming,WY
56025,56CS004,622,587,656,761,105,139,174,696.4021674662057,95,474.4839986514665,0.6010797565170057,2.215701376776625,3.8520765989005783,0.6764844693222771,761,720,802,934,132,173,214,217.06847756174068,131,164.46335982323328,-0.001558667469147233,0.5370587828314328,1.0619636708304538,0.753299764499998,80087,79653,Natrona,Natrona,56,25,Wyoming,WY
56005,56CS005,218,198,238,276,38,58,78,491.7841945127274,39,332.3391563698338,-0.05877600902567878,1.5860039368129546,3.2867938198577815,0.6642721616707117,270,246,294,367,73,97,121,208.26121352521469,86,184.92635200516074,-0.2517805922609398,0.237452632069511,0.7424233981001276,0.8788794076221873,46940,46505,Northeast Wyoming,Campbell,56,5,Wyoming,WY
56011,56CS005,53,52,53,99,46,46,47,2553.59500219055,10,551.7241379310344,19.63777339334043,20.01749979065786,20.423773053917017,0.21148843494083705,65,64,66,82,16,17,18,229.79769221466856,13,178.20424948594928,0.3849843189196706,0.5168245706762132,0.640504941732401,0.7318278017261932,7250,7295,Northeast Wyoming,Crook,56,11,Wyoming,WY
56019,56CS005,83,82,83,84,1,1,2,66.24397714287353,6,282.71881258098716,-2.5722394743585584,-2.1638404784615815,-1.7618934406309994,2.493907793804101,103,102,104,110,6,7,8,85.95731793879924,0,0,0.7345997404785877,0.8545713740335348,0.996317462183877,0,8489,8599,Northeast Wyoming,Johnson,56,19,Wyoming,WY
56033,56CS005,286,272,299,300,1,14,28,186.87951372750058,18,232.21312004128234,-2.075636943460822,-0.4962548928434873,1.4169026026447271,1.1623427672199973,355,339,372,384,12,29,45,90.56626322363374,43,136.28728091027224,-0.9378185306140836,-0.46337337507572285,0.054361369737732826,1.4539522317219369,31006,31551,Northeast Wyoming,Sheridan,56,33,Wyoming,WY
56045,56CS005,55,54,56,68,12,13,14,769.4144568329307,7,410.9790107148099,3.182650353357676,3.590238252366477,4.014352649707337,0.49627609533190437,67,66,68,106,38,39,40,579.4774465539925,11,162.86644951140065,4.029910185064218,4.169834469394453,4.29523814261112,0.2740551486948236,6813,6754,Northeast Wyoming,Weston,56,45,Wyoming,WY
56001,56CS006,172,156,188,213,25,41,57,439.0353908052932,10,106.98619878035734,1.587751943404187,3.345130056190981,5.045337888097177,0.23788772082814413,218,199,237,267,30,49,68,130.25845015637375,34,90.59177746396313,-0.10018847419725961,0.40849735396348597,0.9000513255685803,0.6815361971980491,37388,37531,"Southeast Wyoming, excluding Laramie",Albany,56,1,Wyoming,WY
56007,56CS006,108,107,110,137,27,29,30,790.4938501503507,17,466.93675753622193,2.8374401780513847,3.237797657616044,3.6507665571413117,0.5708547453727572,133,131,135,162,27,29,31,196.67271591786553,31,211.93682915156901,-0.28104723942570037,-0.15044528842478835,-0.021355662862663896,1.0414105777409866,14563,14627,"Southeast Wyoming, excluding Laramie",Carbon,56,7,Wyoming,WY
56009,56CS006,103,101,104,127,23,24,26,709.6251340630014,4,116.45680180508043,5.5440509056318685,5.9274261691577,6.3423491289398255,0.15764261677178992,125,124,127,163,36,38,39,275.9997505546271,36,263.1578947368421,-3.1229130593744695e-4,0.12843049503430934,0.2594196491589451,0.9288700743322564,13739,13680,"Southeast Wyoming, excluding Laramie",Converse,56,9,Wyoming,WY
56015,56CS006,135,129,140,160,20,25,31,804.2682875983417,19,602.6006977481763,0.48701399450956306,2.0454300079459165,3.7448172436425535,0.7208279293875474,165,158,171,188,17,23,30,186.67487725459068,31,247.36674114267475,-1.1515066696133867,-0.5963620078769983,-0.10003759176953919,1.2707993149663412,12612,12532,"Southeast Wyoming, excluding Laramie",Goshen,56,15,Wyoming,WY
56027,56CS006,24,23,25,33,8,9,10,1527.6553205581502,6,990.0990099009902,3.7508505880466214,5.433911334998506,7.067871804600081,0.5849326472566162,29,28,31,36,5,7,8,276.274446104898,8,328.1378178835111,-1.015115211669909,-0.5139255309901408,0.04340503425289922,1.0341835145845137,2424,2438,"Southeast Wyoming, excluding Laramie",Niobrara,56,27,Wyoming,WY
56031,56CS006,84,83,85,96,11,12,13,547.4923233130289,6,278.7780229991869,2.302212006234456,2.6827752554398776,3.0744139302305267,0.46935857001002057,104,103,105,171,66,67,68,771.4331604318782,25,287.75322283609574,4.71717275586446,4.835524783012083,4.967356631514093,0.36752754222685524,8609,8688,"Southeast Wyoming, excluding Laramie",Platte,56,31,Wyoming,WY
56037,56CS007,253,235,271,357,86,104,122,984.8618157598254,22,208.47152468492374,6.073154966942192,7.7826621888792085,9.507202608329397,0.2096586551476405,311,289,332,414,82,103,125,247.3777807708895,82,196.6757009569952,-0.0046543489917731115,0.505420373012305,1.0687517413097272,0.7874074865078896,42212,41693,Sweetwater+Uinta,Sweetwater,56,37,Wyoming,WY
56041,56CS007,139,130,148,154,6,15,24,290.0359972469074,2,39.16768665850673,0.7994607350057937,2.4807715147429885,4.184584659265756,0.12650250896590137,174,163,184,186,2,12,23,60.61954665710058,23,111.61255883922938,-1.0544380216454585,-0.4989333948297145,-6.967670103795101e-4,1.704730332765402,20425,20607,Sweetwater+Uinta,Uinta,56,41,Wyoming,WY
