FIPSCode,csCode,expDeathsMed2020,expDeathsLow2020,expDeathsUp2020,deaths2020,excDeathsLow2020,excDeathsMed2020,excDeathsUp2020,excCDR2020,COVIDDeaths2020,COVIDCDR2020,nonCovidExcCDRLow2020,nonCovidExcCDRMed2020,nonCovidExcCDRUp2020,COVIDExcRatio2020,expDeathsMed2021,expDeathsLow2021,expDeathsUp2021,deaths2021,excDeathsLow2021,excDeathsMed2021,excDeathsUp2021,excCDR2021,COVIDDeaths2021,COVIDCDR2021,nonCovidExcCDRLow2021,nonCovidExcCDRMed2021,nonCovidExcCDRUp2021,COVIDExcRatio2021,pop2020,pop2021,csName,countyName,stateFIPS,countyFIPS,state,stateStr
01001,01CS001,475,450,500,565,65,90,115,185.0670920714162,55,112.92475105225336,20.905035706045012,72.69352204465972,124.63275129263015,0.6034875400538314,587,557,618,707,89,120,150,202.7026152061186,107,181.16248751333322,-29.274781755777376,19.37276003820094,74.83385037758842,0.8863320877705031,58446,59063,Autauga,Autauga,1,1,Alabama,AL
01003,01CS002,2020,1920,2121,2277,156,257,357,132.46274160528046,165,85.20343395658068,-4.889504029348594,47.11763300900111,101.52593704939454,0.6407278832792175,2535,2412,2658,3096,438,561,684,235.4008359759474,435,182.46873912003926,4.467115696841319,51.74057508808239,106.94514403560386,0.7737617828514607,232385,238397,Baldwin,Baldwin,1,3,Alabama,AL
01005,01CS003,257,246,268,324,56,67,78,321.0643306439202,38,181.81093257844586,89.88143793993669,139.58652365474632,190.03351531415527,0.5579609821189985,314,301,327,373,46,59,72,236.309324540613,52,208.0332853256521,-21.70383548770643,28.8283624191025,80.67973698794053,0.8656873036233724,25081,24996,Barbour+Bullock+Henry,Barbour,1,5,Alabama,AL
01011,01CS003,103,102,104,132,28,29,30,337.38314271881796,20,233.326852031888,92.14973859503958,103.90962504633984,116.11894989303923,0.668463532664155,127,126,128,141,13,14,15,135.72147298886685,13,125.99340957549913,-3.054874412391656,10.300649016895854,22.122063775768385,0.8664505402263935,10286,10318,Barbour+Bullock+Henry,Bullock,1,11,Alabama,AL
01067,01CS003,193,185,200,228,28,35,43,247.519145299416,24,167.52952126112498,27.68457866438433,78.98572396119401,129.2970280241133,0.6582704233269768,239,230,248,271,23,32,41,184.7445029065855,37,212.44832338079928,-80.56075742944934,-29.282665445844128,20.077106777291267,1.1152942137627964,17191,17416,Barbour+Bullock+Henry,Henry,1,67,Alabama,AL
01007,01CS004,220,210,229,252,23,32,42,173.51568204378876,40,215.60436598841125,-95.00924885147035,-39.19421458755283,7.6143943850278974,1.2051279310194052,273,261,284,339,55,66,78,295.91371043720045,46,204.99108734402853,43.380169789437666,90.83228192977977,140.61322032195974,0.6824618341440167,22263,22440,Bibb+Chilton+Coosa+Perry,Bibb,1,7,Alabama,AL
01021,01CS004,445,425,464,529,65,84,104,224.8247431763378,76,202.91015885729541,-28.845139821642697,22.684437508621453,79.05619368986764,0.8919339037007686,550,527,574,653,79,103,126,227.22065350479593,107,236.5268137406605,-61.572638291391904,-9.526486806098493,42.48190893953853,1.0309270480496493,44946,45238,Bibb+Chilton+Coosa+Perry,Chilton,1,21,Alabama,AL
01037,01CS004,130,126,135,144,9,14,18,159.06587718177096,19,218.53733346113293,-108.66010071346554,-59.357767257222044,-9.677863053393631,1.2812340870913568,160,154,165,184,19,24,30,232.79790284215306,21,201.1494252873563,-16.289213898811084,33.03320515114724,84.69367774145114,0.829905000494866,10433,10440,Bibb+Chilton+Coosa+Perry,Coosa,1,37,Alabama,AL
01105,01CS004,97,96,98,141,43,44,45,617.3362752337787,23,324.2100317161988,281.33118607424404,292.93519913529457,304.4419087352249,0.5134517177478094,117,116,118,160,42,43,44,512.4148504894005,21,250.92603656350818,249.59566208200863,261.2682167351355,274.50868135207713,0.47853433042376026,8513,8369,Bibb+Chilton+Coosa+Perry,Perry,1,105,Alabama,AL
01009,01CS005,597,572,622,731,109,134,159,272.8737845520424,92,187.4490627546862,35.95811864333956,84.97263459320995,139.9323303280774,0.6818529476026042,733,703,764,841,77,108,138,182.65199217040202,98,165.9694819381171,-39.28907323295479,16.839578830460905,68.581395737499,0.9003172273706371,58896,59047,Blount,Blount,1,9,Alabama,AL
01013,01CS006,215,206,223,256,33,41,50,260.722974795272,52,326.7871170463472,-115.69634118685404,-66.11199305238377,-15.373729910286743,1.2238881300841618,260,250,270,308,38,48,58,254.82076588035727,47,248.5851800920294,-42.85029824220999,7.29302367806285,56.49578328170453,0.9556932048318487,19095,18907,Butler+Crenshaw+Pike,Butler,1,13,Alabama,AL
01041,01CS006,155,150,161,209,48,54,59,487.4786738775008,29,262.74065685164214,173.81965205840552,224.62560823150054,276.49206399854666,0.5291443722091864,188,181,195,241,46,53,60,406.20290578070524,30,229.1125706430426,124.85740082870197,176.11876208837157,223.8776871558059,0.5536259795238084,13245,13094,Butler+Crenshaw+Pike,Crenshaw,1,41,Alabama,AL
01109,01CS006,268,254,282,359,77,91,105,330.3567884850116,45,163.68596544407393,116.57529620926468,167.43026245949983,219.65650240219523,0.4900861715303467,330,313,347,457,110,127,144,385.89638318693756,74,224.31039709002727,112.2449503671985,161.91734142187755,213.63312136752415,0.576740746451049,32990,32990,Butler+Crenshaw+Pike,Pike,1,109,Alabama,AL
01015,01CS007,1265,1215,1315,1535,220,270,320,279.889656535786,175,181.16723461156883,45.34438310328093,99.00043389291866,152.23279805003392,0.6448956143832533,1544,1484,1604,1865,261,321,381,276.5427428810828,302,260.3111666594837,-33.67358840718584,15.076410193863149,69.90355855513235,0.9383805187753727,115915,116015,Calhoun,Calhoun,1,15,Alabama,AL
01017,01CS008,374,359,389,516,127,142,157,494.4851234384223,73,254.2446669569003,183.29914911078566,240.81556512323462,289.4605779856273,0.5105643418440676,455,437,473,576,103,121,139,350.04398640381856,77,222.79447932640838,78.47241755323546,127.28677393728407,179.3286291015184,0.6312577412979659,34455,34561,Chambers+Cleburne+Randolph,Chambers,1,17,Alabama,AL
01029,01CS008,169,162,175,189,14,20,27,162.8548248413061,25,199.60079840319358,-84.13856741548936,-35.71499907007044,12.445137654893918,1.168357141743405,206,198,213,262,49,56,64,373.32853561109096,41,271.6491088584112,49.35249983684936,102.05741390837512,155.67651066430503,0.7149523902035441,15030,15093,Chambers+Cleburne+Randolph,Cleburne,1,29,Alabama,AL
01111,01CS008,250,241,260,306,46,56,65,301.6640233991911,54,293.33212620524193,-43.0556635511765,8.406238220608248,60.050271776734625,0.9551802396264388,304,292,315,356,41,52,64,238.56824218195828,55,250.1591922132266,-65.65245818590236,-11.53705793786812,37.811591898859845,1.0289679986428146,22091,21986,Chambers+Cleburne+Randolph,Randolph,1,111,Alabama,AL
01019,01CS009,291,281,302,398,96,107,117,508.6631962764194,34,162.2201900520854,293.4492474917018,345.64819539287686,395.9574673431341,0.31595116512763194,354,342,367,469,102,115,127,458.30502340132847,64,256.10244097639054,146.40743113872918,202.97964928490032,257.5764781457672,0.5539666266026811,25151,24990,Cherokee+Etowah,Cherokee,1,19,Alabama,AL
01055,01CS009,1201,1156,1245,1446,201,245,290,285.09320051659034,222,258.057016651652,-26.656127824977577,28.046542447273662,78.9119750549798,0.9014915308664233,1464,1411,1518,1820,302,356,409,344.7187777342136,287,278.1115547114229,17.306658804322414,67.58923149996235,117.61867183040229,0.8045165280467081,103233,103196,Cherokee+Etowah,Etowah,1,55,Alabama,AL
01023,01CS010,154,149,160,160,0,6,11,52.6638620776159,31,295.1443986036179,-294.10064803863406,-242.07956089962377,-192.35004761791845,4.7462581639676165,188,182,195,210,15,22,28,174.50777979234692,23,183.32536266539137,-60.79494261683677,-8.795767790155134,39.85069504026503,1.0046411778573652,12604,12546,Choctaw+Clarke+Washington,Choctaw,1,23,Alabama,AL
01025,01CS010,251,242,261,371,110,120,129,621.9711282484104,43,223.7058874533946,347.80157640456525,397.3231092774851,452.9469437298996,0.35668894665483525,305,294,317,389,72,84,95,367.06232745270097,53,232.5173291216987,86.47951202087768,137.3359419656426,186.48525388676111,0.6259730121580123,23066,22794,Choctaw+Clarke+Washington,Clarke,1,25,Alabama,AL
01129,01CS010,165,158,172,188,16,23,30,178.58504063425292,24,186.7219917012448,-58.94275599278056,-7.3856566942945445,43.393064848124304,1.0019148866080985,200,192,208,243,35,43,51,283.8092950726729,32,210.95655613422107,20.863911376451412,70.94950089712353,119.68966200778715,0.7264302008203245,15424,15169,Choctaw+Clarke+Washington,Washington,1,129,Alabama,AL
01027,01CS011,163,157,169,218,49,55,61,468.26572608592477,40,341.46688482606527,74.15580452850683,125.74095680706509,179.89887701078996,0.7161601663717377,200,193,207,235,28,35,42,246.5838782667274,24,169.13319238900633,21.21712656446746,78.90440510086131,130.39627287071184,0.6668472280376192,14057,14190,Clay+Talladega,Clay,1,27,Alabama,AL
01121,01CS011,872,837,907,1038,131,166,201,243.62086450292082,130,190.8420292869114,4.8168164603224755,52.12180902160149,103.01421729234443,0.7786645775159704,1062,1020,1104,1366,262,304,346,372.9506533877608,203,248.7653640184797,77.57895626237338,123.36527283136408,176.53743442595908,0.6648349934571338,81743,81603,Clay+Talladega,Talladega,1,121,Alabama,AL
01031,01CS012,477,454,500,616,116,139,162,312.50942297971875,70,157.02989176153886,104.63618289243215,155.21240061927196,208.1475563945221,0.4988992570851223,592,564,620,716,96,124,152,229.29941314993573,128,236.6645095682722,-62.01859191354492,-8.127341340624422,46.336651557137294,1.0238641323929891,53493,54085,Coffee+Geneva,Coffee,1,31,Alabama,AL
01061,01CS012,315,304,327,402,75,87,98,391.1450935585448,54,243.3894230769231,89.69126191332347,147.85079227370866,194.33761930381257,0.6151598763395266,386,372,400,528,128,142,156,531.5622978057439,81,303.40487695246657,174.13759711637113,228.89181684603315,278.6823755303678,0.5667855813211868,26624,26697,Coffee+Geneva,Geneva,1,61,Alabama,AL
01033,01CS013,649,624,674,675,1,26,51,54.75571526037798,83,174.82885729331227,-170.96718281654032,-118.80583850694894,-69.84637221732355,3.0746120378190223,797,768,827,884,57,87,116,151.0597340505474,117,203.6943540103414,-106.49005748907207,-53.155960642748965,-4.7113397275252025,1.3330720262821305,56970,57439,Colbert,Colbert,1,33,Alabama,AL
01035,01CS014,148,143,153,183,30,35,40,358.4454679534154,27,279.26219617307356,26.56704018322901,80.28369618705747,129.42043237910684,0.7572421235809194,179,173,185,224,39,45,51,394.56544652303677,35,308.07147258163894,33.950135217951,87.77803934721847,137.50746745075543,0.763748892240505,11602,11361,Conecuh+Marengo+Monroe+Wilcox,Conecuh,1,35,Alabama,AL
01091,01CS014,237,229,246,281,35,44,52,273.1437391724552,35,218.90962159908264,6.8816261023407606,54.53511801332145,101.84510374588424,0.7835037713685229,290,280,299,350,51,60,70,317.43179570395284,60,315.20882584712376,-50.32598716532763,3.24295202519877,54.59816945369718,0.9768305192688969,19186,19035,Conecuh+Marengo+Monroe+Wilcox,Marengo,1,91,Alabama,AL
01099,01CS014,219,210,227,283,56,64,73,388.3686305615598,30,181.3053988718775,159.85222562500292,206.33753946374998,258.8206890284105,0.4596851331673997,268,258,278,374,96,106,116,538.5013772664081,52,264.50989368736964,220.71908693210568,274.9693295819739,325.2131461754855,0.4865998552434638,19856,19659,Conecuh+Marengo+Monroe+Wilcox,Monroe,1,99,Alabama,AL
01131,01CS014,139,135,144,150,6,11,15,120.86885584713113,22,251.59630229676927,-180.80361821006724,-131.9967978395076,-77.1403731769937,1.9016379164886252,171,165,176,182,6,11,17,108.84617760185972,25,239.09716908951796,-181.6552651887053,-130.71927704765068,-78.21249317626685,2.0192301251657936,10493,10456,Conecuh+Marengo+Monroe+Wilcox,Wilcox,1,131,Alabama,AL
01039,01CS015,463,447,479,591,112,128,144,410.4733936932571,90,288.63114009300335,69.55527861587294,123.32883550206044,173.7274076538909,0.6977152788840525,566,546,585,723,138,157,177,419.3981602137364,126,335.85670114084655,32.12438104092401,84.16464204902626,135.81312484130495,0.7957488630893562,37418,37516,Convington+Escambia,Covington,1,39,Alabama,AL
01053,01CS015,407,391,423,515,92,108,124,352.8549301261288,58,189.87859773564315,112.21465217745971,162.34410402452048,218.6985687867085,0.533174097568574,498,479,517,658,141,160,179,436.38558403258037,108,294.3260478552352,88.92291647299837,143.2954307601905,195.99146852546977,0.670277367245889,36655,36694,Convington+Escambia,Escambia,1,53,Alabama,AL
01043,01CS016,945,907,982,1043,61,98,136,134.90935392036107,121,165.8405098567741,-85.25592293932928,-29.48517925684947,18.237770947976923,1.2169106761988944,1174,1128,1220,1308,88,134,180,149.79390803307982,187,209.44402132520943,-113.33879209275246,-59.89061790253136,-10.133905725917769,1.3878375705085304,87554,89284,Cullman,Cullman,1,43,Alabama,AL
01045,01CS017,454,433,475,555,80,101,122,246.4719673688327,86,209.58995917869981,-18.131992498879047,35.55799246136991,87.82898358385566,0.8420342724697651,557,532,583,736,153,179,204,362.16709690524675,96,194.635362812481,117.31528997204065,166.1564049161883,218.5533899648225,0.5344268978215955,49239,49323,Dale,Dale,1,45,Alabama,AL
01047,01CS018,436,419,452,560,108,124,141,392.87843272616794,100,315.9224936815501,26.026161511695427,76.73105129582073,128.49531097588007,0.797708216803946,527,508,547,678,131,151,170,399.86372398125866,101,267.89029759694444,77.32448065844304,131.67486395755841,184.32822410680984,0.6655393299553857,37984,37702,Dallas+Lowndes,Dallas,1,47,Alabama,AL
01085,01CS018,134,129,138,156,18,22,27,262.1710369874765,39,459.7701149425287,-249.93036732413472,-198.54331015705299,-143.5854285841771,1.6782380309326392,160,155,165,184,19,24,29,240.88596031155672,33,329.5715569759313,-140.38373172730095,-91.45378743667227,-40.169389013110774,1.3136989111698305,10179,10013,Dallas+Lowndes,Lowndes,1,85,Alabama,AL
01049,01CS019,701,670,731,868,137,167,198,280.4181258930907,123,206.0560371906018,25.180541420536006,73.81784012104185,130.87784705302516,0.730453293462556,859,822,896,1119,223,260,297,361.88526231757595,172,239.6010364137854,70.10609726785006,120.95998454132906,173.26759634087202,0.6595523100461835,71631,71786,DeKalb,DeKalb,1,49,Alabama,AL
01051,01CS020,728,691,766,850,84,122,159,167.19252950156022,93,127.85555530096465,-7.557327420141888,39.417491151975675,88.36869223447646,0.7584836431126196,909,863,955,1087,132,178,224,200.16757907404528,157,176.14522444491814,-26.602890751168143,24.233975884046878,76.23819334071977,0.8750839172511821,87286,89131,Elmore,Elmore,1,51,Alabama,AL
01057,01CS021,193,186,200,236,36,43,50,314.1227429500313,41,302.0999631585411,-37.95874689080693,11.17864495655207,61.47612925787719,0.9396839430005702,233,225,242,316,74,83,91,510.54514222416447,51,315.3793828458351,143.66528287432234,196.5453979860936,243.16100340197406,0.6103380133424046,16286,16171,Fayette+Lamar+Marion,Fayette,1,57,Alabama,AL
01075,01CS021,168,162,174,220,46,52,58,448.2513089053701,45,388.54511440495037,8.761815829774251,57.276153909775076,112.85734451595837,0.8504209288325577,202,195,209,242,33,40,47,293.3072165306923,34,247.7050852396911,-6.963846764460188,45.66714736103308,94.8877280680027,0.8240556674376812,13898,13726,Fayette+Lamar+Marion,Lamar,1,75,Alabama,AL
01093,01CS021,346,333,359,444,85,98,111,400.2622652718359,61,249.31030959435986,100.02490167316004,153.13413053556616,202.72134680076616,0.6165716066635195,420,405,435,510,75,90,105,308.90209885425105,72,246.13701627239163,13.822467759484196,64.76756663668131,114.92517725765245,0.7880907063725917,29361,29252,Fayette+Lamar+Marion,Marion,1,93,Alabama,AL
01059,01CS022,320,306,334,385,51,65,79,243.15335130066035,49,183.8189320995373,6.840741021294465,59.988029101952115,106.2118024663354,0.7444932755865179,391,375,408,491,83,100,116,310.883605397552,57,178.01374141161773,83.25652829456884,133.26720471046198,184.7498877546198,0.5669107308131409,31988,32020,Franklin+Lawrence,Franklin,1,59,Alabama,AL
01079,01CS022,349,335,363,461,98,112,126,406.48801459110354,59,214.31814741940363,141.6104862664947,190.90584602320084,245.13410037502126,0.5225735705973462,427,410,444,583,139,156,173,472.0652936383334,96,290.1529347760382,129.53484196214526,181.31135324019084,231.1329120064035,0.6107354969104112,33035,33086,Franklin+Lawrence,Lawrence,1,79,Alabama,AL
01063,01CS023,86,85,87,133,46,47,48,729.6304582246408,21,324.95164410058027,392.30642628972953,404.6522921632668,417.22061473771714,0.4361156203531146,104,103,105,137,32,33,34,433.521810061593,23,301.0471204188481,120.15372605047067,132.2774797904274,144.12434063433324,0.6740703765055885,7755,7640,Greene+Hale+Pickens+Sumter,Greene,1,63,Alabama,AL
01065,01CS023,169,163,176,216,40,47,53,379.8892866356169,37,300.6093432633717,21.340355427146978,79.27481759781999,130.68436519627167,0.7747386667240116,208,200,215,262,47,54,62,369.00590517546283,40,271.00271002710025,45.49429578022739,97.34542173282581,148.89868521029118,0.7211719846187257,14770,14760,Greene+Hale+Pickens+Sumter,Hale,1,65,Alabama,AL
01107,01CS023,208,200,216,277,61,69,77,431.3756815375389,37,231.69649846057504,147.08930400385515,198.58958139450635,252.35031702790138,0.5294253042759259,252,243,262,340,78,88,97,465.704041481175,48,254.7905939805722,155.1784261737642,209.36441334822126,259.03681342443093,0.5409426877231389,19163,18839,Greene+Hale+Pickens+Sumter,Pickens,1,107,Alabama,AL
01119,01CS023,143,138,148,171,23,28,33,273.64645619916064,27,263.607517695875,-40.91057779949494,10.271646729293318,59.12814171301555,0.9301287850505886,174,168,180,163,-17,-11,-5,-90.54176527618824,14,114.91422473939095,-258.6162087626554,-204.68156945899867,-149.3932235830375,-1.395714700364708,12291,12183,Greene+Hale+Pickens+Sumter,Sumter,1,119,Alabama,AL
01069,01CS024,983,937,1029,1210,181,227,273,254.64545100221574,171,191.63421399153896,11.261990058933403,63.59824912735772,111.23087675450972,0.7492556668589027,1208,1152,1263,1602,339,394,450,367.0935114202871,244,227.14789748554725,87.20667101438075,141.54972707706912,188.95797548410803,0.6172087216173497,107079,107419,Houston,Houston,1,69,Alabama,AL
01071,01CS025,613,591,636,747,111,134,156,306.2946144944639,69,157.94895272976996,98.48192656116973,148.65148514997335,201.61783052623707,0.5118512011537595,751,724,779,985,206,234,261,443.1372270109263,159,301.50182038834953,89.09043075178144,142.48532302670702,196.23436812933457,0.6774812327271432,52422,52736,Jackson,Jackson,1,71,Alabama,AL
01073,01CS026,6243,5954,6532,7235,703,992,1281,177.4974438410455,747,133.6699437971867,-13.381161233766695,42.49834508265018,93.58253479118389,0.7523225041568113,7614,7269,7959,9012,1053,1398,1743,209.09722600861704,1033,154.4961675079454,5.899506863606821,53.257253179572665,106.7296405395888,0.7383442774130914,670607,668625,Jefferson,Jefferson,1,73,Alabama,AL
01077,01CS027,962,922,1002,1121,119,159,199,204.17134661418874,130,166.72010259698624,-11.366956181488753,36.622203969311016,86.03340759087199,0.8114724348778899,1180,1131,1228,1306,78,126,175,134.22347532734545,174,185.1457756969568,-104.96456439286281,-51.24577495392211,0.4737531471684002,1.368535397394988,93570,93980,Lauderdale,Lauderdale,1,77,Alabama,AL
01081,01CS028,1013,938,1088,1123,35,110,185,76.20765001391791,130,89.92598399778643,-64.23593819177984,-12.107273377856048,40.92616301434145,1.169397909717234,1277,1186,1369,1442,73,165,256,93.05482527924468,189,106.87868985953085,-68.53189684972028,-13.035069368467898,38.642455501698564,1.1416184939994507,173476,176836,Lee,Lee,1,81,Alabama,AL
01083,01CS029,768,723,813,925,112,157,202,181.59387142954725,91,105.10207027979095,22.22865106613825,75.43946685674501,132.59895664266077,0.5751175806087722,971,916,1026,1149,123,178,233,166.0996488918772,122,113.964372121699,3.1396097558802882,51.960383927301265,107.06624894321784,0.682283368152951,103899,107051,Limestone,Limestone,1,83,Alabama,AL
01087,01CS030,221,213,229,289,60,68,76,424.75582589147405,38,237.37636647579382,137.40483271503837,188.9581468107879,237.9625899839345,0.5507539436859453,268,258,278,246,-32,-22,-12,-115.24164425768627,30,158.06111696522655,-325.084312712265,-274.0655349079105,-223.13448565908482,-1.4372728095608596,19210,18980,Macon+Tallapoosa,Macon,1,87,Alabama,AL
01123,01CS030,481,464,499,534,35,53,70,153.37820849727225,79,230.7860846702534,-127.88545189284042,-76.75490891340122,-26.056349480489356,1.4765626816576776,591,570,613,729,116,138,159,335.0273904823289,99,241.15168197208487,41.65743911942401,93.91887461607998,149.1299843841244,0.7146012802791333,41077,41053,Macon+Tallapoosa,Tallapoosa,1,123,Alabama,AL
01089,01CS031,2949,2781,3116,3158,42,209,377,64.79876023393327,217,67.15320937669236,-54.603842381109835,-2.248606243614477,48.779365612358426,1.0314090491905572,3677,3474,3881,4090,209,413,616,104.598592308876,466,118.15206119566842,-63.78615414783389,-14.147914641521071,36.34566800773569,1.1268445642370744,387770,394407,Madison,Madison,1,89,Alabama,AL
01095,01CS032,988,946,1030,1227,197,239,281,293.6997520988139,147,180.83405092877354,64.09351516820225,113.01560463875393,163.53610335488472,0.6131424494293509,1213,1163,1264,1424,160,211,261,214.58890458907624,152,154.8839389431209,10.936269970053898,61.24246283149477,107.34618422597227,0.718359368275776,97548,98138,Marshall,Marshall,1,95,Alabama,AL
01097,01CS033,3742,3564,3921,4423,502,681,859,197.23863928825986,473,137.0948263368919,9.634426023765348,58.51903625103858,111.25504006441186,0.6940509342648129,4582,4369,4796,5832,1036,1250,1463,302.39805708713004,844,204.23719585233943,47.71190612546212,98.29422613150929,147.0309075120057,0.6748518568789492,414020,413245,Mobile,Mobile,1,97,Alabama,AL
01101,01CS034,1812,1713,1910,2377,467,565,664,297.61827572489017,337,177.37153283390938,65.95539407640376,118.31928649391286,170.86970193051343,0.5949178096428036,2217,2099,2334,2780,446,563,681,247.59622282982153,384,168.73039168299778,25.28635713287721,79.25300080111539,129.09426832724725,0.6802667631184409,227996,227582,Montgomery,Montgomery,1,101,Alabama,AL
01103,01CS035,1203,1150,1256,1492,236,289,342,282.5293960004631,169,165.1062444028332,67.56632341053027,116.65170194904482,171.34513221612906,0.5823722851116303,1481,1417,1545,1693,148,212,276,171.35279859060367,214,173.11114706358194,-53.93530915414377,1.0359604099307091,46.44019936336914,1.0055146860090292,122830,123620,Morgan,Morgan,1,103,Alabama,AL
01113,01CS036,546,521,572,637,65,91,116,184.77009574928053,70,142.35116677117048,-6.60261570386386,40.118154085149776,95.97816768156943,0.7620361860128801,664,634,695,854,159,190,220,322.78302681724756,124,210.898700591877,59.72868065607107,111.42289714645744,165.8029098242274,0.6499513559063345,59009,58796,Russell,Russell,1,113,Alabama,AL
01115,01CS037,835,795,874,1035,161,200,240,263.30426847496864,136,178.85519523929557,36.341699898261226,83.46331794924788,132.8784561359445,0.6758960553114453,1035,987,1083,1312,229,277,325,299.0754295729017,219,236.64930518035055,13.607089128051976,63.97238584189528,112.02111396469648,0.7884209857740831,91247,92542,St. Clair,St. Clair,1,115,Alabama,AL
01117,01CS038,1347,1251,1444,1592,148,245,341,131.4330848581297,148,79.55777345744823,1.6459479710070302,50.27728900322453,103.80826472924977,0.6028445041715498,1692,1575,1809,1935,126,243,360,107.2171061930564,225,99.36582522213783,-44.704152698568116,7.592392634269392,57.25211480887423,0.9229704205098154,223234,226436,Shelby,Shelby,1,117,Alabama,AL
01125,01CS039,1620,1523,1717,1887,170,267,364,142.45489735493507,252,134.58962182274584,-40.15604049370185,7.902767606960737,61.31381375911677,0.9412586819788755,2003,1886,2120,2344,224,341,458,150.09209944634603,362,159.4516975879627,-58.79357331872303,-8.699215533003564,44.8944526859324,1.0592504573379244,224683,227028,Tuscaloosa,Tuscaloosa,1,125,Alabama,AL
01127,01CS040,877,849,905,1111,206,234,262,432.59134452606503,165,305.2540700542674,75.3512459830592,127.98863057826014,179.44327919826216,0.702635825453851,1065,1032,1099,1294,195,229,262,352.87997945730547,201,309.9030203980943,-8.657317418376358,44.08278516729004,94.67964120201466,0.874390438317995,64864,64859,Walker+Winston,Walker,1,127,Alabama,AL
01133,01CS040,264,254,274,327,53,63,73,321.6602115150268,37,188.6311496303849,82.82363217498147,131.96688804456292,181.71885128886728,0.5772802721938758,323,311,335,424,89,101,113,427.14737200315494,71,300.47822590884084,79.11107355973184,126.43009367880684,178.0760827101006,0.696552001162435,23538,23629,Walker+Winston,Winston,1,133,Alabama,AL
02020,02CS001,1470,1345,1595,1748,153,278,403,115.00520233771599,117,48.39610349320593,11.984069210154516,67.67767183101593,115.77102923946721,0.4193085090096149,1823,1674,1972,2370,398,547,696,189.7310287547782,278,96.36449349712987,45.91889470122223,93.22304286745303,146.09266892716354,0.5069743159723356,290106,288488,Anchorage,Anchorage,2,20,Alaska,AK
02090,02CS002,396,355,437,473,36,77,118,97.06920228075009,19,23.85411326518869,27.005142064880822,73.58401081824465,123.94375872216372,0.24260554723250496,495,446,545,684,139,189,238,197.40845540644264,90,94.19349436932222,51.7156613135226,100.3489165759522,159.68958694546046,0.4746339005724008,95581,95548,Fairbanks North Star,Fairbanks North Star,2,90,Alaska,AK
02122,02CS003,392,366,417,393,-24,1,27,2.721277385875899,18,36.61823791682913,-85.54540698807966,-36.65796399886619,19.821173518231003,7.699986038295857,488,457,519,589,70,101,132,169.37111903601922,66,110.66398390342052,3.8719779283593527,58.84751975376728,107.98202740320995,0.646976775500922,58987,59640,Kenai Peninsula,Kenai Peninsula,2,122,Alaska,AK
02170,02CS004,535,488,581,639,58,104,151,115.90419586264402,33,36.680591706110654,27.65474909376739,78.72642015919931,129.56488743876383,0.31346718972679205,679,622,736,991,255,312,369,282.98768049936336,165,149.7060317921173,86.07228389906805,133.27918126712993,185.41627051985662,0.5273288968804029,107959,110216,Matanuska-Susitna,Matanuska-Susitna,2,170,Alaska,AK
02140,02CS005,48,47,49,52,3,4,5,64.69438412397811,4,61.98347107438016,-9.748005092665084,2.8670838602085773,14.238380499918529,0.7729551860918993,58,57,59,69,10,11,12,148.48331617589199,7,92.1901751613328,44.52883069225084,56.57475470580638,68.1882169382536,0.5702955130873446,7744,7593,Northern Alaska,Northern Alaska,2,140,Alaska,AK
02180,02CS005,63,62,64,66,2,3,4,30.57285615595256,8,95.84664536741214,-77.54966764678163,-65.37809123707613,-53.57938448585906,2.252369947575741,77,76,78,94,16,17,18,170.84666618969067,2,20.224491859642026,137.5444113644193,150.7101865418543,162.90738522794962,0.1117628948072204,10016,9889,Northern Alaska,Nome,2,180,Alaska,AK
02185,02CS005,55,54,56,45,-11,-10,-9,-108.45723051047953,8,89.19446251045247,-209.59356048386255,-197.53546406695875,-185.15051034420568,-0.9166207646677272,69,67,70,59,-11,-10,-8,-90.03310225781905,6,54.66970387243736,-157.11371203238852,-144.65460021004216,-132.23462382465095,-0.6755894792228626,10763,10975,Northern Alaska,North Slope,2,185,Alaska,AK
02240,02CS005,91,90,92,108,16,17,18,146.7256323836513,6,52.07203297895422,83.21459577473588,94.4892939117721,107.58959763238464,0.3350745858089746,112,110,114,146,32,34,36,245.66723338858247,10,72.33796296296296,161.16973564996192,173.13609765586116,185.62930304057613,0.28603269450147334,13827,13824,Northern Alaska,Southeast Fairbanks,2,240,Alaska,AK
02261,02CS005,53,52,54,3,-51,-50,-49,-627.0310208921522,3,37.367656217562796,-676.3025172793889,-664.2768147446675,-653.0476245271652,-0.06080242115228873,65,64,67,4,-63,-61,-60,-640.9007035803633,4,41.71881518564873,-694.6190569947064,-682.7872193969087,-670.304312365035,-0.06617087098366915,9634,9588,Northern Alaska,Valdez-Cordova,2,261,Alaska,AK
02100,02CS006,10,10,10,19,9,9,9,501.88842125766456,7,390.15327450069674,99.88164467672703,112.24856046442285,123.97225615031564,0.699670122464755,12,12,12,21,9,9,9,441.44368878119957,5,241.196333815726,188.71677802098003,199.9069911244364,212.540434696234,0.49255611428746926,2153,2073,Southeast Alaska,Haines,2,100,Alaska,AK
02110,02CS006,166,152,180,171,-9,5,19,17.83116400147424,4,14.930479952720148,-47.50186104095153,3.4747465263553057,52.30999414922834,0.6923868259802357,205,188,221,218,-3,13,30,41.95610833175011,13,40.61865333541634,-48.24280535745604,1.4956076171919976,51.43379370496974,0.9010225063715359,32149,32005,Southeast Alaska,Juneau,2,110,Alaska,AK
02195,02CS006,192,181,203,231,28,39,50,184.82613652750882,8,38.03185167577846,94.43268536989515,146.38386702352332,197.28870697185468,0.20061097165468686,233,220,246,348,102,115,128,461.7180073428608,16,64.17455478902615,344.14430484341875,397.2894640003049,449.3777567144077,0.13779379472513953,25242,24932,Southeast Alaska,Petersburg,2,195,Alaska,AK
02220,02CS006,51,50,52,56,4,5,6,70.17203993214129,3,42.67425320056899,15.731794215951687,27.13156779446401,39.32920904733556,0.505638338797453,62,61,64,76,12,14,15,160.5440681646626,1,11.890606420927467,135.74149959705966,148.3375479237889,160.41769983886232,0.06895716566000429,8436,8410,Southeast Alaska,Sitka,2,220,Alaska,AK
02232,02CS006,32,30,34,20,-14,-12,-10,-350.3459654394731,2,56.91249703580745,-458.4617475152338,-409.67443703177906,-352.6640526555222,-0.17680744069769264,39,37,41,44,3,5,7,117.25427556945013,6,143.36917562724014,-77.09214751481863,-24.410660107652124,24.86206466517816,1.0157283103671055,4217,4185,Southeast Alaska,Southeast Alaska,2,232,Alaska,AK
02010,02CS007,35,34,36,18,-18,-17,-16,-236.49800795748828,7,96.88581314878893,-345.1538799723663,-333.29455031490505,-320.97989066567135,-0.43513447099838143,43,42,44,28,-16,-15,-14,-172.42801944298998,7,82.53743662303974,-267.2558149255268,-254.78533733403614,-242.90464830318015,-0.51381349677809,8670,8481,Southwest Alaska,Southwest Alaska,2,10,Alaska,AK
02050,02CS007,108,106,110,115,5,7,9,45.90473382123981,15,96.69101847872797,-63.10087272672946,-51.114648562834624,-39.12665756307958,1.8469825733751408,133,130,135,146,11,13,16,71.04488103748577,22,118.47065158858373,-59.53200155262954,-47.374679876195934,-35.5197622699395,1.5500561308140561,18616,18570,Southwest Alaska,Bethel,2,50,Alaska,AK
02060,02CS007,7,7,7,5,-2,-2,-2,-343.96873976205865,5,720.2881152460984,-1076.499196434841,-1064.468490022616,-1052.7284454591695,-3.60304182723741,9,9,9,15,6,6,6,703.1588379684333,4,477.89725209080046,213.33277245919993,224.99214256876763,237.62267743885187,0.5809360484865159,833,837,Southwest Alaska,Bristol Bay,2,60,Alaska,AK
02070,02CS007,44,43,45,53,8,9,10,171.10856359326755,3,57.01615457713018,102.07226764117178,113.60483161198316,125.73699292665341,0.2999051623581022,53,52,54,65,11,12,13,190.0410105102935,11,177.33354828308885,0.476796556882195,12.825810223746341,25.987513384902936,0.8601650157394138,6314,6203,Southwest Alaska,Dillingham,2,70,Alaska,AK
02150,02CS007,54,53,55,66,11,12,13,110.43472018805423,1,9.212344541685859,88.33831977049692,101.24699771945629,112.92379706697922,0.07699599286029113,66,64,68,104,36,38,40,296.4825504794114,6,46.798221667576634,236.7597183850395,249.81595816032433,262.0018877185164,0.1537987215436858,13026,12821,Southwest Alaska,Kodiak Island,2,150,Alaska,AK
02158,02CS007,53,52,54,52,-2,-1,-0,-18.103748979467714,4,57.40940078937926,-87.36670552867122,-75.76843356480467,-62.31532671050386,-15.303465220216207,66,65,67,84,17,18,19,219.72121584452566,10,119.61722488038276,86.78712944546828,99.44721456997215,112.95079367109084,0.5162970814392943,8361,8360,Southwest Alaska,Southwest Alaska,2,158,Alaska,AK
04001,04CS001,564,557,571,1042,471,478,485,858.9313548331374,300,539.3500831498045,307.15782212542126,319.6041731048264,332.0003548873182,0.6266199524673407,682,674,690,1194,504,512,520,779.8710753304491,270,411.1904725644579,356.1918369945765,368.76865653085315,381.5502257990764,0.5262268087319549,66747,65663,Apache,Apache,4,1,Arizona,AZ
04003,04CS002,1150,1096,1204,1387,183,237,291,225.96593374031116,171,163.1990837946173,10.418351317495153,60.584512795811484,114.16844782950773,0.7191911586410206,1417,1352,1482,1833,351,416,481,330.26095903445196,311,246.91358024691357,32.1844768786823,83.64726586541326,133.67301253743221,0.7458387874255558,125736,125955,Cochise+Graham+Greenee,Cochise,4,3,Arizona,AZ
04009,04CS002,256,240,273,322,49,66,82,203.41644182744045,50,155.0387596899225,-0.8146007338054564,48.666242427394074,98.89501947165985,0.7507304326785392,320,300,340,489,149,169,189,432.75075841009743,88,225.72205407069205,157.0989271763172,205.8576511215067,258.42421074872925,0.5185248583507244,38700,38986,Cochise+Graham+Greenee,Graham,4,9,Arizona,AZ
04011,04CS002,56,55,57,62,5,6,7,79.33955306941694,5,63.14460113660282,3.782500514480525,16.07495406168512,29.41896996001701,0.6865896417880715,68,67,69,96,27,28,29,294.88336917265,25,265.36461097548033,17.49410391545824,29.502071138078875,42.583309632434656,0.8686297496866247,9502,9421,Cochise+Graham+Greenee,Greenlee,4,11,Arizona,AZ
04005,04CS003,747,685,810,1027,217,280,342,231.69362139683568,207,171.37889638614064,8.815467117789783,59.64584549836515,113.58545505361676,0.7370452530643131,929,854,1004,1194,190,265,340,182.86666156523026,184,126.84319010623118,3.787430239587376,56.197178291920636,108.69740936362201,0.6910325548373516,144942,145061,Coconino,Coconino,4,5,Arizona,AZ
04007,04CS004,659,636,682,834,152,175,198,392.65250394256014,118,264.93039964077235,74.60977739307958,129.3589926255883,174.31589768765397,0.6708836622529601,804,776,831,1054,223,250,278,467.27638909587046,157,293.194890565474,122.84429009987566,173.8716562335832,225.97854327415632,0.6249573057802864,53448,53548,Gila,Gila,4,7,Arizona,AZ
04025,04CS005,2665,2563,2768,3143,375,478,580,241.38172027691363,252,127.34722754473366,62.296777744835545,112.6573033290067,167.58250101361344,0.5264739013564554,3304,3179,3428,4118,690,814,939,337.2092326440353,595,246.37987221373348,39.468310660531635,91.20350240632395,145.05481557092978,0.729747799396492,237461,241497,La Paz+Yavapai,Yavapai,4,25,Arizona,AZ
04013,04CS006,27383,25469,29296,34979,5683,7596,9510,204.73721097539828,4403,118.67199488261272,35.416262484713656,85.44131916873756,137.37822944921595,0.5795545121292061,34149,31832,36466,44161,7695,10012,12329,223.08415397089297,6755,150.50932533944254,20.515512019546563,74.9067194399484,123.05017301230585,0.6746077281105719,4452272,4488094,Maricopa,Maricopa,4,13,Arizona,AZ
04015,04CS007,2859,2767,2951,3445,494,586,678,327.9086290279523,326,182.44992188046547,98.55289181066958,144.85741431489254,194.86490528889183,0.5554567264994196,3529,3417,3641,4621,980,1092,1204,502.9444204459216,767,353.1892947265661,97.94586831385901,149.76255123132935,202.54385012303698,0.7016008254503172,214415,217164,Mohave,Mohave,4,15,Arizona,AZ
04017,04CS008,901,890,912,1519,607,618,629,689.309704713326,365,407.21457791000364,269.7379872152686,282.31944344964944,293.3344403333762,0.5898024621610566,1113,1100,1127,1845,718,732,745,677.7677205437312,366,339.0427138238646,325.90724672294624,339.0631797038184,351.9393537553684,0.4995516101153319,107560,107951,Navajo,Navajo,4,17,Arizona,AZ
04019,04CS009,8313,7863,8763,10505,1742,2192,2642,251.3106818242982,1182,135.49827426937065,67.67879704591098,115.33190402642883,172.69346541734816,0.5389205674100641,10256,9713,10799,12824,2025,2568,3111,244.3114806253039,1745,166.01781766010967,28.354462019493972,78.86641153044016,131.39691547460131,0.6792689077422881,1046803,1051092,Pima+Santa Cruz,Pima,4,19,Arizona,AZ
04023,04CS009,264,243,284,413,129,149,170,376.87399896808284,103,259.98064868957977,65.48428597581908,117.02990697380176,164.67406951341033,0.68524502463939585,329,304,354,427,73,98,123,204.8837314502632,79,165.10271897009343,-7.164354381870314,38.434765852826786,92.23103664757758,0.7976992603511586,47542,47849,Pima+Santa Cruz,Santa Cruz,4,23,Arizona,AZ
04021,04CS010,2671,2485,2858,3650,792,979,1165,269.1145220980585,389,106.98103997121504,112.11647660128692,161.32335738007566,210.11762230040983,0.3971239600260413,3386,3155,3616,4938,1322,1552,1783,347.58965346743844,880,197.0249236528421,102.12733126772973,149.6663006860305,203.5909179796635,0.5664670805487196,436339,446644,Pinal,Pinal,4,21,Arizona,AZ
04027,04CS011,1530,1434,1626,2445,819,915,1011,491.62053131785416,576,309.44450413667136,132.49268903501064,182.26158061343895,235.2330488618182,0.6287506332963693,1895,1779,2010,2633,623,738,854,331.0557404559687,468,209.81748568712987,70.18651331548143,119.09723859973012,170.94684198687582,0.6329258240755644,223368,223051,Yuma,Yuma,4,27,Arizona,AZ
05001,05CS001,205,197,212,259,47,54,62,380.399767858328,22,154.16058394160584,173.27542885587965,225.71183141118996,278.39538306150445,0.3979291990832768,247,239,256,336,80,89,97,529.0820864026956,30,178.80557873405652,301.35503193375723,349.70714846853906,403.13265993120825,0.3341896294384417,17125,16778,Arkansas (county)+Monroe+Phillips+Prairie,Arkansas (county),5,1,Arkansas,AR
05095,05CS001,98,97,99,116,17,18,19,316.84058213120454,11,195.55555555555554,109.73161115019502,121.24144786414396,133.73487298202804,0.5844137052394481,119,119,120,136,16,17,17,247.489149533149,20,298.7303958177745,-64.78001993517623,-51.12032994154597,-38.81902744591697,1.138342893769696,6750,6695,Arkansas (county)+Monroe+Phillips+Prairie,Monroe,5,95,Arkansas,AR
05107,05CS001,197,190,204,266,62,69,76,498.49645490874116,38,274.9969846821855,172.7348281680526,222.6077403920013,274.5224915495747,0.5437589920485332,235,227,243,311,68,76,84,474.7888217238418,52,325.30497341257427,95.69732994741683,149.2633672980932,196.32071630078877,0.6762468903122782,16582,15985,Arkansas (county)+Monroe+Phillips+Prairie,Phillips,5,107,Arkansas,AR
05117,05CS001,93,93,94,127,33,34,34,490.851418421308,14,204.52885317750182,274.2071138036088,285.9193831213478,297.7914863610151,0.4046385498425678,114,113,115,145,30,31,32,380.846184585931,20,245.36866642129797,123.38524548915451,135.69237028329158,148.30109421595316,0.6241657146398661,8214,8151,Arkansas (county)+Monroe+Phillips+Prairie,Prairie,5,117,Arkansas,AR
05005,05CS002,581,563,599,708,109,127,145,364.35855064869577,75,215.55337341029386,98.84740108815997,148.98779408523654,199.48815972609873,0.5869668868635485,711,689,732,928,196,217,239,516.5279644167106,125,297.10265490932426,169.89117022919038,218.4538169587173,271.35658541936806,0.5725571687178318,41753,42073,Baxter+Marion,Baxter,5,5,Arkansas,AR
05089,05CS002,224,217,231,268,37,44,51,314.3305035209332,23,163.8760242251514,97.3598194749768,148.91187102765244,199.88110241952552,0.5097937342130018,273,265,282,305,23,32,40,186.2045210266762,43,253.52278757148753,-117.98575324252724,-67.7555181374745,-15.159515050339289,1.3197410719897433,16842,16961,Baxter+Marion,Marion,5,89,Arkansas,AR
05007,05CS003,1706,1583,1830,1959,129,253,376,105.99603408028707,282,118.2526287098093,-64.10709912175373,-9.878687549454613,37.084657047160604,1.1112363665739555,2150,1999,2301,2520,219,370,521,126.47457814055554,372,127.12646349215028,-55.727640630248494,-1.8352181035888668,49.28400708619686,1.0024456438763074,286167,292622,Benton,Benton,5,7,Arkansas,AR
05009,05CS004,385,369,401,478,77,93,109,298.5392463891645,63,201.9230769230769,45.639419460900534,95.31382337031702,146.83334497751008,0.6691858868771638,473,454,493,582,89,109,128,287.6538762256519,68,180.08474576271186,53.800950010443486,105.58503192658692,156.66895226556423,0.6203354895572113,37440,37760,Boone+Carroll+Madison,Boone,5,9,Arkansas,AR
05015,05CS004,280,268,292,314,22,34,46,145.54973876294636,38,161.4273576890399,-66.65724809752774,-14.534561232462327,30.957273585408288,1.0776348415006867,343,329,358,394,36,51,65,178.76278367223057,40,140.8401112636879,-9.939464003161063,38.57357851510421,89.8739189275011,0.7726420105902637,28248,28401,Boone+Carroll+Madison,Carroll,5,15,Arkansas,AR
05087,05CS004,169,162,176,154,-22,-15,-8,-109.20158810937656,10,72.33709084332992,-233.3919215772011,-181.37868977912922,-129.57376713440962,-0.7094105666899645,210,201,219,260,41,50,59,296.16824450533454,32,189.3491124260355,57.72768527153769,108.11794673565919,158.86660865875874,0.6268065578489356,16589,16900,Boone+Carroll+Madison,Madison,5,87,Arkansas,AR
05011,05CS005,132,128,137,167,30,35,39,393.1800708766044,27,307.63387770603873,31.579804663630313,84.94356477051538,136.766741418633,0.7603897924894973,160,155,166,165,-1,5,10,45.502551771981345,18,172.7281450916419,-174.3579609663507,-127.5797459565207,-79.64843827971204,3.134894008415737,10532,10421,Bradley+Calhoun+Cleveland+Union,Bradley,5,11,Arkansas,AR
05013,05CS005,59,59,60,69,9,10,10,241.90944457151755,4,100.27156883225402,130.3131876973149,141.57797110805058,154.3409835721056,0.3755808266041666,72,72,73,89,16,17,17,356.34284940949215,5,105.50749103186325,238.19371688447674,250.67658450870334,264.42610539755503,0.2795312519535756,4787,4739,Bradley+Calhoun+Cleveland+Union,Calhoun,5,13,Arkansas,AR
05025,05CS005,87,86,87,110,23,23,24,368.834491967213,20,315.872598052119,40.86763178591415,52.968713318028946,65.4792491814337,0.8212415579925513,105,104,106,135,29,30,31,394.8691079772736,11,146.31550944400107,236.39220242440499,248.70453968632876,261.21394904783483,0.3584666285727832,7598,7518,Bradley+Calhoun+Cleveland+Union,Cleveland,5,25,Arkansas,AR
05139,05CS005,439,422,456,539,83,100,117,308.82716102789885,70,216.33872463170908,42.81201583410029,91.75192608507214,142.63635276791442,0.6935762695009516,531,511,551,617,66,86,106,223.45791813281838,70,182.17306441119064,-12.993224772675282,39.43376944600405,95.19317648907975,0.8058601687059327,38828,38425,Bradley+Calhoun+Cleveland+Union,Union,5,139,Arkansas,AR
05019,05CS006,202,193,211,243,32,41,50,228.18775186468497,18,100.44642857142856,76.62686436893745,129.79940989811345,176.9983740203658,0.4296840531322767,247,236,258,291,33,44,55,207.38154896487944,35,164.11122051859147,-8.383297799205662,42.27873749896263,95.8534455761553,0.7738524037600483,21504,21327,Clark+Dallas+Ouachita,Clark,5,19,Arkansas,AR
05039,05CS006,83,82,83,105,22,22,23,409.83316413973495,14,258.26287471176016,139.41840903337092,151.69073667008857,163.56712053869248,0.6030227088891988,99,98,99,120,21,21,22,337.61616207454443,5,79.01390644753477,246.23211043081767,258.6458385774033,271.5025462747069,0.2235700941648274,6505,6328,Clark+Dallas+Ouachita,Dallas,5,39,Arkansas,AR
05103,05CS006,280,271,290,341,51,61,70,321.31692196924604,38,201.09366731345912,71.11886028646241,119.87810503731855,168.47480376486013,0.6157018121145087,338,327,350,393,43,55,66,245.70841912449868,46,205.8349740468946,-15.981659514360645,38.830035668998164,91.64204329412733,0.8227373481236558,22676,22348,Clark+Dallas+Ouachita,Ouachita,5,103,Arkansas,AR
05021,05CS007,198,192,204,216,12,18,24,146.8405970138394,27,223.6024844720497,-124.67606413755497,-75.11184536997202,-21.167360472020203,1.4414605193626586,239,232,246,280,34,41,48,285.45113102950705,41,285.2570792458081,-50.50132629249082,-0.8867665859834022,56.528640201259556,0.9755426447324376,14490,14373,Clay+Greene,Clay,5,21,Arkansas,AR
05055,05CS007,432,412,452,495,43,63,83,164.67571931776052,56,146.73450225997334,-34.678651429427944,17.64830366357355,66.54129837501866,0.8770952162909746,532,509,556,612,56,80,103,171.9299745461334,73,157.858316754606,-33.9369789508413,13.087118771231935,68.92661142166408,0.9067501000673381,45797,46244,Clay+Greene,Greene,5,55,Arkansas,AR
05027,05CS008,235,226,245,319,74,84,93,438.73698760103485,30,157.59061460339692,227.89961556934645,281.9744868442257,331.444738087855,0.3549418043935525,285,274,297,306,9,21,32,91.58426059518334,24,105.81077506392734,-68.30629459419849,-16.25624938261628,36.77921181103529,1.1022754553755916,22844,22682,Columbia+Lafayette+Miller,Columbia,5,27,Arkansas,AR
05073,05CS008,77,76,77,105,28,28,29,539.9848548936669,5,94.74182851729039,433.4941106727378,445.1130202352717,457.2543008234594,0.1695047369273826,92,91,92,105,13,13,14,216.38477698226436,13,210.28793270786153,-5.79470379853264,6.011422704758773,20.218238590987067,0.9042278759004573,6333,6182,Columbia+Lafayette+Miller,Lafayette,5,73,Arkansas,AR
05091,05CS008,415,396,433,503,70,88,107,248.37181610566583,61,171.4486473825975,22.757493546241708,76.2063506329107,129.16431831745234,0.6825661888731155,505,483,527,656,129,151,173,353.98764260888373,102,239.2288388019795,65.33804706781251,115.30626134003661,166.20991322085632,0.6713630876302099,42695,42637,Columbia+Lafayette+Miller,Miller,5,91,Arkansas,AR
05029,05CS009,234,225,243,229,-14,-5,4,-30.27643919502612,11,63.55320173326914,-138.2434563002508,-95.35285457056834,-42.072595638752865,-2.594127309632951,287,276,298,301,3,14,25,66.43519889513644,27,129.48398235181278,-117.53126286449294,-62.080989471022534,-12.775964719584717,1.8178063005775507,20770,20852,Conway+Pope,Conway,5,29,Arkansas,AR
05115,05CS009,515,488,543,642,99,127,154,239.56137742834446,56,105.81177470909635,82.26557333798763,132.4348497189374,184.4301279316257,0.43823314124643353,636,603,668,753,85,117,150,184.3478494790222,93,145.94187433306132,-11.89505894467937,36.44431748700087,90.31131692343692,0.7849835277741517,63509,63724,Conway+Pope,Pope,5,115,Arkansas,AR
05031,05CS010,834,786,882,1005,123,171,219,184.15690115659444,99,106.52224593368362,27.08685992786986,79.55403199314418,127.35754663951633,0.57507200641783,1030,973,1088,1190,102,160,217,142.34307249905598,104,92.7544504298812,0.07436204872573056,50.65796703783876,101.6613460105819,0.6475685960122087,111526,112124,Craighead,Craighead,5,31,Arkansas,AR
05033,05CS011,521,495,547,663,116,142,168,280.4481540564711,56,110.86181866173948,118.61949212214691,170.94708417330375,218.73191621619554,0.3925314969891423,637,606,668,874,206,237,268,392.86934814691756,123,203.8516357850774,137.0084387186267,189.38318213823584,237.9191463914136,0.5166992421152086,60616,60338,Crawford,Crawford,5,33,Arkansas,AR
05035,05CS012,435,414,456,555,99,120,141,299.9947020207922,68,170.03542404667638,79.57220092223467,130.40040988277227,179.90280149121676,0.5621094521141192,531,506,555,687,132,156,181,328.4331055009015,87,182.75775144945803,91.75110620068189,146.83631554407188,196.62302475258855,0.5529170342582632,47990,47604,Crittenden,Crittenden,5,35,Arkansas,AR
05037,05CS013,200,193,208,223,15,23,30,162.25493711162855,29,208.49559642921335,-96.2690913139136,-45.1844826350389,3.207579067470008,1.2304658440948433,245,236,254,266,12,21,30,125.65488645445676,29,173.7255136883724,-100.70004483745674,-46.08136343572588,2.3408013476210194,1.3196472146823512,16691,16693,Cross+Lee+St. Francis,Cross,5,37,Arkansas,AR
05077,05CS013,93,93,94,144,50,51,51,706.6353692435196,17,237.45780467931553,455.96796346898134,468.9086511582724,481.70708015605175,0.3295263106344774,115,114,116,155,39,40,41,465.21908862569035,27,313.73460376481523,139.50430412132587,151.67609368314638,163.47455746832117,0.6579467639002669,8591,8606,Cross+Lee+St. Francis,Lee,5,77,Arkansas,AR
05123,05CS013,211,201,221,271,50,60,70,310.09089153151535,32,164.83516483516485,88.63740766164774,144.12043513141973,196.77838595668422,0.522884545326457,255,244,267,337,70,82,93,358.45458639277786,46,201.89606741573036,111.34412033682213,156.2063462347431,210.0756051043882,0.5564272043910784,23296,22784,Cross+Lee+St. Francis,St. Francis,5,123,Arkansas,AR
05045,05CS014,852,799,906,954,48,102,155,98.13721004897577,70,67.67044493317543,-23.813636902055233,30.573263343739306,82.45763718490943,0.6828230168211072,1060,996,1125,1189,64,129,193,103.16911329096847,117,93.67794004611838,-38.58321201192728,8.374905561823992,62.76350675147233,0.9010112414010251,124131,124896,Faulkner,Faulkner,5,45,Arkansas,AR
05047,05CS015,190,182,197,242,45,52,60,365.6183529145328,22,153.33681826102108,163.6215206889187,210.88831725521229,262.78065310946084,0.4115450109512299,231,222,240,275,35,44,53,256.0891868633336,31,180.58953745776535,24.58626015181834,75.54046440295392,128.31626828264936,0.6894976415000567,17217,17166,Franklin+Johnson+Logan,Franklin,5,47,Arkansas,AR
05071,05CS015,229,218,240,272,32,43,54,199.94019871214573,20,92.87925696594428,57.67277070971194,104.75879444045712,158.76362809899322,0.45399045682480044,281,267,294,354,60,73,87,283.49604814104066,46,178.13577043720716,54.84682485743773,104.62105057144767,157.28368749200345,0.6198860703695818,25840,25823,Franklin+Johnson+Logan,Johnson,5,71,Arkansas,AR
05083,05CS015,240,231,249,285,36,45,54,256.4559657344467,12,68.03042471772098,139.7141364616655,189.48408124355083,241.6585031549557,0.2595341198641344,293,282,304,375,71,82,93,386.35888179680495,37,174.54476837437494,159.56304414579833,212.23821471583784,264.31414708944976,0.4463189531496056,21167,21198,Franklin+Johnson+Logan,Logan,5,83,Arkansas,AR
05051,05CS016,1217,1174,1260,1365,105,148,191,177.13491283986895,137,164.27022652104836,-39.81930632593386,12.751750739521293,66.27007096481357,0.9211381913660526,1487,1435,1539,1705,166,218,270,217.48144404810355,229,228.30139772296775,-60.99965808542756,-11.623132096910988,36.62568958721738,1.044960987618593,100079,100306,Garland,Garland,5,51,Arkansas,AR
05053,05CS017,177,169,184,201,17,24,32,162.0840826488735,14,93.16770186335403,17.611467619730227,69.1143788338216,120.03817660440485,0.5521411580306015,217,208,226,306,80,89,98,492.5728668268057,39,215.7915122005201,225.45382492988637,276.32121952131433,325.970598021155,0.4332240924048976,18032,18073,Grant+Hot Spring,Grant,5,53,Arkansas,AR
05059,05CS017,361,346,375,441,66,80,95,291.1641773359054,51,184.58754335695974,57.53593660821486,105.81848552980823,158.31438000428852,0.6261799514786295,441,424,458,526,68,85,102,256.96535025949385,53,159.97102411638645,45.0058308778028,97.93561613020401,149.1894855340247,0.6153118125163307,33155,33131,Grant+Hot Spring,Hot Spring,5,59,Arkansas,AR
05057,05CS018,192,183,200,226,26,34,43,203.02974132843252,20,118.85895404120443,34.22858034912488,84.60432313845207,137.58025311454705,0.5687774540904761,231,221,242,280,38,49,59,246.02003378334766,29,146.92471375012667,49.72574099919574,99.28821162999546,148.6210880112412,0.5851559935709966,20192,19738,Hempstead+Howard+Nevada+Pike,Hempstead,5,57,Arkansas,AR
05061,05CS018,154,149,160,171,11,17,22,158.65396858945965,18,168.5261761722712,-59.2499575698453,-12.207399618921883,41.26970458728951,1.0030332862366556,187,181,194,164,-30,-23,-17,-181.6306018813758,14,110.18416496143554,-346.2402517622475,-290.51304919736367,-238.10646587060586,-0.634115860650499,12817,12706,Hempstead+Howard+Nevada+Pike,Howard,5,61,Arkansas,AR
05099,05CS018,99,98,100,118,18,19,20,278.61354316399644,22,319.5352214960058,-52.52947606675535,-41.10764876041109,-29.22695437889213,1.0900509714247277,120,119,121,115,-6,-5,-4,-64.83607789407164,18,219.48542860626753,-296.81349165163084,-284.5120930308061,-271.84629229663443,-4.16936251847372,8262,8201,Hempstead+Howard+Nevada+Pike,Nevada,5,99,Arkansas,AR
05109,05CS018,127,122,131,129,-2,2,7,29.090451943787446,18,211.08179419525067,-235.94403436986622,-180.93949959547962,-132.61759884135012,5.171390972948116,153,148,158,177,19,24,29,240.52394756799524,27,267.85714285714283,-79.48875601034614,-27.306623164581286,24.62703843361565,1.0695266002382111,10233,10080,Hempstead+Howard+Nevada+Pike,Pike,5,109,Arkansas,AR
05063,05CS019,351,335,368,452,84,101,117,319.1350915172259,72,228.18508345658145,41.350775355232855,89.4585381218448,140.40483718125668,0.7079802009331939,427,407,446,545,99,118,138,313.8128307738025,76,201.33517007523577,60.95837291815491,110.88560526387646,159.60535281070224,0.6362065089388292,37864,37748,Independence+Jackson+Woodruff,Independence,5,63,Arkansas,AR
05067,05CS019,188,181,195,239,44,51,58,365.69071479164376,22,157.60253119216762,154.94663263038228,207.84205659674774,260.36146774546654,0.42269181537341854,229,220,238,254,16,25,34,148.8082505755298,22,130.95238095238093,-31.96420783710885,17.761540714271113,68.20723798153018,0.8461608075614757,16751,16800,Independence+Jackson+Woodruff,Jackson,5,67,Arkansas,AR
05147,05CS019,83,82,83,95,12,12,13,234.6923399191081,6,115.66265060240963,106.26378695977574,119.0833536650045,131.62614204385056,0.45541954495927406,100,99,101,105,4,5,6,84.31942127704815,16,261.0966057441253,-189.5025116782632,-176.75588708131068,-164.60734896826796,2.5944147515068314,6225,6128,Independence+Jackson+Woodruff,Woodruff,5,147,Arkansas,AR
05069,05CS020,684,655,713,901,188,217,246,390.01813777622135,132,237.2678250449371,100.75936485328934,152.1758265560555,199.46174038165404,0.6055598913033118,826,792,860,999,139,173,207,261.9845712724706,102,154.54545454545453,61.38766548461393,107.11008610567994,154.19740283286694,0.5865108809621651,66760,66000,Jefferson,Jefferson,5,69,Arkansas,AR
05081,05CS021,148,142,153,192,39,44,50,444.0236835830301,28,279.39464493597205,114.70234266464293,163.8303901249353,217.55122720938027,0.6154039094502677,179,173,185,200,15,21,27,173.06684425595515,35,292.9360562437228,-174.33891834743758,-120.77751183440385,-69.72319210669237,1.6145381092013116,12026,11948,Little River+Polk+Sevier,Little River,5,81,Arkansas,AR
05113,05CS021,227,219,236,258,22,31,39,190.52188455087705,51,316.9178188597172,-175.67632130286324,-126.74537619404947,-73.15509642661624,1.6108789657831037,279,269,289,374,85,95,105,493.25045848001906,72,372.5165562913907,66.48344066824227,121.08953689546888,174.89824199492998,0.7473884331792653,19311,19328,Little River+Polk+Sevier,Polk,5,113,Arkansas,AR
05133,05CS021,135,129,142,175,33,40,46,297.57433893153666,29,218.14078856641385,27.73827163685611,80.35069754032642,131.55256453803412,0.7149896343521035,166,157,174,229,55,63,72,401.59178509456774,35,221.77163857559245,129.9583753565073,179.2736012148213,230.0204155715309,0.5436537198431123,15953,15782,Little River+Polk+Sevier,Sevier,5,133,Arkansas,AR
05085,05CS022,598,566,630,674,44,76,108,123.68953850992774,75,121.53129430828437,-50.24019729015208,2.1917545794146704,53.21327807092758,0.9698454808642503,738,699,776,836,60,98,137,131.682172712538,85,113.90590032563686,-31.584396238163933,17.30017375045659,69.38077367767536,0.8562921395950983,74055,74623,Lonoke,Lonoke,5,85,Arkansas,AR
05093,05CS023,426,409,444,571,127,145,162,429.28917201697885,82,243.28734609108437,135.34943619714628,186.28750140777072,241.10559717230205,0.5628315048156686,514,493,535,594,59,80,101,200.9931695235432,61,153.3279710436356,-3.499005435890063,47.615036719797615,98.26578709075069,0.7534294388454235,40446,39784,Mississippi+Poinsett,Mississippi,5,93,Arkansas,AR
05111,05CS023,283,273,293,352,59,69,79,360.30205395491936,49,256.1198710689084,51.30736304642461,103.0782591394172,154.5569980800522,0.7006827857878325,342,331,354,423,69,81,92,355.3962018336219,40,176.2580417731559,128.6110610134153,178.80965985621788,228.99477755923854,0.4898742139984851,22958,22694,Mississippi+Poinsett,Poinsett,5,111,Arkansas,AR
05097,05CS024,125,121,129,135,6,10,14,141.84979395614184,21,294.358135731807,-199.06543399321905,-153.4136029571851,-95.40703867252498,1.8885230530798527,153,148,157,173,16,20,25,236.53617009680823,34,395.855163581325,-212.55540779473273,-161.4656312560428,-108.3725482361639,1.5950391168736746,8561,8589,Montgomery+Perry+Scott+Yell,Montgomery,5,97,Arkansas,AR
05105,05CS024,105,104,107,111,4,6,7,65.65352544368743,3,35.803083043262056,17.68166315024476,29.95715619633016,41.313981668890094,0.46145196985863446,128,127,130,152,22,24,25,237.92318189721112,20,200.62192797672785,23.95979485664616,37.36554502935926,50.05879814281512,0.8091085556394122,10055,9969,Montgomery+Perry+Scott+Yell,Perry,5,105,Arkansas,AR
05127,05CS024,126,122,130,141,11,15,19,181.64817379218542,14,170.19552223685542,-40.05642575712804,12.169745198972487,63.70510588716793,0.878179226743553,153,148,158,181,23,28,33,286.304440882299,19,193.4826883910387,41.49651166846521,91.98116107080313,141.18756044749063,0.6525824245346281,9871,9820,Montgomery+Perry+Scott+Yell,Scott,5,127,Arkansas,AR
05149,05CS024,213,204,221,252,31,39,48,232.30847370302004,37,217.87133814220522,-34.209198980194756,13.950543805119784,67.66370158395351,0.9146691199253302,257,247,268,298,30,41,51,201.26801487273903,40,198.37333862328904,-50.32778633241626,2.9812412873841705,56.45224838339811,0.9619157702491159,20379,20164,Montgomery+Perry+Scott+Yell,Yell,5,149,Arkansas,AR
05119,05CS025,3240,3069,3412,3803,391,563,734,169.6974271272221,342,103.12671972097488,13.846677102449478,66.35469421770328,118.42348952018114,0.6066314483742823,3979,3773,4184,4725,541,746,952,187.48871934190421,479,120.35054924071115,18.285690606721534,67.44321389622772,119.49436003291606,0.6410491450203497,397957,398004,Pulaski,Pulaski,5,119,Arkansas,AR
05125,05CS026,1024,970,1077,1101,24,77,131,75.06237718286327,98,95.08562557609275,-69.869974778782293,-20.095633565659213,35.28050258735246,1.250589578915856,1269,1205,1334,1581,247,312,376,249.54431855512155,165,131.99260841392882,63.12168870955437,118.55314273499746,167.57824677718344,0.5272443680565945,123678,125007,Saline,Saline,5,125,Arkansas,AR
05131,05CS027,1111,1056,1165,1345,180,234,289,220.17617170781276,111,104.22535211267606,62.41749431800554,114.58788500813779,167.45978250244576,0.4713623529243107,1367,1301,1433,1711,278,344,410,267.9138161290338,217,169.12956727771544,45.705050031006635,98.41204320157182,152.54650009220302,0.6294523188540524,127800,128304,Sebastian,Sebastian,5,131,Arkansas,AR
05049,05CS028,164,159,169,183,14,19,24,190.09540233106134,35,346.6776723070574,-209.6309457075754,-155.3820650974272,-104.96088654473552,1.7333842128301844,200,194,206,255,49,55,61,453.36824479325236,43,354.522219473988,43.35610241266424,99.57405485348677,151.44771953854192,0.7680075295524692,12115,12129,Sharp and Nearby Counties,Fulton,5,49,Arkansas,AR
05065,05CS028,175,169,181,191,10,16,22,142.98589944373748,10,88.12513769552764,6.240529968173837,55.6247367547092,104.95635603117012,0.5805405723952068,217,209,224,263,39,46,54,334.8029550828885,35,252.4888183523301,31.014511783800053,81.8587510729584,134.11232017610845,0.7382348726394388,13617,13862,Sharp and Nearby Counties,Izard,5,65,Arkansas,AR
05075,05CS028,201,194,208,230,22,29,36,215.47987134378187,32,236.424085703731,-73.46461826763911,-21.53102284481617,31.6502253464141,1.0608250360664768,245,237,254,251,-3,6,14,33.98484744122083,18,110.57869517139699,-131.4274217210391,-73.76724416029238,-26.279766527826347,2.7556418655119415,16242,16278,Sharp and Nearby Counties,Lawrence,5,75,Arkansas,AR
05121,05CS028,222,214,230,258,28,36,44,234.25596188443973,44,284.651463690765,-103.50944248704256,-49.72972592786479,-1.25245299871713,1.1824741642281478,274,264,284,285,1,11,21,58.822914077392284,24,127.49681257968551,-116.58772384409309,-67.52693885513989,-20.227489437872144,1.9879356581675585,18549,18824,Sharp and Nearby Counties,Randolph,5,121,Arkansas,AR
05135,05CS028,246,239,253,240,-13,-6,1,-41.728373747591824,26,180.169775365248,-274.16604484978774,-222.34224339324524,-172.10603605764723,-5.177475838465273,303,294,313,347,34,44,53,247.73029805566617,42,239.01661734577738,-44.547898931060665,9.072126526714094,58.74744721598804,0.9431596320177345,17317,17572,Sharp and Nearby Counties,Sharp,5,135,Arkansas,AR
05003,05CS029,211,203,219,248,29,37,45,231.5379860275158,21,132.3251417769376,48.53539246278196,99.70608261799515,152.26385024748814,0.5563639261032566,255,246,265,323,58,68,77,361.60441618729504,37,197.6918144902757,113.368249827145,164.10892394881412,214.69021604699194,0.5387469536774155,19044,18716,Southeast Arkansas,Ashley,5,3,Arkansas,AR
05017,05CS029,134,129,138,149,11,15,20,183.165481163962,25,295.9455460195324,-161.4359569241075,-113.47893956429826,-57.75669447070682,1.517643760179456,162,156,167,171,4,9,15,92.84376458477564,13,129.5207731393843,-86.1991691998033,-37.46374366518207,13.417357910664121,1.2598451261986678,10137,10037,Southeast Arkansas,Chicot,5,17,Arkansas,AR
05041,05CS029,143,138,147,151,4,8,13,88.93350908130715,13,137.870083959346,-99.55875602098762,-48.41834390131075,-0.66517406900742,1.3850874757960434,172,166,177,192,15,20,26,182.76997766264648,24,215.73033707865167,-81.82921114383679,-33.643330469537254,17.194070207614036,1.1250091399098523,11315,11125,Southeast Arkansas,Desha,5,41,Arkansas,AR
05043,05CS029,171,164,179,238,59,67,74,458.8253194252901,23,158.60245948741525,249.92589454353754,302.4013850102148,352.14755388211586,0.3405524611143999,208,199,217,223,6,15,24,85.98788464488783,24,140.03150708909504,-101.00296592559384,-55.429785738277324,-3.978915682371662,1.525023389241581,17402,17139,Southeast Arkansas,Drew,5,43,Arkansas,AR
05079,05CS029,129,123,135,151,16,22,28,203.95640103493716,27,250.8710801393728,-97.81503895730451,-47.17307134547277,2.36986380551845,1.1764291870838026,160,153,167,176,9,16,23,123.8048104519973,28,215.15291224834792,-144.51459664361462,-91.00814818014908,-41.36971035494142,1.6362826479163974,12915,13014,Southeast Arkansas,Lincoln,5,79,Arkansas,AR
05023,05CS030,320,309,331,368,37,48,59,233.10073718830063,38,184.2200945339959,-0.9931902767678931,48.76091489416491,101.39119305647137,0.7742011001178688,394,381,407,457,50,63,76,251.30071460230766,61,244.35186668803075,-43.67015703491401,6.827418273605069,59.244850455353436,0.9570922912108077,24753,24964,Van Buren and Nearby Counties,Cleburne,5,23,Arkansas,AR
05101,05CS030,78,77,78,124,46,46,47,763.9934822053995,17,280.4509210888094,471.39767612348936,483.4952874525292,496.1589225789548,0.3593264580121261,94,94,95,139,44,45,45,618.9057991203915,15,208.24656393169514,398.2907150513236,410.03408894388275,423.3745841604461,0.3290932613048928,7274,7203,Van Buren and Nearby Counties,Newton,5,101,Arkansas,AR
05129,05CS030,100,99,101,91,-10,-9,-8,-134.4020135705275,15,229.6504210257719,-375.8427836996666,-363.74136886908576,-352.73241096694454,-1.9283448844812485,123,122,124,158,34,35,36,446.92586902367185,15,190.54878048780486,244.63946237107422,256.09653452673103,269.3724026433422,0.41457073052712257,7838,7872,Van Buren and Nearby Counties,Searcy,5,129,Arkansas,AR
05137,05CS030,151,146,156,197,41,46,51,444.80815350300867,19,183.6784016756626,211.0898650326532,261.5092826644609,313.86451569887123,0.40415473840369626,186,179,192,243,51,57,64,460.86395462117804,25,200.57766367137356,210.2335407556445,261.0198283510167,309.40418937692954,0.4277739359489245,12413,12464,Van Buren and Nearby Counties,Stone,5,137,Arkansas,AR
05141,05CS030,201,194,208,201,-7,0,7,0.6713571529974489,13,98.3048711323965,-149.88218880172346,-99.02670543796583,-48.163725694158465,11.939954276623661,244,236,252,323,71,79,87,505.1854790505981,35,222.8731533367295,233.00708071638076,282.5204035411307,330.80212036344795,0.43567925484053566,15869,15704,Van Buren and Nearby Counties,Van Buren,5,141,Arkansas,AR
05143,05CS031,1481,1375,1587,1646,59,165,271,80.70363270574617,217,105.8730255534549,-77.38061609954659,-26.071975336033525,23.997048743999187,1.3039910651216808,1854,1725,1983,2046,63,192,321,76.96564511378864,237,94.96638109968666,-66.58464737627212,-19.098130117522782,32.34376652518759,1.227489530082647,245955,249562,Washington,Washington,5,143,Arkansas,AR
05145,05CS032,711,678,744,841,97,130,163,201.74481152826544,55,85.58646177786423,65.07370205883811,114.08618444580185,165.64690799834963,0.4209841154808119,873,833,912,1095,183,222,262,288.27643290326284,111,143.8774319822681,94.5895693793363,144.88097357814445,198.48205877238752,0.4968613020421563,77115,77149,White,White,5,145,Arkansas,AR
06001,06CS001,8592,7872,9312,9396,84,804,1524,57.601018177358604,635,45.4947645198153,-42.73165996834598,12.211051644318193,61.910565540829495,0.7888445197072179,10539,9685,11392,11273,-119,734,1588,44.415987819887434,805,48.695828914917804,-56.91560258208503,-3.7437776654177055,45.88368966568814,1.0948669819736645,1674918,1653119,Alameda,Alameda,6,1,California,CA
06003,06CS002,18,18,19,19,0,1,1,50.80875014274108,4,403.7005887300252,-364.0685409644125,-353.18363555969023,-339.8193095355507,2.660582742857238,24,23,24,27,3,3,4,283.4236478220574,4,325.2032520325203,-54.35977191983664,-41.334605662394665,-28.465833898655596,0.8916409151508271,1189,1230,Alpine and Nearby Counties,Alpine,6,3,California,CA
06005,06CS002,396,378,413,426,13,30,48,90.21855359878774,19,56.30741874938259,-19.051302439366456,34.008765953714,86.85495792439207,0.6042728975696215,491,470,513,550,37,59,80,142.45775496766112,43,104.48559070807212,-12.891577062623641,38.33078608022065,90.3870456698512,0.7211490348457783,40492,41154,Alpine and Nearby Counties,Amador,6,5,California,CA
06009,06CS002,431,411,450,466,16,35,55,92.6006701946786,17,44.79971890372452,-3.219240548822823,47.06732967480702,99.95167283591383,0.4704076554003277,535,511,558,619,61,84,108,183.20029358906294,59,128.0076370658046,2.3600100256224454,53.48324770056462,105.76671250727694,0.6905523874907993,45536,46091,Alpine and Nearby Counties,Calaveras,6,9,California,CA
06027,06CS002,191,183,199,204,5,13,21,84.87712203585592,28,178.088726347591,-142.9185313211668,-92.77482180677161,-41.51836782359459,1.9519260805875824,234,224,244,245,1,11,21,58.47322250507228,22,115.92370112762146,-112.2039384679007,-58.00908822398014,-3.388588977472539,1.8186254775765627,18867,18978,Alpine and Nearby Counties,Inyo,6,27,California,CA
06051,06CS002,54,53,55,39,-16,-15,-14,-134.33736414685518,2,17.921146953405017,-164.60444908886905,-152.41422698579422,-139.6855045532936,-0.14293831304513802,68,66,69,64,-5,-4,-2,-27.92744371196306,4,30.209198701004453,-70.78555873961591,-58.05044131708169,-44.5484149513215,-1.4826495776703958,13392,13241,Alpine and Nearby Counties,Mono,6,51,California,CA
06007,06CS003,1877,1786,1968,1992,24,115,206,65.38171726167293,132,75.01456248608868,-62.178587466773,-9.306034628651087,42.49870220297756,1.1374458194411317,2273,2165,2381,2569,188,296,404,141.89993804204994,293,140.4817613440221,-53.050813044660835,0.7261195334186678,53.42723700124075,0.9866719717789245,211159,208568,Butte,Butte,6,7,California,CA
06011,06CS004,148,139,157,155,-2,7,16,38.20190865445638,15,82.55365987892131,-94.50195409689208,-45.096771895815436,4.901515187351413,1.8888626456923872,183,171,194,183,-11,0,12,1.0473352323919487,23,104.98448055504838,-154.06392783505453,-102.63163976552727,-53.27625047970801,18.70754907295726,21804,21908,Colusa+Lake,Colusa,6,11,California,CA
06033,06CS004,777,747,806,719,-87,-58,-28,-101.940290549653,39,69.13463527048188,-223.9634914427154,-171.80922677783653,-120.87790164937866,-0.6901895426183989,956,921,991,957,-34,1,36,1.4794883404607018,89,129.58648806057076,-180.63893348412722,-128.09321176969695,-78.7923683712954,44.1443599643551,67694,68680,Colusa+Lake,Lake,6,33,California,CA
06013,06CS005,6794,6293,7294,7277,-17,483,984,49.85160533520926,422,43.532044278209646,-43.54155306268929,7.062467299715683,60.40414006080864,0.8714293227775489,8388,7788,8988,9112,124,724,1324,62.280281030461495,650,55.937171369118204,-43.02018472152702,5.985390505329823,56.765677499257755,0.8969128694765401,1163281,1162018,Contra Costa,Contra Costa,6,13,California,CA
06015,06CS006,260,248,272,283,11,23,35,98.4886737612619,6,25.919792641658866,22.605759505060657,70.24022687027949,122.28283751733684,0.25211687308541886,322,307,336,380,44,58,73,206.90206117477567,45,160.46785294012764,-7.377606415886123,44.606756968564696,99.54012769600989,0.7624334467757279,27778,28043,Del Norte+Humboldt+Trinity,Del Norte,6,15,California,CA
06023,06CS006,1148,1089,1207,1200,-7,52,111,45.79671719366838,23,20.25361042620641,-27.060497715160107,26.498009320611807,73.38819254788899,0.43390698566887964,1411,1340,1481,1602,121,191,262,140.43324182496985,93,68.22383285894539,20.00655251909632,73.5866851624659,126.02744437158071,0.48328514687177093,136272,136316,Del Norte+Humboldt+Trinity,Humboldt,6,23,California,CA
06105,06CS006,165,163,166,147,-19,-18,-16,-137.60261503130272,4,30.89200669326812,-180.85956968816916,-168.18896467975773,-156.91478391919557,-0.2378510829726666,209,207,211,198,-13,-11,-9,-68.18887041474781,19,118.27689243027889,-198.9322054938497,-186.3667648573357,-173.86772012697514,-1.9088072090856367,15538,16064,Del Norte+Humboldt+Trinity,Trinity,6,105,California,CA
06017,06CS007,1353,1270,1435,1514,79,161,244,101.112162958743,72,45.089945046629474,3.5969572132245586,56.53683950835409,107.59926506560927,0.44319489633850484,1676,1576,1775,1903,128,227,327,117.8421257481409,159,82.4201457644339,-17.164918965448525,34.70212183365075,86.54427389125847,0.696348458496317,191617,192914,El Dorado,El Dorado,6,17,California,CA
06019,06CS008,6034,5601,6468,7507,1039,1473,1906,175.32959683674684,937,111.56698831642397,11.35240086896267,64.04714198345465,116.77403750809482,0.6358953385905118,7503,6980,8026,9355,1329,1852,2375,182.80947536536334,1402,138.41336034467096,-6.986734337092551,44.13003097329323,95.92832839319524,0.7567367650921274,1007825,1012908,Fresno,Fresno,6,19,California,CA
06021,06CS009,233,220,245,223,-22,-10,3,-41.154242551114606,22,91.60941078492608,-185.07739773658236,-130.81143119559215,-82.73980221652118,-2.4765874263580923,287,272,302,330,28,43,58,150.3444768872377,59,204.73315289055452,-103.58216779895258,-53.77490209374381,-1.4877080387471746,1.3310390927083093,28818,28818,Glenn+Tehama,Glenn,6,21,California,CA
06103,06CS009,612,584,640,679,39,67,95,122.35012834836937,44,80.56148916692096,-10.035353616106333,43.169616125332716,91.07213157587428,0.648742101625862,751,717,785,941,156,190,224,289.9695152985942,129,196.90147294512704,42.53419552322537,91.84333164659995,141.99717002206285,0.6754862906193491,65540,65515,Glenn+Tehama,Tehama,6,103,California,CA
06025,06CS010,969,951,987,1660,673,691,709,461.65355027440967,529,353.32424233991037,96.92524516337653,108.16282833060865,120.48567089511566,0.7642393289368794,1196,1173,1218,1587,369,391,414,217.69036599040356,344,191.32582119934594,14.116794307567494,26.471075991892057,38.847236708725106,0.8766499400157395,179665,179798,Imperial,Imperial,6,25,California,CA
06029,06CS011,5345,4954,5736,6535,799,1190,1581,157.0593047371078,678,89.48742710448337,17.49026980036396,68.18977573701873,118.92895321701711,0.5692899772825795,6672,6199,7145,8615,1470,1943,2416,211.97897649299625,1345,146.74530905980444,11.285473090400933,67.01866365649298,114.53825866035815,0.6919073834699987,909178,916554,Kern,Kern,6,29,California,CA
06031,06CS012,749,683,814,920,106,171,237,134.60647075223443,113,88.78587283191577,-5.748092318364508,44.10447746987908,94.63737073184829,0.6557680702689436,938,859,1017,1302,285,364,443,237.40755095097208,225,146.74806292556937,41.41413867114466,91.53446561868023,142.88304430517147,0.61643370602483,152727,153324,Kings,Kings,6,31,California,CA
06035,06CS013,223,209,237,247,10,24,38,89.55399178418857,16,59.13150600554358,-21.797924797424713,31.399543928550177,80.12109057761405,0.6341199927462425,278,261,296,364,68,86,103,258.4699564894498,65,196.4042906783502,10.483660837391387,59.79926739548577,116.83135957051317,0.7510922721797665,32470,33095,Lassen+Plumas+Sierra,Lassen,6,35,California,CA
06063,06CS013,203,194,211,232,21,29,38,179.12159310275203,7,42.68292682926829,84.71500054033555,136.5641211292314,188.15831807340913,0.2304455337875594,249,239,260,278,18,29,39,143.36596056593152,30,150.79923595053785,-57.45435370675039,-7.128225130576996,46.25967363176322,1.0162180200201485,19680,19894,Lassen+Plumas+Sierra,Plumas,6,63,California,CA
06091,06CS013,32,31,32,36,4,4,5,162.9151555201057,1,37.57044458359424,112.78323263667335,125.22773116702419,136.48899719336413,0.1873972223649038,40,39,40,37,-3,-3,-2,-85.81412706393859,3,91.6030534351145,-189.20815386902882,-177.5752333164326,-164.93989720388055,-1.6570807662010616,3194,3275,Lassen+Plumas+Sierra,Sierra,6,91,California,CA
06037,06CS014,53793,49505,58081,69724,11643,15931,20219,191.63488887682013,11176,134.43720359549752,5.197219933630594,57.51060538843887,108.6055616659916,0.7014837755590095,66022,60935,71108,82276,11168,16254,21341,164.97283607827458,13943,141.5127564468332,-29.9126213653763,24.00486077475211,72.45387491562201,0.8577415183557254,9975810,9852822,Los Angeles,Los Angeles,6,37,California,CA
06039,06CS015,949,882,1017,1137,120,188,255,143.4800068246657,170,129.99840688226857,-38.82059197799086,13.505315409414008,59.31063910601287,0.9012352195677493,1188,1106,1270,1496,226,308,390,193.90056420848748,269,169.17919787676962,-27.794323455133096,24.725232834764128,78.0648256277353,0.8696840968722418,156925,159003,Madera,Madera,6,39,California,CA
06041,06CS016,1665,1552,1777,1754,-23,89,202,40.95900692892187,114,52.369650103361145,-62.91558132097817,-11.616743017752405,39.522954571167226,1.2644057464614553,2048,1914,2183,2166,-17,118,252,45.1693936259961,76,29.181945591030395,-38.52971964552966,14.391859787450125,65.63994742795036,0.6406100750121599,261220,260435,Marin,Marin,6,41,California,CA
06043,06CS017,173,166,180,175,-5,2,9,13.556733361806403,5,35.03649635036496,-71.53441678325304,-20.169922974845786,30.315376399356687,1.7037755666682626,212,203,220,243,23,31,40,183.3311511528952,22,128.32477834811013,1.799410415913727,54.36212371186676,109.56536707967096,0.6783780924456176,17125,17144,Mariposa+Tuolumne,Mariposa,6,43,California,CA
06109,06CS017,583,559,607,647,40,64,88,138.04357021949534,33,71.52145643693108,18.250568621035,66.26676996203066,120.66918089588502,0.5100991650919414,716,687,745,847,102,131,160,235.0047426818677,115,206.21514515753043,-22.69979902766672,28.14291167237479,84.14470019245216,0.8708486418446073,55368,55767,Mariposa+Tuolumne,Tuolumne,6,109,California,CA
06045,06CS018,753,714,793,870,77,117,156,154.27819672649244,35,46.30446286823072,56.34665364962993,108.00284401467601,161.40688235734095,0.29758426290599466,928,881,975,1057,82,129,176,141.24949258443343,65,71.18451025056947,20.537753771515504,70.679689471100275,121.6242003710895,0.5000856428642041,90704,91312,Mendocino,Mendocino,6,45,California,CA
06047,06CS019,1566,1445,1687,1948,261,382,503,162.78729642346656,260,110.81631130859145,3.46304573740563,52.808882599817196,106.13187123680697,0.6789652968557184,1964,1817,2112,2342,230,378,525,132.112406894534,384,134.37379710956364,-52.93308859148445,-1.5516782326411152,45.51678588536637,1.0144302031135122,281547,285770,Merced,Merced,6,47,California,CA
06049,06CS020,94,93,95,101,6,7,8,100.91833664595814,2,27.6211301645759,61.45489686763988,74.10877693373625,85.48692528955391,0.24075128192197814,114,113,116,141,25,27,28,306.04851196163065,12,138.55213023900242,155.02740218438663,167.21572047805267,180.35060279693184,0.43625478490937813,8689,8661,Modoc+Siskiyou,Modoc,6,49,California,CA
06093,06CS020,492,473,511,542,31,50,69,137.12911028097713,14,38.23830658927962,47.14378460997873,99.4037107919658,149.97756789998724,0.27340334860235055,600,577,623,743,120,143,166,324.6765095230346,75,170.0873114865631,104.20885428654994,154.7666999160084,207.12868459843702,0.5202332339143669,43935,44095,Modoc+Siskiyou,Siskiyou,6,93,California,CA
06053,06CS021,2246,2058,2434,2539,105,293,481,80.34142521564341,256,70.19612413197419,-41.75528090965461,9.468298567862835,62.23013274125789,0.8707508104153188,2788,2562,3014,3157,143,369,595,84.4051069590536,367,83.88648124782856,-47.723866489823344,2.3914538153448954,51.147207468664,0.9911713726096234,437631,437496,Monterey,Monterey,6,53,California,CA
06055,06CS022,1032,973,1091,1043,-48,11,70,9.732887466058914,38,33.170391061452506,-74.06832867245109,-22.68048589921221,25.692825592162116,3.127573076716649,1259,1189,1329,1345,16,86,156,63.08443101476019,73,53.51474587826495,-42.07376669707779,9.829255666316872,62.2428138994208,0.8385589802628673,137472,136411,Napa,Napa,6,55,California,CA
06057,06CS023,910,866,954,988,34,78,122,91.48426524998784,63,74.1459969988525,-33.82746301226371,16.748933925350308,67.6384946118092,0.8001839856557141,1129,1075,1182,1207,25,78,132,75.9785353453392,67,64.86026002187825,-39.660856294671426,9.574823825704089,58.57608576900351,0.8429256253778695,101961,103299,Nevada,Nevada,6,57,California,CA
06059,06CS024,17174,15806,18542,19959,1417,2785,4153,105.0754039278633,2459,92.7786819063334,-39.94662238559299,11.983270667306682,62.72852645973421,0.8826554610231877,21266,19630,22903,25162,2259,3896,5532,122.88351144629932,3517,110.9398978293065,-39.289692946467426,11.503817055966,63.58926129531432,0.9025737125232817,3180472,3170185,Orange,Orange,6,59,California,CA
06061,06CS025,2880,2706,3055,2988,-67,108,282,31.83855072667508,157,46.46929548700266,-64.70172956894862,-15.184798911407796,36.5583483902687,1.4460858903183373,3588,3376,3800,3895,95,307,519,74.61404390369916,306,74.39047218501348,-48.206675853430426,-0.1243214017463494,57.73522778070616,0.9937657546834135,405429,411343,Placer,Placer,6,61,California,CA
06065,06CS026,14474,13429,15520,18545,3025,4071,5116,200.80051491922282,2657,131.06327983761372,19.552469234491614,68.41126709512373,123.4081913959562,0.6525436028795237,18083,16817,19350,23082,3732,4999,6265,203.76098441167568,3945,160.81043568010585,-8.086037619493588,44.43897783737322,94.80856653770263,0.7890532718305422,2432718,2453199,Riverside,Riverside,6,65,California,CA
06067,06CS027,10289,9608,10970,11312,342,1023,1704,77.64771592489221,948,71.93275653076206,-43.136581368558694,4.478939671181816,59.061113528579455,0.925494466938014,12737,11917,13557,13886,329,1149,1969,72.3141119572049,1326,83.4733999357897,-65.16552183359546,-10.417505347225239,41.65960876077694,1.1533128894703604,1581477,1588530,Sacramento,Sacramento,6,67,California,CA
06069,06CS028,321,293,349,352,3,31,59,57.17398993142861,32,59.54873226331704,-55.356645107968944,-3.833478548107194,49.875434994445826,1.0087040810558159,411,376,445,475,30,64,99,96.99115212273716,60,90.41455071502841,-43.22951974405911,4.850050772663247,60.77834630862051,0.9179322874024511,64485,66361,San Benito,San Benito,6,69,California,CA
06071,06CS029,12427,11488,13366,16663,3297,4236,5175,232.84249428503438,2747,150.99006499663335,31.488024763058853,82.59561657443719,134.16302099367013,0.6483113434323671,15478,14346,16610,19934,3324,4456,5588,203.2047079778768,3626,165.34699156028097,-9.098578966838161,37.884772516737016,88.05894638123503,0.8135140994033518,2183190,2192964,San Bernardino,San Bernardino,6,71,California,CA
06073,06CS030,18345,16927,19764,20772,1008,2427,3845,88.2118583852746,1748,63.545728022102864,-23.599969464160036,26.228931608744876,78.86587739043773,0.7200794978483493,22684,20986,24381,26447,2066,3763,5461,114.46229206394365,2869,87.26465310095203,-18.90180884718297,27.31104683082867,76.73048477494315,0.7621852454301481,3300930,3287700,San Diego,San Diego,6,73,California,CA
06075,06CS031,4876,4505,5248,5343,95,467,838,64.68122503668735,222,30.776731220013193,-20.598616646066372,32.75062233443665,87.78426232531527,0.4748040448295668,5759,5334,6184,6569,385,810,1235,98.41425727065848,342,41.545441845492256,5.559620786157479,55.67498099716929,107.27349796383226,0.42162817147993825,865589,823195,San Francisco,San Francisco,6,75,California,CA
06077,06CS032,4956,4620,5291,5976,685,1020,1356,157.24629969157778,793,122.20681152719987,-17.96208018159169,34.63408784564523,84.52469706279415,0.776407216058266,6177,5770,6584,7229,645,1052,1459,133.48990928378194,1092,138.5588107289183,-55.21678835920443,-4.132154812778572,45.971745325428536,1.036986488866031,778680,788113,San Joaquin,San Joaquin,6,77,California,CA
06079,06CS033,2064,1943,2186,2068,-118,4,125,1.5703325559288532,116,49.29178470254958,-103.93948420354485,-48.86590627254193,5.60224053134952,24.704420403969834,2546,2400,2692,2671,-21,125,271,44.06554600217388,248,87.6250777319238,-92.35186065623135,-42.77915613402851,5.273084341192697,1.9726992594554922,282400,283024,San Luis Obispo,San Luis Obispo,6,79,California,CA
06081,06CS034,4001,3674,4327,4151,-176,150,477,23.7320405372625,248,39.145635971893014,-67.205740442484,-16.517304713732514,37.53912763934666,1.6385861459601194,4847,4464,5230,5116,-114,269,652,36.287228292365235,357,48.147598689090586,-64.43288261493333,-11.59308315731669,37.61716589096608,1.3219337879252335,760238,741470,San Mateo,San Mateo,6,81,California,CA
06083,06CS035,2738,2546,2931,2900,-31,162,354,43.38921595154182,177,47.45912683250548,-54.58403063884631,-5.941155364205435,47.49715299677082,1.0870822557017645,3380,3149,3611,3666,55,286,517,64.01168166531704,378,84.61846697305417,-71.31439957168392,-19.803531168241637,28.220089970323603,1.3173154131759712,447543,446711,Santa Barbara,Santa Barbara,6,83,California,CA
06085,06CS036,8680,7852,9507,9579,72,899,1727,56.07053227480189,851,53.05742640308369,-51.80519748118283,3.612950692377498,53.41133043186524,0.9452112014352413,10655,9678,11632,11365,-267,710,1687,37.520682365001264,1085,57.344177108415906,-74.87533129592126,-20.045298942583536,32.508727117508585,1.526185343465778,1924707,1892084,Santa Clara,Santa Clara,6,85,California,CA
06087,06CS037,1478,1362,1594,1583,-11,105,221,46.65089659230265,122,54.13140175927056,-60.69817130085727,-7.85388845332043,41.54077161653557,1.1494185248322761,1819,1681,1957,2004,47,185,323,68.97195319002044,147,54.816996998116835,-44.24587722728796,12.629469896761703,67.84458974487052,0.7904983676260844,270453,268165,Santa Cruz,Santa Cruz,6,87,California,CA
06089,06CS038,1926,1848,2004,2068,64,142,220,93.69646430511054,102,67.40422157485779,-26.16924535117262,26.983383857298346,73.16187500860006,0.7143509692783934,2356,2262,2450,2782,332,426,520,233.8178668861325,346,190.00236130102195,-7.584496573118549,43.404137379914395,96.02694186205957,0.8107043905618189,181591,182103,Shasta,Shasta,6,89,California,CA
06095,06CS039,2950,2756,3145,3118,-27,168,362,44.53528932658333,171,45.372131075045324,-51.52316416024586,-0.04924775533485813,49.80342794434524,1.0127566896372848,3642,3409,3875,4082,207,440,673,97.39003107677419,358,79.21352913973665,-33.80283459204675,18.424461304927092,66.59168956596116,0.8115200886512604,452260,451943,Solano,Solano,6,95,California,CA
06097,06CS040,3429,3219,3639,3693,54,264,474,64.90145290228075,196,48.1308372964876,-36.13257238850067,18.419317297478198,71.31894593745425,0.7388033785665068,4205,3954,4456,4558,102,353,604,72.52327068753956,232,47.71257287992678,-31.308517126544405,24.64259898939851,75.87443942000772,0.6560329428191098,488668,486245,Sonoma,Sonoma,6,97,California,CA
06099,06CS041,3728,3491,3966,4541,575,813,1050,176.54090342002695,634,137.74872806938134,-12.837369306356806,38.42403656290109,90.46577366753719,0.7793061331175907,4597,4312,4883,5581,698,984,1269,177.86483839426705,860,155.52746416086603,-32.073480694922225,22.419656407146533,73.7587352948958,0.8735256054497234,552310,552957,Stanislaus,Stanislaus,6,99,California,CA
06101,06CS042,736,693,778,799,21,63,106,76.55435634172481,62,75.1044800226121,-49.06294905960547,3.0166984020299545,52.42417910661605,0.9657787655410642,904,853,955,1013,58,109,160,109.75514754937313,146,147.29026270126306,-89.33083212024583,-37.571308667958384,11.832661844114929,1.3297667355289275,99062,99124,Sutter,Sutter,6,101,California,CA
06107,06CS043,2700,2496,2904,3323,419,623,827,158.0806052683682,451,114.43868585819499,-7.9684161289168145,43.011053431515606,92.36955161663617,0.722766008510811,3364,3118,3610,4334,724,970,1216,203.55332090380074,783,164.29905365423755,-15.96321375509371,40.87025317844285,89.70109665139377,0.8063236689135274,472917,476570,Tulare,Tulare,6,107,California,CA
06111,06CS044,4888,4525,5250,5547,297,659,1022,93.88630154425772,376,53.537039871568055,-9.042299246136261,39.55795138684556,90.11069650801876,0.569369215027429,6039,5606,6473,7127,654,1088,1521,129.44422832046666,818,97.35302133554539,-18.783844037885526,31.315021347143507,82.89795638842149,0.7513938366125946,842781,840241,Ventura,Ventura,6,111,California,CA
06113,06CS045,1125,1032,1218,1253,35,128,221,70.66607582489677,110,60.86315012910365,-41.77949398797065,9.767517508565303,61.15152069962399,0.8545869471307324,1398,1286,1510,1542,32,144,256,66.51035313318098,131,60.40234416425749,-45.91628289753982,6.001287294626357,55.78076133219768,0.9019119852866352,216880,216879,Yolo,Yolo,6,113,California,CA
06115,06CS046,587,552,622,561,-61,-26,9,-38.16250386137236,29,42.650194867269654,-132.1178654065961,-78.76265309395153,-32.07864405848335,-1.162390129807599,733,690,776,810,34,77,120,92.01553656954675,85,102.15855006970818,-63.26835595689505,-11.25483838485227,37.319381747608425,1.0959171573803566,81594,83204,Yuba,Yuba,6,115,California,CA
08005,08CS002,3365,3084,3647,4174,527,809,1090,148.11056557054638,492,90.10617694325784,3.648206129407382,56.840203988569556,111.23932191934298,0.6076196895536361,4177,3839,4516,4870,354,693,1031,105.74234059099635,392,59.853633436194045,-7.818904029412911,47.136274033601154,100.564583699923,0.5652166520260282,655227,654931,Arapahoe,Arapahoe,8,5,Colorado,CO
08015,08CS005,156,148,165,182,17,26,34,155.9392561471455,15,91.22237989053313,10.483308917043685,64.94485928250556,118.23056828694774,0.5630290005314309,194,183,204,167,-37,-27,-16,-133.53937300473277,12,59.9970001499925,-245.36033787663217,-193.4496394346161,-143.97465147205594,-0.4667587997641602,19732,20001,Central Colorado,Chaffee,8,15,Colorado,CO
08051,08CS005,66,64,67,70,3,4,6,31.579072121406387,5,35.17411185367569,-15.683823282189504,-3.4136911314132137,8.349474361023706,0.9109185259941631,81,79,83,89,6,8,10,47.30741360632157,7,40.62209842154132,-7.071687156476057,6.631140153626757,19.931965408206995,0.7648590105697685,17058,17232,Central Colorado,Gunnison,8,51,Colorado,CO
08065,08CS005,32,31,33,31,-2,-1,-0,-16.822927361337584,6,95.93604263824118,-124.08229859536706,-112.40135308266808,-101.27778721923501,-115.08822913219949,39,38,40,58,18,19,20,261.5452622931252,4,54.00297016335898,194.7272958654586,207.5927009193836,220.34795861124533,0.19634159091297684,7505,7407,Central Colorado,Lake,8,65,Colorado,CO
08097,08CS005,50,48,52,60,8,10,12,69.28043123687358,6,41.32231404958677,15.723278590361232,28.018417468077153,39.207879178147905,0.5425190922451122,61,59,63,72,9,11,13,64.39261629295258,8,46.11748429123191,5.418305814342024,17.953808439391885,30.45779611308991,0.6573440410151941,17424,17347,Central Colorado,Pitkin,8,97,Colorado,CO
08109,08CS005,40,39,41,53,12,13,14,242.61721311636552,3,55.7534458726963,174.20434970355336,187.10097983331926,198.88739083960292,0.21344978583280538,49,48,50,68,18,19,20,298.45743416390775,2,30.96934035305048,255.78818835721046,267.46586783048764,279.685644672588,0.09864666103998558,6457,6458,Central Colorado,Saguache,8,109,Colorado,CO
08027,08CS006,38,37,38,46,8,8,9,203.32431602108696,6,149.812734082397,42.3487506827853,53.544552598935695,64.95081553050949,0.6562297799556723,48,48,49,61,12,13,13,254.98713953385248,17,340.27221777421937,-97.67619820138555,-85.22495923437437,-72.25933214534571,1.237339335472235,4806,4996,Custer+Fremont,Custer,8,27,Colorado,CO
08043,08CS006,490,469,511,533,22,43,64,105.71832906742203,26,63.79063586178695,-11.758847242683158,43.21830124647912,93.39208671842812,0.5897158684557707,606,581,632,754,122,148,173,297.7366154832723,137,276.42145191880877,-30.412456895907063,22.26479514204194,71.29609656470267,0.9221601186375548,48910,49562,Custer+Fremont,Fremont,8,43,Colorado,CO
08029,08CS007,342,329,356,371,15,29,42,111.05291079655113,23,88.33130640722013,-27.581847130542293,21.358811189741182,73.28235494913037,0.7688109550057239,422,406,439,506,67,84,100,264.78456425007954,93,294.32242546996645,-82.65582372635457,-30.45516901153658,21.963661147710443,1.0984257165042683,31246,31598,Delta+Montrose,Delta,8,29,Colorado,CO
08085,08CS007,384,365,402,417,15,33,52,93.073517565964,27,75.6373144084415,-33.86131261972577,17.344980160163768,67.46154275950656,0.7889167523400334,474,451,496,614,118,140,163,325.46790311149397,114,264.41527114162454,5.605235584956288,62.25462058924134,108.10862013489223,0.8066671364466697,42836,43114,Delta+Montrose,Montrose,8,85,Colorado,CO
08031,08CS008,3944,3635,4253,4938,685,994,1303,166.0972934243221,647,108.11322646406808,6.237885137221928,58.437853767655696,106.73130570342039,0.650248827865789,4844,4476,5212,5239,27,395,763,55.480346497610405,408,57.274251012827754,-56.130387810705656,-1.5320626321988873,50.164437163254014,1.0297286031776196,718136,712362,Denver,Denver,8,31,Colorado,CO
08035,08CS009,1298,1143,1453,1611,158,313,468,104.34800433206321,166,55.36055227153351,-2.0789085225465205,48.3901450034267,101.404765276204,0.5288475175357508,1670,1480,1859,1995,136,325,515,88.5143770770767,165,44.87427045314854,-8.399849145936223,43.17655950276937,98.23919813895681,0.5054186180455891,359823,367694,Douglas,Douglas,8,35,Colorado,CO
08037,08CS010,135,130,141,130,-11,-5,0,-11.72555288509218,13,28.05704933364508,-51.90860779645192,-39.91891431503857,-27.929181365309333,-2.9325928533350254,170,163,177,188,11,18,25,31.956845880223455,16,28.716034315661005,-8.715724155132426,2.9790621375525075,15.759620359295976,0.8508051765262045,55601,55718,Eagle,Eagle,8,37,Colorado,CO
08039,08CS011,140,128,151,150,-1,10,22,46.49539801737153,13,59.14691943127962,-66.61681228581182,-13.921937077657546,38.18043532513945,1.1587174614398819,178,164,192,210,18,32,46,118.4277880848439,25,92.61317329776988,-26.477836202322777,26.269436103637723,77.20928761472011,0.7583019554248583,26375,26994,East Central Colorado,Elbert,8,39,Colorado,CO
08063,08CS011,57,56,58,81,23,24,25,410.0288502838256,5,84.91367110104726,313.49164956991143,324.6951561511376,337.13451904253316,0.19885566149141531,69,68,70,103,33,34,35,493.38128540998605,15,215.3007033156308,265.51521007681225,277.9863745664243,290.40512189671125,0.4240417641132471,7066,6967,East Central Colorado,Kit Carson,8,63,Colorado,CO
08073,08CS011,49,48,50,50,0,1,2,19.79000109977844,4,84.58149779735683,-76.10328452839926,-64.6355575868795,-52.168599869194814,2.0662201497545554,60,59,61,67,6,7,8,120.43629740878191,6,105.54089709762533,3.117949503336417,15.287004816877241,27.461353655916206,0.7646425699484473,5675,5685,East Central Colorado,Lincoln,8,73,Colorado,CO
08121,08CS011,45,44,45,65,20,20,21,502.99170212313726,14,347.970173985087,142.34894238744687,154.31625702773476,166.96825626506904,0.6592258024781198,55,54,56,67,11,12,13,246.04034410714485,14,288.421920065925,-55.46393252891089,-42.37149851856518,-29.59257106280532,1.0816826216628397,4828,4854,East Central Colorado,Washington,8,121,Colorado,CO
08125,08CS011,84,83,85,101,16,17,18,208.229627299384,12,144.27412082957616,52.51171957037083,64.33652647302657,75.95842395997393,0.6550397385774489,102,101,103,103,-0,1,2,9.374205633665902,7,70.37297677691767,-73.46075358077981,-61.308386721513536,-48.97161370240633,3.6223405036674263,9981,9947,East Central Colorado,Yuma,8,125,Colorado,CO
08041,08CS012,4265,3950,4579,5200,621,935,1250,153.51525796574506,530,87.0007715162757,11.91487029668965,66.20534842547669,116.53092317640552,0.5661185926581662,5324,4944,5705,6487,782,1163,1543,157.7788559060157,828,112.34903098960771,-5.6459636485234865,45.31902479013828,92.52975158611383,0.7114546181407085,731028,736989,El Paso,El Paso,8,41,Colorado,CO
08045,08CS013,314,288,341,338,-3,24,50,45.87686259964745,36,70.17315876677172,-72.16810981842701,-24.31618901777079,24.50723980173674,1.4672560340271912,394,362,426,423,-3,29,61,46.95426337332767,40,64.40705257225666,-70.59629591282724,-14.992322161354391,33.242069423423,1.326218380908378,61562,62105,Garfield,Garfield,8,45,Colorado,CO
08059,08CS014,10102,9311,10892,11827,935,1725,2516,112.66200399241785,1405,91.7447667119949,-31.49291221107951,19.850226224872763,74.3876304446326,0.8138646491731543,12564,11611,13517,14167,650,1603,2556,86.85536484117819,1420,76.93866471321925,-41.096390389561975,9.136143319922482,60.1339006311102,0.8852728770261176,1837707,1845626,Jefferson,Jefferson,8,59,Colorado,CO
08067,08CS015,295,271,319,362,43,67,91,143.50966621981715,24,51.59256207230124,43.91422598552146,92.54674627191403,141.2827746709692,0.3542001240473578,369,340,398,440,42,71,100,125.71143036622702,36,64.10142269546483,7.787164283080357,62.34980617273477,110.13464202480242,0.5027877035734952,55822,56161,La Plata+Montezuma,La Plata,8,67,Colorado,CO
08083,08CS015,230,219,242,251,9,21,32,95.09445189810644,16,73.94284834013709,-30.344407929771368,20.142570079113224,70.63121695355343,0.741535334190811,284,271,298,371,73,87,100,331.32786590319085,47,179.87676527995714,99.92326656929457,150.43696800483528,199.29588831092892,0.5366971955570214,25966,26129,La Plata+Montezuma,Montezuma,8,83,Colorado,CO
08069,08CS016,2055,1901,2210,2213,3,158,312,52.574711068682745,114,38.03951883345475,-36.63622631449129,17.31569813051641,67.24324552949199,0.7189694880615641,2557,2370,2744,2778,34,221,408,61.05461327400734,241,66.55289159887108,-53.714969787428394,-6.1192190956122134,46.10330555790359,1.085146910080791,359626,362118,Larimer,Larimer,8,69,Colorado,CO
08075,08CS017,180,171,189,264,75,84,93,465.15652034115135,55,305.1740879456235,111.15364805146822,160.42050414404682,207.16243548683207,0.6483338759940867,220,209,231,272,41,52,63,242.0101496795119,46,214.0729709605361,-24.096978063395355,26.59686565797302,82.33482892278468,0.8678730951434638,21627,21488,Logan+Morgan+Phillips+Sedgwick,Logan,8,75,Colorado,CO
08087,08CS017,236,224,249,296,47,60,72,247.3499302245988,71,293.3783271925898,-98.26459853373832,-45.53158515919001,3.252938599913957,1.1665976277849164,289,274,304,331,27,42,57,143.58841846372025,44,151.64047422111938,-58.06982018036708,-9.056501224074715,42.02940117127571,1.031323751699432,29041,29016,Logan+Morgan+Phillips+Sedgwick,Morgan,8,87,Colorado,CO
08095,08CS017,45,45,46,67,21,22,22,576.8029900757268,2,53.262316910785614,511.3024976853697,523.4685615019847,535.417573720294,0.08826533440382324,55,55,56,71,15,16,16,345.0747158990237,1,22.1483942414175,311.0919509343206,323.4611469463856,335.6401059025676,0.060313181904447795,4506,4515,Logan+Morgan+Phillips+Sedgwick,Phillips,8,95,Colorado,CO
08115,08CS017,31,30,31,41,10,10,11,530.555959820856,5,253.48542458808618,264.7874719577347,277.0539308807663,288.34606618562873,0.4361016718667486,37,37,37,34,-3,-3,-3,-121.72791683965629,3,127.98634812286689,-260.7490060553051,-249.53368824637192,-237.02551876882697,-1.6187320792300148,2367,2344,Logan+Morgan+Phillips+Sedgwick,Sedgwick,8,115,Colorado,CO
08077,08CS018,1336,1269,1403,1536,133,200,267,154.14994277676337,108,83.13981088259068,20.79130715288252,72.33505918012541,119.22569173264104,0.5366637097478603,1652,1571,1733,1998,265,346,427,220.19556551573305,319,203.01531842857233,-30.622193493690467,16.03766798614381,70.10472446704233,0.9193202951319879,155882,157131,Mesa,Mesa,8,77,Colorado,CO
08049,08CS019,67,66,69,64,-5,-3,-2,-24.673335350484717,4,30.480060960121914,-67.70320647588679,-55.37282467400403,-42.41466305086988,-1.787338815122379,84,82,86,100,14,16,18,103.88409104663523,13,82.06552616627738,9.6557934658412,21.90578242592993,34.61509359545851,0.7447177088686319,15748,15841,Northwest Colorado,Grand,8,49,Colorado,CO
08057,08CS019,11,11,11,11,-0,-0,0,-3.758728475298511,8,696.6618287373004,-712.0658321317293,-700.0703765849015,-689.2075576444444,8.36087835149794,13,13,14,14,0,1,1,42.69670789107772,7,512.8205128205128,-483.3430600277207,-469.64509031939184,-457.4512401625019,4.422514213740079,1378,1365,Northwest Colorado,Jackson,8,57,Colorado,CO
08081,08CS019,87,86,88,139,51,52,53,471.7401948497416,21,190.188679245283,269.6952542822227,281.99335941830253,293.8409902413568,0.39556977040998076,106,105,108,157,49,51,52,383.76900390662587,32,242.4793513677351,128.21565209104017,141.54393288816047,153.1622553719698,0.619602734421738,13250,13197,Northwest Colorado,Moffat,8,81,Colorado,CO
08103,08CS019,46,45,46,56,10,10,11,191.8902695538572,3,55.478502080443825,123.53189396595769,136.15011605054607,148.07625874972084,0.2637022704590461,56,55,57,70,13,14,15,216.66525918203578,10,154.27337241592102,49.70391789096999,62.49098094599833,75.01531993064161,0.6647061336430266,6489,6482,Northwest Colorado,Rio Blanco,8,103,Colorado,CO
08107,08CS019,105,103,108,115,7,10,12,47.32200389580816,21,100.90898170023624,-65.66920823189075,-53.015603933486794,-41.603850698206124,1.935822263270531,130,127,134,132,-2,2,5,6.649035709980692,3,11.974135866528298,-17.22522192029399,-5.875083496172579,8.325512753706546,1.1253448872137262,24973,25054,Northwest Colorado,Routt,8,107,Colorado,CO
08019,08CS020,53,52,54,57,3,4,5,46.28619213238775,4,50.86362191374378,-17.254770592643073,-4.728156459149178,7.798491638458455,0.8620646379259074,66,65,67,68,1,2,3,23.767823829307748,1,10.59322033898305,-0.10528739677276108,12.856103891090632,26.153024487005386,0.30829157248832184,9437,9440,Park and Nearby Counties,Clear Creek,8,19,Colorado,CO
08047,08CS020,27,26,27,27,-0,0,1,7.303766721046162,6,122.49064307587614,-127.78357119138829,-115.48935758035248,-102.74324083504243,4.419033887025633,33,32,34,40,6,7,8,122.04717132276774,1,17.053206002728512,90.82468291712632,104.84969541305405,117.2395124703958,0.1225964036231465,5878,5864,Park and Nearby Counties,Gilpin,8,47,Colorado,CO
08093,08CS020,86,84,87,113,26,27,29,185.45522207516103,8,54.344749504670254,119.26865228889946,131.00872450954557,143.077838327059,0.28267997713746523,106,104,108,118,10,12,14,68.67112490451606,10,56.573885494455766,-0.4347288040665034,12.093056938253417,23.811889198193505,0.7611330143108145,17665,17676,Park and Nearby Counties,Park,8,93,Colorado,CO
08117,08CS020,71,68,74,72,-2,1,4,4.386234298897637,6,23.263327948303715,-30.936118909160925,-19.023678614927235,-7.14632352121178,2.8152057695841974,89,85,93,88,-5,-1,3,-2.9422154982557718,7,22.620778801098723,-38.437120746040456,-25.37920713454499,-13.480679253459762,78.18484800136655,30950,30945,Park and Nearby Counties,Summit,8,117,Colorado,CO
08119,08CS020,150,139,161,183,22,33,44,158.60324421792424,3,14.489253803429122,91.64936900678752,143.4522687219639,197.5435499223957,0.08865562159199297,186,173,199,288,89,102,115,409.10940826519374,42,168.69502349680684,188.89945253598998,240.765453863813,295.7548264922646,0.4083379919988172,24846,24897,Park and Nearby Counties,Teller,8,119,Colorado,CO
08101,08CS021,1560,1488,1633,1998,365,438,510,311.5892675687704,262,186.50009787695976,71.89560466553485,125.99003167858639,177.93016914430507,0.5971804065849279,1924,1837,2012,2471,459,547,634,322.56926093258784,365,215.3976890483553,52.49571955268334,106.94053930225536,157.70695034723943,0.6665369927521461,168579,169454,Pueblo,Pueblo,8,101,Colorado,CO
08009,08CS022,44,43,44,60,16,16,17,560.1156533214107,2,68.41505131128848,478.4751536038004,491.6048294105691,503.5536904860389,0.1151142235930357,53,53,54,78,24,25,25,707.1830713248728,3,85.47008547008546,608.6902431133017,621.7424124953928,633.9612041181844,0.11617943552862016,3508,3510,Southeast Colorado,Baca,8,9,Colorado,CO
08011,08CS022,54,53,55,67,12,13,14,275.5587648715789,5,106.38297872340425,157.39652726559103,168.86638932302185,181.449479457428,0.35839051824062534,67,66,68,85,17,18,19,312.2602653200882,22,383.2085002612785,-83.18322494073394,-70.93954246047849,-57.97055244382098,1.162369134156919,5640,5741,Southeast Colorado,Bent,8,11,Colorado,CO
08017,08CS022,15,15,16,23,7,8,8,526.6930482420737,2,137.4570446735395,377.18164033776384,388.97934603186366,401.1938221557306,0.23085667611925725,18,18,19,24,5,6,6,331.3918486938202,7,409.1174751607247,-90.3418881878772,-78.28222780657227,-65.36245807520184,1.0494572420470565,1746,1711,Southeast Colorado,Cheyenne,8,17,Colorado,CO
08021,08CS022,68,67,69,79,10,11,12,169.8995135617011,4,63.30783434450014,94.84799443211706,106.45681290026012,118.81155924238921,0.34086597140611835,83,82,84,140,56,57,58,746.7407962781203,48,632.4110671936759,101.16271855613458,114.16274186847305,125.8516074734626,0.8322117771612094,7582,7590,Southeast Colorado,Conejos,8,21,Colorado,CO
08023,08CS022,33,32,33,35,2,2,3,77.97807812676224,8,268.75699888017914,-202.81234833876803,-190.8607433153538,-178.3860960618321,2.408806022311859,40,40,41,58,17,18,18,492.17228292365917,10,277.1618625277162,202.17575642151212,214.93902118751487,226.7720200232591,0.5331179261713108,3572,3608,Southeast Colorado,Costilla,8,23,Colorado,CO
08025,08CS022,41,40,42,63,21,22,23,444.88015860082197,0,0,432.98702960686785,444.8765548603553,456.31757271861153,0,51,50,51,69,18,18,19,304.7430325664888,13,216.84737281067555,74.90360011482713,88.33563107051296,100.2491459653379,0.6746467061198239,5919,5995,Southeast Colorado,Crowley,8,25,Colorado,CO
08055,08CS022,91,91,92,113,21,22,22,381.1142458101225,10,175.69546120058564,193.39601871354978,205.06924502118608,216.98887293175892,0.440688748218172,112,112,113,139,26,27,27,384.6121123584888,7,101.39049826187717,270.73271365458004,283.5105097598223,295.1569730532129,0.25405010084815277,6830,6904,Southeast Colorado,Huerfano,8,55,Colorado,CO
08061,08CS022,18,18,18,17,-1,-1,-1,-85.878762423653,3,248.790601243953,-346.7557242696187,-334.5434067731272,-322.46620663372573,-84.37692695096487,22,22,22,20,-2,-2,-2,-141.37333848529903,3,206.61157024793388,-360.33974555318764,-347.85122745101006,-334.3729721652534,-2.8497041121836353,1447,1452,Southeast Colorado,Kiowa,8,61,Colorado,CO
08071,08CS022,159,152,165,164,-1,5,12,44.072716954148284,5,41.23994776273283,-49.52574928897557,2.7486926919975168,53.40686940232712,0.7882146575649901,193,186,201,239,38,46,53,312.5806957155945,27,184.64063461669974,75.29703752010148,127.26335308778543,182.2960809689243,0.5780510777121618,14549,14623,Southeast Colorado,Las Animas,8,71,Colorado,CO
08089,08CS022,206,198,214,264,50,58,66,374.81234776586,36,232.2830411872244,91.9451949244695,143.30938178856337,192.38074293293602,0.60924357520857,250,240,259,313,54,63,73,341.16831063809144,62,333.243751679656,-42.951360353122965,8.558931392031415,58.758844419232624,0.9616225111307285,18598,18605,Southeast Colorado,Otero,8,89,Colorado,CO
08099,08CS022,110,108,111,148,37,38,40,384.16672092659826,18,179.92503123698458,192.39243503546842,204.16551996634814,216.75885157895425,0.45647418431881964,133,132,135,181,46,48,49,396.2101008900761,22,183.40975406419344,199.89136146498853,213.01554954396948,225.38757611974998,0.45337079702190386,12005,11995,Southeast Colorado,Prowers,8,99,Colorado,CO
08003,08CS023,135,128,142,140,-2,5,12,35.51417024635315,21,154.0530627216041,-171.28614167149658,-119.06997600381774,-69.73361033922315,3.5951681100337294,167,159,176,187,11,20,28,118.57564951856247,26,157.38498789346247,-92.30213080275514,-39.71364458443904,10.56015802422805,1.2628288045893445,16358,16520,Southwest Colorado,Alamosa,8,3,Colorado,CO
08007,08CS023,92,91,94,90,-4,-2,-1,-20.37015517470631,4,35.46099290780142,-68.48943249768207,-56.412268257714416,-44.06447181060117,-3.082249432249265,116,114,118,136,18,20,22,144.07933177524222,11,80.07570794205431,51.96986449191123,64.03035410470127,76.83989970330721,0.5290451102646992,13536,13737,Southwest Colorado,Archuleta,8,7,Colorado,CO
08033,08CS023,23,22,24,21,-3,-2,-1,-97.10658812352762,8,417.2099087353325,-567.6748709512357,-515.2592938849718,-462.77238958551925,-9.280539759611141,29,28,30,47,17,18,19,762.9701757935959,7,293.13232830820766,421.14406955519723,467.79876718209806,520.1742440577743,0.3642091123031534,2301,2388,Southwest Colorado,Dolores,8,33,Colorado,CO
08053,08CS023,9,9,9,2,-7,-7,-7,-1110.5257205291348,2,303.03030303030306,-1425.175120860804,-1413.7066698607355,-1401.9030493465368,-0.315982235046551,11,11,11,2,-9,-9,-9,-1193.888787420049,2,255.4278416347382,-1462.604941208301,-1449.1178261568225,-1436.618100956545,-0.23957406016205196,792,783,Southwest Colorado,Hinsdale,8,53,Colorado,CO
08079,08CS023,11,10,11,7,-4,-4,-3,-493.05528511597396,7,980.1633605600932,-1484.9910617689632,-1472.9397026889674,-1461.0330668081858,-2.7764154672394765,14,14,14,7,-7,-7,-7,-745.5611999914277,7,764.1921397379913,-1522.2455451257958,-1509.8654176720936,-1497.4835640141744,-1.200821926531599,857,916,Southwest Colorado,Mineral,8,79,Colorado,CO
08091,08CS023,26,25,26,24,-2,-2,-1,-42.639634940280324,5,122.29922543823888,-177.31408066941447,-165.28327134154236,-152.51336534098093,-6.727207873666879,33,32,33,32,-1,-1,-0,-16.177684954732907,8,159.64877270005988,-187.55963420758206,-175.48689659325137,-163.07303930927603,42.25287983851195,4906,5011,Southwest Colorado,Ouray,8,91,Colorado,CO
08105,08CS023,114,113,115,142,27,28,29,293.68357263770343,6,62.68500783562598,218.72913892691662,230.9372215779058,241.9540916153545,0.2061118156155336,140,138,141,174,33,34,36,300.1337977598054,28,245.03369213266825,41.927812541528425,54.8762974920698,67.71466351273146,0.7932845275734172,11486,11427,Southwest Colorado,Rio Grande,8,105,Colorado,CO
08111,08CS023,7,7,7,3,-4,-4,-4,-678.2394023255641,3,504.2016806722689,-1233.0422441358119,-1182.2460380921773,-1133.0443199675549,-0.9882970984110406,9,8,9,5,-4,-4,-3,-519.4433694351814,5,684.931506849315,-1252.0896377512574,-1204.5967184648587,-1154.7216671866795,-1.7908716142025605,714,730,Southwest Colorado,San Juan,8,111,Colorado,CO
08113,08CS023,24,23,25,24,-1,0,1,3.4106779896139345,2,29.725043349021547,-38.06747131606897,-26.302285282476515,-13.729891060671225,1.6267016119448388,30,29,31,31,-0,1,2,9.392208991785044,1,12.390038409119068,-15.540398949199293,-2.3673962107482422,9.570319952613728,0.5688135930640837,8074,8071,Southwest Colorado,San Miguel,8,113,Colorado,CO
09001,09CS001,5892,5481,6303,7546,1243,1654,2065,207.90309006925884,1629,204.7725796652071,-53.008797821255115,4.612792263236235,58.97089273616403,0.9843472876912238,7307,6812,7802,7409,-393,102,597,10.61651360898721,517,53.89891399422229,-92.56651621467138,-41.62777039771146,7.575429420412172,5.027524137148533,954620,959203,Fairfield,Fairfield,9,1,Connecticut,CT
09003,09CS002,6958,6573,7344,8610,1266,1652,2037,220.9869845420579,1731,231.60805476886023,-64.60419461252914,-11.624319790932317,39.019647901697105,1.0474277897229831,8559,8096,9022,8844,-178,285,748,31.804849729182678,731,81.49286909525078,-99.60313611469442,-50.61503782915421,2.3815959987129216,2.5533282282737613,896860,897011,Hartford,Hartford,9,3,Connecticut,CT
09005,09CS003,1595,1516,1674,1890,216,295,374,192.05420305445665,249,162.1850472768327,-21.134084714786706,30.436157758050037,77.01645346844775,0.8416210557160738,1966,1871,2062,2043,-19,77,172,41.45482719980233,143,77.30481884723919,-90.23868332246262,-37.318132796651064,16.061101510502375,1.8407916440401784,184234,184982,Litchfield,Litchfield,9,5,Connecticut,CT
09007,09CS004,1350,1280,1421,1526,105,176,246,128.72183982221225,214,156.7689001758156,-78.48140114140408,-24.590722687863437,23.866835882091646,1.2109970336406068,1668,1583,1753,1696,-57,28,113,17.081709164955672,134,81.39118181210786,-115.0945173128945,-65.45258093424154,-11.955373468487721,4.6012037922641404,163808,164637,Middlesex,Middlesex,9,7,Connecticut,CT
09009,09CS005,6757,6386,7128,8319,1191,1562,1933,217.45798659913854,1488,207.12046184522336,-40.20715438072925,9.59082944615049,63.16726904204454,0.9518526913325108,8314,7868,8760,8576,-184,262,708,30.301864677365966,717,83.01772318394389,-103.25924121486415,-51.88927203774253,-3.5986000338308926,2.729261613838991,862107,863671,New Haven,New Haven,9,9,Connecticut,CT
09011,09CS006,2135,2020,2250,2348,98,213,328,95.41632386008376,274,122.71083460535107,-75.95476355165091,-27.529817804356185,29.267167142054987,1.2800489481081392,2634,2495,2773,2954,181,320,459,119.12181215380846,243,90.42735297182239,-23.462092739925517,29.090052690558966,79.70241405690187,0.7567526192548116,267947,268724,New London,New London,9,11,Connecticut,CT
09013,09CS007,925,861,990,1042,52,117,181,93.28767167543758,113,90.46392784234193,-48.22109012773168,4.916090172652488,55.861455141326715,0.9614796741225365,1150,1073,1228,1280,52,130,207,86.28365467299777,87,57.923155280660986,-21.388634666682197,28.865443356929415,78.40518097857216,0.6661705534658968,149894,150199,Tolland,Tolland,9,13,Connecticut,CT
09015,09CS008,927,877,977,1084,107,157,207,161.64737919051709,84,86.63366336633663,22.290898707614534,75.1251336281457,124.14941900408112,0.5325444950776808,1142,1082,1203,1242,39,100,160,85.49899267074203,147,126.29734002336932,-92.6644991344511,-40.864556887666545,9.917471911014761,1.462483019369375,116352,116392,Windham,Windham,9,15,Connecticut,CT
10001,10CS001,1441,1363,1520,1740,220,299,377,196.71920195481326,191,125.6978644525123,18.17089891999586,70.32375556641273,123.12681197895401,0.6368405113391317,1785,1690,1880,2234,354,449,544,244.10446737223023,250,135.96340952722804,54.60517512583909,106.74612018869412,161.09727891879035,0.5557504297014246,182342,183873,Kent,Kent,10,1,Delaware,DE
10003,10CS002,4182,3937,4427,4893,466,711,956,149.82250304970128,499,105.19122563236824,-8.106483155185426,44.92834665915135,94.29873581739007,0.7011191558677489,5169,4874,5465,5717,252,548,843,95.79140703568626,523,91.50331371464964,-46.46804358634506,3.5096201514574887,57.67213844775065,0.9534935825762355,569249,571564,New Castle,New Castle,10,3,Delaware,DE
10005,10CS003,2364,2261,2467,2784,317,420,523,210.53033648726932,318,159.4831008931221,4.191478874360061,50.69326294247816,99.22608267491229,0.7557299839160205,2970,2843,3097,3314,217,344,471,139.78373848293688,338,137.2471789207824,-46.114290716834034,0.9506221806346666,50.5971548983086,0.9790097681518514,239273,246271,Sussex,Sussex,10,5,Delaware,DE
11001,11CS001,4163,3867,4459,5284,825,1121,1417,194.75622398864553,831,144.38488736762545,-1.792247573828609,51.203690707340826,101.36896756108145,0.7407013176465145,5018,4671,5366,5828,462,810,1157,120.32169909550123,463,68.79919402412875,-0.2982063761545471,50.09861712266803,103.81310858907052,0.5710884571137013,690654,672973,District of Columbia,District of Columbia,11,1,District of Columbia,DC
12001,12CS001,1746,1626,1865,1931,66,185,305,80.13911389692458,133,57.53403917073118,-28.360981653879925,23.397238074239745,71.38504646114338,0.7140725428550252,2165,2021,2309,2438,129,273,417,97.6961769153568,290,103.8841941989633,-60.33623191393549,-6.756256726191412,46.73933241437021,1.0594547111285075,277401,279157,Alachua,Alachua,12,1,Florida,FL
12003,12CS002,223,210,235,257,22,34,47,144.8881695403891,36,151.6108654453569,-53.97673112045784,-6.68140383099502,45.0341043441176,1.016842991337317,275,261,290,368,78,93,107,323.19576924320404,80,279.17364600781684,-8.541436266116841,43.84815441917845,93.16846148466985,0.8545640912649479,28494,28656,Baker+Bradford+Union,Baker,12,3,Florida,FL
12007,12CS002,281,268,293,294,1,13,26,56.49637715666684,20,84.56659619450316,-78.69371375355453,-28.420187175806863,24.449465520673012,1.392622548863125,345,330,359,408,49,63,78,222.44091793584903,87,305.1132776881532,-133.49679068934898,-80.89784604516916,-32.786691131074555,1.350369651906621,28380,28514,Baker+Bradford+Union,Bradford,12,7,Florida,FL
12125,12CS002,217,210,224,259,35,42,49,317.7187288327154,58,434.5925694661255,-166.84979831689034,-117.24455300089795,-64.16945283557294,1.3363374192743347,267,259,276,249,-27,-18,-10,-111.66315493743967,27,165.5933762649494,-327.694186267195,-278.82092357224144,-222.3925178444561,-1.5691582606359429,16015,16305,Baker+Bradford+Union,Union,12,125,Florida,FL
12005,12CS003,1584,1508,1659,1811,152,227,303,156.06981233563226,179,122.8348077703881,-16.968038335739873,33.5340383624427,85.94307946310101,0.7836049413209272,1980,1887,2072,2549,477,569,662,319.03136561862226,420,235.3178471778667,31.85212785450724,80.79935724890655,135.16339206971534,0.7363078790405777,174869,178482,Bay,Bay,12,5,Florida,FL
12009,12CS004,6515,6253,6777,7028,251,513,775,101.27943660789056,478,94.35964249934611,-44.65342254394276,5.688899938166792,60.304779472406416,0.9298638083536965,8050,7732,8368,9279,911,1229,1547,199.73850117145034,1073,174.36635785566756,-27.630334960666143,26.011790152167755,74.76102435947095,0.8722635389403992,607887,615371,Brevard,Brevard,12,9,Florida,FL
12011,12CS005,12919,12084,13753,15293,1540,2374,3209,146.68062073580154,1736,107.24578291171888,-12.951854291733195,42.022931257463995,97.89280391715941,0.7308438745925308,15845,14847,16843,18771,1928,2926,3924,151.42060979069745,2673,138.3168807137213,-38.98323529484953,14.143584257960459,64.91282593985012,0.9131493337662898,1942454,1932519,Broward,Broward,12,11,Florida,FL
12015,12CS006,2341,2260,2422,2695,273,354,435,224.86121729585088,245,155.61648476122926,15.349411925316371,69.2214651333985,119.46566851353809,0.690106334264676,2923,2823,3023,3342,319,419,519,216.26901839576,388,200.16611724162837,-32.79594302081902,16.55064885925007,66.78945332133591,0.9233397141233577,188926,193839,Charlotte,Charlotte,12,15,Florida,FL
12017,12CS007,2327,2261,2394,2726,332,399,465,310.43245355899444,204,158.7888458619549,98.74609759674163,151.03384993780736,203.16339932645568,0.5102291772177548,2884,2802,2965,3563,598,679,761,431.1406127226112,478,303.4034504208295,76.92878412877194,130.0615470885934,178.27945723975586,0.7026882193346564,154167,157546,Citrus,Citrus,12,17,Florida,FL
12019,12CS008,1600,1506,1694,1861,167,261,355,142.8183080445035,148,81.02189781021897,9.952163454326259,62.239569020472466,110.95843917043251,0.565141227561432,1993,1879,2108,2768,660,775,889,349.2270534519435,476,214.568091561073,81.9822024213149,135.6639956997936,186.9036902822749,0.613616521107881,219200,221841,Clay,Clay,12,19,Florida,FL
12021,12CS009,2963,2800,3126,3412,286,449,612,142.12805238046676,318,100.6077064026681,-6.550368751546804,42.441405472900406,93.77849834549089,0.7062944282141179,3700,3501,3898,4462,564,762,961,198.17491069751142,498,129.45757794749952,13.753255288149267,68.84218171160028,119.99565900206403,0.6523933055223778,379295,384682,Collier,Collier,12,21,Florida,FL
12023,12CS010,688,657,718,813,95,125,156,214.40669680084852,96,164.0698436209303,-1.5520351163922994,50.756642282267805,103.21834468978169,0.7591757555689945,845,808,881,1137,256,292,329,415.6103812462026,178,253.15375535107307,109.87234642321772,162.44154967195408,216.04943993639608,0.6070358993154907,70214,70313,Columbia,Columbia,12,23,Florida,FL
12027,12CS011,288,273,303,374,71,86,101,296.88087246933327,55,190.42123485285632,55.75278373350757,107.1489317728432,158.48694700138472,0.6340123998199876,354,336,371,470,99,116,134,338.6457703959968,78,227.0081490104773,62.348466136405335,111.7049953936254,162.43192368762556,0.6646291142813214,34660,34360,DeSoto+Hardee,DeSoto,12,27,Florida,FL
12049,12CS011,182,171,193,217,24,35,46,162.93878259705886,21,98.66102889358703,12.134528921529814,64.9899706017932,117.67767867789867,0.5885399521406626,225,212,238,352,114,127,140,500.9294117388552,74,291.23538903538116,158.88681949470677,208.3265776434068,257.35460444072396,0.576857921531153,25542,25409,DeSoto+Hardee,Hardee,12,49,Florida,FL
12029,12CS012,193,186,201,212,11,19,26,132.29879390895525,14,99.7150997150997,-19.335711403996317,31.104008944301125,84.31794268765813,0.7152070664768622,239,230,247,313,66,74,83,436.4469660127287,50,293.100416202591,94.2974360822314,145.437140146327,193.31961300736842,0.6626598898249351,16848,17059,Dixie+Gilchrist+Levy,Dixie,12,29,Florida,FL
12041,12CS012,173,166,181,191,10,18,25,117.42333919791348,13,86.34527038246526,-15.22119419509459,29.576867701368954,82.13237845897295,0.6959664157725757,215,205,224,301,77,86,96,471.22605970971784,42,229.5458271847844,194.47230877037293,240.82302424722883,289.63595216280373,0.48153964931135274,18067,18297,Dixie+Gilchrist+Levy,Gilchrist,12,41,Florida,FL
12075,12CS012,496,478,515,552,37,56,74,156.09210841808627,30,83.8027841147167,20.740177859212725,71.75360097042521,121.39865840333535,0.5274412447256425,617,595,640,757,117,140,162,317.5066648251648,111,252.28992885878583,13.291626315567902,65.81490347660329,115.11432049264694,0.7889495471885793,42958,43997,Dixie+Gilchrist+Levy,Levy,12,75,Florida,FL
12031,12CS013,7557,7130,7985,8614,629,1057,1484,127.9091126723624,709,85.8164770056626,-5.307823511887696,41.56385181639019,92.95372129308598,0.6702833359892095,9358,8842,9874,11537,1663,2179,2695,217.9958211405863,1831,183.20699288384418,-16.96936136303194,34.11747640333212,86.24225329313695,0.8400295926777656,991418,999416,Duval,Duval,12,31,Florida,FL
12033,12CS014,3012,2874,3151,3586,435,574,712,213.7597959870015,327,121.87243769721965,43.165315890747685,90.69851695977128,142.28539321653648,0.5691449956724821,3700,3533,3866,4583,717,883,1050,273.92957589430046,557,172.769428806278,49.21146416329849,101.34208034892237,153.20285280703172,0.6299941056430515,321976,322395,Escambia,Escambia,12,33,Florida,FL
12035,12CS015,1225,1174,1275,1360,85,135,186,139.60939527998406,53,54.63260432594018,29.631376396742752,85.7973415095238,136.90058551360366,0.3884565342048794,1548,1486,1610,1844,234,296,358,246.13392065120206,221,183.84799680553706,11.468502228309845,62.79723256593264,114.07723788128263,0.7444269119166996,116414,120208,Flagler,Flagler,12,35,Florida,FL
12039,12CS016,386,367,405,481,76,95,114,258.7225201119201,54,147.30620595589906,62.5427384750038,112.10708741117503,164.68095048956613,0.5634192899907191,473,450,495,664,169,191,214,437.59238488701897,96,219.61932650073206,166.0651069437006,219.61106662811846,271.1403488739533,0.4992708999300184,43990,43712,Gadsden+Leon,Gadsden,12,39,Florida,FL
12073,12CS016,1665,1539,1791,2057,266,392,518,160.65747181000555,158,64.78928106451248,44.433634156654044,96.63978077641067,146.6889191935361,0.4022491736410517,2073,1922,2224,2572,348,499,650,170.36221145328048,309,105.54972963556308,8.784396787035396,64.59184339833553,118.76205794478516,0.6183209272396959,292641,292753,Gadsden+Leon,Leon,12,73,Florida,FL
12043,12CS017,100,99,101,129,28,29,30,281.3340521510221,16,154.36565364206464,115.52093416818681,127.20943421681523,138.56527287075738,0.5304991503677114,121,119,122,167,45,46,48,379.18926527365414,16,130.86864060199576,235.6274471151388,248.6566243581807,260.83069318271737,0.3378401235919453,12438,12226,Glades+Hendry+Okeechobee,Glades,12,43,Florida,FL
12051,12CS017,261,244,279,315,36,54,71,160.23856853053172,51,152.56138601520627,-44.21781503358104,7.932950738095446,55.393902790509046,0.9346407871356017,325,304,346,480,134,155,176,385.8801954608643,79,196.3952765692977,137.12348748167705,188.17627853009256,239.10072002010645,0.5056960948020827,40115,40225,Glades+Hendry+Okeechobee,Hendry,12,51,Florida,FL
12093,12CS017,384,367,401,467,66,83,100,248.081373606551,55,164.70764393202066,29.689762694425035,84.37966164491414,134.36152670862802,0.6560069694286788,473,452,494,657,163,184,205,458.0763388934902,103,256.37834474175486,154.04890651490433,201.60747652399527,251.37379471849556,0.556659960659301,40071,40175,Glades+Hendry+Okeechobee,Okeechobee,12,93,Florida,FL
12047,12CS018,138,132,144,176,32,38,44,321.00406415553715,19,162.17369656447826,111.42394344434317,158.97038772288508,207.4106199603047,0.4921221456063207,169,162,177,226,49,57,64,405.1106938365734,33,235.84905660377356,118.79984264489804,169.50646683180028,222.30789341213904,0.5720914219934171,14059,13992,Hamilton+Lafayette+Suwannee,Hamilton,12,47,Florida,FL
12067,12CS018,67,66,68,97,29,30,31,430.81373217226167,16,231.7441158720579,186.77468747589413,199.08599971891368,211.06607806507688,0.520425089462365,84,83,85,118,33,34,35,410.82152938793325,22,263.06349396149704,135.14402191941116,147.94204556046068,160.08587641029217,0.6222246570212698,8285,8363,Hamilton+Lafayette+Suwannee,Lafayette,12,67,Florida,FL
12121,12CS018,486,467,505,587,82,101,120,276.8360242079087,71,194.76956839795167,29.991981943592638,82.34522515841822,134.3890737916713,0.6966524272718371,603,580,626,785,159,182,205,409.62237470361896,161,363.0787271948222,-5.069953518355562,46.26054440421813,100.42871922377138,0.8815211021069134,43744,44343,Hamilton+Lafayette+Suwannee,Suwannee,12,121,Florida,FL
12053,12CS019,2450,2365,2534,2676,142,226,311,138.60123196284476,203,124.37137824521992,-41.776126518070434,15.11217922583542,61.65987719897743,0.893383342266388,3043,2940,3146,3688,542,645,748,322.77227907846924,557,278.6532592926109,-9.567933531453704,44.35748700638217,91.33110778798972,0.8619762353674066,195865,199890,Hernando,Hernando,12,53,Florida,FL
12055,12CS020,1332,1289,1376,1582,206,250,293,293.2393973726852,185,217.39343315151928,25.752110507146675,73.92951261551363,126.60125701015161,0.7383924207480327,1644,1591,1697,2130,433,486,539,471.7461446042087,284,275.7442181097928,143.8420279010978,195.20241968084352,248.51277711644852,0.5833176602286975,102119,102994,Highlands,Highlands,12,55,Florida,FL
12057,12CS021,9337,8707,9968,10901,933,1564,2194,127.91412219447466,945,77.30978316446532,-1.6181977687035862,50.02242466308288,101.25964956578345,0.6040018793192099,11589,10827,12351,14310,1959,2721,3483,184.36404239876663,1769,119.8481877788723,13.37145387381343,64.28376943776075,116.63376153792393,0.6498239093919883,1466826,1476034,Hillsborough,Hillsborough,12,57,Florida,FL
12059,12CS022,239,230,247,286,39,47,56,289.0631821600829,28,171.03588699414607,66.4183601408862,117.44714351780692,168.47609487401294,0.579445594069406,294,284,304,362,58,68,78,344.3714430538885,47,237.85425101214577,57.82073425479714,105.45114162195841,157.50366992357706,0.6806878994218118,19645,19760,Holmes+Walton,Holmes,12,59,Florida,FL
12131,12CS022,637,604,670,665,-5,28,61,44.32438935093928,49,77.32568843533836,-81.34644046069539,-34.47018403373109,18.3578979584521,1.6845650678418145,820,779,861,892,31,72,113,90.82971616782207,127,159.84091423968584,-119.77743771410685,-67.5965224094794,-16.532023846635546,1.7357351992531023,76042,79454,Holmes+Walton,Walton,12,131,Florida,FL
12061,12CS023,1823,1754,1892,2023,131,200,269,149.16596108682893,141,105.35360705346136,-5.687918396925274,42.023632776943,94.99823451080394,0.7027642818625894,2259,2175,2344,2716,372,457,541,279.9028985474968,358,219.39232004314306,9.332320902303621,60.12687501147076,110.70793612743765,0.7821034598325975,160602,163178,Indian River,Indian River,12,61,Florida,FL
12063,12CS024,539,519,559,666,107,127,147,323.8244191651971,102,259.7402597402597,15.86695858240349,64.74885960604298,117.89004410838342,0.7958438263593118,668,643,692,761,69,93,118,195.85687660924395,99,207.8783806484126,-59.98575164036144,-10.426675431465451,39.153958920344344,1.0501206804816416,47124,47624,Jackson+Washington,Jackson,12,63,Florida,FL
12133,12CS024,294,283,305,299,-6,5,16,24.280494988076164,22,103.90428211586901,-133.52563717222776,-82.62360250699344,-28.80931558290432,3.5824841764471476,361,348,374,418,44,57,70,223.30437008208733,62,243.86406544996856,-73.83800243205206,-20.518654676831638,31.523927811189953,1.0731674665317736,25408,25424,Jackson+Washington,Washington,12,133,Florida,FL
12065,12CS025,154,148,160,184,24,30,36,246.43918343939026,13,107.44541635098835,90.23264764603218,140.61726480381253,190.1373001284738,0.42184388724876365,188,181,196,225,29,37,44,253.23255548095787,32,219.84061555372355,-17.363274669542104,32.130936295110885,82.37619744480577,0.8452073794075561,14519,14556,Jefferson+Madison+Taylor,Jefferson,12,65,Florida,FL
12079,12CS025,193,185,201,273,72,80,88,528.8430209407626,38,251.9476214155478,223.4257807231928,278.33791880585204,329.6162613148668,0.47051395158050996,238,228,247,303,56,65,75,358.061406787962,51,279.5746080473632,23.54496332096317,78.85084533787372,128.5547651122743,0.7690270660675183,18099,18242,Jefferson+Madison+Taylor,Madison,12,79,Florida,FL
12123,12CS025,221,211,230,284,54,63,73,350.4478447037073,31,171.16826945198545,126.28776065150545,179.31744688323116,232.96303142945357,0.480851074824753,270,258,281,330,49,60,72,276.79262115175584,49,224.69849131012978,2.386085576673635,54.25755948530104,102.42511827569662,0.7985636689058854,21733,21807,Jefferson+Madison+Taylor,Taylor,12,123,Florida,FL
12069,12CS026,4023,3857,4189,4366,177,343,509,107.23209818353492,292,91.21484427876756,-36.242341110555195,14.857000143895304,70.19359120242376,0.8481592561101182,5027,4823,5230,5756,526,729,933,184.945914760233,778,197.28367262067778,-64.43720352968064,-14.706153932505055,39.44747593664791,1.0652495300927751,384148,394356,Lake,Lake,12,69,Florida,FL
12071,12CS027,6371,6041,6702,7250,548,879,1209,137.2368425773493,599,93.56792135504261,-5.74479634798317,43.541577527487526,97.15182194279734,0.6810236887843554,7978,7573,8383,9408,1025,1430,1835,182.21247590961062,1019,129.87857182004615,0.49202079751018113,52.43139544389392,104.2545679904553,0.712288141304434,768212,784579,Lee,Lee,12,71,Florida,FL
12013,12CS028,149,143,155,180,25,31,37,274.4785527460802,20,175.25923762231633,51.514318071545325,99.84059200651397,151.70932027407451,0.618762535050674,182,175,189,239,50,57,64,414.754633751321,42,307.9856273373909,57.30625644542733,107.74317795489425,158.7652554924924,0.7296722509363258,13694,13637,Liberty and Nearby Counties,Calhoun,12,13,Florida,FL
12037,12CS028,138,133,143,143,-0,5,10,46.92990999702231,5,48.31695925269769,-53.94500856203845,0.02570950681992406,49.72006159320494,0.8537575592044959,171,165,178,205,27,34,40,268.45036648041594,38,302.668259657507,-84.08702231044708,-33.51827322151312,14.740508558780567,1.0949764250071614,12418,12555,Liberty and Nearby Counties,Franklin,12,37,Florida,FL
12045,12CS028,154,148,160,197,37,43,49,362.6339915806509,22,187.23404255319147,123.73313530370112,174.41832221506877,230.33107936666835,0.5044773047490241,192,185,200,242,42,50,57,346.40071346785675,32,223.2142857142857,72.40127768628334,124.15776915042605,172.56913943992114,0.6316619824600169,14100,14336,Liberty and Nearby Counties,Gulf,12,45,Florida,FL
12077,12CS028,60,59,61,78,17,18,19,273.8066013913714,15,224.43890274314214,38.15764296948304,49.20431803123236,61.9569293605958,0.7772259184881986,73,72,74,117,43,44,45,558.2596748497201,17,214.89065857666537,332.2167999186148,343.3502384144671,355.29952957742137,0.37640662982624423,8020,7911,Liberty and Nearby Counties,Liberty,12,77,Florida,FL
12129,12CS028,263,248,277,321,44,58,73,206.57330272612268,30,106.04141506377212,48.39796018161723,100.22469610317006,151.126804631977,0.5046995197952947,332,314,349,414,65,82,100,238.38941426489205,60,173.53077279037484,16.66282724096727,67.03673280426554,116.63589250062606,0.7192043539219075,33949,34576,Liberty and Nearby Counties,Wakulla,12,129,Florida,FL
12081,12CS029,3636,3462,3809,4106,297,470,644,140.14267848370218,379,112.89842120941317,-25.039765329826153,27.173579276786498,75.2396230891728,0.8038875549608866,4541,4329,4753,5302,549,761,973,185.12314338919546,694,168.83138998834724,-28.652356822837632,17.027235979578,67.97256790612873,0.9107981551975199,402840,411061,Manatee,Manatee,12,81,Florida,FL
12083,12CS030,4620,4458,4782,5251,469,631,793,201.0818851859423,441,140.51969984227378,10.117478847946973,60.67544018516933,111.7295469177748,0.6977126825619303,5742,5544,5941,7072,1131,1330,1528,345.6252408055069,1110,288.5597747673974,6.970867113724398,58.83016667404291,108.55684473178196,0.8342645795705607,376602,384669,Marion,Marion,12,83,Florida,FL
12085,12CS031,1646,1578,1715,1995,280,349,417,262.9700295909514,167,125.98464797852478,83.62140634172323,136.05233405204007,191.15269073502665,0.477713227435164,2020,1938,2103,2462,359,442,524,276.4729690263081,225,140.85741473431162,86.08162079205627,135.97075525361603,187.73051894942117,0.5083288417766698,159067,159736,Martin,Martin,12,85,Florida,FL
12086,12CS032,17029,15872,18186,22009,3823,4980,6137,221.96194271634505,3655,162.9175086176156,9.505467941349014,60.534101486140955,106.74450215096692,0.7338411102517697,20833,19456,22210,26100,3890,5267,6644,197.4835252827433,4101,153.76216768287424,-10.12041494336096,45.671153027480514,95.33647090599307,0.7784597729350561,2692160,2667106,Miami-Dade,Miami-Dade,12,86,Florida,FL
12087,12CS033,657,622,693,662,-31,5,40,6.9403236734302265,40,58.9369252114976,-102.7917869964889,-50.1036322572904,0.6545779865499799,7.004837034727021,806,764,849,855,6,49,91,59.38403872869845,56,68.07434691173432,-61.93678324205857,-7.654700732248882,39.663235413572735,1.1233455076133967,81443,82263,Monroe,Monroe,12,87,Florida,FL
12089,12CS034,832,793,871,901,30,69,108,90.88356456062665,67,88.37689889418955,-52.43922500634358,1.3904535804316893,52.2677026867613,0.958507429131022,1047,999,1095,1209,114,162,210,172.7316939517786,169,180.3185984230125,-59.26093680612105,-7.183325623753215,43.82429458986121,1.0375142720861306,90974,93723,Nassau,Nassau,12,89,Florida,FL
12091,12CS035,1619,1528,1710,1896,186,277,368,156.9053034346453,200,113.25990316278279,-7.788929175891914,46.07775182253598,94.65784462938771,0.7192401743596559,1998,1888,2108,2362,254,364,474,170.72277200316395,305,143.16291470306604,-20.9053932545815,25.319957500330492,83.15427793333112,0.836270281691223,211902,213044,Okaloosa,Okaloosa,12,91,Florida,FL
12095,12CS036,7361,6748,7974,8379,405,1018,1631,85.7847278630874,745,62.775652877322756,-31.02285965216562,22.366664710302064,75.7563338307912,0.7310631291132728,9130,8395,9865,10777,912,1647,2382,115.67666850121924,1451,101.9111680171711,-40.32000562066336,12.468335306624985,66.62319894055342,0.8804656092164307,1424119,1423789,Orange,Orange,12,95,Florida,FL
12097,12CS037,2216,2048,2384,2531,147,315,483,97.05544822193849,276,84.98496340925186,-41.718073941995755,10.778873847881318,65.20547212185126,0.8728638705349232,2820,2613,3028,3533,505,713,920,177.48892648966344,605,150.69619149625126,-30.917093323305096,26.20514055308466,76.66741485342142,0.8478557319307621,389716,401470,Osceola,Osceola,12,97,Florida,FL
12099,12CS038,12653,12011,13296,14606,1310,1953,2595,156.86328641949387,1572,126.28035926708657,-19.807848667805107,30.14995624022395,81.50793957935454,0.8046224582398646,15533,14760,16306,17803,1497,2270,3043,151.5972094372811,1994,133.18354081200548,-32.624136139871204,18.39663505354378,66.12285512838461,0.8781486669275894,1493819,1497182,Palm Beach,Palm Beach,12,99,Florida,FL
12101,12CS039,5677,5433,5921,6147,226,470,714,99.6548311721983,352,74.6362279020046,-26.404210496945364,24.393526929387498,75.04165195394084,0.7473572663114414,7113,6812,7413,8130,717,1017,1318,175.00190830309523,1049,180.42810825686496,-57.858751382397664,-4.677688587914927,43.7815352385343,1.0299941920481854,565945,581395,Pasco,Pasco,12,101,Florida,FL
12103,12CS040,10071,9658,10484,11173,689,1102,1515,137.59400955163824,747,93.28249485926456,-8.345413359321922,45.39880105781022,98.80192144008707,0.6773398896906239,12269,11775,12763,13923,1160,1654,2148,172.87171131638164,1235,129.05895643032332,-6.229719243089287,42.437809596457875,93.34481117519783,0.7461081183838987,960952,956927,Pinellas,Pinellas,12,103,Florida,FL
12105,12CS041,6284,5969,6599,7210,611,926,1241,151.98074143111538,718,117.84320671388966,-15.11888950013003,34.950892284368884,90.53252889608122,0.7745460488199034,7888,7501,8276,9804,1528,1916,2303,255.4129800757761,1555,207.33941528951516,0.5860755908748604,46.116448436612174,96.71912337656987,0.8113574770463576,731141,749978,Polk,Polk,12,105,Florida,FL
12107,12CS042,854,823,886,994,108,140,171,227.91842437523056,71,115.80335177306893,55.86847443102489,111.70776067160385,162.5251520270026,0.5044810518608037,1050,1012,1089,1489,400,439,477,592.4529393495957,265,357.8808054343863,181.53265193709456,234.6919837659711,284.45710551769315,0.6026923819780313,73573,74047,Putnam,Putnam,12,107,Florida,FL
12109,12CS043,1920,1801,2040,1984,-56,64,183,27.63182458060963,101,43.784861709199156,-66.480777432271,-17.474957567072842,36.28721022419206,1.560104553563597,2465,2315,2615,2677,62,212,362,72.95094511506288,300,103.37769385040559,-80.25820256903177,-30.391345441076787,22.429590849737615,1.410422755302129,276808,290198,St. Johns,St. Johns,12,109,Florida,FL
12111,12CS044,2952,2809,3095,3405,310,453,596,163.52581790608426,362,130.808701308087,-18.661733423638516,31.623175024223254,83.68446808855255,0.798163169066189,3718,3541,3894,4440,546,722,899,211.38474687865082,522,152.72759190719313,7.281009342659451,56.39055396742048,109.0026498393705,0.721511335245088,332088,341785,St. Lucie,St. Lucie,12,111,Florida,FL
12113,12CS045,1426,1344,1507,1572,65,146,228,92.87416870435534,130,82.5497282738111,-39.75625057393317,9.7493059247029,62.4358557872079,0.8827982460204716,1796,1696,1896,2097,201,301,401,155.72339389433483,332,171.76352508420032,-69.66291471096943,-16.72018831548052,30.882835058428054,1.0993516146467661,188977,193289,Santa Rosa,Santa Rosa,12,113,Florida,FL
12115,12CS046,5035,4847,5223,5783,560,748,936,205.5113171814933,387,106.32963560806401,47.932065041633855,98.83320439241234,151.9619479343341,0.5166998680445322,6258,6028,6488,7121,633,863,1093,193.6613735684331,682,153.12216544378484,-11.738175694796833,40.24838914950125,88.44585057923703,0.7897540309670558,436755,445396,Sarasota,Sarasota,12,115,Florida,FL
12117,12CS047,3033,2830,3235,3358,123,325,528,82.87053787787117,248,63.17612893364808,-30.91183959660968,19.679074730171955,68.3615529568313,0.7600110180726649,3736,3493,3978,4398,420,662,905,140.87361917028645,530,112.7098423338168,-24.75193564657636,29.95574795057935,78.47862625143628,0.7988717466563122,471064,470234,Seminole,Seminole,12,117,Florida,FL
12119,12CS048,1704,1647,1760,2017,257,313,370,285.1033570166248,117,106.51695622486913,127.44855859154912,177.09966300891543,227.79881630270998,0.37241899424230596,2130,2060,2199,2742,543,612,682,453.72242913729696,320,237.13013257056474,165.72779633673937,217.76890403478194,265.2023460431406,0.5217804136603547,131810,134947,Sumter,Sumter,12,119,Florida,FL
12127,12CS049,6297,6058,6536,6918,382,621,860,134.1052926166772,402,86.79849578062868,-4.1590579186273136,47.843143504003955,99.26999139352282,0.6462009704239194,7779,7488,8069,9312,1243,1533,1824,272.3238111298838,1137,201.9448514719595,20.061082968767522,70.9234070166845,125.81666035033439,0.7410781534554972,555770,563025,Volusia,Volusia,12,127,Florida,FL
13001,13CS001,177,169,185,232,47,55,63,360.1077622101906,48,312.5508709099788,-1.4386460245598727,45.93307211962461,104.02821301986134,0.8525217389816452,216,207,226,269,43,53,62,286.3353909198877,58,313.8697981492505,-77.36963464899786,-29.290431284097135,25.09811398666803,1.0758289325975976,18429,18479,Appling+Jeff Davis+Long+Wayne,Appling,13,1,Georgia,GA
13161,13CS001,146,140,152,186,34,40,46,324.391987298509,26,210.32762572468653,62.80697427759212,114.22887844678621,163.99693754686453,0.6325994635349422,178,171,186,216,30,38,45,253.12795880592682,35,235.56333288464126,-31.881636412106666,17.323623695875384,71.10898685477714,0.9065067263777568,14834,14858,Appling+Jeff Davis+Long+Wayne,Jeff Davis,13,161,Georgia,GA
13183,13CS001,80,78,82,105,23,25,27,177.74616344203125,4,28.457935613920668,137.6999961571643,149.55295001927723,160.59292427663783,0.15394263745453482,99,97,102,149,47,50,52,291.22223588358963,29,170.32773405380007,108.51475865648261,120.4915882838891,132.93744406921127,0.5733095023976843,16867,17026,Appling+Jeff Davis+Long+Wayne,Long,13,183,Georgia,GA
13305,13CS001,299,286,312,336,24,37,50,146.27616302904948,40,159.16174812653358,-66.54536472252349,-13.051287419020902,38.23655098576406,1.0592760915779387,367,351,383,512,129,145,161,478.0292366994643,103,339.40751968893136,84.64977181582232,138.58658992593132,192.82113444904587,0.7051532826254152,30158,30347,Appling+Jeff Davis+Long+Wayne,Wayne,13,305,Georgia,GA
13005,13CS002,127,122,132,146,14,19,24,205.76070518120514,25,269.9055330634278,-118.02144160215845,-66.61821101832442,-14.063106578102863,1.2463491120833008,155,149,160,185,25,30,36,274.6067252183233,40,360.8479927830401,-135.25415909888508,-86.1323965244037,-33.95976690624777,1.2722583389305637,11115,11085,Bacon+Ben Hill+Coffee+Irwin,Bacon,13,5,Georgia,GA
13017,13CS002,195,188,202,267,65,72,79,504.9811111814387,50,351.1030487448066,101.09217162034139,154.5808166088815,203.35110829828207,0.6857438934725993,239,230,248,287,39,48,57,281.2383379765015,39,227.312467214548,4.058234449068969,54.1682212465473,104.41043084518007,0.7918450252867701,17089,17157,Bacon+Ben Hill+Coffee+Irwin,Ben Hill,13,17,Georgia,GA
13069,13CS002,362,343,380,479,99,117,136,326.8008043571367,94,261.61981630949066,15.733808680078912,64.5398853450759,114.77233676655075,0.7937879907934687,446,424,469,551,82,105,127,241.22201719265183,113,260.74716754736136,-73.65123046059713,-18.715384490075554,32.19861569864664,1.0707004789532462,43116,43337,Bacon+Ben Hill+Coffee+Irwin,Coffee,13,69,Georgia,GA
13155,13CS002,99,99,100,121,21,22,22,268.61591995275893,18,224.74248257205284,32.12080683951565,44.276238596094124,56.619965179394576,0.7995061993083525,122,121,123,155,32,33,34,341.25239600791593,27,280.60694242361257,47.74293341576369,60.6533837440001,73.06728324576075,0.7979830406728016,9611,9622,Bacon+Ben Hill+Coffee+Irwin,Irwin,13,155,Georgia,GA
13011,13CS003,153,145,161,168,7,15,23,100.20953044143414,18,118.14899901542502,-70.43666661192017,-19.40050200266944,34.771001088102516,1.1065400105327767,190,180,199,268,69,78,88,422.659954598535,41,221.7414818820984,153.12995957570035,202.30148422900905,252.86236851072135,0.5180049316150429,18282,18490,Banks+Habersham,Banks,13,11,Georgia,GA
13137,13CS003,409,389,429,508,79,99,119,256.85235723600175,74,192.6539821664895,11.927011844926712,63.937034890707565,110.87214181297709,0.7425310593054503,507,483,531,608,77,101,125,216.7437039800568,94,201.38829376981747,-38.29237507452199,14.443890044612775,66.73166554485006,0.9200596280059056,46093,46676,Banks+Habersham,Habersham,13,137,Georgia,GA
13013,13CS004,567,530,603,619,16,52,89,74.51768445428843,55,78.39597092222168,-55.182889414736664,-3.284168400268454,49.3841074769096,1.0322992646453586,716,672,761,889,128,173,217,200.44101340469948,114,132.150930272996,16.479819443193893,67.12309099497081,118.54374379187954,0.6555098121769267,84188,86265,Barrow,Barrow,13,13,Georgia,GA
13015,13CS005,816,769,863,1038,175,222,269,243.68204932197023,119,130.71656109260005,62.88343373826294,113.01696356477096,166.59014965038307,0.5340154012160924,1018,961,1075,1338,263,320,377,288.9869499846984,182,164.5272102693907,73.37899682737411,127.02723566992923,175.64465879527964,0.5675486342045873,109244,110620,Bartow,Bartow,13,15,Georgia,GA
13021,13CS006,1498,1430,1565,1827,262,329,397,252.50884132143796,199,152.58980945443392,49.070578798885784,99.40206928029743,154.83054429840053,0.6024654361669743,1835,1754,1916,2317,401,482,563,307.08678773094294,332,211.71849093181643,46.584773544860425,97.01657988490742,147.055257927977,0.6880131255067137,156498,156812,Bibb,Bibb,13,21,Georgia,GA
13023,13CS007,134,129,139,175,36,41,46,390.11331198987614,30,285.01306309872535,54.48078499882862,105.53238212234612,156.6693925966863,0.7132213667177376,163,157,170,197,27,34,40,266.007339883345,43,341.1886058874871,-124.717119079073,-75.03152988820193,-23.076993633071154,1.2454777194414666,12631,12603,Bleckley+Dodge+Pulaski+Twiggs,Bleckley,13,23,Georgia,GA
13091,13CS007,187,178,196,289,93,102,111,613.4091031143269,67,402.8056112224449,159.30083276870468,211.29196056103774,260.4610630069422,0.650293626676415,227,217,238,320,82,93,103,468.7877011879304,64,323.69006676107625,93.41642038048582,145.01903498826061,195.91561701570382,0.6831133005052029,19960,19772,Bleckley+Dodge+Pulaski+Twiggs,Dodge,13,91,Georgia,GA
13235,13CS007,90,89,91,111,20,21,22,250.63490840673495,22,262.4776297474647,-24.21523587710966,-11.36373691082907,-0.7172776659988741,0.9996645410723713,108,107,110,174,64,66,67,661.7515118297674,34,343.1224139671006,307.2878863220396,318.2405780951337,330.9030043054785,0.5107178856889519,10058,9909,Bleckley+Dodge+Pulaski+Twiggs,Pulaski,13,235,Georgia,GA
13289,13CS007,93,92,94,131,37,38,39,574.6163459512811,19,285.0712678169542,276.70949481804,289.7285544366357,301.98348648664296,0.48348295677345826,111,110,112,161,49,50,51,628.814882599986,26,330.1587301587301,286.17231832686076,298.4382067372752,310.88971887218526,0.5146560992241906,7998,7875,Bleckley+Dodge+Pulaski+Twiggs,Twiggs,13,289,Georgia,GA
13025,13CS008,170,162,178,207,29,37,45,242.42965660211993,29,191.1667765326302,1.1806970188519674,50.89299186355677,103.89498861358572,0.7676714207431367,209,200,219,294,75,85,94,467.5424379638609,67,370.3294273712138,46.90109633351908,96.54537381073621,149.1419257200295,0.7828220531293593,18204,18092,Brantley+Pierce+Ware,Brantley,13,25,Georgia,GA
13229,13CS008,192,184,201,252,51,60,68,362.5449956117955,37,225.2892226507002,86.3105224102317,139.04090422061668,188.37728984189266,0.6111462527188882,240,229,250,346,96,106,117,533.4041822151544,78,391.1931390741762,89.05673112418143,143.3404226511122,196.1212379531877,0.7265582959502549,19708,19939,Brantley+Pierce+Ware,Pierce,13,229,Georgia,GA
13299,13CS008,411,395,426,505,79,94,110,313.68876376237785,72,239.0702822357499,23.98060272214175,74.10051430889325,128.54453128928893,0.7541430786199711,503,484,521,650,129,147,166,408.7057210701623,144,399.33444259567386,-41.783790823792515,8.713374543110046,63.68243218819708,0.970485886379622,36140,36060,Brantley+Pierce+Ware,Ware,13,299,Georgia,GA
13027,13CS009,183,176,190,200,10,17,24,123.55283275688487,28,208.28167617158442,-139.97221999132893,-85.72350721186328,-38.071063841081546,1.5900400662298595,226,218,235,231,-4,5,13,28.66466054554257,35,215.1992129857354,-243.72382857589005,-185.5882625944358,-129.59332778709103,6.181539023569842,16132,16264,Brooks+Thomas,Brooks,13,27,Georgia,GA
13275,13CS009,473,453,492,539,47,66,86,174.2969612251737,76,200.0921476995985,-80.74922250814414,-25.99747489883924,23.816251699602716,1.1309129454566966,584,560,607,693,86,109,133,238.39092062335416,85,185.46398725753312,4.021110774104927,53.24601772013796,103.0594199321986,0.7709265087312624,45579,45831,Brooks+Thomas,Thomas,13,275,Georgia,GA
13029,13CS010,283,264,302,295,-7,12,31,31.92777559425682,19,51.3201431561888,-72.42313815546886,-19.830877768258954,31.32174935429272,1.4820060227065937,363,339,387,369,-18,6,30,13.200120879379321,54,115.74322151966564,-152.59666623822613,-104.4137364158028,-52.176572866049725,7.543462501266849,44427,46655,Bryan+Liberty,Bryan,13,29,Georgia,GA
13179,13CS010,333,305,361,384,23,51,79,93.73445778317259,35,64.69500924214417,-23.248563096331957,29.932862092577434,77.45761070729569,0.6768472006945286,416,382,450,602,152,186,220,283.28491446285955,102,155.39542040555156,77.36574173100848,128.6739483075072,178.81172222378095,0.5456138967948674,64920,65639,Bryan+Liberty,Liberty,13,179,Georgia,GA
13031,13CS011,486,451,521,559,38,73,108,107.50865579904037,53,78.27981340849507,-20.021447008254615,27.952056765639483,81.82687454029771,0.7182580947493763,606,564,649,748,99,142,184,172.06762295018902,146,177.42778324644232,-59.212353525139804,-5.055102525519847,47.30565372001086,1.0239198555869131,81247,82287,Bulloch,Bulloch,13,31,Georgia,GA
13033,13CS012,224,213,234,248,14,24,35,120.90022331198907,25,123.56357345854441,-58.393830629613944,-1.0878850952031167,49.63664588314639,0.9818885672995095,275,262,287,286,-1,11,24,46.649464880401794,52,213.5085198111271,-216.55621689989118,-167.92812182775413,-113.30961639492354,4.206616998765809,24279,24355,Burke+Emanuel+Jenkins+Screven,Burke,13,33,Georgia,GA
13107,13CS012,255,245,265,304,39,49,59,258.08450883986785,47,248.34874504623514,-40.282281266724176,11.402364770925193,61.419042346661726,0.9429704834195726,313,301,324,407,83,94,106,415.5207854792935,82,360.9472664847258,1.8993910800329068,54.67084635679068,110.37483751299538,0.859556695596132,22710,22718,Burke+Emanuel+Jenkins+Screven,Emanuel,13,107,Georgia,GA
13165,13CS012,86,85,87,110,23,24,25,332.12997839907183,26,359.8615916955017,-39.79534179134349,-27.621132970529203,-16.027192231897523,1.0401501586010098,105,104,106,133,27,28,29,321.3609767358743,20,231.42791020597085,76.47897841967949,90.34752255688406,102.26604807337539,0.6951198786847054,8670,8642,Burke+Emanuel+Jenkins+Screven,Jenkins,13,165,Georgia,GA
13251,13CS012,154,148,160,181,21,27,33,233.76613722910065,17,145.21640091116174,38.392154834619475,86.91024590003293,135.72785361859104,0.5993043317982714,189,182,196,252,56,63,70,447.6734676375486,43,305.00780252518086,89.11795619371424,142.31138903368574,194.78239246226445,0.6706907543395317,14048,14098,Burke+Emanuel+Jenkins+Screven,Screven,13,251,Georgia,GA
13035,13CS013,242,231,253,290,37,48,59,226.44869479364561,41,193.12293923692886,-16.871107044617155,32.32789914198083,85.42958787633958,0.8354549490216885,298,285,311,361,50,63,76,244.3640062417114,55,213.62541754058884,-25.522829862197955,29.262427747884356,85.76253793907445,0.860531917301924,25476,25746,Butts+Lamar+Monroe,Butts,13,35,Georgia,GA
13171,13CS013,180,172,188,236,48,56,64,356.9379183474045,28,179.95822398371806,126.61005980679512,176.4282603234531,229.0643590689706,0.4952547028069969,224,215,234,307,73,83,92,434.7155225042634,55,289.4279850549913,95.50102661483437,144.83044903861173,199.9670546646629,0.6578239913223837,18671,19003,Butts+Lamar+Monroe,Lamar,13,171,Georgia,GA
13207,13CS013,247,235,259,303,44,56,68,240.4082295855481,43,183.87855462903568,7.6713190788148244,56.439663017183335,103.95657292433395,0.7514925276621861,307,293,322,372,50,65,79,226.05350100376901,65,227.15359077406953,-53.08240575686169,-0.9600534923987524,49.93190144431201,0.9895682860814006,28062,28615,Butts+Lamar+Monroe,Monroe,13,207,Georgia,GA
13007,13CS014,28,28,28,38,10,10,10,425.9601586120449,5,208.9864158829676,204.40822490554459,217.22615244211872,228.60546872709966,0.44678373279072386,34,34,34,46,12,12,12,422.3799675754113,3,106.26992561105206,303.3675215253676,315.9135141775359,327.924159249935,0.2321301116791353,2871,2823,Calhoun and Nearby Counties,Baker,13,7,Georgia,GA
13037,13CS014,52,51,52,70,18,18,19,388.1031657898093,2,42.507970244420825,333.93430775970904,345.3023480586833,358.06323189279027,0.10384079073668549,63,62,64,68,4,5,6,88.89439599553657,2,36.25815808556926,39.86881551823242,52.726731885901266,66.29422863937184,0.3387869630712938,5646,5516,Calhoun and Nearby Counties,Calhoun,13,37,Georgia,GA
13061,13CS014,36,35,37,37,-0,1,2,39.77730935985494,5,210.5263157894737,-221.80208443978154,-170.63998763894753,-117.55385873434312,2.5710759849885996,45,43,46,57,11,12,14,431.2328966273958,2,69.56521739130436,309.6386658520557,362.9974820742006,413.3062075631214,0.14927661547029605,2850,2875,Calhoun and Nearby Counties,Clay,13,61,Georgia,GA
13099,13CS014,141,137,146,172,26,31,35,343.35846447765624,35,392.52336448598135,-99.78778016193948,-51.27131107913828,4.576176607380311,1.1070298698031429,172,166,177,194,17,22,28,209.9645105330696,23,216.02329294636985,-59.751150554490714,-6.939920812537913,46.908930438767044,0.9848031414953976,10700,10647,Calhoun and Nearby Counties,Early,13,99,Georgia,GA
13177,13CS014,224,210,238,267,29,43,57,157.2765071472442,32,117.26623099004459,-8.874291843533525,39.453301721436134,92.644997045315293,0.7286283481743552,283,266,300,310,10,27,44,81.01604253815323,43,128.83123108727565,-98.12322697026342,-47.165256960333835,2.8028255307944683,1.533483914527941,32746,33377,Calhoun and Nearby Counties,Lee,13,177,Georgia,GA
13201,13CS014,81,81,82,95,13,14,14,277.7212634162101,3,60.67756615540199,205.06451074996696,217.18974213405437,228.61564158239776,0.20365213263182677,101,100,101,128,27,27,28,463.78405442393984,20,337.32501264968795,114.28404655107009,126.53052795172943,139.41854483944243,0.7018096297891435,5933,5929,Calhoun and Nearby Counties,Miller,13,201,Georgia,GA
13239,13CS014,28,27,29,33,4,5,6,253.08979133855206,5,268.21636119803304,-70.1544690118251,-16.147394466973928,36.03077446040844,0.8744292449897201,35,34,36,51,15,16,17,725.2782013522692,5,223.2142857142857,452.256780772162,500.8675035360887,550.7742806974918,0.28991840559677157,2237,2240,Calhoun and Nearby Counties,Quitman,13,239,Georgia,GA
13243,13CS014,74,74,75,104,29,30,30,556.6457485842376,25,466.56298600311044,78.68304134295168,90.71106314177757,102.66004032753774,0.8109791079577415,90,89,91,115,24,25,26,393.2274205881386,6,95.23809523809524,284.8940111540108,297.8731927430335,310.24187624989605,0.23279881112309306,6430,6300,Calhoun and Nearby Counties,Randolph,13,243,Georgia,GA
13273,13CS014,104,103,105,136,31,32,33,429.3915486011065,31,411.09514863520826,5.974350735358013,18.308529039916326,29.789976321469293,0.9287081383541148,128,127,129,135,6,7,8,79.45157245159966,15,166.8149466192171,-99.2942825714014,-87.49142971925916,-74.64864259560827,1.8417822157225916,9049,8992,Calhoun and Nearby Counties,Terrell,13,273,Georgia,GA
13039,13CS015,331,307,354,357,3,26,50,57.081860891182394,22,48.025322442742535,-44.442436346269524,8.836644117489913,62.974213324236324,0.8103511368762619,416,387,445,529,84,113,142,203.29893714103923,82,147.60413291572164,7.110370598733342,55.733284203947264,106.80322734127087,0.7196726550645268,54971,55554,Camden+Charlton,Camden,13,39,Georgia,GA
13049,13CS015,96,94,97,141,44,45,47,428.6984713685925,17,161.0865445356917,254.34589623876622,267.94879085348293,279.00005457384543,0.3676313273317827,119,117,120,178,58,59,61,465.6087040144545,45,353.440150801131,99.87969799894073,112.1269332042152,124.32730428460938,0.7465001560076282,12664,12732,Camden+Charlton,Charlton,13,49,Georgia,GA
13043,13CS016,133,129,138,174,36,41,45,444.7934687512135,35,382.47882706493033,12.209728539364558,61.05018628519927,111.87886272554199,0.8392820646334622,162,156,168,234,66,72,78,654.3654627322046,42,380.71065989847716,221.01750537053084,272.10957124895765,321.01074388438315,0.5738520395599325,10981,11032,Candler+Evans+Tattnall+Toombs,Candler,13,43,Georgia,GA
13109,13CS016,98,97,99,126,27,28,29,309.077812357494,11,122.97372833985466,173.72972524165831,186.1965075044293,198.3612947234688,0.38398422309692654,119,118,121,179,58,60,61,558.2542680532704,33,308.87308124298016,236.55164940919482,249.48032963758052,261.7542747367644,0.5441603791789792,10734,10684,Candler+Evans+Tattnall+Toombs,Evans,13,109,Georgia,GA
13267,13CS016,189,179,199,242,43,53,63,275.90950680644397,34,175.61983471074382,48.1421475504391,100.08233736194356,149.6950332447834,0.6248153059999159,228,216,240,346,106,118,130,511.26815820761726,74,321.41771272206057,138.17520324015828,189.4029573514873,240.78916031064725,0.6233717148354171,23232,23023,Candler+Evans+Tattnall+Toombs,Tattnall,13,267,Georgia,GA
13279,13CS016,262,250,274,364,90,102,114,453.314437201936,47,208.83474654719146,195.7407512793353,245.5059288156922,293.854760944411,0.4562123870467912,316,303,330,455,125,139,152,514.2753600797637,96,356.45328976682015,106.12754036212193,159.19047044609022,208.77086610912363,0.68814915415033,27007,26932,Candler+Evans+Tattnall+Toombs,Toombs,13,279,Georgia,GA
13045,13CS017,957,905,1008,1159,151,202,254,202.4898950107605,126,126.1903370917801,27.228301826376665,76.02828708658278,126.98004660275943,0.6201261262395311,1192,1129,1255,1501,246,309,372,254.12928600563296,207,170.22606350172282,35.579164634510406,85.12118249438974,135.39423654943673,0.6676798290661468,119819,121603,Carroll+Heard,Carroll,13,45,Georgia,GA
13149,13CS017,111,110,112,135,23,24,25,249.2681939598839,4,41.637751561415676,195.47738369284014,207.78469704444896,219.5429001891454,0.16034400523734424,136,135,138,178,40,42,43,360.9816110763215,28,242.42424242424244,106.10779495916006,118.57598877987913,131.6332309753858,0.6558394432893292,11528,11550,Carroll+Heard,Heard,13,149,Georgia,GA
13047,13CS018,569,540,598,645,47,76,105,134.31408674908988,60,105.93999676294455,-25.694911174505833,27.814802414990254,79.43164954112133,0.7785140268536039,700,664,735,901,166,201,237,294.79971526709403,151,220.96698665417938,21.946721983494033,73.43208157420094,124.07254648424244,0.745847211297145,67963,68336,Catoosa,Catoosa,13,47,Georgia,GA
13051,13CS019,2133,2006,2260,2425,165,292,419,119.03708743701411,193,78.67809922408989,-12.026572475111715,40.428793787838075,91.47285676846286,0.6586987027106557,2639,2486,2792,3199,407,560,713,189.0684049128613,396,133.72911748913452,3.966383671134891,56.088702738644486,105.54670063033123,0.7060443891065193,294364,296121,Chatham,Chatham,13,51,Georgia,GA
13055,13CS020,276,266,287,336,49,60,70,287.2207958414903,36,173.4173658223275,60.46944967069111,112.20177428240832,167.98859969449106,0.5938179228264128,337,324,350,380,30,43,56,173.49626036205353,48,192.53910950661853,-72.88666899329696,-19.623615047891075,33.45258223130424,1.0846815959328115,24911,24930,Chattooga+Dade+Walker,Chattooga,13,55,Georgia,GA
13083,13CS020,163,156,170,207,37,44,51,327.0169732168151,2,14.799284701239438,263.8237452833611,311.31698121444026,365.55426239437753,0.04425403527312229,200,191,208,247,39,47,56,290.67556747104504,31,190.05579057078046,50.57079327895317,101.61118380823463,152.85256970701803,0.6403358921472423,16217,16311,Chattooga+Dade+Walker,Dade,13,83,Georgia,GA
13295,13CS020,705,675,734,830,96,125,155,221.1051612398802,63,111.02299762093575,60.71672433296157,108.62087499819597,158.778416453915,0.4981571201371373,864,829,899,1000,101,136,171,199.0093390258022,156,228.09351834252044,-77.41537114451025,-29.088824737243307,20.817875073305256,1.1377853936976772,68094,68393,Chattooga+Dade+Walker,Walker,13,295,Georgia,GA
13057,13CS021,1449,1333,1564,1630,66,181,297,81.2962961248312,116,52.04166323959353,-19.412985294298615,29.995809561010205,81.19690455434787,0.6366347430440918,1832,1691,1974,2243,269,411,552,150.01165775924386,260,95.00944613147114,2.8724978035494724,53.630009250073904,110.56621972274682,0.631808031842963,267478,273657,Cherokee+Pickens,Cherokee,13,57,Georgia,GA
13227,13CS021,303,289,317,334,17,31,45,111.96577549557459,23,82.8704398738928,-19.76271454695446,29.346528107227527,75.72102195715333,0.7170656142017783,377,359,394,470,76,93,111,274.6126442589367,86,253.51531409368275,-31.090853305092978,20.230633274671067,72.97964931988588,0.913369579113732,33305,33923,Cherokee+Pickens,Pickens,13,227,Georgia,GA
13059,13CS022,680,625,735,698,-37,18,73,16.60977237282046,50,46.701329431177804,-80.07209638334565,-29.224563471018254,18.79243701841735,2.6619849859094527,851,785,918,967,49,116,182,90.06006202790242,86,66.83297196900816,-28.675147836719386,22.214870448738736,72.02519244125862,0.7357446025876665,128476,128679,Clarke+Madison+Oconee,Clarke,13,59,Georgia,GA
13195,13CS022,261,248,274,282,8,21,34,83.6831889298685,26,103.04511526520906,-71.96336257482153,-20.839467871107022,35.397052959828905,1.1756905209356745,326,310,342,400,58,74,90,240.1328396818927,50,162.3692927193609,25.988629573482548,78.05401948055571,130.67617984918363,0.6671425024838636,30278,30794,Clarke+Madison+Oconee,Madison,13,195,Georgia,GA
13219,13CS022,249,231,268,292,24,43,61,121.86477154306618,27,77.37498208912452,-4.35509485511797,46.329893718609775,96.01044224437578,0.6203372461469491,317,295,339,350,11,33,55,77.476402496302,29,67.63532896424657,-40.77799720590514,10.006485698591584,60.25214889746988,0.8474685957115237,41874,42877,Clarke+Madison+Oconee,Oconee,13,219,Georgia,GA
13063,13CS023,1537,1409,1665,1920,255,383,511,154.86333554582396,204,82.52065544592504,20.96291443900756,73.18197922151222,123.7460928484576,0.5314729109072013,1912,1758,2065,2628,563,716,870,241.01599813520733,432,145.3830776789861,44.199479530256575,96.59179560604504,148.43631599988248,0.6023681452580929,296653,297146,Clayton,Clayton,13,63,Georgia,GA
13067,13CS024,3842,3513,4172,4574,402,732,1061,114.70214631223587,451,70.69704253318005,-4.75875664000177,43.460461531997645,98.15885986551746,0.6155120847568007,4786,4391,5182,5655,473,869,1264,113.2754461387514,629,82.03819928108975,-17.690008655126178,32.35506332219896,81.55396175629795,0.7234034486205653,765520,766716,Cobb,Cobb,13,67,Georgia,GA
13071,13CS025,423,404,443,525,82,102,121,266.27236470046637,55,144.05133465744157,66.63324543166507,121.5084282356471,172.39250648841548,0.5357229419237868,520,497,544,640,96,120,143,261.3012315474595,108,235.7049323439546,-25.16117609764792,25.313641321585816,77.2997398267431,0.8945712622763371,45817,45820,Colquitt+Mitchell,Colquitt,13,71,Georgia,GA
13205,13CS025,220,211,230,288,58,68,77,375.1644895977368,50,276.68895549919296,47.83366587524443,98.17586802277172,147.88562762168854,0.7267933117700086,269,257,280,288,8,19,31,90.34010199355926,35,162.45822502784998,-124.32254661912941,-71.71868387185748,-19.26167244519028,1.710414878688824,21685,21544,Colquitt+Mitchell,Mitchell,13,205,Georgia,GA
13073,13CS026,846,778,913,1012,99,166,234,126.86193167065713,101,77.13702004162344,-2.285404381527046,49.76606216878983,100.53265010989529,0.6044005358814271,1065,983,1147,1356,209,291,373,182.6499983301425,175,109.9101249207077,20.658910656102215,72.11379223367123,128.97132034705226,0.5996905860277466,157123,159221,Columbia,Columbia,13,73,Georgia,GA
13077,13CS027,924,860,987,1100,113,176,240,143.81321700681548,95,77.41041781254455,15.44916212651652,67.86803592963322,114.0181202064712,0.535237878001013,1158,1081,1235,1579,344,421,498,281.4629974190753,247,165.2461297616977,65.98352393538536,115.91408343000408,164.91128065601558,0.5857050028065997,147267,149474,Coweta,Coweta,13,77,Georgia,GA
13079,13CS028,130,125,135,140,5,10,15,99.9293445476479,5,49.419322955275504,-5.673341325792975,51.22984164025648,102.81322816603758,0.45003076900206873,160,153,166,213,47,53,60,440.0163871025818,30,247.0152326060107,139.61235387592464,193.2700335323768,242.7553364299937,0.5510654921554485,12141,12145,Crawford+Peach+Pike+Upson,Crawford,13,79,Georgia,GA
13225,13CS028,276,263,288,319,31,43,56,186.08134431468292,36,154.1425818882466,-19.404883826621926,31.23906416177029,81.97029814417421,0.8097293850341079,342,328,357,408,51,66,80,231.52901263754092,68,239.76587567434154,-61.88585463613359,-8.079071463146175,43.259652950749576,1.020041669608006,28026,28361,Crawford+Peach+Pike+Upson,Peach,13,225,Georgia,GA
13231,13CS028,174,166,182,190,8,16,24,102.77122956861648,32,202.16910603348424,-158.38253163298702,-98.59919023389439,-49.7613535561089,1.8532489970855688,218,208,228,264,36,46,56,235.65365642813754,55,283.5343849881431,-95.24575380834145,-47.92500541336019,7.250851096530996,1.177425215033549,18994,19398,Crawford+Peach+Pike+Upson,Pike,13,231,Georgia,GA
13293,13CS028,340,328,352,421,69,81,93,352.2386877152581,55,239.80815347721824,64.57856356649035,111.73311714066934,166.1697409011878,0.6724872021284921,418,404,432,548,116,130,144,469.34010542836296,97,349.94047404307514,73.97914814848032,119.32315336656082,167.98994404827312,0.7399136205805319,27522,27719,Crawford+Peach+Pike+Upson,Upson,13,293,Georgia,GA
13081,13CS029,198,190,207,318,111,120,128,704.1183020837119,45,265.14779534518317,389.2848288136238,438.6717156697981,490.7192816542434,0.37344208932701994,240,230,251,346,95,106,116,531.2817138938713,66,331.6083002562428,147.4871107600405,199.42557280773661,252.60414501110398,0.6183191116729532,20366,19903,Crisp+Dooly+Turner+Wilcox,Crisp,13,81,Georgia,GA
13093,13CS029,109,104,114,170,56,61,66,641.5393293549413,20,209.69855832241151,378.0315247660008,431.18176334583137,479.0942141623959,0.3216115903418527,129,124,135,174,39,45,50,408.448466912129,25,228.89580662882256,126.21967625648217,176.3895160680355,233.3676174227567,0.5481164994703549,11445,10922,Crisp+Dooly+Turner+Wilcox,Dooly,13,93,Georgia,GA
13287,13CS029,114,113,115,117,2,3,4,39.79652398239287,25,340.17462297312613,-312.2539569864365,-300.41757852625017,-288.1361521737521,6.369892727493252,142,141,143,135,-8,-7,-6,-80.77940998462499,15,167.28002676480426,-260.69116306141484,-248.22174397285298,-235.85510645753328,-2.4025025645586537,8819,8967,Crisp+Dooly+Turner+Wilcox,Turner,13,287,Georgia,GA
13315,13CS029,84,83,85,117,32,33,34,449.7529686511544,25,344.27358274041774,93.93069140609401,105.6938178127387,117.98149212063791,0.7427310088148251,104,103,105,171,66,67,68,766.7850160670191,17,194.55252918287937,559.4366593822409,572.0327046938547,584.9886981806894,0.24999384315186565,8714,8738,Crisp+Dooly+Turner+Wilcox,Wilcox,13,315,Georgia,GA
13085,13CS030,224,213,236,230,-6,6,17,24.56130601363771,18,79.82556635500202,-110.6825241607727,-57.27962567270459,-4.312579750799813,2.7529797903860875,287,272,301,317,16,30,45,107.39954417278051,56,197.97779820405853,-140.98743483548296,-90.59274305254905,-38.622887645293446,1.7846310405820867,27059,28286,Dawson+Lumpkin+White,Dawson,13,85,Georgia,GA
13187,13CS030,256,242,271,287,16,31,45,108.71305446886416,20,71.25679166295537,-10.69438912474448,37.43582944358369,88.77901595650248,0.6346579759137397,320,302,337,425,88,105,123,308.49595638098,67,196.02680008192164,59.60295636651634,112.62578641717657,163.99949183354036,0.629457682308312,33681,34179,Dawson+Lumpkin+White,Lumpkin,13,187,Georgia,GA
13311,13CS030,242,230,254,336,82,94,106,394.5892899548888,33,138.9815042291089,204.64749054767532,257.29471513359306,305.7096502766523,0.3484985149579222,297,283,312,448,136,151,165,530.8446284285226,67,235.99027860941845,242.18631062659992,295.9344923211385,348.5529476357155,0.4416259525862881,28493,28391,Dawson+Lumpkin+White,White,13,311,Georgia,GA
13087,13CS031,298,285,310,367,57,69,82,287.7256817221347,39,161.9825557247681,70.80781570558679,126.28029609066175,179.21317291337547,0.554964594924291,365,350,380,397,17,32,47,108.72673536969725,51,175.36620590055705,-115.91061640023861,-66.07440064873131,-13.547183836787726,1.5634623541788566,28892,29082,Decatur+Grady+Seminole,Decatur,13,87,Georgia,GA
13131,13CS031,234,223,246,273,27,39,50,178.07447694208187,38,175.71577203190628,-49.9913917057956,2.9571702662354507,56.105061767829596,0.9617796464582367,287,274,301,349,48,62,75,236.90421991045704,49,188.73738540944456,-2.603806994649705,50.07421770509908,99.07676636086273,0.7839363622643019,25951,25962,Decatur+Grady+Seminole,Grady,13,131,Georgia,GA
13253,13CS031,119,118,120,125,5,6,7,82.70408490349678,14,186.8535201868535,-116.21431080756125,-103.76119052284616,-91.99639745700424,1.945362125420064,149,148,150,163,13,14,15,154.27411655631826,28,304.74531998258595,-163.4461040217687,-149.94284484713012,-137.61081633273272,1.8451758020989755,8991,9188,Decatur+Grady+Seminole,Seminole,13,253,Georgia,GA
13089,13CS032,3969,3641,4297,4797,500,828,1156,130.2250171677327,479,75.371151783443,2.1964412711133496,56.62011861752001,107.60651644895148,0.5780777939160027,4910,4518,5301,5888,587,978,1370,128.97311440752293,564,74.34660015897518,1.6047384121525698,56.45316573584991,112.22057653420315,0.5758618009255337,762626,758609,DeKalb,DeKalb,13,89,Georgia,GA
13095,13CS033,781,745,818,1089,271,308,344,430.71608579062297,173,242.31388752713778,132.41898696446435,188.6943262639973,241.0471456652798,0.5607602362917133,953,909,996,1205,209,252,296,297.32876372393685,149,175.4592557701366,73.40276676517287,123.54341904792328,172.32439378104945,0.587790712348395,85674,84920,Dougherty,Dougherty,13,95,Georgia,GA
13097,13CS034,847,785,909,1034,125,187,249,154.80503300937218,108,89.40829096327775,11.677013352499717,65.16306053901252,116.78419829116706,0.5744819900709773,1053,978,1128,1309,181,256,331,175.66221022838397,164,112.62034582686681,10.506221446669443,64.49146351652814,113.1602604313134,0.6386222611838479,144953,145622,Douglas,Douglas,13,97,Georgia,GA
13103,13CS035,422,394,450,470,20,48,76,88.18615075079776,31,57.05696493757476,-16.811803568531367,33.01999122580928,85.1258048013603,0.6337782702330624,531,497,565,658,93,127,161,190.9355099390193,143,215.00849509088994,-80.93536013079765,-23.445577563943445,26.433004571276253,1.117280912493534,65198,66509,Effingham,Effingham,13,103,Georgia,GA
13105,13CS036,224,216,233,296,63,72,80,440.79051759381,27,165.64417177914112,226.63156914188852,275.81278909910276,325.54049141241603,0.3706303995349805,273,263,284,331,47,58,68,293.5880246973038,39,199.12182170938425,38.8436059578272,94.3825926513143,149.9477618552412,0.6666421602488694,19560,19586,Elbert+Franklin+Hart+Stephens,Elbert,13,105,Georgia,GA
13119,13CS036,264,254,274,323,49,59,69,301.753488699406,33,168.86993603411514,84.36526316145704,131.96518924366393,185.25464349606736,0.5502966014607964,326,314,338,369,31,43,55,181.6597044859007,43,181.18231997640416,-51.7655811618099,-1.132121475512671,53.60996414776123,0.974762764867928,23450,23733,Elbert+Franklin+Hart+Stephens,Franklin,13,119,Georgia,GA
13147,13CS036,257,246,268,324,56,67,78,308.74835299335314,36,166.28815581816082,90.7966874933022,141.59685497446867,195.10234515975736,0.5306490704023057,319,305,332,408,76,89,103,338.3952438953405,52,197.4933535890619,89.29906356084436,140.2773390654028,191.99537616001206,0.577139924543832,25979,26330,Elbert+Franklin+Hart+Stephens,Hart,13,147,Georgia,GA
13257,13CS036,326,314,337,330,-7,4,16,18.052765058081665,42,188.81354662271008,-219.3156423666776,-171.59801373618893,-116.47067921911241,8.37372801875355,399,385,413,488,75,89,103,331.3552120150216,69,256.9258266309205,24.82467691794169,75.41165021095011,121.97106731413074,0.7667624630827596,26693,26856,Elbert+Franklin+Hart+Stephens,Stephens,13,257,Georgia,GA
13111,13CS037,284,273,295,352,57,68,79,318.4512797130273,26,122.17088260631216,144.79013615727206,198.13406966562397,252.38871846757428,0.3780622688749642,347,334,361,470,109,123,136,476.6877676771232,79,306.7246466842677,121.38197774852578,169.22980019642887,223.3109720336302,0.6382512809788558,25538,25756,Fannin+Rabun+Towns+Union,Fannin,13,111,Georgia,GA
13241,13CS037,181,174,188,234,46,53,60,376.27175149931526,24,169.91150442477874,160.67524532567728,205.63540168143874,254.68474621701512,0.4432265162597654,221,212,230,286,56,65,74,381.8887408828977,46,269.22626711927893,60.40984346691557,111.00968391584408,163.71159496668545,0.6943447553715497,16950,17086,Fannin+Rabun+Towns+Union,Rabun,13,241,Georgia,GA
13281,13CS037,169,164,175,181,6,12,17,112.61843938988474,26,249.65991838041128,-188.3408609360549,-136.01459669354674,-82.08437234200859,2.0426967659179933,209,203,216,249,33,40,46,310.2211366884747,41,319.6631841571807,-60.28641480499428,-10.012398234463387,44.198634461804645,1.005173875304929,12497,12826,Fannin+Rabun+Towns+Union,Towns,13,281,Georgia,GA
13291,13CS037,279,268,290,361,71,82,93,396.88230638262655,31,149.87309133395107,195.1395932109297,246.39038703619596,297.73336608574823,0.3730813491779059,345,332,358,436,78,91,104,357.9984575104564,64,251.8594309550982,53.241216777004794,107.65304524146218,159.30698475677116,0.6958716152268513,24821,25411,Fannin+Rabun+Towns+Union,Union,13,291,Georgia,GA
13113,13CS038,793,742,844,868,24,75,126,75.58977574809477,70,70.67137809187278,-49.60356613779288,5.32916539561577,55.34725229916858,0.9226104729772913,987,925,1050,1189,139,202,264,167.48450678030107,145,120.42289197651337,-4.379054700100122,48.01654974935642,99.48690417961457,0.71546139792278,118860,120409,Fayette,Fayette,13,113,Georgia,GA
13115,13CS039,965,923,1007,1143,136,178,220,216.6336984865019,107,130.26011443411923,38.10212615831258,87.08866542378547,138.00344753195114,0.5979319120182585,1185,1134,1236,1454,218,269,320,272.87649044297257,207,209.6308673856904,8.695801148204318,63.857676066967336,115.60007360748386,0.7653856648092131,98572,98745,Floyd,Floyd,13,115,Georgia,GA
13117,13CS040,1091,982,1200,1196,-4,105,214,49.88010104606377,71,33.760089392912754,-33.32811387806194,17.24960730772591,64.35826447308203,0.670433726712572,1392,1258,1525,1702,177,310,444,119.76072827189367,201,77.56904030502771,-8.22833615108773,40.55070798712331,91.23999451590754,0.6456197009766078,252369,259124,Forsyth,Forsyth,13,117,Georgia,GA
13121,13CS041,5852,5393,6312,7006,694,1154,1613,129.63541714871087,687,77.18703624813328,2.686742073277565,52.69500372519932,106.49431818919376,0.5949006730892701,7237,6687,7787,8396,609,1159,1709,108.75490251729086,877,82.280048636234,-25.12801829731907,24.972930064580343,78.91326054285433,0.7559119373395745,1068055,1065872,Fulton,Fulton,13,121,Georgia,GA
13123,13CS042,308,294,321,363,42,55,69,211.32167878898437,33,125.66641279512565,33.25688354344983,86.09593177926635,133.54573422941348,0.5841424149050766,382,365,398,506,108,124,141,388.52419051993303,93,291.1800619931745,50.1748346698914,97.15358776851187,151.20125821174398,0.7434603001012947,31512,31939,Gilmer+Murray,Gilmer,13,123,Georgia,GA
13213,13CS042,326,309,343,406,63,80,97,239.42144677673883,41,123.16010814058276,59.3976820931848,115.76131531255226,169.27145504524864,0.5080331211196578,402,381,422,545,123,143,164,358.928031019981,92,230.2936243710731,75.8555958995543,130.4819878631019,181.3649128698329,0.6371713620126362,39948,39949,Gilmer+Murray,Murray,13,213,Georgia,GA
13127,13CS043,751,715,787,945,158,194,230,275.13017801800174,107,151.73179868357303,72.5023163288251,123.25419047453705,175.7628879522872,0.5486630576891092,922,878,966,1142,176,220,264,259.5910150412471,189,223.1404958677686,-11.435289557149462,33.80847942193697,88.64727894846426,0.855693069608434,84623,84700,Glynn+McIntosh,Glynn,13,127,Georgia,GA
13191,13CS043,105,100,110,148,38,43,48,449.1092986833863,12,125.4355400696864,274.5426157931774,325.3576441040289,376.95982725580063,0.27294569395788915,127,121,132,226,94,99,105,895.369551709343,25,225.18465141415962,617.6325608899436,670.2172000659627,720.7793733032313,0.24899424345166887,11480,11102,Glynn+McIntosh,McIntosh,13,191,Georgia,GA
13129,13CS044,483,459,508,593,85,110,134,227.35565985469287,61,126.63702575990865,47.179628221608105,98.05307320902361,151.56590288934288,0.5519596404371768,599,569,629,774,145,175,205,300.5347586284126,122,209.7733759757901,35.5564572778821,91.50785870059865,139.39524740024785,0.6940296190415242,57803,58158,Gordon,Gordon,13,129,Georgia,GA
13135,13CS045,3863,3451,4274,4746,472,883,1295,110.89653871449099,531,66.68564395810485,-6.061693724850021,43.3696101642549,95.58704259272389,0.6006518495310286,4873,4376,5371,6005,634,1132,1629,117.4352642800227,761,78.97779281457758,-13.750755265835261,38.434388068238604,91.9183103500169,0.6719281429204301,955528,963562,Gwinnett,Gwinnett,13,135,Georgia,GA
13139,13CS046,1338,1251,1426,1728,302,390,477,229.1109438954485,183,107.60064285994277,69.01268668098055,121.05664227370048,178.168985974965,0.46844208174723706,1672,1565,1779,2032,253,360,467,174.05179494810605,332,160.52761365064936,-37.33880673035918,13.222008191719878,62.943801908259786,0.919742898688923,204088,206818,Hall,Hall,13,139,Georgia,GA
13141,13CS047,94,93,94,159,65,65,66,904.2486096820323,40,553.2503457814661,340.0257338295496,351.0287698519526,363.5078964008099,0.6026167927959294,114,113,115,168,53,54,55,623.8735107091683,30,347.1017007983339,264.84944644617474,276.6132433597115,288.9647879254266,0.5462352891810828,8676,8643,Hancock+Jasper+Morgan+Putnam,Hancock,13,141,Georgia,GA
13159,13CS047,141,134,147,144,-3,3,10,28.63388181481878,16,131.12962710012292,-154.4272735564627,-102.22715404449299,-52.14898821898716,3.5604525127154405,177,169,185,225,40,48,56,315.85807176063116,53,349.0286466908133,-82.4162869451175,-34.41617513004182,18.812577468078484,1.082448947763994,14642,15185,Hancock+Jasper+Morgan+Putnam,Jasper,13,159,Georgia,GA
13211,13CS047,176,167,185,209,24,33,42,198.08230290903455,12,71.69172558000596,75.79488654556017,126.53835289343637,175.3725350069906,0.35133252676596805,219,208,230,294,64,75,86,364.6696203931304,38,184.75301439128745,131.39226430039375,179.24473511465033,231.78402774803064,0.49996547920946177,20086,20568,Hancock+Jasper+Morgan+Putnam,Morgan,13,211,Georgia,GA
13237,13CS047,210,200,219,258,39,48,58,261.0838390886475,30,162.32302281540265,45.05180488372451,98.77452334810127,148.2017208983933,0.6091043452534638,259,248,271,367,96,108,119,477.76918962456574,51,226.46536412078152,201.87967018620805,250.35023307689616,299.96855116980885,0.4696408434852567,22178,22520,Hancock+Jasper+Morgan+Putnam,Putnam,13,237,Georgia,GA
13143,13CS048,311,298,324,392,68,81,94,324.8976467575389,50,199.79354666844262,72.4135988658646,127.14393844332736,172.4837335361804,0.6074718287886945,383,367,398,448,50,65,81,214.3078089286573,68,223.05320474972117,-54.93512631539234,-10.32773323623211,41.24295230869165,1.02511720111081,30031,30486,Haralson+Polk,Haralson,13,143,Georgia,GA
13233,13CS048,422,403,440,504,64,82,101,230.35377902749286,46,128.5544609795291,47.13434836064621,102.58071818046271,154.772774632134,0.5513846041832883,517,495,540,668,128,151,173,346.86023360837527,88,202.70425909289844,93.31286751272938,143.26834362846455,193.97981239840328,0.5805422048765266,42939,43413,Haralson+Polk,Polk,13,233,Georgia,GA
13145,13CS049,253,238,268,284,16,31,46,106.90661927686396,29,99.32073748501627,-43.014883719445756,6.285279679306839,55.86827935676948,0.9002031371495418,317,299,335,347,12,30,48,84.49971692869907,58,163.26990203805877,-128.34279766549895,-77.58866213362775,-28.57304094701141,1.8699013286574122,35038,35524,Harris+Meriwether+Talbot,Harris,13,145,Georgia,GA
13199,13CS049,233,224,242,284,42,51,60,294.9273329989803,19,110.09705924960163,135.72678163259548,183.53082301369292,235.13602775774163,0.3661091983465737,286,276,297,401,104,115,125,551.799288619825,68,327.4268104776579,173.7149502149961,222.84663728918747,271.0797224785447,0.5882471187978142,20709,20768,Harris+Meriwether+Talbot,Meriwether,13,199,Georgia,GA
13263,13CS049,67,66,68,80,12,13,14,270.7755762284134,2,41.386445938954985,217.0545647000671,229.4180026009688,241.17826761015604,0.1419927143243072,81,81,82,98,16,17,17,290.9364617315112,20,348.4320557491289,-71.25940348500058,-57.29851249925415,-45.01818875329613,1.129959277350751,5799,5740,Harris+Meriwether+Talbot,Talbot,13,263,Georgia,GA
13151,13CS050,1426,1322,1530,1751,221,325,429,161.532530364195,151,75.14556342584144,36.90805020785927,85.50193043749468,135.5908943503738,0.4637750941655314,1788,1661,1914,2218,304,430,557,175.87764349656874,326,133.2042151370655,-7.274813205181689,41.518252203088295,92.77324774561775,0.7556132065056675,241132,244737,Henry,Henry,13,151,Georgia,GA
13153,13CS051,1097,1027,1168,1304,136,207,277,151.68615583688663,106,77.7896011448281,20.122601899937187,72.55604010424696,125.02293784215578,0.5103634099085352,1375,1290,1461,1705,244,330,415,197.99115849852,247,148.39112777257108,2.718898785207283,49.1416430217254,102.03329564228453,0.7472162945270866,163518,166452,Houston,Houston,13,153,Georgia,GA
13157,13CS052,580,547,613,680,67,100,133,156.59453638482557,77,120.71330589849107,-12.871313096804641,36.42913290160837,85.47241565505004,0.7632245511596965,736,695,777,865,88,129,170,161.54989211536886,139,174.26189431454898,-64.1345267900488,-12.57988191649254,37.14226265045272,1.0703812524986829,76545,79765,Jackson,Jackson,13,157,Georgia,GA
13003,13CS053,72,71,73,80,7,8,9,115.63615444116462,11,158.92126173850227,-55.04454499987982,-43.25957909584948,-31.63389768862347,1.2216861522340345,89,88,90,139,49,50,51,595.0356645240315,28,334.20864168059205,248.00262126566147,260.6676710164285,273.79409980763774,0.5506165256068402,8306,8378,Lanier and Nearby Counties,Atkinson,13,3,Georgia,GA
13019,13CS053,184,176,192,227,35,43,51,282.19042929958744,30,196.34578674665937,37.14239347804312,86.92682136640057,137.6194762069704,0.6800200540895844,223,214,233,286,53,63,72,344.8142882267659,37,203.86798170698108,89.15434934606712,138.17711511262578,191.86000444607382,0.5819408482434248,18335,18149,Lanier and Nearby Counties,Berrien,13,19,Georgia,GA
13065,13CS053,71,70,72,92,20,21,22,378.28240148725934,13,232.45417970496197,133.3528255707987,145.583423847036,158.35977257580996,0.5867632537118785,87,86,88,116,28,29,30,431.14339196281503,19,282.52788104089217,135.82699816985212,148.64757351119331,160.55822023547066,0.6334517231483054,6711,6725,Lanier and Nearby Counties,Clinch,13,65,Georgia,GA
13075,13CS053,167,159,174,213,39,46,54,321.5518325608735,32,222.82829455115183,47.27234849712695,96.89271734008265,148.33727196981752,0.6782891116734627,204,195,213,230,17,26,35,150.7700378912894,29,168.35016835016833,-65.13276033514165,-16.682925199950734,34.92331269413189,1.0752031677325975,17233,17226,Lanier and Nearby Counties,Cook,13,75,Georgia,GA
13101,13CS053,21,21,21,36,15,15,15,484.12701806579594,4,128.5140562248996,344.5538408118419,355.96742222203306,367.8708798884847,0.24893497159566386,26,25,26,42,16,16,17,444.17522453609723,4,108.13733441470669,322.8777141614724,336.1404244023813,348.7450312106188,0.2294888389819761,3735,3699,Lanier and Nearby Counties,Echols,13,101,Georgia,GA
13173,13CS053,78,77,79,84,5,6,7,75.07105739283736,10,119.85617259288851,-56.71054897853341,-44.93976744970052,-33.06554370455562,1.3767602894531332,95,93,96,114,18,19,21,196.41781433644354,3,30.278562777553493,153.86134062642017,166.06862990328685,178.07335916329217,0.14661984769824385,10012,9908,Lanier and Nearby Counties,Lanier,13,173,Georgia,GA
13185,13CS054,802,751,853,989,136,187,238,189.7285698185605,107,108.52660761376698,33.32086901867868,80.66917803404534,130.70300156673767,0.5689681941328846,998,937,1060,1238,178,240,301,201.33697490224847,156,130.94278807413377,17.459909765998873,68.58233524095505,123.39279191702047,0.647666193110346,118312,119136,Lowndes,Lowndes,13,185,Georgia,GA
13053,13CS055,35,34,36,35,-1,-0,1,-2.0782080881829725,4,49.70487729108419,-63.638478889517494,-52.06176376692902,-38.91548370157987,4.803326568195671,42,41,43,39,-4,-3,-2,-31.211914121213717,9,98.78169245966416,-142.79644901176547,-129.86785871202204,-117.83409268591876,-4.881441989652706,9657,9111,Marion and Nearby Counties,Chattahoochee,13,53,Georgia,GA
13193,13CS055,135,130,140,147,7,12,17,120.37416835737395,11,108.62409479920998,-40.66185143169744,11.304178228234576,62.46877555221191,0.8339720306662272,164,158,170,174,4,10,16,85.65933125707025,23,191.57088122605364,-157.95074368330475,-103.53047153788572,-56.813414042917486,2.0382374568565824,12152,12006,Marion and Nearby Counties,Macon,13,193,Georgia,GA
13197,13CS055,67,66,68,87,19,20,21,317.56593353877247,3,47.108086888249154,257.49022705710274,270.94991376690996,282.2733230472059,0.14135169879573445,80,79,81,127,46,47,48,625.1384269583755,30,402.5764895330112,209.76392140614513,222.70664802096582,235.97057224025048,0.6304465912702546,7642,7452,Marion and Nearby Counties,Marion,13,197,Georgia,GA
13249,13CS055,31,30,31,40,9,9,10,239.35286131564428,6,155.30629853321827,72.38059753192715,84.08868101567656,96.65461773486055,0.5855372946657531,37,36,38,58,20,21,22,469.5434245589595,2,44.57321149988857,412.7877985905638,424.8381386089533,437.73847170184746,0.09062726704974372,4636,4487,Marion and Nearby Counties,Schley,13,249,Georgia,GA
13259,13CS055,49,49,50,59,9,10,10,215.49822295007863,12,261.9610696743678,-58.36572826834965,-46.17693510458662,-34.17150931400674,1.1037919048421743,59,58,60,78,18,19,20,358.93683524490683,12,224.97187851518564,122.08513033262042,133.5873871775224,146.89976033766627,0.595660884698336,5497,5334,Marion and Nearby Counties,Stewart,13,259,Georgia,GA
13261,13CS055,311,298,323,342,19,31,44,126.9281075627908,69,280.64942548215436,-208.1879226013313,-154.1216621597706,-101.42609651349194,2.1424357764037527,378,363,393,431,38,53,68,179.6046605578662,58,197.80369688288656,-71.836174879749,-17.30010371139763,38.095658865183744,1.0808055196153739,29503,29322,Marion and Nearby Counties,Sumter,13,261,Georgia,GA
13269,13CS055,82,82,83,98,15,16,16,239.61520544692468,17,259.97196380782464,-31.76924871792047,-20.18629485993016,-7.780803776940244,1.0198671535619581,101,100,102,138,36,37,38,476.49604178562214,15,192.28304063581592,271.06827293453216,284.42011340109707,296.28928726347885,0.3929637872253885,7847,7801,Marion and Nearby Counties,Taylor,13,269,Georgia,GA
13307,13CS055,21,21,21,27,6,6,6,304.64178030609366,8,402.68456375838923,-110.71490488032705,-98.13785001530252,-86.3787222429221,1.1343950899352333,26,25,26,25,-1,-1,-0,-27.632429246344913,3,126.84989429175475,-165.95743342473443,-154.1920723953675,-142.33009963377194,8.658182363287255,2384,2365,Marion and Nearby Counties,Webster,13,307,Georgia,GA
13215,13CS056,1781,1692,1869,1981,112,200,289,117.12059765112107,190,111.09324523833885,-45.1580781511647,4.9647632335398555,56.036538923444816,0.9438253522742683,2186,2080,2292,2572,280,386,492,187.53872748029974,369,179.28896619747053,-41.50887598946012,8.575229875064943,58.08232998545011,0.9535399145251291,205233,205813,Muscogee,Muscogee,13,215,Georgia,GA
13217,13CS057,786,738,835,999,164,213,261,225.8300893045997,104,110.52170139657629,66.74634745907781,117.98490574586498,168.88673933414694,0.4871097821724447,988,928,1047,1256,209,268,328,233.23219375811325,199,173.0750832760765,6.8241602848609535,59.68414019257232,110.0577602219398,0.7393151021850035,112919,114979,Newton,Newton,13,217,Georgia,GA
13223,13CS058,849,776,922,1046,124,197,270,138.81406528357067,106,74.80724783429488,11.529834430353521,64.05847259196959,112.95551096229049,0.5361765930833021,1076,987,1166,1297,131,221,310,127.39404920834332,188,108.55819701003009,-29.75805863327375,18.314289225288093,70.62223017954199,0.8482998833681251,170037,173179,Paulding,Paulding,13,223,Georgia,GA
13245,13CS059,1775,1686,1863,2116,253,341,430,199.01498170764063,236,137.66150436025316,6.9951273748138085,61.34209995334265,116.3605859795449,0.6896927933407544,2175,2068,2281,2658,377,483,590,234.969113189353,391,190.01890469409872,-5.657600982620501,45.650192810878536,95.74310529929528,0.8070282134245831,205722,205769,Richmond,Richmond,13,245,Georgia,GA
13247,13CS060,655,615,695,777,82,122,162,156.84240023316423,71,91.38787287217497,8.874704967979167,66.89125753584332,114.02506550345683,0.5779303800160878,816,768,865,1011,146,195,243,207.37163077865364,151,160.61437658221118,-3.29310888076454,46.587743161378484,96.2777257999328,0.7705718509676037,93229,94014,Rockdale,Rockdale,13,247,Georgia,GA
13255,13CS061,662,633,691,839,148,177,206,315.0147930297857,94,167.40872662511129,97.16327639825445,146.93044303006192,197.05252623028306,0.5284437481621618,814,779,849,1108,259,294,329,432.90407722306537,205,302.1949673482023,80.20290650264873,132.29067054435848,181.77780094364894,0.6956955207085829,67380,67837,Spalding,Spalding,13,255,Georgia,GA
13133,13CS062,196,188,204,212,8,16,24,99.75350251178777,23,145.408566461198,-98.46324072716922,-45.26064223292568,6.653177752137165,1.3708010808983093,246,236,256,275,19,29,39,147.34614404557752,33,169.56990904886698,-74.47456241679997,-21.819986470845205,28.168052753956058,1.1120459376372858,18981,19461,Taliaferro and Nearby Counties,Greene,13,133,Georgia,GA
13181,13CS062,79,78,80,96,16,17,18,265.09176172707106,17,263.3277397702336,-10.605555500789624,2.0304944181493236,14.420464111042522,0.9385067045278916,97,96,98,122,24,25,26,325.17156974545384,17,219.58150348747094,92.10793725854734,105.66699108431688,118.3353921762463,0.649480075753177,7747,7742,Taliaferro and Nearby Counties,Lincoln,13,181,Georgia,GA
13189,13CS062,220,211,229,238,9,18,27,99.08631364102968,23,128.06236080178172,-79.26519295231243,-28.957535527442065,24.713926813778425,1.2236709941211619,271,260,282,311,29,40,51,184.2825002898169,37,171.09035420327382,-40.57683086067111,15.424260689527944,63.039346405898605,0.9056877148986052,21552,21626,Taliaferro and Nearby Counties,McDuffie,13,189,Georgia,GA
13221,13CS062,141,135,148,151,3,10,16,77.26604828766177,2,16.057808109193093,11.005684061038986,62.14216971707642,112.66492853529131,0.18826211479383703,176,168,184,195,11,19,27,126.50903643214798,20,132.4503311258278,-59.47702612552851,-5.456022117237261,45.47461975113234,0.9948830923449776,14946,15100,Taliaferro and Nearby Counties,Ogelthorpe,13,221,Georgia,GA
13265,13CS062,21,21,21,23,2,2,2,156.46309087813202,5,385.60411311053986,-241.11245673568448,-229.13850425463988,-216.64652625416554,1.6508162198855516,26,26,26,37,11,11,11,723.5387056187024,2,128.36970474967907,581.8357466294793,594.6127890256773,607.4567811318598,0.1629628864682647,1556,1558,Taliaferro and Nearby Counties,Taliaferro,13,265,Georgia,GA
13301,13CS062,66,66,67,89,22,23,23,523.9725816386695,6,138.1692573402418,372.19870998048464,385.6355430879572,398.0519018147194,0.25259425500701116,82,81,82,86,4,4,5,84.40702893723585,13,248.32855778414518,-176.41748844127602,-164.4968864334321,-151.62549108916357,2.3990958885944624,5211,5235,Taliaferro and Nearby Counties,Warren,13,301,Georgia,GA
13317,13CS062,134,130,138,135,-3,1,5,12.178589621166822,11,137.7439215277053,-176.82384668186958,-127.65915078520065,-72.70222536696319,5.576504428124683,163,158,168,179,11,16,21,170.79825379514847,21,220.6114087614245,-102.67695008322035,-51.12597708561919,2.3047054282922117,1.2168068294386893,9583,9519,Taliaferro and Nearby Counties,Wilkes,13,317,Georgia,GA
13277,13CS063,391,373,408,450,42,59,77,172.51975075053284,69,200.8149010477299,-73.5051399971864,-29.04874183085123,19.169967008913318,1.1447002978896923,484,462,505,546,41,62,84,151.09059498479536,79,191.5987582460225,-89.79353195437966,-40.73451493550185,9.071968402651317,1.2480711352059461,41232,41232,Tift+Worth,Tift,13,277,Georgia,GA
13321,13CS063,214,205,222,240,18,26,35,154.04376108037326,40,232.73855702094644,-128.75418863212968,-79.37139224547997,-27.65321349380207,1.4558696215591977,263,252,274,315,41,52,63,252.98475627230374,41,199.24190883467782,3.508178866682841,54.35070282590683,104.40412884832192,0.7727217441883383,20624,20578,Tift+Worth,Worth,13,321,Georgia,GA
13285,13CS064,600,570,630,789,159,189,219,326.2479482696276,100,172.61219792865361,100.15056474429997,153.3345764386909,204.3085265423918,0.5262983070510742,737,701,773,942,169,205,241,293.5892933690775,161,231.08278792054196,11.79400118199982,62.38460526383966,116.86748950303338,0.7832661940922546,69520,69672,Troup,Troup,13,285,Georgia,GA
13297,13CS065,783,741,825,904,79,121,163,149.36166249545002,91,112.48454882571075,-14.27513894978061,36.536315769982565,91.36527098370901,0.7469204819899117,983,931,1034,1244,210,261,313,262.64487552472946,213,214.16290457182504,-2.270024078983544,49.92390902452911,101.47999892882302,0.8122990036528552,97080,99457,Walton,Walton,13,297,Georgia,GA
13009,13CS066,390,371,409,498,89,108,127,294.97657332701846,45,122.85571279064477,122.40334414944388,172.6395407164476,221.70630556906218,0.4126736572470616,480,457,502,620,118,140,163,320.6996803567456,88,201.00502512562815,67.05839104731574,119.82378265440428,174.67050227699426,0.6223377378995317,43954,43780,Washington and Nearby Counties,Baldwin,13,9,Georgia,GA
13125,13CS066,32,32,33,38,5,6,6,228.29288848473212,10,414.0786749482402,-197.4661722945339,-185.85651795068426,-173.82750635601641,1.5353263413901153,40,40,40,51,11,11,11,373.49305707214717,4,137.26835964310226,223.38843637750463,236.1354581379288,249.18523435933517,0.33659868607646604,2898,2914,Washington and Nearby Counties,Glascock,13,125,Georgia,GA
13163,13CS066,192,186,199,257,58,65,71,497.48054000449656,33,253.87870239774333,189.4681006924571,242.64377532575023,295.1869817262456,0.5025571106468398,234,226,242,278,36,44,52,281.27154445033466,47,302.367472979928,-72.51233877196657,-20.614742411612198,29.196107481769314,1.0509639505568846,15598,15544,Washington and Nearby Counties,Jefferson,13,163,Georgia,GA
13167,13CS066,87,86,88,124,36,37,38,478.3449373396762,24,311.4186851211073,154.96703152871464,167.17316938051002,179.75419380201396,0.6338399238047158,106,105,107,142,35,36,37,390.81362546573826,25,272.89597205545243,104.84859215103992,118.40445198819877,130.67544320247757,0.6793028549658103,9248,9161,Washington and Nearby Counties,Johnson,13,167,Georgia,GA
13169,13CS066,219,207,232,263,31,44,56,183.88284308637967,18,76.03224330317857,55.14790959802811,108.85461156887985,160.5284782559396,0.40419708604006227,272,257,286,387,101,115,130,406.300231774508,60,211.31224906670425,147.51610334631846,195.18089711562243,244.70803926656959,0.5156194547099118,28409,28394,Washington and Nearby Counties,Jones,13,169,Georgia,GA
13303,13CS066,198,189,207,271,64,73,82,438.28637956246786,53,318.4139381195554,65.36919974656013,119.35996001798341,173.38684581294038,0.7166736488796519,242,232,252,312,60,70,80,354.65949611472234,58,292.84055336766636,9.163449099365018,62.43316118930258,114.16548784476883,0.8141052458756266,19974,19806,Washington and Nearby Counties,Washington,13,303,Georgia,GA
13319,13CS066,102,101,103,130,27,28,29,375.85299215051157,13,176.15176151761517,187.89015350722622,199.7930985928824,210.95828903407426,0.4523634994403487,125,124,126,193,67,68,69,767.287653888359,26,294.3507302162346,460.9383604055388,473.08810829760006,485.1021183262476,0.3780469944273488,8856,8833,Washington and Nearby Counties,Wilkinson,13,319,Georgia,GA
13175,13CS067,502,481,523,642,119,140,161,341.93585316296725,103,251.1123301030048,35.27824146608019,90.58787973373781,142.99761599830416,0.7291852723968418,617,592,643,811,168,194,219,390.68598672238454,116,234.15421881308032,104.29633251081438,157.20881377947578,210.7161677480204,0.5962605075415379,49221,49540,Wheeler and Nearby Counties,Laurens,13,175,Georgia,GA
13209,13CS067,76,75,77,101,24,25,26,341.49430394316244,14,193.81633594831564,135.99454616785218,148.14526090846266,160.10571796199287,0.5454416839078808,94,93,95,151,56,57,58,662.696505529759,30,347.14186530895626,302.747633812575,315.7243692805893,329.1535686139554,0.5148426386210737,8668,8642,Wheeler and Nearby Counties,Montgomery,13,209,Georgia,GA
13271,13CS067,116,110,121,192,71,76,82,704.8992091320475,33,305.90961761297797,345.29016831155053,398.317286273191,451.8290938514991,0.4283433374958601,139,132,145,185,40,46,53,371.2230412399664,32,257.62821028902664,61.52957671016778,113.44017711884354,164.8666050611696,0.6792668696525954,12945,12421,Wheeler and Nearby Counties,Telfair,13,271,Georgia,GA
13283,13CS067,63,62,63,93,30,30,31,562.1216066143146,13,241.86046511627907,309.0814682109373,320.4462210703855,332.62852566844083,0.4164792996308944,76,75,76,132,56,56,57,891.6917486438497,33,522.3171889838557,356.72866087223616,369.19377219685816,382.8146805237673,0.5755437372612555,6450,6318,Wheeler and Nearby Counties,Treutlen,13,283,Georgia,GA
13309,13CS067,53,53,54,68,14,15,15,233.00231577849164,12,192.0512136569752,29.025827383065455,39.884430110818954,52.112048868799306,0.7712696222458514,66,65,67,78,11,12,13,164.5109063592334,12,160.75016744809108,-9.666162314530105,3.7923572619388657,15.03207582837898,0.9035641657957172,7498,7465,Wheeler and Nearby Counties,Wheeler,13,309,Georgia,GA
13313,13CS068,733,689,778,916,138,183,227,212.77503192057878,138,160.83291247426283,2.967849430092796,52.20598341465435,100.68497624082701,0.7517647272943795,905,852,958,1139,181,234,287,227.86257785450604,199,193.52329086842363,-20.23200434337924,35.76829438599967,86.70352883170128,0.8456890026230387,102964,102830,Whitfield,Whitfield,13,313,Georgia,GA
15001,15CS001,1505,1418,1591,1531,-60,26,113,15.578712813907504,47,28.034874588672714,-62.771336271474276,-9.175862593389688,42.483812871969945,1.7332011624369092,1865,1760,1969,2053,84,188,293,92.98185967325749,107,52.81577167791264,-12.939402760541476,40.96266276895062,91.01137751526213,0.5650228289193181,201178,202591,Hawaii (county),Hawaii (county),15,1,Hawaii,HI
15003,15CS002,6754,6321,7188,6909,-279,155,588,18.45678210876444,275,32.7983883070764,-67.73834353561952,-15.431397137759372,37.45590768806871,1.7656277904211224,8295,7778,8813,8768,-45,473,990,47.13673976652947,470,46.873955932497516,-51.42458482312811,0.8317211862466228,55.50220191156489,0.9923255136766055,1006147,1002689,Honolulu,Honolulu,15,3,Hawaii,HI
15005,15CS003,1,1,1,1,0,0,0,447.26383620692224,1,1445.7831325301206,-1047.6041895171297,-997.1050045906068,-947.3419776110142,0.7637333655248306,1,1,1,3,2,2,2,2629.703316503797,3,3658.5365853658536,-1075.7018914780783,-1027.8885170519745,-975.2624461329144,0.9504629123300607,83,82,Kalawao+Maui,Kalawao,15,5,Hawaii,HI
15009,15CS003,990,919,1061,1026,-35,36,107,26.20883693316319,16,11.632768053510732,-35.9094103003571,14.408237362207878,66.617828841341165,0.43186879068317646,1222,1137,1307,1389,82,167,252,101.51076435444051,84,51.13096832314772,-1.0669254611188632,49.71874826050931,100.08581134709502,0.5006975667474998,165051,164284,Kalawao+Maui,Maui,15,9,Hawaii,HI
15007,15CS004,505,474,537,487,-50,-18,13,-30.31541848318514,3,4.926108374384236,-84.43951576603895,-34.32803673692604,18.018041347300834,-0.17180074233351686,626,588,664,591,-73,-35,3,-47.70622496475362,18,24.51748232698149,-124.33834153325735,-73.0373768862283,-20.27042127497546,-0.529030875197794,73080,73417,Kauai,Kauai,15,7,Hawaii,HI
16001,16CS001,2881,2667,3095,3261,166,380,594,91.72837363749008,315,76.04287369640788,-33.50897133510031,15.818150772299434,72.21560151741879,0.8268245725817144,3647,3383,3910,4154,244,507,771,99.50442039826243,451,88.449235826059,-42.725706549733175,10.084102252409515,61.59669500560048,0.8871490286007859,497088,509897,Ada,Ada,16,1,Idaho,ID
16005,16CS002,638,601,676,704,28,66,103,90.3753802313983,59,81.02169733589673,-42.53614609530921,9.84472661920647,56.382894595508596,0.8830834631514777,794,749,840,937,97,143,188,162.11480006492317,126,143.0111798422337,-34.84131680457647,18.179237827428057,71.089363956166,0.8760266265710418,87384,88105,Bannock+Bear Lake+Caribou+Franklin,Bannock,16,5,Idaho,ID
16007,16CS002,53,52,54,69,15,16,17,302.091414202977,6,113.3322839603337,176.30015510941396,188.79042991748622,200.59532927443874,0.3530819325082967,67,66,68,79,11,12,13,185.3702201009114,11,168.7375364319681,3.0696048413085824,16.172198973997133,28.823133474575325,0.8407032020174884,6353,6519,Bannock+Bear Lake+Caribou+Franklin,Bear Lake,16,7,Idaho,ID
16029,16CS002,58,57,59,74,15,16,17,270.5162991623964,7,119.23349893541518,139.69529181280006,151.16758496233882,163.39238487550247,0.4146535959406701,72,71,73,78,5,6,7,83.96524350801243,15,211.35691137100184,-139.88596376489974,-127.12630304296997,-114.72432410146604,2.1554779801231545,7045,7097,Bannock+Bear Lake+Caribou+Franklin,Caribou,16,29,Idaho,ID
16041,16CS002,97,95,98,91,-7,-6,-4,-48.85529291933999,5,42.08754208754208,-103.03230009537586,-90.16963984127489,-78.06573068316604,-1.0407974276047638,122,120,124,134,10,12,14,79.77400178188489,16,109.52902519167579,-42.162726574247856,-29.813041297659435,-17.060652253205287,1.264483654574076,14256,14608,Bannock+Bear Lake+Caribou+Franklin,Franklin,16,41,Idaho,ID
16009,16CS003,112,111,113,102,-11,-10,-9,-121.05029849670046,4,50.14102162331558,-183.15775803083315,-170.89186628734026,-159.3669903521632,-0.46206516806455106,141,139,142,158,16,17,19,174.7188833973574,23,232.81708674967103,-70.93141925095132,-58.05727150325812,-45.8643123427326,1.2595507840364895,9573,9879,Benewah+Latah+Nez Perce,Benewah,16,9,Idaho,ID
16057,16CS003,182,165,199,213,14,31,48,94.66764721491113,2,6.03090840557859,37.08267247415419,88.65391704460222,139.15923640145238,0.06173952626452721,227,206,247,303,56,76,97,189.87175011130074,29,72.11956927208972,66.04024888798044,118.26837357808559,170.45015141919666,0.37492244872690794,39795,40211,Benewah+Latah+Nez Perce,Latah,16,57,Idaho,ID
16069,16CS003,443,425,461,463,2,20,38,56.65684619223199,37,105.9438306807607,-98.67260339860829,-48.9244894730575,-0.9408919174029983,1.7799645027832733,543,522,565,609,44,66,87,154.48213103533905,58,136.7892266691823,-35.838518646596455,17.91282024673673,71.71337067886527,0.8721546356090505,41909,42401,Benewah+Latah+Nez Perce,Nez Perce,16,69,Idaho,ID
16011,16CS004,350,329,371,406,35,56,77,139.89141146928486,43,107.58292850739112,-20.1411256718275,33.36682028129679,82.55159916245574,0.7555334292864815,438,413,463,504,41,66,91,135.40404584704908,75,153.82091144017392,-71.07562663973695,-17.37167759520476,32.01763948657384,1.1190638473623513,47963,48758,Bingham+Oneida+Power,Bingham,16,11,Idaho,ID
16071,16CS004,38,38,38,39,1,1,1,25.543243218190142,4,105.44815465729349,-91.71640272009057,-79.71482016136638,-68.45843775947898,2.031549600211653,47,47,48,63,15,16,16,342.0901208620898,6,130.3497718878992,198.94227080938086,212.1883372174615,224.11980017800812,0.358285783176297,4552,4603,Bingham+Oneida+Power,Oneida,16,71,Idaho,ID
16077,16CS004,55,55,56,63,7,8,8,116.47586468031557,3,45.854031333588075,59.06505668701868,70.7093929261764,82.44792339197132,0.3480103429306187,69,68,70,88,18,19,20,239.92136825994118,12,151.13350125944584,76.15719118960362,88.49907478561823,101.28976505764675,0.5985110051737846,7851,7940,Bingham+Oneida+Power,Power,16,77,Idaho,ID
16015,16CS005,51,50,52,57,5,6,7,90.64681366673206,3,46.565774155995335,32.02597378445083,44.076659790591776,55.4184226716868,0.43860155884079116,66,65,67,93,26,27,28,341.3902405301113,3,37.36455349358575,290.10063871553564,303.78997081086555,316.9410021467755,0.10559579423481305,7731,8029,Boise+Gem+Payette+Washington,Boise,16,15,Idaho,ID
16045,16CS005,200,192,209,227,18,27,35,166.6672053752874,17,106.49404886197534,5.8410257374295576,58.672341286624096,104.60311763063687,0.6158161536779316,251,241,261,304,43,53,63,269.63282144084167,37,187.68387947651416,30.889995399426645,81.06123736417844,133.17203848456438,0.6832188507290421,19156,19714,Boise+Gem+Payette+Washington,Gem,16,45,Idaho,ID
16075,16CS005,219,208,230,220,-10,1,12,4.002106892359881,25,117.90598962427292,-161.0458899307999,-114.88387368771761,-62.20329269043265,13.523893542295983,276,262,289,338,49,62,76,236.93779532668282,47,179.12267998018217,3.9990139108188245,58.526045127968004,105.15098745189492,0.74402278865608,25444,26239,Boise+Gem+Payette+Washington,Payette,16,75,Idaho,ID
16087,16CS005,107,106,108,138,30,31,32,350.098526635639,13,148.2889733840304,189.37229704735216,202.0005136839365,214.3272411492901,0.4101985347537739,136,134,137,163,26,27,29,250.09476125121083,28,258.1596902083717,-20.7469634427839,-7.576023231050308,4.578056911007581,0.9955457220307815,10520,10846,Boise+Gem+Payette+Washington,Washington,16,87,Idaho,ID
16017,16CS006,417,396,437,414,-23,-3,18,-6.803005640998126,18,45.59559242606548,-102.54359616719066,-53.4880539959724,-1.645853633271046,-10.678331822365497,528,502,553,618,65,90,116,183.66553789800156,120,243.97682220189083,-111.65070877735185,-60.89606947052646,-11.785105242950713,1.3138317661734784,47373,49185,Bonner+Boundary+Shoshone,Bonner,16,17,Idaho,ID
16021,16CS006,99,98,100,113,13,14,15,137.09068295170093,1,9.841712457967686,116.31870877766708,127.349590157014,139.68518968597186,0.06698122922809213,125,123,126,179,53,54,56,434.76607358775175,41,328.10499359795136,93.80799994908237,106.34818839731612,119.37054030325396,0.7410303442953311,12193,12496,Bonner+Boundary+Shoshone,Boundary,16,21,Idaho,ID
16079,16CS006,167,161,172,158,-14,-9,-3,-77.79352272680019,24,218.41346883057787,-347.88193748812444,-296.81391190470356,-248.66644891810571,-3.1795611075730963,208,201,215,246,31,38,45,282.49322307136515,42,309.96309963099634,-79.07501008675588,-27.782843656198697,23.651677856813734,1.069305461992096,13186,13550,Bonner+Boundary+Shoshone,Shoshone,16,79,Idaho,ID
16019,16CS007,835,781,888,942,54,107,161,103.78452786550514,111,107.25414885136604,-54.24719445296086,-2.039344601792689,47.88789281775477,1.0238983171079339,1054,988,1120,1104,-16,50,116,39.19944314319258,115,90.23287929194652,-103.2918284321573,-49.548389606472945,2.844861421232151,2.25672033323178,124191,127448,Bonneville,Bonneville,16,19,Idaho,ID
16027,16CS008,1425,1324,1526,1649,123,224,325,115.14414698838033,209,107.43614018103077,-42.87607401339523,6.607149466016271,64.74648514570487,0.9289107417853832,1818,1693,1943,2131,188,313,438,129.48962393610307,334,138.24617753458224,-57.60248557764652,-9.554476517446224,42.22578002392417,1.064221831299278,233441,241598,Canyon,Canyon,16,27,Idaho,ID
16003,16CS009,38,38,39,41,2,3,3,70.56681008253697,3,81.41112618724559,-23.14892086266917,-10.50280193059759,1.4316343456953884,0.8332437708440102,49,48,50,55,5,6,7,131.88372005482552,4,87.03220191470844,31.47285134081787,44.61464961256508,56.86597372302819,0.5664618522196115,4422,4596,Central Idaho,Adams,16,3,Idaho,ID
16035,16CS009,92,91,92,104,12,12,13,170.82260375821622,4,54.75076993270218,104.11625417374147,115.82372378704623,128.7220700357068,0.296735580875512,113,112,115,132,17,19,20,209.13787171427234,16,180.30200585981518,16.366878247466726,28.853693581881295,41.36678429901966,0.818042134590163,8767,8874,Central Idaho,Clearwater,16,35,Idaho,ID
16037,16CS009,45,43,47,40,-7,-5,-3,-131.6754721845039,2,56.022408963585434,-245.51531667870054,-187.59070360447922,-138.79997753438377,-0.5404215956480465,56,53,58,69,11,13,16,300.69418520799314,4,90.82652134423252,157.4189402547777,209.68963755123292,261.61354758704226,0.28084815182496287,4284,4404,Central Idaho,Custer,16,37,Idaho,ID
16049,16CS009,168,161,176,181,5,13,20,90.62405888239248,16,115.52346570397111,-79.32797246364933,-25.50643493782755,26.189080497397654,1.180687016452871,209,200,218,257,39,48,57,283.8986895209183,30,176.78255745433117,55.335385537857356,106.50259006543116,155.86834686433528,0.610033742122557,16620,16970,Central Idaho,Idaho (county),16,49,Idaho,ID
16059,16CS009,90,89,91,109,18,19,20,283.9002030870212,11,165.24787180771156,106.7648083953176,118.51572132320153,130.52210662635318,0.552811316824588,112,111,113,148,35,36,37,439.6059756758029,13,159.8819333415324,267.2291650171203,279.3681243182428,292.1796965512413,0.35379577529954964,7988,8131,Central Idaho,Lemhi,16,59,Idaho,ID
16061,16CS009,37,36,39,47,8,10,11,322.38988148895265,8,266.96329254727476,0.22575275823959656,54.85062539441323,103.64701819672658,0.750402160547552,47,45,49,67,18,20,22,550.7762386035084,12,325.3796095444685,174.3140243929684,225.07316219897112,276.01121376725024,0.5630464802531746,3596,3688,Central Idaho,Lewis,16,61,Idaho,ID
16085,16CS009,77,76,79,83,4,6,7,55.97895941754773,4,40.602266959905265,2.876975426225561,15.310756763841104,27.627996666141104,0.6139809147155917,98,97,100,101,1,3,4,23.290090087226936,1,8.208832703989492,2.2116463282795604,15.033021577360966,27.370460033608254,0.26060677561578555,11822,12182,Central Idaho,Valley,16,85,Idaho,ID
16039,16CS010,194,181,206,209,3,15,28,64.21417075094143,11,46.322290847838296,-32.4285445573317,17.396744201483326,65.80004284369993,0.6769761901423985,241,226,256,239,-17,-2,13,-7.652995896242891,43,149.28482155256214,-208.62156757542934,-156.94199455975033,-106.89941931372867,-35.7033452498834,28496,28804,Elmore+Gooding+Owyhee,Elmore,16,39,Idaho,ID
16047,16CS010,120,119,122,169,47,49,50,375.8394225252577,20,153.79685998077537,210.42541399249617,221.69401481458902,233.90229991710828,0.40100423567554955,149,147,151,170,19,21,23,134.07487327304437,26,165.04792737891194,-43.1275660284458,-30.77400204105697,-17.793077511013266,1.175363577277867,15605,15753,Elmore+Gooding+Owyhee,Gooding,16,47,Idaho,ID
16073,16CS010,89,88,90,118,28,29,30,290.5699122304883,17,170.09922454765277,107.7816312310877,120.21915431261658,133.1238202582219,0.5659113389265167,112,110,113,140,27,28,30,228.6975396001577,19,154.67274503419083,60.97616370026337,73.7752973824422,86.18017983730816,0.6530734410573265,11993,12284,Elmore+Gooding+Owyhee,Owyhee,16,73,Idaho,ID
16023,16CS011,25,25,25,31,6,6,6,280.0874635967455,1,46.31416441528367,222.41790932968246,233.38377301926423,245.47971768032062,0.14189317834400264,31,31,32,45,13,14,14,521.0869400703622,4,151.3431706394249,357.0739167529828,370.2476445302396,382.07270758034144,0.27077655242281123,2591,2643,Jefferson and Nearby Counties,Butte,16,23,Idaho,ID
16033,16CS011,5,5,5,6,1,1,1,115.97415253020677,6,901.1264080100124,-797.4941291298917,-785.7435177918242,-772.7864284521938,3.3856327722001067,6,6,6,10,4,4,4,456.11652126256627,4,505.0505050505051,-62.539706471973574,-48.384339165656385,-36.19776501094356,0.8672194174477335,799,792,Jefferson and Nearby Counties,Clark,16,33,Idaho,ID
16043,16CS011,95,94,96,111,15,16,17,142.64185139940588,13,116.59192825112106,13.048555980141884,26.392344361770576,37.68619481319537,0.7690229769001545,119,117,120,164,44,45,47,334.1573990178432,5,36.85956505713233,284.2279232502272,297.85205127635663,309.7558950139039,0.1079250411571508,13380,13565,Jefferson and Nearby Counties,Fremont,16,43,Idaho,ID
16051,16CS011,163,150,176,176,-0,13,26,49.87434784814303,16,61.91750782031023,-59.347851762536216,-12.618566474805135,39.738814005569445,1.1520781207424298,207,190,223,251,28,44,61,138.0394758284818,37,115.49867332604964,-26.67793079949475,20.248639505249788,77.05434343602587,0.8182049073716896,31009,32035,Jefferson and Nearby Counties,Jefferson,16,51,Idaho,ID
16065,16CS011,174,152,196,164,-32,-10,12,-23.48003776287927,15,35.2023155300882,-108.72467487305849,-58.665336091583775,-7.600266940052751,-1.6657339005194507,225,197,253,234,-19,9,37,16.683871132604025,20,37.2203818811181,-72.28575557755308,-20.925187487774707,30.206588272630043,2.007042448146201,51133,53734,Jefferson and Nearby Counties,Madison,16,65,Idaho,ID
16081,16CS011,45,44,46,37,-9,-8,-7,-78.08594254572562,7,70.94594594594595,-161.0406462694854,-149.07230462890513,-136.90013570323765,-1.0440780418878237,57,56,59,70,11,13,14,104.66108771690158,7,57.4288292722947,33.482387670026334,47.091319967840825,59.8538392557684,0.5088266899409298,11840,12189,Jefferson and Nearby Counties,Teton,16,81,Idaho,ID
16055,16CS012,1381,1307,1455,1387,-68,6,80,4.1967451970650105,115,80.05987085994742,-128.1569587686035,-76.34153031440525,-27.3527007356633,16.36239787181791,1757,1665,1849,2018,169,261,353,145.94215063168946,310,173.4294841312022,-77.20352479119788,-26.716771572755356,25.95815769391744,1.1838060706777471,172371,178747,Kootenai,Kootenai,16,55,Idaho,ID
16013,16CS013,112,110,115,121,6,9,11,44.06999369767942,15,74.43860882511062,-42.16511106073269,-30.39621204356134,-18.665481714838347,1.5181462533838272,142,139,145,156,11,14,17,55.532686419408975,11,44.530807222087276,-0.8887853787574052,11.6500709461092,22.640907118749162,0.7474001922467146,24181,24702,Lincoln and Nearby Counties,Blaine,16,13,Idaho,ID
16025,16CS013,10,10,11,12,1,2,2,166.72075607845392,0,0,116.54976791547446,167.47630066468528,220.0785726165518,0,13,13,14,7,-7,-6,-6,-554.7703316268659,7,618.3745583038869,-1224.3658742746452,-1175.1727418975445,-1120.0712523747607,-1.3257575370855996,1094,1132,Lincoln and Nearby Counties,Camas,16,25,Idaho,ID
16031,16CS013,185,175,196,192,-4,7,17,32.21046218593152,18,87.61611162941631,-105.3438142011226,-54.44062268377418,-6.137240305371053,2.36301998628141,232,219,245,234,-11,2,15,6.196676009129715,25,99.6174689193497,-146.04276920212348,-92.69011610572508,-42.43025401690582,9.784284657997029,24653,25096,Lincoln and Nearby Counties,Cassia,16,31,Idaho,ID
16053,16CS013,154,143,164,158,-6,4,15,22.181971487839064,17,83.92989385336955,-113.64659777723352,-62.43960334775843,-6.413658510758556,3.0948714689962085,193,180,205,242,37,49,62,200.12490685380547,39,158.54947556711926,-10.868939327360076,41.4192909287602,93.57597165452279,0.7764790620926956,24306,24598,Lincoln and Nearby Counties,Jerome,16,53,Idaho,ID
16063,16CS013,33,33,34,39,5,6,6,129.4840385572883,4,92.71779022599961,24.600051102276822,37.33137981397216,49.416482220106154,0.6073344228291244,42,41,43,38,-5,-4,-3,-74.75462674806954,2,38.02281368821293,-125.02879388578815,-112.3225650215386,-100.42354052853635,-0.6821065190299438,5177,5260,Lincoln and Nearby Counties,Lincoln,16,63,Idaho,ID
16067,16CS013,175,166,185,178,-7,3,12,14.865453201076615,23,127.8251204149685,-164.7977870285186,-111.64157584183913,-62.27219539965519,6.258860120655911,219,207,230,228,-2,9,21,42.6839599490308,29,132.33549329195947,-137.6492061976754,-88.2262888337818,-44.21896988331091,2.8009140297078097,21592,21914,Lincoln and Nearby Counties,Minidoka,16,67,Idaho,ID
16083,16CS014,693,655,732,838,106,145,183,192.7504492681996,98,130.63183151159691,8.8814160174116,61.073973013950585,115.59545219046595,0.6730705111511187,868,820,915,986,71,118,166,128.4987063888981,130,141.37042313255108,-64.95797717014385,-12.741129207239288,35.769675696809,1.0909375733754376,90024,91957,Twin Falls,Twin Falls,16,83,Idaho,ID
17001,17CS001,681,653,710,745,35,64,92,116.62282429576513,71,130.17371774304442,-64.4954714867715,-14.70905561144178,39.74197699090774,1.0989180403441485,828,794,861,936,75,108,142,166.59666742930062,103,158.36895353485656,-44.566014358960935,6.939073020201719,59.03092860077946,0.9419197593185712,65451,65038,Adams,Adams,17,1,Illinois,IL
17005,17CS002,151,143,158,165,7,14,22,104.08049834175621,11,79.39372067845542,-22.40976592452659,26.196288115940046,76.88853674592224,0.7133429414826626,183,174,192,219,27,36,45,216.38342335663606,28,168.61375406479587,-5.833180647639639,48.18730274099322,99.52725817516838,0.7581371548035172,16626,16606,Bond+Effingham+Fayette,Bond,17,5,Illinois,IL
17049,17CS002,308,294,323,379,56,71,85,245.5011887087352,44,152.95037803076386,41.75600029668041,91.8920898429982,142.46877784976522,0.6143144670236765,375,357,392,430,38,55,73,160.4677251863712,53,153.81489973009838,-43.34938554603638,6.365216355325162,55.25488567984687,0.9415131319849716,34521,34457,Bond+Effingham+Fayette,Effingham,17,49,Illinois,IL
17051,17CS002,192,182,201,226,25,34,44,191.99773805179393,34,190.3606587971819,-47.473649051701415,0.8506309479724713,51.34018919980896,0.963380327102095,233,222,244,244,-0,11,22,51.108657066800504,30,140.21967749474175,-139.51768139728821,-90.6185783173031,-35.1241622983365,2.513679195118272,21433,21395,Bond+Effingham+Fayette,Fayette,17,51,Illinois,IL
17007,17CS003,359,336,382,401,19,42,65,94.41045192929445,57,128.32539116731078,-84.37115790305378,-35.10098655503954,20.849208690320445,1.327571231990051,442,415,470,500,30,58,85,108.4105605020117,37,69.57110354812627,-13.301187064614053,39.35157564170732,88.36009183301871,0.6307966332928091,53302,53183,Boone,Boone,17,7,Illinois,IL
17009,17CS004,47,46,48,60,12,13,14,245.57494670155782,2,38.11338732729871,194.79784135496243,207.77950189521596,219.50203752096388,0.14402430213824774,59,58,60,67,7,8,9,127.94810082988727,8,125.17602879048661,-9.731154533603327,2.3759246126274225,15.422095352716688,0.8717290835819724,6297,6391,Brown and Nearby Counties,Brown,17,9,Illinois,IL
17013,17CS004,41,41,42,59,17,18,18,479.60196757095457,5,134.6801346801347,332.80739171256346,344.98247810571667,356.4304751930223,0.26588357860740575,50,49,50,68,18,18,19,419.1284602263267,2,45.714285714285715,360.9402539395996,373.2184505173067,386.18495187765234,0.10342935470152069,4455,4375,Brown and Nearby Counties,Calhoun,17,13,Illinois,IL
17017,17CS004,125,124,127,140,13,15,16,137.98627006105428,27,252.76954283039473,-127.21862231341058,-114.82083212284878,-102.97328330622389,1.7154583892579114,153,152,155,149,-6,-4,-3,-34.8299436604893,16,125,-171.7065888492654,-159.7235428845024,-147.55716681975446,-4.626640535307261,12818,12800,Brown and Nearby Counties,Cass,17,17,Illinois,IL
17149,17CS004,171,164,177,217,40,46,53,376.54259605523646,39,316.8799512492383,9.209970343716549,60.87453671809039,111.76186487901404,0.8237757739832935,208,200,215,236,21,28,36,193.5478646375374,32,218.87824897400822,-73.71122081861077,-26.868044076180972,27.346868458848142,1.0922732728283309,14769,14620,Brown and Nearby Counties,Pike,17,149,Illinois,IL
17169,17CS004,78,78,79,80,1,2,2,31.15410603650224,4,69.91988346686088,-50.97623689459479,-38.52498901156221,-26.61109414042508,1.437672675601564,96,95,96,108,12,12,13,181.01338697684315,3,43.80841121495327,124.89575810058274,137.42011479612904,149.02234689599405,0.22395084504402413,6865,6848,Brown and Nearby Counties,Schuyler,17,169,Illinois,IL
17171,17CS004,50,50,51,59,8,9,9,211.08791503953253,4,97.48172217709178,101.77053282961558,113.25138760110032,125.26137293435791,0.4140083543668475,61,60,61,69,8,8,9,169.2363436964141,6,123.73685295937307,32.73214855089284,45.251147186767376,58.93339267602989,0.651729723403241,4924,4849,Brown and Nearby Counties,Scott,17,171,Illinois,IL
17011,17CS005,345,330,359,417,58,72,87,262.7747977119603,57,207.14091032979013,1.6658486276427211,55.22901784349378,105.30879863974259,0.7775301431835263,420,403,437,447,10,27,44,80.94793909297726,51,154.9351398973175,-120.7314908114559,-72.80485190094784,-24.484661479909693,1.844775983056555,33021,32917,Bureau+Marshall+Putnam+Stark,Bureau,17,11,Illinois,IL
17123,17CS005,148,143,153,148,-5,0,5,1.4751743495773033,6,61.77606177606177,-110.48150915554918,-60.39153535984309,-15.415942910223231,5.2480751628697275,180,174,186,184,-2,4,10,31.1756645587993,17,145.71012256792662,-160.93021156860218,-113.23745601095402,-64.0282420485083,3.6659541327853225,11655,11667,Bureau+Marshall+Putnam+Stark,Marshall,17,123,Illinois,IL
17155,17CS005,49,48,50,42,-8,-7,-6,-150.25873232205913,6,127.56909992912826,-290.4270598319753,-277.90553471614277,-265.8865577087245,-0.9889290964096425,59,59,60,71,11,12,12,207.78890817707156,8,143.47202295552367,51.86812069195529,64.64397541239809,76.76704956713567,0.6356112558107144,5644,5576,Bureau+Marshall+Putnam+Stark,Putnam,17,155,Illinois,IL
17175,17CS005,63,63,64,77,13,14,14,305.53036935277214,12,268.20636990128514,25.59751276092566,37.572446085639356,50.01553936915534,0.817999370368265,77,76,77,97,20,20,21,384.72385231339155,4,75.35795026375283,296.8988985679627,309.1143011815277,322.07606840492036,0.18673140698628807,5369,5308,Bureau+Marshall+Putnam+Stark,Stark,17,175,Illinois,IL
17015,17CS006,171,164,178,216,38,45,52,349.2579051202436,26,201.6285381930981,95.31714357567756,147.22344447243134,198.8719299838046,0.5647654946204044,210,202,218,214,-4,4,12,24.886498470629423,13,82.83948257184731,-108.83669679489459,-58.58354117943229,-7.396042383837652,2.6501200212369067,15474,15693,Carroll+Jo Daviess+Stephenson,Carroll,17,15,Illinois,IL
17085,17CS006,207,198,216,247,31,40,49,219.32051660101263,23,125.9871274022002,41.98986067433425,91.59992565242484,146.36738457208773,0.5604454013889985,253,241,264,259,-5,6,18,28.569565892953978,18,81.99334942832415,-105.60318975897218,-52.61855267949079,-2.460210161852922,2.475289460186042,21907,21953,Carroll+Jo Daviess+Stephenson,Jo Daviess,17,85,Illinois,IL
17177,17CS006,462,443,481,573,92,111,130,299.61066953166835,64,172.97686884839746,76.72973907936124,128.23662615276152,177.43264091329058,0.5721772501817065,560,537,582,653,71,93,116,212.04305136126104,93,210.95610751956445,-53.03774493271671,-0.8504942571964577,55.138916229851816,0.9843438606764738,44399,44085,Carroll+Jo Daviess+Stephenson,Stephenson,17,177,Illinois,IL
17019,17CS007,1126,1037,1214,1277,63,151,240,88.0575217129367,66,38.42365965952368,-4.648418458852185,50.63397209016992,100.02828221065684,0.43348138998859065,1399,1293,1505,1642,137,243,349,118.07228760999465,128,62.173951057442906,1.285523282277298,55.31544892684627,115.79018819955111,0.5244179197408537,206123,205874,Champaign,Champaign,17,19,Illinois,IL
17021,17CS008,371,357,386,418,32,47,61,166.10036561252102,61,217.46880570409982,-104.14689382154744,-50.23145667255442,2.6340065489777973,1.281750844978704,453,436,471,501,30,48,65,141.70351765574455,40,118.70492922218595,-31.906214288666884,23.311858126682317,74.90282441898898,0.8205156086760885,33660,33697,Christian+Shelby,Christian,17,21,Illinois,IL
17173,17CS008,201,192,210,234,24,33,42,189.47819393988343,30,171.4775650185767,-33.41243477402903,17.635745772545857,68.9414946531041,0.8784976277294863,244,234,255,321,66,77,87,368.0108140251704,48,230.71377072819035,89.89436529935364,136.68039632985435,185.56363621184843,0.6188386086692101,20994,20805,Christian+Shelby,Shelby,17,173,Illinois,IL
17023,17CS009,163,157,170,191,21,28,34,217.17702572762684,18,140.22331861854062,24.9786825910735,78.39528490611931,128.40531534901496,0.6233055855523342,197,189,205,234,29,37,45,243.7687724759806,30,195.87359623922697,-0.97325825880573,48.79627792257478,100.9724822447635,0.7825619081316271,15404,15316,Clark+Crawford+Cumberland+Jasper,Clark,17,23,Illinois,IL
17033,17CS009,186,178,194,195,1,9,17,59.23169604215578,29,186.61518661518662,-178.32842535264163,-127.37277521447209,-74.21264604797071,2.841854083964217,225,216,235,240,5,15,24,77.88232416464854,27,144.72555746140654,-121.15083951158782,-69.10873676783595,-16.79394152001109,1.738601138953854,18648,18656,Clark+Crawford+Cumberland+Jasper,Crawford,17,33,Illinois,IL
17035,17CS009,94,93,95,103,8,9,10,99.64351538371649,20,229.35779816513758,-142.22301611648643,-129.76649175136018,-117.39548259640796,2.064214718214047,114,113,115,157,42,43,44,413.7599360419426,19,183.4508062180168,217.48077538946163,230.31127223547398,242.33274171175694,0.43326453131628223,10464,10357,Clark+Crawford+Cumberland+Jasper,Cumberland,17,35,Illinois,IL
17079,17CS009,82,81,83,87,4,5,6,63.691385876193856,13,167.83216783216784,-116.38360500456551,-104.40268624342814,-91.93690858409364,2.190976058113598,99,98,101,124,23,25,26,268.01115908384367,13,141.28899032713835,114.08972074262441,126.7222738987136,140.01555861550136,0.5066308874073803,9295,9201,Clark+Crawford+Cumberland+Jasper,Jasper,17,79,Illinois,IL
17025,17CS010,157,151,163,176,13,19,25,172.4913887210638,29,262.8200286987387,-138.25878901185254,-90.97954417424205,-36.961567607213865,1.447612357603917,190,184,197,182,-15,-8,-2,-64.47276441616741,19,144.36592964060483,-260.2556057222881,-209.7418485939494,-160.3557445390046,-2.538321804166961,13241,13161,Clay+Hamilton+Wayne+White,Clay,17,25,Illinois,IL
17065,17CS010,86,85,87,107,20,21,22,313.5762115797784,11,165.14450143875894,137.0340972166098,148.28930376116702,159.3876464240651,0.50258629017232,105,104,106,103,-3,-2,-1,-22.057541061775307,18,227.24403484408535,-261.6305897310122,-249.86820984534003,-236.57854732855554,-24.090650628845616,7993,7921,Clay+Hamilton+Wayne+White,Hamilton,17,65,Illinois,IL
17191,17CS010,172,165,179,215,36,43,50,317.620359854747,32,238.28730995966487,28.63115321661067,80.29230104661143,131.1880855147429,0.7330409684741815,209,201,218,242,24,33,41,204.7680124221549,29,181.40873264106094,-26.897412050203094,23.344029192589765,73.61327493723341,0.8596613396584508,16115,15986,Clay+Hamilton+Wayne+White,Wayne,17,191,Illinois,IL
17193,17CS010,192,186,198,215,17,23,29,196.82274465835047,31,270.1328879529446,-123.61031674888471,-73.77237335532844,-22.89922518478793,1.3142804978665794,234,227,242,253,11,19,26,135.0168637584637,22,159.55903684363213,-76.64985066429394,-24.538061814799136,30.28610436581088,1.121526285324643,13771,13788,Clay+Hamilton+Wayne+White,White,17,193,Illinois,IL
17027,17CS011,292,276,308,347,39,55,71,178.23833600846373,41,133.09887731638037,-5.8930444237625474,45.29769436902074,94.31060575433195,0.7333891723121005,355,336,374,364,-10,9,28,24.03608857015418,35,95.08802434253424,-124.48180031316822,-72.92899341358131,-20.152394920685413,3.5543085981597655,36965,36808,Clinton+Marion,Clinton,17,27,Illinois,IL
17121,17CS011,439,423,456,567,111,128,144,407.97369106175796,51,163.0043947263284,195.2357074494446,244.66813070996082,295.88612350647225,0.3964405281194525,531,512,551,593,42,62,81,165.11712747430778,67,179.03428372925742,-66.19896882896225,-14.280625950185229,38.87082927505008,1.0670186003654551,37545,37423,Clinton+Marion,Marion,17,121,Illinois,IL
17029,17CS012,401,381,421,524,103,123,143,312.1803188446879,50,126.77216928310338,136.0988629158632,186.50504052447906,238.52923379011304,0.40281480782749934,488,464,512,597,85,109,133,233.75469624489605,64,136.86619191206347,48.83842626718188,96.13798185166102,145.12821609527236,0.5802039830720026,47329,46761,Coles,Coles,17,29,Illinois,IL
17031,17CS013,34998,32744,37252,44691,7439,9693,11947,222.13744176880058,7636,174.99429461918132,-3.8063654467669443,48.19508099872435,101.7936455592602,0.7876936082587671,42715,40037,45392,47087,1695,4372,7050,84.30640464763923,4196,80.90683527784827,-49.82528095267756,5.382097489649667,55.3567404829447,0.9594565854623152,5236285,5186212,Cook,Cook,17,31,Illinois,IL
17037,17CS014,602,559,646,753,107,151,194,178.88838868762716,56,66.55705881187727,62.14227057318614,112.32805349698975,165.8238305600707,0.3696035194116799,744,692,796,892,96,148,200,147.386876782613,69,68.7333147388134,27.777514180827705,77.66048163464816,129.71875283313898,0.46321552524667614,100966,100388,DeKalb,DeKalb,17,37,Illinois,IL
17039,17CS015,171,164,177,205,28,34,41,266.951534163065,21,163.03293006404866,55.283681414266475,104.15701266545364,158.00165805794953,0.5934620457419933,208,200,216,230,14,22,30,144.23959929112422,21,136.75436311539463,-42.78112923044272,8.221973114000383,57.42596440158665,0.9071496533206378,15457,15356,De Witt+Logan+Mason+Menard,De Witt,17,39,Illinois,IL
17107,17CS015,291,278,303,351,48,60,73,259.22058295917213,47,201.42137780793544,7.612665537363984,58.189562014038486,105.63165949687165,0.7643896821751821,357,342,371,332,-39,-25,-10,-88.01809921576236,30,107.23477266228196,-244.11917378129723,-194.6371453625048,-145.70793374901626,-1.2698980625529097,28001,27976,De Witt+Logan+Mason+Menard,Logan,17,107,Illinois,IL
17125,17CS015,156,150,161,193,32,37,43,343.81545492124764,33,303.12308634415183,-10.441777670784992,42.74610560271445,93.15537328724787,0.8587031871713374,188,182,195,222,27,34,40,260.90412775312416,20,155.0147263990079,55.05699272642796,105.0391711970687,156.11573435084415,0.5770032377185758,13064,12902,De Witt+Logan+Mason+Menard,Mason,17,125,Illinois,IL
17129,17CS015,106,105,108,111,3,5,6,44.77641308583611,12,117.5990200081666,-85.48532314976033,-72.29286777779458,-61.1101359772365,2.1547622742080197,130,129,132,162,30,32,33,260.6846989930604,14,114.95196649971263,133.77985832180977,145.53185927248848,158.1757423972446,0.42749671721817395,12245,12179,De Witt+Logan+Mason+Menard,Menard,17,129,Illinois,IL
17041,17CS016,169,161,178,200,22,31,39,187.46395116294264,29,176.67665126669036,-38.89324756219508,11.090452238219914,63.375670989934946,0.9127922851319721,208,198,218,247,29,39,49,199.2363745016003,17,86.1850443599493,60.77430233006932,112.27849854566247,166.44411023772545,0.4218427718706226,19697,19725,Douglas+Edgar+Moultrie+Piatt,Douglas,17,41,Illinois,IL
17045,17CS016,193,186,201,242,41,49,56,346.9208798930947,36,257.2806860818295,42.14563789872325,90.42646652885769,142.18049654543015,0.7266429096182876,233,225,242,278,36,45,53,271.2344230599834,42,253.71511417180136,-33.981997568165525,16.783039311879456,72.25514024606227,0.9150297613448413,16791,16554,Douglas+Edgar+Moultrie+Piatt,Edgar,17,45,Illinois,IL
17139,17CS016,165,159,172,183,11,18,24,145.11186671723482,20,165.68864342423194,-71.33485054921286,-25.11689992192288,26.928054131072553,1.0801345575144863,202,195,210,216,6,14,21,95.37160100214041,19,130.98028402040535,-90.29410697018322,-35.479906996984326,10.297503931667517,1.2807891221563772,14485,14506,Douglas+Edgar+Moultrie+Piatt,Moultrie,17,139,Illinois,IL
17147,17CS016,152,144,159,162,3,10,18,75.74662307504096,2,14.43522194153735,9.163414857947949,60.63556625786355,112.70602736758134,0.1739933129927624,187,178,195,209,14,22,31,133.43807131019187,10,59.74072525240456,22.42592442325349,73.62388151770423,124.51213838422048,0.42851880481032495,16626,16739,Douglas+Edgar+Moultrie+Piatt,Piatt,17,147,Illinois,IL
17043,17CS017,5387,4987,5787,6490,703,1103,1503,142.46034268284893,821,106.01801832824694,-15.384735480029457,36.800302645373,88.27458141647165,0.7435192392616844,6647,6169,7125,6994,-131,347,825,37.50172686299031,393,42.44981902119142,-57.54907210411284,-5.069577062434434,45.019215868248686,1.1286921190271277,929276,925799,DuPage,DuPage,17,43,Illinois,IL
17047,17CS018,61,60,61,81,20,20,21,393.6486095725356,10,192.89503295290143,188.37875330518347,200.5261928041303,212.6664988381097,0.4671281892903012,73,72,73,90,17,17,18,285.523464748511,18,295.3724975385625,-21.881012397940978,-9.647626220944598,1.7659403861352734,0.9782715060468364,6221,6094,Edwards+Lawrence+Richland+Wabash,Edwards,17,47,Illinois,IL
17101,17CS018,163,156,170,180,10,17,24,133.73233218289542,30,235.47880690737833,-152.86797321472028,-103.39133391693856,-49.92167462788145,1.663201744335399,196,188,204,197,-7,1,9,5.250094720810407,20,131.89132155104195,-178.48962912151012,-125.69475674953108,-73.923143483723,11.135086415414749,15288,15164,Edwards+Lawrence+Richland+Wabash,Lawrence,17,101,Illinois,IL
17159,17CS018,174,167,181,222,41,48,55,364.7799157042136,29,220.7981727047776,93.04685325001199,142.59140486266887,200.33444235783847,0.59291605857543,211,203,219,265,46,54,62,341.1025208211864,41,259.5429511932645,30.865246935698764,81.54598322730956,133.74500726412612,0.7470305733203444,15761,15797,Edwards+Lawrence+Richland+Wabash,Richland,17,159,Illinois,IL
17185,17CS018,123,118,128,139,11,16,21,167.4316234808034,15,159.1230551626591,-43.46824528602369,8.477614079575654,63.89913614071891,0.8937497733086767,148,142,154,161,7,13,19,114.87108319101235,15,133.70175594972815,-71.00386432514291,-18.221248794923117,32.00309084907053,1.080116813261199,11312,11219,Edwards+Lawrence+Richland+Wabash,Wabash,17,185,Illinois,IL
17053,17CS019,173,167,178,203,25,30,36,271.0582761677849,24,214.1423154137854,9.476812344554894,56.35225648738032,108.11087207340135,0.7648462317872716,211,204,218,237,19,26,33,194.65198086120216,20,147.9946721918011,-8.755879363609987,48.30802217599676,94.66004510322807,0.7324593734798257,13449,13514,Ford+Iroquois+Livingston,Ford,17,53,Illinois,IL
17075,17CS019,319,307,331,381,50,62,74,276.089628431499,44,195.67150904239546,28.560111313807838,79.85057579192558,136.3758932414346,0.6974898590281087,387,373,401,418,17,31,45,115.29350424926241,43,160.14897579143388,-98.15754855941202,-44.79729670259248,6.628925873894453,1.3455873199726935,26984,26850,Ford+Iroquois+Livingston,Iroquois,17,75,Illinois,IL
17105,17CS019,375,359,390,420,30,45,61,151.90468795677037,54,181.44145153161224,-82.57440131741994,-29.403521410215284,20.849727270870932,1.1685942406303336,457,439,476,482,6,25,43,69.39105893438413,64,179.38728032065475,-165.23009249302862,-111.8714853002036,-60.35220310291577,2.48479537249604,35714,35677,Ford+Iroquois+Livingston,Livingston,17,105,Illinois,IL
17055,17CS020,428,412,444,518,74,90,106,286.50800560778066,60,190.74868860276584,46.51795242342555,95.26970727625908,147.2192556989696,0.6584644445832056,519,500,539,644,105,125,144,332.7284395107117,88,234.8545503069122,46.988191844114255,98.9546442961575,149.46436105275103,0.700228032447473,37746,37470,Franklin+Gallatin+Saline,Franklin,17,55,Illinois,IL
17059,17CS020,63,63,64,68,4,5,5,119.42348145825744,1,24.3605359317905,81.98690588339414,95.04931777935785,107.04039659813058,0.1694245047118611,77,76,78,91,13,14,15,283.26563531383897,1,20.370747606437156,250.27642830182185,262.8169461144367,276.0455682325938,0.06708928426336107,4926,4909,Franklin+Gallatin+Saline,Gallatin,17,59,Illinois,IL
17165,17CS020,309,299,320,330,10,21,31,104.39881101490425,41,208.58063422079022,-155.10722612977014,-102.90744170658193,-53.861187924064964,1.9050870497821386,373,361,385,423,38,50,62,212.18063231511022,53,226.82530172044852,-66.9083920724684,-14.477973011839874,35.17828159266631,1.0478838110188373,23588,23366,Franklin+Gallatin+Saline,Saline,17,165,Illinois,IL
17057,17CS021,390,376,404,450,46,60,74,214.4713273410579,31,110.94211326831885,54.12060134720552,103.53678749341069,158.68339359115265,0.5087918355849944,474,457,491,515,24,41,58,123.41106729941473,55,165.50312951372172,-91.98080963097745,-41.99795302988335,14.555027514172842,1.3091508298047496,33531,33232,Fulton+McDonough,Fulton,17,57,Illinois,IL
17109,17CS021,248,236,260,318,58,70,82,306.4530759116568,31,135.52900029146022,116.9391992110612,171.6945006227702,223.19199327884652,0.4360299505639879,301,287,314,323,9,22,36,83.71990504891097,32,119.1140889633352,-89.33701298010322,-35.699242068624926,12.053631625033377,1.3622033900231443,27448,26865,Fulton+McDonough,McDonough,17,109,Illinois,IL
17061,17CS022,136,131,141,163,22,27,32,268.0355734686356,26,258.83524141363864,-43.85905313537045,8.940172219477912,62.89310046659435,0.9310929161458912,165,159,171,181,10,16,22,134.41575987968682,19,160.28344862493674,-78.66333452862976,-25.430845854702053,24.576879343952697,1.1220266472100386,12054,11854,Greene+Jersey+Morgan,Greene,17,61,Illinois,IL
17083,17CS022,233,224,242,271,29,38,47,211.97412426153028,36,201.25786163522008,-39.514231170719746,11.524660018314949,59.39445333773588,0.9250486648449109,285,274,296,317,21,32,43,149.983153684673,29,135.83774415663498,-37.98109657382889,15.970063323374136,64.56685018526915,0.8782581698774943,21465,21349,Greene+Jersey+Morgan,Jersey,17,83,Illinois,IL
17137,17CS022,339,325,353,414,61,75,89,273.55931812704625,54,196.92457302619584,27.53658164141652,77.00673589645085,126.87706778514064,0.7103905531218602,414,397,431,437,6,23,40,69.91302810629423,31,94.99295213580929,-76.52293402997506,-26.25613510645251,25.838591844685578,1.3016777841486429,32906,32634,Greene+Jersey+Morgan,Morgan,17,137,Illinois,IL
17063,17CS023,369,347,392,466,74,97,119,222.05923290425602,44,100.86537910481975,69.78691824167481,121.17517717034407,169.5403447088786,0.4495861253880081,460,433,487,527,40,67,94,126.80018385860569,55,103.93046107331821,-33.844010551093646,21.90970118557857,75.47102945464714,0.8076043165152104,52347,52920,Grundy,Grundy,17,63,Illinois,IL
17067,17CS024,176,169,184,235,51,59,66,400.23779872401894,32,218.70372479781295,128.05053780086092,181.54675222987012,237.1598041088181,0.5372601626389731,216,207,225,239,14,23,32,132.67499416789076,24,137.7568591436115,-57.96622254411951,-4.5267940131469295,47.03283625663405,0.9952461452507292,17558,17422,Hancock+Henderson+Mercer+Warren,Hancock,17,67,Illinois,IL
17071,17CS024,70,69,70,95,25,25,26,474.7491087328333,15,281.6901408450704,180.67049589208162,193.32950334088875,204.75947825399308,0.57076778454033394,85,84,86,109,23,24,25,383.6504035646861,10,158.32805573147562,212.3570583952635,225.1452837307928,238.29787047780897,0.396332191466019,6390,6316,Hancock+Henderson+Mercer+Warren,Henderson,17,71,Illinois,IL
17131,17CS024,173,166,180,192,12,19,26,144.73129154456805,16,123.02172102261805,-31.249321295900025,22.52269623963704,75.01094731243938,0.8071224292994232,213,204,221,206,-15,-7,2,-41.859493346873364,16,102.63647443710309,-196.14558121032505,-142.504821033495,-93.00538609647398,-2.8956779090268605,15607,15589,Hancock+Henderson+Mercer+Warren,Mercer,17,131,Illinois,IL
17187,17CS024,163,156,170,218,48,55,62,392.30815161401154,31,221.99677746613355,117.7607423107815,171.04571534782,224.58435819087742,0.5557292046156697,199,191,208,215,7,16,24,95.94186339486559,28,169.01068388966019,-124.57560063872705,-73.74249180221685,-17.82939315562072,1.6573256136508003,16757,16567,Hancock+Henderson+Mercer+Warren,Warren,17,187,Illinois,IL
17073,17CS025,454,433,475,583,108,129,150,315.2831719273009,64,156.46646565072123,112.28951712195332,159.24501716498744,211.75435203076825,0.4924541907724881,553,528,578,601,23,48,73,97.64697981530081,41,83.77434053247788,-38.47494989114378,12.598304999719785,65.63529889466918,0.840346324166981,49084,48941,Henry,Henry,17,73,Illinois,IL
17077,17CS026,382,359,405,535,130,153,176,344.35016862355064,68,152.70318318767895,134.78303871898584,190.01790770091378,238.66629758601292,0.44058001155975235,466,439,493,611,118,145,172,274.9663464008874,64,121.6429399578051,103.3904813996011,153.18531273244895,204.70618373305717,0.4393551139730831,53437,52613,Jackson,Jackson,17,77,Illinois,IL
17081,17CS027,373,357,388,486,98,113,129,366.94757760914274,65,210.23125437981776,104.96925142189968,156.8816807830926,206.66526481348254,0.5679133738511868,454,435,473,549,76,95,114,257.023229001226,67,181.57673649692404,24.922036251506242,76.44088836922576,128.36777331939422,0.6990890880825387,37102,36899,Jefferson+Washington,Jefferson,17,81,Illinois,IL
17189,17CS027,138,132,144,149,5,11,17,99.5122907271092,17,148.50404018344616,-102.2527272169137,-49.60139271745438,4.442465961235756,1.3718893992520818,168,161,175,167,-8,-1,6,-5.672295023360095,21,153.69977310985874,-211.640214189217,-158.7450328125124,-110.99642853272967,93.33568499506391,13737,13663,Jefferson+Washington,Washington,17,189,Illinois,IL
17089,17CS028,2735,2512,2957,3584,627,849,1072,196.56711831524743,513,118.73877662026544,25.560161409482188,79.27904448256565,129.97480262884207,0.6033518020097696,3387,3121,3653,3905,252,518,784,100.45501893135052,326,63.218602558608104,-17.254428885654075,36.27165908600767,86.1708767231997,0.6281099623576736,518449,515671,Kane,Kane,17,89,Illinois,IL
17091,17CS029,955,909,1001,1149,148,194,240,216.7167296586277,124,138.40572969956284,27.50183358316914,77.2565747792559,132.07233776277135,0.635375678271756,1163,1108,1218,1378,160,215,270,201.13035173074286,132,123.718297186346,26.629199241590275,77.48466211533159,128.44713760316367,0.6122618871599252,107510,106694,Kankakee,Kankakee,17,91,Illinois,IL
17093,17CS030,532,476,589,630,41,98,154,88.63510124052854,74,67.23961685533638,-35.54669883424557,21.50818556450537,70.63196677173859,0.750913612915564,679,609,748,780,32,101,171,75.44751207892952,61,45.35619483831632,-18.1789449328419,29.631011715762288,80.8284551443049,0.5952955250490217,132065,134491,Kendall,Kendall,17,93,Illinois,IL
17095,17CS031,570,549,591,694,103,124,145,299.4368204638304,106,256.05410954767797,-10.384091307932598,43.76230465222622,95.32037431293809,0.8482758066889597,691,666,717,730,13,39,64,78.76045366415934,73,147.96497486622343,-119.58984419105415,-68.52436197292629,-17.23304725424592,1.8315359541980878,49677,49336,Knox,Knox,17,95,Illinois,IL
17097,17CS032,4052,3746,4358,4865,507,813,1119,137.30427926549652,699,118.030129484174,-31.38922114067186,18.691932531733677,69.8618825694391,0.8585686906733653,5026,4659,5394,5214,-180,188,555,26.380998225230048,373,52.42246604837202,-76.93053408420225,-27.491048722689985,24.687850815487078,1.9765995493914654,710666,711527,Lake,Lake,17,97,Illinois,IL
17099,17CS033,1121,1074,1168,1295,127,174,221,191.06631964187014,180,197.8112550940977,-57.46700791012909,-5.9755250726814815,47.06672348150584,1.02938087617977,1368,1311,1424,1435,11,67,124,61.74984714751823,129,118.32474179523399,-106.745311634188,-57.005523844881196,-5.838569778571202,1.8881479216309016,109195,109022,La Salle,La Salle,17,99,Illinois,IL
17103,17CS034,323,308,337,387,50,64,79,227.4381239559396,64,225.68322068762853,-51.438302057283394,1.4743104445018138,53.89097471945138,0.977134125274759,397,379,414,420,6,23,41,68.96126362129536,39,114.55426641210163,-98.00588497232751,-45.789448324361125,4.456103422903726,1.593276393238586,34030,34045,Lee+Whiteside,Lee,17,103,Illinois,IL
17195,17CS034,573,549,597,706,109,133,157,287.6220375998446,148,320.31743168906127,-82.19741088243923,-35.90789842000404,18.938392306489632,1.105357231941252,701,673,730,757,27,56,84,100.52433349932554,79,142.76678413300803,-92.622823269326,-42.86942974771316,6.780815271217426,1.395140039938531,55445,55335,Lee+Whiteside,Whiteside,17,195,Illinois,IL
17111,17CS035,1837,1704,1970,2165,195,328,461,127.10836465134774,234,90.70617079765222,-13.067686845287987,34.917955743236575,86.90510257691908,0.7114432791634472,2284,2123,2444,2536,92,252,413,81.1548560883561,183,58.85663745276192,-27.202868095288828,23.10888825251626,75.9756652240458,0.7223758264711522,309571,310925,McHenry,McHenry,17,111,Illinois,IL
17113,17CS036,1025,952,1099,1220,121,195,268,136.8473932287119,110,77.22414307527598,5.625664598541975,58.55286365701243,113.46796361774828,0.5614282994404427,1270,1181,1358,1412,54,142,231,83.2717188711109,145,84.85188956380277,-54.724214047825846,-2.5963147828024544,47.925890786631854,1.0118652752034625,170931,170886,McLean,McLean,17,113,Illinois,IL
17115,17CS037,1044,1000,1089,1242,153,198,242,229.02556486002186,142,164.5200532952285,16.205442448337923,62.848664833646986,114.29867850854447,0.7147323064860455,1268,1215,1321,1433,112,165,218,160.87948520710853,136,132.54197974836515,-23.2671813614399,30.389803725891323,78.5536372636898,0.8188980919290355,103574,102609,Macon,Macon,17,115,Illinois,IL
17117,17CS038,470,451,489,568,79,98,117,262.11383543838076,66,176.7580958332403,32.83939280126757,82.83983825090733,137.97401128014195,0.6675356641173016,570,547,593,647,54,77,100,172.41464660624285,70,157.42718992465984,-40.42412199978749,17.22597623263433,66.85783543718891,0.9013164969694529,44807,44465,Macoupin+Montgomery,Macoupin,17,117,Illinois,IL
17135,17CS038,300,288,312,360,48,60,72,254.64047310305722,29,123.46993081426291,75.87003721565335,132.62700958247396,180.66469870448043,0.4769055908766202,366,351,380,460,80,94,109,335.6501999201652,69,245.59530165509878,36.82426858597457,92.31209323329345,140.7936101913928,0.7240223635259448,28185,28095,Macoupin+Montgomery,Montgomery,17,135,Illinois,IL
17119,17CS039,2468,2354,2582,2909,327,441,555,199.45465394139947,294,133.0728204044991,17.140560040785772,67.38129745311457,116.47608507906469,0.6656726992912834,3022,2885,3159,3378,219,356,493,134.52967831580634,319,120.5424789428538,-41.02844039431136,11.879305556553396,67.8684420964083,0.8935191172675168,265118,264637,Madison,Madison,17,119,Illinois,IL
17133,17CS040,264,249,279,302,23,38,53,131.07214839908863,45,154.8253913641837,-77.67773110503582,-24.669306962885234,27.33185381956252,1.1510093604696339,326,308,344,358,14,32,50,91.22309870772345,35,100.20900735820426,-58.99586261975253,-9.334956909073764,38.892199471760414,1.0650764224220381,34878,34927,Monroe+St. Clair,Monroe,17,133,Illinois,IL
17163,17CS040,2176,2065,2286,2685,399,509,620,237.8421217513354,324,151.2646236086417,35.515532472818855,86.40564627840332,138.16244604986986,0.6347415804933172,2660,2528,2792,3073,281,413,545,161.94699689428836,295,115.64681853642091,-9.69929570529793,45.72617437604433,97.70443508568003,0.7123784443859673,257033,255087,Monroe+St. Clair,St. Clair,17,163,Illinois,IL
17141,17CS041,449,427,471,518,47,69,91,161.1713011063441,52,121.15093387178192,-9.49850304345362,41.91196531244901,92.61681723528586,0.7409791985794877,550,524,577,592,15,42,68,80.95129482124857,49,95.17889747873043,-69.1482846543853,-13.178241294403069,33.99480371326405,1.1482039409692164,51506,51482,Ogle,Ogle,17,141,Illinois,IL
17143,17CS042,1539,1461,1617,1770,153,231,309,153.49432447291883,146,96.92088113915227,6.346028100912125,56.45594049449532,106.40333729239414,0.628710652025025,1872,1779,1964,2148,184,276,369,153.8040128377713,211,117.42249280717668,-12.045437318363842,39.02140226523667,83.78363999857393,0.7607028965451113,180766,179693,Peoria+Woodford,Peoria,17,143,Illinois,IL
17203,17CS042,326,310,343,383,40,57,73,177.10014826084824,46,143.85864324620155,-15.474231338443266,34.665035679453176,81.4878689531335,0.7982057966061313,398,378,418,421,3,23,43,59.523791082845975,58,151.63398692810458,-142.96873521164358,-91.64542770310534,-42.946243427550996,2.440271197535985,38371,38250,Peoria+Woodford,Woodford,17,203,Illinois,IL
17145,17CS043,197,188,206,232,26,35,44,198.63925886111974,29,166.51514426527584,-21.12558713852615,33.014642381102014,87.68706146432494,0.8147284414549835,242,231,253,302,49,60,71,287.28350097786176,40,190.74868860276584,47.465909263146045,95.30938726953309,148.47104362470168,0.653132134325227,20899,20970,Perry+Randolph,Perry,17,145,Illinois,IL
17157,17CS043,295,282,308,362,54,67,80,264.3362947325091,51,201.92688399102545,12.678100845179546,61.64549291421386,114.2602517028114,0.7526282571255563,359,344,375,444,69,85,100,281.4846465738056,50,165.95306847223605,64.59056105352055,114.63123077472405,172.67254900310158,0.5826927945239523,30308,30129,Perry+Randolph,Randolph,17,157,Illinois,IL
17161,17CS044,1363,1301,1425,1652,227,289,351,241.07882471653218,192,160.2648822359177,28.984565769893123,83.22146653728878,134.70537012727158,0.6624882749274007,1661,1587,1735,1776,41,115,189,80.16747204186436,160,111.80445400993662,-81.5301947782387,-29.784517588241304,18.67384774336183,1.3825848753545489,143762,143107,Rock Island,Rock Island,17,161,Illinois,IL
17167,17CS045,1682,1598,1766,1899,133,217,301,133.24160792076322,190,116.49652043287654,-34.97541843329053,16.18878676081145,70.3377285751108,0.8703204227488873,2055,1954,2155,2118,-37,63,164,32.443628920665795,141,72.3373691770983,-92.33856360398389,-41.81612596285857,10.039906901378766,2.194924163419706,195714,194920,Sangamon,Sangamon,17,167,Illinois,IL
17003,17CS046,69,69,70,99,29,30,30,680.6913928801068,11,251.71624713958812,417.73793950856975,428.83487427730086,440.8303610468314,0.3577676278099609,82,81,82,103,21,21,22,419.0877919342687,12,237.6237623762376,169.25265635423838,181.679021366313,194.67406209642755,0.5414201411479098,5244,5050,Southern Illinois,Alexander,17,3,Illinois,IL
17069,17CS046,51,51,52,62,10,11,11,348.30164544899,10,327.242977911099,10.62769127930092,20.96794262290508,33.211437623762016,0.8588469728028202,63,62,63,84,21,21,22,584.953919356626,11,301.53508771929825,270.7771035684923,283.23487547986457,296.07821838295524,0.4924097503920875,3667,3648,Southern Illinois,Hardin,17,69,Illinois,IL
17087,17CS046,122,120,123,140,17,18,20,166.9387908680261,16,145.58689717925387,9.30338932408275,21.42506965469027,33.2404507721673,0.8270198501687166,153,151,154,175,21,22,24,165.75210762242355,32,238.09523809523813,-84.25136455885334,-72.48539425730189,-60.09016737798215,1.374742687322298,13188,13440,Southern Illinois,Johnson,17,87,Illinois,IL
17127,17CS046,181,175,187,200,13,19,25,160.34898076289767,23,196.35742743312466,-85.20263591190835,-35.57719226634754,18.345145784171994,1.1626607586750686,221,213,228,239,11,18,26,131.4701742198926,29,207.3798627002288,-124.0014198676822,-74.4744101042422,-29.279584233300064,1.4960183345964704,14056,13984,Southern Illinois,Massac,17,127,Illinois,IL
17151,17CS046,40,40,41,42,1,2,2,53.94370262343166,6,188.92679086853843,-146.3383279274347,-135.14669493837522,-122.93187426366781,2.2114417800528843,49,49,50,71,21,22,22,581.098717504563,12,317.9650238473768,250.2672398256921,263.29951531993663,276.0844235012053,0.5233166891030421,3811,3774,Southern Illinois,Pope,17,151,Illinois,IL
17153,17CS046,66,66,67,68,1,2,2,38.800840796914684,7,162.3815967523681,-136.02192128707765,-123.46771793893019,-112.05467379306116,2.6191335546407384,80,79,81,107,26,27,28,532.7274408319407,16,315.0226422524119,205.32268841113557,217.48641011056407,230.17669466184006,0.5702630612696244,5173,5079,Southern Illinois,Pulaski,17,153,Illinois,IL
17181,17CS046,200,193,207,231,24,31,38,216.93837070413213,22,154.5576956852643,8.403224739075588,63.73586364440668,113.70164643645322,0.6901014831093509,244,235,252,278,26,34,43,202.66722087808418,32,188.67924528301887,-36.93245636493048,12.37463219339592,65.50624951076477,0.9046611366074692,17081,16960,Southern Illinois,Union,17,181,Illinois,IL
17179,17CS047,1182,1126,1239,1421,182,239,295,218.52896711557278,112,102.53593335164331,64.4551763238243,116.25103364966797,164.95367153273165,0.4672523075083578,1441,1374,1509,1718,209,277,344,212.08354095630736,165,126.4358127523927,34.846757809681954,84.8506276608902,137.6576699935939,0.5940141907494083,131076,130501,Tazewell,Tazewell,17,179,Illinois,IL
17183,17CS048,798,766,829,928,99,130,162,211.15886429734155,84,136.0856475543735,22.243286576800696,74.91365082036182,125.24638770116944,0.639563544077212,965,927,1003,1186,183,221,259,301.8026855538804,157,214.45157765332604,38.98030984931299,87.78445337530356,137.33525751985553,0.7073673332048347,74071,73210,Vermilion,Vermilion,17,183,Illinois,IL
17197,17CS049,4024,3725,4323,4966,643,942,1241,162.56079027124667,644,111.16097628335692,-1.544804898129552,50.20985971971095,104.70009248558137,0.6830864220468397,5005,4645,5364,5525,161,520,880,74.6677998672987,461,66.13538386497478,-38.973031124642304,7.846363556951189,58.61087596217494,0.8840298019473516,695208,697055,Will,Will,17,197,Illinois,IL
17199,17CS050,638,609,667,744,77,106,135,190.37599837452498,76,136.11127693869022,2.278121540466764,55.289889344059,106.01385167122342,0.7082970650919019,778,743,813,889,76,111,146,165.82740075392525,97,144.97085637423405,-29.277746410038315,21.732785518611916,68.98759032501243,0.8664186625255031,67004,66910,Williamson,Williamson,17,199,Illinois,IL
17201,17CS051,2538,2416,2661,2933,272,395,517,166.5483399016843,323,136.32143158605555,-20.1612901475708,28.71638859179202,79.8467457357062,0.8164407682239068,3101,2954,3247,3540,293,439,586,155.03126717729066,303,106.926206801636,-3.8892703428982585,47.09369430615618,102.81392069070223,0.6881409760488578,284328,283373,Winnebago,Winnebago,17,201,Illinois,IL
18001,18CS001,271,256,287,336,49,65,80,216.8806289727006,43,144.0536013400335,23.79280469546789,70.83504787569942,122.97830472139213,0.6541031428257071,334,316,353,382,29,48,66,132.35686848322922,55,153.02857460838595,-69.61256313720054,-22.742507747247263,31.706995242560616,1.1323773382099134,35820,35941,Adams+Wells,Adams,18,1,Indiana,IN
18179,18CS001,261,249,273,315,42,54,66,231.11545682401817,46,195.9253212181444,-14.717006275492913,34.97740748395161,87.41474321656415,0.8323975294414107,319,305,334,363,29,44,58,155.02101249622646,54,191.5301127899553,-86.24407684239493,-35.76763205916853,14.482710039110199,1.2078746917258656,28174,28194,Adams+Wells,Wells,18,179,Indiana,IN
18003,18CS002,2958,2792,3124,3470,346,512,678,159.49276612107585,428,133.34337216457106,-27.541288509319976,25.818270612158813,77.03625789999414,0.8344165880839571,3664,3464,3864,3912,48,248,448,63.89071797819686,387,99.68779944978516,-86.49667435067785,-34.464954137070244,14.908212382959068,1.5540206859168473,385171,388212,Allen,Allen,18,3,Indiana,IN
18005,18CS003,631,596,667,726,59,95,130,137.86545582882965,101,146.9660959402435,-58.93682084853555,-8.044771317130126,44.836902637721245,1.0548772552908803,773,731,816,892,76,119,161,143.95296682507038,87,105.54537844690583,-12.365160741177657,37.38292613486081,90.17063541431267,0.7270661339805039,82468,82429,Bartholomew+Brown,Bartholomew,18,5,Indiana,IN
18013,18CS003,147,140,154,172,18,25,32,194.98162019022743,18,140.07782101167314,3.343087963045261,53.70419677797681,101.52918537061564,0.6908426225057661,180,172,188,204,16,24,32,152.66982562029486,23,148.00514800514802,-47.94783338449941,4.254391240572007,57.54689969047083,0.9302366627916412,15420,15540,Bartholomew+Brown,Brown,18,13,Indiana,IN
18007,18CS004,74,73,75,95,20,21,22,292.0647966414154,11,151.37614678899084,128.3749415059339,140.64956887435446,152.48425452845305,0.49497431824887106,91,90,92,107,15,16,17,187.50685539294793,11,126.23364700481983,49.42980575492349,61.300039003280276,74.23786108407283,0.6343952721865083,8720,8714,Benton+Jasper+Newton,Benton,18,7,Indiana,IN
18073,18CS004,277,262,291,350,59,73,88,266.70166802875127,34,123.58393408856847,89.32470967461899,144.49581094408896,192.26543181999904,0.4571485494336027,341,324,358,425,67,84,101,254.18364868269398,75,226.83280909750786,-26.62296291399462,26.32502570718443,74.89038068866876,0.8819038798663518,33014,33064,Benton+Jasper+Newton,Jasper,18,73,Indiana,IN
18111,18CS004,147,141,153,163,10,16,22,142.55557096950554,23,199.66722129783693,-108.75581946423053,-55.9045958923626,-3.359494658923177,1.3202294769708232,179,172,186,223,37,44,51,317.0060648263096,31,224.5400550485296,41.34518920922419,90.90494987919034,146.32491506017715,0.6924920433307611,13823,13806,Benton+Jasper+Newton,Newton,18,111,Indiana,IN
18009,18CS005,147,142,152,173,21,26,31,261.08587295971944,22,219.0507799535347,-8.415282840624757,41.503540325589285,90.32393377194539,0.8081780415442706,180,174,186,204,18,24,30,198.45528550198696,35,289.4475686404234,-141.09630086226753,-91.2472440700429,-38.02260708007755,1.400156082516897,12052,12092,Blackford+Jay+Randolph,Blackford,18,9,Indiana,IN
18075,18CS005,199,190,208,226,18,27,36,159.45510134213518,34,199.67699309939803,-91.19391005144759,-41.05116016707947,6.318861316506146,1.2077630441271348,243,232,253,297,44,54,65,267.07817576116094,38,187.39520662787257,24.513216188708416,80.40027351980862,137.740636872215,0.688928578061735,20433,20278,Blackford+Jay+Randolph,Jay,18,75,Indiana,IN
18135,18CS005,261,251,272,327,55,66,76,323.06009716352804,56,275.4211238165499,-1.3838562811864787,48.04868597998667,97.64978009377822,0.839754024426892,321,308,333,415,82,94,107,386.75829182576547,54,221.44761123641584,111.84321695449351,165.24182877954377,217.66162080572755,0.5665662372581646,24399,24385,Blackford+Jay+Randolph,Randolph,18,135,Indiana,IN
18011,18CS006,490,460,521,511,-10,21,51,35.33247281907033,76,128.64820640137674,-143.06903780953326,-94.35896966394402,-43.53293196187502,3.474610897339544,616,579,654,640,-14,24,61,32.63312004266896,54,74.1992662517004,-93.00467140670014,-42.17382626624513,13.007323164413652,2.1818705666833305,70891,72777,Boone,Boone,18,11,Indiana,IN
18015,18CS007,162,154,171,165,-6,3,11,16.24093067046289,18,106.36726252031319,-143.38767132030972,-90.34863410834781,-37.67371487036148,4.802085394953943,199,188,209,236,27,37,48,183.20957383781726,34,166.4708186447317,-35.50689572640249,16.74748052776861,65.7069554943953,0.8849851589508239,20307,20424,Carroll+Clinton,Carroll,18,15,Indiana,IN
18023,18CS007,318,303,332,387,55,69,84,252.2420707541275,35,127.20334363074686,72.85604436989912,123.9224103809305,177.05539435780227,0.4971279796797745,386,369,403,435,32,49,66,148.54654183300914,49,148.13471189310116,-51.03617276247969,0.4122581503641118,54.551641686363816,0.9773372425808684,33018,33078,Carroll+Clinton,Clinton,18,23,Indiana,IN
18017,18CS008,358,342,374,450,76,92,108,293.1725396704599,75,238.56226475109997,2.97110636475703,55.71361509314945,102.04533971825555,0.8049925832058206,437,417,456,495,39,58,78,154.94000271541435,63,167.58439071103663,-65.99083854816725,-13.112854815181874,39.76276225981898,1.0633522443813985,37726,37593,Cass+White,Cass,18,17,Indiana,IN
18181,18CS008,257,246,267,279,12,22,33,109.8634046851814,31,151.37950679580044,-90.07828935785092,-42.122857694394376,5.164218828035783,1.3192503094534367,314,302,327,516,189,202,214,818.5122202551361,52,210.9619051482819,557.3360161063667,605.242496617528,659.3693794888908,0.25646706719074674,24574,24649,Cass+White,White,18,181,Indiana,IN
18019,18CS009,1117,1065,1169,1253,84,136,188,134.61413347506434,129,127.95186100526519,-42.69118722289524,6.659974975529273,58.31869518256895,0.9435559865413804,1384,1320,1447,1539,92,155,219,126.83606679010461,181,147.72374842890488,-70.56469542079984,-20.981135350781848,29.46615924183739,1.1572360301874487,120983,122526,Clark+Scott,Clark,18,19,Indiana,IN
18143,18CS009,280,270,291,333,42,53,63,260.24936260835403,38,187.90176363936044,25.14909301790577,72.94602094665272,122.00733239177451,0.7085441612166069,343,330,355,437,82,94,107,386.7110373377156,55,225.85413929040737,107.83944709108393,161.44520469773778,215.49857475646633,0.5779018417160888,24268,24352,Clark+Scott,Scott,18,143,Indiana,IN
18021,18CS010,257,246,269,317,48,60,71,270.6948919073943,32,145.39396463594713,76.71246218961147,124.66192825118831,176.33966209839755,0.5282472811903033,312,299,326,350,24,38,51,143.0450777284505,36,136.2965206527089,-49.10574416468279,7.116657683346913,62.62376561666457,0.9282538093184548,26411,26413,Clay+Sullivan+Vermillion+Vigo,Clay,18,21,Indiana,IN
18153,18CS010,196,187,205,225,20,29,38,169.47081334536574,28,161.77957532861478,-38.90811430061945,5.53161030872611,57.36387115620913,0.9231430337193056,237,227,248,274,26,37,47,176.851894207827,30,144.47387430772935,-23.28018790281248,32.15048466748459,85.35805817807746,0.7952645530603009,20769,20765,Clay+Sullivan+Vermillion+Vigo,Sullivan,18,153,Indiana,IN
18165,18CS010,174,167,181,195,14,21,28,162.86780591071428,26,202.62371736589168,-92.37951776579769,-38.70322981966767,9.43527505524468,1.187287586049001,210,202,218,233,15,23,31,147.93315826201416,27,175.91868647380767,-78.7114066696395,-29.390215146417045,19.676288012132638,1.1390107274927863,15398,15348,Clay+Sullivan+Vermillion+Vigo,Vermillion,18,165,Indiana,IN
18167,18CS010,953,908,999,1144,145,191,236,215.5758805210499,138,156.0144709074465,7.734318407295698,61.24653619576289,111.80983588789559,0.7199346968513273,1157,1102,1211,1348,137,191,246,180.65976134271096,128,120.75927393486548,11.179062084574586,59.75565577277391,112.53323075007947,0.6649622830233186,106144,105996,Clay+Sullivan+Vermillion+Vigo,Vigo,18,167,Indiana,IN
18025,18CS011,105,104,106,124,18,19,20,214.12778545564916,11,125.1778093883357,76.7764254251947,88.93835405846903,101.73099817042666,0.5550935622038776,129,128,130,166,36,37,38,352.39329711549476,26,247.19528427457695,92.91701377431518,105.26893435365142,117.61881398558475,0.6830470636612042,10545,10518,Crawford+Harrison+Perry,Crawford,18,25,Indiana,IN
18061,18CS011,352,335,369,403,34,51,68,153.82921729962706,41,123.6336223143611,-28.033959745744827,32.53573112821565,80.15421257973539,0.7882551643614898,433,413,454,542,88,109,129,274.0493292757583,72,181.1548622468235,39.08867667170291,92.54761744087716,143.88384239810776,0.6550164356539736,39795,39745,Crawford+Harrison+Perry,Harrison,18,61,Indiana,IN
18123,18CS011,191,182,199,210,11,19,28,121.7855015700035,25,156.4781973711663,-82.84413732673283,-33.13572561200201,17.246915663238024,1.222059824181236,235,225,245,245,-0,10,20,50.652842391619544,32,165.87186398507154,-167.19823481873127,-113.96332200224913,-60.09508933743852,2.9706794805517354,19172,19292,Crawford+Harrison+Perry,Perry,18,123,Indiana,IN
18027,18CS012,292,278,306,336,30,44,58,158.36635896058664,70,251.504536063954,-145.87496665132366,-93.93710126353224,-39.97389705689379,1.5528874582523995,359,342,376,343,-33,-16,1,-48.05483731913248,38,113.78608216552881,-210.16902536299926,-162.50700531063924,-110.14208410971032,-2.5251864973483213,33399,33396,Daviess+Knox+Martin,Daviess,18,27,Indiana,IN
18083,18CS012,373,358,389,477,88,104,119,342.6230528414832,68,225.0041361054431,63.767243697200925,119.87177770955111,167.42941114211462,0.6504289194263533,455,436,473,503,30,48,67,134.40900576766353,43,119.45108061558976,-33.72335178324882,14.139815235311856,65.63541094732652,0.870717595026627,36266,35998,Daviess+Knox+Martin,Knox,18,83,Indiana,IN
18101,18CS012,90,89,91,95,4,5,6,59.20507911727087,10,121.914050594331,-75.48864703536596,-62.888010905762584,-51.219054561990774,1.7075637827291004,110,109,111,128,17,18,19,182.7996015769706,5,51.11951743175544,119.35727296252296,131.63903689751328,143.8399216899572,0.2648357121843042,9843,9781,Daviess+Knox+Martin,Martin,18,101,Indiana,IN
18029,18CS013,436,414,457,474,17,38,60,91.339183917267,58,137.63917179188007,-96.11042612441373,-46.71522856145304,6.2988638989098575,1.4687422176328215,536,510,562,616,54,80,106,157.6347510263925,84,165.3445662657717,-62.18569315938625,-6.6007894468355595,46.361446810609515,1.0359731493489635,50567,50803,Dearborn+Ohio+Ripley+Switzerland,Dearborn,18,29,Indiana,IN
18115,18CS013,57,56,58,66,8,9,10,183.851275697002,16,323.66824005394466,-152.687615638601,-140.06004298991027,-128.24726627481002,1.585982862173749,70,70,71,89,18,19,19,313.54398626563164,2,33.49522693016245,266.6608604750629,280.2197911525349,292.33817920846303,0.10141107723439273,5932,5971,Dearborn+Ohio+Ripley+Switzerland,Ohio,18,115,Indiana,IN
18137,18CS013,265,252,277,332,55,67,80,278.85014785678686,43,178.45408957288603,49.770616475319585,101.22588629791044,152.7967020639007,0.6305792804429978,326,311,341,421,80,95,110,327.8774215918551,74,254.59299525218466,22.67247532811789,73.66162475567961,125.51358838588469,0.7684251899648584,28915,29066,Dearborn+Ohio+Ripley+Switzerland,Ripley,18,137,Indiana,IN
18155,18CS013,85,84,86,90,4,5,6,58.81770048003624,6,72.80080889787664,-26.489073324219113,-13.670905199003402,-1.0326874523381924,1.0260692008872776,103,102,105,116,11,13,14,128.79067950648573,12,122.69938650306749,-7.360104979882491,5.983863215517478,18.904647958471525,0.8826301613091376,9890,9780,Dearborn+Ohio+Ripley+Switzerland,Switzerland,18,155,Indiana,IN
18031,18CS014,247,235,258,332,74,85,97,387.36516563231146,61,276.6439909297052,58.05732202922059,109.75349157245415,161.4193030460371,0.7059039805164401,302,288,315,332,17,30,44,115.20167186750132,38,144.25084462665603,-78.05172880523375,-28.228905686541154,18.2550442182904,1.2122149250328638,26460,26343,Decatur+Shelby,Decatur,18,31,Indiana,IN
18145,18CS014,408,389,427,492,65,84,103,224.30632830659678,62,165.37008224049785,5.770907947036936,58.246248100493005,112.16208877205409,0.7285873388089661,502,479,525,541,16,39,62,87.02022865031945,69,153.20736283500233,-119.30557729858536,-65.62784165916618,-14.454342229461744,1.7167894383200055,44990,45037,Decatur+Shelby,Shelby,18,145,Indiana,IN
18033,18CS015,364,346,383,458,75,94,112,259.94345950464736,63,174.50717880060938,37.30345133187097,84.50210777422912,134.53886389133513,0.664249212337095,446,424,469,489,20,43,65,98.28682907409667,55,126.95042009048102,-76.94726235120865,-30.178107971627774,24.326713643698287,1.26199509623092,43322,43324,DeKalb+Steuben,DeKalb,18,33,Indiana,IN
18151,18CS015,277,262,292,306,14,29,44,101.25905202096261,32,111.28176891645174,-59.740862254609965,-8.982821094270056,38.78459970200468,1.0624916329218819,341,323,359,395,36,54,72,156.87692255821676,60,173.39035949601202,-65.34461911664822,-14.034452052190995,36.97529254273629,1.0852717890272179,34507,34604,DeKalb+Steuben,Steuben,18,151,Indiana,IN
18035,18CS016,1100,1052,1148,1343,195,243,291,260.11654580490875,120,128.5760205721633,81.63450770663106,131.03917594565775,180.01867967426924,0.49227381942639176,1351,1293,1409,1554,145,203,261,181.35857428649146,183,163.62368341052556,-32.275114590970304,17.155035747928356,66.46099129206823,0.8977847236115248,111996,111842,Delaware,Delaware,18,35,Indiana,IN
18037,18CS017,358,339,377,412,35,54,73,149.55229480264646,55,151.9022302009252,-56.04711138812279,-3.2245156878288794,52.959273544386434,0.9972955675944037,438,416,461,534,73,96,118,219.5285156197542,62,142.34221824276236,28.24137416227721,76.88285088055689,130.0227331522987,0.6416888551948466,43449,43557,Dubois+Pike+Spencer,Dubois,18,37,Indiana,IN
18125,18CS017,139,134,144,154,10,15,20,147.4604388189153,25,244.97795198432144,-143.14695142638826,-98.89003172911751,-47.285061203396545,1.5577937316888628,168,162,174,189,15,21,27,172.2514353466197,16,131.61141729044994,-13.002175857755292,41.14485294491484,88.78483075770527,0.729241447311901,12246,12157,Dubois+Pike+Spencer,Pike,18,125,Indiana,IN
18147,18CS017,170,161,178,195,17,25,34,153.2860958628968,12,72.4200362100181,29.033851338535992,79.61319271482058,129.66896523933343,0.45455395875962123,207,197,217,281,64,74,84,374.64301271084634,43,217.16074945709812,103.2090520341372,156.80320368053592,210.4856210748132,0.5719373262350903,19884,19801,Dubois+Pike+Spencer,Spencer,18,147,Indiana,IN
18039,18CS018,1489,1400,1578,1781,203,292,381,169.57018280457598,331,192.1002867962489,-78.19346246949796,-22.588115912199783,28.45667571007086,1.1290018814310463,1833,1726,1939,2092,153,259,366,125.36402996112784,219,105.84363174149021,-31.866480437690996,19.202992183661184,73.07467158128931,0.841047864868666,206767,206909,Elkhart,Elkhart,18,39,Indiana,IN
18041,18CS019,282,272,292,344,52,62,72,320.042159038187,44,226.6775426093676,43.62389937091737,93.84036968312289,147.63841160663821,0.6970534432324332,345,333,357,390,33,45,57,193.4238493031828,61,261.17485870868296,-118.44564141019747,-67.71394543331259,-17.9440328476104,1.3210304470375183,23293,23356,Fayette+Franklin+Union,Fayette,18,41,Indiana,IN
18047,18CS019,187,177,197,249,52,62,72,326.9250113150494,30,158.0749978045139,119.65546231304444,169.23077207399936,220.98602234229605,0.47585119883720084,231,219,242,263,21,32,44,141.59375957659455,36,157.68034689676318,-68.53303412032824,-16.128053466421868,34.23234619033996,1.0801964472609895,22774,22831,Fayette+Franklin+Union,Franklin,18,47,Indiana,IN
18161,18CS019,64,63,65,94,29,30,31,505.49295850626214,1,16.920473773265652,477.07896289939185,488.6709710633957,500.3266129997529,0.03238904807526467,78,78,79,89,10,11,11,150.3652981155073,19,269.38891251949525,-131.28400283083707,-118.8618793631142,-105.94179118260146,1.6371880226556248,7092,7053,Fayette+Franklin+Union,Union,18,161,Indiana,IN
18043,18CS020,722,687,756,830,74,108,143,161.82901535737375,87,130.22165122051615,-18.64800050419797,33.0826315205054,82.62936692727563,0.7973121117820041,889,848,931,955,24,66,107,81.43246096052519,95,118.08283199920449,-89.00370690277315,-37.617066649580664,14.693008165181455,1.4282698060820918,80171,80452,Floyd,Floyd,18,43,Indiana,IN
18045,18CS021,189,182,196,227,31,38,45,278.20542978977545,26,189.56194179476276,34.24954597421834,88.98071969834126,139.55666613877196,0.6639734359218376,231,222,239,258,19,27,36,165.26904945543822,34,206.90074849388424,-95.86571851624626,-39.8189957412989,7.737064018749466,1.2074436959010453,16459,16433,Fountain+Montgomery+Warren,Fountain,18,45,Indiana,IN
18107,18CS021,354,337,370,405,35,51,68,162.62007444674563,63,198.9683124539425,-88.80869949988777,-35.37609040245329,16.28814642844125,1.2002072074532069,436,416,455,488,33,52,72,137.72962645613003,63,165.5977289454316,-78.8636178281352,-29.8864860841894,24.290148102276902,1.1798225823067374,37996,38044,Fountain+Montgomery+Warren,Montgomery,18,107,Indiana,IN
18171,18CS021,73,72,74,105,31,32,33,458.50249365679224,8,114.3265451947124,332.1058625603823,343.90410596476323,356.5144068690078,0.2418108343325972,90,89,91,98,7,8,9,90.06260886080608,11,129.9314906685566,-53.066847284390825,-39.7587180736885,-26.64507545845497,1.275406611877718,8397,8466,Fountain+Montgomery+Warren,Warren,18,171,Indiana,IN
18049,18CS022,212,204,221,237,16,25,33,145.2977424490202,31,182.6035735322992,-87.21960612655113,-37.27712482282208,15.791968021864202,1.20779000821389,260,249,271,293,22,33,44,161.73851293192868,41,201.049379689109,-89.64268938477467,-40.255944831196075,10.53606616172352,1.2064737045297134,20372,20393,Fulton+Miami+Wabash,Fulton,18,49,Indiana,IN
18103,18CS022,334,318,349,387,38,53,69,177.4810255061526,37,123.75616690358726,0.9568906059878326,54.87718845708311,103.56249449213155,0.6843944611638026,412,393,430,521,91,109,128,303.24609935937497,77,213.54484441732765,36.89682223266211,88.98011643402478,142.5473649834056,0.6978147075579582,35877,36058,Fulton+Miami+Wabash,Miami,18,103,Indiana,IN
18169,18CS022,379,366,392,434,42,55,68,214.32410651245922,54,209.70195139315877,-47.60864974938574,4.574619546784322,56.852886499833275,0.9610209295018913,462,446,477,530,53,68,84,222.0840607077639,62,201.1289171478622,-33.45126406045387,21.765525711602645,73.11959522337042,0.8926047795026834,30901,30826,Fulton+Miami+Wabash,Wabash,18,169,Indiana,IN
18051,18CS023,306,292,321,382,61,76,90,273.67508891716653,71,257.3162997191265,-36.072396948249434,17.05670673509936,66.84661306515594,0.9279371957992428,374,357,391,401,10,27,44,83.00100997279009,48,145.72833808974437,-114.2926232515104,-61.836109576812476,-12.918352197908447,1.6937865019435867,33111,32938,Gibson+Posey,Gibson,18,51,Indiana,IN
18129,18CS023,209,199,220,233,13,24,34,112.63637521167522,23,109.5585900285805,-50.521925053345484,3.721857547035647,55.496739487298086,0.9332094035605947,256,243,269,255,-14,-1,12,-5.034941922099918,20,79.60832703100743,-140.61565044602898,-84.59992065887155,-36.06637756153022,-75.49207838508937,25192,25123,Gibson+Posey,Posey,18,129,Indiana,IN
18053,18CS024,725,696,753,892,139,167,196,302.60285835062564,120,217.07015586843136,37.51052335899689,84.23845161909136,138.91278001114603,0.7130806780712655,886,851,920,1121,201,235,270,355.0087807111018,144,217.22733443958367,85.42710975965255,136.27946876299762,192.83340908079694,0.6093037619309001,66338,66290,Grant,Grant,18,53,Indiana,IN
18055,18CS025,323,309,336,367,31,44,58,171.87342025714122,55,213.02004324952392,-94.2546926917753,-42.958126730692676,10.885683442371555,1.2120868908453355,394,378,410,448,38,54,70,175.5973453679812,40,129.92496833078897,-2.4246951956730607,45.953986065288284,99.85075032348746,0.7264649679895601,30983,30787,Greene+Owen+Parke+Putnam,Greene,18,55,Indiana,IN
18119,18CS025,207,205,209,259,50,52,54,293.5648956871564,23,129.8640191972898,152.71753453283497,163.97416097763175,175.39818532842088,0.4340213123383622,256,254,259,77,-182,-179,-177,-836.8884661314739,21,98.02091112770725,-947.249014685849,-934.7346337564153,-921.9464237821329,-0.11778233696188199,21253,21424,Greene+Owen+Parke+Putnam,Owen,18,119,Indiana,IN
18121,18CS025,142,135,149,150,1,8,15,58.82920754894317,13,95.77603143418467,-85.31813592372824,-34.42216759190183,13.435030240533594,1.4468422739639393,176,168,185,194,9,18,26,109.65686999047685,31,189.37080024434943,-130.91611034410036,-78.65268114329847,-28.26602817791721,1.6358122903215646,16288,16370,Greene+Owen+Parke+Putnam,Parke,18,121,Indiana,IN
18133,18CS025,310,295,326,363,37,53,68,171.4968077679188,38,123.8121096931849,-2.5742643863612114,49.41841827828647,98.24331184884016,0.7084895693212787,384,365,403,441,38,57,76,154.80000076804563,51,138.08788887986353,-37.247235710145624,17.99187058921256,69.49278595434997,0.8767061604683,36830,36933,Greene+Owen+Parke+Putnam,Putnam,18,133,Indiana,IN
18057,18CS026,1638,1488,1788,1971,183,333,483,114.65913548019861,274,94.45914383473097,-31.71115292875519,19.69225720611096,69.20375173142925,0.8213561698657075,2086,1902,2270,2313,43,227,411,63.83963014755357,168,47.255390067929625,-35.98096190052578,17.359691753438625,68.42490391666834,0.7369731406420762,348087,355515,Hamilton,Hamilton,18,57,Indiana,IN
18059,18CS027,603,569,638,659,21,56,90,83.69617341907653,81,121.44686699568938,-87.73606286416357,-36.39509438563291,18.04859875504003,1.4255077100544133,752,710,794,918,124,166,208,203.13687033773053,104,127.52755944133119,26.3961749190444,74.72226551970758,127.6340337193259,0.6240244026148347,80035,81551,Hancock,Hancock,18,59,Indiana,IN
18063,18CS028,1104,1029,1180,1288,108,184,259,125.87090961724988,189,129.51932796144118,-55.50749585957301,-4.0696558061564305,48.24775239611512,1.0234135582716368,1391,1299,1483,1460,-23,69,161,38.524119744040306,157,87.80907957068631,-100.91256879172673,-49.5658536076379,5.8812364064775196,2.2467095957404504,175109,178797,Hendricks,Hendricks,18,63,Indiana,IN
18065,18CS029,514,493,535,622,87,108,129,266.231202763522,63,155.02922177791447,59.5060920283934,112.15000224343099,162.07272303864204,0.5769774722508351,628,603,653,734,81,106,131,216.47958905239244,109,222.77632439502943,-56.59009339091211,-8.461901136488674,41.61688039361104,1.019462060751958,48765,48928,Henry+Rush,Henry,18,65,Indiana,IN
18139,18CS029,170,162,177,183,6,13,21,96.5682707611306,17,122.03876525484566,-77.88055213275457,-26.065679513780246,24.787137042645448,1.1763110237186944,206,198,215,220,5,14,22,81.3878982075745,21,125.88418654837548,-94.22768080160796,-45.21096449866285,5.880427456083533,1.4406128766609798,16716,16682,Henry+Rush,Rush,18,139,Indiana,IN
18067,18CS030,922,886,958,1064,106,142,178,204.49742754711542,137,196.91924394509257,-45.528473800205965,6.9451999974042815,57.34404121555809,0.9562213351212643,1129,1085,1172,1334,162,205,249,245.52330912040242,184,219.89316060566222,-23.724202327077222,23.68316926188772,82.28682430269795,0.8912719029299957,83486,83677,Howard+Tipton,Howard,18,67,Indiana,IN
18159,18CS030,163,157,170,186,16,23,29,178.8053481303705,36,281.76363162014087,-151.9404749227957,-104.5198724682796,-51.54153966938291,1.5097274689327158,200,192,208,230,22,30,38,195.73440190121977,36,234.20727343699176,-90.1651195246911,-38.735884766267255,16.858487468937916,1.1580651143662832,15332,15371,Howard+Tipton,Tipton,18,159,Indiana,IN
18069,18CS031,357,341,372,426,54,69,85,227.1323206653796,44,144.25047127284648,29.577069085819677,83.46595707755404,131.95548626208821,0.6260579302008898,438,419,457,520,63,82,101,223.5429760708448,71,193.46049046321525,-24.17854902378609,28.971555533066915,80.17158774452102,0.8550068310663587,36603,36700,Huntington+Whitley,Huntington,18,69,Indiana,IN
18183,18CS031,277,262,291,305,14,28,43,99.58248508797345,27,94.56264775413713,-48.90483202172622,5.784161412244282,57.890250868101184,0.9173286733189112,341,324,359,385,26,44,61,126.8666134526403,40,116.2351436956964,-41.103546469091306,10.665206643319348,62.104188341102954,0.8956839917612225,34263,34413,Huntington+Whitley,Whitley,18,183,Indiana,IN
18071,18CS032,430,410,450,474,24,44,64,113.88848589972885,50,130.37526346667823,-66.6817252873543,-16.686092987490838,33.925908332265415,1.1191394841859736,525,502,549,567,18,42,65,90.37196596889694,48,104.09437890353921,-65.68736374694559,-12.543473562954741,37.095157887580456,1.1248509322698244,46021,46112,Jackson+Washington,Jackson,18,71,Indiana,IN
18175,18CS032,272,260,284,293,9,21,33,88.57229399205427,19,80.89409260244811,-40.03450847987391,8.65695743397065,60.10406288540684,0.8714230214241883,331,317,346,397,51,66,80,232.99572820941364,44,156.477826380739,24.756675175225855,76.42608395146468,125.2706321389809,0.661494294292118,28185,28119,Jackson+Washington,Washington,18,175,Indiana,IN
18077,18CS033,331,316,345,382,37,51,66,186.79223176897688,45,163.81507098653077,-34.39651590615105,20.972381469692845,72.37385909076723,0.860226135910802,406,389,423,427,4,21,38,62.69533543306295,75,226.3740907307356,-217.53456209915532,-163.0104809181539,-112.06583057591342,3.444856096826527,32964,33131,Jennings+Jefferson,Jefferson,18,77,Indiana,IN
18079,18CS033,262,250,274,300,26,38,50,164.90987847524403,30,130.61461432406938,-16.377926210565136,35.39936464706273,82.74703194481413,0.7716634761748826,320,306,334,346,12,26,40,95.50862746662314,32,116.65208515602218,-72.24468759364373,-21.921135656538596,26.017602708461823,1.176473759236745,27562,27432,Jennings+Jefferson,Jennings,18,79,Indiana,IN
18081,18CS034,1213,1143,1282,1462,180,249,319,184.9132896114665,223,165.3495140231959,-33.54054851914523,20.155214771087092,69.65136440762171,0.8906289694033099,1508,1423,1592,1742,150,234,319,142.95943848499016,199,121.34960271725542,-31.891990489424963,21.129302970224728,72.56200870900808,0.8452340246051055,161839,163989,Johnson,Johnson,18,81,Indiana,IN
18085,18CS035,626,592,661,679,18,53,87,79.21498298280319,67,100.54147335776007,-76.75865032341018,-20.2773976090921,30.643355672585393,1.245626259128063,772,730,813,924,111,152,194,190.3159370853582,97,121.10165047816426,21.567893754610555,67.24242837385863,120.02111507552485,0.6321719776996604,79967,80098,Kosciusko,Kosciusko,18,85,Indiana,IN
18087,18CS036,252,234,269,308,39,56,74,166.87333669758172,72,213.82433736728782,-98.43740471847272,-46.21493058696899,3.8710551229284533,1.2589520165640393,314,293,335,313,-22,-1,20,-2.694764752522308,32,78.96749993830664,-135.26033517895465,-82.3603854630522,-29.910496781242287,-347.8278991980435,40407,40523,LaGrange+Noble,LaGrange,18,87,Indiana,IN
18113,18CS036,395,375,415,437,22,42,62,105.98077619852302,47,118.88701517706578,-69.38702806285366,-11.895292111208542,40.725141575410085,1.0956289794169753,486,461,510,552,42,66,91,139.98355731064507,59,124.87036762682808,-36.51046740034244,13.636882073979717,68.51965932129966,0.878749922018842,47440,47249,LaGrange+Noble,Noble,18,113,Indiana,IN
18089,18CS037,4383,4170,4597,5247,650,864,1077,208.5870378429712,627,151.45201905831627,4.91384990738989,56.38765317792324,110.2860165785088,0.7252456209523018,5395,5138,5652,6032,380,637,894,127.76184341193522,617,123.7554255822723,-46.63773939930968,3.189883984523299,59.01561851014717,0.96712320772274,496791,498564,Lake,Lake,18,89,Indiana,IN
18091,18CS038,1061,1013,1109,1271,162,210,258,225.27948983893967,130,139.38278443916298,27.82631001528447,87.51396006390121,137.17085172527354,0.6157798060606727,1301,1243,1359,1366,7,65,123,57.49686914628781,107,95.22453411174199,-91.38816985814587,-38.32669284607887,13.700983054427027,1.6309252202891913,111922,112366,LaPorte,LaPorte,18,91,Indiana,IN
18093,18CS039,463,443,482,545,63,82,102,218.85926301338222,82,218.25440833980258,-49.95753723103555,-1.0505628606226873,51.96578265388966,0.9852542411658377,565,542,588,733,145,168,191,372.48530226240433,108,239.6644697423607,82.21177203311002,134.04364521578216,187.24708226721194,0.6396094051913318,45085,45063,Lawrence+Orange,Lawrence,18,93,Indiana,IN
18117,18CS039,203,195,212,264,52,61,69,367.81030524666994,35,211.99273167777102,107.62952780380094,156.65496451868333,207.12691386748872,0.5670267644464319,248,238,259,310,51,62,72,310.8400485350066,39,196.66179214361352,63.3332424328198,113.9937661091146,166.07202021370276,0.6225786278406907,19812,19831,Lawrence+Orange,Orange,18,117,Indiana,IN
18095,18CS040,1303,1247,1359,1558,199,255,311,235.51716053308374,227,209.46595409281403,-21.78985779712214,25.454017428698926,76.52337054498153,0.8859162015835598,1602,1534,1669,1950,281,348,416,266.59241787073137,261,199.72910305562573,17.131069778293842,67.73889408960224,120.66271674803035,0.7470483563427925,130045,130677,Madison,Madison,18,95,Indiana,IN
18097,18CS041,7153,6733,7572,8757,1185,1604,2024,197.59423461307358,1268,156.17494549888536,-3.007379426492524,41.03288178024944,93.17926584805029,0.7898897351959403,8768,8266,9270,10250,980,1482,1984,152.47044401070556,1003,103.19683845219146,-2.2168062754373863,48.52434262107412,100.83594209575871,0.6763753335825966,974292,971929,Marion,Marion,18,97,Indiana,IN
18099,18CS042,392,372,412,515,103,123,143,319.73111266158935,74,192.81294104874604,75.65069998703837,127.2295419408805,177.5050531457051,0.5981724863108535,483,459,507,541,34,58,82,125.26792981396677,71,153.99297271504793,-77.2227543653983,-29.304429225034678,21.176618794736342,1.2083865761785102,46055,46106,Marshall+Pulaski+Starke,Marshall,18,99,Indiana,IN
18131,18CS042,145,140,151,163,12,18,23,168.76637241420363,28,269.72786385164966,-154.04026672776183,-100.71922825634901,-47.06680793691238,1.511931637219254,176,170,183,211,28,35,41,280.0187649285147,33,266.9686918534099,-40.33478168945617,13.23614336062518,66.10520823212835,0.9266248066135856,12457,12361,Marshall+Pulaski+Starke,Pulaski,18,131,Indiana,IN
18149,18CS042,236,226,246,296,50,60,70,307.71457231867527,49,252.28472132835628,7.051967523942287,54.73282074149229,106.7728646062939,0.8063738048835778,290,278,302,374,72,84,96,359.4032755937135,42,179.7175866495507,127.28385552611128,180.36103890945654,232.43075738464668,0.4941609849408625,23307,23370,Marshall+Pulaski+Starke,Starke,18,149,Indiana,IN
18105,18CS043,801,741,861,1017,156,216,276,183.9883822922588,113,96.29519163169219,34.93971802674228,88.17249848682611,136.56649502727154,0.5209635576294934,988,916,1060,1162,102,174,246,124.423417551601,116,82.96203056721713,-8.96713546986906,40.571957988746874,92.25557982232034,0.6629611136348766,140817,139823,Monroe,Monroe,18,105,Indiana,IN
18109,18CS044,626,595,656,720,64,94,125,158.110325267226,93,155.7788944723618,-55.003594590912684,2.0542320713397655,53.85121762305779,0.9749259100345613,774,737,811,903,92,129,166,178.85120099089409,112,155.23861006001636,-32.247518429669455,23.18547927975432,74.1062379929282,0.8613014315242996,71640,72147,Morgan,Morgan,18,109,Indiana,IN
18127,18CS045,1337,1262,1411,1602,191,265,340,183.91897714887634,180,124.87642437171547,6.543611498817487,59.58430973520509,108.8058718930869,0.6764236732083606,1656,1566,1746,1902,156,246,336,141.50333367650856,192,110.28208088501371,-25.95571270814962,31.4852736623149,81.12779610147635,0.776209537018902,172971,174099,Porter,Porter,18,127,Indiana,IN
18141,18CS046,2343,2226,2461,2802,341,459,576,202.03927871563417,372,163.88326988241081,-15.198818642518397,38.73765576875985,89.2850010511245,0.8093807359279258,2874,2734,3015,3115,100,241,381,88.39470650059309,250,91.8236545079905,-53.811865430929565,-3.4541891689296773,48.1199561618286,1.034492838723563,272389,272261,St. Joseph,St. Joseph,18,141,Indiana,IN
18157,18CS047,1032,951,1112,1164,52,132,213,84.66994841422469,83,53.09394856923536,-18.359608057357235,29.66359463229124,78.65827943848095,0.6223675538472354,1277,1181,1374,1497,123,220,316,117.48687232140979,167,89.32630846995266,-23.528947276768225,28.13952084408993,79.74570057754161,0.7568630409356226,187592,186955,Tippecanoe,Tippecanoe,18,157,Indiana,IN
18163,18CS048,1697,1619,1774,2038,264,341,419,227.1727899833456,247,164.35165931963735,11.804398673549105,63.40848486188476,114.7015027128754,0.7213525773857902,2076,1983,2169,2334,165,258,351,143.3598714515157,219,121.65855609626024,-27.699806885439234,21.858553780011327,72.00546442883972,0.8453477846914401,180345,180012,Vanderburgh,Vanderburgh,18,163,Indiana,IN
18173,18CS049,529,502,557,661,104,132,159,247.26039483955464,85,159.72439711869714,34.665864396063675,88.38808568509201,137.09740873234168,0.6411042554899962,657,624,691,722,31,65,98,100.29847932373558,73,113.29422354657478,-63.5115836999687,-13.036841190227934,39.17508911736344,1.112358541344571,63860,64434,Warrick,Warrick,18,173,Indiana,IN
18177,18CS050,764,736,793,935,142,171,199,308.5605005898053,131,236.81831877071406,22.04578942498716,73.4689824840832,120.74111010869832,0.7630236032400006,934,900,969,1028,59,94,128,140.88983539624581,113,170.03731792464188,-84.35406330484479,-27.72086242388411,20.965819905710138,1.1941276520446993,66380,66456,Wayne,Wayne,18,177,Indiana,IN
19005,19CS001,158,152,164,169,5,11,17,92.2386087943618,27,231.51125401929258,-190.9019441484408,-138.7010867264695,-83.91734420060344,2.2964401922473123,192,185,199,169,-30,-23,-16,-165.5317139885511,20,143.40001434000143,-360.8444077939943,-310.0872862148852,-257.50081448693544,-0.905521993779557,13995,13947,Allamakee+Clayton+Winneshiek,Allamakee,19,5,Iowa,IA
19043,19CS001,165,158,172,197,25,32,39,224.52922222891704,43,302.3024195910715,-129.8223230031545,-76.82083592516945,-23.15392182044669,1.3055063824053355,201,193,210,223,13,22,30,127.09319132448687,16,94.12872102600306,-18.693200330861526,33.845801898670885,85.73713872776094,0.7078612207892518,17069,16998,Allamakee+Clayton+Winneshiek,Clayton,19,43,Iowa,IA
19191,19CS001,166,157,175,161,-14,-5,4,-29.57502847874185,22,131.9274399080506,-213.75412382436255,-160.80867345857226,-108.34569671162478,-5.595284253370821,203,192,213,202,-11,-1,10,-3.0599189750773954,16,80.35355564483729,-133.76561333283843,-84.19021831276639,-29.89437196309107,40.951200806169325,20011,19912,Allamakee+Clayton+Winneshiek,Winneshiek,19,191,Iowa,IA
19001,19CS002,90,89,91,98,7,8,9,126.08238588105931,16,258.44662807914926,-145.00255783177246,-132.4578616717917,-120.20071673317747,1.817035769826627,112,111,113,130,17,18,19,241.61418819009768,19,252.25703664365375,-23.090522764784872,-10.515531006652203,2.8619337852224307,0.9896668027346419,7429,7532,Audubon and Nearby Counties,Adair,19,1,Iowa,IA
19009,19CS002,73,72,73,68,-5,-5,-4,-104.75795438358026,4,85.09129586952666,-202.21889915896665,-189.71246230948208,-177.96357595680539,-1.019238940459467,89,88,90,82,-8,-7,-6,-126.27678632440092,4,70.92198581560284,-208.73776287827786,-197.19563590674602,-184.82931092115223,-0.653380100786636,5641,5640,Audubon and Nearby Counties,Audubon,19,9,Iowa,IA
19029,19CS002,172,166,177,205,28,33,39,306.5203201317911,41,376.80937428199434,-122.46536317656052,-71.0914123221707,-19.21624879389884,1.1935270602851613,209,202,215,203,-12,-6,1,-43.832322486772036,25,191.45351508653698,-289.8800187772759,-233.19650459811322,-184.9697544053591,-5.29254581911821,13057,13058,Audubon and Nearby Counties,Cass,19,29,Iowa,IA
19077,19CS002,104,103,105,133,28,29,30,324.4204370845765,20,225.8610954263128,85.92302836865834,98.80426237867877,110.74853552410363,0.6727793219679882,127,126,128,127,-1,-0,1,-0.14657568460303153,14,132.40022697181766,-146.79291194234028,-132.57206329490694,-119.21395984286424,14.220400752523174,10626,10574,Audubon and Nearby Counties,Guthrie,19,77,Iowa,IA
19165,19CS002,128,127,129,162,33,34,35,347.43251642397615,28,287.8190851464794,46.4223419630865,59.49296041393594,72.40543272281963,0.8046117285349865,158,156,159,150,-9,-8,-6,-67.8414188442169,13,110.54421768707483,-190.3984258776522,-178.57370728431772,-165.72343548138764,-1.862957718759174,11674,11760,Audubon and Nearby Counties,Shelby,19,165,Iowa,IA
19011,19CS003,212,201,223,267,44,55,66,257.6410017322549,41,192.54099322975776,10.118197518611693,65.38418079030028,113.45316932351008,0.7339448974948161,263,250,276,235,-41,-28,-15,-108.52670989380135,14,54.54262116253701,-213.86032083296624,-163.1482381786757,-111.57702177689444,-0.5212864356672628,25553,25668,Benton+Iowa (county)+Keokuk+Washington,Benton,19,11,Iowa,IA
19095,19CS003,171,164,179,195,16,24,31,170.42993837417987,22,159.13200723327307,-38.87636719106064,9.532683038925962,62.64114119461627,0.8956947583701579,210,201,219,214,-5,4,13,24.484056894696856,14,84.4187168355041,-111.35459420181427,-60.092643688032034,-8.931917739947716,2.7665600380442426,16590,16584,Benton+Iowa (county)+Keokuk+Washington,Iowa (county),19,95,Iowa,IA
19107,19CS003,100,99,101,128,27,28,29,337.7441510710408,26,311.53270094857714,13.881013597351792,26.10187240510232,38.706219216971824,0.8907903397535132,122,120,123,156,33,34,36,347.2272396979421,18,181.34193028410238,153.41730502158345,165.78591571318222,179.36222541036733,0.5075315452058322,10015,9926,Benton+Iowa (county)+Keokuk+Washington,Keokuk,19,107,Iowa,IA
19183,19CS003,217,207,226,263,37,46,56,247.42686162943318,32,171.130620794153,28.08804137657001,76.46040057371556,130.01371776365792,0.6770085185538964,267,255,278,265,-13,-2,10,-7.495893607541393,34,151.1514181559527,-209.55618192119496,-159.67318418909784,-109.34895380808932,-49.55355828743099,22439,22494,Benton+Iowa (county)+Keokuk+Washington,Washington,19,183,Iowa,IA
19013,19CS004,1050,994,1106,1302,196,252,308,230.84814305317892,239,219.04500045825313,-41.85479360541795,11.735343399165924,61.51169758175574,0.945118252892768,1289,1222,1357,1450,93,161,228,123.06157814592649,141,108.08159010248589,-36.00432324664588,15.352789692944718,65.86787436113619,0.8728356299427857,130932,130457,Black Hawk,Black Hawk,19,13,Iowa,IA
19015,19CS005,252,241,264,284,20,32,43,143.68609718937307,15,67.55995946402432,24.29488135030781,77.09183414549614,129.58357911438057,0.4559006436827839,308,294,322,334,12,26,40,96.518171422538,27,101.05546822366944,-57.575644109007555,-4.0102084206120985,46.30668822233251,1.007924336949255,26643,26718,Boone+Carroll+Greene,Boone,19,15,Iowa,IA
19027,19CS005,204,195,213,239,26,35,44,202.13705345946624,36,209.54598370197903,-55.257752531286904,-8.15548912774005,41.08324635435903,1.007637168032139,250,239,260,281,21,31,42,151.8588501595714,10,48.32552070748562,52.503333091394744,103.66847539388601,152.96470705205775,0.3084120763464237,20616,20693,Boone+Carroll+Greene,Carroll,19,27,Iowa,IA
19073,19CS005,99,98,100,85,-15,-14,-13,-189.8127982408395,4,54.77576172543648,-257.0183356263804,-244.58264488747864,-232.84954324886868,-0.31101588101764277,120,119,121,130,9,10,11,111.76360584489399,10,114.66574934067195,-15.451765621458962,-3.013691846321807,9.23296085733672,0.9305005366043297,8763,8721,Boone+Carroll+Greene,Greene,19,73,Iowa,IA
19017,19CS006,203,192,213,272,59,69,80,333.0589131746653,44,211.08179419525067,69.4693498146236,120.82517719774386,174.26723338313218,0.6247681040839214,251,238,264,254,-10,3,16,11.873401916809843,23,91.76142030720128,-133.02498840139845,-80.43080002605373,-26.096496406868553,5.784609040471777,25014,25065,Bremer+Butler+Grundy,Bremer,19,17,Iowa,IA
19023,19CS006,164,158,170,153,-17,-11,-5,-94.6098193602735,22,184.2674670203113,-331.54773756611803,-278.9492771955325,-230.3115789483901,-2.136830168315954,201,194,209,199,-10,-2,5,-17.143376441986245,21,146.55593551538837,-218.66388277498885,-163.35049475932865,-114.11913204958806,-14.418378963921066,14327,14329,Bremer+Butler+Grundy,Butler,19,23,Iowa,IA
19075,19CS006,124,123,126,142,16,18,19,171.48904978009503,26,253.5966837356742,-94.14222416659625,-81.54465067137683,-70.572926687686,1.3992099436295304,154,152,155,147,-8,-7,-5,-53.669863566040426,3,24.307243558580456,-90.55732570046489,-77.76703039763657,-66.23421620899975,-0.5334343718422443,12303,12342,Bremer+Butler+Grundy,Grundy,19,75,Iowa,IA
19019,19CS007,173,164,182,191,9,18,27,103.2921331609951,22,127.69044740024182,-72.8565458160847,-24.623717612673936,25.796511675706924,1.1704385251292853,212,202,223,223,-0,11,21,51.22632477698912,20,96.86637283866905,-98.26434332654706,-45.75593022944216,5.412696122425578,1.727608148226216,20675,20647,Buchanan+Delaware+Fayette,Buchanan,19,19,Iowa,IA
19055,19CS007,151,143,158,187,29,36,44,249.15434404811168,32,220.62625682275205,-23.50862480149199,27.96591707342364,78.37881959337305,0.8616566767719777,186,177,195,189,-6,3,12,19.220879058971686,23,131.4135527368301,-162.52208751227576,-111.83299495914929,-59.689321124860534,5.270347936274284,17405,17502,Buchanan+Delaware+Fayette,Delaware,19,55,Iowa,IA
19065,19CS007,210,201,218,250,32,40,49,248.8876599099108,26,160.74188562596598,36.37289668531279,88.096347057736,142.50216646425625,0.6301872440462905,254,244,264,273,9,19,29,96.36013449769476,30,155.60973079516572,-109.26601001295958,-58.96075662710101,-8.66381533939706,1.5323893216266515,19410,19279,Buchanan+Delaware+Fayette,Fayette,19,65,Iowa,IA
19031,19CS008,155,147,163,181,18,26,34,168.56986799026222,18,116.80095171145838,1.637603166558561,51.744758739593806,107.24092614661427,0.6672097901095054,189,179,198,213,15,24,34,130.87623796404804,5,27.14146129627619,52.123330326206734,102.44933827449331,154.2168875116536,0.19912369201384003,18493,18422,Cedar+Clinton+Jackson+Jones,Cedar,19,31,Iowa,IA
19045,19CS008,471,451,491,531,40,60,80,155.70367558898388,71,183.4506814805245,-80.67216373777575,-28.818756503917804,22.588026621317464,1.1589714625811354,574,550,598,611,13,37,61,79.62503839736358,47,101.17100051661788,-73.86928435963382,-21.97471902545447,27.045271277704504,1.2371478814070933,46443,46456,Cedar+Clinton+Jackson+Jones,Clinton,19,45,Iowa,IA
19097,19CS008,191,182,199,223,24,32,41,200.35382223595556,32,197.72411307347716,-49.35411359697929,4.707379051527006,53.39445383486513,0.9573501548994158,232,222,242,269,27,37,47,191.62406924983847,27,139.33326452678295,-2.071406568076775,52.21399270415349,104.26980004952216,0.7080497786640478,19421,19378,Cedar+Clinton+Jackson+Jones,Jackson,19,97,Iowa,IA
19105,19CS008,173,164,182,210,28,37,46,216.60319662529923,48,278.77262607685606,-113.54343918749885,-62.31496506713302,-7.923058334584699,1.2534122711051567,212,202,223,242,19,30,40,142.58931605924727,14,67.3659897988644,18.473457241194392,73.09588096207467,128.47933765100453,0.4570247893448579,20662,20782,Cedar+Clinton+Jackson+Jones,Jones,19,105,Iowa,IA
19033,19CS009,449,430,467,533,66,84,103,236.360845428885,67,187.55686192175799,-5.619036608630087,48.041533288001105,97.73448855353942,0.7842310747567881,548,526,570,601,31,53,75,124.91332367471212,63,147.38910724312183,-72.66303240877762,-22.64295714626341,27.04772074151276,1.158238315056008,42867,42744,Cerro Gordo+Hancock+Winnebago,Cerro Gordo,19,33,Iowa,IA
19081,19CS009,101,100,102,120,18,19,20,216.43884474768896,20,223.5885969815539,-19.191244906246215,-6.969154758501228,4.470809573279724,0.9822963352905145,123,122,124,154,30,31,32,290.4222008320204,16,149.85482813524396,127.32381167150878,140.62802241289114,152.88502738208092,0.49986912203525885,10734,10677,Cerro Gordo+Hancock+Winnebago,Hancock,19,81,Iowa,IA
19189,19CS009,111,110,112,137,25,26,27,297.7253732224942,24,271.49321266968326,14.311736861085707,26.361909623089495,38.256982361500356,0.8785119386392031,136,135,138,126,-12,-10,-9,-98.0909330709326,11,103.23791647114031,-213.61960227312963,-201.2455104990904,-188.09406207055332,-1.1638254789337383,10608,10655,Cerro Gordo+Hancock+Winnebago,Winnebago,19,189,Iowa,IA
19049,19CS010,481,438,524,557,33,76,119,91.07316982507403,63,75.7279802866845,-34.44825512305631,15.677593110444727,65.63990836839045,0.8206753196320797,617,564,670,585,-85,-32,21,-31.118400377516284,46,44.524890381655744,-128.14780362720273,-75.98415621940782,-22.616759688375982,-1.4767561954351685,99831,103313,Dallas,Dallas,19,49,Iowa,IA
19051,19CS011,81,80,82,91,9,10,11,135.75299460408462,20,263.8232384302517,-140.4205055906168,-127.93176810398512,-116.80971405845446,1.7712896201128354,100,99,101,82,-19,-18,-17,-195.15254401692886,2,21.89621195533173,-229.60133656658613,-217.2008710948435,-204.21348165101998,-0.11886907931428108,9097,9134,Davis+Jefferson+Van Buren+Wapello,Davis,19,51,Iowa,IA
19101,19CS011,137,130,143,178,35,41,48,310.3299520044168,25,187.20748829953197,70.55835090714419,124.66187230403472,174.3096360486375,0.5890394506751355,166,158,174,183,9,17,25,109.9501528032312,15,95.85277014505719,-35.03454615116287,13.823548397272036,64.57715498974157,0.8238997085760631,16025,15649,Davis+Jefferson+Van Buren+Wapello,Jefferson,19,101,Iowa,IA
19177,19CS011,81,81,82,80,-2,-1,-1,-24.153017236002192,13,217.11899791231733,-253.7146634676187,-241.51434961198618,-230.08798878747714,-29.137404596569272,101,100,102,91,-11,-10,-9,-135.25795698498598,4,55.27152134862512,-203.7571191674318,-190.58698147453453,-177.4081584615593,-0.45513411119551445,7185,7237,Davis+Jefferson+Van Buren+Wapello,Van Buren,19,177,Iowa,IA
19179,19CS011,358,343,373,456,83,98,113,332.9294231395907,95,322.90958531611153,-44.349974970009264,10.797938545446609,57.55402271085041,0.9601018431955379,439,420,457,469,12,30,49,85.9992872660045,60,170.12589316093909,-133.56334599300374,-84.28952203077279,-31.80251401514545,1.915083375320509,35304,35268,Davis+Jefferson+Van Buren+Wapello,Wapello,19,179,Iowa,IA
19057,19CS012,391,374,407,434,27,43,60,133.53255713648943,42,129.80323477902542,-50.36672383908599,2.2796723086232085,54.25215383808858,0.9500825625383491,475,456,495,549,54,74,93,190.78161349635857,63,163.46228691523314,-24.094625087001003,25.582963029736927,79.84703791659503,0.845306930937249,38828,38541,Des Moines+Henry+Lee,Des Moines,19,57,Iowa,IA
19087,19CS012,190,181,199,246,47,56,65,329.25298623491386,35,206.6420664206642,70.69826980937633,123.39546240878337,170.5641767341704,0.6165529543047537,234,223,244,250,6,16,27,79.60922726466328,23,112.79486047766171,-84.7622303410906,-33.66427341268441,17.042301311281378,1.3346395368051556,20325,20391,Des Moines+Henry+Lee,Henry,19,87,Iowa,IA
19111,19CS012,365,350,379,439,60,74,89,266.4458977346572,33,118.2089552238806,95.94063609212905,148.95180180391984,203.80796849550572,0.43776556797532024,443,426,460,509,49,66,83,198.52654529771374,75,225.50965181309758,-75.9628436386256,-26.892578188948125,25.15587458864364,1.1189694522996767,33500,33258,Des Moines+Henry+Lee,Lee,19,111,Iowa,IA
19061,19CS013,794,751,837,867,30,73,116,88.5050025593035,151,183.1894372889581,-149.40789547455498,-94.31009722359529,-41.51247750653345,2.0418319019208586,974,923,1025,1052,27,78,129,79.08252711853788,100,101.22174648001378,-70.42741248640168,-21.20026557328135,29.97587379673983,1.2637751328951834,98914,98793,Dubuque,Dubuque,19,61,Iowa,IA
19069,19CS014,103,102,104,135,31,32,33,378.9650846677989,18,216.12967780668401,151.45457035620976,162.86863994545757,174.79773622661097,0.5528005024724273,127,125,128,168,40,41,43,415.46675845639925,16,160.69097117605705,241.70829964340786,255.06522927920165,267.7821340139209,0.3776432804530628,9994,9957,Franklin+Hamilton+Hardin+Wright,Franklin,19,69,Iowa,IA
19079,19CS014,161,155,168,176,8,15,21,117.42929612845565,33,264.4583945505543,-200.5752647673918,-144.9358487051587,-94.21929066240845,2.1081925702312927,197,189,205,193,-12,-4,4,-27.992715905815686,22,147.59157386287401,-228.30063952636667,-174.9344569376417,-121.92681339994456,-6.934388196168863,14974,14906,Franklin+Hamilton+Hardin+Wright,Hamilton,19,79,Iowa,IA
19083,19CS014,188,181,195,215,20,27,34,194.43201128966862,28,199.9167013744273,-56.63692310218282,-5.894500079513063,49.17287857246359,0.9917885768764874,229,221,238,280,42,51,59,302.86748407293527,15,89.6914613728773,162.58591727432574,214.44028523032958,265.753887994773,0.2904075030890927,16807,16724,Franklin+Hamilton+Hardin+Wright,Hardin,19,83,Iowa,IA
19197,19CS014,159,153,164,161,-3,2,8,22.664076431352463,23,214.81942714819425,-241.91071053739557,-192.47948970585054,-140.00930121950014,6.712257258492758,193,187,200,189,-11,-4,2,-33.38492468681064,25,195.25148391127775,-281.00273288242306,-227.28896690831675,-173.043838956184,-7.634506824929306,12848,12804,Franklin+Hamilton+Hardin+Wright,Wright,19,197,Iowa,IA
19071,19CS015,77,76,77,70,-7,-7,-6,-120.32526399392208,5,90.73037955542114,-222.90678913621855,-210.54905207751312,-200.46566603737688,-0.8879536161695175,93,92,94,97,3,4,5,57.873224079527105,12,182.75967103259214,-137.07312787068392,-124.82741402796292,-112.53788487420671,2.500022972574766,6613,6566,Fremont+Harrison+Mills+Pottawattamie,Fremont,19,71,Iowa,IA
19085,19CS015,169,162,175,235,60,66,73,549.5711784978033,61,505.38525269262635,-9.734211530771056,43.37778330251377,96.57231401343752,0.9059418330736484,208,200,215,193,-22,-15,-7,-98.9942559691834,20,136.50945327963962,-286.1077720975815,-236.03240918642476,-184.48110845205102,-1.4810812119284629,14484,14651,Fremont+Harrison+Mills+Pottawattamie,Harrison,19,85,Iowa,IA
19129,19CS015,112,110,113,136,23,24,26,198.82146853090688,16,132.26784238082118,54.12733307411507,66.36293889337145,79.04603914332056,0.6387029142030606,137,135,139,156,17,19,21,131.15441914767888,15,103.76314333148866,14.511474108496094,27.581045459837455,39.907652681828694,0.7515149477205216,14516,14456,Fremont+Harrison+Mills+Pottawattamie,Mills,19,129,Iowa,IA
19155,19CS015,807,767,847,994,147,187,227,239.9338174594185,111,142.4431350322422,48.550168970068015,97.37729147169334,148.74597634023738,0.5905184232781068,987,939,1036,1141,105,154,202,164.53680818142976,117,125.34684650903677,-16.088510499994143,39.28073944812615,91.72315488625502,0.7568881571060087,93511,93341,Fremont+Harrison+Mills+Pottawattamie,Pottawattamie,19,155,Iowa,IA
19099,19CS016,337,321,354,388,34,51,67,161.2002027830003,58,184.5860075319578,-74.80538060554952,-24.54387653284204,29.17706043489425,1.1229039607007356,413,393,432,448,16,35,55,93.01043547489093,29,76.78051363516018,-37.5209255440635,16.678581450734836,70.08601035366819,0.8026561502001899,37706,37770,Jasper+Poweshiek,Jasper,19,99,Iowa,IA
19157,19CS016,185,177,193,194,1,9,17,55.00613535825341,25,161.2036539494895,-157.5308340349015,-104.61580681438355,-54.442056919560855,2.6231476468715687,226,216,236,245,9,19,29,101.73026791094699,25,134.45197375497472,-83.46435641279953,-34.728245212555635,17.58604341513031,1.255289412031321,18610,18594,Jasper+Poweshiek,Poweshiek,19,157,Iowa,IA
19103,19CS017,651,585,717,727,10,76,142,59.51116529601434,53,41.5431042366128,-33.452734683901504,18.649639917900696,65.86182361929045,0.6889975286935344,821,741,901,906,5,85,165,55.0385374264965,59,38.189926921309336,-35.73122085030075,15.734089889738838,69.32845883621926,0.6858105700199689,153094,154491,Johnson,Johnson,19,103,Iowa,IA
19113,19CS018,1565,1466,1664,1921,257,356,455,185.90834442901718,266,138.97354626356213,-8.39769845224009,47.64596800452427,94.21452129156499,0.7454430557741062,1922,1804,2040,2075,35,153,271,66.75722733465521,177,77.24804915943648,-62.02520598853706,-9.900838051922449,41.56931153768373,1.1496330549455205,229684,229132,Linn,Linn,19,113,Iowa,IA
19115,19CS019,93,92,94,111,17,18,19,202.55896966917499,30,332.19525698994187,-142.52704873446817,-129.52013593783565,-117.18074090442185,1.5549872288276723,113,112,114,122,8,9,10,82.89509824690865,20,185.9254438969973,-115.41163602674621,-103.10592845831422,-90.31501112208595,2.016733703014588,10837,10757,Louisa+Muscatine,Louisa,19,115,Iowa,IA
19139,19CS019,357,338,375,431,56,74,93,207.35627909148153,79,220.51639916259595,-64.03138571787109,-14.281666049017904,38.43227175649256,1.0493404253369962,436,414,458,486,28,50,72,117.90900833735637,45,105.26315789473684,-36.206267097482616,12.419965320503495,60.74295603807592,0.8753824753949548,42990,42750,Louisa+Muscatine,Muscatine,19,139,Iowa,IA
19007,19CS020,147,142,153,180,27,33,38,319.4664089762904,40,389.768574908648,-118.22434985391604,-70.05429855118419,-20.4378291219929,1.1839489593124157,178,172,184,188,4,10,16,81.94428233330167,16,130.4950656553299,-100.87644028402568,-47.74473543287517,1.6846631579931493,1.4483323121030502,12315,12261,Lucas and Nearby Counties,Appanoose,19,7,Iowa,IA
19039,19CS020,97,96,98,100,2,3,4,33.311093352128054,4,49.57653377401363,-29.03583742684279,-15.28029219778205,-4.169328212935013,1.0847016249518358,120,119,121,159,38,39,40,396.4449654489666,22,225.04091653027825,158.52901514039405,171.10744239187403,184.32544445359824,0.5533691907765103,9682,9776,Lucas and Nearby Counties,Clarke,19,39,Iowa,IA
19053,19CS020,70,70,71,76,5,6,6,87.28445781109467,2,31.372549019607845,42.98215300982978,55.98808071376331,68.23405735496763,0.30467442847583376,86,85,87,99,12,13,14,166.5309227662677,15,196.02718243596442,-43.670751419508555,-29.345786011361216,-16.60102656505136,1.0914690176844075,7650,7652,Lucas and Nearby Counties,Decatur,19,53,Iowa,IA
19117,19CS020,95,94,96,98,2,3,4,39.76737752239149,11,153.18556342114425,-125.31370867537206,-113.57447153429132,-101.11713869672167,2.8529715156922477,117,116,119,125,6,8,9,86.99700942890938,12,137.9944802207912,-64.02517552529768,-50.7757686374671,-38.51859183870088,1.401008268767955,8617,8696,Lucas and Nearby Counties,Lucas,19,117,Iowa,IA
19135,19CS020,84,84,85,101,16,17,17,263.5270753476985,16,252.66482431898936,-1.126155453125485,10.947544105265676,23.11686873838399,0.9045756351892824,103,102,104,109,5,6,7,76.20028472845208,17,223.50775703392057,-161.07355477666303,-147.39590187354446,-135.07652458117303,2.501547407030945,7599,7606,Lucas and Nearby Counties,Monroe,19,135,Iowa,IA
19185,19CS020,74,73,75,94,19,20,21,370.4159543331822,17,314.08775981524246,42.91828145500882,56.60789879095127,68.28419595548068,0.8076483911825456,91,90,91,86,-5,-5,-4,-70.9189897804604,7,107.55992624462202,-191.27064632314875,-178.22614106497065,-166.07576106072779,-1.9361577672319572,6495,6508,Lucas and Nearby Counties,Wayne,19,185,Iowa,IA
19119,19CS021,95,93,96,112,16,17,19,175.2738788789215,35,352.6152296196793,-189.17174911696944,-177.28280200523818,-166.1196771327697,1.9024434505708405,117,115,118,94,-24,-23,-21,-188.47491097615298,3,25.006251562890725,-226.47482181944173,-213.47485936112597,-200.271534903677,-0.13881604215146268,11911,11997,Lyon+O'Brien+Osceola+Sioux,Lyon,19,119,Iowa,IA
19141,19CS021,172,166,178,220,42,48,54,412.4416256545151,50,425.92461134379215,-60.70807437137001,-14.296986214716327,37.97986282522379,1.0117932631893645,207,200,214,183,-31,-24,-17,-172.75857803013446,11,78.37548984681155,-298.2635023602951,-250.2448619471399,-203.37717373889492,-0.473186124761814,14087,14035,Lyon+O'Brien+Osceola+Sioux,O'Brien,19,141,Iowa,IA
19143,19CS021,61,61,62,71,9,10,10,188.73217238390433,10,195.02681618722573,-19.37813638799845,-6.361662486328525,5.222194257470839,0.9365714357538121,75,74,76,91,15,16,17,258.29043742109576,4,64.9034561090378,181.1540412362786,193.14508189969226,207.1628571625433,0.23642842252574975,6153,6163,Lyon+O'Brien+Osceola+Sioux,Osceola,19,143,Iowa,IA
19167,19CS021,213,198,229,279,50,66,81,221.18775712289784,63,211.5454570892912,-41.16650456711218,9.794417613810507,59.470912671305946,0.9421045739222957,263,244,281,257,-24,-6,13,-15.341749573439433,13,36.22178879910838,-105.27112975061763,-51.75472330083341,-2.266348286727163,-2.8849436182812913,35737,35890,Lyon+O'Brien+Osceola+Sioux,Sioux,19,167,Iowa,IA
19121,19CS022,143,136,150,122,-28,-21,-14,-154.009488456382,10,72.33273056057865,-278.49493224065714,-226.87413409277602,-177.6154485500819,-0.4928096174390045,177,168,186,180,-6,3,12,18.748502398174228,15,89.54154727793697,-120.44047115346021,-69.18166865919238,-21.636494844424206,3.6225329183162436,16590,16752,Madison+Warren,Madison,19,121,Iowa,IA
19181,19CS022,381,359,404,423,19,42,64,95.6543531158712,48,109.7330971023604,-61.99022132723157,-14.073998978738834,36.756887160782526,1.1204061925018358,475,447,502,534,32,59,87,111.47208578943648,62,116.37291889558345,-60.898015174141705,-4.239958858611428,47.543154103526376,1.0266773303677927,52491,53277,Madison+Warren,Warren,19,181,Iowa,IA
19123,19CS023,205,195,214,250,36,45,55,245.87497826954768,38,205.664802453545,-9.07045521931217,41.24727855391745,92.4296280595874,0.8184451668857279,250,239,261,274,13,24,35,109.4099526335682,34,154.4892766266812,-95.07985486445837,-45.38118642768132,8.426833211847562,1.3557190526936014,22172,22008,Mahaska+Marion,Mahaska,19,123,Iowa,IA
19125,19CS023,297,283,311,329,18,32,46,114.81166054044604,51,183.43674130024277,-121.73210760919628,-67.97701264527788,-18.59737475636025,1.549186115975723,366,348,383,371,-12,5,23,15.798974791007867,45,134.81126423007788,-170.82983464125542,-119.63564557637535,-66.75651958846862,7.172803271761332,33363,33380,Mahaska+Marion,Marion,19,125,Iowa,IA
19127,19CS024,409,392,426,467,41,58,75,173.81145218322922,60,180.21625951141368,-57.19710175500773,-7.194096838859136,44.329335381077236,1.019235935390108,499,479,520,531,11,32,52,79.20901725550142,26,65.19068274703507,-33.97550166702216,13.563470229773813,63.59015447084123,0.7977679103861287,39952,39883,Marshall+Tama,Marshall,19,127,Iowa,IA
19171,19CS024,178,171,185,222,37,44,51,309.6101827298993,56,394.6904733936333,-134.42432787677834,-85.47658516164653,-33.37462611626811,1.2464241881870128,216,207,225,216,-9,-0,9,-0.6035986896889483,20,118.36420666390484,-166.6448776114571,-118.09250878535305,-69.77146107720093,22.271468661031747,17026,16897,Marshall+Tama,Tama,19,171,Iowa,IA
19037,19CS025,115,114,116,133,17,18,19,179.6256064913538,11,110.39558417663292,58.1111428159979,68.91757361061325,81.13077776389684,0.5820661768200489,141,139,142,146,4,5,7,44.811147569149895,13,109.25287839314228,-77.3557140429451,-64.4792666915991,-52.16057109935667,2.0530383671309886,11957,11899,Mitchell and Nearby Counties,Chickasaw,19,37,Iowa,IA
19067,19CS025,154,147,161,202,41,48,55,369.09720904421835,30,231.46659808397095,85.51979819814274,138.53230061317547,192.82521950701602,0.6142748368254118,188,180,196,199,3,11,19,72.06106023485762,17,110.15356703168536,-92.64702598344357,-37.64760872271313,15.851445735795691,1.4025033202179742,15553,15433,Mitchell and Nearby Counties,Floyd,19,67,Iowa,IA
19089,19CS025,102,101,103,99,-4,-3,-2,-36.48030805169808,15,190.7587961000424,-240.14443342129118,-227.3218777890886,-214.6577626340695,-8.027536706612127,126,124,127,134,7,8,10,89.20100621038063,7,73.84745226289694,1.4232528949643988,15.470256554489843,27.752028540842076,0.7403205693587799,9436,9479,Mitchell and Nearby Counties,Howard,19,89,Iowa,IA
19131,19CS025,117,116,118,129,11,12,13,138.2753098147751,37,419.77876524534366,-293.0904667970452,-281.64195760892466,-270.2413048830765,2.8056199187127278,143,142,144,150,6,7,8,65.91258678128352,2,18.941187612463303,33.805189635783435,46.710676279855136,59.59443403765411,0.25126543434279436,10577,10559,Mitchell and Nearby Counties,Mitchell,19,131,Iowa,IA
19195,19CS025,72,71,73,59,-14,-13,-12,-210.6006649806636,5,80.88433540037745,-303.0523070103786,-291.6760946775194,-279.3998273954297,-0.4160207560688371,88,87,89,99,10,11,12,147.30097513778415,6,81.17981328642944,54.04907287605992,66.72470475128407,79.13504252538421,0.5047524515985677,7418,7391,Mitchell and Nearby Counties,Worth,19,195,Iowa,IA
19041,19CS026,165,158,172,187,15,22,29,161.11261071084485,16,117.7264087313753,-6.35683881967284,42.811602758983184,97.25716439805096,0.6987953431927046,203,194,211,198,-13,-5,4,-27.550432862943847,20,121.77301509985388,-202.79340398968145,-148.91354338948744,-94.10914541587564,-5.6739470416456905,16309,16424,Palo Alto and Nearby Counties,Clay,19,41,Iowa,IA
19059,19CS026,179,172,187,197,10,18,25,119.5481368940939,28,189.9270815668984,-120.55820572391653,-71.64407286838737,-20.91729737481252,1.5034054214788735,220,211,229,217,-12,-3,6,-17.539607959599067,27,151.37923301188607,-220.57253592400656,-168.43924239160222,-116.40512751557021,-12.685797150156171,17691,17836,Palo Alto and Nearby Counties,Dickinson,19,59,Iowa,IA
19063,19CS026,104,103,105,132,27,28,29,356.5137196979271,32,412.2383252818035,-67.5312503820278,-55.81060874924817,-43.83915796647776,1.1159788912393387,128,127,129,131,2,3,4,32.10243800780156,14,150.16625549715755,-130.26993718793415,-117.48858403842775,-106.2608566549262,3.5062145062193055,9315,9323,Palo Alto and Nearby Counties,Emmet,19,63,Iowa,IA
19109,19CS026,152,146,159,175,16,23,29,183.38310566677652,44,357.796300060988,-222.7526265009695,-173.47655750585707,-123.61447242120974,1.8682432155706612,184,176,191,219,28,35,43,243.6583320144289,30,205.95908279555127,-14.205680459846107,36.950933441442324,89.11648513430406,0.8221143804700042,14757,14566,Palo Alto and Nearby Counties,Kossuth,19,109,Iowa,IA
19147,19CS026,109,108,110,119,9,10,11,137.05332592364473,11,147.6179825542384,-22.41540760024161,-10.430985287532366,1.546106473586655,0.9810254513367629,133,132,134,139,5,6,7,68.8031350688804,22,246.80278214045322,-189.8932418497409,-178.2315636442792,-166.1276179770115,3.0842080799164515,8942,8914,Palo Alto and Nearby Counties,Palo Alto,19,147,Iowa,IA
19021,19CS027,166,157,175,175,-0,9,18,51.5075704525116,31,180.43362273851676,-180.3558729671789,-127.80845878720525,-75.77377594981314,3.14739030827727,205,195,216,184,-32,-21,-11,-102.6954487738566,14,67.39842095128057,-226.1822319565815,-168.90793625786725,-116.86311013296485,-0.6885731756849681,20617,20772,Pocahontas and Nearby Counties,Buena Vista,19,21,Iowa,IA
19025,19CS027,116,115,117,111,-6,-5,-4,-66.6802751394701,4,48.73096446700507,-127.18352622533753,-115.52610975790701,-103.13119183534094,-0.8941865965291237,143,142,145,145,0,2,3,16.208593596417526,10,100.8979921299566,-97.47574117655621,-84.65115631098735,-71.62488677881088,3.836660014213546,9850,9911,Pocahontas and Nearby Counties,Calhoun,19,25,Iowa,IA
19091,19CS027,98,97,99,106,7,8,9,101.7835225681716,20,250.39123630672924,-160.43178446306646,-148.311573401503,-136.58723732172345,2.190590373455017,120,119,122,129,7,9,10,89.32447457538268,10,103.8637307852098,-27.43562586132832,-14.820348894284445,-1.1049303161305593,1.041649261128747,9585,9628,Pocahontas and Nearby Counties,Humboldt,19,91,Iowa,IA
19151,19CS027,84,84,85,95,10,11,11,180.6495455860052,15,256.77603423680455,-88.32524385697899,-76.07135837218104,-63.87025149430083,1.2983703224123746,104,103,105,112,7,8,9,109.5027933595578,10,141.3627367825841,-44.19272778346143,-31.983367039944696,-20.184811677904687,1.143350076714401,7010,7074,Pocahontas and Nearby Counties,Pocahontas,19,151,Iowa,IA
19161,19CS027,115,114,116,128,12,13,14,155.25977949780548,15,184.23746161719546,-40.61984934688888,-28.931718932108474,-16.33138266541442,1.0996475933314847,141,140,142,151,9,10,11,102.7962751540176,12,122.97601967616313,-33.10244958331458,-20.3150239047791,-8.193960075155855,1.0878571048810406,9770,9758,Pocahontas and Nearby Counties,Sac,19,161,Iowa,IA
19187,19CS027,374,358,390,469,79,95,111,309.5977124549122,68,221.54648132059077,37.743642142793284,87.58662729481156,135.56948571475712,0.7081425930887868,461,441,480,510,30,49,69,133.18372995175437,47,126.61979040383632,-43.190691800654626,7.385251974772409,57.01815896624745,0.9318653980353887,36832,37119,Pocahontas and Nearby Counties,Webster,19,187,Iowa,IA
19153,19CS028,3158,2946,3370,3754,384,596,808,145.14997136815262,437,106.38211547044266,-15.352650434373759,38.657218945589946,91.32240161035283,0.7316845819848339,3925,3669,4181,4348,167,423,679,85.21502072615324,380,76.57430730478589,-43.15151982580411,7.987112475260222,58.728117055765345,0.8964811080125785,492940,496250,Polk,Polk,19,153,Iowa,IA
19163,19CS029,1322,1247,1397,1594,197,272,347,186.97164151278437,178,122.55014458163126,12.07365282628736,64.17230157756414,116.34983008345857,0.6530430706788527,1625,1535,1715,1826,111,201,291,115.18610459463633,133,76.34201221472195,-10.683058143198531,39.57904999080149,90.31634460551192,0.659484650791272,174296,174216,Scott,Scott,19,163,Iowa,IA
19169,19CS030,481,438,523,477,-46,-4,39,-4.568850290411265,35,42.62531334679752,-98.4713251484776,-47.30856049586123,0.9985347476718549,-12.72023706142491,604,553,655,628,-27,24,75,24.266150245482255,26,26.17089595055714,-57.49258888714762,-1.6357023723171464,52.58870748244301,1.035539216647796,98533,99347,Story,Story,19,169,Iowa,IA
19003,19CS031,37,37,38,40,2,3,3,86.38692321453124,5,163.17650258362798,-89.01361976676557,-77.0323883907741,-64.70245095575798,1.3709750790076662,45,45,46,62,16,17,17,455.5264778095385,6,164.4286105782406,278.5658745198793,290.8884313228484,303.7668253721871,0.34048037243128043,3677,3649,Taylor and Nearby Counties,Adams,19,3,Iowa,IA
19137,19CS031,141,136,145,169,24,28,33,330.38736902544287,30,350.4331743405042,-72.64947432719849,-20.673956813786212,28.355071711742255,1.0244532896745373,172,167,178,159,-19,-13,-8,-127.85986915122376,15,145.29252227818674,-322.09652910640386,-274.54020400087813,-220.6493634774578,-1.2294827110390028,10273,10324,Taylor and Nearby Counties,Montgomery,19,137,Iowa,IA
19145,19CS031,177,170,183,189,6,12,19,96.33581485901468,15,118.62396204033215,-74.286381394178,-21.619205028648626,32.175741545457456,1.1379443627295125,217,209,225,219,-6,2,10,15.112357581998442,18,118.46001974333662,-154.0489464576847,-101.6120392272558,-51.89340276771496,5.46063035974783,15174,15195,Taylor and Nearby Counties,Page,19,145,Iowa,IA
19159,19CS031,64,64,65,93,28,29,29,736.2722450741668,8,205.4794520547945,519.0078423631832,531.1830613268105,542.157771000553,0.2696732288510004,78,77,79,87,8,9,10,192.52774837069305,16,344.90191851692174,-164.59874445792966,-152.19910526568881,-138.4428693428962,1.6110579397068894,4672,4639,Taylor and Nearby Counties,Ringgold,19,159,Iowa,IA
19173,19CS031,62,62,63,79,16,17,17,342.6142014604882,5,101.5400236926722,228.9138338476704,241.00649270228652,253.09089409426377,0.27978454323896823,75,75,76,105,29,30,30,502.8746268127222,11,187.48934719618205,303.36675383335347,315.4931652350746,327.3896841688435,0.36061253094287066,5909,5867,Taylor and Nearby Counties,Taylor,19,173,Iowa,IA
19175,19CS031,129,124,135,151,16,22,27,213.93130639489252,23,227.96729164945899,-67.05908552868085,-13.742810212428148,38.28562571661336,1.0184252588168576,158,152,164,172,8,14,20,117.83630188523314,13,108.06317539484621,-42.73679292487949,9.750898310903054,63.39135034179764,0.8566322412491808,12107,12030,Taylor and Nearby Counties,Union,19,175,Iowa,IA
19035,19CS032,151,146,156,152,-4,1,6,11.153467451168472,25,259.51557093425606,-299.93528459584246,-247.34899580233295,-199.43806310715712,12.051383060856784,182,176,188,172,-16,-10,-4,-90.6568059164016,17,147.5438291963201,-287.7547187409267,-238.3112737304811,-185.94482708009406,-1.7998031947139297,11560,11522,West Central Iowa,Cherokee,19,35,Iowa,IA
19047,19CS032,149,142,156,169,13,20,27,145.63026036732677,23,167.35386854232357,-75.40137500327596,-22.121231119826234,29.937618102287136,1.0944848750998208,180,171,188,158,-30,-22,-13,-132.56224163424923,20,123.22099685786458,-306.48037604143224,-255.26469744125336,-200.78069057717266,-0.9748404671789739,16492,16231,West Central Iowa,Crawford,19,47,Iowa,IA
19093,19CS032,88,87,88,117,29,29,30,507.0268054880246,31,533.3333333333334,-38.6938654826505,-26.535754024003044,-15.054950203713123,1.0173630039425006,107,106,108,96,-12,-11,-10,-159.80025874947134,6,86.16975441619991,-258.1114524327753,-245.90832837792058,-233.6907547538336,-0.5924818779631827,6975,6963,West Central Iowa,Ida,19,93,Iowa,IA
19133,19CS032,118,117,119,154,35,36,37,490.86590375691344,17,234.26734037666512,244.9068779962036,256.53471797084137,269.26525216045377,0.464220829274888,143,142,144,157,13,14,15,160.32376761563597,22,255.87345894394045,-108.89041158000502,-95.64540694980957,-82.65937465627654,1.488031068809452,8708,8598,West Central Iowa,Monona,19,133,Iowa,IA
19149,19CS032,210,199,221,262,41,52,63,242.23897840561176,64,299.90627928772255,-111.50703978698986,-56.623763314045604,-5.732610742889679,1.2145641885599323,258,244,271,250,-21,-8,6,-29.585364410036284,19,74.05963749756383,-161.66631402915274,-103.74788300731548,-49.343225975167094,-2.883101505631603,25608,25655,West Central Iowa,Plymouth,19,149,Iowa,IA
19193,19CS032,851,806,896,1064,168,213,258,242.52751016760863,175,199.21641543263163,-12.914864174131091,42.797597353307715,97.8359736503411,0.8175802353406435,1043,988,1097,1084,-13,41,96,39.21367539141678,91,86.14242845918648,-95.85475262654623,-47.694732501376905,4.642187295755615,2.1449650063631087,105413,105639,West Central Iowa,Woodbury,19,193,Iowa,IA
20001,20CS001,143,137,148,129,-19,-14,-8,-132.41919376134823,4,38.36930455635492,-222.53467205300393,-171.12827411814706,-118.48468186154503,-0.31238527285703876,173,166,179,199,20,26,33,210.9984781937402,27,216.43286573146295,-59.60772709151153,-4.922314764063254,47.135817396820364,0.9882124498355571,12510,12475,Allen+Anderson+Franklin+Osage,Allen,20,1,Kansas,KS
20003,20CS001,88,87,89,90,1,2,3,33.594562741453004,5,76.43312101910827,-53.816848296746244,-43.026124675173065,-30.036973626075707,1.563651085328178,106,106,107,103,-4,-3,-3,-44.93501887799791,21,269.6456086286595,-326.8996145173899,-315.02582224848294,-301.56302470056295,-8.40154833741198,7850,7788,Allen+Anderson+Franklin+Osage,Anderson,20,3,Kansas,KS
20059,20CS001,232,220,243,269,26,37,49,172.81612318814015,21,97.05746418117393,23.23287557224076,75.29187460402376,128.98447418296868,0.5469939637731599,282,268,295,338,43,56,70,215.84573738319193,40,153.8935056940597,11.17271443269638,61.547422388547304,116.84083028749704,0.7004932025106696,25964,25992,Allen+Anderson+Franklin+Osage,Franklin,20,59,Kansas,KS
20139,20CS001,164,157,170,230,60,66,73,505.6132213395076,23,175.1824817518248,278.2974342836744,331.3261102856175,381.7427706806901,0.34133338389615075,199,191,207,232,25,33,41,209.8838364780383,23,145.92056845577972,12.378039407817893,62.5346612639605,115.38612466332341,0.6748451976613137,15755,15762,Allen+Anderson+Franklin+Osage,Osage,20,139,Kansas,KS
20011,20CS002,163,157,169,181,12,18,24,150.96951560696456,17,142.10086375034828,-43.82127261937908,10.496632811893516,62.710775391941944,0.8918740960051428,197,190,204,213,9,16,23,112.32468697553377,34,237.36386484222285,-172.7259454519063,-125.1144451170811,-73.801526888222,1.989538752174609,14356,14324,Bourbon+Linn+Miami,Bourbon,20,11,Kansas,KS
20107,20CS002,93,92,94,122,28,29,30,356.1521594327897,5,62.383031815346214,281.84139746751106,294.18727323076826,305.87121911948634,0.16922996142382715,115,114,117,166,49,51,52,519.5765332664832,24,246.8373958654736,260.4648046852376,272.8102432053927,285.8198332544548,0.4658527387172397,9618,9723,Bourbon+Linn+Miami,Linn,20,107,Kansas,KS
20121,20CS002,254,240,269,292,23,38,52,131.507263450047,23,80.6192493062655,3.690582615305192,52.69164869165192,100.6096787753573,0.5971245642872263,312,294,330,419,89,107,125,309.85643465410544,61,176.64263168563403,80.36696486506658,133.10280459964414,184.9974941165078,0.5648005767199342,34235,34533,Bourbon+Linn+Miami,Miami,20,121,Kansas,KS
20005,20CS003,155,148,162,146,-16,-9,-2,-68.24681686864993,3,22.12117488017697,-143.29919888978696,-90.34280285808248,-40.37832640879629,-0.3633982468542072,189,181,198,218,20,29,37,175.70915818427915,26,160.0098467598006,-35.408821676006156,15.245032571327416,65.11932760154735,0.879835424084864,16274,16249,Brown and Nearby Counties,Atchison,20,5,Kansas,KS
20013,20CS003,111,110,111,147,36,36,37,461.8201950359964,31,392.3636747178567,57.89252256201618,69.43940447888654,82.13594380242152,0.8269391395965993,136,134,137,157,20,21,23,225.65322805168947,11,116.30365827870585,96.13877533670623,109.43449890517957,121.73179175219704,0.49234003258053594,9481,9458,Brown and Nearby Counties,Brown,20,13,Kansas,KS
20043,20CS003,76,75,77,92,15,16,17,260.4501428564955,10,160.29922522041144,88.24053042032426,99.88239666037177,112.17223022955177,0.5797858337487777,93,92,94,111,17,18,19,238.35894697091868,17,227.54651318431266,-1.6758378815588553,10.833289563648357,22.813221718442854,0.9038804526070239,7486,7471,Brown and Nearby Counties,Doniphan,20,43,Kansas,KS
20085,20CS003,123,121,124,125,1,2,4,22.300405785307106,12,108.89292196007258,-98.4696266744553,-86.62774095264214,-74.3061571522558,3.470711099574442,152,150,153,157,4,5,7,40.55642441528107,14,105.61255280627641,-77.60716988173019,-65.15448764364639,-52.556463105527264,2.195679034604354,13224,13256,Brown and Nearby Counties,Jackson,20,85,Kansas,KS
20087,20CS003,158,151,166,180,14,22,29,139.94230573907515,23,149.6908558411975,-64.58608144892486,-10.189919508306836,44.10183949782183,1.0221252213208498,194,185,204,204,0,10,19,53.01228264756081,27,146.77901603696657,-147.11314866495144,-93.22666911023832,-40.8296109491484,2.5112519449908146,18438,18395,Brown and Nearby Counties,Jefferson,20,87,Kansas,KS
20117,20CS003,118,117,119,123,4,5,6,65.23949507347238,24,289.0695573622403,-235.40457505214968,-224.31204995851675,-211.6863460362408,3.7403516002978785,145,144,146,132,-14,-13,-12,-129.98098520167343,14,140.22435897435898,-283.6029222043246,-269.9686217768677,-257.5628297059724,-1.16887764133717,9963,9984,Brown and Nearby Counties,Marshall,20,117,Kansas,KS
20131,20CS003,114,112,115,158,43,44,46,522.8311707644052,42,493.5853491332876,16.563268922292945,29.29117764422914,41.009101736714385,0.9233087505706131,140,139,141,123,-18,-17,-16,-164.81929731595434,7,68.51996867658575,-246.40932433164573,-233.37661804886034,-220.35919852787322,-0.441976687567175,10211,10216,Brown and Nearby Counties,Nemaha,20,131,Kansas,KS
20015,20CS004,562,533,591,638,47,76,105,134.76978078994958,38,67.6728551711856,16.698630779752428,65.44780816354782,123.24168775841662,0.49558795546583007,695,660,730,790,60,95,130,139.82954535582658,101,148.92801321183165,-66.28944755881638,-8.966694170914716,41.62598870753667,1.0539540901024969,67383,67818,Butler+Harvey,Butler,20,15,Kansas,KS
20079,20CS004,344,330,359,380,21,36,50,126.2519059021649,40,141.16816657843654,-69.95731964473383,-15.023684256908465,35.030582651904346,1.0877404770691588,420,402,437,512,75,92,110,272.8799791996562,61,180.28668538495643,44.136263915992906,93.79698476740933,145.95991721433,0.6536021878219295,34002,33835,Butler+Harvey,Harvey,20,79,Kansas,KS
20009,20CS005,241,230,252,306,54,65,76,307.18938605428855,36,169.58467457014996,87.11074402136241,136.88393754429856,188.29351803657428,0.5437147666458105,291,278,304,368,64,77,90,304.2293683822774,50,198.05117642398795,53.96332234288091,104.73487753873009,159.3033763195851,0.6426260572112116,25474,25246,Central Kansas,Barton,20,9,Kansas,KS
20051,20CS005,207,194,219,259,40,52,65,217.43966974064705,57,236.8749134229118,-74.68886449512075,-17.518932444978418,32.96460454224687,1.0689524489993651,252,238,267,235,-32,-17,-3,-60.342406829844414,18,62.47613758633855,-173.76648932650062,-122.78703031039142,-67.12581986138241,-1.098548944098246,28876,28811,Central Kansas,Ellis,20,51,Kansas,KS
20053,20CS005,72,71,73,92,19,20,21,378.0261523603253,17,323.09154260373776,42.648774104721106,54.95418948817198,66.93277082803519,0.8137679562347273,89,88,89,83,-6,-6,-5,-87.09482131686472,8,126.20287111531788,-225.79749417539716,-213.1357830853081,-201.03345975857474,-1.769543218917252,6314,6339,Central Kansas,Ellsworth,20,53,Kansas,KS
20113,20CS005,324,311,337,356,19,32,45,128.64538197170936,48,192.455477964516,-115.22691314029301,-63.0389501207195,-14.190641175593978,1.4507984243208283,396,380,411,422,11,26,42,87.65464060543175,46,152.58060236168237,-118.86445590616178,-64.67894704837822,-14.758507253922513,1.6772331718582671,29929,30148,Central Kansas,McPherson,20,113,Kansas,KS
20159,20CS005,100,99,101,107,6,7,8,88.12936918472509,10,127.71392081736909,-51.469903383193774,-39.91671663481283,-27.668207089393515,1.26573793115493,122,121,124,145,21,23,24,241.30835838985968,15,159.77844056242012,68.62474165430349,81.41303011482982,94.33305859814315,0.6341414479262153,9396,9388,Central Kansas,Rice,20,159,Kansas,KS
20167,20CS005,75,74,76,120,44,45,46,807.6547737156156,19,340.09546539379477,455.3609260209923,467.31237275288953,478.38337290243874,0.41196002317680774,92,91,92,85,-7,-7,-6,-97.08335852398253,13,194.08778739922366,-304.62547989050404,-290.86331392664914,-278.3300631435968,-2.3625009225248754,6704,6698,Central Kansas,Russell,20,167,Kansas,KS
20017,20CS006,28,28,28,21,-7,-7,-7,-336.3341088239271,1,46.67444574095683,-395.0728184592178,-383.2728100663448,-370.0816035147052,-0.16113546927515193,35,35,35,32,-3,-3,-3,-109.46425385984939,5,192.82684149633627,-314.7020363839444,-302.4742362151331,-289.662497526529,-2.719744322801356,2571,2593,Chase+Coffey+Lyon+Marion,Chase,20,17,Kansas,KS
20031,20CS006,86,85,87,89,2,3,4,40.97889078441963,8,115.20460818432737,-87.25346149317929,-74.19332507688114,-63.01600583909379,2.080276586715121,106,105,107,111,4,5,6,64.09763808123489,15,179.79144192736425,-128.29273148372673,-115.27960711370125,-102.84501925856034,2.3630733138277193,8333,8343,Chase+Coffey+Lyon+Marion,Coffey,20,31,Kansas,KS
20111,20CS006,240,226,253,323,70,83,97,310.27921718371243,68,252.9997209561901,4.440036537470942,56.250388774202676,104.77404038735324,0.8057321052316374,294,277,310,320,10,26,43,82.75973778375696,30,93.71192952862899,-64.8216907720177,-11.186372989505669,42.48431571419823,1.0911521259315646,32253,32013,Chase+Coffey+Lyon+Marion,Lyon,20,111,Kansas,KS
20115,20CS006,148,143,153,133,-20,-15,-10,-150.25246964522034,10,102.03214012413909,-300.3003558256515,-252.50632057416317,-197.1897293842681,-0.7285446799635694,179,173,186,222,36,43,49,363.03669895779194,29,247.4825055470217,66.86447705952438,116.71324911742232,166.14420571195447,0.6660444068879747,11761,11718,Chase+Coffey+Lyon+Marion,Marion,20,115,Kansas,KS
20021,20CS007,228,220,236,271,35,43,51,266.4316157163205,26,161.17367496642214,52.89070103609858,105.88294039534338,155.56953437533116,0.5911796880678921,278,268,288,312,24,34,44,179.1260334590154,43,224.53135606495746,-97.48189902061819,-44.75243911625409,1.5960222037521452,1.2179775755796873,19358,19151,Cherokee+Crawford,Cherokee,20,21,Kansas,KS
20037,20CS007,379,362,396,484,88,105,122,323.65044592190594,53,163.4121274409044,109.98957927850718,159.54229561824476,213.20912837898027,0.5001385857567033,470,449,490,518,28,48,69,123.99267441638719,63,161.19128031931226,-92.2168418085425,-36.25581607264598,14.80080925851509,1.2737231732314687,38920,39084,Cherokee+Crawford,Crawford,20,37,Kansas,KS
20027,20CS008,84,83,85,90,5,6,7,91.86981689652897,17,252.06968985543062,-172.24715358943698,-160.33875364188756,-147.74921462682022,2.3624716428252217,102,101,103,113,10,11,12,136.55837056918344,10,123.73174956693887,0.11377820784056332,13.246306687397096,25.480483738123095,0.8307961159608063,8093,8082,Cloud and Nearby Counties,Clay,20,27,Kansas,KS
20029,20CS008,117,116,118,128,10,11,12,145.25267694585128,21,281.5327896324433,-147.94166611240166,-136.33922677704254,-124.53482032411044,1.7744520586169164,142,141,144,157,13,15,16,162.58510357723472,17,190.22043191227482,-39.923512093664044,-27.29334680554463,-15.682830260642293,1.0946392440048358,8951,8937,Cloud and Nearby Counties,Cloud,20,29,Kansas,KS
20089,20CS008,32,32,32,31,-1,-1,-1,-36.27361365179045,1,41.138155639355496,-90.70194517176279,-77.70112953345932,-65.88918199578235,8.456737704086962,39,39,39,59,20,20,20,678.6229413237218,11,374.78705281090294,291.7495427522516,303.6510105637759,317.2766242881948,0.5258733682372274,2917,2935,Cloud and Nearby Counties,Jewell,20,89,Kansas,KS
20105,20CS008,30,29,30,39,9,9,10,381.59001291170404,5,203.73514431239386,166.1018802770954,178.09477570293234,189.68245850936952,0.4823994207482468,36,35,36,40,4,4,5,148.72775916749262,4,137.50429700928154,-1.586159110167181,11.32893082520327,23.8042020250096,0.7509635076509692,2945,2909,Cloud and Nearby Counties,Lincoln,20,105,Kansas,KS
20123,20CS008,68,67,68,76,8,8,9,170.62817906277746,4,82.87292817679557,74.85946286850739,87.64833282677847,100.36578417940093,0.4331041679713745,82,81,83,97,14,15,16,261.67729819406395,12,208.69565217391303,40.749319876688965,53.12041473867844,65.14010808724427,0.7478292085638206,5792,5750,Cloud and Nearby Counties,Mitchell,20,123,Kansas,KS
20141,20CS008,49,49,50,48,-2,-1,-1,-49.48105041396663,4,137.69363166953528,-198.85989074719,-187.36873288864555,-174.61426457275158,-9.144434907442092,60,60,61,59,-2,-1,-1,-40.00138105703598,7,200.17157563625966,-253.40170083961098,-239.72116891082047,-226.72437717350826,-17.55053256550058,3486,3497,Cloud and Nearby Counties,Osborne,20,141,Kansas,KS
20143,20CS008,61,60,61,64,3,3,4,66.81669743970522,11,229.9251001567671,-174.942580054655,-163.38694018920913,-150.20822675371934,2.6211556730892807,75,74,76,75,-1,-0,1,-2.2738832825421107,10,171.7327837884252,-185.98197214680286,-173.71724619906013,-161.3247258651381,11.526158121081524,5741,5823,Cloud and Nearby Counties,Ottawa,20,143,Kansas,KS
20157,20CS008,69,69,70,65,-5,-4,-4,-114.53802791898474,10,257.4554816562969,-384.6079774309359,-372.26277625593855,-359.7783151630181,-2.8995189949807534,85,84,85,86,1,1,2,29.239523464260248,7,150.05359056806003,-132.95248662259576,-120.61325301714139,-108.72060940442636,2.961053137448572,4661,4665,Cloud and Nearby Counties,Republic,20,157,Kansas,KS
20183,20CS008,47,47,47,43,-4,-4,-4,-132.08460056608504,5,168.39741790625877,-312.1829255778905,-300.41662716528975,-288.4795749340329,-1.7112668839386986,57,57,58,55,-3,-2,-2,-65.03320727699256,2,55.959709009513155,-133.0569615512888,-121.214478871362,-109.16825266887689,-1.5102468419927622,3563,3574,Cloud and Nearby Counties,Smith,20,183,Kansas,KS
20201,20CS008,60,60,61,66,5,6,6,129.35850463319727,10,217.6673317612915,-100.7351334177941,-88.34284300874597,-76.15227583447773,1.440310929640493,73,72,74,83,9,10,11,178.38310596945848,10,181.3894431344096,-14.71855825802079,-2.903385263706333,8.716149792910041,0.9229979174005868,5513,5513,Cloud and Nearby Counties,Washington,20,201,Kansas,KS
20041,20CS009,198,190,206,203,-3,5,13,33.52230136015707,23,150.26132404181183,-169.85836794053563,-117.49218731021958,-65.42009615297813,3.7513372733300736,242,233,252,285,33,43,52,232.20002459182626,47,254.82541747993926,-74.59486890518713,-22.439429099689097,29.212551156335223,1.0723989653106367,18368,18444,Dickinson+Geary+Morris,Dickinson,20,41,Kansas,KS
20061,20CS009,195,179,211,214,3,19,35,63.65664855948605,26,86.74136061608607,-79.1391471114356,-22.755298397692155,26.841753464380755,1.2947852566751867,240,222,259,273,14,33,51,91.00017922427494,40,110.94777133664327,-71.41757046532148,-19.400423065264857,30.571451778915222,1.1831416063616451,35969,36053,Dickinson+Geary+Morris,Geary,20,61,Kansas,KS
20127,20CS009,64,63,64,77,13,13,14,292.7697340018679,14,311.2263801407929,-31.3437910593371,-18.73907131049556,-6.490748980961691,0.9880196593256104,77,77,78,75,-3,-2,-2,-44.83345369989366,2,37.334328915437744,-94.63966593839389,-82.14850741817281,-69.07907658284286,-1.4268102201997497,5398,5357,Dickinson+Geary+Morris,Morris,20,127,Kansas,KS
20045,20CS010,622,571,673,729,56,107,158,107.57089152750744,53,53.27748691099477,1.3165788611343399,53.518974740847966,102.84656411202127,0.49069245993090355,773,711,834,849,15,76,138,63.99791160704544,40,33.53369717394767,-21.20491913602109,32.085197741325295,84.28230897461683,0.5172059625024668,119375,119283,Douglas,Douglas,20,45,Kansas,KS
20019,20CS011,45,43,46,41,-5,-4,-2,-132.1392126241359,5,178.57142857142856,-365.7665840558108,-310.2145631365134,-257.5134847372529,-1.8519218452545885,55,53,57,65,8,10,12,299.84985122184446,10,294.6375957572186,-45.20689806252329,4.904466769263183,56.99170528070389,0.8947021504626981,3360,3394,Elk and Nearby Counties,Chautauqua,20,19,Kansas,KS
20035,20CS011,370,355,384,429,45,59,74,206.60566983012984,63,218.87666473653735,-61.72968624610753,-12.643362317461165,36.43377844573214,1.041873411134453,452,434,469,504,35,52,70,151.9807729630267,64,185.5287569573284,-85.31789463915132,-34.57850989944475,11.541786459338917,1.1978897500698562,34540,34496,Elk and Nearby Counties,Cowley,20,35,Kansas,KS
20049,20CS011,33,32,34,36,2,3,4,155.49624544784444,2,96.93053311793214,10.091062093372665,57.849116294627706,109.79087095083334,0.475239333951866,40,38,41,50,9,10,12,428.62920387803274,5,204.4153720359771,176.38506186892934,224.18562815104738,270.51303338637405,0.43537811786850655,2476,2446,Elk and Nearby Counties,Elk,20,49,Kansas,KS
20073,20CS011,82,81,82,87,5,5,6,107.80952949956159,5,100.45203415369161,-4.83654688669408,7.482927188594905,19.03862421671859,0.7853954977293777,99,98,100,124,24,25,26,420.84545666023905,13,218.70794078061908,189.49848363195483,202.23538604418283,214.62078962130212,0.49971066860139746,5973,5944,Elk and Nearby Counties,Greenwood,20,73,Kansas,KS
20205,20CS011,92,92,93,112,19,20,20,273.11049499138346,6,84.03361344537815,176.98589252376368,188.6890175984028,201.47776386741248,0.29268165127430695,112,111,113,155,42,43,44,500.422116000518,26,304.6994023204031,183.86998277980152,196.08511267500901,209.06820960959453,0.594951799769354,8568,8533,Elk and Nearby Counties,Wilson,20,205,Kansas,KS
20207,20CS011,41,40,42,51,9,10,11,381.8569733554546,2,77.36943907156673,253.85608107726733,303.8223286438136,356.84503949805315,0.1839756684756969,50,49,52,55,3,5,6,157.51089029233427,1,32.23726627981947,72.2141857651901,126.17657599156077,176.09779609509252,0.16989501696455697,3102,3102,Elk and Nearby Counties,Woodson,20,207,Kansas,KS
20091,20CS012,3547,3285,3810,3992,182,445,707,87.53207378481143,479,94.27448176097123,-57.80637871834901,-6.379106717364972,45.455475131303025,1.0746116000071213,4416,4100,4733,4825,92,409,725,66.71078789061143,420,68.5347275255047,-57.889678662663826,-2.184090687050562,47.98958753288002,1.0248342040436225,609709,612828,Johnson,Johnson,20,91,Kansas,KS
20099,20CS013,227,219,236,241,5,14,22,82.00558996575225,28,167.68977391825123,-142.81822494651692,-84.49248082023796,-34.74465339392372,1.9056844914101823,276,266,287,303,16,27,37,133.60872661079637,39,195.56714471968712,-114.054263505403,-60.92896197314948,-11.445092046217468,1.4107815119097444,20037,19942,Labette+Montgomery+Neosho,Labette,20,99,Kansas,KS
20125,20CS013,365,351,378,412,34,47,61,180.78405550297,41,156.67791860391057,-26.195410769407,24.355079657960196,71.81945406403408,0.8487176472748699,443,427,459,544,85,101,117,323.5539153083206,79,253.3187968960431,17.31781507870236,70.26078840797626,124.0319632748175,0.7752430620382884,31402,31186,Labette+Montgomery+Neosho,Montgomery,20,125,Kansas,KS
20133,20CS013,174,167,181,192,11,18,25,138.3531530509217,17,128.34224598930481,-40.92834076320098,9.735641595666143,63.0937781095423,0.8796427255114597,211,203,219,241,22,30,38,187.8885072566421,39,246.80420199974688,-110.22798129256923,-60.56557569313595,-6.326127630509793,1.270766362236503,15895,15802,Labette+Montgomery+Neosho,Neosho,20,133,Kansas,KS
20103,20CS014,549,514,584,669,85,120,155,175.81986939774737,62,90.83250924806798,29.29868342727527,84.70210132080089,134.00771671585142,0.5123533035887544,679,636,721,793,72,114,157,139.19125907008444,88,107.13676982638974,-17.763709802993457,31.069362773699986,88.15623754872962,0.7630350025476055,81909,82138,Leavenworth,Leavenworth,20,103,Kansas,KS
20023,20CS015,31,31,31,48,17,17,17,784.068609446881,12,549.1990846681922,221.96257851486794,234.94743118069067,247.22855310138303,0.6618170508756417,38,38,38,41,3,3,3,117.47806106356416,6,228.05017103762827,-122.65792000094876,-110.67245068016358,-98.39895540162736,1.4666886457324277,2622,2631,Northwest Kansas,Cheyenne,20,23,Kansas,KS
20039,20CS015,39,38,39,35,-4,-4,-3,-160.3187076869539,5,217.47009786154405,-390.58350362795534,-378.05943372789,-365.3224400359014,-1.8615080542576004,47,47,48,58,10,11,11,394.16693884968475,10,363.50418029807344,17.95708700461123,30.716338002146134,44.72196495404073,0.8443426832610221,2759,2751,Northwest Kansas,Decatur,20,39,Kansas,KS
20063,20CS015,29,29,29,47,18,18,18,804.9113136354467,20,890.2077151335311,-97.9208847392889,-85.09966451968457,-72.79358606131372,1.048016215939145,36,36,36,44,8,8,8,288.927744430485,4,145.66642388929353,130.2115073379606,143.13893908482189,155.10050174277058,0.4477299934944133,2696,2746,Northwest Kansas,Gove,20,63,Kansas,KS
20065,20CS015,30,30,30,28,-2,-2,-2,-90.68490244126762,5,248.96265560165975,-351.8450341041153,-339.73393829822686,-327.4838580084983,-6.0882420744868435,36,36,37,40,3,4,4,152.07114414797235,2,83.29862557267805,56.06511799828905,68.67703667143101,82.05287145582919,0.42999395567667775,2410,2401,Northwest Kansas,Graham,20,65,Kansas,KS
20109,20CS015,28,28,28,39,11,11,11,481.60221874080094,4,174.79970866715223,295.2532763175472,306.8681313147507,318.606786995885,0.33276031714118093,34,34,34,50,16,16,16,586.5085014069258,3,110.09174311926607,464.17988234270314,476.48049192657044,489.02864701781255,0.1766539273360309,2746,2725,Northwest Kansas,Logan,20,109,Kansas,KS
20137,20CS015,57,57,58,76,18,19,19,418.22349704209444,22,487.4446085672082,-82.01366194136757,-69.72548468536628,-56.73029238442946,1.1068725439628835,69,68,70,56,-14,-13,-12,-246.030227738116,2,37.34129947722181,-296.14957415034894,-282.9376992726493,-270.76114621626675,-0.16423895490034335,5416,5356,Northwest Kansas,Norton,20,137,Kansas,KS
20147,20CS015,58,58,59,65,6,7,7,160.60802259158618,15,361.30068245684464,-213.86243796809975,-200.98801064301736,-189.64777018895757,1.9562045606518215,69,69,70,77,7,8,8,159.44658703387515,16,330.9203722854188,-183.85463118146893,-171.34136330093554,-159.2673063666146,1.8371287779700443,4982,4835,Northwest Kansas,Phillips,20,147,Kansas,KS
20153,20CS015,35,35,36,32,-4,-3,-3,-163.34605629647936,4,188.6051080550098,-364.66545136483825,-352.0650657926007,-340.4813075007492,-1.6231805698954256,43,43,44,37,-7,-6,-6,-252.4760829817954,3,117.6470588235294,-383.04853981622705,-369.65906129896905,-357.50006373618663,-0.5516591952373042,2545,2550,Northwest Kansas,Rawlins,20,153,Kansas,KS
20163,20CS015,55,55,56,59,3,4,4,89.86260825616942,10,245.1982018798529,-166.5560007419883,-155.13660516148894,-142.90342589676234,2.1436701879394593,67,66,68,73,5,6,7,124.0368604936014,3,61.98347107438017,50.069228443846576,62.17989255708375,74.04968242578516,0.4283643420788436,4894,4840,Northwest Kansas,Rooks,20,163,Kansas,KS
20179,20CS015,25,24,25,44,19,19,20,950.0113226111366,10,488.40048840048837,449.42376308086546,461.51959476416204,473.59588798401626,0.48896212425569746,30,30,31,40,9,10,10,393.34893416933716,2,80.87343307723413,300.81464412142583,312.5496846721559,324.46655914508085,0.18643639536080941,2457,2473,Northwest Kansas,Sheridan,20,179,Kansas,KS
20181,20CS015,59,58,59,51,-8,-8,-7,-158.71845502065332,11,224.07061619419449,-396.03121349787523,-382.2492776525041,-371.34247881047344,-1.6196111975920797,72,71,73,62,-11,-10,-9,-170.70978668300526,4,67.87714237230612,-250.86446920970658,-238.80849758119845,-226.37639637463576,-0.4415046255937606,5891,5893,Northwest Kansas,Sherman,20,181,Kansas,KS
20193,20CS015,70,70,71,69,-2,-1,-1,-21.942870858083378,10,152.26494099733537,-186.40733808195057,-174.16544673992743,-162.83944936414136,-22.670696787228117,86,85,87,72,-15,-14,-13,-182.5858430457912,14,177.59736141063047,-372.90039564083264,-360.1264491756801,-347.6946775094417,-1.0453032949281122,7881,7883,Northwest Kansas,Thomas,20,193,Kansas,KS
20195,20CS015,37,37,37,45,8,8,8,348.07166704651615,2,85.65310492505353,250.44911891331344,262.6447373924575,276.00028370521943,0.2191186878073566,45,45,45,45,-0,0,0,0.5965589125402828,4,143.11270125223612,-154.93573403566467,-142.21567756309358,-130.55944936287779,3.9343985406089432,2802,2795,Northwest Kansas,Trego,20,195,Kansas,KS
20199,20CS015,14,14,14,15,1,1,1,75.46012435678648,5,396.3011889035667,-332.81655027176726,-320.8377939879214,-308.94711506139527,2.561402929960662,17,17,17,19,2,2,2,121.75670764747424,3,198.80715705765405,-90.02744213551209,-76.7874118222659,-64.6437368193129,1.0573399998895205,1514,1509,Northwest Kansas,Wallace,20,199,Kansas,KS
20025,20CS016,27,27,27,33,6,6,6,365.30713723325374,7,424.6713852376137,-72.12283352112414,-59.674227386826615,-46.85198690167292,0.996940913572932,33,33,34,31,-3,-2,-2,-117.8342096894805,3,151.82186234817814,-283.1640378633423,-269.2002101927808,-257.06993308440235,-2.2583491447961292,1978,1976,Pawnee and Nearby Counties,Clark,20,25,Kansas,KS
20033,20CS016,25,25,25,29,4,4,4,283.91390111806,2,142.602495543672,128.6213259954368,141.1995452135599,154.11661722251185,0.4014538681397107,31,30,31,32,1,1,2,78.92905028264619,4,239.23444976076553,-174.0512364937418,-160.5962572540148,-147.20731748775486,1.7243655764815276,1683,1672,Pawnee and Nearby Counties,Comanche,20,33,Kansas,KS
20047,20CS016,38,37,38,69,31,31,32,1307.6831356040423,11,459.2901878914405,835.8960896467092,848.3847141241064,860.615965767226,0.34035694863129956,46,46,46,59,13,13,13,454.17508291063103,2,70.37297677691767,372.3272391390834,383.4710267728555,396.42966647370486,0.14380568664208992,2874,2842,Pawnee and Nearby Counties,Edwards,20,47,Kansas,KS
20057,20CS016,220,205,235,253,18,33,48,116.55012270053817,41,144.38314356145088,-80.00846121406924,-26.95984466645274,22.58931617840428,1.2024747572380472,274,257,292,276,-16,2,19,4.997525186416315,56,163.90563718316454,-210.67225265275192,-157.97053541354776,-111.72787832148268,20.68363509961591,34076,34166,Pawnee and Nearby Counties,Ford,20,57,Kansas,KS
20083,20CS016,22,22,22,20,-2,-2,-2,-128.59086492979478,2,139.21113689095128,-279.7383706140193,-267.7941944796626,-255.43305928232093,-2.360098960051165,27,27,27,41,14,14,14,826.9586204740966,5,292.22676797194623,521.7783913284711,535.0159530806208,547.1023645497431,0.33004908101908126,1724,1711,Pawnee and Nearby Counties,Hodgman,20,83,Kansas,KS
20097,20CS016,25,25,25,29,4,4,4,204.8713887284917,3,147.05882352941177,45.77354050586576,58.01187004096484,70.8830977660742,0.5792203170462675,30,30,31,37,6,7,7,280.5789385919187,4,166.5972511453561,101.3323957517642,113.73544163466292,126.22491535414747,0.5170162778489299,2448,2401,Pawnee and Nearby Counties,Kiowa,20,97,Kansas,KS
20135,20CS016,38,38,39,55,16,17,17,747.3278372066765,14,623.839584106944,112.17192834357922,123.47073716845495,134.78033816735316,0.7877878383762345,47,47,47,53,6,6,6,228.41885112349783,3,112.23344556677891,103.26191519443671,116.09732116816332,128.43469005999444,0.42220007416898064,2693,2673,Pawnee and Nearby Counties,Ness,20,135,Kansas,KS
20145,20CS016,72,72,73,82,9,10,10,185.33876492265136,3,57.4896199297349,115.5976304947551,128.0045639884476,140.7891828053364,0.2811201255886676,89,88,90,86,-4,-3,-2,-51.404692539156315,13,208.73474630700068,-272.7253731393746,-259.9562449541547,-248.28322075436952,-5.9051069713967275,6262,6228,Pawnee and Nearby Counties,Pawnee,20,145,Kansas,KS
20165,20CS016,50,50,50,58,8,8,8,321.92835481323993,13,528.4552845528455,-218.3263034725415,-206.33848155638404,-195.46197765051136,1.4574910086649462,62,61,62,60,-2,-2,-1,-58.10327956514163,1,33.87533875338753,-104.37939300480132,-92.13196176916914,-78.62319911414778,-1.398193062158755,2952,2952,Pawnee and Nearby Counties,Rush,20,165,Kansas,KS
20149,20CS017,167,156,178,180,2,13,24,63.57404567564466,16,75.89232775999051,-67.15070731926161,-11.845912216437197,36.60039040569813,1.1108798182518507,208,195,221,225,4,17,30,66.65567532934176,34,132.1311985076947,-117.27796377751886,-66.92448794505036,-16.315836453789405,1.8730885156750554,25299,25732,Pottawatomie+Riley+Wabaunsee,Pottawatomie,20,149,Kansas,KS
20161,20CS017,308,277,339,348,9,40,71,66.69477961904798,22,36.600582281990846,-22.39501620249452,30.1662846425235,83.96640616178587,0.5354215363923258,384,347,421,431,10,47,84,64.98703279212027,32,44.33545312218574,-32.59329735723327,22.64361153454674,77.14263621450253,0.6679790972684768,72130,72177,Pottawatomie+Riley+Wabaunsee,Riley,20,161,Kansas,KS
20197,20CS017,54,54,55,57,2,3,3,44.497350346578386,6,104.43864229765012,-72.46876353817636,-59.97917977799444,-47.62109205051329,1.687112227972922,67,66,68,92,24,25,26,354.7585610860051,10,143.80212827149842,198.59178196083099,211.02360416584378,223.6710040034592,0.3895611581170009,6894,6954,Pottawatomie+Riley+Wabaunsee,Wabaunsee,20,197,Kansas,KS
20155,20CS018,612,585,638,746,108,134,161,261.04527762782993,94,182.55381129632624,26.48628220329681,77.4584749907085,129.91418077515317,0.694154371377801,744,712,776,825,49,81,113,131.545205977591,75,122.00875209448358,-41.50039285078455,8.683521025081948,61.13109567742642,0.9161742848493254,61790,61471,Reno,Reno,20,155,Kansas,KS
20169,20CS019,479,455,502,545,43,66,90,147.19355439791667,77,170.53319306793642,-74.39236915897635,-23.851151116541594,23.55572189204351,1.1413905783698086,586,558,614,736,122,150,178,278.3685500290504,130,241.01746449627348,-16.593545172308268,36.490955784434036,87.90599690963884,0.8600930983121651,54183,53938,Saline,Saline,20,169,Kansas,KS
20055,20CS020,204,187,220,275,55,71,88,225.7684654646533,59,186.35011712683917,-12.868932442366496,38.78352865916174,91.54143218873772,0.8140156657732879,253,234,273,325,52,72,91,187.6210506818828,45,118.00183558410909,14.65825646912658,69.99891392172268,116.37928614644387,0.6202679783709814,37993,38135,Scott and Nearby Counties,Finney,20,55,Kansas,KS
20071,20CS020,21,21,21,24,3,3,3,317.7923405427328,3,283.46456692913387,22.825912032059893,34.16372595419388,46.75241796758282,0.6875526410615862,26,26,26,27,1,1,1,94.21683043370658,3,230.7692307692308,-149.09951367304174,-136.70580470378252,-122.75721934633026,1.348424422645825,1270,1300,Scott and Nearby Counties,Greeley,20,71,Kansas,KS
20075,20CS020,20,20,21,20,-1,-0,-0,-16.13487724921169,3,144.23076923076923,-172.08549904305434,-160.39550245043668,-147.88911566279,4.515389214852404,25,24,25,27,2,2,3,88.91613689304974,7,281.69014084507046,-205.8134571647482,-192.97772606244627,-180.6000702776865,2.1809802310004094,2496,2485,Scott and Nearby Counties,Hamilton,20,75,Kansas,KS
20093,20CS020,29,28,29,29,-0,0,1,9.548423102014103,7,213.25209444021326,-215.54825010910858,-203.7948949648841,-191.3907767563798,5.329569182170088,35,34,35,48,13,13,14,337.5759009120858,2,51.24263387138099,273.47505977875437,286.0754751099651,299.0833067483938,0.14108762774955472,3939,3903,Scott and Nearby Counties,Kearny,20,93,Kansas,KS
20101,20CS020,24,24,25,26,1,2,2,115.36506582829074,6,460.9475032010243,-357.1398139187597,-345.5544096921781,-334.12046825351223,2.3983992058481234,30,30,30,33,3,3,3,193.60501081713562,5,319.4888178913738,-138.31099247765925,-125.7538529556447,-113.52861552321744,1.2407199054126705,1562,1565,Scott and Nearby Counties,Lane,20,101,Kansas,KS
20171,20CS020,45,44,45,55,10,10,11,237.42985413975487,16,376.8400392541708,-152.23211562420337,-139.19058698956565,-127.59641835460992,1.443929176567468,55,55,56,72,16,17,17,324.0834721015247,12,233.82696804364772,77.34157735757034,90.28345748012039,102.93911883313348,0.6805821599972133,5095,5132,Scott and Nearby Counties,Scott,20,171,Kansas,KS
20203,20CS020,19,19,20,31,11,12,12,654.9424010645629,5,281.1621368322399,360.4596526912563,373.51690615394256,385.4858134552873,0.3953488306842045,23,23,23,30,7,7,7,325.0478471008149,7,334.7680535628886,-22.087223109930417,-9.636275596639539,2.6915538345416112,0.8978099293253345,2134,2091,Scott and Nearby Counties,Wichita,20,203,Kansas,KS
20173,20CS021,3917,3692,4142,4833,691,916,1141,210.11945672587711,497,114.0161044879981,46.29703049037058,95.83137220261715,150.0631669386249,0.5420333705072733,4821,4550,5091,5624,533,803,1074,153.34522212359374,611,116.62775893366724,-17.61200985612996,36.32766569919622,89.2126882583633,0.759611304588491,523084,523889,Sedgwick,Sedgwick,20,173,Kansas,KS
20177,20CS022,1646,1570,1723,1914,191,268,344,180.09702195556125,239,160.85339794390322,-30.904916156392904,19.327702794893085,71.66530726521408,0.8898232814465065,2018,1926,2110,2155,45,137,229,76.8061854378799,238,133.47241383177987,-109.2069884054172,-56.85199829290104,-7.796046322512946,1.7251854712799888,178299,178314,Shawnee,Shawnee,20,177,Kansas,KS
20007,20CS023,49,49,49,66,17,17,17,483.8719029628516,3,85.16678495386799,387.0682732087037,398.59344855631537,411.09660097593735,0.16625667970929023,59,58,59,66,7,7,8,170.69367169792253,5,121.2709192335678,36.88156669358029,49.63312172226288,62.30101518765892,0.6220684956742245,4227,4123,South Central Kansas,Barber,20,7,Kansas,KS
20077,20CS023,77,77,78,94,16,17,17,367.31116058201155,14,308.5399449035812,47.01170481339548,58.54391836636897,69.98935115542459,0.7924493653275364,94,93,94,78,-16,-16,-15,-290.993428181618,7,130.84112149532712,-434.8494266695948,-422.24552878139673,-409.6860297810312,-0.48050032194154396,5445,5350,South Central Kansas,Harper,20,77,Kansas,KS
20095,20CS023,158,155,161,212,51,54,57,880.0277662797633,31,503.791982665222,329.36714112411363,375.435022984863,430.8884565993555,0.5620927355206614,193,189,196,265,69,72,76,978.4481218392942,35,472.972972972973,455.3079460186073,503.66216092336435,558.4873583925877,0.4768057111450205,7384,7400,South Central Kansas,Kingman,20,95,Kansas,KS
20151,20CS023,101,101,102,124,22,23,23,295.68767739046086,25,327.90468903705323,-44.63209739597277,-32.262153005056625,-19.8807036549424,1.06185422610589,126,125,127,129,2,3,4,35.528602845167804,6,65.38084341288003,-42.443120484300444,-29.887804391255617,-17.04566776779392,1.408298673060805,9149,9177,South Central Kansas,Pratt,20,151,Kansas,KS
20185,20CS023,51,50,51,59,8,8,9,247.61808906523058,8,236.27861186315528,-0.3872951723546513,11.445360270328026,22.646119198191474,0.8525207515709058,62,62,63,81,18,19,19,469.3065545237168,16,396.235760277365,59.71558814234292,72.59768749599309,85.24392780347726,0.8019809462019792,4063,4038,South Central Kansas,Stafford,20,185,Kansas,KS
20191,20CS023,230,221,240,270,30,40,49,213.36225656313098,42,224.92970946579194,-62.38668593279634,-10.510437212764264,41.59837261837881,1.028401829828462,286,275,298,322,24,36,47,159.73790617567047,30,134.0662287169862,-28.56709905512203,26.610800377485567,78.974871014246,0.8164475811311103,22407,22377,South Central Kansas,Sumner,20,191,Kansas,KS
20067,20CS024,51,50,52,60,8,9,10,147.97897738467574,16,263.0497328401151,-127.39342816703473,-115.48123438483272,-103.00551146469694,1.599868602883973,63,63,64,59,-5,-4,-4,-61.43666389279331,16,218.45985800109227,-292.357910912457,-280.07379890406037,-267.49598570433545,-4.571923301197702,7299,7324,Southwest Kansas,Grant,20,67,Kansas,KS
20069,20CS024,45,45,46,55,9,10,10,208.4432863920875,10,211.0075611042729,-14.510640462059115,-2.7640182357278307,9.160856103317567,0.9192465149774522,55,55,56,66,10,11,11,187.6204663908948,11,194.96632399858206,-19.616584456116897,-7.3990456708757035,5.934082798986874,0.9494588621287835,5687,5642,Southwest Kansas,Gray,20,69,Kansas,KS
20081,20CS024,25,25,26,25,-1,-0,-0,-13.401894928838056,5,158.68817773075907,-183.4848790963513,-172.51044970643943,-160.74356462100636,8.654582383267122,31,30,31,35,4,4,5,115.87129463642215,3,81.49959250203749,22.05822928808874,34.13632758877366,46.2164527892374,0.5697765065568837,3781,3681,Southwest Kansas,Haskell,20,81,Kansas,KS
20119,20CS024,42,42,43,56,13,14,14,403.19310753273857,5,148.55162168853676,242.44606667228376,254.75559411845475,267.10720827951945,0.3431518688745196,52,52,53,58,5,6,6,146.1995729739088,7,173.91304347826087,-40.50349442588293,-27.740103860534543,-14.669658384391415,1.0167719714539751,4039,4025,Southwest Kansas,Meade,20,119,Kansas,KS
20129,20CS024,32,32,32,36,4,4,4,184.13077130438367,1,44.91017964071856,127.07535435081357,139.0672491223363,151.3931551314294,0.19607925768472237,40,39,40,44,4,4,5,164.765540421545,5,185.73551263001485,-33.398196961517186,-20.66068967385542,-7.620185616901024,0.9198805479370822,2672,2692,Southwest Kansas,Morton,20,129,Kansas,KS
20175,20CS024,117,115,119,141,22,24,26,133.98891333509894,38,209.5299361301291,-87.59933092031278,-75.67450008935232,-62.43209282092717,1.5019759279340885,146,143,148,163,15,17,20,79.8053889830367,14,64.34119215037455,2.6851561167931814,15.251347509358421,28.511813155058814,0.7623256657051668,21763,21759,Southwest Kansas,Seward,20,175,Kansas,KS
20187,20CS024,18,18,18,16,-2,-2,-2,-114.38738117939499,2,116.67476908118618,-243.20879636356185,-231.28768566793926,-218.38543755284033,-2.0816195553598904,22,22,22,19,-3,-3,-3,-151.58239628446506,4,195.3125,-359.39516283296035,-346.6651122426757,-334.81763766867937,-1.9007725670040188,2057,2048,Southwest Kansas,Stanton,20,187,Kansas,KS
20189,20CS024,40,39,41,46,5,6,7,137.27827114716615,5,113.9168407062844,11.230477767247516,23.30473620119661,34.69389253994262,0.7117060728149358,50,49,50,54,4,4,5,81.52351083760108,10,189.2147587511826,-119.92593192667539,-107.76250673169928,-94.98291275248265,1.883765083192772,5267,5285,Southwest Kansas,Stevens,20,189,Kansas,KS
20209,20CS025,1213,1141,1286,1474,188,261,333,185.89995655069598,213,151.90324785308889,-20.025823596562564,34.189906923493155,84.10351242867212,0.8140009127941167,1486,1399,1572,1653,81,167,254,99.95975094274412,174,103.99732236779191,-57.266238508718686,-4.1896901164243765,48.82460193902457,1.034208167760449,168265,167312,Wyandotte,Wyandotte,20,209,Kansas,KS
21001,21CS001,175,167,183,268,85,93,101,589.1101335536042,44,278.42227378190256,262.04547569724303,312.2090603756414,363.56073663276015,0.4675924524379518,214,205,224,270,46,56,65,293.3639766872029,40,211.38297310151665,30.080127156950063,82.98378721321568,133.56334366338098,0.7077984218683958,18964,18923,Adair and Nearby Counties,Adair,21,1,Kentucky,KY
21045,21CS001,169,162,175,210,35,41,48,311.59308002694917,25,188.32391713747646,69.56067661552093,123.21584300738374,175.9413677763014,0.5901239493885848,206,198,214,242,28,36,44,228.36974409438346,39,245.76217783099122,-68.2897345471798,-18.79279099071462,35.37931092165018,1.0472611589850451,15930,15869,Adair and Nearby Counties,Casey,21,45,Kentucky,KY
21087,21CS001,129,128,130,141,11,12,13,130.97343911086003,16,172.8639596650761,-53.27489259083801,-41.73873067198968,-30.090498503858655,1.2192628377466188,160,159,162,164,2,4,5,33.28046401194978,28,248.55747891699954,-228.2767190178957,-215.6723143410272,-202.1043892080558,5.895923137903621,11107,11265,Adair and Nearby Counties,Green,21,87,Kentucky,KY
21207,21CS001,218,210,226,272,46,54,62,360.7807386605158,33,220.13452665517815,90.48408480470502,140.38596567928622,190.65043316708142,0.5990846070926588,268,259,277,310,33,42,51,232.08807860788983,35,193.05019305019306,-13.46005877523035,40.60749892770407,90.77996948625666,0.8124878236063482,17989,18130,Adair and Nearby Counties,Russell,21,207,Kentucky,KY
21217,21CS001,269,258,280,311,31,42,53,193.99419962805538,28,129.22579900773047,12.436576505836394,64.85180097651713,115.87486766743294,0.6506529631793567,331,318,345,447,102,116,129,440.90208176221154,66,251.86994352007326,138.12175243225778,189.69157808646082,238.98307585716546,0.566358405914289,26001,26204,Adair and Nearby Counties,Taylor,21,217,Kentucky,KY
21005,21CS002,213,202,223,246,23,33,44,169.08804688851092,13,65.77837746668915,51.32609220655188,104.46504865696235,153.684968071226,0.3777155459663226,262,250,275,291,16,29,41,120.0759515690777,47,195.74361750864188,-127.76488606025212,-76.63399864809547,-26.05632937067513,1.5755191552930827,23716,24011,Anderson+Franklin,Anderson,21,5,Kentucky,KY
21073,21CS002,487,465,509,528,19,41,63,95.48515777758395,40,93.2382820846526,-48.38214333373565,0.8319248721430262,53.007917290260664,0.9531996056782895,596,569,623,759,136,163,190,315.1504628988458,79,152.90519877675843,109.68500750217342,161.76920334708817,214.3899505193077,0.48222000467478354,51481,51666,Anderson+Franklin,Franklin,21,73,Kentucky,KY
21003,21CS003,204,195,213,231,18,27,36,157.62443946172087,30,173.72840459415113,-67.91806470954603,-17.152853734394803,29.872554227120865,1.0631092245797367,250,239,261,290,29,40,51,193.3733739238202,47,226.30970724191062,-87.72684031804914,-31.68273940529138,19.356811599624212,1.1418913652514093,20722,20768,Barren and Nearby Counties,Allen,21,3,Kentucky,KY
21009,21CS003,447,428,466,507,41,60,79,162.08258315153037,45,121.57507260733502,-10.86694825459086,39.382204973042846,95.5556361437399,0.7377833230485046,547,524,570,653,83,106,129,238.53168203874188,111,249.27015495171796,-61.28317265143007,-11.484330918798133,40.69265418609151,1.0352724021590654,44417,44530,Barren and Nearby Counties,Barren,21,9,Kentucky,KY
21099,21CS003,195,187,203,227,24,32,40,198.5125238286773,31,193.2166415623539,-50.204876421525725,5.433879949634267,53.05146388067577,0.9436925970877882,240,230,250,269,19,29,39,148.52974630718708,45,231.57678056813504,-134.36205149522573,-81.36002461422989,-30.714357900218832,1.5069167326123374,19253,19432,Barren and Nearby Counties,Hart,21,99,Kentucky,KY
21169,21CS003,118,117,119,148,29,30,31,353.33789514257654,14,163.87046429964883,177.33792501821821,189.45850675845807,201.44337598945268,0.44890737935870206,145,144,147,160,13,15,16,141.30658921629347,34,328.8837299284194,-200.61626438667457,-187.36426429939527,-175.89541779650438,2.178331659276184,10252,10338,Barren and Nearby Counties,Metcalfe,21,169,Kentucky,KY
21171,21CS003,150,145,155,152,-3,2,7,22.779287041368992,37,396.42857142857144,-424.5808924835069,-374.6118951720276,-320.694431889723,11.835959523357882,182,176,188,185,-3,3,9,24.25311520664007,37,329.0936582762608,-352.35165268015817,-304.33570021727843,-254.363343674124,9.92814773369536,11200,11243,Barren and Nearby Counties,Monroe,21,171,Kentucky,KY
21011,21CS004,147,142,153,150,-3,3,8,25.100750902501673,10,94.56264775413713,-118.58535519285323,-71.3440611079515,-20.78743880337917,2.736424019814014,180,174,187,220,33,40,46,312.01135941914214,19,148.8095238095238,110.7704926117653,164.6589517995369,213.73346945736662,0.4652573896356528,12690,12768,Bath+Clark+Montgomery+Rowan,Bath,21,11,Kentucky,KY
21049,21CS004,366,351,382,396,14,30,45,96.12868646434323,17,55.313033811447625,-12.598371105991953,40.16412394913343,92.08345395091398,0.5565677319532149,446,427,465,523,58,77,96,207.6071844473167,31,84.03361344537815,71.90453233909678,124.13829766725966,174.71225588540474,0.3995551258232139,36881,36890,Bath+Clark+Montgomery+Rowan,Clark,21,49,Kentucky,KY
21173,21CS004,269,257,281,306,25,37,49,159.26261118052943,20,85.34850640113798,22.651059803894768,73.3231459633337,126.89358435043107,0.5219133330336655,329,314,343,433,90,104,119,369.6836676469957,67,237.5886524822695,80.31944800107634,133.80426814068545,183.63037437246203,0.6365747684907455,28120,28200,Bath+Clark+Montgomery+Rowan,Montgomery,21,173,Kentucky,KY
21205,21CS004,198,188,209,230,21,32,42,153.58667111210556,11,53.41102209274095,50.513297480917714,99.9239034213613,150.19461449753368,0.33710094804959284,244,231,257,328,71,84,97,338.7392310994067,45,181.14483535947187,107.54648908369094,158.98723458435214,206.2751055736055,0.5284816383298567,24714,24842,Bath+Clark+Montgomery+Rowan,Rowan,21,205,Kentucky,KY
21013,21CS005,318,307,328,362,34,44,55,219.5748637814126,40,198.04431241490283,-34.72093162054707,20.30581642742137,70.3006074616544,0.8820552518306028,385,372,397,545,148,160,173,671.508808993492,80,335.14872224549646,287.14231878336557,335.607230576409,391.0931738010434,0.49600359762230734,24237,23870,Bell+Harlan,Bell,21,13,Kentucky,KY
21095,21CS005,365,353,376,471,95,106,118,480.2804441646437,31,140.2291917973462,289.9642593417448,341.07364982881757,390.4561704266914,0.2892492666990843,441,427,454,586,132,145,159,554.266483241241,87,331.5422430547616,170.56344282606042,223.1537087594834,273.95303213024783,0.5940794133047492,26528,26241,Bell+Harlan,Harlan,21,95,Kentucky,KY
21015,21CS006,828,769,886,911,25,83,142,73.39695416110936,91,80.22922636103152,-61.79369178106148,-7.287953411858781,46.91340123564853,1.0801123450034773,1032,961,1103,1168,65,136,207,99.17040617623805,160,116.56285287582413,-67.20819653126765,-16.827315612860936,32.12249408672104,1.1668078914242617,136110,137265,Boone,Boone,21,15,Kentucky,KY
21017,21CS007,205,196,213,202,-11,-3,6,-15.81575084172474,1,5.939123979213066,-71.55763483505082,-22.58192600652318,31.77805531054063,-0.6013312097226197,251,240,261,334,73,83,94,410.56278141589144,37,182.8334239264713,173.85879230474006,229.56914386039222,282.49514414679163,0.44002783315118527,20205,20237,Bourbon+Fleming+Lewis+Nicholas,Bourbon,21,17,Kentucky,KY
21069,21CS007,164,157,170,179,9,15,22,121.57130993619214,17,135.73757402355446,-64.65052924274583,-15.354497050115317,40.865520996310075,1.047714555588417,202,194,210,208,-2,6,14,37.33357628727887,29,190.72673462676752,-202.1664587839757,-152.2143982952942,-101.74185386463606,4.343547481383378,15029,15205,Bourbon+Fleming+Lewis+Nicholas,Fleming,21,69,Kentucky,KY
21135,21CS007,157,151,162,174,12,17,23,159.151637247919,29,265.8721063488425,-160.33861906443872,-107.86499469081326,-54.79944212421495,1.5795667392310762,190,184,197,231,34,41,47,313.21421981220914,39,300.04616094783813,-36.27104007113524,13.985963327351037,62.42403084209578,0.9349920570683381,13089,12998,Bourbon+Fleming+Lewis+Nicholas,Lewis,21,135,Kentucky,KY
21181,21CS007,87,86,88,77,-11,-10,-9,-163.63208452792142,4,63.89776357827476,-238.9271098311189,-227.73769220280673,-215.8542956800025,-0.4327426742427143,109,108,110,116,6,7,8,87.17806950065398,21,273.224043715847,-199.0290865379568,-186.73137250283838,-172.73675077421868,2.727093368884688,7512,7686,Bourbon+Fleming+Lewis+Nicholas,Nicholas,21,181,Kentucky,KY
21019,21CS008,569,549,590,641,51,72,92,179.03964999323392,50,125.12773456236573,0.9422052513556588,53.76691567811641,105.73173894020766,0.6892487329865618,698,673,723,795,72,97,122,201.97686924655764,78,162.70677319093014,-8.428675561718514,39.689374276728685,87.01067606578391,0.797336557760081,47951,47939,Boyd+Carter+Greenup,Boyd,21,19,Kentucky,KY
21043,21CS008,292,280,303,304,1,12,24,54.65540921971956,22,99.30038366057323,-94.49371827488318,-43.58647908333439,8.724371250805962,1.6782483714987702,357,344,371,436,65,79,92,297.49823819646,56,211.83234982599487,36.65925037813285,85.00630881710022,140.17980185473283,0.7031056682758678,26586,26436,Boyd+Carter+Greenup,Carter,21,43,Kentucky,KY
21089,21CS008,425,410,441,498,57,73,88,244.1791728842733,37,124.26184545632644,67.53855150453843,119.5008826979011,171.92904250112858,0.5019917979496094,521,503,539,577,38,56,74,156.85082811125042,66,184.9827629698142,-81.07568391871175,-27.354309899282015,19.763025116815808,1.158650767407676,35731,35679,Boyd+Carter+Greenup,Greenup,21,89,Kentucky,KY
21021,21CS009,302,289,315,339,24,37,50,144.09639019936907,45,176.44752319958175,-87.27806938363663,-33.5548712624683,18.649307828618173,1.1920724728432406,373,357,389,442,53,69,85,224.65443338032316,55,178.91997397527652,-5.064163445397292,45.812968275396386,99.0454329061564,0.7850551442063859,30604,30740,Boyle+Lincoln+Mercer,Boyle,21,21,Kentucky,KY
21137,21CS009,262,251,272,309,37,47,58,233.8355873164672,37,182.86655683690282,0.2013817481558338,51.93698931491611,102.25577004242788,0.7658436412926025,321,308,333,435,102,114,127,470.38146596361224,64,264.0046200808514,152.10746355134222,207.5984025815442,257.99181414018415,0.5563772021115401,24280,24242,Boyle+Lincoln+Mercer,Lincoln,21,137,Kentucky,KY
21167,21CS009,256,247,266,260,-6,4,13,18.98121625833969,25,133.1026221216558,-168.9366791955282,-116.13922658737783,-62.23523758000837,5.476274982643544,318,306,329,351,22,33,45,146.32749534888626,51,223.52734922861148,-128.37361476082557,-77.09960252599191,-23.94835063299629,1.4831582435201962,22539,22816,Boyle+Lincoln+Mercer,Mercer,21,167,Kentucky,KY
21023,21CS010,83,82,83,90,7,7,8,105.79752069574235,8,114.47650846649177,-20.562671592235017,-8.871708248461212,4.230550601047586,0.9531203690229286,102,101,103,140,37,38,39,452.9223564173026,22,260.91081593927896,179.77942959532675,191.9453182303784,203.92948231645366,0.56136177865064385,8386,8432,Bracken and Nearby Counties,Bracken,21,23,Kentucky,KY
21097,21CS010,198,190,206,209,3,11,19,70.16592634213521,11,70.39999999999999,-51.7193978446427,0.651484662767956,51.7117768669823,0.9194690557966643,245,236,255,298,43,53,62,278.228479889149,43,227.34482393993866,-0.009414548425029173,49.770199844006406,106.05419233375602,0.8018777412745633,18750,18914,Bracken and Nearby Counties,Harrison,21,97,Kentucky,KY
21161,21CS010,203,195,210,197,-13,-6,2,-39.247006754927845,21,147.67932489451476,-238.8216577555341,-186.3925196240164,-137.21385891245893,-4.584227624634973,247,238,255,272,17,25,34,149.79868227293085,44,259.54108417389256,-161.2200842820394,-109.34378520727596,-58.8991104085236,1.666958977664378,17064,16953,Bracken and Nearby Counties,Mason,21,161,Kentucky,KY
21191,21CS010,147,141,154,153,-1,6,12,46.391686598010466,8,65.63653767263777,-70.71370050667645,-20.895907996650227,33.5431502915941,1.2022168756222211,181,173,188,209,21,28,36,191.9289003431207,23,157.4048727073638,-13.745358520923757,35.999871234541125,88.87259100822274,0.791884194608714,14626,14612,Bracken and Nearby Counties,Pendleton,21,191,Kentucky,KY
21201,21CS010,27,27,27,39,12,12,12,659.6760096636551,1,54.89478499542543,592.8902632809521,604.7404210137958,615.3021500673957,0.076822038356067393,34,34,34,39,5,5,5,225.80824005351232,7,311.6651825467498,-97.91875239238328,-86.0819613235682,-72.98228576472079,1.1528985463184884,2186,2246,Bracken and Nearby Counties,Robertson,21,201,Kentucky,KY
21027,21CS011,204,195,213,249,36,45,54,264.8423423566243,15,87.97653958944281,123.30002577603304,176.41291099459826,228.15766986569275,0.32498751406991633,250,239,261,355,94,105,116,509.9338023361064,44,213.395411998642,244.48860725942777,298.24455493650856,347.18594331074564,0.4145341291914454,20460,20619,Breckinridge+Grayson+Hancock+Meade,Breckinridge,21,27,Kentucky,KY
21085,21CS011,280,269,291,314,23,34,45,154.65215000976912,40,181.6392946340725,-78.01813369502717,-25.236789534499934,21.822954409797877,1.1409995640106458,341,328,355,447,92,106,119,398.7070686234861,65,245.21824423737127,104.25660968135628,151.25154246761088,203.60912402478786,0.6092686673095224,26426,26507,Breckinridge+Grayson+Hancock+Meade,Grayson,21,85,Kentucky,KY
21091,21CS011,77,76,78,102,24,25,26,333.92752322519397,4,53.132610139473094,268.20242221286946,280.90993843760305,292.6619453636394,0.1530270059328189,95,94,96,114,18,19,20,212.93358360258196,8,88.2223202470225,111.82074769446344,124.32727045934202,137.88237239208337,0.3939175707656139,9034,9068,Breckinridge+Grayson+Hancock+Meade,Hancock,21,91,Kentucky,KY
21163,21CS011,235,222,248,243,-5,8,21,31.632341404881448,13,52.35426385206564,-69.11405920681837,-21.15794114944546,27.60869107046001,1.4681677558566257,289,274,305,357,52,68,83,224.98005554164536,63,209.23976219734962,-35.160407886694834,15.016911480351284,68.71373268869142,0.9165070124139403,29797,30109,Breckinridge+Grayson+Hancock+Meade,Meade,21,163,Kentucky,KY
21029,21CS012,569,534,605,699,94,130,165,189.1481336080156,63,91.87356447555506,49.057331056347664,97.861819978481,152.36215454225962,0.48200660204712253,704,661,747,856,109,152,195,183.31999955788265,103,124.35558453161408,7.1251387346261374,60.21145801409808,108.16278381661672,0.673914161873087,82287,82827,Bullitt+Spencer,Bullitt,21,29,Kentucky,KY
21215,21CS012,148,139,156,157,1,9,18,56.39904785889543,12,73.61210510172783,-72.21344282886493,-16.88107459859303,35.45248496386796,1.1771647940365124,184,174,194,213,19,29,39,146.3701767354941,26,130.88346337780015,-33.73273800311456,15.078075914908988,65.06187530818333,0.8644641385845253,19562,19865,Bullitt+Spencer,Spencer,21,215,Kentucky,KY
21031,21CS013,145,140,150,170,20,25,30,241.86939926789935,20,193.62646228317868,-6.059061678052933,47.09436349402971,101.15145887329413,0.7697312909684133,176,170,183,189,6,13,19,102.54133652993086,30,243.9421044072207,-193.15040045768134,-141.18254116894326,-84.13824830040136,2.2041751598885218,12395,12298,Butler+McLean+Muhlenberg+Ohio,Butler,21,31,Kentucky,KY
21149,21CS013,101,100,102,128,26,27,28,359.7048194434181,16,210.5263157894737,137.4929795921094,148.73476422034366,161.6755008238462,0.5646215290051632,123,122,124,145,21,22,23,238.21561746066072,21,230.71852340145026,-4.852050206149801,7.43028976019043,20.132269742720517,0.925828546509132,9120,9102,Butler+McLean+Muhlenberg+Ohio,McLean,21,149,Kentucky,KY
21177,21CS013,333,319,346,364,18,31,45,122.01236179621789,42,163.4877384196185,-93.40691077394894,-41.84314608287877,10.312353933822163,1.2985015147494827,406,390,422,482,60,76,92,247.85543324804073,61,198.56770833333331,-2.4719710999627638,48.89880868523017,103.38116628366069,0.7907578391853463,30828,30720,Butler+McLean+Muhlenberg+Ohio,Muhlenberg,21,177,Kentucky,KY
21183,21CS013,247,236,257,260,3,13,24,67.84565033793137,29,146.415348367553,-127.68756089034704,-78.29061673390416,-28.367159291489656,2.008593760054084,301,289,314,372,58,71,83,297.61618224172304,46,194.14197687178188,53.639312734564555,103.7337617360155,154.83634417265765,0.6432021109427435,23768,23694,Butler+McLean+Muhlenberg+Ohio,Ohio,21,183,Kentucky,KY
21035,21CS014,329,313,345,404,59,75,91,240.88239359313792,40,128.0990632755998,58.5019504948101,110.64317294522347,165.78440328661713,0.5248136157875855,406,386,425,511,86,105,125,280.7562479887154,40,106.66666666666667,122.04430172593796,175.8565725288164,225.4519536977424,0.3763515973871208,37471,37500,Calloway+Marshall,Calloway,21,35,Kentucky,KY
21157,21CS014,380,366,393,385,-8,5,19,19.763219994677783,35,132.9408413256101,-169.29592998692905,-114.43615324989341,-66.11376626169908,5.642283958385622,466,449,482,510,28,44,61,140.00366346488912,48,151.24779430299975,-61.66611186865577,-10.704831898491834,38.46772651551358,1.0565342069189305,31593,31736,Calloway+Marshall,Marshall,21,157,Kentucky,KY
21037,21CS015,745,705,785,817,32,72,112,92.84701529065175,58,74.68452227659026,-35.91436534066087,17.678043348034528,66.94649667979462,0.793379471824832,914,866,962,957,-5,43,91,45.75294202723651,84,90.26919563698887,-97.16014379961676,-42.626098800187286,6.896316832510548,1.92769313896879,93192,93055,Campbell,Campbell,21,37,Kentucky,KY
21047,21CS016,534,503,566,668,102,134,165,221.01773545404174,72,119.17570139865926,54.04468616446953,102.68969676971228,154.80131081036015,0.5352051046609302,660,622,697,835,138,175,213,242.10224528430817,102,140.87230340027068,52.4238420898222,101.74513229106608,150.0854499869485,0.5785705903180567,72498,72406,Christian,Christian,21,47,Kentucky,KY
21051,21CS017,240,232,249,236,-13,-4,4,-25.759999409483243,21,124.57363191457807,-202.26451059628099,-150.72241585070353,-99.26357733423762,-6.2827377374197715,296,286,306,390,84,94,104,464.9051577364191,43,212.6712498145309,204.7385095461126,252.5360622743865,301.0742359188241,0.45263551524340134,20229,20219,Clay+Jackson+Leslie+Owsley,Clay,21,51,Kentucky,KY
21109,21CS017,154,149,160,173,13,19,24,173.01933501804845,23,212.17712177121768,-95.42222762753647,-36.86426185940762,9.477555458368014,1.164244772533262,190,183,197,224,27,34,41,260.8167441737754,42,323.59966099083135,-112.78547035861591,-63.6852956274259,-13.053263608153298,1.205116399963356,13008,12979,Clay+Jackson+Leslie+Owsley,Jackson,21,109,Kentucky,KY
21131,21CS017,140,139,141,132,-9,-8,-7,-92.09559474172153,3,34.77252970153579,-138.39423164559756,-127.17432827496214,-114.89009068744676,-0.4319313959764695,171,170,173,206,33,35,36,337.04999647188345,29,281.444099378882,44.132132004707984,55.56188091574584,67.47877418452079,0.8116512449684722,10353,10304,Clay+Jackson+Leslie+Owsley,Leslie,21,131,Kentucky,KY
21189,21CS017,58,57,58,91,33,33,34,980.2354181150115,12,353.8953059719833,614.2567353887654,625.9306997260047,638.3186372160042,0.35048623376073157,69,69,70,83,13,14,14,349.9715677807126,7,176.67844522968198,160.5033050465159,173.87635342829685,186.00324140577845,0.47087713969277806,4069,3962,Clay+Jackson+Leslie+Owsley,Owsley,21,189,Kentucky,KY
21053,21CS018,104,103,105,145,40,41,42,526.8680861499773,21,269.0870261612386,245.8467993628085,257.7922475764995,269.2373015830169,0.4986031566487185,126,125,127,157,30,31,32,335.85315458285606,21,226.83084899546338,97.2289525519227,109.02426329032588,121.5773226503579,0.6543424883568255,9365,9258,Clinton+Cumberland+McCreary+Wayne,Clinton,21,53,Kentucky,KY
21057,21CS018,78,78,79,97,18,19,19,378.9430479433036,4,80.38854463238988,286.50878335328224,298.2405861728397,310.9254935822541,0.20145476028540063,94,93,95,111,16,17,18,286.49033091427674,11,187.20217835262082,86.61331902808449,99.46417055021594,112.21678055458682,0.6167934286995356,5971,5876,Clinton+Cumberland+McCreary+Wayne,Cumberland,21,57,Kentucky,KY
21147,21CS018,189,181,196,198,2,9,17,66.80025236514227,11,78.03724504877327,-65.15990084221157,-11.71231168584769,43.17513667750235,1.056062291828892,230,221,239,290,51,60,69,354.18952875233623,57,337.55774013976077,-39.364178854945756,15.446930787023968,69.9890175820304,0.937369819295618,16915,16886,Clinton+Cumberland+McCreary+Wayne,McCreary,21,147,Kentucky,KY
21231,21CS018,197,188,205,258,53,61,70,374.5657500665242,26,158.86755944803707,162.6454424912437,215.66323667291795,267.588409326866,0.41733007180622933,240,230,250,334,84,94,104,481.342587364142,46,235.43863240863956,199.1635646769077,244.55537474564696,297.3395924085487,0.48398272471961656,19639,19538,Clinton+Cumberland+McCreary+Wayne,Wayne,21,231,Kentucky,KY
21059,21CS019,947,902,991,1034,43,87,132,101.77367485397109,92,107.16989923699691,-58.36974037897306,-4.352943656145687,45.68230220855047,1.0411054318790587,1160,1107,1214,1310,96,150,203,145.11024337233513,191,185.26421975634358,-93.51021940926574,-39.2633135643576,7.902854489713986,1.2682362368800186,103014,103096,Daviess,Daviess,21,59,Kentucky,KY
21061,21CS020,135,130,140,140,-0,5,10,47.076628339045165,19,187.63887745864537,-191.38048825248208,-140.52900992156242,-87.90235810711827,3.2946638495328213,166,160,173,187,14,21,27,169.34260008078599,29,236.3873492011738,-119.79461397423503,-65.88781763170876,-16.668804812210126,1.3318055730579117,12151,12268,Edmonson+Warren,Edmonson,21,61,Kentucky,KY
21227,21CS020,922,864,980,1081,101,159,217,141.44345988242924,95,84.53649529487664,5.607664202046208,57.75621934137834,112.60160708884383,0.5939332873322128,1149,1078,1219,1336,117,187,258,136.961957650437,158,115.42957334891877,-29.989953773207755,20.529390594337166,71.40076765454843,0.8383140167491754,134853,136880,Edmonson+Warren,Warren,21,227,Kentucky,KY
21063,21CS021,67,66,68,65,-3,-2,-1,-30.810110441212316,3,48.90639858714848,-91.77587692708578,-79.68279339263991,-67.58927299827921,-3.3710004252084236,83,82,84,115,31,32,33,436.04701655501856,15,203.41741253051262,220.02522536004585,232.54697293973646,245.93182384952559,0.45243263525852023,7361,7374,Elliott+Johnson+Lawrence+Magoffin,Elliott,21,63,Kentucky,KY
21115,21CS021,273,264,283,302,19,29,38,151.69244718500994,17,90.42152386862284,9.07259439975174,61.933095478844535,116.40274804122093,0.5758916021420347,335,324,347,435,88,100,111,442.251474329383,68,301.3249435015731,89.66523380417951,141.67266188904551,189.21576411163298,0.6745838324382137,22561,22567,Elliott+Johnson+Lawrence+Magoffin,Johnson,21,115,Kentucky,KY
21127,21CS021,191,184,198,182,-16,-9,-2,-68.41872342515644,14,103.97326401782398,-222.77858992013537,-171.58726136933961,-125.14156933089671,-1.7047015808856147,236,227,244,276,32,40,49,246.7100883186295,37,227.13321055862494,-30.93211646129431,18.952301984845707,73.97418828963478,0.8982964887863626,16158,16290,Elliott+Johnson+Lawrence+Magoffin,Lawrence,21,127,Kentucky,KY
21153,21CS021,142,137,147,152,5,10,15,103.59990490033853,10,102.82776349614396,-48.57539348558669,1.3647548238145786,50.033302255808756,0.9029271384158463,172,166,178,217,39,45,51,388.6024999845812,24,208.49622100599427,127.60164128617313,180.111929205014,230.06424498450895,0.5247962537378197,11670,11511,Elliott+Johnson+Lawrence+Magoffin,Magoffin,21,153,Kentucky,KY
21065,21CS022,172,166,178,195,17,23,29,193.60134058558688,11,93.41164814945863,45.18387937950626,100.02100155342859,148.57909587848965,0.4622203911497563,210,203,217,273,56,63,70,447.22577187784754,27,191.51652716697404,205.46482898712867,255.53357420186475,304.95279349592397,0.4215463958943601,14131,14098,Estill+Madison+Rockcastle,Estill,21,65,Kentucky,KY
21151,21CS022,710,669,750,833,83,123,164,159.07856872010407,63,81.17859290438966,24.572733591570252,77.73869400321104,130.34489894156332,0.5062047258256056,888,839,937,1071,134,183,232,193.84587789526688,142,150.4062026670621,-6.917055377139889,43.713239737522834,95.2215042261681,0.7716895083681515,93128,94411,Estill+Madison+Rockcastle,Madison,21,151,Kentucky,KY
21203,21CS022,168,161,175,192,17,24,31,178.9790636542126,13,96.54062751407882,33.44239097628849,81.97149633985883,132.60420741150833,0.5179071906307905,206,197,214,317,103,111,120,691.6053042075308,39,242.14578417980874,399.2886356673293,448.98100003110346,501.9521727128805,0.34700611484747945,16159,16106,Estill+Madison+Rockcastle,Rockcastle,21,203,Kentucky,KY
21067,21CS023,2089,1950,2228,2478,250,389,528,144.7543797601163,142,52.82721717752611,40.778070263369045,93.19997804555098,142.74066583334482,0.3640083148067771,2571,2405,2737,2837,100,266,432,82.60387570226133,229,71.1440838568171,-38.52661535939313,11.075256590324662,63.6230316872545,0.8580410204784858,322561,321882,Fayette,Fayette,21,67,Kentucky,KY
21071,21CS024,457,442,472,541,69,84,99,282.1808019938323,46,154.747554035491,77.43605817403211,125.60936254157033,178.1232743090698,0.5419377662768041,552,534,571,680,109,128,146,360.89188526901745,110,311.22679945676776,-4.328667388988971,50.1187884174037,100.83586273535288,0.8556740231426282,35671,35344,Floyd+Martin,Floyd,21,71,Kentucky,KY
21159,21CS024,131,126,136,140,4,9,14,97.11465486145818,6,64.15396952686447,-15.968304211295697,32.26282558770353,85.81519844082106,0.5950817625410528,159,153,165,185,20,26,32,233.1355168840513,29,260.01972563435845,-77.98132980765308,-27.508935838105405,29.29556854596621,1.0740102620296905,11223,11153,Floyd+Martin,Martin,21,159,Kentucky,KY
21079,21CS025,155,148,162,203,41,48,55,336.94295627611405,22,154.48534144771492,132.68988837981576,182.3308330482954,235.43853497185574,0.4491309688478537,193,184,202,241,39,48,57,278.8978526992066,33,190.7514450867052,35.05069286348818,87.31686584516225,137.71778911145373,0.670059897134109,17089,17300,Garrard+Jessamine,Garrard,21,79,Kentucky,KY
21113,21CS025,414,391,437,454,17,40,63,90.06135364172711,49,110.54293878778763,-70.84613093958336,-20.869478764946408,31.874294705059114,1.1974234568059794,513,485,541,597,56,84,112,156.80844418353877,51,95.27189852608768,9.164591958816985,60.486549589917395,113.46792890733843,0.6004158532761598,53192,53531,Garrard+Jessamine,Jessamine,21,113,Kentucky,KY
21093,21CS026,828,781,876,1003,127,175,222,189.02583262018229,84,90.93533487297921,48.89229865177074,98.20980781749957,146.88256024576754,0.4783341331780044,1030,972,1088,1396,308,366,424,328.2914542078065,223,200.0394696711459,77.6540454562438,128.7810995665235,178.55679685991865,0.6076745524769537,110848,111478,Hardin+Larue,Hardin,21,93,Kentucky,KY
21123,21CS026,161,154,167,162,-5,1,8,9.933299861427594,6,48.59283255719781,-93.35537780366359,-37.72277009097979,11.735683246312758,2.6947952988351225,199,191,207,225,18,26,34,173.0531302307422,34,226.59113628790405,-106.13794724010452,-53.42823010120164,-1.8842253811497474,1.260817901442341,14817,15005,Hardin+Larue,Larue,21,123,Kentucky,KY
21101,21CS027,429,410,448,543,95,114,133,305.60819883789094,60,161.05941302791697,87.90822162980746,143.42896108609563,194.321944495925,0.5224240010110603,521,498,544,638,94,117,140,264.383890833244,71,160,54.01791507893025,104.72570810849022,154.93208980215363,0.600065830311914,44704,44375,Henderson+Union,Henderson,21,101,Kentucky,KY
21225,21CS027,145,139,151,142,-9,-3,3,-24.49656964269451,13,113.38033287302856,-190.0669484242092,-137.48570731520255,-87.22393025569914,-7.187340272566491,175,168,182,245,63,70,77,518.8278320542945,40,295.00700641640236,172.42095638327177,223.78920017413176,272.1361127866668,0.5606334482539965,13759,13559,Henderson+Union,Union,21,225,Kentucky,KY
21103,21CS028,161,155,168,164,-4,3,9,20.926497175278516,3,22.896393817973667,-51.60175725391599,-0.6606976875705534,54.13000255282037,0.8017329634619803,197,189,205,230,25,33,41,212.86060289286237,29,185.20883893217524,-22.614547805047557,25.75017666662906,77.9238329405659,0.8447492651696645,15723,15658,Henry+Shelby,Henry,21,103,Kentucky,KY
21211,21CS028,332,311,352,416,64,84,105,209.24300464440427,39,96.83226086776602,62.92935650162201,111.93591064711735,165.1009513133807,0.457347299428371,410,385,435,508,73,98,123,201.46328030604292,77,159.0251961999174,-8.640395860311925,43.29488840852694,94.88943093552419,0.7813410058994311,48331,48420,Henry+Shelby,Shelby,21,211,Kentucky,KY
21107,21CS029,504,484,523,613,90,109,129,289.7756174398693,95,251.98938992042437,-12.308106236652154,36.81796382693739,85.57435656285486,0.8617138973627955,608,585,632,756,124,148,171,327.0884249880379,103,228.0224037546213,46.05967828608992,97.39220600127477,148.5439081369126,0.6924411063877077,45240,45171,Hopkins+Webster,Hopkins,21,107,Kentucky,KY
21233,21CS029,147,141,153,174,21,27,33,249.53456114308372,23,212.89725393397097,-14.067575493644457,37.20183837024735,86.1155471666509,0.8226610816100264,176,170,183,205,22,29,35,224.04702816635185,28,218.0855206791806,-41.72148476304546,5.736974307415334,59.72929429927945,0.9406895903268556,12964,12839,Hopkins+Webster,Webster,21,233,Kentucky,KY
21111,21CS030,6914,6579,7250,8138,888,1224,1559,188.3821556962555,753,115.90722803938996,19.580732494296228,72.28260390874865,125.03349194454756,0.6147747753158466,8450,8048,8852,9578,726,1128,1530,144.91005067951687,907,116.5069994116846,-22.877671068457488,28.258205270377957,80.56225762853015,0.803283240948181,779589,778494,Jefferson,Jefferson,21,111,Kentucky,KY
21117,21CS031,1334,1262,1407,1390,-17,56,128,39.54005407924269,109,77.42118783516625,-87.82128816158215,-37.43021541209895,10.269834734499883,1.9234915143225737,1641,1553,1728,1753,25,112,200,66.34158484520702,197,116.25848332841547,-104.30339151094414,-51.84353419211258,-0.34416720715780347,1.7369711542999702,168946,169450,Kenton,Kenton,21,117,Kentucky,KY
21119,21CS032,169,163,175,197,22,28,34,237.3355491822674,11,92.62507894182863,98.66860330811312,147.40417648569755,195.40467593415696,0.37689852875222646,206,199,213,269,56,63,70,447.1282384158832,34,241.666074347857,154.1940943941635,204.89811327912,255.6680300322946,0.5320274928184284,14251,14069,Knott+Letcher+Perry,Knott,21,119,Kentucky,KY
21133,21CS032,286,277,295,324,29,38,47,212.1144339439863,24,134.39731205375892,25.300124622445953,75.97106619078085,129.0390936815225,0.6173103857033071,349,338,360,427,67,78,89,364.6439773966637,61,286.6676065604587,27.22933963204837,77.25443831698793,128.47558854151313,0.7761545775029854,21429,21279,Knott+Letcher+Perry,Letcher,21,133,Kentucky,KY
21193,21CS032,404,392,416,436,20,32,44,136.47358738394595,33,141.65623323197997,-56.300737693242894,-6.037341576903237,44.98878925391798,1.006322772913908,494,480,509,594,85,100,114,356.91284738880904,87,310.78088161748946,-3.8398904063457837,45.915360326764194,100.21378832734966,0.8621186620790813,27955,27994,Knott+Letcher+Perry,Perry,21,193,Kentucky,KY
21121,21CS033,337,324,350,411,61,74,87,292.4421570794429,30,118.96893588896233,125.08079768172394,171.68792854886647,221.66052699480824,0.4013691292695999,407,392,423,526,103,119,134,396.4176845214216,84,280.5423819384143,65.72429415571736,114.9166558252767,164.11727276685852,0.701781454095352,30260,29942,Knox+Whitley,Knox,21,121,Kentucky,KY
21235,21CS033,430,414,446,474,28,44,60,144.8815571143842,25,81.81966944853542,11.127929451760386,63.54781555921572,116.1469271333685,0.5522596725749712,526,507,545,635,90,109,128,295.5108098061596,108,292.6670641157661,-49.242041370073366,2.7352846486209255,55.96305373119421,0.9813774627335912,36666,36902,Knox+Whitley,Whitley,21,235,Kentucky,KY
21125,21CS034,585,559,612,687,75,102,128,195.40451419313507,27,51.93472894559677,91.67827059222638,142.81587933595011,195.3778281283743,0.2631898310346154,719,687,752,940,188,221,253,352.6750456790795,142,226.92406034262336,75.1431253674252,127.01038702202644,180.11145466067796,0.6405342623484622,62386,62576,Laurel,Laurel,21,125,Kentucky,KY
21141,21CS035,282,270,293,317,24,35,47,154.90060407358897,40,174.74243692890167,-71.21700913815728,-20.41052121974255,36.00958355416998,1.097151711270665,347,333,362,389,27,42,56,150.04788396363872,41,147.84897767841045,-49.84558968680196,1.332046557989584,55.33721535191115,0.9622204397442051,27469,27731,Logan+Simpson+Todd,Logan,21,141,Kentucky,KY
21213,21CS035,195,187,204,222,18,27,35,164.60152084695608,24,147.9122798007293,-35.200528139494764,15.725766838466203,70.84342409079228,0.8661768203893357,241,231,251,265,14,24,34,121.40661731480672,55,279.13114088509946,-208.63157226769175,-156.78873333255058,-108.54016497284368,2.206889035785921,19471,19704,Logan+Simpson+Todd,Simpson,21,213,Kentucky,KY
21219,21CS035,119,118,120,121,1,2,3,21.796809797335936,13,126.97379130717891,-116.95863910626422,-105.62902714300414,-93.06789471645837,4.022737697906235,146,144,148,184,36,38,40,309.1553936121952,20,162.813415825464,133.5623094710796,146.3786523917706,159.3666357595875,0.5131277506752595,12286,12284,Logan+Simpson+Todd,Todd,21,219,Kentucky,KY
21033,21CS036,146,141,152,145,-7,-1,4,-10.631969621367979,14,132.8483314882176,-191.56763681763584,-140.74023736430442,-91.4592484330238,-116.24778849314455,178,172,185,210,25,32,38,251.40843456523194,30,237.6237623762376,-37.58144839981597,13.950928576054292,61.815591188396006,0.916301511599531,12646,12625,Lyon and Nearby Counties,Caldwell,21,33,Kentucky,KY
21055,21CS036,110,109,110,112,2,2,3,32.55794100137715,12,160.80402010050253,-140.6849668060761,-128.07649597417603,-116.16505031264319,3.4989132330895054,134,133,135,157,22,23,24,253.73809697615508,23,256.8971294538144,-15.668498738821466,-3.0884134122124496,8.837501731966775,0.9697614948506805,8955,8953,Lyon and Nearby Counties,Crittenden,21,55,Kentucky,KY
21139,21CS036,125,122,129,154,25,29,32,385.72526118188375,19,256.1509942703067,78.85357140798446,130.83901180868676,177.7916907854703,0.6416497287717601,154,149,158,174,16,20,25,227.76248143256194,27,301.94587340639674,-122.20020922145547,-74.90345554208943,-21.46982197623903,1.2636591556786512,8901,8942,Lyon and Nearby Counties,Livingston,21,139,Kentucky,KY
21143,21CS036,105,104,106,112,6,7,8,92.6134499957514,12,167.07274625826662,-86.2946399991752,-74.5315169505518,-63.60771669548202,1.5682254428568214,132,130,133,139,6,7,9,84.25912849561097,13,148.01320733234658,-76.39538432790386,-63.45032456055418,-51.5676669331381,1.5475307543996975,8619,8783,Lyon and Nearby Counties,Lyon,21,143,Kentucky,KY
21221,21CS036,152,146,158,196,38,44,50,369.463392137311,6,50.81874647092039,266.46183742805437,317.30522710496905,371.4784080872406,0.13446489678018866,187,180,194,258,64,71,78,501.988921903764,25,176.37928601665018,274.3044011377647,326.9564722378215,375.4772882774776,0.3464911749743224,14168,14174,Lyon and Nearby Counties,Trigg,21,221,Kentucky,KY
21145,21CS037,703,674,732,795,63,92,121,163.91194931921368,76,135.1651771819839,-24.97065561110058,29.974526067373983,81.05107202334429,0.8157693250837222,856,821,891,1006,115,150,185,221.7042838184849,109,161.45756184268998,9.695781098879849,61.78708441396304,111.42923858118647,0.7234230210790559,67473,67510,McCracken,McCracken,21,145,Kentucky,KY
21155,21CS038,189,180,197,232,35,43,52,266.4761419551775,27,165.77129700690713,49.76934177137569,101.45215104423897,150.4632706342117,0.6080765864457142,233,223,243,256,13,23,33,117.46369517679487,30,152.2533495736906,-87.83909862955697,-34.45991080934388,17.768608397130677,1.242490877080633,19545,19704,Marion+Nelson+Washington,Marion,21,155,Kentucky,KY
21179,21CS038,388,368,408,441,33,53,73,136.4812713235047,36,92.47762983259835,-8.956308053824424,43.46733932880871,94.72293247747801,0.6650670051585186,480,456,505,618,113,138,162,292.75213722586517,87,184.9175310321374,56.767252108580784,107.58932609415778,159.60264594442637,0.627099225821773,46714,47048,Marion+Nelson+Washington,Nelson,21,179,Kentucky,KY
21229,21CS038,130,125,136,150,14,20,25,195.32367733986558,27,269.10299003322257,-126.94405292846555,-73.77237021363787,-25.54408290161732,1.3108402451682148,160,154,166,151,-15,-9,-3,-73.82644505229686,18,149.1918773311231,-276.5369575009603,-222.00101784866834,-172.35404335898676,-2.2764176574468675,12040,12065,Marion+Nelson+Washington,Washington,21,229,Kentucky,KY
21185,21CS039,376,347,405,424,19,48,77,84.76845955736363,50,88.71802454532013,-52.04205250729714,-5.763075012437076,46.245629900242754,1.0251344305147074,473,437,508,486,-22,13,49,19.57606625110423,37,53.98858943866458,-86.4451311592762,-36.446872903335574,13.460440147066455,2.5665810162558467,67630,68533,Oldham,Oldham,21,185,Kentucky,KY
21041,21CS040,120,119,121,122,1,2,3,26.651234595077206,13,144.2974747941911,-129.4183174840949,-117.65880843490561,-105.5968869884962,3.8223443238171413,147,145,148,154,6,7,9,66.99928316597244,23,211.80587531080212,-156.6342538688958,-145.1081297050934,-133.1399806680804,2.779304327801093,10811,10859,Owen and Nearby Counties,Carroll,21,41,Kentucky,KY
21077,21CS040,86,85,87,100,13,14,15,196.2639945915999,11,151.65441176470588,33.025412845359995,44.60369958586571,56.13327526890035,0.7219893528207953,105,104,107,120,13,15,16,165.86331527703172,23,262.58705331658865,-108.56829508209191,-96.47960808717912,-83.91208163486489,1.4811983331165415,8704,8759,Owen and Nearby Counties,Gallatin,21,77,Kentucky,KY
21081,21CS040,208,197,219,227,8,19,30,90.52361397708036,13,62.27793524691604,-26.478798112326658,27.475218813702675,79.13114920013902,0.6533960240622132,254,241,267,321,54,67,80,264.13010237481546,36,142.80047600158667,70.40864543357857,121.56101714909505,172.93955066331077,0.5326452439891738,25049,25210,Owen and Nearby Counties,Grant,21,81,Kentucky,KY
21187,21CS040,105,104,106,133,27,28,29,295.600757198782,11,117.50044507744349,166.819165174082,177.77099671690212,189.94812873034945,0.38363406540182593,129,128,131,160,29,31,32,270.71818400502474,18,159.37666017354348,99.3675401699715,111.25975827533438,123.20624482499018,0.5700728530977718,11234,11294,Owen and Nearby Counties,Owen,21,187,Kentucky,KY
21223,21CS040,87,86,87,98,11,11,12,162.72406421081035,11,155.6970983722576,-5.020081107033312,7.011673777644331,19.658027189170635,0.8802496291829505,106,105,107,147,40,41,42,478.73221994009344,25,293.42723004694835,172.44152837555384,185.3920311387513,197.8966608437264,0.5982580858326709,8478,8520,Owen and Nearby Counties,Trimble,21,223,Kentucky,KY
21195,21CS041,682,657,707,781,74,99,124,204.3020096194396,47,96.85562672803147,57.19596983647468,109.55438690402872,158.50193736000784,0.46934642250667974,824,794,854,1076,222,252,282,438.08774405498457,160,278.0722640296147,107.6811324716576,160.2918010387523,209.52630337173383,0.6322328748523508,58231,57539,Pike,Pike,21,195,Kentucky,KY
21199,21CS042,710,682,738,814,76,104,132,190.94500901527505,66,121.67393842561297,16.8158292682677,68.88953107073654,121.71589835175222,0.6311263619825853,870,836,903,1042,139,172,206,263.6191273302004,165,252.4325316688085,-38.40966655442479,11.90925246585909,64.95277494915922,0.9520402160165499,65092,65364,Pulaski,Pulaski,21,199,Kentucky,KY
21209,21CS043,377,352,402,389,-13,12,37,25.298755712204063,23,48,-71.72316043209028,-22.443101424941307,29.784603799922678,1.7527387854644307,470,440,500,559,59,89,119,152.81182195658994,51,87.7208070314247,15.401180339792738,65.246412567614,114.25130523575163,0.5676552372067905,57500,58139,Scott+Woodford,Scott,21,209,Kentucky,KY
21239,21CS043,220,209,232,237,5,17,28,74.75264155053901,6,26.789700848340527,-3.106494805793205,46.31899592354345,95.14528354381814,0.3381786832465639,272,258,286,301,15,29,43,107.30878002594557,31,114.61106181603076,-62.688644982308105,-8.480664839156983,45.696560572926245,1.0324771062152183,26876,27048,Scott+Woodford,Woodford,21,239,Kentucky,KY
21007,21CS044,91,90,91,96,5,5,6,84.68290640607468,6,93.08338720103426,-20.47379842696066,-8.07682334112792,3.967387635841017,0.9290055493935305,111,110,112,134,22,23,24,297.0141304067338,24,311.72879594752567,-27.589664369865567,-14.71866614215215,-1.440937280998241,1.005567580490541,7735,7699,Southwest Kentucky,Ballard,21,7,Kentucky,KY
21039,21CS044,63,62,63,69,6,6,7,161.01043061646178,4,100.0834028356964,49.81627845790284,60.457356495603236,72.65251718183556,0.5379923318414461,77,76,78,107,29,30,31,625.6074283440879,10,208.59407592824365,404.763309238252,416.78997078779724,428.87602963664784,0.3226678683770872,4796,4794,Southwest Kentucky,Carlisle,21,39,Kentucky,KY
21075,21CS044,86,86,87,111,24,25,25,460.76163833888234,19,354.7533841605726,93.94601212251642,106.1219425022955,119.22622559035487,0.7399438107742407,108,107,108,125,17,17,18,266.8892761715331,14,215.05376344086022,38.907669677476,52.18459969438993,64.82100924990031,0.7619258313302324,6427,6510,Southwest Kentucky,Fulton,21,75,Kentucky,KY
21083,21CS044,394,379,410,471,61,77,92,250.7384770572348,66,216.28116551516968,-17.799659172882055,33.773224162083,85.94418776817781,0.8514488124355851,485,466,504,578,74,93,112,254.9794588944371,52,142.07650273224044,62.7243502015482,111.62378832307333,163.94140486292824,0.5513001664291218,36619,36600,Southwest Kentucky,Graves,21,83,Kentucky,KY
21105,21CS044,57,56,57,76,19,19,20,514.6252784084751,7,187.1657754010695,315.7868275389828,327.7571550867199,340.092665767818,0.3457304807305453,69,69,70,72,2,3,3,64.66347043666683,11,247.85939612438037,-194.7146979906863,-183.54468300304327,-170.94383411691152,2.8425500043033662,4488,4438,Southwest Kentucky,Hickman,21,105,Kentucky,KY
21025,21CS045,176,171,182,183,1,7,12,58.368108492256155,7,62.1761658031088,-52.80783635310042,-3.3060250366981583,48.626272686510916,0.9245469061963665,216,209,223,277,54,61,68,447.6515367289412,47,346.32672610714025,46.52260263684598,101.79025990487388,155.26092581660086,0.7611238651738073,13510,13571,Wolfe and Nearby Counties,Breathitt,21,25,Kentucky,KY
21129,21CS045,94,94,95,124,29,30,30,480.284046138159,16,260.3742880390561,207.9903820449766,220.43950006009692,232.032635772172,0.5243588505887458,117,116,118,150,32,33,34,443.0169017324665,22,295.778435063189,135.3749182438437,147.82912856752915,160.10449502630334,0.6479812982654389,7374,7438,Wolfe and Nearby Counties,Lee,21,129,Kentucky,KY
21165,21CS045,73,72,74,80,6,7,8,135.4607537416232,5,97.13453132588634,25.90673412739294,38.083666891111946,51.434787797507056,0.6271289224824081,90,89,91,127,36,37,38,601.0762865643128,22,355.8718861209964,232.202472573789,244.95115833510584,257.9249625977687,0.5765420345158697,6177,6182,Wolfe and Nearby Counties,Menifee,21,165,Kentucky,KY
21175,21CS045,132,130,133,138,5,6,8,54.07236311138958,7,61.457418788410884,-19.361771706204113,-7.609349648674955,5.049027161393446,0.9778117529520923,164,162,166,183,17,19,21,137.1708857291074,19,137.63129300977906,-13.120057619559052,-0.6507974407781923,12.683254725534903,0.9530286882459932,13668,13805,Wolfe and Nearby Counties,Morgan,21,175,Kentucky,KY
21197,21CS045,169,163,174,163,-11,-6,-0,-52.421265227880156,5,46.23921085080148,-153.26425391717723,-99.30531736616149,-47.0613840792906,-1.071010996486956,208,202,215,218,3,10,16,73.38201876586159,19,144.7508761237239,-121.99212504005924,-73.00045652289296,-20.679117621733646,1.7870371326949492,12976,13126,Wolfe and Nearby Counties,Powell,21,197,Kentucky,KY
21237,21CS045,86,85,87,102,15,16,17,290.3164978234855,4,72.3436322532027,205.6431210514272,218.0515195055228,231.35032330040463,0.23457544711813919,104,103,104,164,60,60,61,926.9428901636137,11,168.86705557261283,746.8193364147204,757.58530985652,769.9564698346892,0.17920837509399368,6635,6514,Wolfe and Nearby Counties,Wolfe,21,237,Kentucky,KY
22001,22CS001,529,504,554,770,216,241,266,497.90404670848693,134,276.6166073179543,170.97391583217248,220.47149322087782,275.94425900589715,0.5532682367939532,646,617,676,882,206,236,265,411.05811817763987,83,144.821328866555,216.41805908857864,265.9670804830825,314.7759772689168,0.35082435251706023,58131,57312,Acadia +Jefferson Davis,Acadia,22,1,Louisiana,LA
22053,22CS001,342,329,356,365,9,23,36,84.51690035068334,56,209.4828392406247,-176.44421506936294,-123.58102958584199,-77.94860664678065,2.3735370569848024,423,407,440,515,75,92,108,283.84042475168326,66,204.2142393019586,29.47595949301305,79.18001464123621,129.75942946011162,0.7117101026247188,32079,32319,Acadia +Jefferson Davis,Jefferson Davis,22,53,Louisiana,LA
22003,22CS002,206,196,215,320,105,114,124,593.8451372639074,53,275.1103036594861,262.8132216075955,318.1936667501417,367.8198772741078,0.45925512095524934,250,238,261,339,78,89,101,393.3467235176272,39,171.89703808180536,170.02254177463286,222.34160533686165,274.3583659827857,0.4321688561191509,23118,22688,Allen+Evangeline,Allen,22,3,Louisiana,LA
22039,22CS002,315,301,329,416,87,101,115,373.15323261047473,57,210.7468572837072,109.17206024970308,162.68379829914917,212.99507538552152,0.5592319278257892,384,368,401,490,89,106,122,327.5273862546884,78,242.0255678292168,36.3052031250144,85.72608707249604,138.18182909959435,0.7320127157847978,32456,32228,Allen+Evangeline,Evangeline,22,39,Louisiana,LA
22005,22CS003,655,601,710,841,131,186,240,175.26282000134623,116,109.51920126513559,15.131626772952965,65.56994445008536,110.52426972027251,0.621537349205298,821,755,887,1009,122,188,254,146.65627660349386,115,89.72668471603455,7.813017152350917,56.01329870350445,109.35613854028281,0.6085784690709304,127101,128167,Ascension,Ascension,22,5,Louisiana,LA
22007,22CS004,180,171,189,226,37,46,55,260.1954302149822,24,136.63535439795046,70.91933487058655,123.29629497814409,173.41475097618934,0.5138820160920218,219,208,230,325,95,106,117,512.1867232899878,31,149.54172696575012,310.60072576723627,363.22356718048235,415.2807953512997,0.2892430300526632,21078,20730,Assumption+St.James+St.John the Baptist,Assumption,22,7,Louisiana,LA
22093,22CS004,167,158,176,210,34,43,52,255.3013450564505,38,225.5081351070669,-17.8169915260232,31.94148157269091,83.27990350785416,0.8632360545290397,202,192,212,254,42,52,62,262.78809677061025,21,106.07132033538741,102.96565723041877,156.49892792585106,209.30451921954852,0.39602625446882067,20221,19798,Assumption+St.James+St.John the Baptist,St. James,22,93,Louisiana,LA
22095,22CS004,349,331,367,440,73,91,109,257.12281651904107,91,257.3954036535062,-53.82308647315857,0.21656668681587712,50.19284584202373,0.9901676451831652,427,406,449,476,27,49,70,115.46421082016145,43,102.04565949973896,-39.07958285720966,11.854695294885701,67.05943486975144,0.8659872774672164,42425,42138,Assumption+St.James+St.John the Baptist,St. John the Baptist,22,95,Louisiana,LA
22009,22CS005,410,393,427,526,99,116,133,350.86734912301046,71,214.8639447204499,80.81421872730188,138.2381404953636,188.0153179601112,0.6071427784729463,500,480,520,627,107,127,147,323.64005193375016,75,190.88340841414063,83.19546304821625,132.50181830544636,183.9172559098798,0.5851995414091161,39653,39291,Avoyelles+East Feliciana+Pointe Coupee+West Feliciana,Avoyelles,22,9,Louisiana,LA
22037,22CS005,219,210,227,278,51,59,68,366.37797060541664,67,414.6894986589642,-97.95567589223354,-48.987832506723635,-3.1782868923133756,1.1130591038909954,268,258,278,293,15,25,35,131.03566456434285,38,196.34184147979744,-119.37357967146477,-64.74152603811496,-16.134269635598358,1.44154301138457,19388,19354,Avoyelles+East Feliciana+Pointe Coupee+West Feliciana,East Feliciana,22,37,Louisiana,LA
22077,22CS005,211,202,220,281,61,70,79,403.79683903516263,45,259.52804344691685,95.62075837734444,144.93329962186854,193.7377695807318,0.6336688814779305,255,245,266,327,61,72,82,351.6302811289066,27,132.32050967900025,168.63159632397495,219.63367621119102,274.60792045419385,0.37113321017405565,20807,20405,Avoyelles+East Feliciana+Pointe Coupee+West Feliciana,Pointe Coupee,22,77,Louisiana,LA
22125,22CS005,120,118,121,149,28,29,31,230.52997036863985,26,203.56234096692108,15.025903128435024,26.698985819287884,39.14911766943329,0.8540147101604586,149,147,151,168,17,19,21,124.20462104533729,14,90.56213209133837,21.19046286526507,33.63294312165668,45.95587070436358,0.6930421215849969,15327,15459,Avoyelles+East Feliciana+Pointe Coupee+West Feliciana,West Feliciana,22,125,Louisiana,LA
22011,22CS006,323,307,339,423,84,100,116,327.0730946809682,54,176.4177397838338,101.01008583663692,148.77015373223227,203.74812024210757,0.5340488339076624,396,377,415,468,53,72,91,197.8249014797593,75,205.01886173527967,-57.488555371947946,-7.466035396846074,44.26556046686779,1.0222397741158007,36731,36582,Beauregard +Vernon,Beauregard,22,11,Louisiana,LA
22115,22CS006,348,327,369,463,94,115,136,283.70054503653165,63,155.88593108852092,80.67318444253463,126.917844334416,181.01880214029615,0.5447225369087576,427,402,451,490,39,63,88,131.73053866054246,75,155.89922673983537,-76.42026640701728,-25.23162044812948,27.59490805504391,1.1650860519708168,48497,48108,Beauregard +Vernon,Vernon,22,115,Louisiana,LA
22013,22CS007,163,157,168,223,55,60,66,558.1846120690074,44,408.1948202551218,97.00934125051495,149.29415596331307,198.43889486769385,0.7193344890164407,197,190,204,264,60,67,74,524.2374665530499,30,234.4849148038143,238.10332297514174,289.6238393081451,341.648235098688,0.44071668985025214,12935,12794,Bienville+Natchitoches+Red River,Bienville,22,13,Louisiana,LA
22069,22CS007,340,324,356,424,68,84,100,268.0774935646511,51,163.47900416711184,54.210576167685005,103.54209145469694,153.8525653919851,0.6026143389739057,415,396,434,533,99,118,137,319.08761679138775,72,194.2114207104901,72.23549647561023,124.6743665039182,174.90796948545514,0.6035440500275644,37436,37073,Bienville+Natchitoches+Red River,Natchitoches,22,69,Louisiana,LA
22081,22CS007,83,82,84,139,55,56,57,871.4476252550635,27,419.47177628171926,439.2584607982914,451.77199859737186,464.76768464436674,0.47291941841614044,100,99,101,135,34,35,36,467.2468590533694,19,250.9244585314316,203.44442943687207,216.25955947618021,227.94334401832526,0.5222659545517956,7724,7572,Bienville+Natchitoches+Red River,Red River,22,81,Louisiana,LA
22015,22CS008,934,879,989,1132,143,198,253,185.02116980460454,169,157.8332944197992,-28.392697668929337,26.60004388573845,79.66440967020723,0.8487710150626879,1155,1089,1222,1379,157,224,290,173.3296960829706,142,110.02037701348911,12.760251349646065,62.452302514755516,113.66679082174423,0.6319215467217673,128490,129067,Bossier,Bossier,22,15,Louisiana,LA
22017,22CS009,2263,2161,2365,3042,677,779,881,394.29680623906955,463,234.29691947624772,110.32965832013491,159.1811172940004,211.55151826808338,0.5934529631590857,2735,2615,2856,3398,542,663,783,283.6711045822131,409,175.033166431292,59.41437767009251,107.1637362977467,157.59443983647446,0.6160990723949126,237135,233670,Caddo,Caddo,22,17,Louisiana,LA
22019,22CS010,1840,1748,1932,2226,294,386,478,217.05196008182585,269,151.229087706312,14.722242840372681,64.86540025321882,116.90888060090154,0.6949414259460696,2181,2074,2288,2454,166,273,380,132.01682487760556,327,158.0427827129228,-80.55344367380563,-25.976722483675935,24.32035749709515,1.192774493048542,213451,206906,Calcasieu,Calcasieu,22,19,Louisiana,LA
22023,22CS011,37,36,38,61,23,24,25,501.3021272174442,3,62.489151189029684,426.42675523202547,438.8319600653968,451.2695865895687,0.11968078919826369,41,40,41,52,11,11,12,218.28571760121278,3,58.15080441946114,148.01638138342253,160.39990767378387,172.24683562378067,0.24467106080808773,5761,5159,Cameron +Vermilion,Cameron,22,23,Louisiana,LA
22113,22CS011,479,454,504,639,135,160,185,333.22277401132436,65,135.3861107736101,148.9030624130681,196.53668781595357,248.68889913848437,0.40376926520640216,587,557,616,778,162,191,221,334.18124537816357,84,146.81208053691276,140.638902595823,187.1898960929046,235.7249273851876,0.43703305441036117,57613,57216,Cameron +Vermilion,Vermilion,22,113,Louisiana,LA
22021,22CS012,104,103,105,125,20,21,22,260.56511269210995,23,285.7142857142857,-37.800060838456474,-25.125176067998225,-12.899178245378248,1.0466205010678264,126,125,128,158,30,32,33,330.6011884773859,16,167.04948841094173,151.53472882667984,163.6125287471414,176.18845658830028,0.4898211816590517,9660,9578,Catahoula and Nearby Parishes,Caldwell,22,21,Louisiana,LA
22025,22CS012,97,97,98,140,42,43,43,571.4290998085468,22,295.26898557208364,263.4342835458199,275.9333501867104,288.9779293453832,0.5048624004027712,118,117,119,147,28,29,30,333.37887762448975,25,283.67184840576425,36.39174703703048,49.729820422324224,62.28053461710517,0.8228913770481634,8941,8813,Catahoula and Nearby Parishes,Catahoula,22,25,Louisiana,LA
22029,22CS012,198,190,206,258,52,60,68,383.40107921405485,43,276.3348149734911,55.93487639775211,105.7337561801222,159.57835183585993,0.7088643978558562,239,229,248,295,47,56,66,305.8630393851474,30,162.9814744390721,91.25786783067821,143.59847371684677,195.53894887596522,0.5235582937341179,18673,18407,Catahoula and Nearby Parishes,Concordia,22,29,Louisiana,LA
22059,22CS012,143,137,149,175,26,32,38,259.5424931612653,25,202.30629172567265,2.5327141217232065,57.49846519640926,105.95933529021096,0.7559044392907786,174,167,182,199,17,25,32,166.0309522363648,19,128.11003978153866,-12.779805313917668,35.74182959851381,89.94362163433154,0.7414908888269354,14829,14831,Catahoula and Nearby Parishes,La Salle,22,59,Louisiana,LA
22107,22CS012,45,45,46,71,25,26,26,743.5904519859195,6,173.99710004833253,558.4549179587208,569.393036730072,581.157718295972,0.22521273522354052,54,54,55,85,30,31,31,754.2736742100853,6,148.00197335964478,593.3221760739077,606.586886049649,618.6539274714498,0.19000416733066564,4138,4054,Catahoula and Nearby Parishes,Tensas,22,107,Louisiana,LA
22027,22CS013,150,144,156,202,46,52,58,436.0503724500445,40,334.8214285714286,46.047865144507504,103.75685897088901,148.74706808644996,0.7533881111813582,180,173,188,202,14,22,29,153.96776626358005,23,163.7243735763098,-60.294659187897956,-10.173160814836615,40.691297253037334,1.0163772936758813,14336,14048,Claiborne+Webster,Claiborne,22,27,Louisiana,LA
22119,22CS013,416,401,432,564,132,148,163,478.6127722727605,77,249.68923958277037,180.42975236082592,232.5062181685958,280.9356901836587,0.5181828264606929,499,480,517,698,181,199,218,549.1719697150896,74,203.95226414574316,292.87868032724384,344.35709640908965,396.46267150188197,0.36952688406629036,37006,36283,Claiborne+Webster,Webster,22,119,Louisiana,LA
22031,22CS014,256,245,268,310,42,54,65,238.97091016700125,53,236.02761077710977,-49.6977778025528,2.6155746996513756,51.59454360328615,0.9696141604920137,314,300,328,376,48,62,76,230.76049308186916,57,211.81716833890746,-32.42960898788244,20.061269273507556,70.87078145812897,0.9033617129150066,26946,26910,De Soto+Sabine,De Soto,22,31,Louisiana,LA
22085,22CS014,222,212,231,339,108,117,127,628.4103393350007,48,257.38415478797083,319.95459007892543,371.16897074355614,422.3852015161358,0.40611441967108075,270,258,281,374,93,104,116,471.1901871707974,51,230.42515700537658,189.43337214561876,240.42851293612247,294.93866435553485,0.48438327370530354,22379,22133,De Soto+Sabine,Sabine,22,85,Louisiana,LA
22033,22CS015,3381,3185,3576,4176,600,795,991,210.45622258263785,522,138.12172969683337,17.96856507950451,72.17330875639162,126.70520862522538,0.6554726169860553,4155,3921,4389,5069,680,914,1148,201.4098998977919,538,118.58631011422197,30.464415697954493,81.9546835164175,131.33804379048564,0.5881372890326828,453513,453678,East Baton Rouge,East Baton Rouge,22,33,Louisiana,LA
22043,22CS016,186,177,196,235,39,49,58,263.58463723640955,38,205.65552699228792,4.2184535845227,58.43220833437018,108.33935691606794,0.7645282804337307,229,218,241,282,41,53,64,237.34317750165778,33,148.5148514851485,35.03052281411453,88.42411816597257,136.91051940880928,0.61409454113689,22173,22220,Grant+Jackson+Winn,Grant,22,43,Louisiana,LA
22049,22CS016,156,150,163,200,37,44,50,348.6543077697559,17,135.18886679920476,162.91922998231504,213.91837531760348,266.43898628209854,0.3790980566654024,189,181,197,224,27,35,43,235.12088482348335,16,107.44023636852002,71.64470519968329,128.2380204003456,182.2823885017921,0.4442691781814676,15090,14892,Grant+Jackson+Winn,Jackson,22,49,Louisiana,LA
22127,22CS016,148,142,154,210,56,62,68,538.8637111699917,29,253.4226623944072,237.1475731918135,288.0851003633413,337.6587824392527,0.4627858669756646,179,172,186,211,25,32,39,239.08258656995253,21,155.30247004880934,31.763807250474617,85.59168574696876,136.21101998116598,0.6300866868981327,13732,13522,Grant+Jackson+Winn,Winn,22,127,Louisiana,LA
22045,22CS017,621,591,651,802,151,181,211,311.7071889410811,81,139.5869833701927,120.16402629742589,172.88196193775525,221.6327445594603,0.44535228714561625,757,721,792,928,136,171,207,247.94624539821058,100,144.75131723698684,53.72694853493733,101.4707165329662,154.79959572740356,0.5804127499687249,69634,69084,Iberia,Iberia,22,45,Louisiana,LA
22047,22CS018,260,247,273,393,120,133,146,523.1849484327468,56,220.87099424815116,254.67989150092032,301.36907793064654,350.81722556916924,0.419007422324179,313,298,329,435,106,122,137,408.07113126914015,54,180.81971604607554,179.52978204821417,227.06595467122617,280.548230374482,0.43950190140524253,30425,29864,Iberville+West Baton Rouge,Iberville,22,47,Louisiana,LA
22121,22CS018,185,174,197,249,52,64,75,280.3938982365403,40,176.50952415974112,49.00347591121881,103.68621757126004,156.4688699828421,0.6197521463253215,231,217,245,285,40,54,68,195.4691648391455,26,93.82555663815813,53.65360437927119,102.43535191836943,149.29204999645106,0.4713008569594657,27194,27711,Iberville+West Baton Rouge,West Baton Rouge,22,121,Louisiana,LA
22051,22CS019,3648,3459,3836,4495,659,847,1036,231.9043849069491,592,162.0567335439645,19.067377154641434,69.18234072522222,119.93014474914956,0.697984491348228,4445,4220,4669,5112,443,667,892,153.55468553978656,415,95.49318201690805,8.428072208905498,56.91956714385105,106.59793854932776,0.6209533613157441,438365,434586,Jefferson,Jefferson,22,51,Louisiana,LA
22055,22CS020,1537,1433,1642,1930,288,393,497,194.23966049650255,134,66.27074566952822,78.66379722675542,127.8126994144055,179.67432422294175,0.34031381976963015,1911,1785,2037,2416,379,505,631,207.03495127258606,184,75.44570369519936,81.1496324857877,131.09979478683456,181.56129902628678,0.36369018362982114,242641,243884,Lafayette,Lafayette,22,55,Louisiana,LA
22057,22CS021,767,725,809,953,144,186,228,228.53932474181184,132,162.43821400004103,17.503049652501993,65.91125309173479,117.07334259934775,0.7069603189510069,944,894,995,1215,220,271,321,277.70780682038367,150,153.8414202639919,70.83597081895776,124.21022706220215,175.50493472419782,0.551930307863011,97514,97503,Lafourche,Lafourche,22,57,Louisiana,LA
22061,22CS022,344,323,364,437,73,93,114,232.79016176639084,68,169.84784463917742,7.093388495676252,62.7897077683627,111.78161156888453,0.7218723409867243,426,401,451,490,39,64,89,133.10177566837174,33,68.51021425012456,12.247306079531192,65.65757032790805,119.75486225465244,0.5068154132943469,48043,48168,Lincoln+Union,Lincoln,22,61,Louisiana,LA
22111,22CS022,225,216,234,351,117,126,135,712.231778237117,52,293.53655094552636,367.87513409595465,418.73564196791307,472.1265250483364,0.4088954914902936,274,263,285,350,65,76,87,359.6015323897989,34,161.16799393249906,146.1740748180962,199.65737094809964,249.07470949377299,0.44235387843663443,21258,21096,Lincoln+Union,Union,22,111,Louisiana,LA
22063,22CS023,957,895,1018,1142,124,185,247,155.45434766583057,119,99.94470845960566,4.298694221226197,55.24556768901106,108.1932456714304,0.6394651637996916,1199,1124,1274,1590,316,391,466,269.04025480456045,250,171.96667973613432,42.83860877219932,96.23130910356657,148.31510249297355,0.6375556199509906,142879,145377,Livingston,Livingston,22,63,Louisiana,LA
22035,22CS024,76,75,77,82,5,6,7,101.72491041300934,19,312.97185998627316,-223.21243824348764,-211.29436259170865,-198.74928961088304,2.6478807352638154,93,92,93,116,23,23,24,323.306504401638,19,262.2860298177802,47.71726998951841,61.0046172434389,73.1110199950377,0.7780404813172961,7285,7244,Northeast Louisiana,East Carroll,22,35,Louisiana,LA
22041,22CS024,228,220,236,286,50,58,66,352.31662938438643,55,334.07572383073494,-33.3448444926816,19.564297731457295,70.3242872854165,0.932155027031636,278,268,288,314,26,36,46,181.83966511571256,46,233.7873551534865,-101.56474138612487,-52.48824516054135,-1.6080876622069997,1.2507214586833915,19756,19676,Northeast Louisiana,Franklin,22,41,Louisiana,LA
22065,22CS024,101,100,102,118,16,17,18,201.64328724150639,18,214.51981328831062,-24.91856354044904,-12.911948339491607,-1.060621912771289,1.0044893889641326,121,120,122,147,25,26,27,264.17129971285584,32,325.9319617029945,-73.68773782675993,-62.07923450392628,-49.060617931090825,1.187986271760575,10069,9818,Northeast Louisiana,Madison,22,65,Louisiana,LA
22067,22CS024,314,304,325,405,80,91,101,429.3428461036093,44,208.67915579796065,167.08010529597425,220.5248394309977,273.09720493036133,0.4807327813232335,381,368,394,505,111,124,137,495.3815882896169,62,247.16951044490514,195.6156928589985,248.02241231283753,298.9319810344744,0.4949644646230066,25302,25084,Northeast Louisiana,Morehouse,22,67,Louisiana,LA
22083,22CS024,197,189,206,250,44,53,61,317.0849939274545,45,270.01350067503375,-4.884475783843562,45.522874964651876,98.08769570849455,0.8357344197880014,240,230,251,303,52,63,73,316.0457279228924,42,211.76826501285734,55.98473392498366,105.68010691626648,156.5136158840881,0.6595337648327283,19999,19833,Northeast Louisiana,Richland,22,83,Louisiana,LA
22123,22CS024,121,116,125,156,31,35,40,430.5688634612144,35,425.96348884381337,-49.59067312569091,2.895372346092986,56.13234965116345,0.9621091645787962,145,140,150,159,9,14,19,147.46169444762856,17,176.91747320220625,-78.21367312624886,-28.168040198266187,23.03871818697514,1.12066280442609,9860,9609,Northeast Louisiana,West Carroll,22,123,Louisiana,LA
22071,22CS025,2785,2621,2950,3765,815,980,1144,306.30481439981446,548,171.35040062536643,85.01144903825578,134.8662506934,190.69324460527858,0.558840907513511,3386,3191,3582,4069,487,683,878,180.61393151608686,261,69.06753534749438,62.91207931319813,112.97435509644949,160.6338626457831,0.38184479176231434,383775,377891,Orleans,Orleans,22,71,Louisiana,LA
22073,22CS026,1396,1328,1465,1726,261,330,398,249.02018931506444,274,206.90696737817154,-8.947017075965029,41.90399851967292,93.8242739191058,0.828372330268992,1712,1630,1794,2054,260,342,424,215.246105455993,282,177.41651357676724,-14.409138685332373,36.501121877600376,87.4079757075499,0.8218474333104225,158912,158948,Ouachita,Ouachita,22,73,Louisiana,LA
22075,22CS027,162,151,172,209,37,47,58,243.26217402386416,20,102.47651579846284,88.24393662908945,141.14941086956574,193.6778161725796,0.41256961292217975,198,186,210,223,13,25,37,105.93971179952771,20,85.73755733699147,-33.740701108763915,19.369477536141588,70.44830538764671,0.77783008252812,23420,23327,Plaquemines+St. Bernard,Plaquemines,22,75,Louisiana,LA
22087,22CS027,305,286,324,379,55,74,93,201.1274114199332,42,113.58770368033173,33.87700295102076,88.4876140027319,138.66163602424234,0.5572617167194437,376,353,398,489,91,113,136,256.41015902178367,47,106.34205941579746,100.37273625733279,149.047788328733,200.15709497951764,0.4111065310766823,44371,44197,Plaquemines+St. Bernard,St. Bernard,22,87,Louisiana,LA
22079,22CS028,1261,1205,1317,1626,309,365,421,337.9829658305689,211,195.46689723320156,88.92924684615244,141.2206863078657,197.8034790603789,0.5767527442881969,1537,1471,1604,1973,369,436,502,338.1860403743353,241,187.12197091456832,103.29773393392507,151.30114700045183,202.12002292505343,0.5520433142516796,129536,128793,Rapides,Rapides,22,79,Louisiana,LA
22089,22CS029,364,341,386,463,77,99,122,226.5556377477987,57,130.16670472710663,41.51924425265853,98.35717261110035,148.47215231429777,0.5688128093427369,449,422,476,502,26,53,80,102.03334303199104,43,82.20068436848847,-29.081831136963014,20.263403684638448,67.32229416206965,0.7908095123773516,52548,52311,St. Charles,St. Charles,22,89,Louisiana,LA
22091,22CS030,111,110,112,136,24,25,26,282.33899659746527,3,33.385885189650374,237.3052244633882,248.77485964595795,261.1404675803924,0.11376343537155488,137,136,139,172,33,35,36,317.6405329069112,19,174.16811806765057,131.25314889821894,143.36902703574083,155.37143364946624,0.5329383122036555,10783,10909,St. Helena +Tangipahoa +Washington,St. Helena,22,91,Louisiana,LA
22105,22CS030,1102,1044,1159,1323,164,221,279,198.32302210572476,155,138.8971862118406,5.471215104364057,59.670060079681576,108.6532639104164,0.6972080649635183,1369,1300,1439,1774,335,405,474,299.71377708617695,286,211.89266080874836,33.019837293943866,90.81679637103896,139.31937463259698,0.7052400533416322,133912,134974,St. Helena +Tangipahoa +Washington,Tangipahoa,22,105,Louisiana,LA
22117,22CS030,510,490,529,630,101,120,140,316.9176601145248,79,208.53497580290363,56.74508392636225,109.4926212432086,162.55273898872602,0.6525745070200045,621,598,644,758,114,137,160,303.32423365857335,110,243.53524619199433,9.963162325084074,59.18145384429907,111.14310836533583,0.7970697405767193,45460,45168,St. Helena +Tangipahoa +Washington,Washington,22,117,Louisiana,LA
22097,22CS031,857,822,892,1109,217,252,287,367.83678058258727,168,245.13320606510135,71.10587506435951,123.1308719848512,170.59576853959945,0.6637853318850205,1048,1006,1090,1249,159,201,243,244.78283275702995,122,148.59926918392205,46.51161966448483,96.92412378168333,145.61871588236048,0.6040599591951128,82241,82100,St. Landry,St. Landry,22,97,Louisiana,LA
22099,22CS032,412,389,434,580,146,168,191,389.7412570247994,82,189.69406049389855,150.02005813880973,198.12772558510082,251.46466099689454,0.48384602774313124,504,478,531,631,100,127,153,245.6283844306439,62,120.27391413994451,73.30764728536978,125.50383227961262,178.39904480348025,0.4858211685804953,51873,51549,St. Martin,St. Martin,22,99,Louisiana,LA
22101,22CS033,465,444,486,589,103,124,145,303.112727632465,87,212.7659574468085,38.31672010770477,92.04709780861921,139.009745176568,0.6963186670130843,562,537,587,717,130,155,180,319.66194837488064,112,231.57720618641966,39.48245578516064,88.77496492375809,135.33520400127966,0.719788309020155,49068,48364,St. Mary,St. Mary,22,101,Louisiana,LA
22103,22CS034,2000,1886,2114,2355,241,355,469,160.7003491750888,259,117.34146820302944,-9.643640677086898,44.08148040885908,94.83655364545068,0.728135208661451,2499,2360,2637,2956,319,457,596,170.1747689268432,307,114.23765898384299,4.986808273551048,56.22473713771935,104.79827030009545,0.6698314266722383,264868,268738,St. Tammany,St. Tammany,22,103,Louisiana,LA
22109,22CS035,872,825,919,1054,135,182,229,199.19022034829732,116,127.188333759731,23.37225785484994,72.5277579416906,122.92302462609649,0.6350314417144974,1068,1012,1125,1393,268,325,381,298.28078930615357,171,157.17345147384577,92.53199985651537,140.34129414501732,191.10906404978095,0.5253124566809991,109444,108797,Terrebonne,Terrebonne,22,109,Louisiana,LA
23001,23CS001,1042,994,1089,1032,-57,-10,38,-10.48621912591232,23,24.943966452172653,-85.87686473657494,-35.73801726925103,10.823321287566559,-2.6531339561489973,1282,1225,1339,1480,141,198,255,178.39680274212995,150,135.09253838879633,-8.181353178364196,44.5413973771357,92.93718737625227,0.7534550058858251,110648,111035,Androscoggin,Androscoggin,23,1,Maine,ME
23003,23CS002,733,704,762,796,34,63,92,112.8038967664795,21,37.61530883362689,25.457737600431148,71.93706770538105,127.67470195333213,0.32824534551534773,892,857,926,1107,181,215,250,321.5916993216806,94,140.5523407945693,129.83544340927355,180.5945912284239,236.26481025800476,0.43502947567034145,66994,66879,Aroostook,Aroostook,23,3,Maine,ME
23005,23CS003,2397,2267,2527,2469,-58,72,202,28.62555151364309,106,42.05612111633874,-66.5682327033136,-14.781794370322462,35.80288563161466,1.4490963993830939,2965,2807,3122,3102,-20,137,295,45.08446709102435,171,56.07458247390564,-63.339127831186126,-9.054959507548556,38.750128091769795,1.234786017000023,302453,304951,Cumberland,Cumberland,23,5,Maine,ME
23007,23CS004,295,283,308,285,-23,-10,2,-41.90605604751363,4,16.250253910217346,-109.0192577431835,-56.76505897059329,-7.864605373971461,-0.4294068228553786,364,349,379,410,31,46,61,155.59164168057785,40,134.91635186184567,-30.61170682518971,21.066869018281622,77.0837160859212,0.8487197394444302,29538,29648,Franklin+Oxford,Franklin,23,7,Maine,ME
23017,23CS004,583,558,608,608,0,25,50,52.26976809725018,32,66.27888913820185,-61.278943606505635,-12.21653656087053,37.47524774802593,1.2196851255208836,721,691,752,849,97,128,158,217.95629570110958,91,155.51567974023754,11.074528178301476,63.42465917067535,111.51378198745878,0.7079666593442061,57937,58515,Franklin+Oxford,Oxford,23,17,Maine,ME
23009,23CS005,534,510,558,575,17,41,65,88.40240300500382,27,58.39626552277274,-21.21044961629473,31.09655716004025,84.43530344967793,0.6447978659742982,660,631,689,753,64,93,122,166.02750152490452,44,78.45234911295356,38.000459360851906,88.83587407680068,137.49511164547488,0.4675055773666296,55483,56085,Hancock+Washington,Hancock,23,9,Maine,ME
23029,23CS005,362,349,376,429,53,67,80,257.2484253981378,2,7.716793672229189,194.77360803362401,248.9595932004524,296.9591842964375,0.029554163335135133,442,426,458,530,72,88,104,282.6981977939356,38,122.13936744664437,106.17371131784873,159.81548311107514,208.5753461092021,0.42719158386762635,31101,31112,Hancock+Washington,Washington,23,29,Maine,ME
23011,23CS006,1153,1100,1206,1193,-13,40,93,39.00118857827015,34,33.0070382655125,-44.15334449345952,5.94061128784037,57.32280394966793,0.8257543186501357,1418,1354,1483,1629,146,211,275,169.29927678315528,124,99.69528618175094,21.431654496133984,68.37587222600035,117.12039260705458,0.5860868258446749,123610,124379,Kennebec,Kennebec,23,11,Maine,ME
23013,23CS007,436,419,454,390,-64,-46,-29,-137.53216152518343,5,14.80056242137201,-201.71005087994908,-152.35780116107722,-103.2131814937199,-0.10998244083266308,538,517,560,539,-21,1,22,1.2301430490475815,19,46.32451542118737,-93.33219844138036,-44.100135260629216,7.08203668132529,12.628417953745366,40539,41015,Knox+Waldo,Knox,23,13,Maine,ME
23027,23CS007,357,340,374,388,14,31,48,92.78428795361391,20,60.48234671505254,-18.919780667161785,31.51180576296925,83.18921646374834,0.6312843485118032,440,419,461,529,68,89,110,223.2497076787028,32,80.25682182985554,90.58608598844658,142.0373975594779,190.8208983751894,0.3554997679816386,39681,39872,Knox+Waldo,Waldo,23,27,Maine,ME
23015,23CS008,355,340,371,384,13,29,44,97.37285155005068,3,10.231923601637106,39.068177247532894,85.73760456175405,137.6284481320995,0.10152380436901022,439,420,457,453,-4,14,33,39.74777794804896,18,50.37078494473206,-59.390137592611865,-10.956018270757522,37.69912325931806,1.1839092175461032,35184,35735,Lincoln+Sagadahoc,Lincoln,23,15,Maine,ME
23023,23CS008,317,302,333,302,-31,-15,0,-50.20089490207949,3,9.826400262037339,-111.36434717335082,-60.09246045563838,-6.201535505557389,-0.20940459469078088,391,372,410,437,27,46,65,125.31853964737718,21,56.73375658516817,16.194993999002985,68.93928114896977,119.86763442784863,0.44316271984254,36636,37015,Lincoln+Sagadahoc,Sagadahoc,23,23,Maine,ME
23019,23CS009,1433,1368,1499,1529,30,96,161,75.65716750157588,34,26.831690330726886,1.3361432386809369,47.017852095055105,99.57592970484171,0.350987269414229,1765,1687,1844,1999,155,234,312,152.98631348078976,211,138.22107511103542,-32.72970204697021,14.946624813254106,63.55139791624366,0.8996343720359353,152059,152654,Penobscot+Piscataquis,Penobscot,23,19,Maine,ME
23021,23CS009,209,202,217,203,-14,-6,1,-45.81683172814307,4,28.527279210745277,-123.94515313756854,-74.76420638118772,-22.32759603614027,-0.7374245939413253,260,251,269,302,33,42,51,246.3146698352109,36,210.44017069036065,-14.809432685317898,35.39774117842697,86.35052701532774,0.8345494076526745,16826,17107,Penobscot+Piscataquis,Piscataquis,23,21,Maine,ME
23025,23CS010,523,501,545,559,14,36,58,85.87969650337557,19,45.17445661865229,-13.687366866508302,40.347232436265934,89.93122294359787,0.5118495227377516,640,614,666,774,108,134,160,265.41619103799366,65,128.54741421932167,81.98924951637395,140.18615585463348,188.94061522120072,0.48074186191328816,50471,50565,Somerset,Somerset,23,25,Maine,ME
23031,23CS011,1860,1769,1951,1901,-50,41,132,23.268408681940787,82,46.46989374262102,-72.57255741013209,-22.555472370659,27.520302373265793,1.949640029900811,2306,2195,2417,2367,-50,61,172,28.492410549798933,176,82.15622753540653,-103.75519115885747,-54.93440629652502,-5.127064413644914,2.8369639642541524,211750,214226,York,York,23,31,Maine,ME
24001,24CS001,741,712,770,995,225,254,283,446.0974779717129,161,282.8655510168226,111.96997491561623,164.6061401894942,215.74450863726844,0.6316015800760817,900,865,935,1055,120,155,190,228.27159768713258,140,206.60852112572127,-30.77103582264337,21.646783901185422,75.72103560042544,0.8992856744062883,68301,67761,Allegany+Garrett,Allegany,24,1,Maryland,MD
24023,24CS001,284,271,296,376,80,92,105,383.95285266735453,49,204.18793624335865,132.50768669417178,177.7672686348646,229.63681346885096,0.5260949210442427,347,332,361,396,35,49,64,172.10077362236413,56,195.0471944550869,-72.83721482938307,-23.856187976067766,25.366746467337705,1.1108498604994084,28797,28711,Allegany+Garrett,Garrett,24,23,Maryland,MD
24003,24CS002,3871,3618,4124,4228,104,357,610,72.81237298218954,356,72.69781736375116,-51.269133530980255,0.5988540989846515,56.42151174490914,0.995634375519585,4800,4496,5105,4995,-110,195,499,32.9797322492276,412,69.8178465939228,-89.48616129008812,-35.416473721570846,16.044723692579854,2.1061703223245387,587638,590107,Anne Arundel,Anne Arundel,24,3,Maryland,MD
24510,24CS003,5384,5133,5634,6749,1115,1365,1616,280.5048619211424,684,140.52051483100902,83.66644650298234,141.31560557927736,191.9812032175713,0.5005890920108931,6540,6242,6839,7538,699,998,1296,172.73885200274677,604,104.59508368472548,17.705670100638894,68.66015972133405,116.8773082237542,0.6049034767448118,584114,577465,Baltimore (city),Baltimore (city),24,510,Maryland,MD
24005,24CS004,7313,6948,7679,8384,705,1071,1436,151.3197363427192,889,125.63905975628283,-24.081029586782382,26.949595212055705,79.53702982976318,0.8295139198395466,8968,8530,9407,9467,60,499,937,58.677339084584915,863,101.54565907015711,-89.77909361855068,-44.288651514137676,7.028932871842587,1.727113708418882,849099,849864,Baltimore (county),Baltimore (county),24,5,Maryland,MD
24009,24CS005,614,574,654,711,57,97,137,125.464113633141,52,67.1400903808909,9.064248735185567,58.11410654993938,108.51110017788865,0.5296828352416949,765,717,814,860,46,95,143,100.80556457542777,61,65.05140127116836,-15.92526695998624,35.183616345403124,86.41322776792104,0.6385602855582013,92940,93772,Calvert,Calvert,24,9,Maryland,MD
24011,24CS006,292,278,307,347,40,55,69,196.58456002129242,15,54.00216008640345,91.87084676168834,144.83621234092715,194.15976043919358,0.2697616700979596,360,343,378,436,58,76,93,226.3249046215467,58,173.79839386311878,4.2080916928103695,54.93218637101535,104.9278773286627,0.7578811752720946,33332,33372,Caroline+Dorchester+Talbot,Caroline,24,11,Maryland,MD
24019,24CS006,354,340,368,379,11,25,39,92.60935310733335,27,99.96297667530544,-60.27625232934113,-8.387214943535428,48.50533963461466,1.0379111950605948,434,417,451,493,42,59,76,181.12945078463747,57,175.4277976117198,-47.24671487787366,4.670363314517808,57.50420226607761,0.9523398808508241,32412,32492,Caroline+Dorchester+Talbot,Dorchester,24,19,Maryland,MD
24041,24CS006,391,375,407,458,51,67,83,214.88300857679909,1,3.2056419297964416,160.67673121572858,210.722252152356,264.6256142483547,0.014698802172190502,481,462,501,556,55,75,94,198.93095103923534,52,138.294194303343,9.078497566500792,59.86136523965797,114.16622350712406,0.6860155876781049,37434,37601,Caroline+Dorchester+Talbot,Talbot,24,41,Maryland,MD
24013,24CS007,1411,1337,1485,1557,72,146,220,101.50178640579392,178,123.90366142280385,-74.00885713559535,-18.615364728530942,28.224119692203992,1.2123898090911085,1746,1656,1836,1887,51,141,231,81.12073162827325,132,75.97996891728545,-48.85588905028026,5.939800658827939,55.82711325253337,0.9300290721186969,172392,173730,Carroll,Carroll,24,13,Maryland,MD
24015,24CS008,868,823,913,1040,127,172,217,199.1465218772572,93,107.65654090659154,38.99046852402825,91.82488598396856,148.45061040892128,0.5374654370313644,1071,1018,1125,1248,123,177,230,170.04105477407043,144,138.62015190458314,-14.426446407188813,29.423011653373383,79.81034202863381,0.8106266483499063,103663,103881,Cecil,Cecil,24,15,Maryland,MD
24017,24CS009,992,920,1063,1223,160,231,303,166.7492286912634,153,110.29544280376302,5.710003387482287,56.38445053602529,107.12510844016114,0.658597765356317,1244,1157,1331,1476,145,232,319,137.55546481087958,160,95.00961972399706,-8.677648841694229,44.74306156958515,96.45700885587357,0.6877315843263095,166462,168404,Charles,Charles,24,17,Maryland,MD
24021,24CS010,1720,1603,1838,1873,35,153,270,67.3598741976208,189,83.4719625480295,-69.25850298195371,-17.57647885504893,36.058369840921934,1.2311222026751263,2172,2028,2316,2209,-107,37,181,13.356120837370014,205,73.52941176470588,-109.45798308349,-59.85653347161054,-10.781410975870449,5.361318208622737,271708,278800,Frederick,Frederick,24,21,Maryland,MD
24025,24CS011,1913,1801,2025,2163,138,250,362,115.04230461401237,158,72.7805949122679,-11.791010658360541,42.22711850178967,96.82939626661532,0.6301189744519992,2372,2236,2508,2606,98,234,370,89.02600307081381,231,87.93099510479395,-53.19093595448792,0.9177558361071271,54.18981679675214,0.9834949468141898,260509,262706,Harford,Harford,24,25,Maryland,MD
24027,24CS012,1522,1379,1665,1734,69,212,355,76.51826315619446,178,64.35227447329652,-37.05220848788471,12.746694698772183,60.44903742765456,0.8370505712820431,1913,1741,2086,1994,-92,81,253,24.110500942707073,93,27.822236848009812,-55.00272957013781,-3.320767930022876,46.28710143161505,1.1398041349201102,331923,334265,Howard,Howard,24,27,Maryland,MD
24029,24CS013,221,213,229,285,56,64,72,400.7237872117726,34,212.53320831379904,140.21205016962054,187.9030531581624,238.04454998076602,0.5222269957553977,272,262,282,315,33,43,53,225.16582843412456,23,119.47431302270012,52.15654701550697,105.88742790806701,155.44224558691923,0.5186409287635851,19197,19251,Kent+Queen Anne's,Kent,24,29,Maryland,MD
24035,24CS013,380,359,402,392,-10,12,33,27.810359892444637,27,64.59845282717919,-88.49489343977523,-36.65881864102338,15.691681177133082,2.1388165749404826,476,450,502,523,21,47,73,92.44011659637667,48,94.71378677558752,-54.675386477643606,-1.9478666379598344,48.92857733295087,1.0031824565273335,50156,50679,Kent+Queen Anne's,Queen Anne's,24,35,Maryland,MD
24031,24CS014,5402,4946,5857,6588,731,1186,1642,134.40016973034656,1118,126.67359078462846,-48.41958350493599,6.413643852838447,57.31595058740251,0.9417167478362778,6689,6143,7234,7012,-222,323,869,30.640030435001748,565,53.5157985267527,-75.6069413934012,-24.352253445450433,28.322156734783082,1.7412147766179171,1059100,1055763,Montgomery,Montgomery,24,31,Maryland,MD
24033,24CS015,5499,5087,5912,7260,1348,1761,2173,220.85139838770678,1249,156.67204656258102,11.100682884330983,65.79812381547332,113.90504268150866,0.7089975996237945,6813,6319,7307,7624,317,811,1305,84.78944645044831,734,76.71348558277688,-49.88153288529631,8.039899539648282,56.90419089200515,0.9036389033767964,956648,956807,Prince George's,Prince George's,24,33,Maryland,MD
24037,24CS016,719,670,768,855,87,136,185,142.88577825641755,88,92.64864580317426,1.5440121841575596,50.30108739451593,101.71121012242985,0.6436678095528235,894,835,953,1051,98,157,216,136.98017387962236,89,77.80196340685183,7.0821869121233005,59.38544695310738,109.02945962099372,0.5643779944278431,113979,114393,St. Mary's,St. Mary's,24,37,Maryland,MD
24039,24CS017,220,210,231,300,69,80,90,387.7050934644167,17,82.52093361919017,251.76538306643374,304.4817600972292,359.01019107895166,0.2102126755373313,269,256,282,312,30,43,56,174.7212536886662,31,126.10853470018714,-2.9175463428984005,49.40139330132773,100.67564953627169,0.7053473289489622,24721,24582,Somerset+Worcester,Somerset,24,39,Maryland,MD
24047,24CS017,550,528,573,614,41,64,86,145.58877265139455,53,121.16593636883216,-24.695811394684874,25.924726286801118,78.84302258854588,0.8193812338635069,679,652,707,744,37,65,92,122.28834074574692,70,131.99577613516368,-64.15846484522943,-9.18595760441689,42.36945521519499,1.0629904954263738,52490,53032,Somerset+Worcester,Worcester,24,47,Maryland,MD
24043,24CS018,1406,1340,1473,1660,187,254,320,197.4147626884973,143,111.34975893685638,35.165371726716344,84.91995493887599,137.9865816000429,0.5618236569547929,1735,1655,1815,2025,210,290,370,187.11463937422943,272,175.61303151995662,-39.21071060510838,11.462731346445967,61.6492811876429,0.9353045048216085,154109,154886,Washington,Washington,24,43,Maryland,MD
24045,24CS019,862,817,906,1033,127,171,216,198.40065010222324,83,96.13621227184541,52.63099195385865,103.71884694116403,152.19383536450965,0.4817435039748744,1064,1010,1118,1255,137,191,245,183.93980701216145,151,145.32365792158296,-15.8109408367245,39.31526051705993,90.48006173564927,0.7859487116051309,103603,103906,Wicomico,Wicomico,24,45,Maryland,MD
25001,25CS001,2675,2577,2773,2625,-148,-50,48,-26.379887731543917,197,104.14647470350856,-185.85670178968672,-130.4450256154879,-77.2607566332981,-4.028686184029793,3313,3193,3432,3312,-120,-1,119,-0.2526234363937721,199,85.8095201134928,-141.9923685159705,-86.96715494165186,-37.42770201658422,480.50975771319776,226988,231909,Barnstable+Dukes+Nantucket,Barnstable,25,1,Massachusetts,MA
25007,25CS001,151,149,153,143,-10,-8,-6,-46.82885386641614,7,41.62537165510406,-100.6418060437709,-88.60400448159865,-76.7291474295222,-1.0181740787947067,193,190,195,171,-24,-22,-19,-103.83802303960339,6,28.54152792312815,-145.07118711012964,-132.52920243313451,-119.8452835069985,-0.28806227855691413,20180,21022,Barnstable+Dukes+Nantucket,Dukes,25,7,Massachusetts,MA
25019,25CS001,77,76,78,64,-14,-13,-12,-113.10087994376426,8,69.33911159263272,-194.2940090100914,-182.05458779434605,-171.0632883244211,-0.6639547422211666,99,97,101,91,-10,-8,-6,-55.25973985256192,3,20.75406433759945,-88.10401492950011,-76.28170723418953,-62.61871172301059,-0.42931995430938097,13845,14455,Barnstable+Dukes+Nantucket,Nantucket,25,19,Massachusetts,MA
25003,25CS002,1339,1284,1394,1386,-8,47,102,44.164924872631495,121,113.23314955042072,-123.2833494545341,-69.93725324065154,-14.535724963064501,2.5106718765142104,1642,1575,1708,1760,52,118,185,91.97560262661287,128,99.4777418552599,-59.949887103027706,-7.758070174778819,39.82614800968684,1.0725042410080057,128231,128672,Berkshire,Berkshire,25,3,Massachusetts,MA
25005,25CS003,4766,4517,5014,5477,463,711,960,147.8978516929904,777,161.5320248846633,-62.127512542764,-12.718593840140198,39.376157373861744,1.0906533463177694,5869,5570,6169,6249,80,380,679,65.49838129002661,669,115.34104917252711,-98.59803008423312,-49.80946928451091,0.005596573241301044,1.7563524081921302,577223,580019,Bristol,Bristol,25,5,Massachusetts,MA
25009,25CS004,6102,5755,6449,7072,623,970,1317,144.36383573210753,1242,184.8782859808076,-89.45462337183017,-41.10433593792326,9.016034030680824,1.2793221457363166,7509,7092,7925,7483,-442,-26,391,-3.1764889041898448,631,78.15335149067299,-132.41161642807603,-81.13913517861091,-29.05718146804103,-25.601951720641097,806152,807387,Essex,Essex,25,9,Massachusetts,MA
25011,25CS005,607,577,638,705,67,98,128,165.3476778737076,70,118.49845528799356,-2.2036087082815037,45.53801681676589,96.59930970748042,0.7093994935467861,745,708,782,717,-65,-28,9,-39.57809680319284,26,36.61404571122784,-128.18120178818285,-75.72741904444707,-25.901182020748074,-0.9592396097254414,70887,71011,Franklin,Franklin,25,11,Massachusetts,MA
25013,25CS006,3896,3696,4096,4817,721,921,1121,237.74095645376633,751,193.8885936622612,-8.847325677609833,43.933134227061636,96.85153879079618,0.8146609333393082,4769,4530,5008,5148,140,379,618,81.83378806584145,448,96.75252733582846,-64.27751067194905,-13.839416892271156,34.413112228461884,1.1791933939454295,464803,463037,Hampden,Hampden,25,13,Massachusetts,MA
25015,25CS007,1109,1039,1179,1246,67,137,207,101.44700059273319,149,110.4085362841476,-60.215868714431274,-8.084091530250204,42.63824966674915,1.0804452480357716,1368,1285,1452,1404,-48,36,119,22.235442020346564,93,57.53383979609512,-89.76498352823933,-34.74524371738917,15.920041507775872,2.5174422270921486,161944,161644,Hampshire,Hampshire,25,15,Massachusetts,MA
25017,25CS008,10013,9313,10712,11522,810,1509,2209,111.4489156022606,2117,156.30874114364295,-98.72775429634132,-44.7576456598799,7.301086441089472,1.4015861361827329,12299,11465,13134,12202,-932,-97,737,-6.0286519309795,823,50.90040528597308,-105.8717574432926,-56.681314268656436,-5.462096537550928,-8.530597067620423,1625245,1616883,Middlesex,Middlesex,25,17,Massachusetts,MA
25021,25CS009,5146,4835,5458,5757,299,611,922,101.34046949790914,926,153.66829111788428,-106.57477954922291,-53.29445870370161,2.3112423328170726,1.513877587066012,6333,5959,6707,6186,-521,-147,227,-20.239719102138984,374,51.6056390889259,-126.07510291281038,-71.75253543776604,-20.636680920298044,-2.5672229904287898,723116,724727,Norfolk,Norfolk,25,21,Massachusetts,MA
25023,25CS010,4129,3901,4357,4799,442,670,898,151.6824914199078,740,167.59238813491189,-68.96693592401533,-15.391344311940902,36.34853095053444,1.1032422296098048,5097,4822,5372,5438,66,341,616,64.05260575687032,412,77.34068194958589,-63.45342215967727,-13.085253491335346,37.58545304318357,1.2039272982474156,529857,532708,Plymouth,Plymouth,25,23,Massachusetts,MA
25025,25CS011,4048,3706,4389,5128,739,1080,1422,163.19502861493999,1089,164.49302087883177,-49.60092669962739,-1.4453233595087334,48.64775628334395,1.0070215500147572,4904,4504,5304,5141,-163,237,637,30.602506266570934,393,50.724600269498644,-70.86039549504513,-17.444052736558326,32.508561300606935,1.6505694159772326,794441,774772,Suffolk,Suffolk,25,25,Massachusetts,MA
25027,25CS012,6446,6077,6816,6985,169,539,908,75.44315132800376,1135,158.95727760569727,-131.03018156830018,-84.3686618878058,-34.18106273137638,2.1030767926627387,7953,7508,8398,7793,-605,-160,285,-18.552890593683298,665,77.15100481932744,-148.4479698367914,-94.42013003233424,-45.27045529062405,-4.184603346026759,856834,861946,Worcester,Worcester,25,27,Massachusetts,MA
26001,26CS001,157,153,162,176,14,19,23,220.96328261665403,20,235.08668821627973,-63.42200274483342,-13.273654937724917,38.59101074960191,1.0101800251268993,191,186,196,227,31,36,41,353.31457731030883,35,342.3317683881064,-40.855845319289074,9.829482322698412,63.2767721570862,0.9428147210597752,10209,10224,Alcona+Alpena+Presque Isle,Alcona,26,1,Michigan,MI
26007,26CS001,326,314,339,343,4,17,29,69.43228690816079,20,83.31019161344071,-65.57320812693727,-13.185167808612961,34.14740861790319,1.131965841206694,397,382,412,477,65,80,95,276.83003540450323,72,249.21255754387178,-23.709714535282473,28.20711173563955,74.74861684762084,0.8891197798083614,28808,28891,Alcona+Alpena+Presque Isle,Alpena,26,7,Michigan,MI
26141,26CS001,171,165,176,170,-6,-1,5,-5.382947128510315,11,102.0408163265306,-156.68100655918124,-106.04833944588226,-57.96206771048709,26.20805433521256,209,202,215,211,-4,2,9,18.10227175516797,33,252.370755582747,-283.0888955074322,-234.57797331231026,-184.6396243601853,9.80085536635055,12936,13076,Alcona+Alpena+Presque Isle,Presque Isle,26,141,Michigan,MI
26003,26CS002,94,93,94,78,-16,-16,-15,-210.54618764984696,6,81.19079837618405,-303.335253603363,-291.4073101160555,-279.3380658035593,-0.41210593415620733,114,113,115,114,-1,-0,1,-3.8545350095425297,3,34.002040122407344,-50.20661610922315,-37.94072705725418,-26.144886506308058,4.546044318193096,8868,8823,Alger+Delta+Schoolcraft,Alger,26,3,Michigan,MI
26041,26CS002,403,388,419,502,83,99,114,322.36872269092004,63,206.1068702290076,68.65205387080896,116.76195722118223,171.86630901985404,0.6329280968837196,497,478,516,555,39,58,77,158.51057746632463,51,138.48159009449333,-30.11882748699294,20.96602100233093,71.15799758322648,0.8589289172637783,36680,36828,Alger+Delta+Schoolcraft,Delta,26,41,Michigan,MI
26153,26CS002,93,93,94,110,16,17,17,248.58513180913562,2,29.828486204325127,207.58475633749958,218.77985092209173,230.33247591355504,0.11320135470669065,114,113,115,131,16,17,18,207.3426553422391,5,62.25099601593625,133.12714504820556,145.40555346458714,157.96927825869426,0.2832257497391497,8046,8032,Alger+Delta+Schoolcraft,Schoolcraft,26,153,Michigan,MI
26005,26CS003,903,852,955,1042,87,139,190,138.2457649541982,73,72.84156958615013,11.960526797390028,65.66753336947433,114.81147516783668,0.5231233060048274,1115,1053,1178,1279,101,164,226,135.5385506434647,168,138.96011513838113,-59.48626115040859,-3.5856796974467122,45.81619917949243,1.0190254665435734,120261,120898,Allegan,Allegan,26,5,Michigan,MI
26009,26CS004,233,223,243,259,16,26,36,134.43178325001531,5,25.583081055728474,55.99451728543548,108.44147350978399,163.30131131927507,0.18332765660167055,288,276,301,333,32,45,57,187.71887681698092,36,151.5406634113487,-17.121569821209697,36.12736182062756,83.74275150445585,0.78956898005003,23453,23756,Antrim+Charlevoix+Kalkaska+Otsego,Antrim,26,9,Michigan,MI
26029,26CS004,246,235,257,242,-15,-4,7,-17.447555749932224,12,55.28467769800745,-125.6177951264834,-72.39852467577303,-20.973928816986678,-4.305492840548784,302,288,315,376,61,74,88,285.2251020691811,36,138.06327900287633,94.73369745339436,148.92224135208886,200.15441949588984,0.47762812823553663,26047,26075,Antrim+Charlevoix+Kalkaska+Otsego,Charlevoix,26,29,Michigan,MI
26079,26CS004,180,172,188,209,21,29,37,193.01140610990092,13,86.9613690841184,57.88122109212732,106.67899723120918,157.98606119371107,0.4354584170746177,221,212,230,251,21,30,39,167.48846551743625,26,144.677536030271,-29.29045062579343,21.00060101825923,68.16134954567569,0.8360302775605117,17939,17971,Antrim+Charlevoix+Kalkaska+Otsego,Kalkaska,26,79,Michigan,MI
26137,26CS004,237,226,248,276,28,39,50,185.54088682852435,18,86.2000159629659,48.859356470274285,100.29387947683803,148.96579314069814,0.4528982143566679,293,280,306,366,60,73,86,290.0464080389252,59,233.55237115034438,7.184483161102262,56.23696737911007,108.01038486624634,0.7943825189141345,25058,25262,Antrim+Charlevoix+Kalkaska+Otsego,Otsego,26,137,Michigan,MI
26011,26CS005,172,166,179,204,25,32,38,255.38190422050417,15,120.14417300760911,82.74360979948948,136.20692303886273,190.9607692869839,0.45614291205819635,210,202,218,254,36,44,52,294.9160298484443,20,133.53809174066902,111.41863413944515,159.959970483203,215.7457519516552,0.44277592905359636,14982,14977,Arenac+Iosco+Ogemaw,Arenac,26,11,Michigan,MI
26069,26CS005,351,340,362,405,43,54,65,255.4917440835976,43,204.6238648530753,1.0515012270043276,51.04286885977841,101.51565092052223,0.786257521570343,429,416,442,499,57,70,83,274.7013089905603,56,220.968314722014,-0.808842366998885,53.56049571712111,102.41782971616252,0.793003974637598,25217,25343,Arenac+Iosco+Ogemaw,Iosco,26,69,Michigan,MI
26129,26CS005,276,267,285,294,9,18,27,103.49574279642536,28,161.79515577599076,-108.09542471378198,-57.95306387521565,-7.038777443611494,1.4806353449595924,336,325,346,385,39,49,60,238.45988711293109,52,250.86839058278656,-61.97808694867029,-11.654210114130219,37.71061616138069,1.0311738652697595,20767,20728,Arenac+Iosco+Ogemaw,Ogemaw,26,129,Michigan,MI
26015,26CS006,497,470,524,534,10,37,64,71.56490914877949,39,74.95315427857588,-53.64314911471372,-1.4170898099991478,45.823362510377606,1.0199541915062529,614,581,646,769,123,155,188,246.8784197611932,78,123.95315206509129,73.03779564867423,125.00493209008431,171.99858916570707,0.49887055960137633,62439,62927,Barry,Barry,26,15,Michigan,MI
26017,26CS007,1086,1042,1131,1312,181,226,270,261.6474449315429,148,171.6953953537834,41.61700846637456,88.00298333466053,139.35223959909922,0.6533122660936301,1326,1273,1379,1559,180,233,286,226.12559299318977,219,212.46871179928982,-37.618730899688764,13.413272216975034,65.4749053994151,0.935590795127519,103439,103074,Bay,Bay,26,17,Michigan,MI
26019,26CS008,181,173,189,226,37,45,53,301.00300973554045,24,160.2671118530885,87.62453603433363,140.83100614439732,193.2705353130325,0.52088758445465555,224,215,234,241,7,17,26,91.5076480632464,24,131.9623907186452,-90.38587218122346,-40.55841891195279,8.366789759780456,1.3603517361477235,17970,18187,Benzie+Manistee+Mason,Benzie,26,19,Michigan,MI
26101,26CS008,282,271,292,343,51,61,72,294.82403135391974,21,100.68723030206169,143.14509580464312,193.93474740172712,247.39638874153655,0.33605126543934716,348,335,361,373,12,25,38,99.23104397066666,43,169.90674885411727,-124.85790388198092,-70.74028974103672,-21.43250691383788,1.6466646308786426,25028,25308,Benzie+Manistee+Mason,Manistee,26,101,Michigan,MI
26105,26CS008,295,282,307,349,42,54,67,223.8518211227991,21,86.56818962555822,86.53395112765998,135.77287507031792,188.16858398713904,0.37972815157712986,364,349,379,441,62,77,92,261.8302771579947,46,156.80392691573493,51.10494168133413,105.84593785345034,154.09741401322887,0.5911796248747155,29110,29336,Benzie+Manistee+Mason,Mason,26,105,Michigan,MI
26021,26CS009,1485,1419,1551,1652,101,167,233,130.10482578026924,170,132.56824990414796,-53.72100444255449,-2.614201018025774,47.83160738616307,1.0128633191932896,1807,1728,1886,2006,120,199,278,129.97989419860073,204,133.11929838299204,-51.71620272903661,-4.4368917694543715,48.58555256236262,1.019037067732115,153883,153246,Berrien,Berrien,26,21,Michigan,MI
26023,26CS010,419,400,438,468,30,49,68,131.16961534827985,71,190.907257612763,-109.0545842778401,-59.62270328532075,-12.086105077041474,1.4261875710213445,518,495,542,565,23,47,70,103.73188993458875,75,166.81865699859873,-117.19483620925585,-62.83910413812314,-10.88278627927478,1.57441238472715,44629,44959,Branch+Hillsdale,Branch,26,23,Michigan,MI
26059,26CS010,427,408,447,545,98,118,137,309.4857786086756,63,165.6260269470917,94.59921618498934,143.8181831591355,195.69590465911332,0.530657458392594,525,501,548,651,103,126,150,277.5399544202119,108,237.0240316032042,-12.077532236242241,40.12866066715052,92.8652750688373,0.8473174698016608,45645,45565,Branch+Hillsdale,Hillsdale,26,59,Michigan,MI
26025,26CS011,1327,1269,1384,1625,241,298,356,267.07751618495695,158,141.45242393947984,76.3239865443854,127.8290524151488,177.58936778775617,0.5278611561343446,1622,1552,1691,1847,156,225,295,168.41495929611926,229,171.07170070669795,-57.40094670304291,-4.440609047808726,48.575360391151946,1.011289198796507,134038,133862,Calhoun,Calhoun,26,25,Michigan,MI
26027,26CS012,452,429,474,560,86,108,131,252.07392633781683,66,153.50027133886346,50.40048819537222,97.20637621372506,148.88771794410275,0.6033823096666616,552,526,579,634,55,82,108,158.91156203113252,65,126.22584716962812,-21.60027614510708,32.22252813130153,80.86907656351315,0.7847255336569732,51596,51495,Cass,Cass,26,27,Michigan,MI
26031,26CS013,283,272,294,343,49,60,71,279.89107185616825,39,182.98404754457306,46.068944944515025,95.31599422074525,151.2126807683898,0.6429901522775728,349,335,362,443,81,94,108,366.6266584527639,52,202.09871745044697,108.91701584603574,166.3122074318905,217.62632929778277,0.5454562282448195,25576,25730,Cheboygan+Emmet,Cheboygan,26,31,Michigan,MI
26047,26CS013,325,311,340,374,34,49,63,171.94398674035403,32,112.96111078425605,8.478018240898756,59.411145105975365,105.62819577319179,0.6437483443378136,401,384,419,387,-32,-14,3,-41.95395767185766,28,81.85937728402281,-178.18483252725738,-122.27160216755256,-72.28755977710905,-2.0973230992286003,33994,34205,Cheboygan+Emmet,Emmet,26,47,Michigan,MI
26033,26CS014,309,293,325,308,-17,-1,15,-2.482191915250126,22,71.67874888001955,-129.80469512397727,-72.82255627311277,-23.488686913259556,92.37749361582864,382,363,401,452,51,70,89,189.71485786314753,50,135.84741618214423,5.457417007205953,52.92752049131706,108.86612550862856,0.7059509489313807,36831,36806,Chippewa+Luce+Mackinac,Chippewa,26,33,Michigan,MI
26095,26CS014,55,55,56,65,9,10,10,218.46724955954878,4,87.89598974546786,117.91095837280037,131.4040736851623,142.7362785321595,0.3655611956918561,66,65,67,83,16,17,18,321.40380693629766,6,112.9730747505178,194.35024714756705,207.8639915696561,219.130830608229,0.3320465388747318,5461,5311,Chippewa+Luce+Mackinac,Luce,26,95,Michigan,MI
26097,26CS014,146,141,150,140,-10,-6,-1,-63.22560667537083,8,88.60175357637286,-200.38688849322205,-151.6556825083226,-101.3981599592948,-1.698966352133036,179,174,185,195,10,16,21,144.9806062400408,14,128.49931161083066,-33.75658207618703,19.725604500641655,69.38009038216404,0.8335498057290417,10835,10895,Chippewa+Luce+Mackinac,Mackinac,26,97,Michigan,MI
26035,26CS015,392,378,405,434,29,42,56,165.21988359063843,42,163.3393829401089,-47.69537914643998,1.1218233074560415,53.752476017156894,0.9658827358339307,481,465,497,557,60,76,92,244.38352863870543,65,209.47470190138574,-14.857599380603187,34.48775058510308,83.37095558786733,0.8459993653656968,30856,31030,Clare+Gladwin,Clare,26,35,Michigan,MI
26051,26CS015,314,303,325,390,65,76,87,358.6858956377952,36,170.14572666404095,137.00597202670508,188.9518893170169,236.47924207075403,0.4681894076902032,385,372,398,481,83,96,109,375.83680523718664,59,231.66326370347102,95.07060406644497,143.39792250332874,199.22841292119836,0.6100201439997708,25390,25468,Clare+Gladwin,Gladwin,26,51,Michigan,MI
26037,26CS016,526,492,560,638,78,112,146,169.64813732934152,48,72.69973494888299,43.88353197265887,95.66942074556174,147.2295205170151,0.4247404867881973,650,609,691,771,80,121,162,152.12964269319522,90,113.37440006046636,-16.05570868277752,37.50392403727145,89.74134296595562,0.7391281986857983,79230,79383,Clinton,Clinton,26,37,Michigan,MI
26039,26CS017,156,150,161,155,-6,-1,5,-7.7469717836944305,2,18.260671079662178,-79.3163858599685,-27.851123782300906,25.25793922470907,13.200194814022778,192,185,198,219,21,27,34,208.24036184455449,12,91.12309211025895,68.93805446272744,117.37701703110804,169.2392426799125,0.4221907207157875,13143,13169,Crawford+Montmorency+Oscoda+Roscommon,Crawford,26,39,Michigan,MI
26119,26CS017,143,139,147,159,12,16,20,211.40926724783736,16,208.87728459530024,-49.14213612920673,4.136246264577148,54.36499642103627,0.9305598841377741,175,171,180,200,20,25,29,265.0043373900934,26,280.2932298404485,-64.51831240485637,-15.802548668981839,35.56952788704884,1.0163474667733416,9192,9276,Crawford+Montmorency+Oscoda+Roscommon,Montmorency,26,119,Michigan,MI
26135,26CS017,106,105,107,148,41,42,43,611.1235805231333,13,188.99927307971893,410.2482709720532,422.2431871128705,433.8454981699592,0.3020788816727363,131,130,132,172,40,41,42,496.9404934623582,33,397.5903614457831,85.94739497374238,99.1142129377354,111.89539994742464,0.7811379156342039,8254,8300,Crawford+Montmorency+Oscoda+Roscommon,Oscoda,26,135,Michigan,MI
26143,26CS017,345,335,355,389,34,44,54,226.34437439655278,29,147.87116512280105,26.977712062846905,80.91642048156126,135.37425553103674,0.6389085964135877,421,409,433,468,35,47,59,197.88530330229352,61,258.4307744450093,-109.06381687533828,-59.22037252948291,-10.273949724453187,1.2785888539897445,23534,23604,Crawford+Montmorency+Oscoda+Roscommon,Roscommon,26,143,Michigan,MI
26043,26CS018,271,260,282,339,57,68,79,315.1130453775689,68,316.3403760418685,-50.460511162721055,0.17887282218131922,52.5327592160427,0.989289845624068,332,319,346,360,14,28,41,107.80949021695592,30,116.27456300143406,-61.486427365356015,-6.8311195401118345,42.3944184285922,1.0410909372013706,25795,25801,Dickinson+Iron+Menominee,Dickinson,26,43,Michigan,MI
26071,26CS018,174,169,179,204,25,30,35,311.88551448265684,28,290.85872576177286,-28.869802488443867,20.347308355036205,70.81369235932085,0.9025218725553863,213,207,219,197,-22,-16,-10,-135.64116406905381,25,214.86892995272885,-403.1834411228687,-351.57760804678435,-302.14426778703796,-1.6912633363255634,11552,11635,Dickinson+Iron+Menominee,Iron,26,71,Michigan,MI
26109,26CS018,251,240,261,248,-13,-3,8,-12.872859905571284,22,113.23182500536134,-172.47999494010367,-127.7614044881366,-72.83835613195278,-14.65602242924547,306,294,319,326,7,20,32,83.7666025273908,33,141.5276407771154,-108.57148578011012,-58.293672458044234,-2.299533295872182,1.607258284015911,23315,23317,Dickinson+Iron+Menominee,Menominee,26,109,Michigan,MI
26045,26CS019,888,841,935,1071,136,183,230,200.7544824210044,80,87.88231093860138,63.64882739323198,113.16894770442192,166.57823911780437,0.4353777551756193,1092,1035,1148,1330,182,238,295,218.78244955493312,183,167.93921151163644,0.6231337285530499,49.74339750177892,101.20795447082845,0.7644018967945888,109237,108968,Eaton,Eaton,26,45,Michigan,MI
26049,26CS020,3916,3742,4090,4701,611,785,959,232.3161123928873,497,147.07550566452775,37.383817766652825,84.27807997980507,137.20323575590643,0.6322781328077213,4789,4580,4998,5638,640,849,1058,209.99341184810729,670,165.67017293987902,-9.894814666782944,45.59436018772836,94.15013803759219,0.7880024567019005,405506,404418,Genesee,Genesee,26,49,Michigan,MI
26055,26CS021,789,748,830,899,69,110,151,138.41918684133765,37,46.717663275076546,36.13383417778243,92.23701625390979,144.75917856422342,0.33445770636523553,978,929,1027,1122,95,144,193,150.2990197087446,113,117.97746943548303,-17.31659876906509,34.38219192353197,82.66098212955812,0.7795366573980654,95039,95781,Grand Traverse+Leelanau,Grand Traverse,26,55,Michigan,MI
26089,26CS021,214,204,223,243,20,29,39,156.95905192106667,10,53.942281758518384,51.04909226788211,103.92385814174922,154.446650781486,0.33225249114965194,266,254,277,316,39,50,62,222.23839180316946,28,124.02551381998582,44.05490958682014,98.29200422308693,151.8043984243105,0.5471684689620017,22246,22576,Grand Traverse+Leelanau,Leelanau,26,89,Michigan,MI
26057,26CS022,408,390,426,484,58,76,94,220.3440733564799,54,156.11824511528175,17.34199537623703,65.07424788078644,114.9688496755519,0.6993443628289051,500,478,521,528,7,28,50,68.17608380094383,48,115.4928899689613,-96.91541045139144,-47.975953041682644,7.029211053687372,1.6362895093709493,41507,41561,Gratiot+Isabella,Gratiot,26,57,Michigan,MI
26073,26CS022,395,367,423,512,89,117,145,214.8236009076274,33,60.669199656820695,104.41493400529026,153.1179710794662,205.2486555453355,0.2800176423868274,489,455,522,685,163,196,230,303.021004878538,101,155.94602106043294,96.51185994042362,147.10957386891445,201.08902202836376,0.5120286583045739,65272,64766,Gratiot+Isabella,Isabella,26,73,Michigan,MI
26063,26CS023,382,369,396,424,28,42,55,160.76524579158138,46,176.4931576927996,-65.7148045092706,-16.33393732442229,33.763358211390496,1.0722415296016379,464,448,480,529,49,65,81,207.23422844366573,71,227.08373312863816,-69.46286839185929,-18.276596311999477,32.11395613322226,1.0791281529954184,31276,31266,Huron+Sanilac,Huron,26,63,Michigan,MI
26151,26CS023,419,401,436,492,56,73,91,216.33767513219033,64,189.11598128539768,-23.198496798516498,27.13351875872637,79.59376422925955,0.8623910275298241,510,489,531,644,113,134,155,331.3154736375292,99,244.40823581691603,34.888119280685856,87.36917079297095,136.2178844172764,0.7322341914955873,40610,40506,Huron+Sanilac,Sanilac,26,151,Michigan,MI
26065,26CS024,1849,1727,1972,2244,272,395,517,165.91879506143368,157,65.99503986324594,49.18963804441263,101.58293507106862,152.36247737669208,0.3967499028071923,2277,2130,2424,2850,426,573,720,201.65476009241152,345,121.433976874747,27.703098353349635,80.98111878609284,131.5240300056891,0.6011382357405617,285476,284105,Ingham,Ingham,26,65,Michigan,MI
26067,26CS025,473,444,502,520,18,47,76,84.58838282901364,31,55.87766996124613,-25.340264946875433,27.49455573332832,84.1671022294504,0.6468005023826215,587,552,621,628,7,41,76,61.470957475878556,82,122.11830583189372,-113.68594950531586,-61.99221373089417,-6.226031904989693,1.9396109911405877,66574,67148,Ionia,Ionia,26,67,Michigan,MI
26075,26CS026,1489,1420,1558,1706,148,217,286,163.0085611479462,175,131.31894244478352,-16.66994403860527,33.23180777691847,82.72066659908985,0.8019038858715556,1824,1742,1907,2162,255,338,420,210.86807669212416,229,143.06062271977612,15.178840270203034,69.83520814665918,119.30348353950673,0.67643260535252,159916,160072,Jackson,Jackson,26,75,Michigan,MI
26077,26CS027,1841,1728,1954,2161,207,320,433,146.4366397766671,185,84.686279296875,8.005674497987728,61.36635634431848,114.73942447745004,0.5765112714218622,2261,2127,2396,2662,266,401,535,153.34557159213136,249,95.33508943886302,1.56252013623883,58.621388804714975,109.14055483722525,0.6201525710352153,262144,261184,Kalamazoo,Kalamazoo,26,77,Michigan,MI
26081,26CS028,4184,3901,4467,4822,355,638,921,116.378072929849,442,80.62505700300974,-16.627682312147403,34.044023259163644,90.19877460486121,0.6917014688984522,5166,4827,5506,5811,305,645,984,97.95186154670972,542,82.36518779110851,-36.10275805349201,15.972849640874271,66.30127150003639,0.8395716094465486,657860,658045,Kent,Kent,26,81,Michigan,MI
26085,26CS029,154,149,159,175,16,21,26,207.69090263859943,3,29.826014913007455,124.9542901633713,177.4062533294961,228.51144229364994,0.13704735759221892,190,184,197,194,-3,4,10,28.942621894380483,20,162.89297931259162,-182.2375834692216,-133.7439595849017,-83.33133812802923,4.3921533058457944,12070,12278,Lake+Missaukee+Wexford,Lake,26,85,Michigan,MI
26113,26CS029,149,143,156,167,11,18,24,140.20990207080496,7,55.721393034825866,34.79914358685472,83.9989976928771,136.18439087913907,0.37606367701894006,183,175,191,204,13,21,29,137.66659947603304,30,198.3995767475696,-113.80489330283035,-60.17713700715193,-5.101494514436213,1.3751018058084095,15075,15121,Lake+Missaukee+Wexford,Missaukee,26,113,Michigan,MI
26165,26CS029,308,293,322,329,7,21,36,75.51723421605247,12,42.73504273504274,-16.768780970411086,31.941885953912053,82.53040227977519,0.5404129989863925,379,361,396,507,111,128,146,378.67993913199274,66,194.87421755049016,133.22724664208914,184.42139554125433,235.24913638649278,0.5106330758432945,33696,33868,Lake+Missaukee+Wexford,Wexford,26,165,Michigan,MI
26087,26CS030,768,730,806,874,68,106,144,143.8770397550054,96,130.28579183678085,-36.60497792860169,12.571259829195512,65.7974549135492,0.8970738759210363,946,900,991,1207,216,261,307,295.3928488434309,210,237.24792408066432,4.95990954066365,58.33917754389057,108.64332073937311,0.8001006445724115,88421,88515,Lapeer,Lapeer,26,87,Michigan,MI
26091,26CS031,908,865,950,1037,87,129,172,156.80514316385822,75,90.83018791756656,13.311568393846834,64.50080576779432,114.68881035333284,0.5748156254016226,1110,1059,1161,1308,147,198,249,200.0583560283877,188,189.91049962623998,-40.81431849630287,9.959637106675759,60.52727488996983,0.9445063865256653,99086,98994,Lenawee,Lenawee,26,91,Michigan,MI
26093,26CS032,1277,1193,1360,1499,139,222,306,137.73477894740108,80,49.535092517105085,36.25763523460642,88.81743288295738,140.5093544946939,0.35803160093633146,1584,1483,1685,1913,228,329,430,168.80224545839303,226,115.97951370713633,-1.0837221082128445,53.34720815107815,110.36942330600611,0.6849908144295241,193802,194862,Livingston,Livingston,26,93,Michigan,MI
26099,26CS033,7541,7163,7919,9309,1390,1768,2146,241.3922108183515,1407,192.1216907254972,-0.8836953237885901,50.96769268189882,102.87567949995379,0.7954402300826288,9230,8777,9683,10658,975,1428,1881,162.79778025521964,1448,165.04979420068824,-54.15459820572989,-0.7092069273740808,51.51646033306406,1.0131238482501181,878818,877311,Macomb,Macomb,26,99,Michigan,MI
26103,26CS034,585,557,613,600,-13,15,43,27.23499396493467,44,79.92854872159737,-105.15244052528757,-51.808465275482504,0.05300976881015558,2.7512660605211696,717,683,752,794,42,77,111,115.83638575629408,41,62.04788280516965,2.9934001764695233,54.302682758120945,103.6278810842423,0.5287432096385658,66059,66078,Marquette,Marquette,26,103,Michigan,MI
26107,26CS035,323,306,341,412,71,89,106,263.4563264764466,13,38.650215549279025,174.87400008660364,224.47011213314897,274.8278742948032,0.1450673711339609,397,376,418,474,56,77,98,192.42648493556501,59,147.51843980497563,-6.329062214502201,44.76941032398074,95.773877685126,0.7567889162298147,40362,39995,Mecosta+Osceola,Mecosta,26,107,Michigan,MI
26133,26CS035,211,202,221,223,2,12,21,60.5020443544337,17,88.75739644970413,-75.75435026024222,-27.50118135138501,24.618793098928652,1.3504755573583778,261,249,273,285,12,24,36,104.25989320981071,47,203.70129588696744,-148.9170485462278,-100.33005287328591,-48.337071608436425,1.8758068094305538,22984,23073,Mecosta+Osceola,Osceola,26,133,Michigan,MI
26111,26CS036,648,612,684,767,83,119,155,170.7902375950093,37,53.19595039837057,68.04762598678352,118.8898277410631,168.54445163938172,0.30886941092519654,797,754,840,938,98,141,184,169.11255876902675,103,123.4124131320393,-2.8215403089043707,45.32579763998827,96.4406983722314,0.7246308419339169,83465,83460,Midland,Midland,26,111,Michigan,MI
26115,26CS037,1330,1264,1397,1530,133,200,266,155.27484632934033,123,95.71611999533091,5.463567242078864,59.092420941782976,111.29237086424588,0.6133563849834219,1642,1562,1722,1933,211,291,371,187.62290669732496,207,133.37285121517488,2.659118527699421,52.501888174820174,103.89951835546675,0.7084231191363023,154206,155204,Monroe,Monroe,26,115,Michigan,MI
26117,26CS038,570,541,598,620,22,50,79,91.05420045249743,70,126.92848184469393,-86.28853504437485,-33.97782135332038,14.677615137404707,1.3667701875676908,710,675,745,820,75,110,145,163.8135084031792,90,134.09419372141187,-25.61292829639065,30.046019448636365,79.18895890370574,0.8112002422132067,66179,67117,Montcalm,Montcalm,26,117,Michigan,MI
26121,26CS039,1517,1442,1593,1878,285,361,436,246.57879453115314,247,168.81866801843105,24.541966007432865,78.27904152005345,129.33575386430925,0.6827514258053754,1869,1778,1960,2152,192,283,374,160.45246280170798,230,130.3780964797914,-24.47405359440373,31.190515499632948,83.57471829584414,0.8097046563573341,175573,176410,Muskegon,Muskegon,26,121,Michigan,MI
26123,26CS040,441,420,463,488,25,47,68,112.52096967202932,30,72.11538461538461,-11.599459893045577,41.02469309092822,94.66968463623914,0.627500545440489,541,515,567,641,74,100,126,199.36127363323797,82,163.15485783640742,-17.489459545036762,38.91412104574626,85.11537289101827,0.810300840616259,49920,50259,Newaygo+Oceana,Newaygo,26,123,Michigan,MI
26127,26CS040,231,219,242,284,42,53,65,240.449853465409,41,184.3870629239591,5.883146205028921,55.608736829707674,109.78210807931687,0.7527627955181219,282,268,296,330,34,48,62,178.23168201361415,37,138.0803104941036,-12.759486773731725,41.71863607245435,92.64880499516997,0.7588348654762611,26683,26796,Newaygo+Oceana,Oceana,26,127,Michigan,MI
26013,26CS041,89,88,90,105,15,16,17,231.8154628072079,27,397.35099337748346,-178.0413872550948,-165.44510384298727,-153.8124803436089,1.6117612536992276,110,109,111,114,3,4,5,43.886370806323654,18,219.45866861741038,-187.6870316971488,-175.67721971958173,-162.80656259812434,3.9134176915668184,8154,8202,Northwest Upper Peninsula,Baraga,26,13,Michigan,MI
26053,26CS041,169,163,175,207,32,38,44,321.06114028404767,38,319.5515066573231,-48.33503340881566,1.7354317693275214,52.4996026717122,0.9698944606582351,208,201,215,211,-4,3,10,20.519303509551598,20,139.33398355858995,-172.99620286676105,-117.87486272222584,-67.71575820672366,5.06927053536423,14270,14354,Northwest Upper Peninsula,Gogebic,26,53,Michigan,MI
26061,26CS041,322,306,338,333,-5,11,27,35.2498541605237,27,87.65285142300617,-102.47129452413753,-52.9370251898348,1.289412635140629,2.276918858676165,401,382,420,381,-39,-20,-1,-53.431125083647515,46,123.3541605213054,-227.37965406930263,-176.4059089755559,-125.84277745348874,-2.4306471821366036,36964,37291,Northwest Upper Peninsula,Houghton,26,61,Michigan,MI
26083,26CS041,24,23,25,26,1,2,3,99.03851045793124,4,232.44552058111378,-184.26432720101548,-131.62900923655798,-79.78907777660076,1.479132563750994,30,29,31,35,4,5,6,222.95685640321508,2,95.28346831824678,75.77257667770384,128.55517339491396,176.90042641973523,0.35212108134131653,2065,2099,Northwest Upper Peninsula,Keweenaw,26,83,Michigan,MI
26131,26CS041,82,81,83,115,32,33,34,681.9135786451552,20,414.0072451267897,256.0398688579889,267.8694834142481,279.8603003283636,0.5892385861225501,102,101,102,101,-1,-1,0,-12.356684217000186,13,221.88086704215738,-247.04847228429276,-234.41224449822624,-222.40772416979166,47.09771699869749,5797,5859,Northwest Upper Peninsula,Ontonagon,26,131,Michigan,MI
26125,26CS042,9157,8610,9703,10946,1243,1789,2336,169.05834105686492,1401,132.37607655954483,-19.513642225515998,39.94195211410012,89.11560174780011,0.7825826987213773,11265,10609,11920,12423,503,1158,1814,91.1939923029582,1189,93.59507417547384,-51.85825784535539,-2.058594799732188,51.19169555934365,1.02544423635794,1270018,1270366,Oakland,Oakland,26,125,Michigan,MI
26139,26CS043,1761,1633,1888,2147,259,386,514,156.54491402581218,221,89.51687217517222,13.405309196177475,67.12497219513332,117.45953715471718,0.5703529185810768,2198,2044,2352,2544,192,346,500,115.7280314646467,290,97.05131337199768,-33.14866514734579,19.185286246257473,69.35740069703509,0.8361973378098558,296257,298811,Ottawa,Ottawa,26,139,Michigan,MI
26145,26CS044,1813,1732,1895,2310,415,497,578,313.9067425336157,328,207.26589117487532,51.14652118172978,107.00069919260869,154.96727436288697,0.6589520578418386,2218,2120,2316,2583,267,365,463,192.27578767030536,337,177.71824538829063,-35.89460545610494,14.476040476141529,68.3232379561908,0.9217601123745857,189901,189626,Saginaw,Saginaw,26,145,Michigan,MI
26147,26CS045,1531,1462,1600,1776,176,245,314,183.38188493869305,154,115.4220900891898,17.049000467323662,69.13217528929736,123.0634859581343,0.6268463892309782,1874,1791,1957,2357,400,483,566,301.73415037406824,411,256.74021138902077,-7.776877406336183,45.9272628884121,98.01204555509075,0.8491242601525042,160108,160084,St. Clair,St. Clair,26,147,Michigan,MI
26149,26CS046,569,542,595,639,44,70,97,138.69026230153736,59,116.30199093238714,-25.645340047568453,22.451102107587776,70.31603412820404,0.8268218767228951,696,664,727,792,65,96,128,158.23174905435133,89,146.43215584330113,-36.747859651324646,12.11654033774647,62.57150479215122,0.9159047656828314,60876,60779,St. Joseph,St. Joseph,26,149,Michigan,MI
26155,26CS047,633,604,663,728,65,95,124,167.00509936004826,49,86.49093904448107,28.649332374380478,79.87676883499425,130.41078719144454,0.5124774901336975,777,742,812,880,68,103,138,152.21499482585364,118,173.80545572379663,-73.28052255789015,-22.19995628867066,29.4586749364414,1.1308985962638858,67984,67892,Shiawassee,Shiawassee,26,155,Michigan,MI
26157,26CS048,534,511,557,647,90,113,136,255.07441856965215,90,203.37834020676797,1.1979335289149797,53.33789929227217,100.16086321800492,0.7903277437232824,654,626,681,794,113,140,168,264.69530219891783,118,222.77180992656085,-7.316189369131976,40.83240619593237,96.4775528144718,0.8356558509743139,53103,52969,Tuscola,Tuscola,26,157,Michigan,MI
26159,26CS049,660,627,692,767,75,107,140,170.53520297543997,90,142.9100725136294,-18.96405711987525,25.911545789682258,76.82684476285174,0.830278321733339,809,770,848,980,132,171,210,226.28811831693062,117,154.67392884999273,21.152606066294574,71.485897690065,120.68011872094297,0.6795564731787195,75572,75643,Van Buren,Van Buren,26,159,Michigan,MI
26161,26CS050,2004,1845,2164,2311,147,307,466,99.1889344580832,179,57.909749219512456,-9.35699803052953,40.58262775709287,94.39430782939561,0.5819346996338353,2485,2294,2676,2640,-36,155,346,41.865212573377264,172,46.521692091312346,-58.87091529224031,-4.003627546995859,48.400681858582935,1.1040923934387936,370922,369720,Washtenaw,Washtenaw,26,161,Michigan,MI
26163,26CS051,15695,14927,16463,19800,3337,4105,4873,276.31224495185455,3079,207.25086340503273,18.21953831188862,67.65944617289087,122.63441795424316,0.7498776912769727,19152,18234,20069,21711,1642,2559,3477,144.00689050483953,2477,139.38729240325188,-47.710398027502464,3.809002779865179,54.95290463964936,0.9675429122538277,1782767,1777063,Wayne,Wayne,26,163,Michigan,MI
27001,27CS001,192,185,198,225,27,33,40,254.59205246996208,29,221.16301239275498,-17.039065453324405,33.88472944165706,84.20797705625006,0.8434306799045134,236,228,244,248,4,12,20,76.91559027352557,20,126.1113563276373,-103.66517781425907,-49.32558161538669,7.606816483590789,1.5153761281643512,15735,15859,Aitkin+Itasca,Aitkin,27,1,Minnesota,MN
27061,27CS001,445,426,465,469,4,24,43,63.52714755941218,36,95.94030381096206,-86.17287285614366,-33.25896312117773,20.07058777154461,1.4494210433783603,546,523,569,684,115,138,161,306.1895273003612,64,142.04230197305634,112.57124144664036,162.65802705618444,212.5860559156172,0.46056480324609494,45028,45057,Aitkin+Itasca,Itasca,27,61,Minnesota,MN
27003,27CS002,1948,1792,2105,2359,254,411,567,135.49849021951783,331,109.24212587597223,-27.162718464646026,27.19205998295729,79.87391428615058,0.8042649685344031,2440,2251,2629,2764,135,324,513,88.42815232952096,307,83.73770187741565,-44.22710908379718,5.013547844699843,54.405411672346126,0.944045540276229,363596,366621,Anoka,Anoka,27,3,Minnesota,MN
27005,27CS003,328,312,343,386,43,58,74,199.94720170846733,40,136.93159125920008,14.137860064243323,62.946459268471834,116.38572541063688,0.6733110111304847,406,388,424,412,-12,6,24,17.269860063239296,43,122.1313337877755,-158.19897075167304,-103.80312821224398,-55.1485839499958,6.073126947199731,35054,35208,Becker+Hubbard+Mahnomen+Norman,Becker,27,5,Minnesota,MN
27057,27CS003,191,182,200,229,29,38,47,211.36331805851955,37,207.01230883998505,-46.115596165728554,4.588525358706434,51.593631603987205,0.954157370375089,239,228,250,239,-11,0,11,0.15730696342803904,15,69.23289947382996,-119.8917580912615,-68.82313739015352,-16.623874325040966,14.505617699748795,21448,21666,Becker+Hubbard+Mahnomen+Norman,Hubbard,27,57,Minnesota,MN
27087,27CS003,55,55,56,68,12,13,13,281.2190003228549,3,66.64198445020362,202.50240763937222,214.6682322475098,226.6376755245617,0.21962669029960322,68,67,69,89,20,21,22,387.5268178240575,10,184.91124260355028,189.0451172309421,202.44051438864713,215.13246877902927,0.45542628400669694,5402,5408,Becker+Hubbard+Mahnomen+Norman,Mahnomen,27,87,Minnesota,MN
27107,27CS003,83,83,84,66,-18,-17,-17,-322.23093260862356,5,93.51620947630923,-428.1314774050707,-415.3499867067182,-403.50110340599394,-0.30809778592695797,102,101,103,85,-18,-17,-16,-265.2553638182151,3,46.75081813931744,-324.9520448859786,-311.9466391671528,-299.7900995863754,-0.18724912483714795,6416,6417,Becker+Hubbard+Mahnomen+Norman,Norman,27,107,Minnesota,MN
27007,27CS004,345,325,364,461,97,116,136,301.2087099390549,40,103.4750366474088,145.74632599614884,196.50003489839827,251.42737079751467,0.3406074395587666,424,400,448,511,63,87,111,188.1371151732523,56,120.7989990940075,17.102889018764373,67.24972469481011,122.48023898182639,0.6348011321535367,46388,46358,Beltrami+Clearwater,Beltrami,27,7,Minnesota,MN
27029,27CS004,82,81,83,92,9,10,11,142.25949964834402,10,139.24344395451382,-8.885823376617752,3.208604622287301,15.168099322174186,0.8915355157699195,100,99,101,125,24,25,26,293.94172710383657,15,174.88632388947184,106.5864270504493,118.58782709639335,130.64701631438422,0.5722704753966726,8618,8577,Beltrami+Clearwater,Clearwater,27,29,Minnesota,MN
27009,27CS005,327,309,345,397,52,70,88,203.9281700755803,72,209.24149956408021,-57.65899884465509,-6.020382458659312,47.195223782367464,1.0116382898130083,403,382,425,407,-18,4,25,9.257750350790985,51,123.06652831736687,-165.91679536761603,-115.16674586481588,-61.17002182131473,10.544806040765158,41292,41441,Benton+Stearns,Benton,27,9,Minnesota,MN
27145,27CS005,919,851,987,1187,200,268,336,202.36395294530067,185,139.79056602585493,9.118748604994439,62.218941628329674,115.52673546536126,0.688218081483458,1142,1060,1224,1279,55,137,219,86.24187481402652,121,76.16769482563264,-38.911188241527555,9.501796204620268,60.33907008392666,0.876787181845588,158809,158860,Benton+Stearns,Stearns,27,145,Minnesota,MN
27013,27CS006,434,404,463,456,-7,22,52,38.785673626021335,27,46.959924632219725,-57.59396184284921,-6.769516373878099,44.6570057306983,1.158791008977212,535,499,571,594,23,59,95,85.00024335969132,41,59.1938091938092,-24.492411283858264,25.463702939891185,73.50541890776937,0.6847648506805438,68995,69264,Blue Earth+Faribault+Martin+Watonwan,Blue Earth,27,13,Minnesota,MN
27043,27CS006,162,156,168,159,-9,-3,3,-22.24121188385458,11,95.24496716934844,-168.10700389719534,-117.768442386066,-63.38115518567253,-7.012289097797511,197,190,204,184,-20,-13,-6,-93.59128637899029,17,122.24938875305624,-268.84526079140466,-216.71115139685458,-163.64946584077305,-1.4149210922090047,13859,13906,Blue Earth+Faribault+Martin+Watonwan,Faribault,27,43,Minnesota,MN
27091,27CS006,214,206,223,215,-8,1,9,3.2182093544401136,23,138.5820445872665,-182.95964453151407,-135.26497318455444,-86.04710834213874,14.992352474088298,261,251,271,302,31,41,51,205.67881827897472,25,125.48310997339757,31.465528640690792,81.47416536608235,132.64486500725403,0.5955586906393414,19916,19923,Blue Earth+Faribault+Martin+Watonwan,Martin,27,91,Minnesota,MN
27165,27CS006,103,102,104,134,30,31,32,335.63811363568703,10,107.55579456843238,216.38108245889632,228.32849827122328,240.18384624788828,0.3105015960544685,126,124,127,128,1,2,4,21.02437158443315,15,134.55328310010765,-126.42687577740011,-113.41253761530272,-101.02858966933796,4.485918328824377,11157,11148,Blue Earth+Faribault+Martin+Watonwan,Watonwan,27,165,Minnesota,MN
27015,27CS007,257,246,268,268,0,11,22,52.475695168733395,30,139.83840894965817,-139.2015053240855,-87.09547435495838,-36.88020405441726,2.4474240683301085,316,303,330,342,12,26,39,99.98447122373105,30,116.14851523481359,-69.65371923826791,-15.206203444043224,35.905267799494474,1.1183601946325457,25744,25829,Brown+Le Sueur+Nicollet,Brown,27,15,Minnesota,MN
27079,27CS007,210,198,223,216,-7,6,18,23.50208763079381,19,79.48959313879301,-107.66069278948179,-55.070173201255486,-4.073317544300715,2.8711373869652776,262,247,277,284,7,22,37,75.50640431148473,32,111.07254425546687,-84.30592052130051,-36.098410305701414,12.204566055509638,1.4063835258202748,28683,28810,Brown+Le Sueur+Nicollet,Le Sueur,27,79,Minnesota,MN
27103,27CS007,224,209,239,238,-1,14,29,49.48076025065944,30,104.50837518506691,-103.67538436736594,-54.532177017373236,-5.565307418715101,1.9731825328110462,278,260,296,298,2,20,38,58.053045489991334,20,58.21568912822005,-52.82198312121066,-0.39951766634731256,49.868914537389884,0.9549217819714023,34447,34355,Brown+Le Sueur+Nicollet,Nicollet,27,103,Minnesota,MN
27019,27CS008,476,430,522,510,-12,34,80,37.75346164652009,36,40.331992045634905,-51.20956915158629,-3.5488961625002933,49.71798425115456,1.0375110610060074,602,546,658,674,16,72,128,66.59212771422766,53,48.87901061504551,-34.21394620284487,16.948767672061045,71.10573371571957,0.723979329142812,107111,108431,Carver,Carver,27,19,Minnesota,MN
27021,27CS009,291,278,303,310,7,19,32,77.65428030447677,24,95.66517189835575,-68.64599562949594,-18.090903778568997,36.33948530921835,1.1717881703028687,361,345,377,429,52,68,84,222.8109042193741,40,130.87292239235703,39.01141770411141,89.9680421307596,143.3770278151735,0.578871831419239,30105,30564,Cass+Crow Wing,Cass,27,21,Minnesota,MN
27035,27CS009,609,581,638,619,-19,10,38,17.463213738521162,68,123.27959994561193,-155.9591654515385,-106.30562255559245,-54.67775099726341,6.3954475420369175,757,722,792,815,23,58,93,86.55105886428959,67,99.8227029604136,-68.76727474996838,-14.322058532474513,36.48685744420186,1.1338212844525033,66191,67119,Cass+Crow Wing,Crow Wing,27,35,Minnesota,MN
27025,27CS010,389,364,413,412,-1,23,48,49.27736388858315,27,57.10760553450251,-61.535830733585314,-8.352016767132264,45.72311466796527,1.1112059064945838,486,456,515,544,29,58,88,101.54518598842418,64,111.59157483609987,-61.39357202693447,-9.515792192090702,40.826657865650525,1.0803840313913402,56735,57352,Chisago+Isanti,Chisago,27,25,Minnesota,MN
27059,27CS010,294,276,312,314,2,20,38,57.84019830866946,31,90.070458342413,-82.31907718141133,-33.427161042360225,19.007844251830683,1.4827463152574003,367,346,389,435,46,68,89,161.63010057280044,57,136.26583791537175,-27.548909953141404,24.32397198918081,74.69611505815196,0.8307842459312508,41301,41830,Chisago+Isanti,Isanti,27,59,Minnesota,MN
27027,27CS011,423,395,451,489,38,66,94,120.81514670077766,83,152.662395389473,-80.02260869812771,-32.752929335977875,19.546279136320162,1.2446543282130036,523,490,557,543,-14,20,53,29.838377598048538,32,48.82439999389695,-71.59419883783714,-17.830626264287993,36.280055205881155,1.5566949975852096,65242,65541,Clay,Clay,27,27,Minnesota,MN
27037,27CS012,2337,2148,2526,2746,220,409,598,111.7264107572732,285,77.91994750656168,-17.07707263516007,32.374936864671184,80.2539665504073,0.6957149718981863,2922,2694,3150,3241,91,319,547,72.1674947033331,333,75.37569009500054,-56.98126081613572,-3.7181967361845984,50.48400716106718,1.0411891624095735,438912,441787,Dakota,Dakota,27,37,Minnesota,MN
27039,27CS013,139,137,141,133,-8,-6,-4,-33.51132729588809,7,40.22025377064879,-84.890186591626545,-73.93162954988458,-61.65159391869339,-1.448565398886749,171,169,174,163,-11,-8,-6,-40.33921131675717,11,52.57121009367234,-105.67551641937808,-92.64891551050215,-79.92071931937109,-1.478380053986938,20885,20924,Dodge+Steele+Waseca,Dodge,27,39,Minnesota,MN
27147,27CS013,278,262,294,299,5,21,37,69.12214190819526,4,12.88417662058784,2.458120673589027,54.9143703410727,107.42544797614333,0.17809799819027486,344,325,363,383,20,39,58,103.90084774538948,33,88.3557792711987,-34.664135973261104,15.41955068075383,66.55739047761047,0.8290222579752343,37255,37349,Dodge+Steele+Waseca,Steele,27,147,Minnesota,MN
27161,27CS013,162,154,170,162,-8,0,8,0.39580779797521426,18,114.27966774244749,-164.75414663812444,-114.56956777045339,-65.304407158466,16.943679724577603,200,191,210,188,-22,-12,-3,-65.45280813802793,14,73.71136734586426,-189.10837017068303,-138.4047268706989,-89.64168347936175,-1.224691332660578,18901,18993,Dodge+Steele+Waseca,Waseca,27,161,Minnesota,MN
27041,27CS014,386,369,403,433,30,47,64,145.25061352995365,52,160.21361815754338,-66.6081601473667,-15.540306638239702,36.045001306087606,1.0801041041332926,473,453,494,448,-46,-25,-5,-64.83788190776829,46,117.30205278592375,-234.52009280901484,-181.48329402351047,-127.39094515352876,-1.8832256489317163,38948,39215,Douglas+Morrison+Todd,Douglas,27,41,Minnesota,MN
27097,27CS014,281,266,295,323,28,42,57,150.25597007143926,43,152.27527592516086,-52.07860846037456,-3.457429398341025,48.585584208797094,0.9901039870484853,344,327,362,415,53,71,88,208.08672931130977,34,100.02942041776994,54.241495966212575,109.42931545539652,159.1773897185707,0.4740084487148606,33886,33990,Douglas+Morrison+Todd,Morrison,27,97,Minnesota,MN
27153,27CS014,188,178,199,214,15,26,36,122.01784490155785,31,147.7832512315271,-81.65052090271062,-24.293175153372424,23.168790294085497,1.1656205147849572,232,219,245,252,7,20,33,80.96409842681462,28,110.93941915289828,-82.14446868387125,-29.152720222473086,17.26271860715301,1.3063035002412036,25172,25239,Douglas+Morrison+Todd,Todd,27,153,Minnesota,MN
27045,27CS015,199,189,208,206,-2,7,17,41.98995568057553,5,28.268551236749115,-36.47848017215894,12.80496187229387,62.82858751693105,0.5933328321022436,242,231,253,248,-5,6,17,27.241812275940923,14,65.8296891898246,-88.15601460703876,-39.65490823583849,14.25853230793087,2.0607884861648875,21225,21267,Fillmore+Houston+Winona,Fillmore,27,45,Minnesota,MN
27055,27CS015,165,157,173,179,6,14,22,88.80627971656678,12,76.62835249042146,-40.34122860266816,11.960523092066488,64.9704571593323,0.804987520016215,201,191,211,202,-9,1,11,4.8610275388139454,6,31.942078364565585,-80.9095459006102,-25.951733221720126,23.53531788691235,3.1362784937807207,18792,18784,Fillmore+Houston+Winona,Houston,27,55,Minnesota,MN
27169,27CS015,356,335,377,389,12,33,54,79.27305310507579,41,98.87062417105422,-71.64734932105856,-19.167338908219186,29.999417116721624,1.2103959227145826,435,409,461,431,-30,-4,22,-8.111376427952466,20,40.301454882521256,-98.15223555142182,-48.34763506659132,1.1054712281059373,-6.61080172062978,49762,49626,Fillmore+Houston+Winona,Winona,27,169,Minnesota,MN
27047,27CS016,311,297,324,326,2,15,29,59.60945828162586,17,66.2423691388492,-58.051882046617834,-8.542420232680993,46.58053068595411,1.0430872353477687,379,363,394,391,-3,12,28,40.30017833319507,24,78.00058500438753,-89.68792300465991,-37.70502439349677,11.438557800532825,1.7910498724127022,30796,30769,Freeborn+Mower,Freeborn,27,47,Minnesota,MN
27099,27CS016,354,336,371,354,-17,0,18,1.3777370281963808,30,89.86744551786116,-142.37959224295554,-84.9447500296422,-36.708046922248435,20.549028062725096,433,413,454,447,-7,14,34,33.74238978710629,21,52.31428429076778,-75.91401459905698,-20.87991929005985,25.00375840229181,1.4438080122804495,40059,40142,Freeborn+Mower,Mower,27,99,Minnesota,MN
27049,27CS017,427,407,448,482,34,55,75,138.39300914677824,42,106.2977179735943,-18.50152500072672,30.787693270857464,85.76130850052446,0.7542915896267075,529,504,554,567,13,38,63,79.64473446630055,43,89.76098528337334,-63.46666666421549,-8.373823504459017,39.92644999003673,1.0982328399047763,47414,47905,Goodhue+Wabasha,Goodhue,27,49,Minnesota,MN
27157,27CS017,168,159,177,194,17,26,35,146.32089180250978,6,33.572694208710246,65.15009892972036,111.18766325991538,165.83477569918617,0.22099462127426578,207,196,218,219,1,12,23,55.070792849532324,10,46.52028284331969,-43.43402879728393,7.876772581832837,57.82523184819879,0.7789364594657695,21446,21496,Goodhue+Wabasha,Wabasha,27,157,Minnesota,MN
27053,27CS018,7636,7086,8185,9067,882,1431,1981,134.46757517605892,1286,120.8007984500675,-33.6513837536689,15.37423794014038,65.38257959399989,0.8977366411899065,9379,8723,10034,9922,-112,543,1199,42.796173762240144,683,53.80342136192766,-59.344084987285264,-10.606218653150368,38.559209920355705,1.2548917896845204,1277475,1269436,Hennepin,Hennepin,27,53,Minnesota,MN
27065,27CS019,142,135,149,181,32,39,46,290.4317083915038,19,141.6237033356109,99.52749589270756,147.79302344986198,197.67636763415618,0.47542986056265685,174,166,182,213,31,39,47,240.85758880179387,29,179.6555569322265,12.155825855844585,62.64664550843268,108.43198247763755,0.7271955490856681,16099,16142,Kanabec+Mille Lacs+Pine,Kanabec,27,65,Minnesota,MN
27095,27CS019,261,249,272,306,34,45,57,206.03775209556034,42,190.75013246536975,-32.52550846637209,14.661979339615375,65.35626736272738,0.9058346287098792,322,308,336,377,41,55,69,205.30154913689717,47,175.3731343283582,-22.533675341544345,29.201809621349117,82.79410883430734,0.8389738681680159,26422,26800,Kanabec+Mille Lacs+Pine,Mille Lacs,27,95,Minnesota,MN
27115,27CS019,250,237,262,302,40,52,65,216.23516668499587,18,74.52130412282214,90.10953592336408,142.12087426950984,193.6671309112034,0.33815642998233425,308,293,323,394,71,86,101,293.8438995391475,38,129.97229537914288,113.90211288661447,162.5752890715596,211.2729769661911,0.43722818044824735,28985,29237,Kanabec+Mille Lacs+Pine,Pine,27,115,Minnesota,MN
27067,27CS020,337,318,356,406,50,69,88,190.4831451776446,69,189.84729673957904,-49.94748662593998,1.1421899407124916,50.55965250347854,0.9824707411626535,415,392,437,439,2,24,47,55.31652060171061,48,109.70174837161468,-108.97207117711024,-55.34608209184133,-3.2906958206303245,1.9044789846385726,43614,43755,Kandiyohi+Renville,Kandiyohi,27,67,Minnesota,MN
27129,27CS020,159,152,165,174,9,15,22,125.02603892213585,34,278.3652862113666,-205.25225547556138,-153.8242028515858,-100.70948820772192,2.0896215615010028,193,186,201,203,2,10,17,67.39597224923531,10,68.40413160954921,-50.171044738059344,-0.6359661356996428,47.743810924777506,0.9214367217852117,14657,14619,Kandiyohi+Renville,Renville,27,129,Minnesota,MN
27085,27CS021,294,279,310,376,66,82,97,267.81002910602086,39,127.94925773026765,91.11546961315763,139.16584360426333,193.78597688061723,0.4719793792273399,361,342,380,417,37,56,75,152.7475844243275,43,117.07051456575007,-12.250734632196941,34.04176108364902,89.79735021726293,0.7530095722827461,36577,36730,McLeod+Meeker+Sibley,McLeod,27,85,Minnesota,MN
27093,27CS021,194,184,204,226,22,32,42,165.06344818063036,29,148.8197057817311,-34.81984934620006,13.530942017468309,69.7829248104852,0.8744062045099026,237,225,249,244,-5,7,19,31.15889169520167,27,115.46356483065343,-134.69053793354485,-84.43121524191614,-32.97224881246764,3.258431552420333,23384,23384,McLeod+Meeker+Sibley,Meeker,27,93,Minnesota,MN
27143,27CS021,122,121,123,93,-30,-29,-28,-234.74206942800583,3,24.284943335132215,-271.8797571168722,-259.09891554645134,-248.25188472948298,-0.10714871086824465,150,148,152,170,18,20,22,131.82278833938906,12,80.53691275167785,38.713312147149175,51.55125904520379,63.73564685603545,0.5813504107160972,14824,14900,McLeod+Meeker+Sibley,Sibley,27,143,Minnesota,MN
27069,27CS022,50,49,50,74,24,24,25,689.4272240672154,19,543.8931297709923,132.94690404779953,145.46096146634477,157.11873557121024,0.7574552223063137,61,60,61,62,1,1,2,31.751662304826553,5,120.45290291496025,-101.2051342999705,-88.51240768597897,-76.09623165215986,2.1570212206006465,4192,4151,Northwest Minnesota,Kittson,27,69,Minnesota,MN
27077,27CS022,39,38,39,45,6,6,7,200.29239530427677,7,223.22614934892374,-34.1335574714169,-22.807338521509845,-11.25921356534589,0.9614280959211379,48,48,49,50,1,2,2,45.99388817567374,3,78.65757734661773,-46.59823903559313,-32.74506291062204,-19.59017077430992,1.089242789067232,3763,3814,Northwest Minnesota,Lake of the Woods,27,77,Minnesota,MN
27089,27CS022,72,71,73,87,14,15,16,199.77354995718642,15,198.3471074380165,-10.745768703259388,1.336231041780927,13.978988757594395,0.931221546288455,88,87,89,99,10,11,12,123.56916932115344,12,133.40744858254587,-21.975750066713157,-10.00886288528105,1.7118926620606527,0.9905038104662115,9075,8995,Northwest Minnesota,Marshall,27,89,Minnesota,MN
27113,27CS022,116,114,117,121,4,5,7,46.636662738413065,13,111.90015063481816,-77.23236971623437,-65.18208527733042,-53.120755337734565,2.025548620683556,141,139,143,156,13,15,17,108.2547349870511,13,94.18242411070058,1.820948932498145,14.25929979489679,26.368734322999245,0.8154355133022517,13941,13803,Northwest Minnesota,Pennington,27,113,Minnesota,MN
27119,27CS022,301,288,315,349,34,48,61,184.04354441751,60,231.8019381217604,-98.16560034684893,-46.351043374148624,3.1432231001872815,1.233599860997856,368,352,384,380,-4,12,28,38.54499849645678,35,113.63636363636363,-126.41235682980748,-75.7163537723791,-21.951314938657394,2.719109845756258,31061,30800,Northwest Minnesota,Polk,27,119,Minnesota,MN
27125,27CS022,28,28,29,27,-2,-1,-1,-40.43940356124059,0,0,-52.41572839497178,-40.186730582949416,-29.004778220524955,-0,35,34,35,43,8,8,9,207.2246747019416,8,203.40706839562674,-9.811702531563741,3.8351842995723375,16.151592560274004,0.8743029456900394,3950,3933,Northwest Minnesota,Red Lake,27,125,Minnesota,MN
27135,27CS022,120,118,121,174,53,54,56,427.37446580014864,17,133.5690434099391,281.7375607735232,293.6748792079633,305.6564363112173,0.3068919715644257,147,146,149,171,22,24,25,154.29578863395034,15,98.27687872633166,43.96945161116741,55.897243474529965,69.11828783242218,0.6109938265211833,15273,15263,Northwest Minnesota,Roseau,27,135,Minnesota,MN
27109,27CS023,970,900,1040,1055,15,85,155,62.73363160655023,57,42.134571909053385,-33.625628158325746,21.25261904455031,68.62226006772798,0.6638205487378438,1206,1122,1290,1266,-24,60,144,36.723601288832974,51,31.217290706428923,-48.57954826339753,3.783112353007436,57.31836350756951,0.8361243127154385,162337,163371,Olmsted,Olmsted,27,109,Minnesota,MN
27111,27CS024,582,556,608,675,67,93,119,186.66163706804534,53,106.29941000484699,27.36596841717465,81.417192739348,133.60197428643482,0.5634225841795338,712,681,743,783,40,71,102,118.25896205807126,82,136.5687923654714,-70.53542757736794,-16.566129181393705,31.931687924745688,1.1387903742130512,59831,60043,Otter Tail+Wadena+Wilkin,Otter Tail,27,111,Minnesota,MN
27159,27CS024,182,176,189,170,-19,-12,-6,-106.70871268671583,11,93.9568652573137,-249.00919592286948,-199.75203350950895,-147.91960440929418,-0.957110775246578,223,216,231,222,-9,-1,6,-8.715385044221064,29,204.70106585727396,-267.3198350893703,-213.31389557695672,-163.4627540881532,-123.5574669910585,14049,14167,Otter Tail+Wadena+Wilkin,Wadena,27,159,Minnesota,MN
27167,27CS024,71,70,72,76,4,5,6,94.14025742662095,12,223.811004041032,-141.98589363492107,-129.9690502660327,-117.7846247747487,1.9842953597389197,87,86,87,89,2,2,3,38.82602825990988,11,171.66042446941324,-145.01076702172097,-132.72909940727791,-119.75645931781693,3.1536951397785957,6434,6408,Otter Tail+Wadena+Wilkin,Wilkin,27,167,Minnesota,MN
27123,27CS025,3669,3432,3905,4354,449,685,922,149.41774122870103,630,137.36613161710463,-34.75722706028015,13.540456160525448,62.7250172883327,0.9180032284501014,4478,4197,4760,4976,216,498,779,91.39083344093798,357,65.57003688084988,-29.59974230114709,23.87314171694024,76.77412780634982,0.716029404737627,550354,544456,Ramsey,Ramsey,27,123,Minnesota,MN
27131,27CS026,446,417,474,508,34,62,91,111.84770195527287,52,93.06210105589692,-28.389748211906205,17.25941820266767,68.25503985323977,0.8189393250842963,553,518,587,615,28,62,97,92.77890225373292,73,108.58570833581246,-67.15765279234235,-15.790375474451091,32.877519018975285,1.1519028414289714,67052,67228,Rice,Rice,27,131,Minnesota,MN
27017,27CS027,326,310,341,367,26,41,57,137.72676920697276,41,136.11088057100173,-48.502205166305934,2.1170022251759937,48.45511507258172,0.9650068270121751,401,382,419,472,53,71,90,196.16570168673508,34,93.47849994501264,50.08938813286002,101.24661751929958,150.42835699273388,0.46994177092188516,36147,36372,St. Louis and Nearby Counties,Carlton,27,17,Minnesota,MN
27031,27CS027,45,45,46,48,2,3,3,61.16804076255441,1,21.547854192853297,27.089510759009183,39.57767862472108,52.72720356463271,0.26050439524918134,56,55,57,49,-8,-7,-6,-123.54322390055752,4,71.26313914127917,-206.79445711614804,-194.93801719116652,-181.94776452760857,-0.6740269104939338,5569,5613,St. Louis and Nearby Counties,Cook,27,31,Minnesota,MN
27071,27CS027,124,123,125,147,22,23,24,230.67771684988034,3,29.882958412882875,189.16714998276925,200.77702555926402,212.5904400221213,0.1241818462362397,151,149,152,186,34,35,37,295.46217052177,22,184.03881545926052,98.69161743223934,110.67117771522005,123.29402423534627,0.6057344128367307,12047,11954,St. Louis and Nearby Counties,Koochiching,27,71,Minnesota,MN
27075,27CS027,121,120,122,135,13,14,15,154.77425165749972,12,132.62110885982685,10.709485265433505,22.02259159080435,34.25057468787206,0.7997605941111399,150,148,151,169,18,19,21,174.86236651186297,6,54.68963631391851,107.94986160488213,120.22958792473756,133.2942980962366,0.2972629479876349,10858,10971,St. Louis and Nearby Counties,Lake,27,75,Minnesota,MN
27137,27CS027,1766,1680,1852,2079,227,313,399,188.23548229888928,220,132.15131325367545,5.936210395167436,56.05785559022149,108.42407997080012,0.6998199189975459,2156,2054,2259,2371,112,215,317,107.65565040225032,185,92.82675016056518,-37.74009634939911,14.19502936699685,69.13891928990246,0.8582559852300622,199771,199296,St. Louis and Nearby Counties,St. Louis,27,137,Minnesota,MN
27139,27CS028,629,564,694,740,46,111,176,88.01314095724297,64,50.81247022706823,-14.550633129449942,36.277904352865875,89.46144137745968,0.5721668464485303,795,716,874,911,37,116,195,75.85306608786506,109,71.25300700763518,-45.277307733423434,4.33729747065371,55.13983866078529,0.93132951704194,151144,152976,Scott,Scott,27,139,Minnesota,MN
27141,27CS029,486,444,528,595,67,109,151,133.78406676099473,57,70.05540932228561,13.065760919403237,64.69418633908937,120.0730396479543,0.5188785727971015,612,561,663,727,64,115,166,116.4485147866671,87,88.02015357999211,-19.078105119983025,27.453311557487144,77.08991920197937,0.749361256736907,97637,98841,Sherburne,Sherburne,27,141,Minnesota,MN
27033,27CS030,136,131,141,150,9,14,19,150.99579261661037,16,167.5392670157068,-75.16080303058936,-15.967334264974653,33.67420060809557,1.0376068814727792,167,161,173,166,-7,-1,5,-8.429352497610227,16,138.4442329324219,-196.1716883127825,-147.09396741264118,-95.73379513196478,619.6811063808541,11460,11557,Southwest Minnesota,Cottonwood,27,33,Minnesota,MN
27063,27CS030,91,90,92,96,4,5,6,55.985753180290075,11,132.71667001809772,-89.13374902652326,-76.61566545085527,-64.26753865975951,1.9502557683526658,113,112,114,106,-8,-7,-6,-69.97208979680258,8,80.10413537598879,-162.44886136845025,-150.21583110170886,-137.27255706560098,-1.335980220095267,9946,9987,Southwest Minnesota,Jackson,27,63,Minnesota,MN
27101,27CS030,82,81,83,58,-25,-24,-23,-350.1634089228103,5,73.43941248470011,-435.96714045707057,-423.4751331490112,-410.84346234291206,-0.21891138607670674,100,99,101,109,8,9,10,105.23427636500075,1,12.272950417280313,80.79457080806088,92.69242055617686,106.2414509313923,0.10444421805664597,8170,8148,Southwest Minnesota,Murray,27,101,Minnesota,MN
27105,27CS030,161,152,171,201,30,40,49,215.8444578339084,43,233.6427439438533,-70.69034441500101,-17.13822442887591,35.83514290072353,1.0558787288631257,199,187,210,184,-26,-15,-3,-66.88748053225338,18,81.74758163404333,-199.1283914071745,-147.8527727219485,-93.54107339010396,-1.3111931724346058,22085,22019,Southwest Minnesota,Nobles,27,105,Minnesota,MN
27117,27CS030,103,102,104,106,2,3,4,39.45516057772802,17,217.97200555614916,-189.89106438925228,-178.76997012299873,-166.47835659043128,4.169554970476859,126,125,127,128,1,2,3,20.6220649934482,11,117.9498177139181,-110.33101427977525,-97.05568215369887,-85.31763363063259,3.762981712254242,9359,9326,Southwest Minnesota,Pipestone,27,117,Minnesota,MN
27133,27CS030,102,101,103,119,16,17,18,212.46522524417452,13,161.6915422885572,38.83690835945617,50.59352944680585,63.41723326557182,0.7189389037520844,126,125,127,122,-5,-4,-3,-39.121837107196846,16,165.22098306484924,-217.60669268101074,-204.8788275719377,-191.47465925292732,-5.737731096952191,9648,9684,Southwest Minnesota,Rock,27,133,Minnesota,MN
27011,27CS031,68,67,68,67,-1,-1,-0,-15.212144746913653,3,70.298769771529,-97.05700157413418,-85.69109837481683,-73.6012588242897,8.551351880332165,84,83,84,76,-8,-8,-7,-145.87496165815938,1,19.436345966958214,-177.64550850429188,-165.19822744087207,-152.1442292548372,-0.1537215973198193,5121,5145,Stevens and Nearby Counties,Big Stone,27,11,Minnesota,MN
27023,27CS031,151,145,156,155,-1,4,10,40.60369009753021,28,269.96625421822273,-279.38741551715293,-228.8729878315365,-174.86776787564264,5.372960821644015,183,177,190,172,-18,-11,-5,-91.89904897171719,4,32.28149463320152,-171.3302749683559,-125.02680654958779,-73.0042994784566,-0.385088927058768,12446,12391,Stevens and Nearby Counties,Chippewa,27,23,Minnesota,MN
27051,27CS031,60,59,61,73,12,13,14,258.81067697827353,6,118.55754981063724,128.5927210767246,140.0788416648555,152.68092108294536,0.4255929765971548,75,74,75,78,3,3,4,54.03153987588102,1,16.281341582546403,25.297769305890604,37.914479035845595,49.85526402653127,0.23155560183055168,6073,6142,Stevens and Nearby Counties,Grant,27,51,Minnesota,MN
27121,27CS031,113,112,114,109,-5,-4,-3,-42.263045260404624,8,84.91817779743478,-139.69995019163997,-127.08914196459361,-114.77863627356251,-2.683185199444444,140,139,142,148,6,8,9,67.88558810638034,8,70.24321713934498,-14.613625221334173,-2.3768713504817507,10.288447944849022,0.9162239594295967,11305,11389,Stevens and Nearby Counties,Pope,27,121,Minnesota,MN
27149,27CS031,74,73,75,80,5,6,7,73.44896779943541,7,86.80376149633149,-25.42388669101248,-13.495135407337003,-0.4903155217916275,1.0111154553371353,92,91,93,74,-19,-18,-17,-183.57788844093676,4,41.27115146512588,-237.00655640726208,-225.1752151215224,-212.44920687146885,-0.23820343707663222,9677,9692,Stevens and Nearby Counties,Stevens,27,149,Minnesota,MN
27151,27CS031,106,105,107,123,16,17,18,215.7326015014733,17,210.00617665225448,-5.900318471945092,5.5596481720936,16.805710479100032,0.920732807763456,130,129,132,94,-38,-36,-35,-373.8672949919314,15,153.76729882111738,-541.271584786505,-527.5738703527077,-515.0656858832757,-0.42288358840861173,9714,9755,Stevens and Nearby Counties,Swift,27,151,Minnesota,MN
27155,27CS031,48,48,48,56,8,8,8,285.1785570769428,9,324.61677186654646,-50.849993259072924,-39.01951851860601,-28.3319766731184,1.0104893856336417,58,58,59,62,3,4,4,107.6082920042251,6,182.09408194233689,-88.12265609263557,-74.77283344837086,-60.97592478518308,1.3199306921042815,3327,3295,Stevens and Nearby Counties,Traverse,27,155,Minnesota,MN
27163,27CS032,1492,1376,1607,1715,108,223,339,100.00635244334592,172,77.07532021360021,-27.651070249792905,22.773954633663482,73.88612218499962,0.7672662473484044,1875,1735,2015,2018,3,143,283,52.64680134227394,182,66.99476925455436,-66.5263076867229,-15.059486090133452,33.83441773593045,1.2636968777790945,267790,271663,Washington,Washington,27,163,Minnesota,MN
27171,27CS033,751,690,812,824,12,73,134,62.14728139712379,92,77.9600454766932,-64.66001467616384,-16.145462198785914,32.932517087427705,1.2375656785201228,951,877,1026,1097,71,146,220,100.87929299233312,146,101.11153433290626,-52.09968567982732,-0.10251230081878175,52.62667198974221,0.9954681984166367,141611,144395,Wright,Wright,27,171,Minnesota,MN
27073,27CS034,71,70,72,94,22,23,24,409.64606847659024,16,287.0384212886829,110.86790573126757,122.56595548332825,134.15412699522886,0.6712999058836158,87,86,88,102,14,15,16,223.91051954576855,2,29.91325157044571,181.5669113419096,194.14543884431734,206.758177756566,0.12522966073461364,6689,6686,Yellow Medicine and Nearby Counties,Lac Qui Parle,27,73,Minnesota,MN
27081,27CS034,68,67,69,65,-4,-3,-2,-63.94089540897531,5,106.76156583629891,-182.6218296763782,-171.06551757357923,-158.0749710974242,-2.5068119250921197,82,82,83,101,18,19,19,332.4389792342545,6,107.60401721664275,211.67549450655812,225.31376027840753,237.48093914145267,0.30711277042702084,5620,5576,Yellow Medicine and Nearby Counties,Lincoln,27,81,Minnesota,MN
27083,27CS034,188,177,199,226,27,38,49,180.25594601358168,25,118.8636633781053,8.00776514812345,62.363009157156405,116.37886310203726,0.6424698499022332,231,218,244,247,3,16,29,64.06137512954909,37,146.69151171549777,-134.15336740635883,-82.87024412286837,-32.03558044961356,2.156403270777441,25239,25223,Yellow Medicine and Nearby Counties,Lyon,27,83,Minnesota,MN
27127,27CS034,157,150,163,178,15,21,28,165.2293624897296,21,164.126611957796,-48.14715829914593,1.3834106514353988,52.281431075759215,0.9484624933380842,191,183,199,187,-12,-4,4,-28.296547457280752,18,117.11125569290827,-196.54951715842543,-144.52847516214126,-94.03523596806379,-5.374450917732289,15354,15370,Yellow Medicine and Nearby Counties,Redwood,27,127,Minnesota,MN
27173,27CS034,89,89,90,91,1,2,2,19.301460621138183,14,176.4891270091396,-169.44267452054018,-157.16084072990458,-144.5497443725965,5.5312174005404655,108,107,110,109,-1,1,2,6.144261458537506,16,169.79730446779158,-176.4339252717504,-163.58303551155788,-150.71517613417146,10.133163978600829,9519,9423,Yellow Medicine and Nearby Counties,Yellow Medicine,27,173,Minnesota,MN
28001,28CS001,329,317,342,414,72,85,97,343.74499473664304,61,247.88350829664745,43.47883744978166,94.99000862868994,147.81494646224692,0.7127007968888487,394,379,409,467,58,73,88,253.29278178982915,60,208.05159679600538,-5.497694645351174,44.55249188933685,98.11114870769512,0.8102950105098753,29530,28839,Adams+Amite+Wilkinson,Adams,28,1,Mississippi,MS
28005,28CS001,151,146,157,167,10,16,21,151.40471946915886,23,218.49271690943633,-119.92142780569323,-66.50576178189291,-17.053766182238004,1.3579039049869879,184,178,191,224,33,40,46,315.95935018922194,31,245.13680215087777,17.348485658317433,70.5740462013294,122.01048420454673,0.7569057992967753,12632,12646,Adams+Amite+Wilkinson,Amite,28,5,Mississippi,MS
28157,28CS001,104,103,105,119,14,15,16,211.2184422935522,19,267.6684667762385,-67.9185622902531,-56.28382187054593,-44.50153599411857,1.1880205686741176,125,124,126,123,-3,-2,-1,-23.924321864771233,15,179.72681524083393,-217.090893817728,-203.8853692466458,-190.4303737435328,-15.049302978842164,8518,8346,Adams+Amite+Wilkinson,Wilkinson,28,157,Mississippi,MS
28003,28CS002,378,363,393,463,70,85,100,290.5254382648327,41,140.6116033152329,94.03040034580964,150.84538744625536,202.82501286074373,0.4783439924704624,456,438,474,541,67,85,103,246.89223826013952,67,194.78442887461117,0.8166069061325343,52.72289000607872,103.47748408148752,0.7797631836913935,34990,34397,Alcorn+Prentiss+Tishomingo,Alcorn,28,3,Mississippi,MS
28117,28CS002,267,256,278,342,64,75,86,361.2361636977827,45,216.32881980610526,95.30559925675986,144.98341586432122,198.71067586629437,0.5909921554688623,326,313,339,367,28,41,54,162.6633477913658,40,160.08324328650897,-53.644976589435416,-0.18623398934372978,53.29826503497122,0.9605065931698749,24962,24987,Alcorn+Prentiss+Tishomingo,Prentiss,28,117,Mississippi,MS
28141,28CS002,240,232,249,308,59,68,76,429.3235043390523,44,279.45379485550967,97.10571980830352,148.91314764239127,197.21151734539416,0.6414276008439728,291,282,301,394,93,103,112,547.6087614375147,39,207.88912579957358,287.2017083405798,341.04424222866083,391.66527590088083,0.37597100424105795,18894,18760,Alcorn+Prentiss+Tishomingo,Tishomingo,28,141,Mississippi,MS
28007,28CS003,221,213,229,272,43,51,59,342.56249667337534,33,221.61284906821868,67.58010592539382,120.16544140607924,168.70002788990874,0.6344883595316528,268,258,277,305,28,37,47,211.02089764975835,33,185.86313714446635,-26.58039938051249,26.0118574916897,75.85934343070493,0.857883525307691,17869,17755,Attala+Choctaw+Leake+Webster,Attala,28,7,Mississippi,MS
28019,28CS003,92,92,93,108,15,16,16,227.46191548009034,10,146.50225857648638,69.08571056493395,81.43430058291176,92.60855756526301,0.6051008337170511,112,111,113,115,2,3,4,33.704321482105435,13,160.0985221674877,-138.47074003090714,-126.1656728516697,-114.13040675145449,3.478920906405886,8191,8120,Attala+Choctaw+Leake+Webster,Choctaw,28,19,Mississippi,MS
28079,28CS003,188,179,198,270,72,82,91,456.3446994592234,62,346.4816280910912,60.016764316046576,109.69628748584012,161.73077264177007,0.7500688270196714,229,218,240,317,77,88,99,416.85658381714256,38,179.2199217091921,187.21208895583413,237.2252333732036,286.4147715664629,0.42512201982693976,21473,21203,Attala+Choctaw+Leake+Webster,Leake,28,79,Mississippi,MS
28155,28CS003,135,131,139,152,13,17,21,205.89787744113204,20,242.5222312045271,-88.08482478714402,-36.235600975345164,14.776670150064461,1.1123648930348486,165,160,170,203,33,38,43,379.5634851135292,23,230.59955885301784,93.69738073319586,148.25097998843384,199.93976423477523,0.5919038566167014,9896,9974,Attala+Choctaw+Leake+Webster,Webster,28,155,Mississippi,MS
28009,28CS004,88,87,89,119,30,31,32,482.9140760278705,18,278.74564459930315,192.1510662042272,204.02843782281803,216.83169627233343,0.5592810498864568,106,105,107,132,25,26,27,337.75787409770686,24,313.8075313807531,11.012223228468065,23.989049466431386,37.10682039324595,0.8944636431189459,7749,7648,Benton+Marshall+Tippah,Benton,28,9,Mississippi,MS
28093,28CS004,339,324,353,437,84,98,113,347.19833711696214,46,162.46284251111047,133.16120696528114,183.93280766675528,238.7072244636393,0.4632132368734866,413,395,430,580,150,167,185,495.9120410836921,72,213.46615671973672,232.4563999893276,282.70465538557363,334.04876926858356,0.42789349160298945,33977,33729,Benton+Marshall+Tippah,Marshall,28,93,Mississippi,MS
28139,28CS004,231,221,240,285,45,54,64,300.1209299566196,43,237.08877044660906,12.424380149547925,63.850893562824496,114.70365936997347,0.7757261551986132,281,270,292,334,42,53,64,246.2041902759369,45,207.8617950020786,-12.442613455541485,36.438000163892994,85.55398383843719,0.8287179093646093,21764,21649,Benton+Marshall+Tippah,Tippah,28,139,Mississippi,MS
28011,28CS005,337,324,350,473,123,136,149,529.3228305348324,87,339.25844084099697,144.80581721101865,190.75751394266752,240.94099388776192,0.6362419711625715,409,393,425,492,67,83,99,273.40722121558804,50,164.54404844176787,57.69732933975042,107.58304830526498,161.88716375012297,0.5946699566883795,30773,30387,Bolivar+Sunflower,Bolivar,28,11,Mississippi,MS
28133,28CS005,267,256,278,367,89,100,111,467.73989819983706,55,257.0093457943925,160.0245345649392,211.1792720935148,261.8070335622735,0.5440355305763909,325,312,338,397,59,72,85,283.0821181028844,43,168.86584982720703,63.12471855372709,114.0024256061618,164.14837697062617,0.5883638282428059,25680,25464,Bolivar+Sunflower,Sunflower,28,133,Mississippi,MS
28013,28CS006,143,137,149,209,60,66,72,593.5717180096599,19,170.39085270159183,371.67171943798786,422.2875055238836,477.0342110514337,0.2827877809289135,171,164,178,231,53,60,67,459.7067712967297,32,245.21072796934865,162.44544995890251,211.9482045501147,263.6662719749784,0.5246612628100666,13381,13050,Calhoun+Chickasaw+Grenada,Calhoun,28,13,Mississippi,MS
28017,28CS006,171,164,179,210,31,39,46,272.54077751238884,34,239.2260334212841,-16.893606361746404,33.83331946369272,80.43381305838095,0.8556718636473191,209,200,218,248,30,39,48,229.7652305269906,33,193.90093424995592,-15.679470311040237,36.22326452039998,86.28578374991794,0.8228658032514252,17055,17019,Calhoun+Chickasaw+Grenada,Chickasaw,28,17,Mississippi,MS
28043,28CS006,262,252,271,329,58,67,77,377.1445110379624,48,268.71938418474457,57.17700099438891,109.20941473501794,158.7999606926726,0.7020886141805882,318,306,329,350,21,32,44,151.72606304379826,39,182.27706113292203,-82.78229672706468,-31.67865521959495,22.886674979834634,1.1654555932391382,21435,21396,Calhoun+Chickasaw+Grenada,Grenada,28,43,Mississippi,MS
28015,28CS007,96,95,97,141,44,45,46,547.887768965511,20,241.61884627000904,294.2849175191858,305.93266786494564,318.76497399665146,0.43148633379556706,117,116,119,156,37,39,40,391.61952076440406,24,242.71844660194174,136.20532162965847,148.7270135242724,162.13594307222004,0.6041788298656717,9933,9888,Carroll+Leflore+Montgomery,Carroll,28,15,Mississippi,MS
28083,28CS007,306,294,318,477,159,171,183,729.8920776623512,91,388.1976537504444,289.5872588089222,340.8663444490346,391.0273674072843,0.5287658258604785,369,354,383,442,59,73,88,265.5389929145859,39,141.0488245931284,73.83011280026079,123.78964784183644,175.02487645915554,0.5240418893902445,28130,27650,Carroll+Leflore+Montgomery,Leflore,28,83,Mississippi,MS
28097,28CS007,133,129,137,184,47,51,55,624.334285485648,35,429.3600490697199,145.01393842131142,193.7484371844636,248.14467172292294,0.6744563180451033,162,157,167,169,2,7,12,75.3714597431769,26,266.99527623742046,-244.54777673665234,-190.80369122185448,-143.3128825754664,3.117628326681396,9782,9738,Carroll+Leflore+Montgomery,Montgomery,28,97,Mississippi,MS
28021,28CS008,91,90,92,113,21,22,23,293.34657325262407,20,264.9006622516556,15.828342482795229,28.775826321039386,40.67396485796636,0.8640179859852729,110,109,111,130,19,20,21,227.7530554651082,20,223.83883603805262,-7.936225981145436,3.7423185705406006,16.4037945206703,0.9367797551665092,9060,8935,Claiborne+Jefferson+Warren,Claiborne,28,21,Mississippi,MS
28063,28CS008,73,73,74,97,23,24,24,391.2340811070884,17,282.74428274428277,96.67318392607386,108.11069907653876,120.8201023147626,0.6932282048240805,90,89,91,104,13,14,15,195.8570423170834,20,277.31558513588465,-94.34221973781307,-81.78760170685199,-68.86579137354722,1.3222956998897544,7215,7212,Claiborne+Jefferson+Warren,Jefferson,28,63,Mississippi,MS
28149,28CS008,427,408,446,581,135,154,173,414.6238852048515,87,234.16997510261757,127.50592488090173,180.25632846802765,230.67045068655761,0.5611341500744881,511,489,534,653,119,142,164,323.66832079127903,98,224.15370539798718,47.900831863657814,99.84833298225246,150.549054275092,0.6876817057031659,44583,43720,Claiborne+Jefferson+Warren,Warren,28,149,Mississippi,MS
28023,28CS009,183,176,189,237,48,54,61,421.4696101353596,45,348.00541341754206,25.86572981087054,71.9031584107552,126.18899635004436,0.8108176357440348,220,212,228,254,26,34,42,217.5556348724102,35,226.72799118999805,-60.35450216114501,-8.263907229001617,42.787894321704584,1.0120268298283364,15517,15437,Clarke+Jasper+Wayne,Clarke,28,23,Mississippi,MS
28061,28CS009,166,159,173,209,36,43,50,313.3983376194545,22,161.5172835729581,103.26665808126828,152.92101422768334,205.3476634903866,0.5035769386221461,202,193,210,317,107,115,124,707.2934721012687,37,227.00779188907296,427.0723378116922,481.0770611412249,531.2746018589007,0.3181926300372716,16345,16299,Clarke+Jasper+Wayne,Jasper,28,61,Mississippi,MS
28153,28CS009,185,176,193,224,31,39,48,237.2119827289638,29,175.49167927382751,11.211930614241687,64.28947337899176,112.95743047687172,0.7214059529101684,224,214,234,301,67,77,87,390.28611587774816,39,197.7787920279933,144.63887442460097,194.57236468348782,240.7885171493232,0.5002532102818008,19830,19719,Clarke+Jasper+Wayne,Wayne,28,153,Mississippi,MS
28025,28CS010,185,177,193,241,48,56,64,355.9048603765896,29,185.7386848847139,117.36558227757187,171.48500657071733,220.1086739606963,0.5126517846575803,224,215,234,287,53,63,72,338.4625845096512,41,221.01234434801358,68.1375254780979,114.56959885743889,169.19776955362417,0.6427521676868477,18736,18551,Clay+Oktibbeha,Clay,28,25,Mississippi,MS
28105,28CS010,284,262,306,397,91,113,135,263.398780070095,73,170.40149393090567,39.90981502252873,91.92923278400923,146.63225029606193,0.6412506678561941,352,325,379,428,49,76,103,146.21101102408417,61,117.70835343380352,-20.031480669780837,28.186931577342673,81.50004363805206,0.7945715678807996,51408,51823,Clay+Oktibbeha,Oktibbeha,28,105,Mississippi,MS
28027,28CS011,234,225,243,333,90,99,108,559.3991874717972,58,326.54593225110256,185.50331131280726,232.00437814155845,284.1129500429823,0.5779274423002657,282,271,293,390,97,108,119,516.5046396800598,53,253.92870831736298,210.58979769841068,263.64091996310236,315.47678237020074,0.4871106460997735,21314,20872,Coahoma+Quitman+Tallahatchie+Tunica,Coahoma,28,27,Mississippi,MS
28119,28CS011,72,72,73,123,50,51,51,979.1636491924717,13,250.56215868936715,716.2915789788207,728.277227537829,741.1174805420181,0.25095423417641854,85,84,86,130,44,45,46,751.8629117508835,19,318.417965476789,420.22962823149277,433.6983099920076,446.2622122454346,0.4142713430006808,6226,5967,Coahoma+Quitman+Tallahatchie+Tunica,Quitman,28,119,Mississippi,MS
28135,28CS011,131,125,136,181,45,50,56,471.6088413590165,31,290.1263453439401,135.16350882146222,181.91742282101455,228.7715693504968,0.603213712126378,157,150,163,192,29,35,42,283.9539416939919,24,193.39242546333602,39.42527172301532,91.26870113907474,141.7600303924113,0.6622757021540344,12822,12410,Coahoma+Quitman+Tallahatchie+Tunica,Tallahatchie,28,135,Mississippi,MS
28143,28CS011,94,93,95,117,22,23,24,288.1265963409449,15,185.56701030927834,88.86206197834412,102.35341583225767,114.27637052864542,0.6175321526921393,116,114,117,163,46,47,49,489.11819333095957,21,216.49484536082477,259.1044304704574,272.9464830232024,284.3911636070327,0.4334860568080662,9700,9700,Coahoma+Quitman+Tallahatchie+Tunica,Tunica,28,143,Mississippi,MS
28029,28CS012,273,261,285,364,79,91,103,385.696110632827,42,178.50818162499115,156.16738986708023,205.7410057398051,257.55359665726434,0.45777631211707676,331,316,345,399,54,68,83,243.46597517098763,46,164.0630572794065,28.35901021044942,79.93902216260629,129.4022384883613,0.6641353473382944,28234,28038,Copiah+Franklin+Lincoln,Copiah,28,29,Mississippi,MS
28037,28CS012,84,83,84,103,19,19,20,305.36665907088405,14,219.2925205586738,74.635961894127135,85.81944090877819,98.74190629472679,0.6830895558780308,103,102,104,143,39,40,41,527.0761153677603,16,208.52339371823277,305.233979376947,318.55180747156555,330.7021244686208,0.38607662587745206,7661,7673,Copiah+Franklin+Lincoln,Franklin,28,37,Mississippi,MS
28085,28CS012,362,347,377,474,97,112,127,387.4562399132436,74,255.7161780798249,79.99297188183495,133.06062945471047,186.6867376982023,0.6541530244223834,443,425,461,536,75,93,111,267.5687399684992,54,154.62146374985682,61.95030275753837,111.07629874115808,163.15069531781901,0.5717570640334558,34726,34924,Copiah+Franklin+Lincoln,Lincoln,28,85,Mississippi,MS
28031,28CS013,218,210,226,298,72,80,88,522.6819537403447,50,327.0467676877793,143.85111274800954,195.7829946210186,247.82324313392667,0.6179754776812527,264,255,273,302,29,38,47,207.89771672521294,30,164.07788230146576,-7.609980083437187,42.055604623535835,93.36612253689965,0.768993790464264,18346,18284,Covington+Simpson+Smith,Covington,28,31,Mississippi,MS
28127,28CS013,252,241,263,350,87,98,109,452.33083554514945,58,267.57910114951363,131.579161483429,185.51746337044614,232.3842751748867,0.585583668947621,304,291,318,400,82,96,109,371.0722871541774,58,225.05917504171356,94.14164802178144,146.4852687108751,195.8996205033276,0.6002336412190702,26011,25771,Covington+Simpson+Smith,Simpson,28,127,Mississippi,MS
28129,28CS013,140,134,146,164,18,24,30,201.21727678249056,16,132.95478152482514,19.344803644448973,70.29187909705227,121.14514729062896,0.6345473989215291,168,161,176,221,45,53,60,371.47603047567515,32,225.4632565349116,94.91954908654215,146.0163272688536,194.99807240831876,0.5956414716487047,14441,14193,Covington+Simpson+Smith,Smith,28,129,Mississippi,MS
28033,28CS014,1250,1170,1330,1497,167,247,327,159.53743086580403,152,98.00602866031561,11.108496901907515,62.652653061729666,110.34763331302668,0.6118409170991369,1558,1461,1655,2083,428,525,622,278.966484909052,275,146.09397827184105,81.24741145684352,132.35398408366328,185.15106950119656,0.5227018311454141,186111,188235,De Soto,De Soto,28,33,Mississippi,MS
28035,28CS015,682,649,716,780,64,98,131,151.29565313813995,92,142.16361693086264,-41.12711484464257,8.469023597758277,63.116740970114,0.9301411322141968,839,798,879,1029,150,190,231,244.274427342818,141,180.9710831311848,14.826901755892065,62.9174992065289,113.83610215577536,0.7369792444575921,77657,77913,Forrest,Forrest,28,35,Mississippi,MS
28039,28CS016,245,235,256,269,13,24,34,116.71241522646352,37,182.0119701565959,-114.0996030482171,-65.91241025185006,-17.530350751940805,1.496419383354104,303,290,316,382,66,79,92,320.74614977091875,42,170.04048582995952,100.25347675564947,151.57414582796432,201.360661057609,0.5235321533123829,24394,24700,George+Greene+Perry+Stone,George,28,39,Mississippi,MS
28041,28CS016,118,117,119,141,22,23,24,203.1752864783461,22,195.20851818988464,-3.891491814959818,7.917914932215776,19.759764214132165,0.9205847218047072,146,144,147,143,-4,-3,-1,-20.205491534581586,17,124.8989787671736,-157.66698949677345,-145.1896665028925,-133.32408692816924,-9.713345169563771,13524,13611,George+Greene+Perry+Stone,Greene,28,41,Mississippi,MS
28111,28CS016,126,121,131,177,46,51,56,524.8705148751923,25,259.56047759127875,216.30571167455332,266.3185547235982,316.3380374252199,0.48493050876305566,154,148,160,195,35,41,47,351.6328461322721,26,224.9913464866736,76.44925904564083,126.64194530616383,177.76741938653947,0.6244792248718909,11558,11556,George+Greene+Perry+Stone,Perry,28,111,Mississippi,MS
28131,28CS016,168,160,176,217,41,49,57,321.14494317684574,14,91.5082520834468,178.0956912880213,229.69860176937965,284.1223776572126,0.27925996055607327,208,198,217,282,65,74,84,400.1326080156988,47,252.70175815904082,94.30158693188827,148.5390480463079,199.8598114127682,0.6231713916831215,18359,18599,George+Greene+Perry+Stone,Stone,28,131,Mississippi,MS
28045,28CS017,428,408,448,522,74,94,114,243.77462012635846,54,139.938668855008,50.54816597723466,104.94224309000428,156.43033930431048,0.5680111100662151,522,498,546,658,112,136,160,295.22639519460927,78,169.3516870033436,73.04185472201983,126.37303810528587,174.4396789126141,0.5694454282944487,46306,46058,Hancock+Harrison,Hancock,28,45,Mississippi,MS
28047,28CS017,1808,1719,1898,2084,186,276,365,158.59698714601407,145,83.41922957067861,23.60339812647299,74.96530216367977,127.02875232178388,0.5240813487666266,2223,2115,2331,2856,525,633,741,302.5581226014519,348,166.2828145755488,84.63325172924732,135.69120135028356,188.01566049875464,0.5487230684733676,208585,209282,Hancock+Harrison,Harrison,28,47,Mississippi,MS
28049,28CS018,1812,1715,1910,2460,550,648,745,342.3364621836827,268,141.67775359701136,154.36799528881988,201.09643479455008,254.7990166528536,0.4132171785661274,2200,2084,2315,2878,563,678,794,303.8951549110728,329,147.36446052961622,101.12508864330712,156.77553247390478,206.90280009066475,0.4842050779943926,226994,223256,Hinds,Hinds,28,49,Mississippi,MS
28057,28CS019,259,248,269,301,32,42,53,213.70078494091652,43,217.20828422293317,-54.24824780007468,-4.510457983289328,47.466576980396525,0.992942440872623,318,305,330,358,28,40,53,169.6952822244306,56,234.93874811209935,-117.20082324060087,-66.55737200261615,-10.771437328600125,1.351072025327786,23756,23836,Itawamba+Monroe,Itawamba,28,57,Mississippi,MS
28095,28CS019,368,353,382,495,113,127,142,445.8298027824901,76,266.3084739823629,127.78215548758996,178.0653546120389,229.03836632751953,0.5926739485069039,447,430,465,554,89,107,124,314.8010517619627,84,247.68532169605473,17.145383465040695,68.86733045757418,118.22877146046093,0.7794982408636023,34246,33914,Itawamba+Monroe,Monroe,28,95,Mississippi,MS
28059,28CS020,1217,1155,1279,1424,145,207,269,173.32190039295875,142,118.84668498653909,-0.23003313966017072,54.1691749590218,100.33748738304055,0.6824039418706795,1502,1428,1576,1824,248,322,396,223.8512680325857,207,143.86389224802969,28.78402723038582,81.06818334927773,130.69063774743233,0.6406870928523427,143378,143886,Jackson,Jackson,28,59,Mississippi,MS
28065,28CS021,143,138,148,145,-3,2,7,20.29238294531486,21,224.5989304812834,-257.9181799545707,-204.61803646366295,-154.96499334648075,7.248032991167023,173,168,179,197,18,24,29,211.87454923075026,17,152.4390243902439,8.510392938273489,60.20459260520428,110.77247313329244,0.6902642366479198,11220,11152,Jefferson Davis+Lawrence+Marion,Jefferson Davis,28,65,Mississippi,MS
28077,28CS021,142,136,147,176,29,34,40,341.76395530579606,17,169.1963174919134,125.07028950587109,173.10375455675606,222.07830280965783,0.4810585541671443,170,164,177,202,25,32,38,266.46240883953413,27,228.09833572695783,-18.389852167855576,38.032646608933426,91.61110968296802,0.8297185432599276,12057,11837,Jefferson Davis+Lawrence+Marion,Lawrence,28,77,Mississippi,MS
28091,28CS021,275,264,285,397,112,122,133,601.073445690591,66,324.43060789775524,224.85474136304455,276.2590225102448,330.04911403597845,0.535373703582783,335,323,348,408,60,73,85,297.5128630384305,39,159.96062507690417,88.11913824568997,136.85749047872474,184.5934057290992,0.5303480728412996,24412,24381,Jefferson Davis+Lawrence+Marion,Marion,28,91,Mississippi,MS
28067,28CS022,658,629,687,763,76,105,134,187.92902508942606,86,153.41846670730075,-16.366870421753802,34.85658535596998,86.12699344582413,0.8086873247971301,800,765,834,1048,214,248,283,371.9752583544434,138,206.58064129816475,115.49937462423611,166.15615340348074,215.47337823641473,0.5531352280013236,67267,66802,Jones,Jones,28,67,Mississippi,MS
28069,28CS023,83,82,84,106,22,23,24,301.748707373238,20,264.22987999559615,25.347703621605397,37.40838978306082,49.90807184384413,0.8389310104696686,100,98,101,133,32,33,35,378.48664351285095,19,214.6650096034346,151.76455258123966,164.3062655692246,176.76359253016534,0.5507269871731183,9083,8851,Kemper+Neshoba+Noxubee+Winston,Kemper,28,69,Mississippi,MS
28099,28CS023,336,324,349,497,148,161,173,665.5750009303664,121,500.43081164914696,114.18685675969084,166.21927209274477,213.79667773951826,0.747234204760466,410,395,425,470,45,60,75,207.53575731828587,65,224.19204635601696,-72.1578278674902,-16.584707588742482,33.570411754117515,1.0625977630525676,29015,28993,Kemper+Neshoba+Noxubee+Winston,Neshoba,28,99,Mississippi,MS
28103,28CS023,103,102,104,143,39,40,41,466.56947793561733,18,210.77283372365338,243.2314631633118,256.15658309486486,268.2045728749054,0.44069005445054693,125,124,126,151,25,26,27,254.48124001142023,19,187.39520662787257,53.64068740402284,67.55060895665125,79.65220205586925,0.7089062108257812,10248,10139,Kemper+Neshoba+Noxubee+Winston,Noxubee,28,103,Mississippi,MS
28159,28CS023,191,184,199,258,59,67,74,450.72821551075117,49,331.97831978319783,63.70229514546267,116.92179233885413,170.70845775457497,0.7256304641501277,233,224,242,299,57,66,75,376.14854856682433,39,221.50281138183678,104.91781704370985,155.52545111859212,204.12186223211708,0.5801113297785314,17712,17607,Kemper+Neshoba+Noxubee+Winston,Winston,28,159,Mississippi,MS
28071,28CS024,342,318,366,409,43,67,91,144.76423538721642,56,120.50785452980415,-24.519998638128115,24.143443557347446,76.27479747416328,0.8202491367421767,428,398,457,523,66,95,125,168.19989189138494,46,81.07012565869476,37.521958941902234,88.53194252240426,141.70785985228792,0.4769889109005242,55764,56741,Lafayette+Yalobusha,Lafayette,28,71,Mississippi,MS
28161,28CS024,165,160,171,212,41,47,52,452.2914074258543,25,242.07213749697408,161.4805712153661,210.32002451915687,261.57556196614206,0.5239948222311354,201,195,207,196,-11,-5,1,-39.631227665112924,16,128.8244766505636,-222.84057580751934,-168.8001395861825,-114.24413039721861,-4.079344810793135,12393,12420,Lafayette+Yalobusha,Yalobusha,28,161,Mississippi,MS
28073,28CS025,387,359,415,484,69,97,125,181.08854317144687,53,98.8560059686645,29.759542262343835,80.96151007040731,132.87752017499622,0.5403333111210983,482,448,516,577,61,95,129,145.88274321302254,86,131.88363569445934,-35.595700417444945,14.427985282158156,67.26602738697177,0.8946341692175874,64336,65209,Lamar,Lamar,28,73,Mississippi,MS
28075,28CS026,702,671,733,1032,299,330,361,542.8308466023104,151,248.4880898506603,244.07087658864637,295.5271323371531,347.8894605198353,0.4563798560544073,852,815,889,1071,182,219,256,303.6504158732996,140,193.96492005874364,58.945118588492555,109.82074421315193,159.9700212779536,0.6358757544218121,72921,72178,Lauderdale+Newton,Lauderdale,28,75,Mississippi,MS
28101,28CS026,224,215,233,276,43,52,61,296.64321895623794,39,220.90059473237042,23.87325851943394,76.65151015891469,126.9324141719617,0.7307152948805753,272,261,283,324,41,52,63,248.13161222723951,45,213.442109756676,-14.316475165748253,35.47349586927899,83.59727268300028,0.8440624961099744,21186,21083,Lauderdale+Newton,Newton,28,101,Mississippi,MS
28081,28CS027,762,726,797,969,172,207,243,297.9605564792381,116,166.60881638320026,81.40203906875557,131.6107089999221,185.47559236709466,0.5564815471289657,927,884,970,1168,198,241,284,290.8644510884729,141,170.0167605175262,70.91701547905372,119.31479250277977,169.88836331614095,0.5821091472868277,83549,82933,Lee,Lee,28,81,Mississippi,MS
28087,28CS028,550,524,575,694,119,144,170,295.2556399975692,88,180.04808102163645,61.88216778825165,115.02666268359468,170.98562067967075,0.6056074243839541,671,641,701,753,52,82,112,141.03486323454567,87,149.39725933303566,-57.182903594798034,-8.89854657782688,44.00316770711017,1.0465505409220088,58651,58234,Lowndes,Lowndes,28,87,Mississippi,MS
28089,28CS029,900,853,947,1018,71,118,165,130.07193297392755,121,133.37987543862872,-52.88386666123346,-3.3835490527420777,46.98458487765862,1.0168145006501257,1112,1056,1169,1176,7,64,120,58.181408219442766,131,119.38720643050479,-113.05776467153596,-64.26915654568998,-12.86066593705959,2.0203355627797874,108862,109727,Madison,Madison,28,89,Mississippi,MS
28107,28CS030,327,313,342,403,61,76,90,273.28854171876213,67,241.94276428635914,-17.26107670559085,30.79126210791688,82.72953351516297,0.873756191908917,397,380,414,499,85,102,119,311.27635154120645,61,185.4723463772082,76.02490345822137,126.0355650914608,179.2431678266064,0.5900807659752404,33231,32889,Panola+Tate,Panola,28,107,Mississippi,MS
28137,28CS030,254,242,266,377,111,123,135,525.6163091118461,55,234.35835523045236,238.05482278339292,291.60480742463744,343.95487803264825,0.44228791121827105,311,297,326,413,87,102,116,360.9547381273971,62,219.71791055354737,89.31565724329859,140.9669959895713,190.26176770711598,0.602794977499737,28162,28218,Panola+Tate,Tate,28,137,Mississippi,MS
28109,28CS031,592,568,616,712,96,120,144,255.99087635046268,84,179.61190998022127,24.124413669865397,76.82825972996945,131.41647122793614,0.6958219769652961,729,700,758,932,174,203,232,359.7050969316011,154,272.80779450841453,36.0759360845747,86.68439023180588,137.6352483042691,0.7547039352843847,56121,56450,Pearl River,Pearl River,28,109,Mississippi,MS
28113,28CS032,448,431,465,543,78,95,112,285.17279476067046,59,176.77902621722845,60.8098381807817,107.56576715283607,158.9486171455488,0.6134559785630745,545,524,565,640,75,95,116,238.05810931525713,78,194.9658809708301,-11.846341220857331,42.295649621123324,102.68084654519323,0.8104745919661145,40050,40007,Pike+Walthall,Pike,28,113,Mississippi,MS
28147,28CS032,153,147,159,200,41,47,53,401.07405286011846,33,284.3601895734597,65.63256040476034,116.47513409481627,165.44060679898507,0.6940844927754379,186,179,193,229,36,43,50,308.1418767526484,30,216.7630057803468,41.95606555053328,92.41048140749842,144.72037987366033,0.6873350493708877,13926,13840,Pike+Walthall,Walthall,28,147,Mississippi,MS
28115,28CS033,257,243,270,386,116,129,143,494.13847725904793,38,145.27845036319613,296.1811054276059,349.3495375713162,401.7961071620831,0.2917462953059012,316,300,332,458,126,142,158,452.3847806436033,63,200.57306590257878,201.4210265099012,251.24313430852408,303.95788938007036,0.44026984890944704,31388,31410,Pontotoc+Union,Pontotoc,28,115,Mississippi,MS
28145,28CS033,260,248,272,294,22,34,46,146.20198382019268,40,171.8336077897902,-78.15256454634603,-25.089231993937137,28.567360749500686,1.1417680548838707,319,304,333,379,46,60,75,215.88757038777214,46,164.7092523632197,1.6240730214538353,50.08308733220714,105.26723158931246,0.7504925434690702,27934,27928,Pontotoc+Union,Union,28,145,Mississippi,MS
28121,28CS034,1054,986,1122,1391,269,337,405,257.74307799081976,140,107.06706349459247,100.16692475389803,151.785900300376,201.29805348145018,0.4141733665171296,1312,1230,1393,1608,215,296,378,187.51293104322775,209,132.32538114774857,3.5083623396663834,55.65253068112914,104.08691461447869,0.7033119712332297,156911,157944,Rankin+Scott,Rankin,28,121,Mississippi,MS
28123,28CS034,257,245,269,302,33,45,57,194.87095760380478,43,184.57576191157534,-38.07649176102259,9.218718270982738,61.49185162792625,0.9267553475538426,312,298,326,398,72,86,100,311.7344819563195,51,184.44846292947557,74.3294761700087,128.394042314969,176.19793111873895,0.5848987116835933,27956,27650,Rankin+Scott,Scott,28,123,Mississippi,MS
28151,28CS035,492,473,511,687,176,195,214,526.0521101989881,97,262.0264277513901,213.20102621357142,263.2586209536463,317.8596635539951,0.49555505652126053,596,573,618,713,95,117,140,267.4310988660086,45,102.68814750581899,110.72180851872348,162.55989868880278,217.15243875905077,0.3807310939325735,44423,43822,Washington,Washington,28,151,Mississippi,MS
28051,28CS036,179,172,187,260,73,81,88,573.4333481355312,62,440.5755906910641,83.7620798193647,132.09158891627868,183.49938293765712,0.7589072956973263,215,207,224,299,75,84,92,505.6296321076927,27,163.07302047472368,292.32768149589793,343.0171114034849,396.1772933495155,0.31870780016638917,16887,16557,Yazoo and Nearby Counties,Holmes,28,51,Mississippi,MS
28053,28CS036,82,81,83,117,34,35,36,542.9654486158544,25,387.19669592152815,144.0331248308529,155.84043781567058,167.99341211024728,0.6933376246755841,99,98,100,144,44,45,46,593.884308239142,14,184.8184818481848,395.5520483592116,409.19126691060876,420.67183246020437,0.3044356071219528,7748,7575,Yazoo and Nearby Counties,Humphreys,28,53,Mississippi,MS
28055,28CS036,13,13,13,13,-0,-0,-0,-14.811599067120277,1,90.84027252081756,-117.73808427191594,-105.54438299549336,-94.60152334343027,1.1948159607985371,16,16,16,13,-3,-3,-3,-222.37938458362973,1,77.7000777000777,-312.60304687859,-299.59394303426296,-287.1668407700308,-0.5370503866362598,1321,1287,Yazoo and Nearby Counties,Issaquena,28,55,Mississippi,MS
28125,28CS036,46,46,47,75,28,29,29,897.4134850253112,14,437.956204379562,448.21820082788645,460.09555707359493,470.82832157976753,0.4715818425755356,55,54,55,76,21,21,22,576.9667703533327,7,190.32082653616095,373.6916660334353,387.01569818579105,399.4235838794405,0.315019625214902,3836,3678,Yazoo and Nearby Counties,Sharkey,28,125,Mississippi,MS
28163,28CS036,244,232,256,307,51,63,75,279.46574340004463,38,168.6265808741957,59.849789655946964,110.24624839333208,165.18887006119482,0.5939578362857247,295,281,308,361,53,66,80,251.63809254410964,33,124.95740088606156,77.16823285254246,125.35231699228191,177.18000393616887,0.48921427900404335,27042,26409,Yazoo and Nearby Counties,Yazoo,28,163,Mississippi,MS
29003,29CS001,159,151,167,175,8,16,24,107.69496587202201,18,119.87346689605415,-61.72051876320124,-12.88914310740728,35.03077762356284,1.04826096924166,194,185,204,191,-13,-3,6,-18.89282165835561,16,88.81980681692018,-163.2504930374715,-107.46532675580309,-56.5246275697119,-6.657366066811085,18019,18014,Andrew+Atchison+Holt+Nodaway,Andrew,29,3,Missouri,MO
29005,29CS001,64,64,65,87,22,23,23,512.4895074918327,11,250.47438330170775,249.56459100717765,262.13974142453026,273.9893175980412,0.4679490851197159,79,78,79,95,16,16,17,313.785715201569,3,57.20823798627002,244.2312902437415,256.47988005299385,268.96813156695265,0.1718712833221038,5270,5244,Andrew+Atchison+Holt+Nodaway,Atchison,29,5,Missouri,MO
29087,29CS001,47,46,47,64,17,17,18,495.64784372142975,18,511.9696610571226,-28.57277665762659,-16.509585007758744,-4.417584178040817,0.9768724309304602,57,57,58,83,25,26,26,615.1258105676883,5,118.48341232227489,484.32252052308877,496.34053193771433,508.77879303255395,0.18547157248627627,4219,4220,Andrew+Atchison+Holt+Nodaway,Holt,29,87,Missouri,MO
29147,29CS001,162,153,171,156,-15,-6,3,-33.80132754878438,20,112.4701251230142,-197.56856301502066,-148.18647086984768,-94.27755889231686,-3.9914414941802647,198,187,209,168,-41,-30,-19,-142.3930994402853,15,70.86167800453515,-265.21279948460784,-212.70644301816097,-159.68692723852453,-0.5147250608405717,21339,21168,Andrew+Atchison+Holt+Nodaway,Nodaway,29,147,Missouri,MO
29007,29CS002,258,247,269,325,56,67,78,322.08991328532124,42,202.11742059672758,70.0071103085448,119.79504909078827,169.1153363233682,0.6182809424429782,317,304,330,330,0,13,26,52.61977462982026,38,152.15824457435733,-150.15929253559057,-98.93506559390322,-47.57151765288995,2.6871716692103953,24936,24974,Audrain+Callaway,Audrain,29,7,Missouri,MO
29027,29CS002,353,333,372,452,80,99,119,268.83824582128244,38,102.71658332207053,115.42222530622493,164.57739011424363,219.8331193902788,0.37827239576671906,437,414,460,503,43,66,89,147.95104052727484,57,127.83995334963106,-33.48454376494336,22.061127698661117,71.61538416142878,0.8511663835504373,44394,44587,Audrain+Callaway,Callaway,29,27,Missouri,MO
29009,29CS003,362,348,377,437,60,75,89,257.6681259346678,52,179.62520510089524,24.826204266846062,79.87543949319267,129.75462974595985,0.6878964272196004,444,426,462,501,39,57,75,164.06394091477674,51,147.02914636607375,-34.34922954392246,17.755371839155057,67.70230718182589,0.8806942619431667,34739,34687,Barry+Lawrence+McDonald,Barry,29,9,Missouri,MO
29109,29CS003,412,395,428,453,25,41,58,130.36857335860302,56,176.61900756938604,-96.57000762107373,-46.90384327845033,5.687129461248195,1.3227660391202443,507,487,527,581,54,74,94,193.64687370518322,59,154.171783950456,-16.965721179915587,39.05773428277969,89.97302382745589,0.7855488610304465,38048,38269,Barry+Lawrence+McDonald,Lawrence,29,109,Missouri,MO
29119,29CS003,210,200,220,260,40,50,60,257.40115514187005,29,149.73538143797597,55.45350151664677,107.78006400439862,161.50944455365237,0.5702804959701914,259,247,271,304,33,45,57,191.14005159326823,39,166.88775728529248,-27.800809854551268,24.537416062084233,76.94475467636066,0.8539986657270783,23241,23369,Barry+Lawrence+McDonald,McDonald,29,119,Missouri,MO
29015,29CS004,262,254,271,308,37,46,54,282.3853280559649,24,147.9122798007293,85.41913512517046,134.65405340901083,187.1893320311538,0.5126083204885767,323,313,333,365,32,42,52,210.8564784462836,42,211.74691202419964,-57.518442136643095,-0.30476987330845073,50.27823098694036,0.9807725954430665,19471,19835,Benton+Henry+St. Clair,Benton,29,15,Missouri,MO
29083,29CS004,254,244,263,301,38,47,57,257.089657849539,33,180.17198234678554,24.88417257762528,79.92716219735944,130.19721157825094,0.6862402737482061,310,299,322,340,18,30,41,133.53866955603206,34,153.3673147187514,-74.34648521235704,-19.914022753460127,32.95834335666376,1.1109590747687461,21979,22169,Benton+Henry+St. Clair,Henry,29,83,Missouri,MO
29185,29CS004,130,126,134,140,6,10,14,133.17505576778007,16,205.1282051282051,-120.7290266298133,-71.24628695585044,-21.136034061859323,1.4050303520284655,157,152,162,153,-9,-4,1,-44.24480718322603,12,128.05463664496853,-227.03655048360227,-173.25341866277628,-118.45424783867868,-3.814148154015686,9360,9371,Benton+Henry+St. Clair,St. Clair,29,185,Missouri,MO
29017,29CS005,113,109,118,166,48,53,57,587.0026178537314,15,167.22408026755855,370.3460034261323,419.0157395285055,467.82456850452695,0.27956838834338915,136,131,142,163,21,27,32,253.62459701698893,15,142.1666192777936,60.29265793878744,112.16997876004322,160.67379935001583,0.5403471599060519,10764,10551,Bollinger+Madison+Stoddard+Wayne,Bollinger,29,17,Missouri,MO
29123,29CS005,153,148,159,174,15,21,26,196.56733120415996,22,210.6102911846829,-62.9559602753579,-12.976812191881255,37.56817621994491,1.0216830965158168,187,181,194,215,21,28,34,218.7425020855892,26,205.6311293894337,-36.31070176311884,14.837506938857752,64.94915977467251,0.9072572988302353,12535,12644,Bollinger+Madison+Stoddard+Wayne,Madison,29,123,Missouri,MO
29207,29CS005,325,313,338,380,42,55,67,228.07078114621106,49,204.8851876371999,-27.887778384185257,22.940268680934953,75.71534815006582,0.8821671687224729,393,378,408,450,42,57,72,200.29372378900234,65,228.03817008139208,-74.75465382944687,-29.308292448317665,25.509875681204825,1.1189201595510572,28699,28504,Bollinger+Madison+Stoddard+Wayne,Stoddard,29,207,Missouri,MO
29223,29CS005,138,134,143,188,45,50,54,530.7891281026428,21,224.93974828171025,258.3904853655966,305.54622542665203,357.15091925827534,0.4154007793501458,165,160,171,242,71,77,82,702.1553769041138,17,155.76323987538942,491.1951678234278,546.4394431016406,599.026106486786,0.21897837155861585,11203,10914,Bollinger+Madison+Stoddard+Wayne,Wayne,29,223,Missouri,MO
29019,29CS006,1002,923,1081,1164,83,162,241,105.98358968041575,83,54.22267226314328,1.1638231763213707,53.78346243203274,101.3990501635803,0.5084795697537727,1258,1162,1354,1381,27,123,219,66.31189415983766,94,50.658561296859176,-33.531015260691966,16.58406245426926,65.60031625824884,0.7577852458215131,183687,185556,Boone,Boone,29,19,Missouri,MO
29021,29CS007,766,729,802,954,152,188,225,266.30282240199443,105,148.38542525378617,63.525735907464195,117.90135210420264,172.07822317949754,0.5542642795764092,929,886,973,1119,146,190,233,225.73204033920365,89,105.99780858463151,68.00773482904738,120.81442698602466,171.9648838560417,0.4671090898448689,84914,83964,Buchanan,Buchanan,29,21,Missouri,MO
29023,29CS008,484,466,502,575,73,91,109,259.0750591231339,53,151.07247203021447,54.759958023938836,108.74508140738091,155.30189859083796,0.5767765328846027,592,570,614,707,93,115,137,273.7239951597719,76,180.57832584883695,41.94350759591136,95.44039132401758,143.67006198696598,0.6540322672907406,42099,42087,Butler+Carter+Ripley,Butler,29,23,Missouri,MO
29035,29CS008,63,62,63,79,16,16,17,365.616528316178,2,45.011252813203306,307.3678956422636,320.20830697013713,332.6780411745168,0.11597187191066961,77,76,77,102,25,25,26,478.51849445488426,13,245.09803921568627,220.99999396150474,233.36985760971638,246.5175148202358,0.49278597447217404,5332,5304,Butler+Carter+Ripley,Carter,29,35,Missouri,MO
29181,29CS008,133,128,137,185,48,52,57,567.9741080308937,18,195.26306273729887,322.3007714830182,371.55651484428046,421.0385095639652,0.3373455809544027,158,152,163,236,73,78,84,735.1975644513944,38,357.61340109166196,326.37051754367695,377.3311730816318,430.32681473649836,0.4802704082236021,11062,10626,Butler+Carter+Ripley,Ripley,29,181,Missouri,MO
29029,29CS009,401,383,420,549,129,148,166,408.7856015958879,73,202.06680199298762,152.81892478973992,207.76831546485735,256.7187011136357,0.4909853354792944,492,470,515,664,149,172,194,396.39019349730034,74,170.73902309591378,173.4427937675023,225.96721104899098,279.25139266613303,0.42824204488729295,43352,43341,Camden+Miller+Moniteau+Morgan,Camden,29,29,Missouri,MO
29131,29CS009,240,229,251,298,47,58,69,279.07921955011324,38,183.28710961051488,45.77743333586336,94.33687338215918,147.59958386725907,0.645598640179874,294,281,307,365,58,71,84,286.40035434507206,36,144.6770887754692,91.08804653431304,140.52393907168994,191.08184923038957,0.4981664694454113,24879,24883,Camden+Miller+Moniteau+Morgan,Miller,29,131,Missouri,MO
29135,29CS009,137,130,144,165,21,28,35,216.37487106008314,21,162.40252626151963,-0.3235099425584052,53.80580540477913,105.65245010841457,0.7246608374990825,167,159,175,172,-3,5,13,30.07485925373307,14,90.43343453265294,-110.81651567596728,-61.65069932448635,-12.32950426027513,2.4752961199136414,15517,15481,Camden+Miller+Moniteau+Morgan,Moniteau,29,135,Missouri,MO
29141,29CS009,257,248,266,305,39,48,57,272.1602727767734,31,177.17660506763193,43.33413333240237,95.55262877478746,148.48230941355038,0.637611128917402,318,307,329,325,-4,7,18,35.12815252879945,36,168.83177789241665,-187.37062445103658,-132.55555960119676,-78.79060915212365,4.240094920866638,20996,21323,Camden+Miller+Moniteau+Morgan,Morgan,29,141,Missouri,MO
29031,29CS010,711,676,746,943,197,232,267,341.46235271393965,113,166.56225817150016,123.207314927355,176.38220601078976,224.87036854307618,0.4856943737334561,876,834,919,926,7,50,92,60.46619004787159,70,85.29719981478321,-78.38462774751352,-24.402050974781982,22.52031681380945,1.3827929797983516,81411,82066,Cape Girardeau+Perry,Cape Girardeau,29,31,Missouri,MO
29157,29CS010,174,166,182,213,31,39,47,245.64236198512023,22,139.04982618771726,57.641351876718296,106.29975282061847,159.0322411965446,0.5518664716581199,213,203,222,225,3,12,22,65.6533857255345,11,58.1149619611158,-46.22762946820191,7.336827101144352,60.533541636410824,0.8192525633319135,18986,18928,Cape Girardeau+Perry,Perry,29,157,Missouri,MO
29033,29CS011,92,91,93,123,30,31,32,441.6306688267496,30,424.17815482502647,4.260548405602113,17.581260679071793,29.11886072069555,0.9306847972819916,111,110,112,110,-2,-1,-0,-13.918342418582213,10,119.21793037672865,-145.96197313363606,-133.21616238094126,-119.96479557247493,-59.71198684924575,8487,8388,Carroll+Lafayette+Ray,Carroll,29,33,Missouri,MO
29107,29CS011,339,325,353,383,30,44,58,160.55005870662288,42,152.96367112810705,-42.27202834130197,7.901146493386991,60.51262321513424,0.9316143522886546,412,395,429,470,41,58,75,175.70552715005851,40,121.78784557301181,3.004342273503485,52.7788812621739,102.02697999863652,0.6813297535066348,32949,32844,Carroll+Lafayette+Ray,Lafayette,29,107,Missouri,MO
29177,29CS011,225,215,235,284,49,59,69,306.0995417156332,23,119.5892369686728,133.0698599771748,186.727896138048,237.10248303174998,0.3841618785597038,274,262,286,353,67,79,91,341.6243823844808,53,230.2245775596195,61.39097729852984,111.84979442627379,164.78894938570926,0.6654500309147084,23079,23021,Carroll+Lafayette+Ray,Ray,29,177,Missouri,MO
29037,29CS012,868,821,914,956,42,88,135,98.35725984163658,69,76.72065527593492,-32.15379658312349,23.04307819698787,73.76645203116105,0.771300977803861,1081,1025,1138,1255,117,174,230,159.0010303902607,151,138.0054105432478,-27.267877455546827,20.295516497397276,71.86211077431874,0.8629924235186716,107924,109416,Cass,Cass,29,37,Missouri,MO
29043,29CS013,603,565,642,708,66,105,143,140.73057813617265,82,110.04741880647758,-19.64471111584688,29.068546289099608,83.19887296077128,0.7745856938443342,758,711,805,952,147,194,241,212.8482941352537,135,148.07989733127118,12.29741652999304,63.42824813893686,116.05453327206858,0.6921394338704953,89416,91167,Christian,Christian,29,43,Missouri,MO
29047,29CS014,1610,1501,1719,1878,159,268,377,126.79990934266556,209,98.898628905372,-25.928155216081926,26.637476745626522,79.81580774948662,0.7770583279711324,1998,1866,2130,2220,90,222,354,86.96818578814445,265,103.80555065906732,-69.13986570776036,-16.66899872322963,34.20896847884098,1.1882516451979916,253593,255285,Clay,Clay,29,47,Missouri,MO
29051,29CS015,580,547,613,751,138,171,204,266.12617241332373,125,194.45920893993804,21.02253026437303,72.6302092056811,122.10327701570478,0.7264564698134335,715,675,755,775,20,60,100,77.36902289070929,88,113.98373141288016,-86.62380883796085,-37.006793367744706,15.30451056862158,1.4489894677112365,77137,77204,Cole,Cole,29,51,Missouri,MO
29055,29CS016,253,243,263,306,43,53,63,274.2712273051792,27,140.1141670991178,81.12396574175304,134.5229982182115,186.6126071258118,0.5013735266875443,306,295,318,382,64,76,87,331.470476273932,55,240.81614781733003,41.57221211893455,88.85134366680458,142.78114552008716,0.7170370686179104,23124,22839,Crawford+Iron+Reynolds+Washington,Crawford,29,55,Missouri,MO
29093,29CS016,129,125,134,155,21,26,30,320.18069889275426,12,150.04688965301656,117.91484474852645,171.39607154769243,222.38106339537285,0.4510184324216026,155,151,160,190,30,35,39,366.94584450317,19,201.61290322580643,113.89022860627199,166.37377010126102,219.170581875946,0.5339932157535524,9597,9424,Crawford+Iron+Reynolds+Washington,Iron,29,93,Missouri,MO
29179,29CS016,72,71,73,79,6,7,8,135.3734960712752,6,117.83960720130932,5.289976293425225,17.35360912462235,29.490126701617182,0.7601896606089309,88,87,89,112,23,24,25,391.7923223084272,13,213.60499507065396,166.53838372835645,177.93116391382745,190.8608675416032,0.5232550496144831,6110,6086,Crawford+Iron+Reynolds+Washington,Reynolds,29,179,Missouri,MO
29221,29CS016,240,229,250,322,72,82,93,417.93703913871326,44,222.96355728220936,148.42493072493826,197.02934489464135,244.53083608427062,0.527095134525761,292,280,304,401,97,109,121,464.40863808526893,55,234.02263637137267,180.97538020134502,229.52569112094324,281.6664354205361,0.4993403345449605,23681,23502,Crawford+Iron+Reynolds+Washington,Washington,29,221,Missouri,MO
29059,29CS017,185,177,192,265,73,80,88,562.9668916640733,27,189.3961536213246,322.73955213271853,373.15595962816684,426.15054196903975,0.3322847010794542,228,219,237,302,65,74,83,428.72894664986825,31,179.12862591008897,197.36576521140734,249.44872648268785,299.2648962866516,0.41225689481232686,17107,17306,Dallas+Hickory+Polk,Dallas,29,59,Missouri,MO
29085,29CS017,130,126,133,149,16,19,23,273.48205144434144,27,380.77329886003054,-159.26265057660112,-108.6602581730156,-54.449798231660026,1.3240384873960953,160,155,164,197,33,37,42,437.14299168511917,12,140.13780217213593,243.18252582388283,298.03707615667116,349.206687317675,0.31223529620165424,8509,8563,Dallas+Hickory+Polk,Hickory,29,85,Missouri,MO
29167,29CS017,309,295,323,364,41,55,69,208.0446481479741,41,155.10718789407315,3.542541633927401,53.0219593238769,105.30098105836613,0.7322326167391074,381,364,397,429,32,48,65,150.2196548244358,44,137.60750586395622,-36.14748582180707,14.060466837074646,62.964990461434525,0.8973596992279012,31720,31975,Dallas+Hickory+Polk,Polk,29,167,Missouri,MO
29025,29CS018,85,84,86,92,6,7,8,92.18856105414417,5,67.80427166911515,11.52405274358843,24.424445306305415,36.27872412647886,0.6411786904008769,105,104,106,136,30,31,32,352.0712748166239,17,191.35524538496173,148.15338150681944,161.03377137939154,174.32755279205654,0.5266743184551218,8849,8884,DeKalb and Nearby Counties,Caldwell,29,25,Missouri,MO
29049,29CS018,220,211,230,270,40,50,59,281.7246879986248,43,244.54976303317534,-11.78233089394494,36.849108615202084,91.23286853337319,0.8508686314614211,271,260,282,246,-36,-25,-14,-118.26537345915195,26,122.20916568742655,-289.65955551500787,-241.97920210544157,-185.86616637005642,-1.0761162608320725,21100,21275,DeKalb and Nearby Counties,Clinton,29,49,Missouri,MO
29061,29CS018,78,77,79,99,20,21,22,302.9543186654468,14,199.95239228755057,90.82065491923053,102.62178114241861,115.57303596479946,0.6302941459650271,95,94,96,107,11,12,13,139.44539918167888,11,130.9056289420445,-4.608091549203228,8.616615930932594,21.74071661970351,0.8649432823153929,8402,8403,DeKalb and Nearby Counties,Daviess,29,61,Missouri,MO
29063,29CS018,95,94,96,139,43,44,45,479.88457500443985,22,240.17467248908298,228.0464471998515,239.84803667524395,251.9033056449827,0.48935184759453326,117,116,119,130,11,13,14,113.2209043788846,12,108.24463287028685,-7.707078282700204,5.002853926261915,16.658416780336836,0.8854997560199563,10992,11086,DeKalb and Nearby Counties,DeKalb,29,63,Missouri,MO
29075,29CS018,71,70,72,92,20,21,22,406.27896247185225,13,252.14158719896557,142.9304824663073,154.04567808339092,167.46732258110345,0.5923342964049421,87,86,87,105,18,18,19,298.5652310047606,2,32.441200324412,254.04067966278112,265.9279703122794,279.30186044061577,0.10305800678558735,6187,6165,DeKalb and Nearby Counties,Gentry,29,75,Missouri,MO
29081,29CS018,92,92,93,105,12,13,13,184.22844823329638,15,219.94134897360703,-47.91414794055794,-36.01598062645651,-23.34903524622995,1.105837481149053,113,112,114,111,-3,-2,-1,-21.72585622551909,2,24.50079627587897,-58.573893285522395,-46.295784985547975,-33.61127621504711,-2.5857110072593223,8184,8163,DeKalb and Nearby Counties,Harrison,29,81,Missouri,MO
29227,29CS018,25,25,26,25,-1,-0,-0,-26.410914371789737,6,365.85365853658533,-403.8296477711349,-392.2515003829064,-380.3228928483418,10.5846053167499,31,31,32,32,0,1,1,36.67480464996235,5,252.52525252525254,-228.82615675719103,-215.85061863286836,-203.2000463461881,2.896600964480179,1968,1980,DeKalb and Nearby Counties,Worth,29,227,Missouri,MO
29065,29CS019,159,153,165,232,67,73,79,598.7809100199679,28,230.38946791003838,314.9436775642088,367.7861531809353,420.4631038595676,0.3795486194481985,193,186,200,269,69,76,83,527.0050770848476,45,311.85031185031187,164.2970817935184,215.0812102568493,264.0409742970075,0.5840603496316341,14584,14430,Dent+Phelps,Dent,29,65,Missouri,MO
29161,29CS019,397,378,416,509,93,112,131,301.6830815814569,73,196.53594184689936,52.85693503535455,106.05215105877456,155.90880528674396,0.6457025471182442,489,466,512,602,90,113,136,252.10722516965768,80,178.26900793297085,21.192178938105837,71.70059006151992,127.90661018159267,0.7009204236687858,44572,44876,Dent+Phelps,Phelps,29,161,Missouri,MO
29067,29CS020,149,144,154,177,23,28,33,285.36073527242604,24,243.07900067521945,-8.22292905338656,42.67186011232269,94.66329814983297,0.8226329186233359,182,176,188,229,41,47,53,399.2670042294728,40,341.53005464480873,6.187287821076018,54.52009110668314,111.33093577898607,0.8374832103279531,11848,11712,Douglas+Ozark+Texas+Wright,Douglas,29,67,Missouri,MO
29153,29CS020,122,118,125,140,15,18,22,253.74508302712437,11,152.86624203821654,50.61028828876395,100.671745893034,150.8707311997765,0.5711593620305678,152,147,156,188,32,36,41,415.9946128758436,39,446.07114262838843,-81.23939806868745,-30.42350490555018,17.900965358106767,1.0436064533332274,8635,8743,Douglas+Ozark+Texas+Wright,Ozark,29,153,Missouri,MO
29215,29CS020,265,255,276,346,70,81,91,392.9490670439915,19,92.63021044933777,246.94943753357649,301.21461930168454,354.59534804816354,0.23284198787768184,332,319,345,441,96,109,122,438.4741619534415,47,188.73228125125488,201.18844049875034,249.86800566756742,301.73985918428593,0.42652351718982606,24614,24903,Douglas+Ozark+Texas+Wright,Texas,29,215,Missouri,MO
29229,29CS020,220,212,228,204,-24,-16,-8,-106.90806786866887,27,177.56343508521948,-332.73483587069103,-282.55966422657707,-232.23839496366216,-1.7697650251910702,275,266,285,290,5,15,24,79.00148768894279,43,231.84342481263818,-199.39892121819807,-152.85413073590843,-100.04218717588797,2.747181501373758,18247,18547,Douglas+Ozark+Texas+Wright,Wright,29,229,Missouri,MO
29069,29CS021,354,342,366,455,89,101,113,428.02039750106496,55,233.42175066312998,145.60495894944796,195.8301043955278,243.75426449977596,0.5399975913452429,426,412,441,519,78,93,107,333.66651757711134,47,169.16210768787792,113.77289532378911,162.7670090315279,212.3759780031421,0.5015692434516842,28275,27784,Dunklin+Pemiscot,Dunklin,29,69,Missouri,MO
29155,29CS021,188,182,195,261,66,73,79,558.1315275008417,32,246.3275386490474,264.87171153969155,312.87109784628996,361.7599016327695,0.4353389877833916,226,218,234,292,58,66,74,429.3161643221896,27,176.62065807548896,203.3326617596797,251.82224469739575,302.3758265428029,0.40522553613391726,15589,15287,Dunklin+Pemiscot,Pemiscot,29,155,Missouri,MO
29071,29CS022,918,873,963,1087,124,169,214,193.8572885434661,134,153.60366814729903,-9.12104932664076,40.232041027434995,91.08767478629895,0.7876966389234846,1132,1078,1186,1329,143,197,251,187.38623720832385,144,136.92898710585374,0.19669667398485707,50.71667085149556,102.6364803224718,0.7270419006573096,104685,105164,Franklin,Franklin,29,71,Missouri,MO
29073,29CS023,182,176,189,240,51,58,64,468.6225820978382,37,301.2416039079992,112.23292085252825,166.55520369775033,219.79230027167128,0.6318460450009972,223,215,231,247,16,24,32,162.613560913294,42,284.0909090909091,-172.2917717177773,-120.62782014391216,-67.4997327254907,1.6772634544090865,14739,14784,Gasconade+Montgomery+Warren,Gasconade,29,73,Missouri,MO
29139,29CS023,150,145,155,162,7,12,17,124.14039550598221,15,159.16526660182157,-85.66659075593158,-34.978488850052194,16.30170223592391,1.181176974164694,184,179,190,185,-5,1,6,4.42210450167877,17,149.21442991310454,-195.55061453011385,-145.2253690692786,-89.89091971989504,11.304616849142539,11309,11393,Gasconade+Montgomery+Warren,Montgomery,29,139,Missouri,MO
29219,29CS023,271,256,287,315,28,44,59,145.9139948888575,18,60.34699522252954,36.30178351788421,84.5683026036093,135.07811868892196,0.404289994574184,340,321,358,463,105,123,142,339.1592834261037,65,178.57142857142856,112.29291305330302,158.05142248461004,211.11142928416822,0.5222814122538088,35793,36400,Gasconade+Montgomery+Warren,Warren,29,219,Missouri,MO
29077,29CS024,2556,2428,2685,2927,242,371,499,149.14728591469304,359,144.3520743071402,-49.11377055129512,5.95013747874171,58.85597192200741,0.9652468870600452,3153,2998,3309,3571,262,418,573,138.93075574945036,388,129.07432418945982,-45.49688640706337,9.112937918908386,62.37870088425962,0.9268357962788017,298437,300602,Greene,Greene,29,77,Missouri,MO
29079,29CS025,108,107,109,137,28,29,30,361.9279135479603,31,382.0870994248151,-32.62512205017913,-20.26772763805104,-7.7676105969365565,1.020931800714114,132,130,133,152,19,20,22,209.82400102834532,26,267.4621952474025,-70.41507240818257,-57.6604207986838,-45.343433761125404,1.2151241186167068,9736,9721,Grundy and Nearby Counties,Grundy,29,79,Missouri,MO
29115,29CS025,145,140,150,162,12,17,22,175.04821017318508,14,141.68845407775996,-17.428356986842143,34.76679391439384,86.13928146696038,0.7651852976187633,175,169,181,186,5,11,17,90.95386465656009,38,320.8375548801081,-282.10810884341873,-230.72105306835462,-179.30035508788308,3.2278407777334057,11857,11844,Grundy and Nearby Counties,Linn,29,115,Missouri,MO
29117,29CS025,156,149,162,169,7,13,20,110.62714792217938,30,245.8512599877074,-184.1658481271814,-135.85489238351659,-87.48128023466302,2.0690685817991694,190,182,198,220,22,30,38,203.31369623627413,40,271.6099680858287,-122.4824383484145,-67.25667016972226,-13.43226726548971,1.2927409217331234,14643,14727,Grundy and Nearby Counties,Livingston,29,117,Missouri,MO
29129,29CS025,37,37,37,59,22,22,22,744.933796411727,10,340.2324922030054,392.9113692177198,404.77457313819855,416.42498301382784,0.4367795298994293,45,45,45,52,7,7,7,200.66703555366772,5,143.184421534937,44.23895118194769,58.002021918250364,69.79877785722178,0.6244307625528086,3527,3492,Grundy and Nearby Counties,Mercer,29,129,Missouri,MO
29171,29CS025,59,59,60,59,-1,-0,0,-5.655505861918268,5,128.15036309269544,-146.988182448482,-133.79400517940684,-121.52476271026833,6.415676728018063,73,72,73,88,15,15,16,322.00565519143254,6,127.46972594008922,182.4238982672979,194.87713918382252,208.3484562753423,0.371360523205714,4682,4707,Grundy and Nearby Counties,Putnam,29,171,Missouri,MO
29211,29CS025,57,57,58,72,14,15,15,292.33784796605795,12,240.64171122994654,39.64125937603613,51.06890612725649,62.890438165441495,0.7703213656008102,70,69,71,86,15,16,17,271.622565765048,11,185.1851851851852,73.95125943719603,86.21252239190183,99.98577249943628,0.6419841125893965,5984,5940,Grundy and Nearby Counties,Sullivan,29,211,Missouri,MO
29091,29CS026,437,419,454,539,85,102,120,308.5380086364735,80,241.072773843604,15.15788619003515,66.68039392804084,119.68564580846326,0.7737816606699066,535,514,555,638,83,103,124,258.1828405112257,83,207.80131190225828,1.5862576796424965,51.3744921760723,103.76530775104216,0.7971311717266925,39822,39942,Howell+Oregon+Shannon,Howell,29,91,Missouri,MO
29149,29CS026,115,111,119,140,21,25,29,336.4077750747587,10,134.89208633093523,152.64245357248592,201.1118717232333,252.96382997931514,0.38551943175241515,138,133,142,179,37,41,46,478.8317926218902,14,162.24359717232588,265.95135720932984,316.6941912340778,365.54272759168936,0.3308253980926918,8896,8629,Howell+Oregon+Shannon,Oregon,29,149,Missouri,MO
29203,29CS026,74,73,74,121,47,47,48,788.6893974673071,13,216.27616802994592,560.0450525927067,572.1978434965799,584.9340471252801,0.26855728128393164,89,88,90,120,30,31,32,435.72881261458593,15,211.35691137100184,211.92265162180743,223.97325356377524,236.5400420914062,0.4698707322749669,7213,7097,Howell+Oregon+Shannon,Shannon,29,203,Missouri,MO
29095,29CS027,5534,5226,5842,6353,511,819,1127,137.42504156987107,518,86.89780700466783,-5.638430999688215,51.033505668987615,96.8644358419457,0.631557816228782,6804,6434,7174,7829,655,1025,1395,142.97995031216595,862,120.23690296519267,-26.65235013503242,21.61287723722933,76.43795410426624,0.840115822781993,715323,716918,Jackson,Jackson,29,95,Missouri,MO
29097,29CS028,1064,1011,1116,1291,175,227,280,222.5227904028466,175,171.31389600430734,1.9427984680852473,48.54046354722337,102.02790722491616,0.7664992049100653,1311,1248,1375,1536,161,225,288,182.6541334159742,214,173.84522900453297,-38.803350524755025,10.021864236939928,61.913361758286335,0.9475584611163339,122582,123098,Jasper,Jasper,29,97,Missouri,MO
29099,29CS029,1817,1720,1915,2088,173,271,368,143.1726812745991,200,105.82290536786687,-11.23056437088131,38.29808880002665,88.72518468895457,0.7364062834266096,2243,2126,2361,2501,140,258,375,113.2722743970223,265,116.40778746134382,-54.2248873887813,-2.9839200618728454,47.28153043192616,1.0237112097828764,226794,227648,Jefferson,Jefferson,29,99,Missouri,MO
29101,29CS030,355,332,378,420,42,65,88,143.7973246035387,46,102.13899785360077,-9.360392670986524,42.85251350914371,89.01299011024393,0.6994971948760811,437,409,465,565,100,128,156,236.52589596811126,57,105.30594147206622,82.20129954492653,130.6401988889753,185.26074513899158,0.4417689026222624,54044,54128,Johnson,Johnson,29,101,Missouri,MO
29105,29CS031,380,364,395,408,13,28,44,94.38939827874943,52,173.27076333546216,-126.2792218779287,-79.99172380404882,-29.69135056921987,1.773107382515306,466,448,485,567,82,101,119,278.91741602278483,74,204.88966414707755,22.176783074962767,74.66717684960736,122.71181734251876,0.7273684958261141,36013,36117,Laclede+Webster,Laclede,29,105,Missouri,MO
29225,29CS031,314,297,331,362,31,48,65,147.68246799690988,50,152.6872964169381,-55.6825371513978,-4.645059283948971,45.01906543547968,1.012943687789963,390,370,411,508,97,118,138,296.81301771888525,63,158.88227579945527,86.57413234730517,138.37152206311902,188.56138337809506,0.5307842309502252,39296,39652,Laclede+Webster,Webster,29,225,Missouri,MO
29113,29CS032,447,421,473,480,7,33,59,66.1822018717145,51,102.17540110523063,-86.533162903045,-36.87975020016831,13.805396910990401,1.4984885298913235,559,528,591,606,15,47,78,75.853656869158,54,88.04826349258111,-63.27782502476244,-13.099954730472668,37.27284645493007,1.1363385814883367,59897,61330,Lincoln+Pike,Lincoln,29,113,Missouri,MO
29163,29CS032,167,160,175,204,29,37,44,249.51636109400698,23,156.48032656763806,41.65593405422744,93.2400329046537,141.23576487725222,0.6104885142461097,205,196,214,212,-2,7,16,38.40282371963983,27,152.20700152207002,-165.88157978630235,-114.47928612553495,-58.60326381339066,3.45609869528427,17638,17739,Lincoln+Pike,Pike,29,163,Missouri,MO
29125,29CS033,84,84,85,125,40,41,41,574.2728747093266,13,184.13597733711046,378.34892270485255,390.0934558689829,401.8462739059846,0.31292376380959097,103,102,104,133,29,30,31,357.2367899784799,11,130.812224997027,213.9974160206,226.24131443402803,240.10125057732785,0.35438096756432214,8472,8409,Maries+Osage+Pulaski,Maries,29,125,Missouri,MO
29151,29CS033,111,110,113,119,6,8,9,70.36986676556025,10,90.11038522189682,-32.03270291628037,-19.395231454559568,-8.286275906121643,1.1351644944745,137,136,139,165,26,28,29,207.5738844215623,21,157.18562874251495,37.396861971817444,50.093270511718735,62.31056846312188,0.7308956673991348,13317,13360,Maries+Osage+Pulaski,Osage,29,151,Missouri,MO
29169,29CS033,293,270,316,342,26,49,72,109.90236758644053,39,87.06166868198308,-28.91082921038325,21.234601290244065,78.49494040787171,0.7764024397078816,365,337,393,459,66,94,122,174.81917083592054,50,92.87120621122628,31.115418136213485,81.95246724890886,132.27903523578684,0.5256565321070189,53755,53838,Maries+Osage+Pulaski,Pulaski,29,169,Missouri,MO
29127,29CS034,295,283,308,310,2,15,27,61.397830115018394,39,164.2912307800323,-158.24252540286207,-101.38101258272911,-53.257264342707785,2.504041527497859,363,348,377,396,19,33,48,117.30691682199533,50,175.37090947353653,-107.74610346425564,-57.692079121004426,-7.923554006589565,1.4515736850009786,28486,28511,Marion+Monroe+Ralls+Shelby,Marion,29,127,Missouri,MO
29137,29CS034,88,87,89,114,25,26,27,356.92513632185916,16,221.5810732833237,123.38259091272559,135.16448648893788,147.4060254070012,0.5976176892961017,108,107,110,122,12,14,15,155.66620277417573,17,195.29006318207925,-52.19634443507333,-39.74722601596142,-26.654944718712695,1.1683252227513827,8665,8705,Marion+Monroe+Ralls+Shelby,Monroe,29,137,Missouri,MO
29173,29CS034,84,83,85,128,43,44,45,507.6290929648484,14,162.4286957362467,332.72854478058497,344.9443276630387,357.0687737941706,0.3128254112494851,103,102,105,136,31,33,34,314.75819221626136,12,115.83011583011583,185.64526337494627,198.8475456362512,211.91589174605883,0.3570477643396945,10343,10360,Marion+Monroe+Ralls+Shelby,Ralls,29,173,Missouri,MO
29205,29CS034,69,68,70,84,14,15,16,296.9949776034622,7,138.56812933025404,145.76082421727827,158.4543443135657,170.74249840369757,0.43741261903060336,83,83,84,88,4,5,5,76.34499805910573,6,100.1001001001001,-35.74908946876017,-23.727323642416213,-12.123368637997734,1.0760171729433456,6062,5994,Marion+Monroe+Ralls+Shelby,Shelby,29,205,Missouri,MO
29133,29CS035,149,144,155,185,30,36,41,339.93923409450355,24,227.93826671943017,60.7583777348394,112.86804549004334,165.48671060460853,0.6523020953116455,183,176,189,221,32,38,45,306.1195795130708,26,207.36959642686233,49.576844200368384,100.04413893863295,148.51484276622878,0.6602122810924724,12635,12538,Mississippi+New Madrid+Scott,Mississippi,29,133,Missouri,MO
29143,29CS035,200,193,207,289,82,89,96,653.4696799374498,37,270.6656912948061,329.9615721661498,382.8826591302218,433.192992539204,0.4096123611118415,241,233,249,296,47,55,63,340.8655587902787,24,149.27229754944645,141.57506387293705,191.0647315982774,240.3248672089836,0.4300738875327115,16404,16078,Mississippi+New Madrid+Scott,New Madrid,29,143,Missouri,MO
29201,29CS035,383,367,399,469,70,86,102,271.55453119817616,60,189.21973141310346,32.42439045512067,82.63966917857972,134.32500963715006,0.6888026493828535,471,451,490,585,95,114,134,301.66116682685384,49,129.40710418592369,117.2166241142589,172.76494308256997,219.52173597963912,0.4252586236523485,38051,37865,Mississippi+New Madrid+Scott,Scott,29,201,Missouri,MO
29145,29CS036,565,540,590,642,52,77,102,158.0725643007254,80,163.6772829571029,-57.076076596335554,-5.146958731011802,41.45522019512276,1.022225738719362,698,668,729,818,89,120,150,201.73865623299912,115,194.0175121893611,-43.29569563441592,9.698984934307402,60.32278829298637,0.9537509280415768,58652,59273,Newton,Newton,29,145,Missouri,MO
29159,29CS037,396,378,415,492,77,96,114,268.0087112165479,51,142.66399365937806,77.46488536225588,128.0638519306668,173.78671998311523,0.5268124423219674,488,466,511,514,3,26,48,59.224555894109464,47,108.91479155562766,-102.4473200724412,-48.1843884995056,2.3474808821116953,1.7697667104508563,42898,43153,Pettis+Saline,Pettis,29,159,Missouri,MO
29195,29CS037,219,209,229,255,26,36,46,183.72100582962196,42,216.83014971605576,-81.90471852826045,-34.70804159156502,20.650914098457175,1.1479562919490487,269,257,281,325,44,56,68,239.3126218165536,36,154.55286996093247,34.619952702471046,84.57898380804208,136.8065057142395,0.6344384952354535,23244,23293,Pettis+Saline,Saline,29,195,Missouri,MO
29165,29CS038,648,602,694,740,46,92,138,103.25297701591984,67,75.20555248954699,-21.404856773338867,28.1490355536681,80.7739310955162,0.720529147109217,811,755,867,902,35,91,147,84.34503623860499,96,88.59766508236814,-57.090941306701126,-4.651797405075029,45.189462873552536,1.0390502801519994,106907,108355,Platte,Platte,29,165,Missouri,MO
29041,29CS039,80,79,81,115,34,35,36,571.5380522079248,17,276.0487144790257,284.0379073641053,295.65619164520893,307.4874330723687,0.46964934765665334,98,97,98,117,19,19,20,264.31235685801573,12,163.04347826086956,88.95448834439016,101.24969027087843,113.48793731923439,0.5866998240404697,7390,7360,Randolph and Nearby Counties,Chariton,29,41,Missouri,MO
29053,29CS039,166,159,173,173,-0,7,14,48.621750338147095,18,125.86679097954664,-129.2901575649053,-78.04272433214786,-26.672902550513236,2.2632070922059677,203,194,212,227,15,24,33,138.5255840880599,36,210.39097656478287,-122.03913955521541,-73.09476862114447,-22.438895216015812,1.4573062288523826,17161,17111,Randolph and Nearby Counties,Cooper,29,53,Missouri,MO
29089,29CS039,92,91,93,92,-1,0,1,0.4777375467394611,1,11.854193420922652,-22.90335899499008,-11.381771923885381,1.0882786899278685,0.9612601183065145,114,112,115,145,30,31,33,309.69462770738335,14,137.7410468319559,158.6731133183101,172.18618164324445,184.14690190277554,0.4310694944117031,10123,10164,Randolph and Nearby Counties,Howard,29,89,Missouri,MO
29121,29CS039,175,168,181,235,54,60,67,474.7843693149845,15,118.63959926179804,306.50633343389916,357.0734784876812,410.3248594020735,0.24578652088742914,214,206,222,226,4,12,20,79.90220953040763,17,111.96733188434432,-78.429139544459,-33.94048605767115,19.235167239841132,1.294591788362546,15172,15183,Randolph and Nearby Counties,Macon,29,121,Missouri,MO
29175,29CS039,246,235,256,280,24,34,45,167.24149809554123,41,199.3597795696746,-82.32721153130107,-32.2005907783481,23.53827911691848,1.1583685366741132,302,289,315,355,40,53,66,215.0351375475168,38,153.5849971708027,8.901008236424486,61.7068435988531,115.60652697571294,0.7010553537416118,24679,24742,Randolph and Nearby Counties,Randolph,29,175,Missouri,MO
29183,29CS040,2589,2415,2764,3221,457,632,806,186.724032779929,396,117.05298421065595,16.495774729184554,70.03486916631005,120.53035295140786,0.625886115623727,3215,3004,3427,3655,228,440,651,107.34389632931129,298,72.78269237344848,-19.230769450345573,34.8141739253795,86.24897299236002,0.676493679837313,405970,409438,St. Charles,St. Charles,29,183,Missouri,MO
29186,29CS040,172,164,180,176,-4,4,12,24.381677082274013,10,65.1748859439496,-90.76784350410166,-41.33497817828768,10.139165236046152,2.1092765618963356,212,202,222,246,24,34,44,183.27811307912216,26,139.9956924402326,-7.579528827411116,43.526110315483976,91.45847369730824,0.7420427792941472,18412,18572,St. Charles,Ste. Genevieve,29,186,Missouri,MO
29187,29CS040,661,632,690,827,137,166,195,297.00759132009597,103,184.55198363519628,65.84875147624491,111.9263749283134,163.72559353051128,0.6176451809565786,813,778,848,1027,179,214,249,317.4299809415694,123,182.36270904993475,87.63866514929559,135.10760594227065,188.17833502440973,0.5718265958255919,66973,67448,St. Charles,St. Francois,29,187,Missouri,MO
29510,29CS042,2506,2377,2635,3132,497,626,755,250.53501607788948,330,132.0757234147578,64.58056606674037,119.76418889180887,171.85688889778208,0.5263338879680807,3025,2873,3177,3392,215,367,519,124.60034701406279,265,90.0249012273961,-15.498664226199507,33.75949303646182,84.74448654788642,0.7205447045346859,299828,294363,St. Louis (city),St. Louis (city),29,510,Missouri,MO
29189,29CS043,8783,8352,9213,10649,1436,1866,2297,223.70590545472763,1364,163.4880650116763,7.548773349266217,60.01678283257775,111.6385232459464,0.7304255843898954,10743,10228,11258,11421,163,678,1193,67.93432146091,933,93.48594354170444,-75.51034510783671,-25.441609741810215,24.33626754238686,1.3740957164258274,1001174,998011,St. Louis (county),St. Louis (county),29,189,Missouri,MO
29001,29CS044,193,182,204,196,-8,3,14,13.478457901231824,11,52.21932114882506,-86.39986581086708,-38.23637547303247,9.80066676913101,2.8651525161049904,238,225,251,291,40,53,66,209.79780748133302,35,138.92196554735253,23.555717269268563,70.31180753963844,122.13039909916641,0.6498756184309508,25278,25194,Scotland and Nearby Counties,Adair,29,1,Missouri,MO
29045,29CS044,66,65,67,82,15,16,17,290.30819342141746,17,305.9388122375525,-26.981061337593232,-15.521330756518699,-3.8041598558789627,0.9923264785907248,81,80,82,102,20,21,22,317.33457899079315,12,178.54485939592323,126.19815174225816,138.90425474963345,152.23530786240312,0.5374404038378123,6668,6721,Scotland and Nearby Counties,Clark,29,45,Missouri,MO
29103,29CS044,36,36,37,45,8,9,9,280.12621349680006,3,95.41478929234032,173.68882320344645,184.3688188230514,197.47872746946342,0.30588413934844266,44,44,45,67,22,23,23,598.9489124022267,6,158.01948907031868,428.40862749381097,440.67396791729016,453.69713220498875,0.2527157444213247,3773,3797,Scotland and Nearby Counties,Knox,29,103,Missouri,MO
29111,29CS044,101,100,102,109,7,8,9,97.61544145191611,7,84.06725380304242,1.7653901375595087,13.590776786161516,26.148717538907743,0.7668617206015172,123,121,124,155,31,32,34,322.60644206955135,14,139.93003498250874,170.18726964600333,183.18406260849898,195.60663294968867,0.42071385217262086,9992,10005,Scotland and Nearby Counties,Lewis,29,111,Missouri,MO
29197,29CS044,39,39,40,51,11,12,12,348.05484585703505,5,146.34146341463415,188.69718995237625,201.4869951282234,214.20456414178966,0.3878412121262881,47,46,47,64,17,17,18,432.1576133620799,23,571.8547986076579,-152.0965636738727,-139.39173947968868,-125.43296745943363,1.2512662808354176,4100,4022,Scotland and Nearby Counties,Schuyler,29,197,Missouri,MO
29199,29CS044,45,45,45,51,6,6,6,151.79298891779837,6,152.1555367709214,-13.251201584678178,-0.3852980461426098,11.212098598645195,0.8588970279838515,54,54,55,69,14,15,15,314.2269886137555,11,234.34171282488282,67.33312146331531,79.67828964031455,92.46365941812172,0.698420908936727,4732,4694,Scotland and Nearby Counties,Scotland,29,199,Missouri,MO
29209,29CS045,342,329,356,386,30,44,57,167.45314820436826,47,179.99617029424905,-58.07223342758158,-11.493213247525157,41.77857096088572,1.0508709198715989,421,405,437,499,62,78,94,247.2134724293459,66,209.56372642408076,-13.833671699982103,36.51098026286738,88.12971996924396,0.8369536757201747,31334,31494,Stone+Taney,Stone,29,209,Missouri,MO
29213,29CS045,527,502,551,622,71,95,120,204.22195189578338,72,154.10958904109586,-4.73210349503344,49.16067163937114,100.67374359795039,0.7467911634139117,649,620,678,795,117,146,175,259.520339089916,103,182.84131858768396,28.76652949456186,75.2978550130826,130.49790609255984,0.6997492123710451,56064,56333,Stone+Taney,Taney,29,213,Missouri,MO
29011,29CS046,129,124,134,132,-2,3,8,26.145468169895764,16,165.11867905056758,-195.29678301850697,-140.66226762989228,-87.60494198159155,4.52809359577341,157,151,163,168,5,11,17,91.58711289456792,26,223.15681057419965,-182.16099030055332,-131.77579304290333,-78.22247015532582,2.227779384891262,11628,11651,Vernon and Nearby Counties,Barton,29,11,Missouri,MO
29013,29CS046,174,167,181,191,10,17,24,128.4370277540592,16,119.44012441679627,-43.345250369182736,8.025867927605654,62.09543898617592,0.878869282206847,211,203,219,244,25,33,41,203.98769715143277,42,260.93439363817095,-110.47352564047455,-58.04837915687308,-6.004799868539037,1.2413599964895852,16075,16096,Vernon and Nearby Counties,Bates,29,13,Missouri,MO
29039,29CS046,180,174,186,157,-29,-23,-17,-196.1930614749134,13,109.5121095121095,-354.7742259718436,-305.36345603803426,-252.73561434881955,-0.5832276817331571,221,214,229,236,7,15,22,100.47907309905847,34,235.24527779699716,-188.3576931485657,-133.97034469005342,-81.95063143778756,2.190405447097743,14245,14453,Vernon and Nearby Counties,Cedar,29,39,Missouri,MO
29057,29CS046,91,90,92,111,19,20,21,316.4725058703996,28,443.1548404115009,-138.32699600012086,-126.81001805078523,-114.61973309648045,1.3336008264000068,112,111,113,119,6,7,8,97.70630560988359,10,131.63090693694878,-46.24608059483345,-34.308551913967634,-20.716168385120117,1.1872609694430185,7582,7597,Vernon and Nearby Counties,Dade,29,57,Missouri,MO
29217,29CS046,197,189,206,251,45,54,62,326.4170022520388,37,224.41243366186504,53.08084179148653,102.47285799687293,152.0076438456221,0.6749607393351025,238,228,248,340,92,102,112,520.921314033388,44,224.46689113355782,244.6049753502926,297.10130477400384,347.2311027184293,0.426724614413476,19785,19602,Vernon and Nearby Counties,Vernon,29,217,Missouri,MO
30001,30CS001,75,74,76,94,18,19,20,238.85948497811074,4,51.047538019780916,174.59926981408742,188.20164686659737,199.93649275571528,0.20287441454060773,93,92,95,122,27,29,30,301.54993340426057,18,189.43380340980846,99.5067376137518,111.8546584548602,124.86483566555923,0.6070155893086648,9403,9502,Beaverhead+Gallatin+Madison,Beaverhead,30,1,Montana,MT
30031,30CS001,675,616,734,705,-29,30,89,26.370633981236658,40,35.23194362889019,-62.86292575886366,-9.627161707010549,44.51138416908948,1.2928473956684037,853,781,925,876,-49,23,95,16.232818001875422,80,57.27499874710941,-93.65782590166502,-41.48391397955974,11.972825412383969,3.3793040907160123,136240,139677,Beaverhead+Gallatin+Madison,Gallatin,30,31,Montana,MT
30057,30CS001,76,75,77,91,14,15,16,206.13550548172046,5,68.98137502874224,124.58115197214278,136.7408877824676,148.85063393585295,0.3136489636734087,95,94,96,105,9,10,11,110.34452299321666,14,157.67541389796148,-59.27413349427205,-47.44076006073628,-34.97874961577976,1.296597611586654,8698,8879,Beaverhead+Gallatin+Madison,Madison,30,57,Montana,MT
30013,30CS002,781,745,817,908,91,127,163,181.28530359792234,137,195.90319236406532,-70.8891127028696,-14.068711082240789,35.145704381782025,1.0721775449772684,961,918,1005,1029,24,68,111,79.9484270556456,114,134.93679276549406,-107.221290302822,-55.3137176666166,-1.347257746125595,1.6631742654143833,83919,84484,Cascade,Cascade,30,13,Montana,MT
30023,30CS003,106,105,107,133,26,27,28,347.70150417021983,3,38.334575657544455,297.8337944077063,309.1241357716618,320.9774390339578,0.1063432311915343,131,129,132,125,-7,-6,-4,-58.59188851940873,14,147.67932489451476,-218.0968142912292,-206.54562564700302,-193.80821919436465,-3.073875527524852,9391,9480,Deer Lodge and Nearby Counties,Deer Lodge,30,23,Montana,MT
30039,30CS003,28,27,28,25,-3,-3,-2,-94.70451119280597,5,180.94089264173704,-288.33333681788883,-275.65362549409843,-262.7854566885094,-3.092143413690658,34,34,34,39,5,5,5,147.95358842339692,4,119.79634621144056,15.339517049796191,28.11959937306654,41.588397762321044,0.6733813655552319,3316,3339,Deer Lodge and Nearby Counties,Granite,30,39,Montana,MT
30077,30CS003,67,67,68,81,13,14,14,235.27846679185066,2,34.637032760860144,188.60756551029093,200.7273574047709,211.87003714283267,0.1371236992851826,83,82,84,82,-2,-1,-0,-17.236911995477865,14,200.28612303290413,-230.63883602379826,-217.46386441464284,-205.80859532628548,-68.33930417218305,6929,6990,Deer Lodge and Nearby Counties,Powell,30,77,Montana,MT
30081,30CS003,415,395,434,478,44,63,83,170.8970333975118,35,94.40535862797545,23.80338414919361,76.57664872374718,126.53368610501835,0.5438274336318674,522,498,545,665,120,143,167,313.671316769764,106,231.82573703088093,30.598601962021096,79.90963663319016,133.90620371484732,0.7339547475784308,44489,45724,Deer Lodge and Nearby Counties,Ravalli,30,81,Montana,MT
30093,30CS003,363,348,378,402,24,39,54,132.34581466514064,54,184.33179723502303,-102.5542718194696,-52.424502646345196,3.2993746003620856,1.3577832751707328,447,428,465,536,71,89,108,252.33055627221276,51,144.16553595658073,58.7215825084677,108.6057027506325,163.61186068728216,0.5650064417760964,35154,35376,Deer Lodge and Nearby Counties,Silver Bow,30,93,Montana,MT
30003,30CS004,134,128,139,197,58,63,69,580.3198544895884,61,560.061208875287,-30.492617470343134,19.320146210047536,74.35298567564979,0.9500595119783275,163,156,169,165,-4,2,9,18.1273443077105,24,185.02813969624546,-216.53960410558886,-169.11295457865882,-117.7350053817311,7.1614046904638675,13070,12971,Eastern Montana,Big Horn,30,3,Montana,MT
30011,30CS004,16,15,16,17,1,1,2,127.41143968908445,3,258.99280575539564,-143.79312985314505,-131.18348582087216,-119.11084687903305,1.2117054740644106,20,19,20,12,-8,-8,-7,-527.7466307964335,6,420.7573632538569,-960.1221558997252,-948.9085705396698,-936.0544801454973,-0.9194462483652012,1390,1426,Eastern Montana,Carter,30,11,Montana,MT
30017,30CS004,120,119,121,119,-2,-1,0,-8.000968251994209,12,122.11668928086837,-141.99089149396315,-129.595377828884,-118.02976044275664,56.13469938779287,148,147,150,158,8,10,11,80.27392085964321,28,235.13604299630504,-166.98752953333687,-154.76257522947262,-141.45569804781317,2.651761620712794,11792,11908,Eastern Montana,Custer,30,17,Montana,MT
30019,30CS004,17,17,18,25,7,8,8,544.8640346210242,6,433.9963833634719,99.31271464385726,110.81559787287817,123.1309218386605,0.7031734575533196,22,22,22,20,-2,-2,-2,-102.44490246383384,4,237.81212841854932,-353.7674846357363,-340.40813221154576,-327.8288732132494,-5.531560419019507,1659,1682,Eastern Montana,Daniels,30,19,Montana,MT
30021,30CS004,79,78,80,115,35,36,37,489.0660361456249,20,270.3007095393626,206.1578482963769,218.97614179057132,230.6177184651448,0.5378250889288196,97,96,98,141,43,44,45,492.32520542241576,22,246.99674413382732,232.68360798837452,245.16333842958616,257.72983409019673,0.490508591346246,8879,8907,Eastern Montana,Dawson,30,21,Montana,MT
30025,30CS004,26,26,27,29,2,3,3,103.19524753266802,4,159.52143569292122,-68.76027182767255,-56.12947638126322,-43.91019877743948,1.1149450255316036,33,32,33,34,1,1,2,47.26443557520068,4,132.49420337860218,-97.3031887216468,-84.96692914264437,-72.14307470771605,1.6481841289892505,3009,3019,Eastern Montana,Fallon,30,25,Montana,MT
30033,30CS004,12,12,12,12,-0,-0,-0,-24.820862809347574,3,302.52100840336135,-340.44824704833883,-327.91346630941274,-315.08854144325755,3.979519919976224,15,15,15,19,4,4,4,316.1875890770651,5,415.2823920265781,-111.91684817788453,-99.29293768125694,-85.92328466947619,1.0401717291513797,1190,1204,Eastern Montana,Garfield,30,33,Montana,MT
30055,30CS004,17,17,17,13,-4,-4,-4,-262.65969751813344,4,279.2321116928447,-553.3653152343574,-542.1555474446241,-529.4440747302289,-1.4479113003240327,21,20,21,25,4,4,5,256.34816506313985,3,174.41860465116278,70.50165395664258,82.06721057110462,95.19851590586173,0.5546118486689128,1719,1720,Eastern Montana,McCone,30,55,Montana,MT
30071,30CS004,46,46,47,46,-1,-0,0,-8.57792904384279,12,346.4870067372473,-367.8577246296167,-355.1938644122389,-342.7868754015518,17.071699273353744,57,57,58,67,9,10,10,232.33769087826565,13,310.1145038167939,-89.76859610829757,-77.79019613910852,-66.17218883794003,1.2104738388709213,4156,4192,Eastern Montana,Phillips,30,71,Montana,MT
30075,30CS004,17,17,17,15,-2,-2,-2,-119.91238451876404,2,141.76018901358535,-273.139893357334,-261.34101497149555,-249.21999394349018,-2.8911598658552196,21,20,21,22,1,1,2,83.46175670935412,1,58.78894767783657,12.420357804565144,24.587846899794588,37.341057653274426,0.41327702334478117,1693,1701,Eastern Montana,Powder River,30,75,Montana,MT
30079,30CS004,15,14,15,18,3,3,4,351.3738073243737,3,334.5724907063197,-35.08597494611714,15.182051606442805,70.34916099818805,0.7227780455826426,18,18,19,12,-7,-6,-6,-576.5821239144104,5,459.1368227731864,-1089.2567663255877,-1035.4060326315505,-981.9649676986364,-0.9471527899583266,1076,1089,Eastern Montana,Prairie,30,79,Montana,MT
30083,30CS004,80,79,81,95,14,15,16,160.92555984002965,15,157.9362990260595,-8.754289459965243,3.0489466096298536,15.509552652475179,0.9211549660726234,98,96,99,128,29,30,32,269.43857428461826,16,141.40521431727794,115.20292778303342,127.61142688409481,140.45094399013146,0.5081466276913601,11397,11315,Eastern Montana,Richland,30,83,Montana,MT
30085,30CS004,123,119,128,167,39,44,48,482.9659872413992,45,499.07578558225504,-63.746796941443186,-16.499574433397914,40.55164138440202,1.0101592119844192,151,145,156,193,37,42,48,389.48664522736425,22,203.4211742949607,136.8498454993267,185.26691483458447,239.73892066991849,0.5101688160790804,10820,10815,Eastern Montana,Roosevelt,30,85,Montana,MT
30087,30CS004,73,72,74,123,49,50,51,721.0646599614109,35,501.432664756447,207.30895553540591,219.69753361490174,232.1566721569425,0.6818582972423833,87,86,88,126,38,39,40,479.780887261489,21,257.70033132899744,209.72023126659863,221.48786214410418,234.77009897665647,0.5237254551473081,8376,8149,Eastern Montana,Rosebud,30,87,Montana,MT
30091,30CS004,40,39,40,29,-11,-11,-10,-371.09465891440095,6,206.30372492836673,-590.4143543457219,-577.1909978830105,-565.4239501414597,-0.6127031959842671,49,49,50,61,11,12,12,332.14007442076024,2,56.72149744753262,261.2447599078197,274.93412104349994,288.9277995577897,0.15734082644463945,3490,3526,Eastern Montana,Sheridan,30,91,Montana,MT
30103,30CS004,10,10,11,5,-6,-5,-5,-866.6545273262655,5,797.8723404255318,-1717.5747407935323,-1664.103440480923,-1616.3497738964838,-1.1284045278858685,13,12,13,4,-9,-9,-8,-1157.2721176099503,4,521.5123859191656,-1734.198226590851,-1678.3861456007264,-1624.7645945119868,-0.5078541457912178,752,767,Eastern Montana,Treasure,30,103,Montana,MT
30105,30CS004,77,76,78,91,13,14,15,227.05938736726083,17,271.0603242094073,-56.050951671071786,-43.98580508777228,-31.53913338668999,1.11545570822118,94,93,95,102,7,8,9,101.35130987343089,13,172.43666268735907,-84.48410157148399,-70.89101602707096,-58.78415912998541,1.5044772227161813,7526,7539,Eastern Montana,Valley,30,105,Montana,MT
30109,30CS004,13,12,13,19,6,6,7,793.4901200259723,6,772.5321888412016,-30.913128338382677,20.88202748775489,70.64857115395374,0.8376643762926379,16,15,16,20,4,4,5,464.5499708211702,3,321.54340836012864,91.71310601347828,145.54860555442494,193.54149520991035,0.5624032074805239,932,933,Eastern Montana,Wibaux,30,109,Montana,MT
30029,30CS005,815,770,860,941,81,126,171,143.76078658329135,62,70.83960162245539,20.786876013833353,72.95214936233558,123.89804079427314,0.48887480062494626,1026,970,1081,1249,168,223,279,206.86134493536403,150,138.99570966576164,18.511928972231726,68.83203037635138,119.7536444054954,0.6689304533356668,105026,107917,Flathead,Flathead,30,29,Montana,MT
30043,30CS006,89,88,90,136,46,47,48,461.84530520234836,7,68.97117989982758,380.57210778085533,392.82160291038304,405.0521633995647,0.14621883390575252,112,110,113,177,64,65,67,525.645498482747,18,144.9158682875775,367.9309791214497,380.46056713656117,393.69257491393824,0.271532417500825,12179,12421,Jefferson+Lewis and Clark,Jefferson,30,43,Montana,MT
30049,30CS006,552,521,583,604,21,52,83,87.97122361136776,49,82.82856740385971,-46.31037101278365,4.747869930947191,54.98823721231587,0.9237908431178972,686,648,723,782,59,96,134,133.831167955858,99,137.38932526575815,-54.571011742676845,-5.410058174079847,48.79985613244386,1.0160509050358228,70990,72058,Jefferson+Lewis and Clark,Lewis and Clark,30,49,Montana,MT
30047,30CS007,274,260,287,319,32,45,59,174.6308546733383,23,88.34544348772447,33.74267764707419,85.03392618398668,136.77575630982628,0.49501021357252606,339,323,356,397,41,58,74,180.1525336756101,62,194.23558897243106,-67.50800913493025,-15.252566806960303,38.23599909864079,1.05974412180408,31241,31920,Lake+Lincoln+Mineral+Sanders,Lake,30,47,Montana,MT
30053,30CS007,210,202,219,239,20,29,37,173.7089254915439,12,72.48200533548093,53.01281222200949,102.62849786516412,149.34858151546408,0.4032398956006644,262,252,273,331,58,69,79,336.9043577942768,50,244.9899554118281,36.84318154126422,92.95574481561623,144.24938262800907,0.7167553420998979,19867,20409,Lake+Lincoln+Mineral+Sanders,Lincoln,30,53,Montana,MT
30061,30CS007,50,49,50,54,4,4,5,117.14396617331215,5,131.14754098360655,-26.3382862227494,-14.032097630633572,-2.6780953220871684,0.9147266714422159,64,63,64,84,20,20,21,423.48462341517563,13,269.87751712684246,140.9944328658814,153.15617018901665,166.3033400793796,0.6074978039762955,4575,4817,Lake+Lincoln+Mineral+Sanders,Mineral,30,61,Montana,MT
30089,30CS007,146,141,152,163,11,17,22,162.54012855671843,14,135.15687851971038,-25.259356769021245,25.59281974234258,83.87654421317349,0.784909627281556,183,176,190,233,43,50,57,387.27400701722735,39,302.67753201396977,35.38750567891789,84.26685692656129,131.47430411553316,0.7662044008196345,12430,12885,Lake+Lincoln+Mineral+Sanders,Sanders,30,89,Montana,MT
30063,30CS008,771,720,822,835,13,64,115,64.92538858392267,56,56.64241944048753,-43.92443120489869,9.303745806526766,59.59948321541495,0.8590402868977597,955,893,1017,1090,73,135,197,113.16156317687056,94,78.76390937122939,-18.819161007918222,34.09833170387459,86.4193373767989,0.6909146547904726,118639,119344,Missoula,Missoula,30,63,Montana,MT
30005,30CS009,60,59,60,89,29,29,30,506.4672124657029,24,414.03105232892466,79.89234094330881,92.52003747385126,105.13960021112027,0.7905602863720146,73,72,74,76,2,3,4,38.34257519134272,7,100.2434483746241,-73.92826972881957,-61.591847302924144,-49.816586088569395,1.9034866849063088,6956,6983,North Central Montana,Blaine,30,5,Montana,MT
30015,30CS009,51,50,51,64,13,13,14,274.9227058915239,1,20.446413358323394,241.6862708166517,254.29227151149198,265.6833463038044,0.06922326006947309,62,62,63,72,9,10,10,162.69642980430908,4,67.63611768684477,82.58197158084012,95.07888044054023,106.61455228046898,0.3765816360945337,5869,5914,North Central Montana,Chouteau,30,15,Montana,MT
30027,30CS009,132,130,133,150,17,18,20,194.31118475843522,15,157.72870662460568,23.869318214418485,36.644370244969004,48.33593801321362,0.7700603149071219,163,162,165,172,7,9,10,74.61295904049135,23,198.3784716232534,-136.36033258354354,-123.76728766742,-111.36948926155469,2.3832649692479873,11412,11594,North Central Montana,Fergus,30,27,Montana,MT
30035,30CS009,135,129,141,160,19,25,31,216.70352688589662,42,366.7054714784634,-196.21895035607386,-149.5494556717394,-98.42370892659861,1.6266600422467954,165,158,173,183,10,18,25,127.7862770045213,21,152.405834966253,-75.80978095301641,-24.615287051524987,24.918589196560333,1.1285668086889302,13744,13779,North Central Montana,Glacier,30,35,Montana,MT
30041,30CS009,141,134,148,158,10,17,24,122.6392217495688,34,250.6450423884998,-179.04738887657086,-125.7028647291207,-77.80273883298425,1.9278736613542427,172,164,181,205,24,33,41,202.71338742222116,29,179.13397986286984,-27.578275088519515,21.7765829905845,76.72556995622465,0.857549995948705,16278,16189,North Central Montana,Hill,30,41,Montana,MT
30045,30CS009,16,16,17,16,-1,-0,-0,-20.275414603831063,8,475.48291233283794,-508.0071915087814,-495.8531769453327,-483.79839995077884,12.14207166146612,20,20,20,24,4,4,4,184.75854043300336,2,98.0392156862745,74.14515376028075,86.33887337343498,98.79877017924144,0.4193686039914638,2019,2040,North Central Montana,Judith Basin,30,45,Montana,MT
30051,30CS009,13,13,13,18,5,5,5,285.9005916075111,5,296.8827313211281,-21.905663452718933,-11.166007166444476,0.8209548694686502,0.8598389489413976,16,15,16,15,-1,-1,-0,-30.781446393750148,5,256.6735112936345,-300.4214119680319,-287.3532343425493,-275.14559579204405,12.488216610537721,2021,1948,North Central Montana,Liberty,30,51,Montana,MT
30069,30CS009,7,7,7,3,-4,-4,-4,-892.5637742839426,3,720,-1663.9241282872242,-1615.2361188586935,-1564.8699432264827,-1.103340437170382,8,8,9,8,-1,-0,-0,-80.22497287190703,8,1550.3875968992247,-1681.4585035146106,-1631.5282364057985,-1575.4408611194103,13.650965360880024,500,516,North Central Montana,Petroleum,30,69,Montana,MT
30073,30CS009,62,61,62,67,5,5,6,104.4034720043856,1,20.37351443123939,71.76122492097507,84.32583308444396,95.36795316253843,0.1632794236599912,77,76,78,69,-9,-8,-7,-130.55699753882806,6,100.36801605888257,-244.01480680615683,-231.1011984446958,-219.6732026503149,-0.8817438490101464,5890,5978,North Central Montana,Pondera,30,73,Montana,MT
30099,30CS009,56,56,57,65,8,9,9,169.21439371465868,2,38.51709195955704,119.26932340941546,130.23329099423387,142.88557446487744,0.2043640430398289,69,68,70,92,22,23,24,364.0898375614444,14,223.46368715083798,128.26103784837514,140.84653965622786,152.45403710313096,0.587982601844452,6231,6265,North Central Montana,Teton,30,99,Montana,MT
30101,30CS009,45,44,45,48,3,3,4,80.67227406139827,2,48.661800486618006,20.3957241910034,32.30409185535281,43.190431723609315,0.46343170869679606,56,55,56,75,19,19,20,389.576270773194,9,179.85611510791367,197.0416219892338,209.45958273519113,222.1816398998218,0.4391444247065626,4932,5004,North Central Montana,Toole,30,101,Montana,MT
30007,30CS010,58,57,59,43,-16,-15,-14,-266.8726540917823,9,158.8702559576346,-437.532096674984,-425.80104251245507,-413.5147035081142,-0.6374688980967416,75,74,76,92,16,17,18,231.55981074504595,20,276.85492801771875,-58.96671661082701,-45.214351094318296,-32.89123270508633,1.1281664349287253,6798,7224,South Central Montana,Broadwater,30,7,Montana,MT
30009,30CS010,89,88,90,104,14,15,16,171.90838413180424,7,79.43262411347517,80.68792118242277,92.88155179069945,103.54262776878176,0.43345192873057486,111,109,112,109,-3,-2,-0,-14.745659742240736,18,166.69753658084832,-192.50599451681535,-182.0163907314631,-168.3489548850575,-30.39327176611883,10575,10798,South Central Montana,Carbon,30,9,Montana,MT
30037,30CS010,11,11,12,12,0,1,1,106.72758600947557,4,583.9416058394161,-525.7877882005171,-477.61888815140156,-425.80234724402186,2.310690921297766,14,13,14,17,3,3,4,383.54794212783656,4,482.50904704463204,-150.88541065552832,-97.6846786948726,-48.055703177950654,0.9570265322902853,822,829,South Central Montana,Golden Valley,30,37,Montana,MT
30059,30CS010,20,20,20,18,-2,-2,-2,-136.21350745656588,5,312.98904538341156,-462.0119519307858,-449.154705700347,-436.912308317819,-4.251661700854554,25,25,25,19,-6,-6,-6,-312.3114233340068,3,153.21756894790602,-478.2469868395664,-465.7137325431672,-453.1446086246624,-0.5865036514157171,1917,1958,South Central Montana,Meagher,30,59,Montana,MT
30065,30CS010,51,50,51,60,9,9,10,230.5331037437991,5,126.44889357218123,91.57648949916712,104.00957098150434,116.31853109051038,0.4942829677983352,64,63,64,92,28,28,29,580.8959063045812,17,348.7894952810833,220.51841067032242,231.80051679552778,244.92629608785185,0.5799501053741435,4745,4874,South Central Montana,Musselshell,30,65,Montana,MT
30095,30CS010,71,70,72,95,23,24,25,318.2250456576525,7,92.20636663007683,213.34253857886662,226.18899062521393,238.10384931439404,0.27823504696188456,86,85,87,133,46,47,48,523.3446941354134,20,221.26341409447946,290.26431944651983,302.12351151397706,314.4847724692112,0.41403472638013694,9110,9039,South Central Montana,Stillwater,30,95,Montana,MT
30097,30CS010,31,31,32,46,14,15,15,481.1809850749686,4,130.328536519142,338.79679134447815,350.6821123031593,362.60283641464486,0.25367437180168845,38,38,39,42,3,4,4,96.82594338381031,8,215.34320323014802,-130.7863876204325,-118.44036502227412,-105.15120199251739,1.7402336685113042,3683,3715,South Central Montana,Sweet Grass,30,97,Montana,MT
30107,30CS010,23,23,23,32,9,9,9,531.2720173326786,2,114.77761836441894,404.4668495376428,416.62585367289705,427.3799229332353,0.194980901046107,27,27,28,31,3,4,4,176.69053146868183,2,96.89922480620154,66.9465835438312,79.95671485920555,91.98035642361899,0.43039514472987855,2091,2064,South Central Montana,Wheatland,30,107,Montana,MT
30111,30CS011,1375,1304,1445,1579,134,204,275,148.9459949666954,173,126.0282288662923,-27.33434174065529,22.732575075918326,72.8348102857463,0.8420154679544051,1706,1620,1793,1942,149,236,322,141.1763855239488,238,142.6516422920163,-52.087038930772536,-2.2215773293387557,54.22548636028396,1.0061779256648797,164725,166840,Yellowstone,Yellowstone,30,111,Montana,MT
31007,31CS001,9,9,10,3,-7,-6,-6,-1121.3705851212983,3,517.9856115107913,-1691.3188881270476,-1637.8965665712958,-1590.9357328906956,-0.5459901480082037,12,11,12,4,-8,-8,-7,-1096.375162850835,4,578.8712011577423,-1728.132570596437,-1676.44720872557,-1626.7122412567776,-0.6082769113451739,695,691,Banner and Nearby Counties,Banner,31,7,Nebraska,NE
31033,31CS001,84,83,85,107,22,23,24,295.1500273729147,13,165.6402633255468,118.30876112866169,129.5678066892155,141.4928010321715,0.5379824289092009,105,103,106,136,30,31,33,330.518697151218,15,157.52993068683048,161.05782282975144,172.72246311136556,185.3746782190422,0.46193657492738605,9418,9522,Banner and Nearby Counties,Cheyenne,31,33,Nebraska,NE
31105,31CS001,47,46,48,56,8,9,10,314.12805386702325,3,104.92567764500146,155.15649306715162,209.92014503036896,259.8376858115695,0.3005576966235736,57,55,59,50,-9,-7,-5,-209.9876581168972,6,175.95307917888562,-439.82574504072585,-385.16125185276087,-339.1758132809102,-0.9739344080985809,3431,3410,Banner and Nearby Counties,Kimball,31,105,Nebraska,NE
31123,31CS001,49,48,49,69,20,20,21,535.6227105699467,12,316.1361141602635,207.83141982019237,219.49219292557078,232.29860382849705,0.5625524213933063,60,59,61,73,12,13,14,283.13232302840925,14,306.4127817903261,-36.15633093679195,-23.393465560280454,-10.752076820755514,1.0045696553929266,4555,4569,Banner and Nearby Counties,Morrill,31,123,Nebraska,NE
31157,31CS001,364,349,380,460,80,96,111,320.49032044524336,96,320.76627499025443,-53.38410493919196,-1.3663604054055678,50.26245025140197,0.9905340909272007,444,426,463,465,2,21,39,57.78529378285289,48,134.14565982896428,-130.46011134048993,-76.68836080550265,-23.462120598456025,2.2143557417610644,35914,35782,Banner and Nearby Counties,Scotts Bluff,31,157,Nebraska,NE
31019,31CS002,316,294,337,385,48,69,91,165.8086708933119,58,138.9055202969704,-27.02819342791024,27.02022746318475,79.34261866752259,0.8258177918611082,391,365,417,424,7,33,59,65.84800064411502,35,69.571439930031,-52.569865717578125,-3.6103096440258757,43.647680065675594,1.0255865631914685,50106,50308,Buffalo+Kearney+Sherman,Buffalo,31,19,Nebraska,NE
31099,31CS002,64,63,65,61,-4,-3,-2,-54.153323860905985,3,53.89221556886227,-120.34584166250289,-108.00902871855413,-96.10355702171363,-1.4891773823339707,78,77,79,63,-16,-15,-14,-226.25903947174172,5,74.8839299086416,-313.22783107899403,-301.652447716937,-288.5592192048943,-0.35442602808181956,6680,6677,Buffalo+Kearney+Sherman,Kearney,31,99,Nebraska,NE
31163,31CS002,34,33,34,43,9,9,10,375.0901115531404,1,40.52684903748734,322.20877574373367,334.54995145407037,346.73605487837847,0.0975100943423848,41,41,42,39,-3,-2,-2,-74.07174771867365,5,168.74789065136687,-254.63007319126243,-243.06481244090054,-230.79092135994398,-4.184990350814644,2961,2963,Buffalo+Kearney+Sherman,Sherman,31,163,Nebraska,NE
31021,31CS003,81,80,81,94,13,13,14,240.08653156701598,11,197.39793629430235,31.759839524430273,42.84023100527164,54.67132706052815,0.7650139922274469,99,98,100,72,-28,-27,-26,-404.5414123368101,5,74.5045447772314,-491.05527767469727,-478.8383678103026,-466.743468992921,-0.1912135523146819,6687,6711,Burt+Dakota+Thurston+Washington,Burt,31,21,Nebraska,NE
31043,31CS003,155,146,165,210,45,55,64,308.0403342588421,68,383.638928067701,-124.0854113667045,-75.03471089513938,-24.314352786425857,1.2230182997791972,190,179,201,157,-44,-33,-22,-154.32903227207385,11,51.69415856008271,-258.18084217599807,-206.7410921126868,-152.67129630621264,-0.3454809157751116,21270,21279,Burt+Dakota+Thurston+Washington,Dakota,31,43,Nebraska,NE
31173,31CS003,67,66,68,84,16,17,18,297.6470383551547,10,175.92728338953233,110.07866380162189,122.00933026752452,133.52246284018565,0.5580745260487485,80,79,81,104,23,24,25,358.76264609153793,18,271.00271002710025,75.10266217491386,87.20453510880823,99.63129977208924,0.7249582810185218,6821,6642,Burt+Dakota+Thurston+Washington,Thurston,31,173,Nebraska,NE
31177,31CS003,163,154,172,177,5,14,23,78.1857904276764,19,109.2006322141865,-80.171852031293,-30.31974361146099,20.87989354385778,1.3010422867505178,201,190,211,201,-10,0,11,2.0112615832738023,17,81.10687022900763,-129.48310962598237,-78.06942472314142,-27.653024081045203,11.958689667284203,20879,20960,Burt+Dakota+Thurston+Washington,Washington,31,177,Nebraska,NE
31027,31CS004,86,85,87,95,8,9,10,132.71844505404584,20,286.56716417910445,-166.02766886338154,-153.4545317967628,-141.41945583494345,1.9488160083736317,104,103,105,87,-18,-17,-16,-208.6465094382655,12,143.95393474088291,-364.8674284411838,-352.77253110990176,-339.5024333108298,-0.7320299000297735,8375,8336,Cuming and Nearby Counties,Cedar,31,27,Nebraska,NE
31037,31CS004,66,65,67,65,-2,-1,0,-10.694126859759447,21,238.6363636363636,-260.79604015806615,-249.3649876398399,-237.57524476589282,356.43461706592075,81,79,82,65,-17,-16,-14,-147.90471650743524,4,38.07710613993336,-199.1808168492971,-185.8678256219284,-173.13458897094907,-0.2751525460157752,10560,10505,Cuming and Nearby Counties,Colfax,31,37,Nebraska,NE
31039,31CS004,81,80,82,104,22,23,24,303.81440275275276,12,160.37420648179085,131.6000398124406,143.4706994781639,156.1256388529269,0.5056269392122087,100,98,101,121,20,21,23,238.21614527653745,5,55.62972852692479,170.33300339779095,182.41205329658027,195.25464783030378,0.22310604803164988,8979,8988,Cuming and Nearby Counties,Cuming,31,39,Nebraska,NE
31051,31CS004,51,51,52,64,12,13,13,270.7622972919442,14,300.8057296329454,-42.453358473138195,-29.822105093941897,-17.6959882430091,1.0292809410955177,63,62,63,64,1,1,2,26.522695515823287,4,72.07207207207207,-58.373025103190294,-45.43936143420761,-33.067416525417066,1.6181166926594674,5585,5550,Cuming and Nearby Counties,Dixon,31,51,Nebraska,NE
31167,31CS004,37,36,37,55,18,18,19,373.6861806320607,6,123.30878575098474,237.8746532806452,250.5756415155111,262.6400195102717,0.31277780632742413,45,44,46,43,-3,-2,-1,-34.899003484259545,4,68.7639676809352,-116.23349677417748,-103.60001398950207,-91.29102938871229,-3.8832122642516715,5839,5817,Cuming and Nearby Counties,Stanton,31,167,Nebraska,NE
31179,31CS004,61,60,62,67,5,6,7,70.25226702413715,3,37.27865796831314,21.829061974522624,32.91652239765128,44.44883237435062,0.4508870398509321,76,75,77,72,-5,-4,-3,-42.842437234879526,2,20.470829068577277,-75.84629018867714,-63.13245866793251,-50.15849443020823,-0.6278043002131046,9657,9770,Cuming and Nearby Counties,Wayne,31,179,Nebraska,NE
31053,31CS005,380,364,396,451,55,71,87,231.30119830391132,57,184.83489163919364,-3.4091272980470606,45.91724279061037,98.48857642885334,0.7880609099864812,462,443,481,488,7,26,45,69.63253093169838,41,110.50319381182113,-92.00638656886363,-40.7765937668807,10.889364830511633,1.5278122598200643,37006,37103,Dodge+Saunders,Dodge,31,53,Nebraska,NE
31155,31CS005,196,186,205,234,29,38,48,206.21637374457578,18,96.90878908878818,53.32670547443999,109.92599539281346,165.3910998412335,0.45798062201044476,242,231,254,252,-2,10,21,42.37945926965096,23,101.2101210121012,-107.92881759937185,-58.014665456442536,-5.577715825238152,2.1635386671847177,22289,22725,Dodge+Saunders,Saunders,31,155,Nebraska,NE
31055,31CS006,3658,3407,3910,4168,258,510,761,104.88232056651283,488,100.45527373032836,-46.94442688089748,3.6599068420401757,51.48040765066182,0.955914183878438,4520,4218,4822,4695,-127,175,477,29.956728089625805,384,65.6401279982496,-90.66970683049459,-37.08456171343263,16.962701234126737,2.1787326029872665,582946,585008,Douglas,Douglas,31,55,Nebraska,NE
31029,31CS007,44,44,45,46,1,2,2,53.24736485041036,7,216.60649819494586,-175.76085035410412,-163.0547229760265,-151.0974978700366,2.5727941405424724,54,53,54,60,6,6,7,157.59932127427837,5,130.41210224308816,15.049759020111843,27.109133791315763,39.70390094497913,0.7099894688489456,3878,3834,Frontier and Nearby Counties,Chase,31,29,Nebraska,NE
31047,31CS007,191,181,201,228,27,37,47,186.05758484284826,36,180.33060611120388,-48.8353724999324,5.40945922713716,57.690560765443536,0.9438093692185396,235,223,248,241,-7,6,18,24.061653184915087,29,121.24252686149086,-150.52414383807306,-98.57489029009535,-48.52453241551795,4.292921217344234,23956,23919,Frontier and Nearby Counties,Dawson,31,47,Nebraska,NE
31057,31CS007,20,20,21,20,-1,-0,-0,-34.41246115329425,3,218.04966686856451,-263.3389297135621,-252.64249856891422,-240.804771495201,5.6975523975706315,25,25,25,25,-0,0,0,0.8972289376160668,3,183.26206475259622,-195.4069845216983,-181.92760229906713,-169.5555723052422,2.9565748990242735,1651,1637,Frontier and Nearby Counties,Dundy,31,57,Nebraska,NE
31063,31CS007,17,17,17,19,2,2,2,89.06998634678975,1,47.393364928909946,29.23427902212934,41.71664690481777,53.18838034715609,0.34729738413913175,21,21,22,32,10,11,11,414.8085372334658,7,274.72527472527474,127.74328774560153,139.8187421957489,153.03698436454258,0.6050484449437973,2532,2548,Frontier and Nearby Counties,Frontier,31,63,Nebraska,NE
31073,31CS007,20,20,20,29,9,9,9,582.5677561646357,4,253.03110173958882,317.2887541701694,329.68910858388875,341.12009449993985,0.3917948259383615,24,23,24,22,-2,-2,-1,-88.0082386981785,9,490.73064340239915,-590.4953116577188,-578.6660901250947,-566.0565618224131,-14.656283341373658,1897,1834,Frontier and Nearby Counties,Gosper,31,73,Nebraska,NE
31085,31CS007,8,8,8,5,-3,-3,-3,-430.5557949371269,5,696.0556844547564,-1139.4628457660754,-1126.8462148643703,-1114.7750913417724,-2.3891142851997564,10,10,10,2,-8,-8,-8,-923.6179101579985,2,236.68639053254438,-1172.5546711135469,-1160.4544455039586,-1147.1218907228554,-0.2939200575351086,862,845,Frontier and Nearby Counties,Hayes,31,85,Nebraska,NE
31087,31CS007,31,31,32,44,12,13,13,572.7059644851404,4,182.5789273488018,378.1207019143183,389.99544196644786,402.5747606985516,0.2952676020819503,38,38,38,45,7,7,7,264.071322776722,6,231.66023166023166,19.505931978466705,32.354591411587705,45.773890274448554,0.7653600822953234,2629,2590,Frontier and Nearby Counties,Hitchcock,31,87,Nebraska,NE
31145,31CS007,114,113,115,119,4,5,6,56.529643491070686,4,44.973297104843994,-0.1942493293445649,11.444791510304638,23.1706223544691,0.6635875421491496,140,139,141,171,30,31,32,291.21496655457344,12,112.88805268109125,165.8011755668905,177.94166890113226,190.80379882664786,0.37551456121066473,10673,10630,Frontier and Nearby Counties,Red Willow,31,145,Nebraska,NE
31079,31CS008,488,462,515,549,34,61,87,116.39600891339549,111,213.236000384209,-148.4464363366987,-95.57401913398242,-42.21449116182592,1.8022423077984264,594,562,626,625,-1,31,63,49.2276036086722,53,85.36133614649938,-83.67698524081085,-35.373385306094484,12.55676409318667,1.6790788183388272,62466,62089,Hall,Hall,31,79,Nebraska,NE
31093,31CS009,64,63,65,70,5,6,7,111.39152836221083,14,258.8996763754045,-159.75662858801755,-147.49785390400018,-135.7539799826202,1.9933090605623223,79,79,80,93,13,14,14,208.04010898504802,6,91.93993257738278,103.85249620612619,116.04333560492289,127.8195831134563,0.4116158680600105,6489,6526,Howard+Merrick+Nance+Platte,Howard,31,93,Nebraska,NE
31121,31CS009,73,72,74,90,16,17,18,268.1404046821735,17,265.52128074970716,-8.784549830239147,2.514818153406093,13.502745891159039,0.9357271371477862,90,89,91,95,4,5,6,68.63195796492997,4,52.192066805845506,4.543745614843714,16.63228643014781,29.83475832113713,0.6389824068753152,7683,7664,Howard+Merrick+Nance+Platte,Merrick,31,121,Nebraska,NE
31125,31CS009,44,44,45,52,7,8,8,270.99414918060603,3,105.97586105387106,153.4707352831807,164.9754170932825,177.2167435528412,0.3459651870904305,54,54,55,49,-6,-5,-5,-158.94140396443194,4,118.02891708468574,-288.6257769897745,-276.66084976771344,-263.9449571619949,-0.9118837228606471,3397,3389,Howard+Merrick+Nance+Platte,Nance,31,125,Nebraska,NE
31141,31CS009,264,249,278,305,27,41,56,144.89685428254307,51,179.20937042459738,-84.9729165166835,-34.97019675718989,16.12942996556822,1.2075227307666423,326,309,344,344,-0,18,35,51.39730242616922,32,93.43884135836716,-92.66706892490852,-41.52728796484914,6.702818044851464,1.7202419757704843,34150,34247,Howard+Merrick+Nance+Platte,Platte,31,141,Nebraska,NE
31109,31CS010,1974,1835,2113,2179,66,205,344,76.29657302550925,148,55.083431548911356,-28.396462262003517,20.66917303735524,72.60328964280386,0.7184599401015719,2451,2284,2619,2552,-67,101,268,31.068980304714703,179,55.199210558776365,-74.31128060601226,-25.693925920410162,29.66307038184185,1.759205298912295,322420,324280,Lancaster,Lancaster,31,109,Nebraska,NE
31049,31CS011,20,19,20,18,-2,-2,-1,-109.37770700838333,7,458.76570180229385,-580.5975954516202,-567.9368817755853,-556.4308106999845,-10.464605886298097,24,24,25,35,10,11,11,564.8761723216971,3,161.29032258064515,390.4945522558106,403.4557239374515,416.4201185690059,0.26071774122427144,1831,1860,Lincoln and Nearby Counties,Deuel,31,49,Nebraska,NE
31101,31CS011,82,81,83,78,-5,-4,-3,-56.463268442389875,1,14.5032632342277,-83.37150767831453,-70.61508802723638,-58.6156003168236,-0.3456449340813353,101,100,102,132,30,31,32,378.95094313036157,15,181.05009052504525,184.91504981043786,198.35359508311993,209.53468372950914,0.46301890195780365,8274,8285,Lincoln and Nearby Counties,Keith,31,101,Nebraska,NE
31111,31CS011,316,301,331,406,75,90,105,312.1407110394446,55,191.01643899050708,69.47046705658886,121.38074097012638,171.76358757501248,0.6052221955969629,383,366,401,501,100,118,135,344.19379702386686,60,175.4693805930865,117.77747713247169,169.82741389090762,219.53866761392516,0.5055031305352288,34552,34194,Lincoln and Nearby Counties,Lincoln,31,111,Nebraska,NE
31113,31CS011,9,9,9,12,3,3,3,486.82035928043746,6,1005.586592178771,-572.1025614955638,-520.5192659523824,-469.1480335073008,1.5366117690069658,11,10,11,6,-5,-5,-4,-683.3122070021251,6,868.3068017366137,-1600.2543724277098,-1552.066418754887,-1501.318524642974,-1.6121719626394257,716,691,Lincoln and Nearby Counties,Logan,31,113,Nebraska,NE
31117,31CS011,5,5,5,2,-3,-3,-3,-918.9630402127752,2,588.2352941176471,-1558.0505872562176,-1507.110909455261,-1460.3427790069059,-0.9414093479164299,6,6,6,8,2,2,2,545.9904942484042,8,2099.737532808399,-1607.897249607114,-1552.6727293186073,-1499.80507965618,2.597213892032191,408,381,Lincoln and Nearby Counties,McPherson,31,117,Nebraska,NE
31135,31CS011,29,29,29,28,-1,-1,-1,-34.90674643107085,11,462.5087596355991,-509.8041629463068,-497.43305184936486,-485.9661715472527,64.78163340404636,35,35,35,36,1,1,1,30.857078515168773,3,105.82010582010582,-88.16811050619346,-75.01682898401293,-62.41583496187509,1.6001722417677244,2854,2835,Lincoln and Nearby Counties,Perkins,31,135,Nebraska,NE
31005,31CS012,6,6,6,8,2,2,2,511.274333724719,8,2196.796338672769,-1739.2905701838488,-1685.5568464654768,-1631.0244829357532,2.7953548344039367,8,7,8,6,-2,-2,-1,-345.70724200418,6,1369.86301369863,-1767.7574309793567,-1715.7235179553704,-1660.8855078239355,-11.668663175428147,437,438,Northwest Nebraska,Arthur,31,5,Nebraska,NE
31009,31CS012,6,6,6,4,-2,-2,-2,-592.2901897797536,4,1095.890410958904,-1739.2498414209138,-1687.8159597715176,-1640.5287393394888,-3.4427579737248353,8,8,8,3,-5,-5,-5,-1058.048471044154,3,656.4551422319474,-1767.8818077434637,-1714.2628029338262,-1666.8286263871405,-0.7822111597513741,438,457,Northwest Nebraska,Blaine,31,9,Nebraska,NE
31013,31CS012,98,97,99,112,13,14,15,153.6941577960866,5,55.576139310855865,86.66900797972868,98.00178463012038,110.48877622270723,0.3372146500569837,117,116,119,130,11,13,14,117.92395137567675,15,141.03046257991727,-35.7956172037457,-23.56631305759319,-10.25890618420623,1.1076330229482112,10796,10636,Northwest Nebraska,Box Butte,31,13,Nebraska,NE
31017,31CS012,30,30,30,40,10,10,10,406.7105254494687,7,288.36251287332647,107.05179713635002,118.56655348057927,130.39120597395896,0.6438025995090686,37,36,37,50,13,13,14,463.5564348919414,4,137.59889920880633,313.61048602905527,325.9681463242998,338.38558567893716,0.27632733631274486,2913,2907,Northwest Nebraska,Brown,31,17,Nebraska,NE
31031,31CS012,52,51,52,70,18,18,19,402.4662406140111,10,217.98365122615803,171.70125147287203,184.28371880634006,196.58756047481944,0.5137917428857521,62,61,63,79,16,17,18,310.2258996928291,10,183.18373328448433,114.75802640295409,126.88154650769573,138.72791628964728,0.5575617909876665,5505,5459,Northwest Nebraska,Cherry,31,31,Nebraska,NE
31041,31CS012,100,99,101,126,25,26,27,297.3219725091321,15,170.85904129093498,113.13847632606645,126.13290655191798,138.407538834484,0.5534566939685117,121,119,122,144,22,23,25,224.42916126191744,14,133.7792642140468,78.0552337324437,90.27355310087752,104.43219907191254,0.571743340032405,10535,10465,Northwest Nebraska,Custer,31,41,Nebraska,NE
31045,31CS012,70,70,71,90,19,20,20,285.03821597129104,16,233.8611449451888,39.334281293438885,50.98951784406024,64.28009405871381,0.7804358541425077,85,84,86,107,21,22,23,270.4593854347983,4,49.09180166912125,208.66484132687472,221.07581329988864,234.0407479543396,0.17363348808749401,8210,8148,Northwest Nebraska,Dawes,31,45,Nebraska,NE
31069,31CS012,26,26,27,24,-3,-2,-2,-155.56243381867503,2,128.34224598930481,-333.1665616857071,-284.1265977442588,-231.6229748538242,-1.4043156272966981,32,31,33,36,3,4,5,227.14168230053843,6,323.97408207343415,-151.8659551176493,-97.4478967438296,-46.20747514755891,1.1523693578972825,1870,1852,Northwest Nebraska,Garden,31,69,Nebraska,NE
31075,31CS012,9,9,9,14,5,5,5,980.3843901202847,4,785.5973813420621,182.47287297090432,194.71836709707318,207.1856762246793,0.667580080920968,10,10,11,7,-4,-3,-3,-593.0719679811766,7,1198.6301369863013,-1804.6784362259164,-1791.665050178303,-1778.8396929324924,-2.8414392165053917,611,584,Northwest Nebraska,Grant,31,75,Nebraska,NE
31091,31CS012,13,13,13,10,-3,-3,-3,-522.4722034570899,2,340.90909090909093,-875.6678428911628,-863.4450085844845,-851.1678461156824,-0.9684431537994802,16,16,17,15,-2,-1,-1,-200.5377903659875,7,958.9041095890411,-1171.7463968458799,-1159.8364799131211,-1146.4620347529988,-15.088617508985786,704,730,Northwest Nebraska,Hooker,31,91,Nebraska,NE
31103,31CS012,11,11,11,6,-5,-5,-5,-753.8164813561227,6,936.2808842652795,-1745.766706515471,-1692.525216210371,-1638.0513385138445,-1.5662903881951888,13,13,14,3,-11,-10,-10,-1332.39454520402,3,382.65306122448976,-1767.2525114791251,-1715.8543111837726,-1661.4198232679678,-0.3175956490195063,769,784,Northwest Nebraska,Keya Paha,31,103,Nebraska,NE
31115,31CS012,10,10,10,8,-2,-2,-2,-400.97398030798746,8,1563.5179153094462,-1976.7131514176535,-1964.2468084237134,-1952.2603945816927,-7.607092173578344,12,12,12,1,-11,-11,-11,-1826.3970119563694,1,165.56291390728478,-2005.2464660909118,-1992.2433773103683,-1979.6716799357052,-0.09968660572525871,614,604,Northwest Nebraska,Loup,31,115,Nebraska,NE
31149,31CS012,18,17,19,15,-4,-3,-2,-279.85753616640994,6,561.6224648985959,-895.6389689304729,-842.025827442194,-789.5001641882121,-3.0153612381132535,22,21,22,24,2,2,3,181.78113143773368,3,237.34177215189874,-104.41973867699808,-55.61516897730577,-8.27897645076762,0.9097212352592167,1282,1264,Northwest Nebraska,Rock,31,149,Nebraska,NE
31161,31CS012,62,62,63,86,23,24,24,553.4359703657942,16,375.2931978107897,166.01235225584642,178.12649415004486,190.68919383456654,0.6505434830492529,76,75,76,71,-5,-5,-4,-88.45520747303354,13,255.15210991167814,-356.0882674076598,-343.7623996977248,-330.8788729438649,-3.707090970151968,5116,5095,Northwest Nebraska,Sheridan,31,161,Nebraska,NE
31165,31CS012,9,9,9,10,1,1,1,143.2566572066408,6,628.2722513089005,-496.95124050853724,-485.06625325335796,-473.5127576620343,2.5336756357187515,10,10,11,13,2,3,3,222.8026447867582,8,699.912510936133,-489.8072282615678,-477.003288330638,-464.1732742599241,2.25565972733451,1146,1143,Northwest Nebraska,Sioux,31,165,Nebraska,NE
31171,31CS012,10,9,10,7,-3,-3,-2,-447.2556815900036,7,1237.1134020618558,-1734.0988911434963,-1684.1163352871054,-1631.3500486629355,-4.573006220009101,12,11,12,6,-6,-6,-5,-824.0495587078261,6,891.5304606240712,-1767.8128233784441,-1717.2977126832468,-1665.0279238391752,-1.3198841450272523,679,673,Northwest Nebraska,Thomas,31,171,Nebraska,NE
31059,31CS013,69,68,69,71,2,2,3,52.95767876623462,13,280.92922744462453,-240.22732194642123,-228.0209352664572,-215.54368815916294,3.76744262369227,84,83,85,82,-3,-2,-1,-37.91266993027085,2,36.04253018561903,-86.29990034150119,-74.29336051866954,-62.35025991437159,-1.8119650411890664,5553,5549,Saline and Nearby Counties,Fillmore,31,59,Nebraska,NE
31067,31CS013,234,225,243,252,9,18,27,100.77485341962257,25,138.63216266173754,-90.32260351982858,-37.578279712381914,15.466454994571583,1.3039125301951915,286,274,297,330,33,44,56,205.1525323338355,30,138.74115525135272,16.07427918087714,63.997647179897214,118.08920819183406,0.6613737357728307,21640,21623,Saline and Nearby Counties,Gage,31,67,Nebraska,NE
31095,31CS013,91,90,92,96,4,5,6,82.6331688843138,3,49.889135254988915,21.1648356199248,33.01820010783837,45.297748498930915,0.5025960856198155,111,110,112,123,11,12,13,162.71141698440402,10,139.12075681691707,10.554033770193216,23.437274321045578,36.40441690990789,0.7876684732982998,7216,7188,Saline and Nearby Counties,Jefferson,31,95,Nebraska,NE
31129,31CS013,52,51,52,70,18,18,19,536.1186868458018,12,352.1643433602348,171.8082466551948,183.86441792217533,197.27492093310502,0.6227863754291089,63,63,64,62,-2,-1,-1,-26.881709855291522,5,123.06177701206006,-162.9412876933041,-149.66612821677427,-138.4913936528509,-54.227657938543274,4089,4063,Saline and Nearby Counties,Nuckolls,31,129,Nebraska,NE
31151,31CS013,125,124,127,102,-25,-23,-22,-195.29424548775742,2,16.859852476290833,-224.72244219116095,-211.63116639720442,-200.50624129870454,-0.09022510313362479,154,152,156,133,-23,-21,-19,-146.96289919247204,8,56.33802816901409,-214.90706278888206,-203.06908723701048,-190.37494671301937,-0.40264271150766784,14235,14200,Saline and Nearby Counties,Saline,31,151,Nebraska,NE
31169,31CS013,67,66,67,65,-2,-2,-1,-46.7198841348982,3,72.04322593556134,-130.83464560818575,-118.74413802970734,-106.02616628025369,-3.1729450443884097,81,80,82,95,13,14,15,284.3729873712572,8,162.33766233766235,108.5451942046411,121.65192577142582,134.6702361959653,0.5328395396479789,4997,4928,Saline and Nearby Counties,Thayer,31,169,Nebraska,NE
31153,31CS014,916,834,998,1136,138,220,302,138.57629062930468,116,72.97968941689648,11.215151206092463,66.3517984067523,113.73662208488776,0.5242589428826425,1155,1055,1254,1298,44,143,243,74.2967902403145,105,54.38104017981997,-34.245731193984035,18.688012167343764,71.6237297284243,0.7268763573442995,190738,193082,Sarpy,Sarpy,31,153,Nebraska,NE
31001,31CS015,265,252,278,337,59,72,85,277.58714577837287,47,181.01290198343924,44.24037143008308,96.35080888585527,148.38069670418804,0.6431703984990845,323,307,339,364,25,41,57,131.733750642803,32,103.07950006442469,-23.472078098718008,27.558410919409727,81.44971418946467,0.7638065392641028,31158,31044,South Central Nebraska,Adams,31,1,Nebraska,NE
31035,31CS015,58,57,59,74,15,16,17,311.70529390926936,12,235.44800523217788,63.67794696085731,76.31849657267475,88.8288581031716,0.7106234733706402,70,70,71,83,12,13,13,207.78221244615457,11,180.8913007728992,15.300381206131695,27.073892312826267,39.61894192570266,0.8067333580906021,6116,6081,South Central Nebraska,Clay,31,35,Nebraska,NE
31061,31CS015,32,32,33,40,7,8,8,319.55254830538405,6,248.6187845303867,59.33795097459769,70.7571917724967,82.47197599057529,0.6887156561407554,39,39,40,65,25,26,26,883.6352751760363,7,241.3793103448276,628.0123159611367,642.2247743415394,654.4971604713529,0.2629066214358553,2896,2900,South Central Nebraska,Franklin,31,61,Nebraska,NE
31065,31CS015,52,52,52,57,5,5,5,129.794016975844,7,181.6216216216216,-63.391543807706384,-52.140329623659326,-39.71192685672025,1.1661850832263843,63,62,64,79,15,16,17,346.4458308911667,10,217.10811984368218,117.92098376398154,129.28860533717994,142.26267034246592,0.5897166981639425,4625,4606,South Central Nebraska,Furnas,31,65,Nebraska,NE
31083,31CS015,32,32,32,37,5,5,5,197.04239196572144,3,115.97938144329898,69.21605875407386,81.212355924054,92.32783436172708,0.49205899834749917,39,38,39,62,23,23,24,757.8911008041829,2,64.80881399870383,681.2875189337185,692.8736373526792,706.237534174675,0.08200579828528534,3104,3086,South Central Nebraska,Harlan,31,83,Nebraska,NE
31137,31CS015,94,93,95,98,3,4,5,54.5196914769199,12,160.5709188224799,-118.13014638979223,-106.06854236568134,-93.98795265808404,2.364793765620897,114,113,115,141,26,27,28,301.72128367877775,11,123.01498546186535,165.3331756119226,178.7874334583633,192.38049713165236,0.3931391192710621,8968,8942,South Central Nebraska,Phelps,31,137,Nebraska,NE
31181,31CS015,48,48,48,54,6,6,6,209.73637131931284,7,246.9861805351367,-49.032494561273815,-37.327280112860834,-25.157391358622306,1.008024113319417,59,58,59,63,4,4,5,128.8431329656881,7,205.39906103286387,-88.84784157898446,-76.503401302536,-65.05022478380583,1.2984666661431514,3401,3408,South Central Nebraska,Webster,31,181,Nebraska,NE
31025,31CS016,202,190,213,266,53,64,76,289.70597417017234,17,76.75521107683046,159.4984776270103,213.30818496751183,267.08323222297315,0.26087605771206956,250,236,264,267,3,17,31,62.59862836469426,22,81.61751066592468,-68.0019992711376,-17.76033471888755,30.195928735976334,1.230875256421733,26578,26955,Southeast Nebraska,Cass,31,25,Nebraska,NE
31097,31CS016,59,58,59,51,-8,-8,-7,-175.8763449340708,4,91.32420091324201,-279.55889795891125,-267.2521945570148,-255.21587857430703,-0.5967135486838641,73,72,73,67,-6,-6,-5,-108.50505647930034,6,112.95180722891565,-233.86454342831527,-221.42003687508435,-208.79615281102167,-1.2595017335094896,5256,5312,Southeast Nebraska,Johnson,31,97,Nebraska,NE
31127,31CS016,72,71,72,81,9,9,10,159.95428965838107,14,237.82559456398639,-89.02841542809347,-78.17264592540334,-66.14620972344238,1.3440891376832147,88,87,89,90,1,2,3,29.53180960916931,10,141.48273910582907,-124.52018065310081,-112.02988271044535,-98.6944952463551,3.239067504114325,7064,7068,Southeast Nebraska,Nemaha,31,127,Nebraska,NE
31131,31CS016,153,146,160,148,-12,-5,2,-39.43547554997436,4,30.16780843441644,-121.85391478272277,-69.7262923321629,-19.63290956828529,-0.9458913653699569,187,179,195,193,-2,6,14,38.01569032281408,14,87.91760864104496,-98.35565614824151,-50.41408707784632,2.6855471795370693,1.9847968736047648,15911,15924,Southeast Nebraska,Otoe,31,131,Nebraska,NE
31133,31CS016,34,33,35,43,8,9,10,439.57052340764074,4,188.08777429467082,204.56605196671248,249.89002276402877,302.27505044519324,0.3865406619660963,41,40,42,41,-1,0,1,6.371976845799001,6,235.6637863315004,-280.10866446211463,-228.48275100598516,-175.5058086266631,5.162486995974466,2552,2546,Southeast Nebraska,Pawnee,31,133,Nebraska,NE
31147,31CS016,98,97,98,129,31,31,32,482.4948810206336,18,275.8268420380539,194.58200283994415,206.6049078475016,218.50670981985584,0.5540709911273348,119,118,120,131,11,12,13,159.87553326837582,12,154.44015444015443,-6.984416448161072,5.996730486722373,17.704385685074165,0.8940326271360446,7831,7770,Southeast Nebraska,Richardson,31,147,Nebraska,NE
31003,31CS017,62,61,63,75,12,13,14,250.5571486904089,10,191.0219675262655,48.219454379556595,59.57870845110068,71.41384379383221,0.708382523188384,75,75,76,83,7,8,8,120.96019697570222,7,111.48272017837235,-3.682770927752585,8.793263620679665,22.261301444951236,0.8144183917145367,6282,6279,Wheeler and Nearby Counties,Antelope,31,3,Nebraska,NE
31011,31CS017,56,56,57,62,5,6,6,126.54072329062551,5,112.59148057796958,2.3706739853039203,13.836137036514252,26.36481943682092,0.7553483246198771,69,69,70,82,12,13,13,234.21380732811724,5,92.9195316855603,128.05261728372267,141.54195107693369,154.57907570406405,0.36756476290212897,5329,5381,Wheeler and Nearby Counties,Boone,31,11,Nebraska,NE
31015,31CS017,26,26,27,33,6,7,7,435.76854889903615,6,396.2575674188222,-12.536922138214765,40.766180410019665,87.6103996021357,0.7896542541115237,32,31,33,38,5,6,7,347.6956516332444,2,111.66945840312674,182.6984979653319,235.30841780917098,281.8659659312271,0.2767312294358342,1817,1791,Wheeler and Nearby Counties,Boyd,31,15,Nebraska,NE
31071,31CS017,27,26,27,23,-4,-4,-3,-234.87527248005756,1,65.46644844517185,-348.73228804803296,-302.3065254768544,-248.73176763055307,-0.3864406049574524,33,32,33,40,7,7,8,407.4748122055891,4,218.10250817884406,139.00790166074725,190.26997257507028,237.548528992241,0.47208290219975674,1833,1834,Wheeler and Nearby Counties,Garfield,31,71,Nebraska,NE
31077,31CS017,23,23,23,27,4,4,4,208.4740181075882,7,380.77969174977335,-184.19375980417132,-172.84410818565723,-159.68234818449864,1.44854138483629,28,28,28,28,-0,0,0,9.869886038067044,5,230.30861354214645,-233.9980295067217,-220.49840384558462,-208.09588428519882,4.117682625328982,2206,2171,Wheeler and Nearby Counties,Greeley,31,77,Nebraska,NE
31089,31CS017,105,104,106,112,6,7,8,78.41156001222281,17,202.38095238095235,-135.84943744267144,-124.24294235273203,-112.59935914819259,2.2408015305026834,128,127,129,125,-4,-3,-2,-31.608648334293104,5,49.731450169086926,-93.95528006603085,-81.05890352749631,-68.31282233990561,-2.295754205487165,10080,10054,Wheeler and Nearby Counties,Holt,31,89,Nebraska,NE
31107,31CS017,89,88,90,104,14,15,16,213.13139301101316,12,171.8787300071616,29.146243433201,41.79841737685657,54.35354460065114,0.7556616331669042,109,108,110,122,12,13,14,155.98865632027093,12,142.89116456299118,0.35744181049139356,13.214853675811545,26.46767005665244,0.8510682144317427,8378,8398,Wheeler and Nearby Counties,Knox,31,107,Nebraska,NE
31119,31CS017,320,305,336,327,-9,7,22,22.425388310918844,41,138.99090344087236,-166.69635478999973,-114.83406387072492,-66.19647911559602,5.38402843796261,392,374,411,357,-54,-35,-17,-100.09735877055809,24,67.8790621376248,-222.11784438398132,-167.22228836568422,-110.01994424763988,-0.6978484112724256,35398,35357,Wheeler and Nearby Counties,Madison,31,119,Nebraska,NE
31139,31CS017,62,62,63,64,1,2,2,27.313321397391913,17,279.52863798300905,-264.43883789013523,-252.01542965170432,-239.8205324910921,6.388323256241649,76,75,77,82,5,6,7,79.18859701565783,4,54.682159945317835,12.41202809460792,24.88832324323619,36.31517814089961,0.5888721531425344,7298,7315,Wheeler and Nearby Counties,Pierce,31,139,Nebraska,NE
31175,31CS017,44,43,44,41,-3,-3,-2,-83.22822681117407,6,177.33990147783254,-273.2580405049969,-260.28722731991365,-248.5192531657228,-3.304167919559725,53,53,54,73,19,20,20,481.0351334149479,4,98.44942160964804,370.0080672171211,382.80076696735836,395.6119119284725,0.1946997143007824,4060,4063,Wheeler and Nearby Counties,Valley,31,175,Nebraska,NE
31183,31CS017,11,11,12,6,-6,-5,-5,-822.1497758503407,6,927.8350515463918,-1803.9575513966493,-1749.2596712744482,-1698.5283479563466,-1.3899929839656027,14,14,14,5,-9,-9,-9,-1141.5250162302198,5,631.3131313131313,-1820.9527809849908,-1772.6661953878931,-1722.33535650715,-0.621822631815685,776,792,Wheeler and Nearby Counties,Wheeler,31,183,Nebraska,NE
31023,31CS018,94,94,95,90,-5,-4,-4,-63.74362413089732,11,158.90213073311665,-235.1427246795197,-222.1152942488753,-210.80296622162115,-3.2232992914774625,117,116,118,109,-9,-8,-7,-97.67128302810612,6,71.17437722419929,-181.5536184942968,-168.8818858607308,-155.85043687053795,-0.8294522847047581,8307,8430,York and Nearby Counties,Butler,31,23,Nebraska,NE
31081,31CS018,72,71,73,101,28,29,30,365.4176843473738,20,255.7544757033248,97.42160063619147,109.68643123511936,121.47620479225995,0.6762316725351983,89,88,90,112,22,23,24,246.05724299654395,1,10.651896037494673,222.82247276662432,235.37973365457455,248.41205235529188,0.04149402735553671,9384,9388,York and Nearby Counties,Hamilton,31,81,Nebraska,NE
31143,31CS018,50,50,51,90,39,40,40,910.2018739048995,10,230.37051257439046,667.9429862849905,679.6972194929012,691.6607813270289,0.24685051851466344,62,61,62,63,1,1,2,28.833944071296735,3,57.90387955993051,-41.910893646128,-28.97401940635645,-16.55247374538886,1.2029416049129138,5209,5181,York and Nearby Counties,Polk,31,143,Nebraska,NE
31159,31CS018,156,149,164,155,-9,-1,6,-10.116260113175242,23,157.14855093093433,-220.29717364395725,-165.74815450501197,-116.18426493273499,-47.85694820128887,190,181,200,177,-23,-13,-4,-76.38052495960395,19,107.93614724762826,-234.04109968229912,-184.30122880887095,-135.59976465447357,-1.526685194636922,17563,17603,York and Nearby Counties,Seward,31,159,Nebraska,NE
31185,31CS018,145,139,151,137,-14,-8,-2,-70.24906531640632,10,85.5188141391106,-203.5484041986861,-155.52028485125817,-104.65140360900794,-1.3861056328642565,178,171,185,179,-6,1,8,6.02785721907649,11,77.35039729976795,-119.9119985205363,-72.40707589783223,-20.880197641384488,5.922825874591958,14032,14221,York and Nearby Counties,York,31,185,Nebraska,NE
32005,32CS001,451,429,472,522,50,71,93,173.0541708089693,43,104.36682105944459,19.36920192987169,68.31040452130813,124.08592566128549,0.5947460919337829,555,530,581,660,79,105,130,210.1780383581861,53,106.40220031719902,57.12883297857818,103.02103490033103,159.12776158200592,0.5014580949699651,49441,49811,Carson City (city)+Douglas,Douglas,32,5,Nevada,NV
32510,32CS001,708,683,734,786,52,78,103,159.70311058369103,68,139.9560922063666,-30.009541551234694,19.77091019706754,74.4421497676248,0.8652013938675687,870,839,900,985,85,115,146,195.60587122662622,110,186.6083091590751,-43.44317330210783,8.537309004498864,60.02304236615715,0.9457989051420597,58304,58947,Carson City (city)+Douglas,Carson City (city),32,510,Nevada,NV
32003,32CS002,15108,14130,16087,18083,1996,2975,3953,156.8603491234394,2428,128.02874143300264,-24.709302980546735,27.92570441432651,81.47091555226406,0.8159214136062567,18894,17712,20076,22834,2758,3940,5122,172.06139710594803,3895,170.11021569713307,-50.71009669289708,2.2705267326806315,58.044757463663316,0.9884090840998091,2275739,2289692,Clark+Nye,Clark,32,3,Nevada,NV
32023,32CS002,753,731,776,783,7,30,52,69.11604047637485,66,154.16058394160584,-139.69233886062318,-86.48476339092333,-32.67755337547014,2.1575463327041904,946,918,973,1088,115,142,170,267.31006602146647,187,351.2792576173122,-134.71592936549612,-85.17661803944239,-30.533012945449478,1.3049560926771928,51375,53234,Clark+Nye,Nye,32,23,Nevada,NV
32001,32CS003,252,241,263,325,62,73,84,345.31356811294876,46,216.5810020794915,76.31307797161892,128.88816162407005,179.62502318038483,0.6187642331614203,310,296,323,388,65,78,92,304.95384059442864,50,194.58281444582815,61.15306122509688,108.29607589073656,161.6208120534368,0.6300328688921261,25487,25696,Lyon and Nearby Counties,Churchill,32,1,Nevada,NV
32009,32CS003,9,9,9,6,-3,-3,-3,-458.8982858524388,6,957.4468085106382,-1468.3200877518123,-1416.401093640953,-1365.1344844644022,-3.198699039896892,11,10,11,12,1,1,2,165.1571608848595,8,1079.6221322537112,-962.5751325604389,-915.4636953148894,-865.4656311206948,3.5974222563958063,752,741,Lyon and Nearby Counties,Esmeralda,32,9,Nevada,NV
32019,32CS003,576,550,601,699,98,123,149,249.37294539273972,61,123.43389035967826,79.30622257015365,126.58608236852733,177.0691870242434,0.49099296939069825,718,687,750,893,143,175,206,287.77864770993006,108,177.95939889269707,60.90629463108084,110.66474261948703,159.92624985902995,0.6148692263156856,59303,60688,Lyon and Nearby Counties,Lyon,32,19,Nevada,NV
32021,32CS003,63,62,63,78,15,15,16,403.4264861684913,2,52.73566249176005,338.7848184658513,351.1733117237278,362.8933374355812,0.1226997667372991,77,77,78,87,9,10,10,211.7093652375962,14,305.61012879284,-106.84783486829882,-93.99692289405185,-81.02731946905014,1.3086061579472779,4551,4581,Lyon and Nearby Counties,Mineral,32,21,Nevada,NV
32029,32CS003,33,33,34,36,2,3,3,73.79421976692707,5,145.52510308028135,-83.94726986922636,-71.59006726369304,-58.71254211660988,1.4142485652823842,41,41,42,48,6,7,7,161.09825486703312,1,24.16626389560174,124.55382013482705,136.9605586392101,150.2629880483027,0.13044194353568644,4123,4138,Lyon and Nearby Counties,Storey,32,29,Nevada,NV
32007,32CS004,283,260,306,340,34,57,80,128.09403865325152,42,93.95973154362417,-17.746268947746568,33.89145575623547,87.6956129294724,0.7209305943734425,354,326,382,505,123,151,179,280.455425464276,101,187.41533836818763,41.53226821401841,94.06616750261918,147.62875571945074,0.6638612139913707,53640,53891,"Northern Nevada, excluding Washoe",Elko,32,7,Nevada,NV
32011,32CS004,12,12,13,11,-2,-1,-1,-92.19511481044387,6,381.55802861685214,-486.6143829413192,-473.77084789058557,-461.5204577396173,-13.340205602674898,15,15,16,28,12,13,13,662.2494312038526,1,52.770448548812666,596.1605305749634,609.7958817530321,621.7882621962444,0.07380277114402281,1887,1895,"Northern Nevada, excluding Washoe",Eureka,32,11,Nevada,NV
32013,32CS004,130,123,138,124,-14,-6,1,-45.061411676215435,10,69.51283091003882,-163.46187123319032,-114.72133396879892,-64.45138717527506,-1.823998855176073,164,155,173,207,34,43,52,246.5341963846963,36,204.60358056265983,-11.824687745390564,42.394889433689855,94.2533106965218,0.8112183959122817,17263,17595,"Northern Nevada, excluding Washoe",Humboldt,32,13,Nevada,NV
32015,32CS004,43,43,44,55,11,12,12,243.2792429674547,4,84.18098912662222,146.43070305677264,159.4616159223466,172.33555005818113,0.31847593481514563,54,54,55,70,15,16,16,270.2222389881141,12,207.3613271124935,50.09847341086029,62.49782085261615,74.75504546958585,0.721250895565988,5702,5787,"Northern Nevada, excluding Washoe",Lander,32,15,Nevada,NV
32017,32CS004,40,39,40,51,11,11,12,299.2543278756746,3,78.20986313273953,208.84969032745803,220.66120802082472,232.8276527886079,0.24040585778302173,48,47,48,63,15,15,16,336.26843750765096,1,22.114108801415306,301.11452543486024,314.04358447000584,326.46254482128074,0.06170531748592542,4603,4522,"Northern Nevada, excluding Washoe",Lincoln,32,17,Nevada,NV
32027,32CS004,47,46,48,54,6,7,8,125.31963540655823,11,198.55595667870034,-84.29502515702166,-73.13305561087364,-61.76365622326517,1.3849181255151193,59,58,60,86,26,27,28,404.93956839765895,19,282.4858757062147,110.08585667670962,122.46856269757296,134.25998837834095,0.6728942350402636,6648,6726,"Northern Nevada, excluding Washoe",Pershing,32,27,Nevada,NV
32033,32CS004,74,73,75,79,4,5,6,60.8421904382752,0,0,48.67950391376704,60.55317949827183,72.69860373116906,0,92,91,93,105,12,13,14,143.9843036858994,18,196.35649612741355,-65.05901733459783,-52.31109053912624,-39.63110839328712,1.2676912369848607,9148,9167,"Northern Nevada, excluding Washoe",White Pine,32,33,Nevada,NV
32031,32CS005,3511,3302,3720,3998,278,487,696,120.31601889496278,441,108.92811197447641,-36.51705652033451,11.378444157060214,61.49450941448295,0.9034952068613034,4362,4108,4617,4849,232,487,741,98.82297285039377,522,105.98640450259485,-55.666929723360276,-6.739778865429053,46.1699935977315,1.070288527496892,485825,492516,Washoe,Washoe,32,31,Nevada,NV
33001,33CS001,660,632,687,697,10,37,65,70.64656410359355,44,83.18104480433549,-65.36475169800731,-11.385392237024503,39.84500436466879,1.146738853120465,818,785,851,823,-28,5,38,7.612699234167569,80,124.3104653873048,-170.63562680449976,-116.5977965214654,-63.33122705473038,13.56126981805417,63476,64355,Belknap+Carroll,Belknap,33,1,New Hampshire,NH
33003,33CS001,505,483,526,489,-37,-16,6,-37.202858946664996,3,7.181042048990665,-95.0034923124435,-43.66627243263391,4.80555961749308,-0.2062973734857119,632,606,659,611,-48,-21,5,-41.325246218420105,36,70.15902712815715,-162.08879421006642,-111.59071620868178,-59.928137202670136,-1.7817539187413287,50132,51312,Belknap+Carroll,Carroll,33,3,New Hampshire,NH
33005,33CS002,646,613,679,631,-48,-15,18,-23.627454404035586,6,9.412133809168987,-85.85656473196015,-31.743151979963663,19.180802917996996,-0.4266845230547803,800,761,840,900,60,100,139,128.88866825953014,76,98.43539529582426,-18.979029648521585,30.1352547619158,81.43003478196682,0.7561258907792154,76497,77208,Cheshire,Cheshire,33,5,New Hampshire,NH
33007,33CS003,382,368,395,402,7,20,34,77.50840300499267,20,76.87133660036513,-49.050912013375715,0.7093741369313653,50.89097189997196,0.944922867341345,467,451,483,573,90,106,122,337.99416142910025,62,198.26042466103866,87.24376777893282,139.83151724516952,187.05695227331967,0.5810818449262553,31221,31272,Coos+Grafton,Coos,33,7,New Hampshire,NH
33009,33CS003,744,704,783,734,-49,-10,30,-12.568570835951336,11,14.485596707818932,-73.3685123949465,-27.822200643398805,22.583846049928404,-1.2874142358420373,925,877,972,935,-37,10,58,11.35257427712124,44,47.80322454478293,-89.57561923301034,-34.66965409242843,15.725700556590999,3.843008401679694,91125,92044,Coos+Grafton,Grafton,33,9,New Hampshire,NH
33011,33CS004,3003,2822,3185,3420,235,417,598,118.42022410354127,412,117.12198311396651,-51.69122043376666,1.4687015771869172,50.324532526611506,0.9866684275872838,3712,3493,3931,3963,32,251,470,59.281456686731445,297,70.06716539389778,-61.03404619021396,-11.862834567343242,41.961804964643306,1.1772556781567214,422124,423879,Hillsborough,Hillsborough,33,11,New Hampshire,NH
33013,33CS005,1236,1170,1302,1280,-22,44,110,34.17345703134919,58,45.27683270340422,-63.296242342089485,-10.453711695362001,38.257978586888505,1.2953228080541002,1530,1450,1610,1560,-50,30,110,19.617669603481218,101,65.14195787056744,-93.4108274694289,-45.227790442586034,6.13360873516265,3.2148801701759333,153721,155046,Merrimack+Sullivan,Merrimack,33,13,New Hampshire,NH
33019,33CS005,390,371,408,405,-3,15,34,42.42773387771819,3,8.348987685243165,-20.615962905594447,33.07972492042859,84.45376331693699,0.18466827956991486,481,459,504,518,14,37,59,84.60148042858926,45,103.54348826507133,-68.84915125851003,-19.553687196245846,34.76219882733695,1.1914910573494812,43119,43460,Merrimack+Sullivan,Sullivan,33,19,New Hampshire,NH
33015,33CS006,2224,2089,2359,2461,102,237,372,90.5909300296748,183,69.937419385659,-30.497417643265507,20.092872033352563,73.68489811543141,0.7687703075209946,2760,2597,2923,2970,47,210,373,66.33527448495238,256,80.86423652789185,-67.09805859521552,-14.759113287913491,39.9043286767093,1.2132459234658124,313995,316580,Rockingham,Rockingham,33,15,New Hampshire,NH
33017,33CS007,1001,945,1058,1019,-39,18,74,16.36487933358301,26,23.796630336127404,-57.45902097730359,-7.906687425330009,42.015147987833615,1.3771091045326367,1243,1175,1312,1338,26,95,163,71.6623995303759,114,86.22645790787384,-65.57795942970905,-16.133055622951996,36.25087634819829,1.1906644584608468,131111,132210,Strafford,Strafford,33,17,New Hampshire,NH
34001,34CS001,2421,2303,2538,2830,292,409,527,180.10428880582558,286,125.83643463435203,2.53926671759837,56.56206830269912,104.12877098357518,0.6969837935915376,2988,2846,3130,3403,273,415,557,151.05479965145813,413,150.2621401258127,-54.37807808911217,-0.09023577763372471,50.03711624514092,0.9923622980237321,272735,274853,Atlantic,Atlantic,34,1,New Jersey,NJ
34003,34CS002,6316,5906,6726,8114,1388,1798,2208,226.79838337634217,1962,247.4692318930913,-72.8755819084285,-20.626973586901972,29.427055833800598,1.0905354692794988,7806,7313,8298,7617,-681,-189,304,-19.778071926332732,626,65.62133762702342,-135.28123686694954,-85.63090834007366,-37.669111905432715,-3.3355623808491957,951391,953958,Bergen,Bergen,34,3,New Jersey,NJ
34005,34CS003,3622,3423,3820,4075,255,453,652,118.32878880506986,523,136.48730054825444,-66.8017174358814,-18.60343568360441,28.266374888493054,1.1509197922680912,4479,4240,4719,4560,-159,81,320,17.37052071550511,341,73.5043693066447,-104.58252961030239,-55.350292515545355,-1.5814186452460046,4.179691313438585,459823,463918,Burlington,Burlington,34,5,New Jersey,NJ
34007,34CS004,4264,4040,4489,5018,529,754,978,173.67737799195243,700,161.2816515241116,-36.84332429796333,12.212923321481604,64.4102419351342,0.9273975620776843,5265,4995,5536,5644,108,379,649,72.30396632190657,516,98.5319503215655,-73.69946641982709,-24.967539057005002,26.8229936653981,1.3591566238059265,520828,523688,Camden,Camden,34,7,New Jersey,NJ
34009,34CS005,1129,1088,1170,1224,54,95,136,120.12589867293373,112,141.88440221694376,-68.61806158015288,-23.13152995863156,30.95911308126254,1.1688048336083545,1389,1340,1439,1434,-5,45,94,46.83616780013944,97,101.48991378588768,-106.85375293586483,-55.95297981186097,-2.992918989020536,2.1195636810047764,94725,95576,Cape May,Cape May,34,9,New Jersey,NJ
34011,34CS006,1369,1303,1435,1630,195,261,327,204.8754595202767,180,141.06859460412625,14.52959461266847,64.31745292877895,115.25667447445342,0.6859338774203552,1684,1604,1763,1922,159,238,318,155.14779681565733,239,155.5392134531658,-49.12163186831745,-0.6401535897437051,51.91117630609282,0.9983351899842542,153117,153659,Cumberland,Cumberland,34,11,New Jersey,NJ
34013,34CS007,5450,5081,5818,7733,1915,2283,2652,321.38768053753114,2055,289.2465046448344,-21.09011215127206,33.023907171004346,82.20278985019497,0.8995985265159738,6727,6286,7169,6771,-398,44,485,5.0841246873115,721,84.23340012033343,-132.47303440635181,-79.67930669961103,-26.872451202858464,16.195761801181018,852560,855955,Essex,Essex,34,13,New Jersey,NJ
34015,34CS008,2401,2271,2531,2802,271,401,531,159.87299862665435,343,136.6388697083975,-29.687601780219453,24.733447108448892,75.925296011927,0.8525470016916058,2978,2821,3135,3186,51,208,365,68.35714912329851,321,105.52129492051385,-90.04981707417804,-35.32031756168412,10.215517843481454,1.5362881165854279,301232,304204,Gloucester,Gloucester,34,15,New Jersey,NJ
34017,34CS009,3422,3114,3730,5136,1406,1714,2022,288.2314275240238,1511,254.1414316970374,-20.527502324924317,34.14478701714586,86.42471973538528,0.88121277753567,4200,3835,4564,4532,-32,332,697,47.13508765149912,635,90.01882598439485,-94.75634304034695,-43.17123626922585,6.374402811873684,1.9040783550501095,713461,705408,Hudson,Hudson,34,17,New Jersey,NJ
34019,34CS010,793,738,848,925,77,132,187,123.29417226224066,144,134.55743219566892,-62.37353970691664,-10.966517265711294,41.60353382143924,1.0831437641132486,989,922,1056,996,-60,7,74,5.7456962314025946,66,50.860780173543155,-94.6352929836551,-45.3684487688788,4.439159566112864,7.805145561273949,128421,129766,Hunterdon,Hunterdon,34,19,New Jersey,NJ
34021,34CS011,2595,2429,2760,3247,487,652,818,203.86220527867945,607,189.7171433036412,-35.65769061042256,15.522751967967812,62.823796929928065,0.9291900172795569,3209,3009,3408,3441,33,232,432,60.161353645946136,296,76.67917020703376,-68.95619487415394,-16.887339109447435,33.817070324444714,1.2690939482812178,383940,386024,Mercer,Mercer,34,21,New Jersey,NJ
34023,34CS012,5282,4913,5651,6749,1098,1467,1836,205.57507965761548,1445,202.49368520990328,-49.78967868105205,3.0065143078416465,51.94372137572568,0.9843398627255482,6552,6107,6996,6782,-214,230,675,26.738307913628958,741,86.06591650328467,-113.112145059535,-59.54674377618167,-8.222673173133842,3.204902594388533,856323,860968,Middlesex,Middlesex,34,23,New Jersey,NJ
34025,34CS013,4894,4618,5170,5879,709,985,1261,184.64529303450522,937,175.69628481424073,-42.03584809170671,8.056017509774106,61.3253910819095,0.9505687438776818,6065,5732,6398,6325,-73,260,593,40.34054820172414,647,100.30479013509365,-107.51154695308874,-58.64052067206637,-10.18335960593843,2.4769318808130785,639968,645034,Monmouth,Monmouth,34,25,New Jersey,NJ
34027,34CS014,3392,3173,3610,4288,678,896,1115,212.29509624181574,829,196.34236360837315,-35.779790710598675,16.786844941354616,64.30209480191729,0.9238252135066725,4213,3950,4477,4198,-279,-15,248,-3.0191146358035903,314,61.48520047308358,-115.413646673561,-64.9544984537833,-14.272877993273998,-21.77776332467846,506666,510692,Morris,Morris,34,27,New Jersey,NJ
34029,34CS015,6582,6308,6856,7343,487,761,1035,143.68233767353277,1136,214.5707247585843,-119.7828326166884,-71.38477844523891,-18.057503569883124,1.491408248508332,8164,7829,8498,8288,-210,124,459,19.22279807505381,891,137.60320240180135,-170.0592581911304,-120.25303686578627,-66.05603235258674,7.101281642126594,635315,647514,Ocean,Ocean,34,29,New Jersey,NJ
34031,34CS016,3297,3073,3521,4800,1279,1503,1727,347.1840224940554,1352,312.3123123123123,-13.322284211501552,35.80408963035281,86.25259948795889,0.8989602978667862,4061,3793,4329,4216,-113,155,423,29.857292633806672,514,99.06638604281827,-119.4898824902569,-69.16588378198607,-18.598447300237392,3.296715178672328,519480,518844,Passaic,Passaic,34,31,New Jersey,NJ
34033,34CS017,651,623,679,789,110,138,166,256.20957748164676,94,174.85390088512037,26.819206615876766,80.5071191473091,133.0061686414312,0.6775451891495533,802,768,835,913,78,111,145,171.31429308161455,98,150.72517264184316,-29.44409253480352,19.93491675163358,68.18509478736507,0.8719882132931729,64511,65019,Salem,Salem,34,33,New Jersey,NJ
34035,34CS018,2146,1998,2293,2624,331,478,626,167.4422830690682,525,183.7323923124034,-73.15390491903007,-17.6985312270605,34.6850137480024,1.09499927932535,2667,2489,2845,2637,-208,-30,148,-8.659642814176607,218,63.086918146170646,-123.04024790920386,-73.27927907425794,-15.616034264180744,-7.537038130780302,342890,345555,Somerset,Somerset,34,35,New Jersey,NJ
34037,34CS019,1081,1019,1143,1321,178,240,302,200.08180346953998,217,181.15790791835371,-31.56358923555808,18.12432985435264,74.78393283570901,0.9016570984178272,1347,1272,1422,1478,56,131,206,90.20509066825429,122,83.94687951558522,-45.473616886562034,5.069978010431476,57.869581979033974,0.9235773207527614,143742,145330,Sussex,Sussex,34,37,New Jersey,NJ
34039,34CS020,3498,3251,3744,5073,1329,1575,1822,330.76586792807666,1389,291.6346623228242,-13.796583758554542,39.876985300447295,85.93665733081315,0.8811358340197708,4322,4027,4618,4420,-198,98,393,17.08557942668384,480,83.85158269862343,-120.56584352508673,-65.43898289859212,-19.892603315527015,4.858068941595289,571537,572440,Union,Union,34,39,New Jersey,NJ
34041,34CS021,901,854,948,1062,114,161,208,177.15451166537986,150,164.97113005224085,-40.39588632247117,11.890293295682211,65.12358528738717,0.9254818104464166,1118,1061,1175,1190,15,72,129,65.33111909009799,106,95.87120698231809,-83.41931203053905,-30.38908770093646,21.874909491198558,1.4474279459130885,109110,110565,Warren,Warren,34,41,New Jersey,NJ
35001,35CS001,4930,4639,5221,6092,871,1162,1453,206.0285138362408,602,106.74263558560688,47.02133982196212,99.01485061384732,151.2394626227512,0.5176509172563655,6064,5715,6412,7401,989,1337,1686,198.19104464469999,797,118.12447384958324,29.958496536748736,78.45970770950237,132.92497331058195,0.5955677973900005,676768,674712,Bernalillo,Bernalillo,35,1,New Mexico,NM
35003,35CS002,37,36,39,38,-1,1,2,20.875160440046873,4,133.00083125519535,-164.68775438056198,-114.38149630887025,-62.55942875643467,2.4572734661393345,47,45,49,73,24,26,28,705.1649001206051,10,269.25148088314484,382.71535438705473,434.3551486530451,488.6273585513993,0.36778464827090157,3609,3714,Catron+Cibola+Sierra+Socorro,Catron,35,3,New Mexico,NM
35006,35CS002,220,208,232,321,89,101,113,448.1211885499678,69,306.32630410654826,89.69010455093087,142.83980278012928,193.9433444413325,0.6768734093982943,271,257,285,396,111,125,139,460.3650925759685,85,312.8680800942285,93.41052630690793,146.34314605062158,197.51966940573644,0.6742179695248648,27030,27168,Catron+Cibola+Sierra+Socorro,Cibola,35,6,New Mexico,NM
35051,35CS002,219,214,224,264,40,45,50,475.70964133692456,42,440.9448818897638,-15.843614642084052,36.242722735540404,87.93373441044601,0.906905241207596,266,260,272,278,6,12,18,106.85606545102466,29,252.04241265426734,-194.11706569710995,-144.99067236876192,-97.39961362260227,2.1812943061831995,11430,11506,Catron+Cibola+Sierra+Socorro,Sierra,35,51,New Mexico,NM
35053,35CS002,150,143,157,194,37,44,51,316.4428561059794,48,348.1203916354405,-83.2764302520625,-31.7467786128049,21.690893163355327,1.075456834007637,182,173,190,224,34,42,51,257.7142460487512,30,183.50868607780768,23.37765308933473,73.57399672052395,126.04137275743416,0.6955533860736607,16546,16348,Catron+Cibola+Sierra+Socorro,Socorro,35,53,New Mexico,NM
35005,35CS003,570,542,598,734,136,164,192,303.5100983551051,106,195.6110538699309,57.079131723756134,107.6833466040747,156.87612746022432,0.6406010799178776,696,663,730,846,116,150,183,231.5377012506145,142,219.44736354082957,-39.61499373405859,12.52433662969075,64.76984432600261,0.9414983695812785,65027,64708,Chaves,Chaves,35,5,New Mexico,NM
35009,35CS004,348,328,369,400,31,52,72,127.97141107303405,57,141.31647452584605,-64.4953638356777,-13.888877175732121,40.274046128903024,1.0832945429440544,427,402,452,560,108,133,158,277.084828513341,102,212.2921306220992,13.60737062643887,65.4954914924871,117.70853988578781,0.7604509015905004,48402,48047,Curry+Roosevelt,Curry,35,9,New Mexico,NM
35041,35CS004,145,137,154,162,8,17,25,104.91459966934481,40,252.39247029130297,-199.73959047679045,-147.6884675360586,-94.48232716286294,2.269218304273082,179,169,189,220,31,41,51,216.4871044741472,47,246.93952608627123,-80.72905596411447,-31.82965772253215,16.81136969306794,1.1136387658576832,19018,19033,Curry+Roosevelt,Roosevelt,35,41,New Mexico,NM
35013,35CS005,1391,1296,1486,1984,498,593,688,323.538805556704,329,179.52309063460595,90.37966346532342,142.79528489831776,198.11348256154253,0.5539391983063328,1732,1617,1846,2317,471,585,700,264.54774662866504,323,145.97352591594998,70.53434410520664,120.43518902208052,173.23339246861298,0.5508441653259322,219916,221273,Do�a Ana,Do�a Ana,35,13,New Mexico,NM
35015,35CS006,530,504,557,534,-23,4,30,7.028106426873449,77,150.11453544100206,-192.5358076583925,-141.91559127592157,-89.4753413139852,16.720924168705963,645,614,677,787,110,142,173,231.76453230828142,149,243.83458523573404,-65.16205807245889,-12.694720836178375,40.114309664751154,1.044702374588254,61553,61107,Eddy,Eddy,35,15,New Mexico,NM
35017,35CS007,303,291,315,374,59,71,83,304.2833523372932,23,98.60312243221034,153.8560097680304,205.29654103299129,262.51565182166456,0.31954817498679056,370,356,385,426,41,56,70,199.91203863967445,58,207.61741122565866,-60.6396791461681,-6.575813206410964,38.93394902615897,1.0202748469741914,27991,27936,Grant+Hidalgo+Luna,Grant,35,17,New Mexico,NM
35023,35CS007,45,45,46,47,1,2,2,49.27921491912333,6,173.5357917570499,-136.45717965993202,-124.26024954431321,-112.28124506279039,2.2190753630969278,55,54,55,61,6,6,7,149.74701289551285,7,171.35862913096696,-33.86905325597136,-21.56739518882784,-8.988514485244561,0.9835376208177359,4149,4085,Grant+Hidalgo+Luna,Hidalgo,35,23,New Mexico,NM
35029,35CS007,274,263,285,337,52,63,74,299.7782654099911,59,281.0416005080978,-32.850519730551866,18.817741096887598,73.16744290067868,0.9228345963122393,339,326,352,423,71,84,97,328.5455427357858,57,223.38924596331714,50.211087763183436,103.59471424513924,156.61820202991646,0.6719187871806428,25192,25516,Grant+Hidalgo+Luna,Luna,35,29,New Mexico,NM
35011,35CS008,21,21,21,28,7,7,7,500.0472636188333,7,497.9253112033195,-9.810209392107462,1.7075627711157542,14.419562491315986,0.8717493432045922,26,25,26,38,12,12,13,738.6595544340748,6,357.1428571428571,368.7024513915168,381.4367027885178,394.5098567613223,0.447444626472698,1687,1680,Guadalupe and Nearby Counties,De Baca,35,11,New Mexico,NM
35019,35CS008,42,42,42,55,13,13,13,352.29950109477426,5,135.65453312231517,204.66910490532516,216.79661158735206,228.4760923367146,0.3575215121469492,52,51,52,59,7,7,8,158.77672746039363,4,89.90784445942909,55.996287962281905,69.34539692623558,80.51135458274238,0.49603318512385547,4423,4449,Guadalupe and Nearby Counties,Guadalupe,35,19,New Mexico,NM
35027,35CS008,205,197,214,208,-6,3,11,15.685635601796061,18,106.78267747676486,-144.73692751199923,-90.83604375652756,-37.49029825477908,4.939524702128564,254,244,265,319,54,65,75,317.968307756018,40,195.92476489028212,74.84242250984178,122.78871076082763,173.87700204547906,0.6068291670479209,20228,20416,Guadalupe and Nearby Counties,Lincoln,35,27,New Mexico,NM
35037,35CS008,104,103,105,140,35,36,37,494.8166092916126,10,138.8085598611914,343.89921888533434,355.99861454568855,368.14084183012,0.27287055536124327,128,127,129,175,46,47,48,539.3292279568143,39,450.08655510675135,76.91351244443048,89.18994897940009,101.66958909116623,0.8170469068471106,8645,8665,Guadalupe and Nearby Counties,Quay,35,37,New Mexico,NM
35057,35CS008,142,136,149,151,2,9,15,69.3163124089028,10,79.2864222001982,-59.125089247801164,-11.29941372899856,41.530151882809314,1.0264284907808232,177,169,185,235,50,58,66,381.23457637061017,45,294.6954813359529,40.03890237351983,86.3390880682805,139.18229850527473,0.7599487447171455,15135,15270,Guadalupe and Nearby Counties,Torrance,35,57,New Mexico,NM
35025,35CS009,502,470,533,604,71,102,134,166.22668771160042,134,217.5442394068943,-101.85871563669399,-50.68041814606152,-3.259847100397373,1.2960622112954647,614,576,652,742,90,128,166,174.5694026617551,163,222.5711749846385,-96.0436982273564,-48.85163402939641,5.581598391777343,1.2650770992331326,73916,73235,Lea,Lea,35,25,New Mexico,NM
35028,35CS010,117,115,119,116,-3,-1,1,-7.814921167333377,5,30.915086562242372,-51.02332529651321,-38.48317428774005,-27.25892883060468,-18.944183794714306,144,141,146,140,-6,-4,-1,-19.849309602045928,10,51.69561621174525,-84.57443343209367,-71.43793535652237,-59.28415900801943,-3.521560198384042,19408,19344,Los Alamos+Santa Fe,Los Alamos,35,28,New Mexico,NM
35049,35CS010,1071,1005,1138,1215,77,144,210,111.66152064016079,87,67.61088768432708,-6.1808166377282125,43.7203622793802,95.60252119265861,0.6013135457125987,1324,1244,1404,1591,187,267,347,171.98028889754656,133,85.71354918539906,36.19806026291982,86.48069710281139,133.1329472378957,0.49653104989009744,154413,155168,Los Alamos+Santa Fe,Santa Fe,35,49,New Mexico,NM
35031,35CS011,569,562,577,1056,479,487,494,806.8450428421486,374,620.1207632680696,174.67912893006965,187.18378591214136,199.06313107331414,0.76699860287536,696,687,705,1029,324,333,342,462.82896116491736,179,248.94303515798845,201.15029584603278,214.03454347312154,226.121088402052,0.5362612418434378,72373,71904,McKinley,McKinley,35,31,New Mexico,NM
35007,35CS012,123,122,124,150,26,27,28,261.4787403404236,30,292.7543303244694,-43.57111360309068,-31.185339615628315,-20.417345350560563,1.0793294978609573,152,151,154,178,24,26,27,207.59645243285144,32,258.81591717890655,-63.8447880353369,-51.22178839450798,-38.256900734677906,1.1999748584808587,12297,12364,Northeast New Mexico,Colfax,35,7,New Mexico,NM
35021,35CS012,9,9,10,12,2,3,3,465.9494559463143,5,917.4311926605503,-464.15184518061926,-451.69508536660766,-439.05402850075353,1.412659021456095,11,11,11,14,3,3,3,408.3611294359372,2,311.52647975077883,84.43936512393445,96.83289298444372,109.48290103668835,0.552230140546995,654,642,Northeast New Mexico,Harding,35,21,New Mexico,NM
35033,35CS012,41,39,43,43,0,2,4,60.0959120404265,4,113.47517730496453,-103.07274152223506,-53.41194777127289,-0.4221823443913506,1.2827169383757828,50,48,52,56,4,6,8,148.6490398471613,8,190.74868860276584,-93.35214591451471,-39.1713079877777,9.314718589661295,1.1058367717612485,4230,4194,Northeast New Mexico,Mora,35,33,New Mexico,NM
35047,35CS012,243,232,255,264,9,21,32,90.69908229440838,10,44.19726713564877,-1.2872627889237944,46.489360711115516,97.44029428888535,0.4646532856813206,298,284,312,391,79,93,107,342.0990549922977,45,165.77638607478357,126.1297932002493,176.35421288254037,226.9552473575757,0.4794232169089106,27151,27145,Northeast New Mexico,San Miguel,35,47,New Mexico,NM
35059,35CS012,40,38,41,48,7,8,10,250.52323528960704,3,88.49557522123892,110.56219888571913,161.75883140167934,212.43977593823953,0.3160310652515289,49,47,51,55,4,6,8,154.61232882108953,6,146.3057790782736,-42.276271876844135,10.592799248220512,58.27524660778832,0.8173661308148288,4068,4101,Northeast New Mexico,Union,35,59,New Mexico,NM
35035,35CS013,542,512,571,640,69,98,128,173.92032992876014,45,79.54160467822474,46.19877577948032,94.56405514813159,144.95553539954582,0.45274372967909277,670,634,705,855,150,185,221,270.93198234424705,122,178.26353780063707,39.06647222975097,89.8816295445518,144.73723755888253,0.6544347094884844,67889,68438,Otero,Otero,35,35,New Mexico,NM
35039,35CS014,367,350,385,438,53,71,88,211.31781651410301,45,134.81799570579716,27.119769751472223,76.01744995624199,129.44952702640032,0.6290682790185181,451,430,471,604,133,153,174,381.8298867474133,70,174.16834614714736,153.73081235379988,208.67027501877533,261.767976705966,0.45318809797602394,40054,40191,Rio Arriba+Taos,Rio Arriba,35,39,New Mexico,NM
35055,35CS014,282,267,296,344,48,62,77,218.71902870147406,44,154.48986160283232,14.895477111331418,65.80036839314718,116.22187599146933,0.6951795393941221,349,331,367,425,58,76,94,220.3536207592042,36,104.07933157940386,65.86527784548544,116.34600884025996,168.7498932251288,0.46621185352822214,34177,34589,Rio Arriba+Taos,Taos,35,55,New Mexico,NM
35043,35CS015,1029,965,1093,1237,144,208,272,167.4184935295655,153,123.11818943839062,-4.175977503542151,44.74378310562954,98.29106217231006,0.7318740728365458,1288,1210,1366,1557,191,269,347,178.12496745108893,177,117.17586309622322,11.908485171944776,59.94673733385607,110.59356083699515,0.6553937228653218,149125,151055,Sandoval,Sandoval,35,43,New Mexico,NM
35045,35CS016,905,853,958,1336,378,431,483,424.38896018496644,327,322.2680310770191,51.602737268500796,99.83286194646557,155.76350609080404,0.7576101509592394,1115,1052,1177,1705,528,590,653,487.4720770049675,369,304.81508710772613,127.42433337859676,182.41390342627085,232.9345056454022,0.6242397129723433,121762,121057,San Juan,San Juan,35,45,New Mexico,NM
35061,35CS017,598,565,631,740,109,142,175,222.25318712392232,73,114.49483727617304,57.20944422123081,106.59441046541423,156.1371844950996,0.5115450536932493,743,703,783,961,178,218,258,283.0182593254748,142,184.262431225994,47.377277374416146,99.9010664981773,151.8127393972245,0.6480905318323583,76510,77064,Valencia,Valencia,35,61,New Mexico,NM
36001,36CS001,2389,2255,2524,2634,110,245,379,93.76807578196501,209,80.15314748115217,-38.004837555181354,15.94193446353501,69.47491535870046,0.8513202259734948,2939,2777,3101,3188,87,249,411,79.28152406853953,256,81.57178635839328,-54.17423093558633,-1.8123048150604328,52.1599097714719,1.0247690758888848,312901,313834,Albany+Greene,Albany,36,1,New York,NY
36039,36CS001,449,428,469,461,-8,12,33,30.504442772464206,28,70.21356626405317,-89.55216948258908,-37.93745886055353,12.316050251211767,2.1269058852817593,555,530,580,653,73,98,123,202.98880618597744,67,138.40115678578806,14.755022144888363,64.40294725755567,114.4490391792317,0.6749481727911597,47854,48410,Albany+Greene,Greene,36,39,New York,NY
36003,36CS002,418,398,438,474,36,56,76,144.8676180602978,69,178.91870867366782,-86.09702038067802,-33.20000187513682,18.724050558605406,1.2133319457151517,512,488,536,562,26,50,74,107.67084013180553,81,175.53364394842345,-117.11814848113207,-66.30754509282599,-19.770862106071323,1.598115118195162,46278,46145,Allegany+Steuben,Allegany,36,3,New York,NY
36101,36CS002,852,811,892,972,80,120,161,154.4721983119613,123,157.68219985898338,-57.14317793150931,-2.016149197628097,47.99871417914959,1.0123786892797655,1041,993,1089,1267,178,226,274,242.63574669738634,145,155.89889150512317,35.51707433376273,87.61262157251845,139.78328300713028,0.6396877783070655,93606,93009,Allegany+Steuben,Steuben,36,101,New York,NY
36005,36CS003,8329,7702,8955,14136,5181,5807,6434,478.9119266180804,4277,352.72287434367865,77.41089655064299,126.11904690142228,181.6249812160804,0.7363820475992693,10144,9405,10882,11765,883,1621,2360,113.30056623402905,1456,101.74710115101408,-37.45631114409757,9.855129256059108,63.48561329675485,0.8974746365417506,1455080,1430999,Bronx,Bronx,36,5,New York,NY
36007,36CS004,1842,1757,1927,2054,127,212,297,129.04276888891016,211,128.52074249661186,-52.787513481834594,2.7848638426460206,51.0409619961304,0.9912756412966989,2257,2155,2359,2511,152,254,356,128.54470272803488,298,150.9778093018543,-74.18766134337011,-22.580639340264646,30.491367007771178,1.1699050136603169,197011,197380,Broome,Broome,36,7,New York,NY
36009,36CS005,722,689,755,789,34,67,100,105.02277487865844,53,82.85781286641131,-29.956622926474427,22.263837768781503,72.46162906158949,0.7773789421947692,880,841,920,1157,237,277,316,361.8520786178651,161,210.46852122986823,100.14005082524609,151.2792477115372,204.35310815513165,0.5795486996158414,76758,76496,Cattaraugus+Wyoming,Cattaraugus,36,9,New York,NY
36121,36CS005,326,308,343,373,30,47,65,141.20591169747968,28,83.3106047457291,7.257125620979284,57.32393376821463,108.28237099776707,0.5778184152216582,401,380,422,428,6,27,48,67.0331428233057,54,133.40580068185187,-118.66541883195471,-65.98205485972657,-15.397284611085567,1.9194079316140849,40331,40478,Cattaraugus+Wyoming,Wyoming,36,121,New York,NY
36011,36CS006,644,611,676,759,83,115,148,181.69524764375092,29,45.71488623824286,84.18364797966487,136.817934776038,189.9018798170298,0.2494378861393142,787,748,826,940,114,153,192,201.91501100763446,111,146.22386742369355,5.603632620630535,54.874385479754324,101.32280743681372,0.7194911260666109,76124,75911,Cayuga,Cayuga,36,11,New York,NY
36013,36CS007,1279,1224,1333,1291,-42,12,67,11.563981365477781,41,38.665566426971594,-78.01142424776168,-27.783321340534332,28.908332978180646,3.09150319985633,1559,1494,1625,1880,255,321,386,252.90100191861544,286,225.37963860453755,-21.49125189681993,29.62677325247684,78.4366623700706,0.888409039204421,127245,126897,Chautauqua,Chautauqua,36,13,New York,NY
36015,36CS008,864,828,900,942,42,78,114,112.46631105970116,100,143.3263660794267,-81.83755653984872,-31.501053840929956,21.93094336440112,1.2583573418175031,1052,1009,1095,1138,43,86,129,103.51716912204537,123,147.89519881683842,-95.41771774958792,-44.642055949603545,7.498137476162742,1.4122976256525577,83725,83167,Chemung,Chemung,36,15,New York,NY
36017,36CS009,487,467,507,519,12,32,52,81.22481258846372,29,73.97801917476244,-44.92367031591448,7.853080904917913,62.74433356874731,0.8830478243669633,589,565,613,697,84,108,132,231.33247628352734,83,178.05427437520112,-1.2435633488747218,51.77926471335238,106.31113746812208,0.7626178769501355,47041,46615,Chenango+Cortland,Chenango,36,17,New York,NY
36023,36CS009,373,353,393,425,32,52,72,132.76656806854007,28,71.8255664814023,8.337853171134492,60.637213854854764,112.21262653632846,0.5307369300042463,454,430,478,556,78,102,126,219.98766892848548,54,116.45209290289189,55.69769804496174,103.32132545207146,149.83447621123935,0.5242184967310718,46780,46371,Chenango+Cortland,Cortland,36,23,New York,NY
36019,36CS010,619,585,654,676,22,57,91,85.13320533906678,10,15.0472106233307,17.868577140772484,70.18495608733507,117.17059279491613,0.1736792562833957,763,722,805,866,61,103,144,128.86227210457915,57,71.5963473302099,7.492273345309106,57.71988979178814,108.59538106777204,0.5502402099716064,79749,79613,Clinton,Clinton,36,19,New York,NY
36021,36CS011,588,561,614,579,-35,-9,18,-17.266182628678823,44,86.15203876841744,-153.79381401415068,-102.98330765421417,-53.38971077423732,-5.627842691510093,723,691,755,763,8,40,72,65.39172248524369,65,105.27168191756418,-92.94713721107235,-39.01109140599642,13.95767442427862,1.5709544900474393,61287,61745,Columbia,Columbia,36,21,New York,NY
36025,36CS012,452,433,471,476,5,24,43,65.03004793059426,23,62.39967443648119,-49.788341081133105,2.3230283586691565,52.935923931672804,0.9211225259607,557,534,580,673,93,116,139,262.26485372503157,70,157.83540022547916,50.76296120334925,106.28952166560902,156.80217870026937,0.5966868741711197,44231,44350,Delaware+Schoharie,Delaware,36,25,New York,NY
36095,36CS012,246,233,259,258,-1,12,25,48.288014980251205,2,8.018978248521499,-16.630715848159934,40.4387341958423,93.00778103515556,0.15333386144960723,304,288,319,357,38,53,69,178.93766719889746,33,110.58240064338851,15.527167315073845,66.39877090572423,120.80647121047907,0.6066334970818745,29929,29842,Delaware+Schoharie,Schoharie,36,95,New York,NY
36027,36CS013,2180,2053,2307,2497,190,317,444,128.63998157001174,264,107.16424070008559,-29.219437659103246,23.53015099720074,73.43343806146973,0.8304350244067578,2700,2547,2853,3137,284,437,590,147.15754019699241,335,112.82804332596864,-18.397949437115038,33.93788426216175,86.75709346355653,0.7649652391837027,295621,296912,Dutchess,Dutchess,36,27,New York,NY
36029,36CS014,8523,8114,8931,9465,534,942,1351,119.28504256279116,1189,150.51204476119344,-83.33988192634938,-30.626306581396513,24.306869944602248,1.2604471206397236,10445,9954,10936,10895,-41,450,941,47.35016019292407,1200,126.17527006765097,-129.2423518755488,-78.70875156631357,-24.526933301713235,2.658823217775733,947964,951058,Erie,Erie,36,29,New York,NY
36031,36CS015,366,350,382,403,21,37,53,120.25583334885245,3,9.657170449058425,58.86646473446861,110.35336457514235,162.6532174404831,0.07821161400619556,447,428,466,490,24,43,62,114.72161868399644,33,88.52406244970224,-27.399296058253743,26.506323966392245,78.6003689499474,0.754011253964874,37278,37278,Essex+Franklin,Essex,36,31,New York,NY
36033,36CS015,380,360,401,413,12,33,53,82.16494715235123,11,27.560288130285,0.038699682084198446,54.529544875957484,106.50387364479859,0.3255007541193985,465,440,489,547,58,82,107,173.35800596238127,37,77.95053301310412,41.16037049405128,96.69822789087141,145.5441363097763,0.44425174265954326,47895,47466,Essex+Franklin,Franklin,36,33,New York,NY
36035,36CS016,514,491,537,565,28,51,74,115.47682126634533,48,108.30935860551699,-43.9533374800391,6.239865138836938,56.45921947111003,0.9199554388240403,630,602,657,803,146,173,201,325.8539689032548,117,220.2477316366101,55.068457507808006,107.31628678667553,157.9435283138907,0.6720270092683805,53181,53122,Fulton+Hamilton,Fulton,36,35,New York,NY
36041,36CS016,57,56,57,64,7,7,8,168.65616671756382,2,48.10583283223091,108.62213339123045,120.23228636405442,131.76451119273833,0.24962929639834697,72,71,72,79,7,7,8,141.46508584413343,4,78.23195775474281,51.22155337032139,63.21048950056864,75.5234247025393,0.48584314774349624,4989,5113,Fulton+Hamilton,Hamilton,36,41,New York,NY
36037,36CS017,539,514,564,607,43,68,93,139.77211258810425,57,117.74224088960803,-29.908345078736016,20.397560182422836,72.21511942774707,0.8301191161024659,661,631,691,734,43,73,103,126.66466589047224,121,208.9376985771515,-135.38418158739364,-82.72409421712487,-32.141639966719985,1.627349339287744,58093,57912,Genesee+Orleans,Genesee,36,37,New York,NY
36073,36CS017,356,339,373,418,45,62,79,184.67913568097384,49,146.09421586165772,-8.470937647913063,39.02432522238081,87.402222183959,0.7785021294319522,438,417,459,488,29,50,71,124.7517146871826,52,129.35966963530524,-54.97684214584806,-4.547395796106613,43.474019535353904,1.0166636197821144,40248,40198,Genesee+Orleans,Orleans,36,73,New York,NY
36043,36CS018,559,533,585,609,24,50,76,100.21813534420421,35,69.77207787892883,-21.24518446832354,29.217765147532273,80.83564259128843,0.6826237137955949,680,649,711,834,123,154,185,256.9280232109283,139,231.87148647972376,-26.613273582679742,25.305387309091934,76.94732906995907,0.8966547818413675,60196,59947,Herkimer,Herkimer,36,43,New York,NY
36045,36CS019,814,765,864,793,-71,-21,28,-22.246606808886526,13,13.53262142491564,-88.98265536312333,-34.585100242547945,12.978413154402054,-0.638161546749036,1015,955,1075,1081,6,66,126,56.479530489141204,119,102.34622265033714,-95.55174534305226,-44.708927817313445,6.116581090319376,1.7849139754372847,115277,116272,Jefferson+Lewis,Jefferson,36,45,New York,NY
36049,36CS019,223,211,234,205,-29,-18,-6,-80.31420418033898,6,27.158537965372865,-158.09966754327823,-107.37691690423978,-58.252155497193584,-0.3583498228913751,275,261,289,304,15,29,43,108.3637329965136,40,150.55706112616681,-93.53586190422206,-41.26831416015401,3.975164186341834,1.3427290087424386,26511,26568,Jefferson+Lewis,Lewis,36,49,New York,NY
36047,36CS020,14153,12990,15315,22012,6697,7859,9022,350.0452286460812,6645,295.95516802526197,4.22669986334272,53.268545673059805,107.97201597138664,0.8453693772327548,17265,15895,18636,18747,111,1482,2852,55.82944639406066,2754,103.7818576198833,-101.08463328782481,-46.54991056602948,0.7798298123160037,1.8576550613181364,2694327,2653643,Kings,Kings,36,47,New York,NY
36051,36CS021,482,456,509,482,-27,-0,26,-0.7655079842218674,33,64.01448408528798,-114.5601756451339,-65.806575356912,-12.959429030722953,54.51173341593124,593,561,625,678,53,85,117,137.54925328995526,74,120.13767127735566,-35.249633524956884,15.132593422069542,67.55393362472176,0.8632270608810506,61861,61596,Livingston,Livingston,36,51,New York,NY
36053,36CS022,486,457,516,612,96,126,155,220.99214338931688,70,122.98502218122721,42.748643454996056,95.76850531185701,147.88263024499312,0.5521236112173189,594,559,629,716,87,122,157,179.80687635712266,71,104.88684039472906,22.76255537993673,74.83162940730242,124.37342622918727,0.5785769855742293,68301,67692,Madison,Madison,36,53,New York,NY
36055,36CS023,5834,5508,6159,6541,382,707,1033,112.25575879086422,654,103.8266909211179,-46.236000709445875,6.733877763717914,60.666218283543415,0.9236057348761404,7167,6777,7557,8105,548,938,1328,124.08465516270189,896,118.57262904367734,-44.5155598130765,4.523839448074948,56.61644478189337,0.9545604702598999,755875,755655,Monroe,Monroe,36,55,New York,NY
36057,36CS024,492,471,513,560,47,68,89,165.07438955026893,33,80.10518863153636,31.86766458960238,85.62244833738698,138.45668160981205,0.4782347371893935,601,576,627,737,110,136,161,273.59685542909307,116,234.15421881308032,-13.202593114064888,38.89493252930492,90.61866876436244,0.8495686252859121,49435,49540,Montgomery,Montgomery,36,57,New York,NY
36059,36CS025,9511,8913,10109,12307,2198,2796,3394,241.7169527787469,2755,238.1621317888094,-43.98706981384063,5.111359257985702,56.49949515912978,0.9849412033722311,11722,11003,12440,12165,-275,443,1162,31.856367600326113,1300,93.43409841485459,-112.71581302319889,-62.87155356790061,-10.900610259326386,2.9263779795719937,1388130,1391355,Nassau,Nassau,36,59,New York,NY
36061,36CS026,8712,7994,9429,12306,2877,3594,4312,258.55750155195574,2787,200.48184219817875,6.538080093901989,57.95415072146387,105.96231979520229,0.7751702402863231,10331,9508,11153,11301,148,970,1793,60.90276946993465,1124,70.55616967879995,-61.229601473596716,-10.15046096185662,42.54959414285437,1.1573122705524728,1668181,1593057,New York (county),New York (county),36,61,New York,NY
36063,36CS027,2043,1952,2134,2390,256,347,438,196.5066620855666,234,132.57978158330855,11.29668673392615,65.0588682528825,114.50152885355011,0.6727436967251688,2498,2389,2607,2968,361,470,579,222.04085839440694,372,175.68716350240862,-1.6436350008794147,45.8875394994342,98.01279050696238,0.7895586161120826,211797,211740,Niagara,Niagara,36,63,New York,NY
36065,36CS028,2204,2104,2303,2455,152,251,351,130.5311701869704,246,127.76842405959064,-46.96046267359546,3.137813847683768,52.292078798296544,0.9749552377748513,2691,2572,2810,3040,230,349,468,151.52034989759628,471,204.35523969437827,-101.9658250625658,-53.2911557213044,-0.46543022542309687,1.344847367716222,231043,230481,Oneida,Oneida,36,65,New York,NY
36067,36CS029,3786,3582,3990,4339,349,553,757,140.20991864728782,474,120.19144417796278,-32.60234652660621,20.39880879488509,72.09711042582481,0.8556774907399339,4643,4399,4888,5173,285,530,774,111.89933184314134,514,108.53315540089699,-46.209263811667924,4.0216435973572,55.14037779273875,0.9680910272200481,473245,473588,Onondaga,Onondaga,36,67,New York,NY
36069,36CS030,944,896,993,935,-58,-9,39,-10.07693320079062,74,79.2043883512465,-144.86171347244303,-90.0785225530143,-37.64166248438442,-8.794035090078056,1161,1103,1219,1194,-25,33,91,29.18715669654065,103,91.55311413917852,-111.93182434287422,-62.20136443492652,-10.755806855680003,3.0440566407780816,112115,112503,Ontario,Ontario,36,69,New York,NY
36071,36CS031,2455,2283,2627,3006,379,551,723,165.62202891663432,594,178.52670386807858,-64.43170620791757,-14.425217160375926,38.198143681621346,1.0759638924776505,3060,2851,3269,3163,-106,103,312,25.48102279426828,393,97.26326418484476,-123.94964208533445,-72.17012235824602,-19.929518347119917,3.7803688034478213,399268,404058,Orange,Orange,36,71,New York,NY
36075,36CS032,932,882,983,981,-2,49,99,49.82826164048007,48,49.10737122103433,-50.70165994932198,1.8273867941339241,53.112042275433964,0.9657047202317164,1149,1088,1210,1329,119,180,241,153.34206116494823,138,117.5648736603568,-17.392128964383815,35.545611215012464,83.53094760161018,0.7624478805798364,117294,117382,Oswego,Oswego,36,75,New York,NY
36077,36CS033,515,490,540,571,31,56,81,115.06059271037087,19,38.993022301272404,28.472899207413143,76.12080934060344,123.76574573538947,0.3329525321654718,630,600,660,735,75,105,135,179.92208279515924,85,146.15860788224774,-21.250311643572882,33.821708683822635,82.66058786656265,0.8046538416222064,58472,58156,Otsego,Otsego,36,77,New York,NY
36079,36CS034,601,559,643,777,134,176,218,216.33034290853058,116,142.31237156615174,19.368587025341622,75.11895196783601,126.69253821079946,0.6541378027082237,742,691,792,753,-39,11,62,11.289922610182579,53,54.139086377380075,-91.48677404248677,-42.51248124382173,16.41413849048751,4.397470740005732,97813,97896,Putnam,Putnam,36,79,New York,NY
36081,36CS035,12854,11833,13876,20419,6543,7565,8586,383.27628715033285,6559,332.32968990077984,1.6060719130635366,50.46273276189377,101.81095356031466,0.8669614428708055,15723,14514,16931,17202,271,1479,2688,63.196203364161924,2511,107.28151378445686,-94.74970201718192,-46.59851130734629,8.099151423464761,1.6964473815254837,2368371,2340571,Queens,Queens,36,81,New York,NY
36083,36CS036,1267,1198,1336,1393,57,126,195,94.33945084171049,78,58.29305963828409,-15.1021329627044,36.74786646043551,93.77486085190685,0.6130510334917827,1552,1470,1635,1786,151,234,316,145.7103798330105,167,104.15822070316155,-10.09551641504769,42.91231983598588,91.65849341744071,0.7117837448059123,160568,160333,Rensselaer,Rensselaer,36,83,New York,NY
36085,36CS037,3289,3077,3501,4420,919,1131,1343,275.589475007048,1125,274.1205805670844,-47.29822393879481,1.7057070535593515,52.81841224970956,0.993791329090319,4058,3803,4313,4367,54,309,564,62.53293597077682,594,120.29405212742259,-109.64786170093586,-57.28642216035729,-7.414567802392569,1.9174812615064867,492484,493790,Richmond,Richmond,36,85,New York,NY
36087,36CS038,1979,1833,2124,2791,667,812,958,289.7280779536745,819,292.0480209200048,-55.27009946902425,-3.173498012073797,49.92131712285523,1.0067682031709724,2464,2289,2639,2477,-162,13,188,3.933728919751694,273,80.51529790660226,-127.46031039928675,-76.826442459201445,-27.952918373388155,19.040395721229597,336520,339066,Rockland,Rockland,36,87,New York,NY
36089,36CS039,855,809,902,939,37,84,130,92.77377867049815,47,52.12376621936342,-12.615063764324042,40.04713135110465,91.02485628996929,0.5552004095567548,1054,998,1110,1261,151,207,263,191.53072815146666,139,128.59772964871541,10.489269957102163,60.75757797096804,114.23122335528707,0.6681932599209106,108204,108089,St. Lawrence,St. Lawrence,36,89,New York,NY
36091,36CS040,1671,1570,1772,1689,-83,18,119,9.1415232412320009,64,32.6836326495872,-73.2605245081654,-23.616064912682756,27.43434702246767,3.386131215085904,2074,1952,2196,2364,168,290,412,122.2795492769418,252,106.27754465132952,-34.56915920390506,16.608439236839068,70.24216617578413,0.8661485832177477,234980,237115,Saratoga,Saratoga,36,91,New York,NY
36093,36CS041,1341,1274,1409,1453,44,112,179,85.06510567291063,88,67.0276171555155,-35.29270779485631,17.902980902643378,72.27153860534415,0.7809638751777772,1648,1566,1729,1851,122,203,285,128.6846023555168,188,118.94518398542289,-44.48472364588115,11.196183277271905,61.02852943062305,0.9197933581912755,157547,158056,Schenectady,Schenectady,36,93,New York,NY
36097,36CS042,176,169,184,192,8,16,23,105.93792260956837,11,73.99103139013452,-19.19761447232609,31.18049832528764,82.74066998308886,0.6567384597016344,215,206,224,259,35,44,53,245.9904767412542,17,95.68300782349299,95.80106736791039,148.8698533071697,199.64625524420788,0.3802695744211763,17840,17767,Schuyler+Seneca+Yates,Schuyler,36,97,New York,NY
36099,36CS042,310,295,324,324,-0,14,29,50.20344660923991,30,106.56878126757644,-106.22363277399728,-56.09698882718899,-4.32113469432844,1.982463316834648,380,363,397,410,13,30,47,89.06625332586033,52,154.3393090347857,-118.33282910305738,-64.81345445466013,-14.789135181951567,1.6769756557213886,33781,33692,Schuyler+Seneca+Yates,Seneca,36,99,New York,NY
36123,36CS042,231,221,242,256,14,25,35,119.4898759381202,16,77.64791523435919,-11.202790387060894,41.801249439968245,91.20605083811957,0.6244661622699695,283,270,296,279,-17,-4,9,-16.777286027396368,25,101.51459779916352,-170.98845012570015,-116.26097101496713,-71.42531169405983,-7.98277705003333,24727,24627,Schuyler+Seneca+Yates,Yates,36,123,New York,NY
36103,36CS043,10827,10173,11481,13547,2066,2720,3374,215.05769164838935,2804,221.71017561939226,-55.91836669966632,-7.423521355196523,43.77273542549287,1.030554586273682,13397,12609,14185,14328,143,931,1719,61.003948256912096,1770,115.98822293591749,-104.78377758083134,-55.28744079755304,-1.775132757173754,1.8992830152576938,1517657,1526017,Suffolk,Suffolk,36,103,New York,NY
36105,36CS044,648,614,681,739,58,91,125,140.01364635747822,63,96.53569649994253,-9.95279701727805,42.08145433018995,96.20735864230767,0.6820095549298898,807,766,848,876,28,69,110,86.90843872699193,81,101.7127932091014,-65.61686206989957,-15.233576450798537,34.40886568583632,1.1536751689209201,78313,79636,Sullivan,Sullivan,36,105,New York,NY
36107,36CS045,403,382,423,492,69,89,110,221.96890842626473,57,141.62663574623159,26.924047675144053,80.59418227817565,130.8275716281634,0.6309840627396948,492,467,517,559,42,67,92,139.19638622407226,59,122.8271052357656,-34.925755186635214,15.866444571861681,66.20596339674405,0.8693988447854868,48296,48035,Tioga,Tioga,36,107,New York,NY
36109,36CS046,612,567,657,584,-73,-28,17,-31.89141110870133,22,25.172104731211505,-111.14064118299635,-55.62786064813222,-3.6367281821852755,-0.8186789252032499,758,704,813,759,-54,1,55,0.6053374947623409,54,51.33226232687244,-101.3779340008344,-50.49583016607639,-1.2388993130296242,32.99126514463329,104878,105197,Tompkins,Tompkins,36,109,New York,NY
36111,36CS047,1504,1426,1582,1664,82,160,238,105.76740505437027,149,98.6368475928306,-40.359700772532996,7.2270441556344815,56.78966855464901,0.9267819801344294,1858,1764,1953,2042,89,184,278,100.5160602972245,209,114.35324757751674,-65.2159100803821,-15.143867583774718,35.98808853682045,1.131502286634244,181271,182767,Ulster,Ulster,36,111,New York,NY
36113,36CS048,632,604,660,671,11,39,67,71.22158412639634,37,67.89613726029911,-44.63175600498229,4.134216940886421,56.57104969977076,0.929363307997121,776,742,810,883,73,107,141,162.80257062599676,71,108.19707105956934,-0.8328326956164405,53.768765099797285,110.3052219893399,0.658427513601754,65394,65621,Warren,Warren,36,113,New York,NY
36115,36CS049,552,526,578,627,49,75,101,147.4302619502421,16,31.41001521422612,66.90558067190781,116.53988994708679,164.64717352537107,0.2102503708866507,678,647,710,781,71,103,134,168.80564874877723,91,149.22191430398635,-30.06380316802127,20.225044337852456,70.73531432597204,0.8754819462750524,61127,60983,Washington,Washington,36,115,New York,NY
36117,36CS050,768,729,807,832,25,64,103,84.90118864393445,50,66.00877916762929,-31.74921976642699,18.032529815082917,71.61833642769788,0.7655733559680684,943,896,990,1040,50,97,144,106.67473229986277,106,116.54883506140804,-63.77076457403151,-9.320193840664501,39.1053930301824,1.081416344639411,90897,90949,Wayne,Wayne,36,117,New York,NY
36119,36CS051,6302,5872,6732,8319,1587,2017,2447,242.58482121525068,1925,231.55202001571746,-39.08154172874639,9.90150829850047,61.01211082625281,0.9540467522251423,7779,7263,8294,8016,-278,237,753,23.749419266716817,930,93.12338848974892,-121.70667255463148,-71.48682619498328,-14.782319741293625,3.904617944782218,997616,998675,Westchester,Westchester,36,119,New York,NY
37001,37CS001,1520,1446,1594,1726,132,206,280,144.2798196689306,149,104.15635103253429,-10.623396754672706,40.97755541732329,91.53429438623155,0.7184244255100696,1880,1791,1970,1995,25,115,204,66.11777527150115,173,99.66586012213389,-88.18036305004146,-33.24565688863515,16.32764878661586,1.4943779301781586,171665,173580,Alamance,Alamance,37,1,North Carolina,NC
37003,37CS002,335,319,351,440,89,105,121,343.96122706954844,44,144.2780631763034,141.75184887046947,200.1389603834585,252.12808338993892,0.4154992205568789,410,391,429,614,185,204,223,556.1039358739837,97,264.93322044082703,239.2645251386233,291.52817251683643,338.0909410393547,0.47408111999262886,36596,36613,Alexander+Catawba,Alexander,37,3,North Carolina,NC
37035,37CS002,1454,1385,1524,1706,182,252,321,187.93216116426322,174,129.97441595548003,7.236849418836215,56.91105715470537,110.87762200135599,0.6888647868830207,1787,1704,1871,2319,448,532,615,329.0531399635451,320,198.04308674906085,81.80326972131947,131.42040274385505,182.01412919471178,0.6007276079417515,160647,161581,Alexander+Catawba,Catawba,37,35,North Carolina,NC
37005,37CS003,121,120,123,129,6,8,9,82.92957938201992,4,43.839620056626174,26.3579890413243,38.94265663461132,50.40251993542591,0.46692790293362707,150,149,152,170,18,20,21,178.99450606140056,14,126.96109549288111,39.593716742305254,51.471751785628676,64.45577870436911,0.6750981870620572,10949,11027,Alleghany+Ashe+Avery+Watauga,Alleghany,37,5,North Carolina,NC
37009,37CS003,289,277,300,343,43,54,66,243.7693969078212,34,152.93500262388483,40.67821379032645,89.51143689171892,139.5688819011342,0.6160089892084951,355,341,368,440,72,85,99,319.67316946385284,57,213.56313225927315,52.117527655221984,105.05861797427771,158.31833012414694,0.6603277601278951,26678,26690,Alleghany+Ashe+Avery+Watauga,Ashe,37,9,North Carolina,NC
37011,37CS003,187,180,195,187,-8,-0,7,-1.26658104618364,19,128.3711502730702,-180.67166298077726,-130.50164674691098,-73.68949607471401,23.383595131083183,231,221,240,247,7,16,26,92.05582189112381,32,179.23154475187633,-135.29018931526954,-86.84130204595974,-35.34001763996923,1.835320537687513,17761,17854,Alleghany+Ashe+Avery+Watauga,Avery,37,11,North Carolina,NC
37189,37CS003,308,284,331,361,30,53,77,117.54289584214335,24,52.931446425289465,12.49553817150106,65.01694959029473,117.2951881598603,0.4420222604950799,384,356,412,457,45,73,101,134.74239101301288,39,71.94244604316548,10.808300164098263,63.98000392269364,114.87124045301451,0.526714911656142,54410,54210,Alleghany+Ashe+Avery+Watauga,Watauga,37,189,North Carolina,NC
37007,37CS004,239,229,248,286,38,47,57,253.9812706253853,34,183.34606569900686,18.928285640954243,70.61963976656904,121.38741139902223,0.7068796628912632,290,278,301,417,116,127,139,577.74460225919,73,330.97569822270583,196.84817719481688,246.94900259914334,298.17886953840673,0.5684147519887552,22253,22056,Anson+Richmond,Anson,37,7,North Carolina,NC
37153,37CS004,460,442,479,575,96,115,133,319.81390701630056,57,158.56089758449627,113.12822664781164,161.3984290024829,217.05219030806794,0.4915158782833984,557,535,579,726,147,169,191,395.76663335284576,104,243.2919269188481,98.77876850588902,154.36883856937132,205.04707708739662,0.6111235195456216,43138,42747,Anson+Richmond,Richmond,37,153,North Carolina,NC
37013,37CS005,489,470,508,571,63,82,101,219.31873496125706,65,173.47211102215104,-4.746208712450414,44.089595642843825,97.98897153799298,0.7814497769781741,593,570,615,685,70,92,115,207.87267368424503,80,179.81568891885817,-24.14033335498895,27.731136600930498,80.98308619642343,0.8557746642729909,44964,44490,Beaufort+Martin+Pamlico,Beaufort,37,13,North Carolina,NC
37117,37CS005,254,244,263,341,78,87,97,475.23058029060735,30,163.6214889555495,260.7173394554085,312.25350495101236,361.88577220788517,0.34039259583137466,307,296,318,384,66,77,88,353.30039368558926,54,247.91111927279402,52.95888860972184,107.3301269656348,152.80933811398333,0.6926994071388121,22002,21782,Beaufort+Martin+Pamlico,Martin,37,117,North Carolina,NC
37137,37CS005,149,144,154,152,-2,3,8,28.160555675389322,1,9.723685276719875,-33.39563762528666,18.23413345883283,71.00122820514326,0.25666834103953484,182,176,188,207,19,25,31,203.13575639380608,21,170.24726388325902,-19.612700601612563,30.95571973188831,82.31831265873109,0.805931794596755,12341,12335,Beaufort+Martin+Pamlico,Pamlico,37,137,North Carolina,NC
37017,37CS006,320,307,333,421,88,101,114,404.4330672730861,27,107.75933747962883,245.4865700332508,296.6338460945045,347.9621825130124,0.2638417352763946,387,372,402,575,173,188,203,636.6882393740285,87,294.5557963163597,291.9227505450958,341.9177285720945,392.7402397621583,0.46019026669460217,30067,29536,Bladen+Columbus,Bladen,37,17,North Carolina,NC
37047,37CS006,549,528,571,753,182,204,225,477.22702223635054,85,199.28491882070216,231.11751925917952,278.5772116295983,330.6800885784422,0.4155478333372791,663,637,689,908,219,245,271,488.6510821749778,154,307.0665177859308,130.42316252402955,183.07888137178466,234.88217881484303,0.6258425233972087,51183,50152,Bladen+Columbus,Columbus,37,47,North Carolina,NC
37019,37CS007,1325,1265,1385,1530,145,205,265,176.5552780895359,84,72.29019349101392,54.344219958305175,103.22427047463422,157.3430279034521,0.4074618082168046,1669,1595,1743,2039,296,370,444,258.0732391975669,203,141.64009461279227,65.14670614392588,114.44586453815235,164.87304667817025,0.5473569643954505,139438,143321,Brunswick,Brunswick,37,19,North Carolina,NC
37021,37CS008,2394,2279,2510,2542,32,148,263,65.89821903530834,158,70.55776358683516,-57.0783163370416,-3.6070454367705986,44.253197160765566,1.0635012426439068,2968,2828,3108,3154,46,186,326,68.42393998676475,264,97.32539492359588,-81.96762917432703,-28.465707523076183,21.033815578414586,1.4147655339535299,268716,271255,Buncombe+Madison,Buncombe,37,21,North Carolina,NC
37115,37CS008,221,212,231,239,8,18,27,99.02599663134023,14,78.86583419397239,-30.89779299362786,18.24697054932233,71.93913334048509,0.7535484798951508,274,263,285,296,11,22,33,103.91572008188265,40,186.40197586094413,-135.7669976776347,-82.54169962060075,-31.87501459562097,1.7167916631529474,21302,21459,Buncombe+Madison,Madison,37,115,North Carolina,NC
37023,37CS009,859,821,897,1016,119,157,195,214.24596405035533,85,115.94598281271314,47.14001445164622,100.25166533757627,150.70739825838024,0.5377578233582695,1049,1003,1094,1317,223,268,314,306.44592843878996,178,203.19170795187327,51.386143017355714,103.85949106657563,153.08405559876215,0.6605981639462121,87972,87602,Burke,Burke,37,23,North Carolina,NC
37025,37CS010,1467,1369,1564,1580,16,113,211,60.14317479857485,127,67.45153580596619,-59.81099534158032,-6.922986440324624,39.05700456516709,1.1116988206303298,1835,1716,1954,1971,17,136,255,59.0762022562075,272,117.92043838657095,-110.26532518870941,-58.85370000952915,-6.04961509920171,1.981531959357995,225940,230664,Cabarrus,Cabarrus,37,25,North Carolina,NC
37027,37CS011,820,785,855,976,121,156,191,231.83719746348544,108,160.4675350403645,17.54591062457231,70.46333830267125,124.16367630879847,0.6877484412461039,1002,961,1044,1322,278,320,361,397.2726470384214,173,214.98695165900338,131.80834426571283,182.2785415623081,233.79320384298595,0.539469693499285,80764,80470,Caldwell,Caldwell,37,27,North Carolina,NC
37029,37CS012,77,76,78,95,17,18,19,207.90320493037316,6,68.5844922842446,127.55108126903087,139.55273818670236,150.89575109527073,0.31269436922399335,97,95,98,105,7,8,10,76.37551115657035,10,92.8418902608857,-29.070464960253172,-16.55315713219669,-4.048301658374122,1.0838456130819,10498,10771,Camden+Currituck+Pasquotank,Camden,37,29,North Carolina,NC
37053,37CS012,207,194,219,262,43,55,68,233.0355059352554,13,54.834967837182326,128.92714513566327,178.86608956646245,227.02022815089936,0.23112387913543175,262,247,277,317,40,55,70,187.15421885377376,27,91.62481335686168,48.86040609010598,94.83080474588543,144.38494967335026,0.4808496702420497,28449,29468,Camden+Currituck+Pasquotank,Currituck,37,53,North Carolina,NC
37139,37CS012,371,354,389,442,53,71,88,209.69075012004987,41,121.28682361641809,39.61138263047496,85.90260221930257,139.28975178110483,0.5703616917584386,455,434,476,537,61,82,103,201.1812652984113,56,137.27172447603874,12.625051765048788,63.29369183061082,118.00041735580268,0.6741148559503743,40565,40795,Camden+Currituck+Pasquotank,Pasquotank,37,139,North Carolina,NC
37031,37CS013,710,681,739,754,15,44,73,77.38263419710412,31,54.69060115555948,-24.40504770829129,23.80829874318586,75.06497537762466,0.6910016397807164,878,842,913,1064,151,186,222,272.15637907353283,79,115.47681693270185,106.70639994621924,157.58532142442465,206.80802570480736,0.42203645269955253,68019,68412,Carteret,Carteret,37,31,North Carolina,NC
37033,37CS014,238,229,248,279,31,41,50,215.08727160358296,16,84.65235218905691,81.39905323349743,131.04389270216993,180.99758902808867,0.3841233491335967,293,281,305,362,57,69,81,303.79058915448263,44,193.73871692131564,57.9022836724897,108.77486309712242,158.0463386875703,0.6286263821659053,22681,22711,Caswell+Person,Caswell,37,33,North Carolina,NC
37145,37CS014,385,368,402,449,47,64,81,195.80646567872157,26,79.56545023334098,64.01333366860534,116.2033166270522,165.43686793554355,0.40009443569205355,473,453,493,537,44,64,84,163.77028802192743,76,194.2243802708919,-77.83448976387308,-29.824016263039777,19.279690706426848,1.1677340269863965,39213,39130,Caswell+Person,Person,37,145,North Carolina,NC
37037,37CS015,647,614,680,727,47,80,113,126.1712562838987,51,80.07955616036847,-9.87282523430642,44.73359814373236,95.50508442397651,0.6268878279923465,806,766,846,833,-13,27,67,34.483188577143665,55,70.78233787627248,-90.19691533212577,-34.54391976221318,17.93970257505946,1.978810749138533,76424,77703,Chatham,Chatham,37,37,North Carolina,NC
37039,37CS016,346,334,358,351,-7,5,17,21.033416621410577,28,116.46447140381282,-148.67936416700002,-95.20744057598668,-43.350041269534934,4.6229154619742365,430,415,445,545,100,115,130,393.9203955952931,94,322.8243698056185,17.70690974364898,71.60665401115642,123.30249674661127,0.8124337573370493,28850,29118,Cherokee+Clay+Graham+Swain,Cherokee,37,39,North Carolina,NC
37043,37CS016,136,134,137,111,-26,-25,-23,-263.50772753015696,5,53.75862377923126,-329.6849511914674,-316.8162582040841,-304.66320371049943,-0.21268980039707722,169,167,170,191,21,22,24,198.14988409254082,42,372.307419555004,-185.7246954292928,-173.97893600074144,-162.5872990666171,1.79846192264617,11161,11281,Cherokee+Clay+Graham+Swain,Clay,37,43,North Carolina,NC
37075,37CS016,86,85,87,113,26,27,28,397.105705750367,10,148.4230055658627,237.2534822561513,248.71781754042385,260.1611594987064,0.36029548218099355,106,105,107,130,23,24,25,301.43631061822225,15,186.59037193680805,102.8982993593953,114.92563227476398,127.71659108744079,0.5944722401754746,8085,8039,Cherokee+Clay+Graham+Swain,Graham,37,75,North Carolina,NC
37173,37CS016,173,167,179,211,32,38,44,323.2759811318382,10,84.9737997450786,186.58475301109794,239.57980740031334,286.4859578390872,0.25612001958723035,213,206,221,249,28,36,43,251.80656245108707,30,212.34428086070213,-12.661811182655624,40.05667051635367,90.213174503926,0.820227215588441,14122,14128,Cherokee+Clay+Graham+Swain,Swain,37,173,North Carolina,NC
37045,37CS017,1069,1026,1112,1263,151,194,237,234.11557499458405,162,195.31014527699074,-11.015961030630985,38.917190007015876,94.90311272351367,0.8299726116529224,1314,1262,1366,1480,114,166,218,165.67077578969528,218,217.419489961802,-103.0217930732597,-52.5156794781763,1.6650835817251535,1.3045056200567826,99534,100267,Cleveland,Cleveland,37,45,North Carolina,NC
37049,37CS018,928,885,971,1121,150,193,236,230.00826361370505,102,121.45266918039293,56.75744518474011,108.39684087763565,157.95588130887597,0.5253166395972,1137,1085,1189,1292,103,155,207,154.20428430923965,108,107.29613733905579,-3.072183453934048,47.96157904218278,96.66494697817802,0.6913510379046237,100780,100656,Craven,Craven,37,49,North Carolina,NC
37051,37CS019,2225,2081,2369,2594,225,369,513,132.3437066682845,148,53.046119658425994,28.711177116228942,76.5916895655537,129.8341677670779,0.39973827925143446,2754,2581,2927,3572,645,818,991,243.84853423884135,444,132.40214467618134,59.00696560913704,112.86644445345482,164.78541034376113,0.5423056075132945,334803,335342,Cumberland,Cumberland,37,51,North Carolina,NC
37055,37CS020,314,298,330,324,-6,10,26,32.298751493851405,5,16.173814594172036,-32.33788528105572,17.993327067930093,68.70427193071681,0.455170699028797,394,375,414,414,0,20,39,52.914392624146814,26,68.95454304354745,-64.98570248302897,-16.804551597388283,34.43674080904858,1.2409375237770754,37097,37706,Dare+Hyde+Tyrrell+Washington,Dare,37,55,North Carolina,NC
37095,37CS020,49,49,50,49,-1,-0,-0,-12.31752924083718,4,104.32514670723756,-129.31629641379433,-116.93240002212717,-104.87230122425493,7.579699598205576,60,59,60,51,-9,-9,-8,-191.4301762815078,4,88.61320336730172,-293.5621323242148,-280.38397194018944,-268.10715206954035,-0.5234808542935142,4601,4514,Dare+Hyde+Tyrrell+Washington,Hyde,37,95,North Carolina,NC
37177,37CS020,36,35,38,39,1,3,4,104.8273920188613,2,72.31093702922567,-16.64331232556831,31.84046217611425,79.007535037311,0.512905872072702,44,42,46,49,3,5,7,158.44170169816226,5,153.79883112888342,-48.59550186563507,3.9352488524345723,57.799627151014846,0.8128839211264061,3319,3251,Dare+Hyde+Tyrrell+Washington,Tyrrell,37,177,North Carolina,NC
37187,37CS020,134,129,139,167,28,33,38,356.45994569353644,12,130.34033309196235,179.13813747177258,225.58582753741894,275.4070199956099,0.35483978850290054,163,157,168,215,47,52,58,479.20029610438945,33,302.72452068617554,125.85601294227884,176.8850081893229,227.6455523681289,0.6198623707825094,11048,10901,Dare+Hyde+Tyrrell+Washington,Washington,37,187,North Carolina,NC
37057,37CS021,1583,1510,1655,1849,194,266,339,188.97469184196322,137,97.18724506083069,40.946527294451755,93.56474502791536,141.16413558178309,0.5123637211348728,1951,1863,2039,2384,345,433,521,254.15912084415095,349,204.79177546840984,0.7550585484872058,49.57798275143368,100.89822264292559,0.8039060176945607,169158,170417,Davidson,Davidson,37,57,North Carolina,NC
37059,37CS022,411,393,429,438,9,27,45,75.6237947641285,34,95.18032939859096,-70.71855497742924,-20.065015808643412,36.54795109292819,1.2136754138620014,508,486,531,579,48,71,93,162.39148239932766,84,193.42805167292238,-81.54006549679312,-32.03713119091456,21.014528755135153,1.1744679220261298,42866,43427,Davie+Yadkin,Davie,37,59,North Carolina,NC
37197,37CS022,373,357,389,433,44,60,76,193.2793083693525,40,128.8728991032594,14.441704265780013,65.28243403453627,114.77827175989232,0.6558379514041877,455,436,474,507,33,52,71,139.55521494599208,66,177.46228926353152,-90.52879305411422,-37.9839553085633,11.028978497941733,1.2475903550636926,37246,37191,Davie+Yadkin,Yadkin,37,197,North Carolina,NC
37061,37CS023,390,369,411,596,185,206,227,492.93459582489845,74,177.12177121771217,265.6552535251498,316.19604945749836,366.3119466498203,0.3575847187339354,469,444,494,752,258,283,308,583.219963898361,107,220.44583625200872,308.94279802527114,362.8828449719787,413.0398758172767,0.3766500801388275,50135,48538,Duplin,Duplin,37,61,North Carolina,NC
37063,37CS024,1829,1689,1969,2037,68,208,348,76.68348763911806,138,50.911080845935565,-24.031406491902956,26.40133714251344,75.9330212997224,0.6607331532816131,2270,2102,2439,2269,-170,-1,167,-0.38984295700302596,133,40.79128967949701,-93.95494360281944,-40.37964828185839,9.60356382853912,-490.62471266391395,325273,326050,Durham,Durham,37,63,North Carolina,NC
37065,37CS025,546,525,567,680,113,134,155,328.9321329354308,85,207.9086832450061,67.803490150258,120.77330117653442,170.442058282581,0.6274061934099139,663,638,688,703,15,40,65,82.77367591674988,61,126.01222938357296,-95.14117671150075,-43.39941490420298,7.5779385212951995,1.48530228723367,49060,48408,Edgecombe,Edgecombe,37,65,North Carolina,NC
37067,37CS026,2987,2822,3152,3325,173,338,503,105.86836869140005,244,76.46226242642335,-25.546506015918908,25.950837743479752,82.96451804035695,0.7201074631157874,3693,3494,3892,4133,241,440,639,114.1986071379386,409,106.20176777905877,-39.003492996477306,6.361700731534296,62.48923470298315,0.9278645270171394,382934,385116,Forsyth+Stokes,Forsyth,37,67,North Carolina,NC
37169,37CS026,469,450,488,554,66,85,104,227.55461300669882,35,93.99337570495031,82.30018493204642,134.74029899185487,184.88448487681362,0.40824061569140063,573,550,596,671,75,98,121,220.9288030317497,76,170.60249618389153,-0.8761483396893335,49.446623710389844,100.5775151753207,0.7644386120894917,44684,44548,Forsyth+Stokes,Stokes,37,169,North Carolina,NC
37069,37CS027,544,515,574,593,19,49,78,84.01343798110128,43,74.30875576036865,-35.48150171998963,10.62780898369253,61.71506265746351,0.8666598281798025,688,651,725,758,33,70,107,98.5932272084931,73,102.35845088196528,-53.948951936195385,-4.062993772078492,47.373729238122216,1.0236316187162484,69440,71318,Franklin+Warren,Franklin,37,69,North Carolina,NC
37185,37CS027,205,197,214,262,48,57,65,361.2789479860219,14,89.48069241011984,224.02075087231572,270.5530562789034,326.29294044120354,0.2433720149316342,251,242,261,302,41,51,60,270.02772418501826,29,154.7657167253709,66.57943075328528,115.47542119208943,167.7911897745654,0.562039521722283,18775,18738,Franklin+Warren,Warren,37,185,North Carolina,NC
37071,37CS028,2085,1987,2183,2346,163,261,359,137.23759519462664,226,118.94163000907852,-32.65587102527536,18.928511296932317,69.59423377551242,0.8633730784899635,2580,2461,2699,3062,363,482,601,209.1562684473627,452,196.11331184185977,-39.87343740349315,11.674508816641021,59.52333932399069,0.9356990976074354,228011,230479,Gaston,Gaston,37,71,North Carolina,NC
37015,37CS029,200,192,207,261,54,61,69,408.5776336353209,38,253.65745118762865,103.92758126458283,153.02630113126398,203.69634175700241,0.610850626494591,242,233,251,313,62,71,80,406.7873102113772,28,159.49871831387068,197.97677638223448,247.45254366218646,296.2984238637044,0.38667884577599726,17977,17555,Gates and Nearby Counties,Bertie,37,15,North Carolina,NC
37041,37CS029,167,161,173,194,21,27,33,235.85540621183765,22,192.58826962357747,-8.253553763847659,45.49770323072641,91.2565096970674,0.7873297391007912,206,199,213,237,24,31,38,227.5865801196859,21,153.12819017062856,23.00492973307989,74.85418203625089,127.07744683117082,0.6519466712079738,13708,13714,Gates and Nearby Counties,Chowan,37,41,North Carolina,NC
37073,37CS029,105,104,106,126,20,21,22,233.82989974893667,18,203.75436279596263,17.469130629413815,30.557698711006203,41.85400894454441,0.8311429998557465,127,126,128,164,36,37,38,355.7203932220417,19,183.06195201849889,159.92631578209432,172.79378087660845,184.26689711398464,0.5010519504936881,10601,10379,Gates and Nearby Counties,Gates,37,73,North Carolina,NC
37091,37CS029,215,206,224,315,91,100,109,551.8209932008112,47,259.28650239058476,240.75023265469767,292.6836477429909,342.8281307439044,0.4652233101989579,262,251,273,304,31,42,53,196.79340369888723,30,140.8252358822701,6.402929078794841,57.23347691951714,115.751393188919,0.6989276317704686,21752,21303,Gates and Nearby Counties,Hertford,37,91,North Carolina,NC
37143,37CS029,151,145,156,182,26,31,37,285.53178805843413,15,137.44654856444714,92.16069775914416,151.18577516127175,197.74086938242752,0.4664028886281645,186,180,193,196,3,10,16,72.67502782641031,26,198.30676531157044,-177.09902722803525,-125.40957782730092,-75.19642299840918,2.4695056658625623,13096,13111,Gates and Nearby Counties,Perquimans,37,143,North Carolina,NC
37077,37CS030,483,457,510,594,84,111,137,217.28634393217166,48,94.36435124508519,73.56437971229934,123.29667584870302,170.4338260643752,0.4303916768653306,601,569,633,706,73,105,137,169.46407489079948,67,108.33009959901693,6.414951070658255,62.761973830744886,109.5795061145787,0.6332096275691165,61040,61848,Granville+Vance,Granville,37,77,North Carolina,NC
37181,37CS030,430,411,448,566,118,136,155,381.94661531890193,71,199.0421679710314,131.29029672323273,182.15742539590366,236.04145062459304,0.5173285365833544,520,498,542,629,87,109,131,257.9153487876409,60,142.06227062862555,65.42181413968218,115.6790129780559,168.98020156429774,0.5457991552984934,42805,42235,Granville+Vance,Vance,37,181,North Carolina,NC
37079,37CS031,173,164,182,206,24,33,42,193.01270455815998,26,152.12091662603606,-8.877688243696758,40.76812317854363,91.47800892063782,0.7649513847839676,212,202,223,266,43,54,64,261.99510244282936,21,102.8353165858675,105.4040848693984,156.95233190896377,210.3200540511998,0.3853068207407287,20510,20421,Greene+Jones+Lenoir,Greene,37,79,North Carolina,NC
37103,37CS031,98,97,99,135,36,37,38,483.269514832989,17,221.9079734580659,250.10254609860448,261.79735853717864,273.48681421994246,0.44710401688938556,121,120,122,169,47,48,49,521.1942814081069,16,173.14143490964182,335.7784299869629,348.03835961079983,360.1195477147395,0.32544426901398255,9193,9241,Greene+Jones+Lenoir,Jones,37,103,North Carolina,NC
37107,37CS031,607,584,631,733,102,126,149,273.4305888972913,78,169.80515946446064,52.10456844250539,104.89102286436903,157.80538777358865,0.6161120845152929,740,711,768,944,176,204,233,373.30823872910867,111,202.74713231533573,119.03233953065818,170.62284399230083,220.9211150160898,0.5404647556186672,55122,54748,Greene+Jones+Lenoir,Lenoir,37,107,North Carolina,NC
37081,37CS032,3938,3705,4171,4378,207,440,673,97.59008446110461,346,76.75371706494673,-34.7735566209649,20.635001021499686,73.1272002565413,0.7847072237548032,4862,4583,5142,5761,619,899,1178,165.7000899113104,547,100.87504956155314,14.525374777153905,66.18158038350163,113.27181004135414,0.608104111748992,540951,542255,Guilford,Guilford,37,81,North Carolina,NC
37083,37CS033,541,520,562,696,134,155,176,381.1875185408949,53,130.59011950227915,198.16258510163746,252.9593026438593,301.96015524216466,0.3403873704872972,659,634,683,863,180,204,229,423.32135065440616,92,190.45647448504295,181.8893113812748,234.33013886430751,286.0811001459089,0.44772042031070236,48702,48305,Halifax+Northampton,Halifax,37,83,North Carolina,NC
37131,37CS033,202,194,209,305,96,103,111,701.2112265537572,43,291.42663503896983,360.72529074310256,410.9446046208954,460.2509617553981,0.41162617461588147,241,232,250,323,73,82,91,477.75104381429156,45,262.02398975195064,165.11750192926922,214.34510770495103,267.9210115866015,0.5418490212182628,17706,17174,Halifax+Northampton,Northampton,37,131,North Carolina,NC
37085,37CS034,878,820,935,1068,133,190,248,170.00440202829472,97,86.64453409953701,30.910161796882786,82.91708758838939,133.69660216281474,0.5069966545066311,1094,1024,1164,1426,262,332,402,244.73121968934677,187,137.86087110377164,50.366121822645674,105.71253339720175,161.2895032272002,0.5616236005023393,134342,135644,Harnett,Harnett,37,85,North Carolina,NC
37087,37CS035,696,669,722,806,84,110,137,212.65719122189734,72,138.85763877728132,23.2052845460237,72.84555772422925,119.99610667903217,0.6470962127455097,853,821,886,959,73,106,138,169.32746683991877,107,171.40294108224137,-55.72401216713266,-1.6573742353184142,49.60863480457275,1.0027706041082534,62222,62426,Haywood,Haywood,37,87,North Carolina,NC
37089,37CS036,1215,1165,1265,1298,33,83,133,85.04366976816836,98,100.81180938338491,-65.7079736685034,-16.749558195632517,33.87035756687902,1.1712448385463714,1485,1425,1545,1646,101,161,221,137.81008198682184,149,127.59034081178285,-39.54758700642448,10.670614852434094,56.977178812891324,0.9201244660104487,116653,116780,Henderson,Henderson,37,89,North Carolina,NC
37093,37CS037,297,274,319,410,91,113,136,257.8831528432838,40,91.00388662432458,116.50750977265623,167.629190582162,214.74146960242754,0.34980204018597977,373,346,400,499,99,126,153,237.64299940840107,77,145.326891136947,45.98480994007165,91.51112756512285,142.4187400127167,0.6067159509442489,52745,52984,Hoke+Scotland,Hoke,37,93,North Carolina,NC
37165,37CS037,337,322,352,484,132,147,162,515.8108193919849,56,196.38212688857067,262.13588504997597,318.2836849942699,372.9116586310552,0.37815415960341103,414,396,432,550,118,136,154,397.5552487515914,78,228.00350774627304,121.27963622066218,170.43675863991936,218.36391005064854,0.5693278949837306,34219,34210,Hoke+Scotland,Scotland,37,165,North Carolina,NC
37097,37CS038,1422,1341,1503,1614,111,192,273,123.1592899244079,134,85.87862701010995,-17.856417623024516,36.477075937049676,87.96506869673503,0.6936874432605152,1779,1681,1878,2032,154,253,351,132.05146504463212,302,157.83834635586797,-78.32389999062103,-26.424020808294237,22.816963378510227,1.1905669067037101,187241,191335,Iredell,Iredell,37,97,North Carolina,NC
37099,37CS039,339,320,357,381,24,42,61,117.67534876589758,31,86.00957203301657,-19.140390484152544,31.353905575558763,82.82221905446384,0.7140695588662576,417,395,439,464,25,47,69,108.24844444745216,50,115.28706479133041,-60.01034130629056,-6.931477326268219,46.52946775756253,1.0428104916718577,43251,43370,Jackson+Macon+Transylvania,Jackson,37,99,North Carolina,NC
37113,37CS039,422,406,438,463,25,41,57,132.9867154111287,16,52.01842319154701,29.518237438204704,81.2388442440008,133.14307215928932,0.38182059357089504,521,502,541,630,89,109,128,290.10970126394926,90,240.070420656726,-2.696603907602797,51.19393270800688,103.2743292789645,0.8199766284465911,36910,37489,Jackson+Macon+Transylvania,Macon,37,113,North Carolina,NC
37175,37CS039,353,339,368,369,1,16,30,56.36180118219391,14,50.58869583546628,-46.70317414135798,5.227930968640001,56.117442666176245,0.8434924571289167,431,414,448,513,65,82,99,246.48852803084895,47,141.814012431356,55.02816652532807,102.83974838181436,156.46741298699774,0.5683795144842243,33209,33142,Jackson+Macon+Transylvania,Transylvania,37,175,North Carolina,NC
37101,37CS040,1416,1322,1509,1536,27,120,214,66.47685940752473,121,66.79025009544749,-54.960612174341286,-0.3394224162324268,47.78915802541514,0.9964404153129877,1801,1685,1917,2110,193,309,425,137.22548305997978,249,110.56494691550441,-29.13713423653685,26.31173108030225,78.29140462399803,0.8031185677523682,217397,225207,Johnston,Johnston,37,101,North Carolina,NC
37105,37CS041,533,506,560,646,86,113,140,214.58421873507078,46,87.30033212082871,73.00426369775398,127.44858554984101,177.67888980945543,0.40326822153308656,659,626,692,784,92,125,158,194.66193411825822,85,132.7544199412757,10.0088816790438,62.46828280317403,112.52332906505261,0.6765461336060186,63230,64028,Lee,Lee,37,105,North Carolina,NC
37109,37CS042,733,695,770,850,80,117,155,161.29056922605122,74,101.64137078497356,8.940791867281614,60.43020966140763,112.04356362594868,0.6248543470584712,915,869,962,1057,95,142,188,158.48067720931812,174,194.83137009002553,-85.4295303480911,-35.413814521381305,13.497679605050386,1.2207448907689755,87366,89308,Lincoln,Lincoln,37,109,North Carolina,NC
37111,37CS043,448,429,467,541,74,93,112,250.00701324839372,64,171.66998234123875,27.306242786644916,79.77027398542158,129.85892103330045,0.6793716386313058,551,528,574,685,111,134,157,300.5474970760321,110,246.13456848134973,0.7086481406474573,56.56284731660208,103.40265504262767,0.8129018945687759,44737,44691,McDowell+Mitchell+Yancey,McDowell,37,111,North Carolina,NC
37121,37CS043,200,194,206,214,8,14,20,112.2470111221946,26,209.45220193340495,-149.0045188651492,-96.07306202626106,-47.291531712161195,1.741040846026774,245,238,253,271,18,26,33,171.67421665667757,36,240.78656946023676,-121.51314476076976,-70.05065128064551,-21.07871567707903,1.3499825110268635,14896,14951,McDowell+Mitchell+Yancey,Mitchell,37,121,North Carolina,NC
37199,37CS043,207,199,215,234,19,27,35,177.22372867758307,19,123.61743656473651,0.8461421563080984,54.254261407896344,106.90817969233063,0.6728215175629393,257,247,266,306,40,49,59,262.96785990398934,50,267.1511006625347,-56.60691551853153,-4.264748762113423,47.240870088895726,0.995677472168039,18444,18716,McDowell+Mitchell+Yancey,Yancey,37,199,North Carolina,NC
37119,37CS044,5557,5076,6038,6552,514,995,1476,106.78199393403017,611,65.58063278333972,-12.04512119236491,39.960680576990775,92.66732582200875,0.6135377075891422,6926,6347,7505,7967,462,1041,1620,92.77636312953504,847,75.51025138584045,-33.79287626065519,18.28208685665972,70.50049505961242,0.8131140253022098,1118013,1121702,Mecklenburg,Mecklenburg,37,119,North Carolina,NC
37123,37CS045,252,241,263,314,51,62,73,288.40798089721795,38,175.75640778570053,58.69581132625422,113.73221804660248,161.5904963704601,0.5997833626390144,308,294,321,403,82,95,109,369.1860213748135,65,252.06499398921937,64.54234650097642,116.95591776083539,170.25005012912365,0.6756616333485155,25945,25787,Montgomery+Moore,Montgomery,37,123,North Carolina,NC
37125,37CS045,1005,962,1048,1118,70,113,156,134.68982658672996,97,115.72417084228107,-30.83398297047843,18.307416054565508,66.85099112313627,0.8516465686623146,1254,1201,1307,1386,79,132,185,128.96141879023762,149,145.52913024368806,-68.63642666680272,-16.080381859823007,36.40679198456646,1.119987924697669,100584,102385,Montgomery+Moore,Moore,37,125,North Carolina,NC
37127,37CS046,934,893,975,1058,83,124,165,156.99603720688683,115,145.3702728326135,-38.995749324843906,12.031578316091526,60.69706793264955,0.9185527398126314,1147,1098,1196,1240,44,93,142,97.86095032911477,133,139.77341992979802,-90.67727864279267,-44.38105996697537,13.293271932742428,1.413110561989005,94930,95154,Nash,Nash,37,127,North Carolina,NC
37129,37CS047,1684,1586,1781,1952,171,268,366,141.46881313924268,88,46.40412012339277,46.91854574118286,96.27823558034888,142.96865392458753,0.32679847856120847,2084,1966,2202,2373,171,289,407,126.5257230735709,205,89.68139045527523,-11.579792811321482,36.88391682633158,88.65571519456401,0.7063573949649592,227566,228587,New Hanover,New Hanover,37,129,North Carolina,NC
37133,37CS048,1081,993,1169,1205,36,124,212,72.76164030910977,79,46.334084388639354,-25.749915724280314,26.15718893865933,78.90958295110258,0.6317008109609671,1353,1247,1459,1649,190,296,402,143.69892106734042,220,106.82100683654444,-12.195337911395313,37.616108466737636,91.32044467223855,0.740863464856988,204601,205952,Onslow,Onslow,37,133,North Carolina,NC
37135,37CS049,717,653,781,754,-27,37,101,30.146134699366847,52,41.9597347929583,-62.352272124676716,-11.784391580861142,42.514547636655394,1.355592782138838,892,816,969,929,-40,37,113,24.543329273313734,51,34.2578473980829,-60.87309723282391,-10.17966213947376,41.69223323063589,1.3586268911434332,148714,148871,Orange,Orange,37,135,North Carolina,NC
37141,37CS050,509,482,535,579,44,70,97,138.2261041720932,31,60.824068018312616,27.66797536178976,76.47900121216618,130.31108767420454,0.4338744676920924,639,606,671,770,99,131,164,210.34790652550333,88,140.82929249283853,18.090706936771443,69.59835201260717,119.06629306298804,0.6644513438517076,61160,62487,Pender,Pender,37,141,North Carolina,NC
37147,37CS051,1074,1000,1148,1393,245,319,393,222.03909612670878,126,87.75646420383643,79.12088890163561,133.39068416664625,189.41780858738625,0.39399392669677313,1330,1241,1419,1667,248,337,426,196.01547262030894,180,104.69011725293132,46.03994965402371,91.03493356014675,143.08105508353722,0.5325110368832972,172295,171936,Pitt,Pitt,37,147,North Carolina,NC
37149,37CS052,244,236,253,275,22,31,39,188.37275301594823,17,104.08694321138833,35.34483616510793,85.74845340758314,134.61115957092431,0.5351637210887936,299,289,309,358,49,59,69,300.3475655614173,53,270.2013764975784,-23.695637203773952,31.429009779606265,78.26069387772668,0.8846134429260748,19599,19615,Polk+Rutherford,Polk,37,149,North Carolina,NC
37161,37CS052,713,685,741,889,148,176,204,326.0145995623576,115,212.90053842237614,63.246008230693306,114.56223860570302,162.7588685897552,0.6493524725903592,869,836,903,1122,219,253,286,391.24024537505863,210,325.26873393017564,18.06186117856621,65.58009338508734,114.67617000362144,0.8281001112410877,64819,64562,Polk+Rutherford,Rutherford,37,161,North Carolina,NC
37151,37CS053,1345,1283,1407,1564,157,219,281,181.97433276847195,137,113.93010346572046,15.307213707283541,67.87845970621794,119.18519601866463,0.623229769572301,1658,1583,1733,2047,314,389,464,268.35137141446114,294,202.68872802481903,9.10386850091314,65.17808324847002,117.77661845896608,0.7533754598554975,144299,145050,Randolph,Randolph,37,151,North Carolina,NC
37155,37CS054,1083,1032,1133,1529,396,446,497,452.1590053552693,194,196.6033561071184,205.20891411175506,257.1127864694533,308.42944469440465,0.4338378625531949,1317,1257,1377,1932,555,615,675,528.7976061995229,300,257.8803950727653,221.49479180013313,271.363332137409,322.7643851749819,0.4868816876522251,118411,116333,Robeson,Robeson,37,155,North Carolina,NC
37157,37CS055,998,958,1037,1204,167,206,246,271.78453757069434,104,136.98479776082542,83.50065509538535,134.22093399314096,183.62790701875028,0.5015889619817909,1222,1175,1269,1518,249,296,343,324.2785768319962,167,183.03576321529172,91.97010617141693,142.59017923159718,188.7410543784988,0.5625385742212751,91105,91239,Rockingham,Rockingham,37,157,North Carolina,NC
37159,37CS056,1449,1386,1512,1687,175,238,301,195.38513500540455,157,128.70259044704338,22.313985583726488,67.74463756067992,116.28652426666008,0.6559601344989182,1785,1709,1862,2150,288,365,441,246.31124475756144,349,235.83311934912763,-43.95167379816263,11.476470162813747,59.31696611976364,0.9548402721116214,146384,147986,Rowan,Rowan,37,159,North Carolina,NC
37163,37CS057,557,531,582,647,65,90,116,181.69086774164532,57,114.66505733252866,17.30491926904559,66.82054100786483,118.40618722624754,0.6241887575150964,677,646,707,889,182,212,243,359.97660966575694,118,200.01695058903297,109.44685271499766,160.75832050592214,209.69643626654548,0.5530346111443999,59652,58995,Sampson,Sampson,37,163,North Carolina,NC
37167,37CS058,623,596,650,718,68,95,122,181.93657982832576,74,141.6290530949457,-11.266962982309662,39.71876525075775,91.05747875035306,0.7703490820933444,768,735,800,922,122,154,187,243.77524329999923,138,217.98881622595016,-24.183085547314516,25.018257985559053,79.46321701248446,0.8884633677370921,62699,63306,Stanly,Stanly,37,167,North Carolina,NC
37171,37CS059,805,775,836,919,83,114,144,191.0447770342877,85,143.02941918837814,-6.146930127357216,47.38872657208564,96.13942284174445,0.7421329957455755,985,948,1021,1087,66,102,139,143.83136243397954,169,237.46961372546264,-144.30050281211763,-95.92567885401866,-43.04656087108789,1.6350545525304925,71314,71167,Surry,Surry,37,171,North Carolina,NC
37179,37CS060,1303,1199,1406,1448,42,145,249,72.77792431495024,117,58.53682942184457,-35.65485888731543,14.417148795861909,65.84790218391501,0.7988296408827523,1637,1511,1762,1997,235,360,486,148.26428492681828,292,120.15867529175513,-23.851562832724863,28.138436537928495,78.90880503764798,0.8081926285564192,239849,243012,Union,Union,37,179,North Carolina,NC
37183,37CS061,5162,4674,5650,5693,43,531,1019,56.278736504648705,449,47.586243442318896,-46.24954789233754,10.406645249380892,60.6134712589038,0.8439563784766014,6523,5930,7115,6958,-157,435,1028,37.93103289985853,525,45.74063231850117,-58.50726896222687,-8.206404245509475,44.06031048195246,1.2031259489797583,1132260,1147776,Wake,Wake,37,183,North Carolina,NC
37191,37CS062,1041,990,1091,1316,225,275,326,279.77561880329597,149,151.32152438663158,80.27518748354684,128.86351480258173,181.6366424739283,0.5389112075235891,1273,1213,1334,1508,174,235,295,200.76091016392795,191,163.39869281045753,-14.428172307434865,36.43382254535387,88.62186292566518,0.8104434571858341,118159,116892,Wayne,Wayne,37,191,North Carolina,NC
37193,37CS063,688,660,717,827,110,139,167,251.2997792041392,77,139.5390981304177,58.92534923105659,113.0947520102715,159.95203353880964,0.5512939400594747,839,805,873,1055,182,216,250,328.7442504194598,157,238.54744359188632,34.486678921432485,91.2494395316772,140.4882329636406,0.7222939482665043,66218,65815,Wilkes,Wilkes,37,193,North Carolina,NC
37195,37CS064,741,707,775,942,167,201,235,304.88241006507997,110,166.6729800371226,85.77893042166944,138.94426906814775,190.4245069470252,0.5439760941843007,904,864,945,1183,238,279,319,355.09114094405373,136,173.396402024658,131.5311476812728,181.701963728771,230.06580723953658,0.4865681527369943,79197,78433,Wilson,Wilson,37,195,North Carolina,NC
38005,38CS001,51,50,51,91,40,40,41,799.8143538041494,15,296.68699522004283,491.760673609349,503.30261047073276,515.3930145003369,0.3619928659653064,60,59,60,101,41,41,42,709.411652187093,4,68.61063464837049,628.3526551705916,640.6808716571531,652.916928949805,0.094431605879706,6067,5830,Benson and Nearby Counties,Benson,38,5,North Dakota,ND
38027,38CS001,39,38,40,32,-8,-7,-6,-366.460129097701,4,206.89655172413794,-628.5110827969236,-572.5155892203865,-521.2135544537952,-0.6573654031660368,48,47,49,49,0,1,2,52.63346478783025,5,214.04109589041096,-213.8270095725918,-161.06728825825266,-110.2723483587659,2.2426374619171328,2320,2336,Benson and Nearby Counties,Eddy,38,27,North Dakota,ND
38031,38CS001,37,37,38,52,14,15,15,520.0521986701044,21,749.7768521273431,-241.24580729034867,-229.60018754156005,-218.10220272374966,1.3491119183651745,46,46,46,45,-1,-1,-1,-27.646823958139898,3,89.07363420427554,-130.17723633952542,-116.99923617800249,-104.04595819326482,43.5698401967957,3361,3368,Benson and Nearby Counties,Foster,38,31,North Dakota,ND
38039,38CS001,33,33,33,30,-3,-3,-3,-152.9062169347168,5,262.81208935611033,-428.74050816902627,-415.771254390619,-404.66299006427846,-2.6191163959200936,40,40,41,24,-17,-16,-16,-711.4586139489768,1,43.802014892685065,-768.0511380341416,-754.7383483719043,-742.4558976622379,-0.06560560466952264,2283,2283,Benson and Nearby Counties,Griggs,38,39,North Dakota,ND
38069,38CS001,43,43,43,53,10,10,10,299.91734995274436,21,634.6008562075044,-346.9989163459536,-334.513218832591,-322.9219700652396,1.9222381491468865,53,52,53,58,5,5,6,137.62134920479497,4,101.1378002528445,23.299396566450486,36.685756920373834,49.210963049260464,0.6208360948922182,3971,3955,Benson and Nearby Counties,Pierce,38,69,North Dakota,ND
38071,38CS001,115,114,117,150,33,35,36,359.1311192563962,20,207.8461938165757,139.2579779441551,151.05442432177622,162.69850317405763,0.5624709491593837,142,140,143,126,-17,-16,-14,-136.2627949839583,16,138.2886776145203,-287.5901424739262,-274.6440465947394,-262.8330886411418,-1.0835993234695123,11547,11570,Benson and Nearby Counties,Ramsey,38,71,North Dakota,ND
38079,38CS001,110,105,115,159,44,49,54,472.1240223968708,21,202.27965965644563,221.05449847299425,270.1844957738016,320.79398412302294,0.4198795595763386,133,126,139,194,55,61,68,509.3452191428967,13,107.74968918358888,351.86218280793804,400.22529073262274,455.5008556738123,0.208158197933727,12458,12065,Benson and Nearby Counties,Rolette,38,79,North Dakota,ND
38095,38CS001,23,23,23,35,12,12,12,667.3416661765651,4,224.08963585434174,431.2039699178854,443.43922266589686,454.7514644371699,0.30978817383338364,28,28,29,30,1,2,2,81.88851217884844,4,186.9158878504673,-117.7808960721945,-105.17425350072837,-91.68549510819086,1.453269663126672,2142,2140,Benson and Nearby Counties,Towner,38,95,North Dakota,ND
38103,38CS001,55,54,55,60,5,5,6,166.14119806770805,8,244.52368823229747,-91.55406293859406,-78.50631547878756,-66.28167937745954,1.2430880040112655,66,66,67,57,-10,-9,-9,-242.711662822034,3,76.68711656441718,-331.5862409751121,-319.40172483479864,-307.5170950437034,-0.3531538893843711,3926,3912,Benson and Nearby Counties,Wells,38,103,North Dakota,ND
38017,38CS002,1012,933,1092,1197,105,185,264,119.98672381062016,153,99.42543363243996,-30.263547274468795,18.81211799374821,75.87364238208241,0.8241732933786355,1267,1171,1363,1289,-74,22,118,11.888590022504712,104,55.81944556262244,-97.19836557446062,-43.59201592758867,5.065537636939177,4.492396650981788,184661,186315,Cass,Cass,38,17,North Dakota,ND
38003,38CS003,111,110,112,151,39,40,41,444.9431561285026,26,289.66669761396344,143.11205612341314,155.26696629063778,167.10021246035663,0.6351167359809307,136,135,138,158,20,22,23,200.43050297799715,12,111.00832562442183,78.11277189635146,88.92421351636307,101.69146399533133,0.52941478458307345,10771,10810,LaMoure and Nearby Counties,Barnes,38,3,North Dakota,ND
38021,38CS003,58,58,59,82,23,24,24,573.9841304375916,35,850.7190601579906,-288.44985649062517,-277.05220853967415,-265.54731492399065,1.4219166401024774,71,70,72,66,-6,-5,-4,-100.20541168897999,5,101.9160211985324,-214.22554783530646,-201.8907029024952,-189.6583100933254,-1.276787806993428,4937,4906,LaMoure and Nearby Counties,Dickey,38,21,North Dakota,ND
38045,38CS003,36,36,37,50,13,14,14,401.86262471132846,14,412.16879293424927,-21.780835178663235,-10.46199584938664,1.2194627095741124,0.9556357163537148,44,44,45,36,-9,-8,-8,-206.81780309263448,2,49.164208456243855,-268.7006083364619,-255.90822338130312,-244.1942926025024,-0.2697836305541657,4076,4068,LaMoure and Nearby Counties,LaMoure,38,45,North Dakota,ND
38073,38CS003,72,71,72,73,1,1,2,27.01679309907781,5,106.59086871558003,-90.49721258137272,-79.43704557170945,-67.3376144459383,2.2052537878754053,88,88,89,67,-22,-21,-21,-377.182332528977,4,70.43493572812115,-460.7410241946472,-447.6219578975005,-434.74469574242903,-0.19588461445155514,5629,5679,LaMoure and Nearby Counties,Ransom,38,73,North Dakota,ND
38077,38CS003,128,126,129,136,7,8,10,61.399024419550045,20,145.63990533406152,-97.53500291206473,-83.92456165599305,-72.51439196008306,2.120526253095397,157,155,159,121,-38,-36,-34,-217.69105400251897,3,18.12141347025068,-248.91569093264945,-235.51099512342503,-222.28989669509772,-0.08561948295439319,16479,16555,LaMoure and Nearby Counties,Richland,38,77,North Dakota,ND
38081,38CS003,30,30,31,38,7,8,8,242.58648864648748,5,155.60165975103735,74.94702785676027,87.224425226912345,99.47462666427812,0.5684975603158801,37,36,37,46,9,9,10,241.09112293067957,4,104.41138084051163,123.83098419067268,136.83711720281033,149.2776476605174,0.3907699772080494,3856,3831,LaMoure and Nearby Counties,Sargent,38,81,North Dakota,ND
38093,38CS003,211,201,220,244,24,33,43,186.72864379709026,65,364.2817111899869,-230.55256274997032,-178.82122789812425,-125.54690214023324,1.8940158641937446,260,249,271,248,-23,-12,-1,-56.26114751370744,15,69.54425332653345,-177.5223501721623,-125.620790476808,-74.16184887935509,-1.3471077305365238,21412,21569,LaMoure and Nearby Counties,Stutsman,38,93,North Dakota,ND
38009,38CS004,70,69,71,68,-3,-2,-1,-35.39795011299934,21,395.8529688972667,-443.6932377456899,-431.5193518068794,-418.76180579709967,-23.9217756979279,87,86,87,64,-23,-23,-22,-352.62791456491107,4,62.61740763932373,-428.89503667835623,-415.32474945046476,-402.1577290670754,-0.1858229089129397,6366,6388,McHenry and Nearby Counties,Bottineau,38,9,North Dakota,ND
38049,38CS004,51,50,51,80,29,29,30,650.4843703900694,11,245.49005021387393,391.97176974663466,405.08494216280144,416.8552320978887,0.36487730233653853,62,61,62,75,13,13,14,256.30166299590604,4,76.04562737642586,167.98906125969884,180.32595666388988,194.06469917945824,0.27621510094169094,5377,5260,McHenry and Nearby Counties,McHenry,38,49,North Dakota,ND
38055,38CS004,96,95,97,114,17,18,19,220.99321881245234,22,271.9126583582243,-62.408712037867325,-50.51684425511879,-39.68151629444679,1.1652423249020294,120,119,121,113,-8,-7,-6,-69.20139286005251,10,102.15548064153641,-184.38424235417907,-171.25670706841908,-158.57466956288476,-1.7318643310952295,9709,9789,McHenry and Nearby Counties,McLean,38,55,North Dakota,ND
38075,38CS004,24,23,24,30,6,6,7,336.73016099388167,12,631.8560772268539,-307.66115660342416,-294.8978556037562,-282.38249930455976,1.6227033564200923,29,29,29,31,2,2,2,88.32597813702138,4,176.444640494045,-101.16854289061109,-87.90263799404019,-75.6803629488571,1.332289739959044,2279,2267,McHenry and Nearby Counties,Renville,38,75,North Dakota,ND
38083,38CS004,10,10,10,18,8,8,8,757.7170306715312,3,284.8101265822785,461.07134533090937,473.1159608120106,484.4789534557189,0.3340278865586239,12,12,13,19,6,7,7,516.8619946664987,3,236.77979479084453,267.4868032049771,280.0637547037002,293.2999119597073,0.3974225045604708,1264,1267,McHenry and Nearby Counties,Sheridan,38,83,North Dakota,ND
38101,38CS004,412,382,442,638,196,226,256,390.4411960544515,159,274.2876858054685,62.70823771588316,116.0042617719252,168.3482839501185,0.6994168104291576,509,473,545,569,24,60,96,86.4312231593412,50,72.27104532839962,-39.36924012951573,13.66837543931735,70.1423694174945,0.8224147166361399,69562,69184,McHenry and Nearby Counties,Ward,38,101,North Dakota,ND
38019,38CS005,39,39,39,40,1,1,1,28.763620404480132,4,129.87012987012986,-112.92697332160003,-101.36265618409256,-88.95876148149159,2.120981294302734,48,47,48,57,9,9,10,254.14567337626636,3,81.81074447777475,160.75420137252698,172.47270843079835,184.3930841586315,0.2907111439586667,3696,3667,Northeast North Dakota,Cavalier,38,19,North Dakota,ND
38035,38CS005,456,425,488,486,-2,30,61,48.91430731094537,66,109.19619467806424,-110.80954043606795,-60.366887563901216,-8.139446650100282,2.159359234138025,568,530,605,536,-69,-32,6,-43.40496501370352,37,50.85421334029716,-142.63741524005914,-92.79453395070712,-42.98719326423733,-1.2099351874353486,72530,72757,Northeast North Dakota,Grand Forks,38,35,North Dakota,ND
38063,38CS005,47,47,47,52,5,5,5,203.2386075610249,11,443.54838709677415,-252.58147825311357,-240.1994720208837,-228.87990912906668,1.8210963346150588,59,58,59,42,-17,-17,-16,-552.5651908100109,6,197.04433497536945,-762.0437189008098,-749.3716136331825,-736.3583116597263,-0.37913230372728557,2976,3045,Northeast North Dakota,Nelson,38,63,North Dakota,ND
38067,38CS005,67,67,68,77,9,10,10,169.388955853953,10,176.21145374449335,-19.58468554933999,-6.6729360775843585,5.574518805743153,0.9422563411656563,82,82,83,84,1,2,2,23.011979743536557,5,73.78984651711924,-62.88843834041969,-51.131927327778506,-39.378692148633,1.9536655033707966,6810,6776,Northeast North Dakota,Pembina,38,67,North Dakota,ND
38091,38CS005,15,14,15,13,-2,-2,-1,-111.12187019886525,5,330.9431880860452,-454.04392998493216,-442.248365091574,-430.3530439280962,-7.365220997279223,18,18,18,26,8,8,8,440.2797965496556,1,55.309734513274336,372.65404557885745,384.8517771443542,397.73004076050853,0.1116039202737943,1813,1808,Northeast North Dakota,Steele,38,91,North Dakota,ND
38097,38CS005,81,80,81,87,6,6,7,97.31470584379639,14,210.36814425244174,-125.43224570142205,-112.89027651351778,-100.95729754658734,1.8725856167028025,99,98,100,95,-5,-4,-3,-51.84509489598686,2,25.003125390673837,-89.52278415238882,-76.8414611204025,-64.63720073895259,-0.6355078965243693,7986,7999,Northeast North Dakota,Traill,38,97,North Dakota,ND
38099,38CS005,121,120,122,128,6,7,8,80.76398815087528,22,250.87902689347143,-181.590199706167,-169.8837309683864,-158.06622725670516,2.7219877762309808,148,146,149,121,-28,-27,-25,-255.87752803976812,11,105.00190912562047,-373.66392411908953,-360.7883492323931,-349.2486142070557,-0.4262619220340031,10523,10476,Northeast North Dakota,Walsh,38,99,North Dakota,ND
38007,38CS006,8,8,8,4,-4,-4,-4,-506.2013694741079,4,513.9186295503212,-1032.2600583955336,-1020.1443974325235,-1007.976356330983,-1.3605747647161832,10,10,10,3,-7,-7,-7,-721.3722660942085,3,315.1260504201681,-1049.2322158673837,-1036.753886516295,-1024.7531262406073,-0.5112941491748497,934,952,Northwest North Dakota,Billings,38,7,North Dakota,ND
38013,38CS006,16,15,16,19,3,3,4,183.96931644345017,3,165.36518144235185,5.5111705423218815,18.644086590014766,31.342402126167656,0.6916410542140661,19,19,19,21,2,2,2,92.64498770137342,5,231.16042533518262,-150.86443824106163,-138.62840182736247,-125.69136137164497,1.6644966712443852,2177,2163,Northwest North Dakota,Burke,38,13,North Dakota,ND
38023,38CS006,22,22,23,18,-5,-4,-4,-244.15824283251948,3,163.3393829401089,-419.67874904834645,-407.3840005536795,-395.72118141268083,-0.8609870264521523,27,27,28,30,2,3,3,125.73221664992815,4,182.7318410232983,-69.72499559011254,-56.93950626151777,-44.284335598905734,1.0660190323973922,2204,2189,Northwest North Dakota,Divide,38,23,North Dakota,ND
38025,38CS006,27,27,28,34,6,7,7,191.39910143276907,4,115.91403042743298,64.23821112688877,75.30713582357929,87.24365613786061,0.5259791633667731,33,32,33,42,9,9,10,230.20083832784613,5,123.60939431396785,94.27724244110685,106.2937010121397,118.49338400924665,0.48488967823737983,4141,4045,Northwest North Dakota,Dunn,38,25,North Dakota,ND
38033,38CS006,10,10,10,12,2,2,2,134.1235046728107,1,69.00517538815411,52.99196099021458,65.16847853102328,76.83674520871165,0.33971163189483466,12,12,13,19,6,7,7,370.12344737499103,3,170.06802721088434,186.75075381244721,200.23273939508616,211.82614533099908,0.3984604756082775,1739,1764,Northwest North Dakota,Golden Valley,38,33,North Dakota,ND
38053,38CS006,66,65,68,90,22,24,25,194.26279386434692,11,89.85092914028998,91.81404887916246,104.0299164312555,115.86592717781508,0.4438594011896568,77,75,79,94,15,17,19,121.92766651947129,17,121.82886627490326,-12.95924499453591,0.27425761623597267,13.465909359260465,0.9437216278054624,14691,13954,Northwest North Dakota,McKenzie,38,53,North Dakota,ND
38061,38CS006,77,76,78,108,30,31,32,383.01822082566684,18,219.20032474122183,151.84812964174682,163.28403682159367,176.18139174689068,0.5546622827889881,91,90,92,96,4,5,6,51.255177055103616,16,166.5972511453561,-127.92272584770345,-115.9503628768012,-103.61046525096467,2.701540308228942,9854,9604,Northwest North Dakota,Mountrail,38,61,North Dakota,ND
38089,38CS006,213,199,228,258,30,45,59,160.48757236485207,45,161.7395992452152,-52.61320030569397,-0.793413989460648,49.50195390839973,0.9857254939878282,259,242,277,266,-11,7,24,19.856874109593008,28,84.44672316554573,-112.23772295630759,-63.664412354079545,-9.585278396450956,3.692010506469338,33387,33157,Northwest North Dakota,Stark,38,89,North Dakota,ND
38105,38CS006,224,207,242,193,-49,-31,-14,-92.68952542292321,31,92.08604599351438,-233.6214009545877,-185.36354591078012,-132.29855715851915,-1.0263827949177933,265,245,285,233,-52,-32,-12,-83.15707686815549,30,77.17438839297199,-212.72879323834502,-160.9435740806665,-108.504496525134,-0.9576816292660636,40397,38873,Northwest North Dakota,Williams,38,105,North Dakota,ND
38015,38CS007,662,620,704,871,167,209,251,255.76536681823848,161,196.88369391311437,6.294109743549749,57.920978676075556,112.72492320066854,0.7661194482024689,825,774,876,888,12,63,114,64.12064687948863,87,87.99878622363829,-74.80114770872864,-24.245021836630688,26.594321297643475,1.3510811028667087,98129,98865,South Central North Dakota,Burleigh,38,15,North Dakota,ND
38029,38CS007,39,39,39,52,13,13,13,479.5844556456967,11,403.1765424557116,64.6881389640475,76.3435432288995,88.90996323227543,0.7809913762107981,48,47,48,45,-3,-3,-2,-82.32973350829394,7,213.87106630003055,-308.65614756922304,-296.10140990504743,-283.46830754823793,-4.130641138048266,3274,3273,South Central North Dakota,Emmons,38,29,North Dakota,ND
38043,38CS007,18,18,19,24,5,6,6,278.0748683000767,3,150.18773466833542,115.93434484959035,128.15201268003923,139.8910250317167,0.4576976393880564,22,22,23,35,12,13,13,528.2959331618371,6,253.05778152678195,262.76504159280523,274.9933871215525,288.03285738723486,0.44359351460452007,2397,2371,South Central North Dakota,Kidder,38,43,North Dakota,ND
38047,38CS007,22,22,22,25,3,3,3,180.86319624312384,4,255.31914893617022,-86.96976999230091,-74.87716420951644,-61.92991425464898,1.0434265229349964,27,27,27,25,-2,-2,-2,-118.4585085362889,2,106.21348911311736,-236.88203047618765,-224.44554395906107,-211.07044975694862,-1.6252581819529923,1880,1883,South Central North Dakota,Logan,38,47,North Dakota,ND
38051,38CS007,39,39,40,51,11,12,12,554.9957747098257,4,191.54030327214684,351.59741528033845,363.61256952521603,374.74595143747763,0.31770838815736224,48,48,49,43,-6,-5,-5,-212.92939772358582,3,119.3792280143255,-345.2466759023285,-332.052880506624,-319.23838319230566,-0.6895100163223311,2506,2513,South Central North Dakota,McIntosh,38,51,North Dakota,ND
38001,38CS008,28,27,29,24,-5,-4,-3,-214.55576105224424,3,164.23357664233575,-427.597256681242,-380.1114971663552,-329.3862678286296,-1.0276722792585131,34,33,35,40,5,6,7,286.4250436916282,2,92.16589861751152,142.46194053083292,195.5608892552191,245.96559800362493,0.2771840092800569,2192,2170,Southwest North Dakota,Adams,38,1,North Dakota,ND
38011,38CS008,28,28,29,41,12,13,13,510.8765109273056,6,241.5296880241529,256.68087358148364,269.56338955264954,281.2407089886607,0.43824333398149684,34,34,34,36,2,2,2,67.69975873995178,5,171.58544955387782,-117.2252055956455,-103.76507955771525,-90.81027340604932,1.6819324633456465,2981,2914,Southwest North Dakota,Bowman,38,11,North Dakota,ND
38037,38CS008,29,28,30,37,7,8,9,412.1466893765695,5,262.6970227670753,94.06721655847116,150.79899618103005,200.2226202484925,0.5653214636688838,36,35,37,46,9,10,11,428.7444656598295,4,172.63703064307293,205.64167838515647,257.0987100036056,309.24001921010347,0.36583104161224933,2284,2317,Southwest North Dakota,Grant,38,37,North Dakota,ND
38041,38CS008,24,24,24,38,14,14,14,666.8513359300405,8,387.72213247172857,267.2225449703133,279.32742189604653,291.69425391268885,0.542028706061925,29,29,30,24,-6,-5,-5,-218.11067442574344,6,246.30541871921181,-478.0357574173277,-464.5024554029721,-450.48917107401,-1.3910862806532918,2476,2436,Southwest North Dakota,Hettinger,38,41,North Dakota,ND
38057,38CS008,66,65,67,60,-7,-6,-5,-89.21390397231256,6,86.60091412076017,-188.35341427318295,-175.45117943419754,-163.47934920977846,-1.1580693998007487,82,81,83,91,8,9,10,112.60407403480782,10,120.13455069678041,-20.145399031853298,-7.52551607253245,6.295303722420743,0.9640261009833802,8314,8324,Southwest North Dakota,Mercer,38,57,North Dakota,ND
38059,38CS008,280,265,294,326,32,46,61,168.11458226773385,61,221.37543095626927,-104.27590374067869,-52.663744886510315,-2.4598007998831166,1.2889872922239254,348,331,365,369,4,21,38,62.17381063391863,32,95.3232052427763,-83.42710526961154,-32.47953572872701,14.53091250397726,1.4630746323419583,33066,33570,Southwest North Dakota,Morton,38,59,North Dakota,ND
38065,38CS008,11,10,11,16,5,5,6,345.9203986777362,2,127.72751463544438,206.3367907126123,217.87483339154812,229.77898903403917,0.31169461475435856,13,13,13,13,-0,-0,0,-3.0435197932306894,5,267.0940170940171,-281.69712670541963,-270.13169346561835,-256.97874569927296,5.30208463101195,1879,1872,Southwest North Dakota,Oliver,38,65,North Dakota,ND
38085,38CS008,33,32,33,53,20,20,21,615.1576477281134,3,91.76650522559267,510.9592404498368,523.175471957316,534.959860733349,0.1421091832002188,39,38,39,57,18,18,19,484.22229345847967,5,133.01409949454643,338.68284093876105,351.10735235773643,364.45987736689676,0.26039068169595975,3923,3759,Southwest North Dakota,Sioux,38,85,North Dakota,ND
38087,38CS008,9,9,9,4,-5,-5,-5,-844.3720268533663,4,677.9661016949152,-1572.3424083150949,-1523.5310033367618,-1473.3285706897686,-1.0045720690681408,11,10,11,2,-9,-9,-8,-1266.9811128539488,2,289.01734104046244,-1608.4390357346008,-1555.6384240839207,-1506.8935632101275,-0.2574827943566884,708,692,Southwest North Dakota,Slope,38,87,North Dakota,ND
39001,39CS001,305,294,317,347,30,42,53,181.65086808083188,30,131.02820746132846,1.2658561964551527,51.83659498098904,102.71893248966543,0.70438276340024,375,360,389,515,126,140,155,509.68094248986506,95,345.128242389014,116.37751700779326,165.32967499799304,215.01835023769087,0.6723532358020083,27475,27526,Adams+Brown,Adams,39,1,Ohio,OH
39015,39CS001,457,438,475,544,69,87,106,240.62783002414943,30,82.54987388213712,106.34461965671596,157.92612058929734,209.45844423842553,0.3391817159228594,560,538,583,681,98,121,143,276.98766900772296,118,270.28884256820214,-44.4652458010391,6.981863327065086,60.03246838852426,0.9678119947642083,43610,43657,Adams+Brown,Brown,39,15,Ohio,OH
39003,39CS002,969,925,1013,1178,165,209,253,246.11958118472813,172,202.2022806536306,-3.8125860603663346,43.66876262663698,95.7679057435021,0.8176555808945828,1184,1132,1237,1359,122,175,227,171.79919823980603,215,211.34998574616372,-89.71144982588854,-40.51606319734686,12.725336295780707,1.2232160461753114,102076,101727,Allen,Allen,39,3,Ohio,OH
39005,39CS003,489,467,512,570,58,81,103,184.38038374891718,69,157.5492341356674,-23.459276100277986,27.031242362617327,76.77941424959307,0.8440271412494733,598,571,625,725,100,127,154,242.45639813264813,104,198.73497544476504,-3.0695598471446695,43.32927359368257,97.09417144117548,0.8132633384567255,52555,52331,Ashland,Ashland,39,5,Ohio,OH
39007,39CS004,1034,992,1076,1111,35,77,119,94.62282756415475,125,154.07054376630578,-107.72135793654708,-60.33514747360053,-7.559718364738569,1.6073226627050583,1265,1215,1316,1543,227,278,328,285.2483141148286,229,235.23852570160662,0.2822095335298603,48.071910067671915,102.86075701552899,0.8217206125023959,97358,97348,Ashtabula,Ashtabula,39,7,Ohio,OH
39009,39CS005,415,388,442,494,52,79,106,150.42976280611794,25,47.777547737733116,55.11366224600168,101.29541405393256,150.11554148037817,0.3136226634062952,514,482,546,648,102,134,166,216.48503420787372,77,123.99555548398526,41.78692062950889,91.13252718999867,141.9647066804101,0.5685382394996877,62791,62099,Athens+Hocking,Athens,39,9,Ohio,OH
39073,39CS005,273,261,285,328,43,55,67,237.01264178315594,42,179.7175866495507,4.386884824778509,58.28878202132576,107.13370074348668,0.7448148334175895,336,322,351,434,83,98,112,347.6711512495493,68,242.1393725741552,52.61439134097032,105.27846688076575,156.38603278870133,0.6894000426202282,28044,28083,Athens+Hocking,Hocking,39,73,Ohio,OH
39011,39CS006,416,396,436,541,105,125,145,324.29177345829095,66,171.18402282453638,104.05171328550159,155.66241311690933,205.31403557061853,0.5236819563111931,507,483,531,609,78,102,126,220.93174571912556,86,186.2278042442616,-19.753354621466688,35.09752942821778,85.8452105242319,0.8347384750329071,46266,46180,Auglaize+Mercer,Auglaize,39,11,Ohio,OH
39107,39CS006,355,337,373,456,83,101,119,286.17008236040556,75,212.8817087305154,24.78001957950074,73.24598586025586,120.81839510939456,0.736593231485799,434,413,456,460,4,26,47,60.24714362364057,37,87.40226300994496,-75.5832384013088,-28.275727368653698,28.77823889510234,1.3959933995533034,42277,42333,Auglaize+Mercer,Mercer,39,107,Ohio,OH
39013,39CS007,741,712,769,879,110,138,167,249.94602309549626,98,177.36753993031988,18.811409145175453,72.84455916015062,120.53268135384556,0.7045218911742493,901,867,935,1119,184,218,252,330.7518866421504,166,251.87770275396406,29.130285730254045,77.95987639736647,129.43983292746216,0.75805306638261,66303,65905,Belmont,Belmont,39,13,Ohio,OH
39017,39CS008,3004,2837,3172,3648,476,644,811,198.2416563151735,399,122.91389096398068,22.955053167769986,74.54075499870368,127.06773754684386,0.619058523095549,3699,3498,3901,4220,319,521,722,133.44839153934285,547,140.15327182304304,-57.582709788250114,-4.735239153099857,45.326164117694894,1.04823063635412,389541,390287,Butler,Butler,39,17,Ohio,OH
39019,39CS009,275,263,286,331,45,56,68,252.99261619824495,27,121.20305252132275,77.87324816577421,132.0296720676753,185.45916283757109,0.4707250692116729,338,324,351,398,47,60,74,226.65279269500041,81,303.47308081375746,-127.20570597540139,-76.8941614183197,-24.83543915436269,1.3171610478997857,26732,26691,Carroll+Harrison+Tuscarawas,Carroll,39,19,Ohio,OH
39067,39CS009,169,163,175,198,23,29,35,237.0357864562175,17,139.98490358882864,43.880267462716176,97.37540907784982,148.64592961575397,0.5707375288192654,207,199,214,288,74,81,89,561.5488856942643,46,317.70149872228745,192.7206338196348,244.42038214809153,292.9688287381542,0.5588854927912864,14573,14479,Carroll+Harrison+Tuscarawas,Harrison,39,67,Ohio,OH
39157,39CS009,949,909,989,1157,168,208,248,269.1740747106987,178,230.0534206444942,-16.611978326080518,39.90892866687242,89.26719208787223,0.8505800623347926,1163,1115,1211,1374,163,211,259,227.74362153665044,266,287.3128685921669,-111.18721883274904,-60.580992820098345,-11.35090424812086,1.2556077537456067,92848,92582,Carroll+Harrison+Tuscarawas,Tuscarawas,39,157,Ohio,OH
39021,39CS010,350,334,367,432,65,82,98,253.16644088507667,36,111.52128455998142,92.25028584806759,141.8455033754214,193.45809589354428,0.43518080523946545,428,408,448,502,54,74,94,190.94500975887254,77,198.96640826873386,-59.864134737834064,-7.8950887428089365,46.426656142394,1.0280961483204487,38737,38700,Champaign+Logan+Madison+Shelby,Champaign,39,21,Ohio,OH
39091,39CS010,440,420,459,473,14,33,53,87.34319736660647,43,112.19098558476288,-75.73718788698373,-24.119804360779845,25.516985639040772,1.2472276749889755,537,513,561,624,63,87,111,188.5517427933367,98,212.8630074502053,-74.4897077100277,-24.932608049728067,25.627262482266637,1.1160798573254773,45993,46039,Champaign+Logan+Madison+Shelby,Logan,39,91,Ohio,OH
39097,39CS010,362,343,381,395,14,33,52,89.79547770685443,45,122.65479489392632,-86.01957165983004,-33.56329696765607,23.006047850349134,1.3256948102711807,447,424,470,557,87,110,133,248.67991185923026,68,153.4850126399422,45.379811458839804,96.41475501726521,146.08112197831753,0.6116474871540852,44026,44304,Champaign+Logan+Madison+Shelby,Madison,39,97,Ohio,OH
39149,39CS010,396,375,416,518,102,122,143,304.58151038001256,54,134.51518485458658,117.48575715069958,170.1861267202789,223.92551310570374,0.4380567152572136,483,459,508,597,89,114,138,236.6264430442177,104,216.6756948206175,-35.02340913939887,20.85632841693854,67.80122868297349,0.907694771921215,48173,47998,Champaign+Logan+Madison+Shelby,Shelby,39,149,Ohio,OH
39023,39CS011,1505,1447,1563,1775,212,270,328,239.05115841415238,209,185.08542120216967,-0.11111709093352312,54.50063501883976,106.5120084953775,0.7713925986230482,1836,1766,1906,2135,229,299,369,220.5867298065159,235,173.2450643586984,-5.3447035000638685,48.87620512426731,99.5750592049612,0.7827669348859297,135505,135646,Clark,Clark,39,23,Ohio,OH
39025,39CS012,1600,1510,1690,1865,175,265,355,152.53030344732014,147,84.61243284727551,15.78191782274105,69.49292484244494,116.13188189826076,0.5526399297886307,1977,1869,2086,2409,323,432,540,205.9855552252235,288,137.47344805365285,15.287032071748293,66.46298491765553,119.71047685771039,0.6658506313922353,208480,209495,Clermont,Clermont,39,25,Ohio,OH
39027,39CS013,388,370,406,475,69,87,105,249.4852708585484,45,128.65720003812064,67.86614389517452,120.57736209966322,174.76909078484331,0.5098478149476766,475,454,497,574,77,99,120,235.1202132551293,85,202.39059002809657,-19.05264195006023,31.901273519997222,82.34093546358537,0.8521663161692364,41972,41998,Clinton+Fayette+Highland,Clinton,39,27,Ohio,OH
39047,39CS013,321,309,333,336,3,15,27,62.14665739857714,31,128.85348112227226,-116.1708585443476,-66.19846711393099,-17.672295406466947,1.9433969961743491,392,377,407,441,34,49,64,169.10106305640554,65,224.82792016879387,-103.55117185931364,-56.08561810901191,-6.1814636543623,1.3028974265471638,28870,28911,Clinton+Fayette+Highland,Fayette,39,47,Ohio,OH
39071,39CS013,431,413,450,486,36,55,73,151.67752170178625,41,113.63636363636364,-13.055617351258691,38.22282613335849,89.75295244626015,0.7357526457947636,528,506,550,642,92,114,136,262.9876502126531,102,235.29954554891694,-24.135379106705162,26.80946602198317,76.42897055522671,0.8869371133131997,43296,43349,Clinton+Fayette+Highland,Highland,39,71,Ohio,OH
39029,39CS014,1105,1061,1148,1284,136,179,223,211.89479252296354,161,190.15186559451985,-29.401663475582342,20.82387957424965,74.22154898125012,0.892413929877316,1348,1295,1400,1625,225,277,330,273.661315622917,251,247.64930490464022,-22.975789191181658,26.159535527480458,77.09249115165696,0.9016972100502375,101603,101353,Columbiana,Columbiana,39,29,Ohio,OH
39031,39CS015,360,345,376,426,50,66,81,215.6675009798933,37,121.46081247435369,41.76446220265763,94.57595308547106,145.48822886406555,0.5547416638579079,444,425,463,550,87,106,125,290.4987674806583,98,267.70104895104896,-29.957726433317386,24.80573221501759,76.89743442230474,0.9129375366853828,36555,36608,Coshocton+Holmes,Coshocton,39,31,Ohio,OH
39075,39CS015,295,276,314,372,58,77,96,208.36730223027809,75,203.7259207279806,-44.11413469197158,5.219332222044072,55.99522816739787,0.9651430739079252,368,345,391,418,27,50,73,113.32324952272113,77,173.97198373248983,-108.7418572256325,-62.80842557002363,-5.25477317543455,1.5051741758365997,44177,44260,Coshocton+Holmes,Holmes,39,75,Ohio,OH
39033,39CS016,488,470,506,584,78,96,114,275.55476965489515,75,215.14629948364887,14.125265111562722,60.55627555258522,114.05801783124986,0.7727307027482756,596,574,617,722,105,126,148,302.41603733891975,100,239.3546997295292,10.999677157661655,62.652315130295655,113.07678873782456,0.7852597556955854,41832,41779,Crawford+Richland,Crawford,39,33,Ohio,OH
39139,39CS016,1292,1238,1346,1455,109,163,217,157.28235639159726,141,136.04238862132456,-32.611634879139444,21.441939279681428,70.54749297011423,0.8596827750296,1591,1526,1656,1784,128,193,258,154.27784783417246,281,224.54312266766817,-122.38089653855786,-70.46064068093798,-15.705024516066352,1.4479466245512822,124373,125143,Crawford+Richland,Richland,39,139,Ohio,OH
39035,39CS017,11937,11396,12478,13820,1342,1883,2424,179.84094819119557,1496,142.8612355204981,-16.47925606721888,36.535178126447846,89.94958183645197,0.7939538684165174,14539,13893,15185,15985,800,1446,2092,115.57378445642321,1677,134.03325815109233,-70.19253357992143,-18.22480953361347,32.52739397547958,1.1589188055377622,1256604,1251182,Cuyahoga,Cuyahoga,39,35,Ohio,OH
39037,39CS018,542,520,564,607,43,65,87,150.7055810622328,98,227.2463768115942,-127.09739921247433,-76.1958816365525,-22.628618812012736,1.4850333977626193,663,637,690,727,37,64,90,123.45711003437239,106,205.2712097445729,-133.79580615528178,-82.0353634407912,-31.799481261918384,1.63701464183094,51750,51639,Darke+Preble,Darke,39,37,Ohio,OH
39135,39CS018,414,396,431,486,55,72,90,211.59605913028196,70,205.19334587292667,-45.90269686588761,6.937983010068073,61.974471422136794,0.9564901868482153,507,486,529,631,102,124,145,302.18080489918555,92,225.04341870306502,26.103140369324773,77.0583140433172,128.73220379125667,0.7387509023918144,40937,40881,Darke+Preble,Preble,39,135,Ohio,OH
39039,39CS019,352,335,368,409,41,57,74,179.83298564139852,70,219.99895238594104,-91.68573959202173,-37.95340224633568,9.863710113765721,1.2023388827313148,432,412,452,486,34,54,74,141.32451035398265,65,170.35328650801972,-83.62014345732766,-28.106698868598635,21.223583406338907,1.1834582360868893,38182,38156,Defiance+Williams,Defiance,39,39,Ohio,OH
39171,39CS019,368,353,384,368,-16,-0,15,-1.420234756352345,51,165.60681910431606,-217.04657074985903,-169.06118588559897,-117.25689134151995,90.64622147318832,450,431,469,517,48,67,86,183.0452238010791,87,236.66385571665623,-104.41502831729281,-54.64033427055744,-5.88132006679623,1.2739925242234407,36955,36761,Defiance+Williams,Williams,39,171,Ohio,OH
39041,39CS020,1050,957,1142,1241,99,191,284,106.87154407852341,89,49.70192804389406,5.217689633242255,58.072381052635,108.99096099111333,0.46264480515120104,1339,1225,1452,1526,74,187,301,85.20184828977885,132,60.024009603841534,-27.038051036790485,25.846377057607437,72.96938405120217,0.7007519172775718,214881,219912,Delaware,Delaware,39,41,Ohio,OH
39043,39CS021,827,795,859,1025,166,198,230,316.09871958808907,114,181.9463471078777,84.72972554362383,134.97664130058234,184.15319933282518,0.5727080876650614,1006,967,1044,1136,92,130,169,174.07170014899134,111,148.12640119568698,-26.444446125726927,25.69002546049621,77.90515378463805,0.844476561519782,75187,74936,Erie,Erie,39,43,Ohio,OH
39045,39CS022,1214,1146,1283,1439,156,225,293,169.24297027416705,136,102.45206975780631,15.425226860851717,66.01446554377668,113.54609021508523,0.6026723710050891,1511,1428,1594,1816,222,305,388,189.44943524077752,221,137.42499144980255,1.7601117531575252,51.41071124830034,100.82116953068376,0.7230182291830934,159294,160815,Fairfield,Fairfield,39,45,Ohio,OH
39049,39CS023,8660,8091,9229,10063,834,1403,1972,127.2971537818442,1033,93.69777403537627,-15.976864321657478,34.38409855156802,80.20447234846564,0.7355314335365379,10669,9987,11352,11859,507,1190,1872,90.01834347984489,1056,79.89148073866332,-35.94624711149084,10.458853130170331,61.91775853278683,0.886756967766972,1322977,1321793,Franklin,Franklin,39,49,Ohio,OH
39051,39CS024,378,360,396,450,54,72,90,203.6069880247504,47,132.5904506664786,22.16161502240075,71.79824563997468,118.67990837691363,0.6423082682630852,463,441,485,545,60,82,104,192.81140107933868,103,242.49558563861095,-102.59648769671524,-50.739337813035185,1.536682598746583,1.2425111169641254,42537,42475,Fulton+Henry,Fulton,39,51,Ohio,OH
39069,39CS024,255,244,267,315,48,60,71,259.58661129947274,50,218.03117845851955,-6.89382083088837,42.30242487341253,93.83645199972045,0.8260407750322737,313,299,328,370,42,57,71,205.56104627458947,45,163.33345432107728,-8.471182043828408,41.738270650334975,91.57238416287522,0.7807874395731852,27519,27551,Fulton+Henry,Henry,39,69,Ohio,OH
39053,39CS025,324,311,336,381,45,57,70,235.41877521213772,30,122.9298275567697,56.23688343100365,112.33496408423302,165.15776254755139,0.5132417196191524,395,380,410,439,29,44,59,150.07783281499957,63,216.02715769982512,-116.96953631717595,-64.01355268657385,-17.58192372583281,1.4072803810466732,29285,29163,Gallia+Meigs,Gallia,39,53,Ohio,OH
39105,39CS025,251,242,261,299,38,48,57,257.14074498090696,22,118.8118811881188,89.40567808700486,138.85739324348268,187.68219452921983,0.4525455155455622,306,295,318,380,62,74,85,334.51749553496836,49,222.1315562808831,57.57477855218681,111.25044111245063,164.0107818042148,0.6551571656158452,22220,22059,Gallia+Meigs,Meigs,39,105,Ohio,OH
39055,39CS026,732,691,773,887,114,155,196,196.00589027717965,118,148.91155747186875,-8.395507291103918,46.868711852853174,94.20293512651233,0.754869865959357,904,855,953,1095,142,191,240,200.11493531685733,109,114.09908825407459,33.928074681107645,88.14276990992953,138.16153673356737,0.567200810150086,95090,95531,Geauga,Geauga,39,55,Ohio,OH
39057,39CS027,1320,1248,1393,1595,202,275,347,195.8529050010827,169,120.52847098817894,22.92940350363638,76.048909658767,125.36304766219195,0.6131702077410369,1629,1542,1716,1913,197,284,371,168.8622413728048,255,151.46475326094705,-36.29489340154475,18.220978850449175,69.22980568605355,0.8938282262418362,168259,168356,Greene,Greene,39,57,Ohio,OH
39059,39CS028,407,391,424,458,34,51,67,158.45490587088725,38,118.59557867360206,-11.283908563235387,38.87914722830701,88.39427732852145,0.7339932572482141,497,477,517,656,139,159,179,414.83062057370023,74,193.20139940473084,168.5245638866014,221.2521803824742,269.3565407423707,0.46282274859868267,38450,38302,Guernsey+Monroe+Noble,Guernsey,39,59,Ohio,OH
39111,39CS028,146,140,152,163,11,17,23,153.5716770367693,27,241.7369245691263,-135.69426300761327,-88.5913024435691,-37.12673317647251,1.4873839628675276,178,171,185,235,50,57,64,428.73960124355455,37,277.5069376734418,100.95361603459601,150.38502806739857,199.75961289615333,0.6361339447502656,13403,13333,Guernsey+Monroe+Noble,Monroe,39,111,Ohio,OH
39121,39CS028,120,118,121,135,14,15,17,130.71341696379048,32,271.3397399660825,-152.88207931061592,-140.3314007610908,-128.92292081534376,1.9493807975161086,148,146,149,162,13,14,16,102.15539092460209,19,134.15236884840783,-44.868826804950224,-31.966899937889327,-19.180345515905366,1.2283211009498116,14152,14163,Guernsey+Monroe+Noble,Noble,39,121,Ohio,OH
39061,39CS029,6946,6590,7302,7950,648,1004,1360,145.51014763463613,802,116.24943379133323,-26.83461193199175,28.733364417509208,80.79585963765537,0.7981144233405778,8496,8069,8923,9038,115,542,969,65.56270944653211,928,112.25503181970487,-96.32428712943316,-46.704317355681,1.6944014949811448,1.7090248629456046,827875,826689,Hamilton,Hamilton,39,61,Ohio,OH
39063,39CS030,663,631,695,766,71,103,135,164.46233163958263,96,153.72913247127588,-39.73648891018836,8.988055683592917,61.17727239224351,0.9257240081746647,811,772,849,920,71,109,148,146.05800098648456,136,182.1078989301161,-87.28715319790847,-36.9248760245412,16.298883649610406,1.235492325430518,74937,74681,Hancock,Hancock,39,63,Ohio,OH
39065,39CS031,267,254,280,340,60,73,86,283.37007957639184,47,183.0693326408725,48.60204632128138,100.2604049913889,150.55169192457635,0.6372834253421693,327,311,343,486,143,159,175,519.7303417043878,80,261.13069591330463,212.54133373141266,256.57165467382214,308.567138338146,0.4992991478771075,30808,30636,Hardin+Wyandot,Hardin,39,65,Ohio,OH
39175,39CS031,218,209,227,274,47,56,65,308.4366186704293,34,186.89876316994958,71.67544503718541,120.18741712145273,169.15586046330264,0.5953448076006924,266,254,277,304,27,38,50,177.0142677088231,49,225.5050853697823,-97.78724115025192,-47.55112375503187,2.2677369224362596,1.241655875170004,21830,21729,Hardin+Wyandot,Wyandot,39,175,Ohio,OH
39077,39CS032,527,502,553,652,99,125,150,255.85739514800568,79,162.30931223997126,44.7082765036642,92.8848313175178,142.6048080925127,0.6293206514503863,649,619,679,733,54,84,114,144.16510014066256,107,183.28822501627326,-90.9154893752487,-38.822646471063315,8.878541226894828,1.2564480715391775,58407,58378,Huron,Huron,39,77,Ohio,OH
39079,39CS033,373,359,387,405,18,32,46,118.08017644677676,36,132.56006628003314,-60.986643143462615,-13.896465629224224,37.61852135388935,1.0886781611128429,458,441,475,519,44,61,78,187.7809025448363,80,245.92683676606208,-111.5942437113039,-58.165033429777075,-5.720603929233127,1.2885533636688442,32589,32530,Jackson+Pike+Vinton,Jackson,39,79,Ohio,OH
39131,39CS033,315,304,327,363,36,48,59,211.34948484994794,14,61.853392732226354,93.00881444996641,150.84014581234533,199.3224317404943,0.2866667526730563,387,373,401,481,80,94,108,346.36844783282794,74,273.23413211239523,19.767449275104354,74.36215363784999,128.20910177587376,0.7805333569359445,27161,27083,Jackson+Pike+Vinton,Pike,39,131,Ohio,OH
39163,39CS033,137,132,143,163,20,26,31,239.6941663866815,10,93.67681498829039,94.85664941887822,147.03563675382495,199.09904126697032,0.376118686115876,168,162,175,226,51,58,64,454.3666843512014,35,275.3953890943426,126.64169142571703,179.6122426046004,230.27924367920494,0.59579070211623,12810,12709,Jackson+Pike+Vinton,Vinton,39,163,Ohio,OH
39081,39CS034,783,755,811,867,56,84,112,153.86696515789382,91,167.66467065868264,-62.47170408398182,-15.609405073005037,39.620559331133975,1.0767791409951852,951,918,985,1178,193,227,260,349.9135370604555,170,262.20405645099095,38.768564130892564,87.62414581399541,137.4524118660621,0.7460510582078841,65130,64835,Jefferson,Jefferson,39,81,Ohio,OH
39083,39CS035,532,505,559,642,83,110,137,209.7911960085977,73,139.70846225000798,17.09839043338955,68.93964011519913,123.26634658710036,0.6599204330614277,650,618,683,816,133,166,198,263.2159906851139,125,198.79767168166927,8.828291862416275,64.09484243680801,117.7190425522612,0.7507284289884881,62702,62878,Knox+Morrow,Knox,39,83,Ohio,OH
39117,39CS035,276,261,291,320,29,44,59,150.42412870862725,26,89.04363709009961,5.991347098952632,61.76593641598995,111.82880956654752,0.578773370243681,338,320,356,416,60,78,96,222.1748938144104,58,165.1292563489352,7.082906042674951,57.3304221450695,113.2875866633937,0.7338362163313132,35039,35124,Knox+Morrow,Morrow,39,117,Ohio,OH
39085,39CS036,2183,2083,2283,2476,193,293,393,151.48696796040952,246,127.25234934046038,-24.697474029095435,25.94924677206797,72.09623057971666,0.8371630796350422,2675,2555,2795,3088,293,413,533,177.981932719236,359,154.6887051391983,-29.762512425698063,23.701169068123008,75.35049996910836,0.8670268466435334,231980,232079,Lake,Lake,39,85,Ohio,OH
39087,39CS037,703,678,728,814,86,111,136,229.37004453311988,59,121.50751699045789,54.6062732777643,108.83144832107563,162.00322465628795,0.5250303878912673,851,821,880,1088,208,237,267,412.29440297188785,137,238.07455035189852,121.06890556098627,175.09969971520485,224.87988675945468,0.5750146139361861,58268,57545,Lawrence,Lawrence,39,87,Ohio,OH
39089,39CS038,1477,1401,1554,1618,64,141,217,94.3932759937213,156,104.79175996417375,-60.78911549782248,-9.508411900354634,38.87023984295074,1.1023167314271056,1830,1737,1923,2179,256,349,442,193.70098356036948,247,137.10796558423536,5.277021888208473,56.517868904090086,110.44444316988604,0.7058104334620475,178640,180150,Licking,Licking,39,89,Ohio,OH
39093,39CS039,2763,2628,2898,3103,205,340,475,130.22191620916706,314,120.33609795511668,-44.33354259611731,9.848561101371384,61.160318425645485,0.9213732838053225,3412,3249,3575,4045,470,633,796,200.70885694115358,497,157.6426555016335,-11.421448077023827,42.369559382527676,99.9337369173449,0.7841902038188145,313123,315270,Lorain,Lorain,39,93,Ohio,OH
39095,39CS040,3935,3750,4120,4860,740,925,1110,258.0389622739786,591,164.81524517778294,42.90331347751459,92.1332855856628,144.93738832519276,0.6380327691936887,4823,4601,5045,5498,453,675,897,157.19289651721041,602,140.19072459043116,-30.168672481734216,17.563378195258476,66.11768426004961,0.8905195335993162,430300,429415,Lucas+Ottawa,Lucas,39,95,Ohio,OH
39123,39CS040,429,412,446,506,60,77,94,229.84335977541738,54,160.86190204304543,20.436680486825942,69.70153152345273,122.19964263866494,0.6909214159281016,523,503,544,626,82,103,123,255.8867865696742,72,179.43030876965634,23.5746167754271,75.785386331325725,127.19910368979932,0.694446515146154,40283,40127,Lucas+Ottawa,Ottawa,39,123,Ohio,OH
39099,39CS041,2566,2468,2664,3285,621,719,817,378.9727379971861,476,250.78920447310992,75.96178193767601,128.65294299802886,176.82291644813162,0.6608418044690488,3118,3001,3235,3624,389,506,623,222.83604680251204,459,202.26055919095776,-30.072993701310217,21.54458058629243,74.55195916748788,0.9058740017541469,227761,226935,Mahoning,Mahoning,39,99,Ohio,OH
39101,39CS042,665,637,693,709,16,44,72,81.23567072388734,111,203.9472676884445,-177.04059293806245,-122.07490807146793,-69.93714416833373,2.455035757164446,814,780,847,934,87,120,154,184.24630214961994,120,183.7615999509969,-48.83935332595727,-0.9573191244695968,46.91137322999308,0.9891480547970579,65311,65302,Marion,Marion,39,101,Ohio,OH
39103,39CS043,1338,1259,1416,1593,177,255,334,167.94732885093268,182,119.83407589491472,-2.9032919931066266,47.33257175533258,97.99328521966805,0.7107353712622484,1653,1559,1748,2004,256,351,445,191.59073543985068,245,133.870271510767,7.563937263814657,57.23875303161011,109.68501069079132,0.6967433169255254,182252,183013,Medina,Medina,39,103,Ohio,OH
39109,39CS044,989,943,1036,1096,60,107,153,117.827059957004,130,143.6450861410116,-78.55988674422743,-25.12284919982571,25.719489472748364,1.2077915058912678,1219,1163,1275,1465,190,246,302,225.37586437023498,257,235.35014056905285,-61.59565371668128,-9.946747245804847,39.75916288658596,1.0400302792918232,108601,109199,Miami,Miami,39,109,Ohio,OH
39113,39CS045,5413,5182,5643,6341,698,928,1159,207.88646387266962,692,154.95659573197585,4.0660518065135145,53.91482866817866,104.2364174222937,0.7445884659481343,6624,6347,6900,7364,464,740,1017,138.15608045636282,886,165.3123863010887,-79.2213904021192,-26.785348374883934,20.210458499491153,1.1949487047271525,535892,535955,Montgomery,Montgomery,39,113,Ohio,OH
39115,39CS046,149,144,155,188,33,39,44,333.94391737814146,16,138.66820742452694,143.80988311832638,195.17227683128297,246.75672770695923,0.4047398851840676,182,175,189,267,78,85,92,622.459654570087,36,262.94646117887663,307.62628891590845,358.4718206028215,407.3713983985698,0.41753192761395214,13846,13691,Morgan+Perry,Morgan,39,115,Ohio,OH
39127,39CS046,312,296,327,372,45,60,76,203.94794509170518,36,121.54633954195036,26.75372218211149,82.57140829896221,136.5419498173652,0.5862620987081046,383,365,402,491,89,108,126,303.64960252209005,66,186.14095947203654,67.20388442118767,117.04847330262763,169.7486648561476,0.6073710575493523,35542,35457,Morgan+Perry,Perry,39,127,Ohio,OH
39119,39CS047,865,828,902,983,81,118,155,164.5345163690234,84,116.79508719077688,-4.122880244855814,48.223199527664065,97.87877901284077,0.7039031706887191,1059,1015,1104,1181,77,122,166,140.99742315122427,165,190.97664297784672,-101.79514568267895,-49.73442731147354,1.7956517393372207,1.3434408541255687,86305,86398,Muskingum,Muskingum,39,119,Ohio,OH
39125,39CS048,182,173,190,204,14,22,31,143.26995858187064,28,178.7994891443167,-83.41972677597775,-36.287195444886166,14.539640324019722,1.1947392806175294,223,213,233,220,-13,-3,7,-16.3910555807208,42,222.68172419277874,-289.2264733883858,-240.28543746770137,-190.59815895274255,-20.081118221351463,18792,18861,Paulding+Putnam+Van Wert,Paulding,39,125,Ohio,OH
39137,39CS048,272,257,287,350,63,78,93,273.5349425515352,81,283.42323953929144,-61.55128168620439,-9.674641944071881,40.03665398474485,1.023063034737909,334,317,352,381,29,47,64,135.63923403168397,56,163.13688932909955,-81.67837528512392,-26.775556497776147,20.436381337792692,1.1774382677046895,34295,34327,Paulding+Putnam+Van Wert,Putnam,39,137,Ohio,OH
39161,39CS048,282,269,294,342,48,60,73,251.17887544316775,56,233.59288097886537,-36.10176713057879,15.95825604218482,66.399454025982,0.9147942790742897,344,330,359,402,43,58,72,200.15434014114385,66,229.54126525927728,-82.5691375875237,-28.672330318643766,25.05402864041521,1.1272344074860323,28768,28753,Paulding+Putnam+Van Wert,Van Wert,39,161,Ohio,OH
39129,39CS049,530,505,556,627,71,97,122,197.50284664912292,83,169.71679787342805,-23.177616875691466,25.513036590611815,80.42609503220473,0.8505077215416751,658,627,688,766,78,108,139,183.1774968175733,104,175.58669593111597,-43.64913006324172,5.113292087934849,55.37265181464686,0.9498061135501298,58686,59230,Pickaway,Pickaway,39,129,Ohio,OH
39133,39CS050,1286,1217,1356,1453,97,167,236,123.58556964491646,125,92.63090290428757,-16.330302572033034,31.78472438977018,82.80777126255352,0.7450609148523947,1584,1501,1668,1947,279,363,446,223.43371936423017,250,154.04238013962402,17.210457519480553,69.97488476894901,121.54795428320122,0.6875360702313758,161933,162293,Portage,Portage,39,133,Ohio,OH
39141,39CS051,749,715,782,948,166,199,233,311.1997386430293,102,159.12429635600162,99.24904425459448,152.36016841052054,206.43857693148354,0.5087748046350874,916,877,956,1146,190,230,269,298.5286023492922,154,200.2470580586438,45.113591387015894,97.52078145962072,150.1939899568468,0.6678710850367294,76921,76905,Ross,Ross,39,141,Ohio,OH
39143,39CS052,586,561,611,633,22,47,72,96.05471343271707,87,177.6295640929663,-134.03286774595932,-81.40537251766314,-29.878991697312337,1.810764769492689,718,687,748,860,112,142,173,242.2035786449321,115,195.80467206974052,-8.620057676014454,44.86871246193524,98.98419007747458,0.8027866844630535,58774,58732,Sandusky,Sandusky,39,143,Ohio,OH
39145,39CS053,876,845,908,1092,184,216,247,350.16093568401413,66,107.20812182741116,193.1350619940127,242.67919367527972,296.0958194105924,0.30475440978344476,1068,1030,1106,1314,208,246,284,334.98315051314245,142,193.45785479761855,90.792797012518065,141.93012569184359,193.38664551249437,0.5751759356772105,73875,73401,Scioto,Scioto,39,145,Ohio,OH
39147,39CS054,521,498,545,609,64,88,111,191.2187456165881,76,165.77297100790693,-25.41857940567821,26.572951029947166,76.52759265519761,0.8571509702623513,638,610,666,774,108,136,164,247.87671078026793,129,234.89566262427618,-37.814275911798525,11.984272472818109,65.08603422863585,0.9407205182291651,55015,54918,Seneca,Seneca,39,147,Ohio,OH
39151,39CS055,3753,3593,3914,4484,570,731,891,234.5565825494274,643,206.43545681469766,-25.172505392766226,26.32727733111385,81.46680404062556,0.878906408220355,4599,4406,4792,5406,614,807,1000,215.9258787126606,796,212.88545371880934,-46.679590693345,3.9625585536965278,58.426776871613924,0.9846994856774016,373773,373910,Stark,Stark,39,151,Ohio,OH
39153,39CS056,5004,4772,5236,5794,558,790,1022,175.6642096965875,651,144.79537366548044,-19.57895845788943,31.537179301667493,78.9019881054789,0.823231271040056,6112,5835,6390,7035,645,923,1200,171.51398317828938,805,149.6532877247123,-30.834942456588724,22.902325214932628,75.09474230211211,0.871598051515449,539520,537910,Summit,Summit,39,153,Ohio,OH
39155,39CS057,2225,2138,2311,2647,336,422,509,252.2784688661621,353,210.83962550582098,-10.126947490086229,39.52898131342427,91.35579521462101,0.833767678228547,2721,2617,2825,3260,435,539,643,267.81549252719554,435,216.0470833643746,-0.3924175528871783,52.830932848589995,104.26400822194375,0.8052079690027084,200911,201345,Trumbull,Trumbull,39,155,Ohio,OH
39159,39CS058,377,350,404,412,8,35,62,67.52014247753786,27,51.68453292496171,-38.32097023903576,16.761596917267216,66.69103100291842,0.7443651058982104,479,446,512,493,-19,14,47,21.673707340866898,56,86.56001236571605,-119.20767576855796,-64.39515007118705,-11.640395539792,3.727914197631833,62688,64695,Union,Union,39,159,Ohio,OH
39165,39CS059,1615,1510,1719,1888,169,273,378,135.25565103672508,208,103.01534499409807,-18.784635456131596,32.694546681453794,87.36237199940112,0.7588556098241953,2024,1897,2151,2351,200,327,454,132.7350069254544,291,118.27585506127177,-36.3017894692896,14.000717816893609,67.41495134164745,0.8883473347453107,242294,246035,Warren,Warren,39,165,Ohio,OH
39167,39CS060,636,610,662,696,34,60,86,120.97600453517927,80,160.93341380004023,-90.6015542273175,-39.114300906207596,13.487160201329141,1.3085328871684345,774,743,804,877,73,103,134,174.0042080274758,88,148.0210593598089,-29.475717065820675,25.631484134972805,82.69315897093516,0.8425306265206544,59652,59451,Washington,Washington,39,167,Ohio,OH
39169,39CS061,1009,959,1060,1153,93,144,194,147.68117683634074,156,160.44155710588115,-66.14940386887973,-11.212016109674186,39.76373246676464,1.0788913757735867,1242,1182,1303,1494,191,252,312,215.50841988029865,208,178.19050964199127,-14.058620796116852,37.33811312738169,93.62587743514668,0.8235639920920116,116678,116729,Wayne,Wayne,39,169,Ohio,OH
39173,39CS062,1013,956,1070,1197,127,184,241,167.20737799361294,145,131.74332765474162,-18.24811326186273,36.84090160728034,86.27628815263243,0.7836456062894998,1250,1181,1318,1361,43,111,180,84.160521127135425,152,114.77415165289881,-82.99429741460172,-29.993828948522303,21.283631836967704,1.3516259959195414,132075,132434,Wood,Wood,39,173,Ohio,OH
40001,40CS001,191,182,199,241,42,50,59,303.5947908290704,28,169.4829760403531,84.10251113667981,132.77026904278804,182.9823007544636,0.5473412085480402,230,220,240,345,105,115,125,591.9394952316342,61,314.2062429174822,230.65371515505456,277.75705121965535,331.3259669733857,0.5262289158254482,19825,19414,Adair+Cherokee+Sequoyah,Adair,40,1,Oklahoma,OK
40021,40CS001,405,384,425,514,89,109,130,276.76125130700785,52,131.67057036146105,92.29525171072035,144.17477773466683,194.220366982727,0.47144179165500316,498,473,522,636,114,138,163,291.0260054772369,72,151.42911224682945,88.58824085295457,139.1862226149494,193.56347690747967,0.5165951350355321,47391,47547,Adair+Cherokee+Sequoyah,Cherokee,40,21,Oklahoma,OK
40135,40CS001,420,403,437,560,123,140,157,423.4016330017065,54,163.54137748277515,207.84584101329378,257.4607034181487,311.2416300941804,0.3835126740375831,512,492,532,693,161,181,201,458.8538759188944,108,273.6186060652124,132.52978882791334,186.17934025866944,239.89781415024754,0.5930344370440049,39623,39471,Adair+Cherokee+Sequoyah,Sequoyah,40,135,Oklahoma,OK
40005,40CS002,150,144,156,180,24,30,36,253.06918837599326,20,169.8994761432819,31.84808050655606,84.31109152836127,133.69304555987378,0.6495518144580972,185,177,192,195,3,10,18,73.01572015566315,33,230.73695986575302,-212.02159649009516,-157.51652652582297,-107.36088744090787,2.88393264465405,14126,14302,Atoka+Bryan+Coal,Atoka,40,5,Oklahoma,OK
40013,40CS002,436,416,456,524,68,88,108,227.5884095799299,68,174.95711835334475,5.6986993038913205,52.1503321372492,102.30947300724169,0.7601499990826547,536,511,560,716,156,180,205,384.00595152118177,110,234.10730627620407,98.38542819781513,149.53963759548085,198.74023345077177,0.60628482641961845,46640,46987,Atoka+Bryan+Coal,Bryan,40,13,Oklahoma,OK
40029,40CS002,70,70,71,93,22,23,23,512.9435725446649,10,225.8610954263128,275.50471078475806,286.82606106775563,299.6317192388697,0.4217527113455038,85,85,86,93,7,8,8,146.32931672490704,6,113.72251705837756,20.530676200262434,32.531845135805035,45.91220624227387,0.6880469811919304,5313,5276,Atoka+Bryan+Coal,Coal,40,29,Oklahoma,OK
40009,40CS003,206,196,215,249,34,43,53,232.82176953572878,49,264.7813752420408,-82.89651643255829,-30.2187910996066,18.912395632293155,1.1114738237323674,252,240,263,301,38,49,61,222.42389678618343,46,208.30503101933613,-41.41529197760627,14.237533092055829,68.78520431994298,0.9178363087059022,22207,22083,Beckham+Custer+Roger Mills+Washita,Beckham,40,9,Oklahoma,OK
40039,40CS003,261,248,273,341,68,80,93,339.2082331754964,72,303.50932658868163,-17.476244357404642,36.28172463205379,84.415074930969,0.8837752874447256,318,304,333,333,0,15,29,52.199307258888055,55,195.02854508705366,-193.85089357685004,-143.1768913235229,-88.99798606403623,3.4985660179206284,28467,28201,Beckham+Custer+Roger Mills+Washita,Custer,40,39,Oklahoma,OK
40129,40CS003,30,30,30,47,17,17,17,591.7701699088792,11,382.9416884247171,196.85187556487602,208.48468608834165,221.1867242600038,0.6111587091485001,36,36,37,52,15,16,16,460.64114045422957,3,88.4433962264151,358.94178472540597,372.451293423446,384.58339745942976,0.18045169783843162,3447,3392,Beckham+Custer+Roger Mills+Washita,Roger Mills,40,129,Oklahoma,OK
40149,40CS003,119,118,120,138,18,19,20,208.59811143019138,20,219.98166819431714,-23.47676316741879,-11.30130878390247,0.7200561411417643,1.0017508117746685,146,145,148,163,15,17,18,152.80322565511304,27,247.41134426830388,-107.12808281190475,-94.85449443874055,-82.25249562356647,1.5275453757893245,10910,10913,Beckham+Custer+Roger Mills+Washita,Washita,40,149,Oklahoma,OK
40015,40CS004,298,286,309,413,104,115,127,510.91361857378683,81,358.55251023645286,99.0071750326103,154.10646703344858,202.0182964862092,0.6957588700897808,358,344,371,438,67,80,94,303.89812733331985,73,276.10726578161047,-24.487391763229578,25.632240222779323,79.89441703881481,0.8973832881442662,27109,26439,Caddo+Grady,Caddo,40,15,Oklahoma,OK
40051,40CS004,482,458,505,608,103,126,150,275.7629386676854,92,200.6616016576393,24.77870585159647,75.3521958367863,122.96562149275874,0.7219496394583024,598,570,627,750,123,152,180,273.9678459798626,114,205.75760310441296,18.910321969203576,68.80608574725993,119.29640974485554,0.7461129231529283,55018,55405,Caddo+Grady,Grady,40,51,Oklahoma,OK
40017,40CS005,984,917,1051,1086,35,102,169,78.68794919094536,157,121.42774275880738,-92.79733171320878,-46.1482977505568,7.384078464666569,1.5281354472194801,1257,1174,1340,1358,18,101,184,62.91828588622029,186,115.6515034695451,-107.36328263364341,-51.44201610688601,1.2283247186416686,1.8201350236668845,155154,160828,Canadian,Canadian,40,17,Oklahoma,OK
40019,40CS006,482,461,503,590,87,108,129,269.5905894183733,51,127.28785357737104,91.30414055567523,142.02534251336817,192.53157746304763,0.46782139677059104,587,562,612,817,205,230,255,477.4594561585748,153,317.1050177205745,107.05691779734842,159.71354480647787,214.26810140484807,0.6612801494150395,48080,48249,Carter+Johnston+Love+Marshall,Carter,40,19,Oklahoma,OK
40069,40CS006,121,117,126,125,-1,4,8,44.68531342232726,19,220.24729520865532,-222.6123181542059,-174.61590556442607,-123.23390576404742,3.9136097121120694,146,141,152,177,25,31,36,296.64414013413773,34,330.4499951404413,-79.62953917653854,-33.41954982583544,18.21767388661784,1.0786214955665892,10352,10289,Carter+Johnston+Love+Marshall,Johnston,40,69,Oklahoma,OK
40085,40CS006,100,99,101,119,18,19,20,224.63913238804213,17,200.86648286727058,11.667610796651964,23.593139768472458,35.096303413146295,0.8494920644370887,123,122,125,148,23,25,26,242.7946932501539,25,244.9779519843214,-15.327161359662863,-1.82130063258956,11.34658018574739,0.9698493826704649,10156,10205,Carter+Johnston+Love+Marshall,Love,40,85,Oklahoma,OK
40095,40CS006,159,153,166,220,54,61,67,467.01813446339054,19,146.1351108832201,268.2078066431403,320.9462140413322,376.50936467510274,0.30784116264976336,194,186,202,267,65,73,81,471.4648491806325,34,218.55113453750724,197.42715380371067,252.90381863713935,306.21841739662085,0.4573224867316289,15602,15557,Carter+Johnston+Love+Marshall,Marshall,40,95,Oklahoma,OK
40023,40CS007,170,164,176,232,56,62,68,519.5362029591486,22,184.96461851047434,283.6991308061672,334.8914677175627,386.8600757604814,0.3503491443291113,206,199,214,295,81,89,96,619.6303556274593,54,377.86019172906026,191.77014391709545,243.12647137955693,293.5652609256363,0.6030058224008824,14273,14291,Choctaw+McCurtain+Pushmataha,Choctaw,40,23,Oklahoma,OK
40089,40CS007,325,312,338,476,138,151,164,583.5744282523154,84,324.3034553761019,208.27446146073692,260.03194601377356,310.3162117625842,0.552066788625269,392,376,408,602,194,210,226,680.1227049422982,114,369.29057337220604,258.2428820070918,309.60436455582914,363.05428981345597,0.540402482912023,31082,30870,Choctaw+McCurtain+Pushmataha,McCurtain,40,89,Oklahoma,OK
40127,40CS007,138,133,143,159,16,21,26,233.62437792749222,10,110.77263915812793,71.32814100996184,123.19373495345918,174.23475655400128,0.4526844949780162,167,161,172,253,81,86,92,799.157999068949,45,416.20421753607104,334.4262023529072,383.8736624536392,437.81438700303914,0.5148449072899988,10833,10812,Choctaw+McCurtain+Pushmataha,Pushmataha,40,127,Oklahoma,OK
40027,40CS008,1824,1697,1951,2071,120,247,374,100.51140728431326,238,96.97496511142275,-49.29042217719686,2.244346130238549,53.70076296812415,0.9609200915530732,2274,2121,2428,2571,143,297,450,99.71160883774759,309,103.91200099540299,-57.782633465449955,-4.131594903266031,44.784158713446246,1.0386225758940684,294509,297367,Cleveland,Cleveland,40,27,Oklahoma,OK
40031,40CS009,883,831,935,1077,142,194,246,191.9619741179638,92,91.05905641702408,50.89381570063942,101.36039723416998,157.25591821262222,0.471926572745635,1092,1029,1155,1431,276,339,402,278.3233479733122,224,183.7164860941383,41.013309429061145,94.03013922643247,143.76354844533327,0.6581434959017113,121240,121927,Comanche,Comanche,40,31,Oklahoma,OK
40033,40CS010,62,61,62,84,22,22,23,477.5609859588447,13,280.97982708933716,184.88330052601583,196.6409497039998,207.80109678392634,0.5628886243863856,75,74,76,107,31,32,33,582.0113754319121,15,273.2738203680087,296.6398150664637,308.44465158057494,321.6199851509768,0.4552821231300389,5552,5489,Cotton+Jefferson+Stephens,Cotton,40,33,Oklahoma,OK
40067,40CS010,65,64,65,88,23,23,24,513.508932469615,5,110.4158998895841,391.5529367187712,402.84620658897757,415.4114313245002,0.20615669522280491,79,78,80,97,17,18,19,328.7890057382029,12,221.32054592401326,94.79647351943376,107.30189589766071,119.5867250948903,0.6373845175793309,5434,5422,Cotton+Jefferson+Stephens,Jefferson,40,67,Oklahoma,OK
40137,40CS010,484,465,502,541,39,57,76,160.24031656661015,56,156.7676013623851,-48.53418653870379,3.083072251823432,52.011179205328396,0.9615300126624698,597,574,619,698,79,101,124,235.39410878406778,110,255.3744718391605,-68.91841534272798,-19.771735483619338,31.878335737711012,1.0742852799665135,42866,43074,Cotton+Jefferson+Stephens,Stephens,40,137,Oklahoma,OK
40035,40CS011,172,166,178,196,18,24,30,206.89240020330493,19,161.2675060121658,-5.9320045619152495,45.57400379792935,96.84480765726548,0.7487574679975781,209,201,216,225,9,16,24,116.10585742577722,27,191.21813031161474,-125.44068411768566,-75.61876765903646,-26.810291771134555,1.5522462753500061,14138,14120,Craig+Mayes,Craig,40,35,Oklahoma,OK
40097,40CS011,402,385,419,470,51,68,85,207.03149669354906,53,161.51150388541825,-1.8758912290684695,44.00622805900278,97.78390811013837,0.7688136053894186,489,469,509,652,143,163,183,415.6899668637239,86,219.69600204368376,141.78597429916078,195.4490099563408,248.37567737904828,0.5252811799456467,39378,39145,Craig+Mayes,Mayes,40,97,Oklahoma,OK
40037,40CS012,733,703,764,801,37,68,98,113.06541309498782,100,167.266036631262,-105.90071170581672,-54.68689395232947,-1.1846283473459038,1.4578076098486918,898,861,935,1072,137,174,211,241.50437323257864,188,261.1401266807423,-68.64139737496436,-18.092906267362185,32.64938173846309,1.075122292267535,71742,71992,Creek,Creek,40,37,Oklahoma,OK
40041,40CS013,450,433,468,612,144,162,179,475.85261408292644,88,258.5510368973876,167.3543196009999,216.59621536393234,269.0124939359358,0.540008484107349,551,530,573,751,178,200,221,487.6470842480752,118,288.42393429800546,149.0935138663398,197.97373909109925,250.02969480739176,0.5885105530375433,40843,40912,Delaware+Ottawa,Delaware,40,41,Oklahoma,OK
40115,40CS013,360,347,373,408,35,48,61,190.4125442209561,53,209.45856935845077,-71.12248112897204,-19.815604763473207,30.448642657254684,1.0776580572078578,438,423,454,566,112,128,143,420.9536998588386,74,244.05527522179347,126.13276110506085,178.7408870267813,226.3865095199223,0.5752605112533653,30364,30321,Delaware+Ottawa,Ottawa,40,115,Oklahoma,OK
40047,40CS014,600,573,627,709,82,109,136,209.5753911567474,128,246.28409254894413,-92.78143467253432,-36.831358105060836,16.4217731486601,1.1644666265526809,730,698,762,862,100,132,164,213.28686523436636,92,148.31772235567234,15.39094076296228,65.81938999105698,115.24942402462192,0.690174046523192,62367,62029,Garfield,Garfield,40,47,Oklahoma,OK
40049,40CS015,285,274,296,361,65,76,87,350.9950166117605,47,217.3745471363601,81.00769665450197,132.6965109717006,185.73209283057338,0.6112551118385412,349,336,362,454,92,105,118,407.3822729871764,72,279.3079370005431,76.5109479692896,128.79750477165834,176.35465234192137,0.6791491620728354,25946,25778,Garvin+McClain+Murray,Garvin,40,49,Oklahoma,OK
40087,40CS015,349,331,367,389,22,40,58,115.15425802628323,62,177.78202585485914,-117.04792865739817,-61.34810153910239,-11.697774428056512,1.5063501941312474,444,422,466,438,-28,-6,16,-14.049482289657268,51,117.84278386247054,-187.8298136284544,-131.4518058219248,-81.26239285941142,-10.038708185373194,41849,43278,Garvin+McClain+Murray,McClain,40,87,Oklahoma,OK
40099,40CS015,165,159,171,183,12,18,24,152.5908534572698,16,138.28867761452028,-35.96481851765587,14.299119586971587,64.63083182356853,0.8576898605678095,201,193,208,242,34,41,49,301.43088834549053,42,305.6768558951965,-54.94622155854473,-5.758035027530089,49.494940588192264,0.990178278815198,13884,13740,Garvin+McClain+Murray,Murray,40,99,Oklahoma,OK
40053,40CS016,50,50,51,66,15,16,16,447.64417505662965,5,143.3006926200143,291.7573794950525,304.18502897513446,316.49080583143626,0.30085953146791156,61,61,62,70,8,9,9,214.00888458377554,4,96.71179883945841,104.9185771352871,117.4749343937763,130.5830500733447,0.4060333524573853,4187,4136,Grant+Kay,Grant,40,53,Oklahoma,OK
40071,40CS016,500,481,518,606,88,106,125,293.1799794018434,102,280.8692260033502,-40.02327106180062,13.146690119381162,64.19529165739539,0.9490954278300764,614,591,637,681,44,67,90,153.44285121376035,90,205.9308072487644,-102.12624410558631,-52.94188718210884,-3.4879996638305224,1.3223497261799904,43579,43704,Grant+Kay,Kay,40,71,Oklahoma,OK
40061,40CS017,137,132,142,152,10,15,20,150.70175903746815,13,133.1285202252944,-35.58154958354376,16.701514226320597,69.83708781426809,0.8271810801956752,166,160,172,197,25,31,37,264.1591956603083,34,293.2551319648094,-82.03672026841951,-29.7366095039404,27.553575515650127,1.0750438418460406,11718,11594,Haskell+Latimer+Pittsburg,Haskell,40,61,Oklahoma,OK
40077,40CS017,116,115,117,100,-17,-16,-15,-203.8483298726981,10,125.75979878432193,-341.7180297454168,-329.75812193507556,-317.69825869304583,-0.6574907391899146,140,139,142,168,26,28,29,291.7481314743917,27,286.25954198473283,-6.849824507703448,5.652275372434629,17.688774709476096,0.9467809597230328,9542,9432,Haskell+Latimer+Pittsburg,Latimer,40,77,Oklahoma,OK
40121,40CS017,509,490,528,586,58,77,96,211.0627984048163,52,142.7623601546592,17.411454774667483,67.87067325593446,117.91738609606992,0.6677121887113368,619,597,642,810,168,191,213,437.0561944749659,136,311.59071642953694,76.5322394543732,125.8999244452309,178.16686019786124,0.7092127674985262,43709,43647,Haskell+Latimer+Pittsburg,Pittsburg,40,121,Oklahoma,OK
40063,40CS018,167,161,173,183,10,16,22,143.2347810643793,26,234.093637454982,-141.41630848032352,-90.23666973549435,-40.01225332189463,1.5376781702693272,205,198,212,229,17,24,31,176.79484847227727,29,216.49869354236654,-92.56476133455746,-39.12839495621878,12.244028138583328,1.1749610158221,13328,13395,Hughes+Okfuskee+Pontotoc+Seminole,Hughes,40,63,Oklahoma,OK
40107,40CS018,153,149,158,174,16,21,25,218.3058703721924,28,296.34856235667667,-129.6387355804599,-79.31816549113749,-22.839058719966165,1.2947218714032562,186,180,192,191,-1,5,11,45.97473779858197,30,267.78541462108365,-274.4785668532582,-221.42821123223854,-171.3334291267402,4.8776126699069655,11338,11203,Hughes+Okfuskee+Pontotoc+Seminole,Okfuskee,40,107,Oklahoma,OK
40123,40CS018,376,360,393,429,36,53,69,166.4198625086785,43,135.34071237475737,-19.363927179929014,31.023301618442872,82.62180736451681,0.7981532740370443,463,443,483,599,116,136,156,356.58287536560414,79,207.0773263433814,97.73030578004675,148.28566163245594,197.75952654619311,0.5764893054095938,38126,38150,Hughes+Okfuskee+Pontotoc+Seminole,Pontotoc,40,123,Oklahoma,OK
40133,40CS018,282,272,292,353,61,71,81,359.30806384507446,41,208.18347226336053,103.73129602236259,150.42192599851975,202.7473141928113,0.5713272140756869,345,333,357,428,71,83,95,351.4968082097689,62,263.18023601324387,41.438491836373714,87.47491404527877,139.81868317238488,0.7398072041214778,23633,23558,Hughes+Okfuskee+Pontotoc+Seminole,Seminole,40,133,Oklahoma,OK
40079,40CS019,524,503,545,630,85,106,127,262.20358784574535,59,146.2477536097168,61.90578349804809,116.07482913442692,169.60203531999335,0.552540606670555,643,618,668,798,130,155,180,320.4329035984127,104,214.76066575806385,55.89590351935687,104.5747156189064,160.9303357422871,0.6659288606183797,48411,48426,Le Flore,Le Flore,40,79,Oklahoma,OK
40081,40CS020,321,307,335,382,47,61,75,217.060151554616,50,177.93066635034546,-8.83728135480581,39.61072734171434,92.02391926788016,0.8065073995216022,393,376,411,485,74,92,109,271.22129855625127,69,204.2870677404074,13.878631584029716,65.46137047934822,121.65657417334926,0.745078386335883,33721,33776,Lincoln+Logan,Lincoln,40,81,Oklahoma,OK
40083,40CS020,343,322,365,366,1,23,44,54.96547606148621,31,74.98941681617514,-76.8830707851748,-20.88734740131351,29.609326710896248,1.3067889504672932,430,404,456,509,53,79,105,155.8012449817006,84,165.62820411704394,-60.88371935473871,-11.196145430456092,40.16561300149107,1.0497879506428274,49607,50716,Lincoln+Logan,Logan,40,83,Oklahoma,OK
40091,40CS021,249,241,258,306,48,57,65,356.3709087480685,34,213.92617449664428,88.12207171665564,142.82384182941735,192.78145789824356,0.5898761660141436,308,298,318,416,98,108,118,563.9923410633824,67,348.9401593666997,166.23799354791458,215.27808872747121,264.102909143166,0.6130356855680931,19072,19201,McIntosh+Okmulgee,McIntosh,40,91,Oklahoma,OK
40111,40CS021,426,410,442,538,96,112,128,363.4579682078546,57,185.11502029769957,125.71743783197448,179.84101853349244,231.479078814279,0.5048055448991285,522,503,541,670,129,148,167,401.18280328272033,103,279.7468698226459,69.16213909275498,120.92167343975707,174.75320309655,0.6926162572128925,36950,36819,McIntosh+Okmulgee,Okmulgee,40,111,Oklahoma,OK
40003,40CS022,51,51,52,66,14,15,15,305.51267259729394,5,105.15247108307045,187.46802414363725,200.05278136445378,212.4309742904686,0.32201706166154515,64,63,64,53,-11,-11,-10,-186.69531443847825,2,35.02626970227671,-234.64481352334747,-221.5345288347807,-209.62574157445923,-0.20703285527891238,5706,5710,Major and Nearby Counties,Alfalfa,40,3,Oklahoma,OK
40011,40CS022,104,103,105,135,30,31,32,421.90822283070105,17,231.71285779191274,178.2309186671955,190.29607429182212,201.94069919527126,0.5320147720936601,125,124,126,162,36,37,38,432.37404794290734,21,244.64119291705498,175.49417803030428,187.83938195365226,201.31080883361219,0.5509643568103407,8804,8584,Major and Nearby Counties,Blaine,40,11,Oklahoma,OK
40043,40CS022,54,53,54,61,7,7,8,197.5173861404582,13,344.82758620689657,-158.7903862308461,-147.4552383634131,-134.91599538598757,1.5391162625829076,64,64,65,85,20,21,21,463.82867182829324,10,226.03978300180833,225.06464541160761,237.9618690464969,251.5224549334893,0.464688755868069,4524,4424,Major and Nearby Counties,Dewey,40,43,Oklahoma,OK
40073,40CS022,138,132,145,152,7,14,20,108.40101454207529,33,259.3999737979824,-201.63956343280964,-151.68433899683038,-98.15018452861531,2.231174606244511,170,162,177,173,-4,3,11,22.717072701930757,19,125.03290339563043,-154.86348958701598,-101.86491657779861,-47.76266230926741,4.267662042111544,15266,15196,Major and Nearby Counties,Kingfisher,40,73,Oklahoma,OK
40093,40CS022,89,88,90,99,9,10,11,155.5619819433785,20,310.7198342827551,-167.0750360520725,-154.95101475627607,-143.3227830776668,1.816034565696946,109,108,110,120,10,11,12,143.7003695395591,14,182.29166666666666,-50.577513630299684,-38.52290253951064,-26.105552923487277,1.1631589301577336,7724,7680,Major and Nearby Counties,Major,40,93,Oklahoma,OK
40151,40CS022,84,84,85,93,8,9,9,118.98667639541016,3,41.78272980501393,65.37272358209995,77.20661547460232,88.82204787735223,0.3143585346406107,104,103,105,100,-5,-4,-3,-44.728744648457436,21,244.64119291705498,-301.7422884718853,-289.6526433666986,-277.59859789464537,-7.395628035531368,8616,8584,Major and Nearby Counties,Woods,40,151,Oklahoma,OK
40101,40CS023,751,723,780,896,116,145,173,261.57057350634074,108,195.06027904456585,15.400520480349384,65.22018567168845,116.91118496873749,0.740613306049962,912,878,947,1150,203,238,272,359.0938386758515,185,279.6758783334341,29.53386556523838,78.1880066328978,129.68744632241246,0.7755727537053071,66441,66148,Muskogee,Muskogee,40,101,Oklahoma,OK
40103,40CS024,118,117,119,123,4,5,6,55.91387512412322,12,131.59097139724022,-87.67029970265473,-75.58673933092695,-63.4043217916318,1.9675745477604838,145,143,146,178,32,33,35,305.88531610324213,23,210.46852122986823,83.69008495481097,95.48047956303569,109.06421112947461,0.6680774265244857,10943,10928,Noble+Osage+Pawnee,Noble,40,103,Oklahoma,OK
40113,40CS024,388,368,407,442,35,54,74,141.96705233995195,43,112.37178509984973,-22.70337320563022,28.59893995750918,78.24786021941864,0.7772272328708676,477,453,500,616,116,139,163,304.7662568467043,99,216.3130639980772,36.19981495001956,87.2218812363539,138.68955028536388,0.7047147485283275,45919,45767,Noble+Osage+Pawnee,Osage,40,113,Oklahoma,OK
40117,40CS024,174,167,181,211,30,37,44,283.93125764914697,26,198.90348081091417,33.28431867377857,85.74822997760666,137.84756915757072,0.6821542340874795,214,206,222,258,36,44,52,281.4692134767991,31,197.30142566191446,34.61609752056773,83.51160165502442,134.2013047008921,0.685470026073594,15686,15712,Noble+Osage+Pawnee,Pawnee,40,117,Oklahoma,OK
40105,40CS025,106,105,107,120,13,14,15,182.27628237110153,14,178.4007645747053,-7.5932905622251745,4.006826647723865,15.602430167207032,0.9147856721171865,128,127,129,164,35,36,37,388.2102086687855,21,225.75790152655344,149.88561923684372,162.7004560246895,174.63657816924302,0.565865175791884,9417,9302,Nowata+Washington,Nowata,40,105,Oklahoma,OK
40147,40CS025,556,534,579,598,19,42,64,94.94257994511935,70,160.0731763091699,-116.07016545738895,-65.67398235703551,-13.525156682657865,1.6463464316091487,683,656,711,786,75,103,130,194.36824885737542,135,255.94357865999316,-112.01340801507472,-61.454690180885535,-11.12195867535063,1.3040772263794256,52476,52746,Nowata+Washington,Washington,40,147,Oklahoma,OK
40109,40CS026,6263,5920,6606,7521,915,1258,1601,189.26982545163744,864,130.0114863543114,4.036150685467059,58.626198247853296,112.23845337166019,0.6863651107157941,7705,7293,8117,8951,834,1246,1658,156.06937042064624,1058,132.51702179892482,-30.552973283020435,22.640150689241874,73.43406346116957,0.8484096278080213,797468,798388,Oklahoma (county),Oklahoma (county),40,109,Oklahoma,OK
40007,40CS027,44,43,44,56,12,12,13,294.23231943997314,10,237.5296912114014,44.67534465361829,56.71636303720688,68.7156192167203,0.7469832717300404,52,52,53,63,10,11,11,212.38662298683187,8,160.481444332999,38.94157858945182,52.37843031622839,64.2849586054105,0.6904007364134497,5052,4985,Oklahoma Panhandle,Beaver,40,7,Oklahoma,OK
40025,40CS027,24,24,24,22,-2,-2,-2,-110.62284599558981,0,0,-122.14274422087144,-110.64667642335061,-97.45344849422308,-0,29,29,29,31,2,2,2,80.25320205047035,4,177.46228926353152,-110.5755343968203,-97.54537156709581,-84.88623674257249,1.4240413626748514,2265,2254,Oklahoma Panhandle,Cimarron,40,25,Oklahoma,OK
40045,40CS027,42,42,42,44,2,2,2,62.636294576111496,6,191.28586609989372,-141.81422753302388,-128.55418348491688,-115.61082909362473,2.0238191552424425,51,51,52,50,-2,-1,-1,-29.712577217932495,5,132.9787234042553,-175.18050475107955,-162.51309054942894,-150.30791223545617,-42.66469944156037,3764,3760,Oklahoma Panhandle,Ellis,40,45,Oklahoma,OK
40059,40CS027,29,29,30,51,21,22,22,778.7839696592692,7,253.5466344702686,513.5319688601874,525.0337951468364,537.2866302364913,0.31109828792990746,35,34,35,38,3,3,4,106.47096907136222,7,219.36696960200564,-125.38928258373869,-113.0658032094048,-100.26883594507532,1.591817648664575,3313,3191,Oklahoma Panhandle,Harper,40,59,Oklahoma,OK
40139,40CS027,157,154,159,159,0,2,5,14.149368693977443,38,216.27774615822426,-214.31016290511118,-202.48477937452756,-189.71827555282596,10.900608005250255,189,187,192,162,-30,-27,-25,-130.18253440315652,25,119.46860365096053,-262.6853091349035,-249.37676623097892,-237.55552571166973,-0.9526713937912997,21084,20926,Oklahoma Panhandle,Texas,40,139,Oklahoma,OK
40153,40CS027,171,162,180,215,35,44,53,259.8858150978225,28,165.27299557304477,41.4475208883561,96.7377892034292,146.22072189278765,0.6218216515153486,209,199,219,251,32,42,52,207.36887567151513,34,168.05891948000593,-13.164964867199156,38.38780903691891,94.21641673513408,0.7915666076953316,20330,20231,Oklahoma Panhandle,Woodward,40,153,Oklahoma,OK
40119,40CS028,512,477,547,568,21,56,91,81.85936119312575,55,80.83579310936102,-54.58763497510893,0.37974227790895504,54.119679137614824,0.970078763717491,638,595,680,764,84,126,169,154.22285311134306,82,100.08421720716213,5.278561931791964,53.198696195711676,105.40294741935993,0.6438627959473382,81647,81931,Payne,Payne,40,119,Oklahoma,OK
40125,40CS029,732,701,764,850,86,118,149,194.65994462875886,79,130.68831938681262,14.892324743923758,64.20386334805157,117.33962501240217,0.6657098738197764,900,863,938,1142,204,242,279,331.37358797880677,146,200.178240899431,80.39518376566234,132.43962143060898,187.39187009543838,0.6015971339350773,72539,72935,Pottawatomie,Pottawatomie,40,125,Oklahoma,OK
40131,40CS030,792,751,833,929,96,137,178,172.662720078658,114,143.90154105085995,-26.206724976399993,27.59053951411488,80.57994947146837,0.8273769108563572,983,933,1033,1125,92,142,192,146.88380841414363,167,173.06775550811452,-75.45325041946306,-25.644948745544152,23.631418428562668,1.170008038399139,95065,96494,Rogers,Rogers,40,131,Oklahoma,OK
40055,40CS031,57,56,57,73,16,16,17,349.16257381536826,19,413.11831853596664,-75.76125342778553,-63.97794445278682,-51.7659408523442,1.1138097413628216,70,69,70,97,27,27,28,499.3261971562944,4,72.89958082741025,413.18096199566037,426.20411517369723,439.2077917207993,0.14085484873493267,5519,5487,Southwest Oklahoma,Greer,40,55,Oklahoma,OK
40057,40CS031,25,24,25,39,14,14,15,699.6761748507814,6,289.6218825422365,398.1037996412455,410.18741411124864,422.4357255419958,0.3872227317776702,29,29,30,45,15,16,16,643.5342948745263,7,288.659793814433,342.10410279791864,354.6633019586756,368.3091535029428,0.42154183180767313,2486,2425,Southwest Oklahoma,Harmon,40,57,Oklahoma,OK
40065,40CS031,220,210,231,281,50,61,71,295.5147575290889,55,267.2930503806901,-18.66199234157477,28.307228312208103,77.64094661570799,0.8898655966298973,272,259,285,287,2,15,28,61.32352587426938,35,141.29995962858297,-130.58633882204688,-81.88182376930695,-29.658345668077533,2.161850006505541,24692,24770,Southwest Oklahoma,Jackson,40,65,Oklahoma,OK
40075,40CS031,126,122,129,160,31,34,38,483.5546275286147,27,380.54968287526424,51.2289774013347,104.16521748688793,157.48569078895886,0.764694868912531,152,147,156,140,-16,-12,-7,-140.6720816039276,20,237.50148438427738,-430.7461415162574,-377.2852613112422,-328.86136136444685,-1.8439984686512618,8514,8421,Southwest Oklahoma,Kiowa,40,75,Oklahoma,OK
40141,40CS031,77,76,77,106,29,29,30,500.0342248327336,18,307.9994296306858,179.61255926511038,191.9106902063673,202.72689919465708,0.5955761893137579,95,94,96,123,27,28,29,397.54260969075165,18,255.02975347123834,130.59047242144663,141.83827943807316,155.69722832246418,0.6194388715584374,7013,7058,Southwest Oklahoma,Tillman,40,141,Oklahoma,OK
40143,40CS032,5207,4919,5495,5987,492,780,1068,140.1444450110543,621,111.58779003167044,-20.32021559266835,27.80504681967584,80.45916193053385,0.7952145198591658,6434,6086,6781,7801,1020,1367,1715,203.34636429405967,1169,173.8383021247234,-26.999416586415453,29.06272910208061,78.01850805238732,0.8542629615126955,667815,672464,Tulsa,Tulsa,40,143,Oklahoma,OK
40145,40CS033,556,521,592,648,56,92,127,134.53349168272828,64,94.03928099133076,-13.329702463489658,39.37105515769545,90.10585677182425,0.6914507837457543,703,659,746,907,161,204,248,244.36536831564638,169,202.0081281377002,-10.050853293589556,41.25754030918897,94.01840410301135,0.8226403589136856,81668,83660,Wagoner,Wagoner,40,145,Oklahoma,OK
41001,41CS001,188,180,195,206,11,18,26,132.96395596743088,1,7.2189135535101965,74.83710477372868,127.05370072984698,173.7980892861927,0.05149640307820783,231,222,240,274,34,43,52,254.90743021272638,31,184.2605801236329,13.16068825167899,71.03785475592281,123.00286532848294,0.7063816284250153,16623,16824,Baker+Harney+Lake+Malheur,Baker,41,1,Oregon,OR
41025,41CS001,75,75,76,78,2,3,3,40.43770920438328,5,80.18174528932245,-51.818316222025295,-39.51235841471507,-27.237812930662386,1.4197978285354251,94,93,94,124,30,30,31,403.22968474403325,30,396.6679888932963,-6.535707009406421,6.524219303180004,18.954751392340494,0.9524940101787223,7483,7563,Baker+Harney+Lake+Malheur,Harney,41,25,Oregon,OR
41037,41CS001,87,86,88,98,10,11,12,166.68203143030877,4,59.02606984751598,95.94504163670595,107.84090619291402,119.9060615422653,0.3253226517072165,108,107,109,144,35,36,37,437.4924841106177,16,193.7749788058617,231.20736981453567,243.85853130599494,255.5950419983555,0.43099089122276957,8132,8257,Baker+Harney+Lake+Malheur,Lake,41,37,Oregon,OR
41045,41CS001,269,255,282,326,44,57,71,219.06225798491673,42,160.08131114216746,7.81706597213907,58.27270518441037,110.35919474383182,0.7182601553067948,331,314,347,392,45,61,78,193.00600859814173,46,145.19743694959124,-2.8697953052810825,48.24429222811035,99.41227619152616,0.7401896679360446,31484,31681,Baker+Harney+Lake+Malheur,Malheur,41,45,Oregon,OR
41003,41CS002,519,478,560,504,-56,-15,26,-19.323468731589724,10,12.637432073802604,-81.26314436404544,-31.39792621999365,19.474676983487953,-0.69975770433841,649,600,699,741,42,92,141,95.71635908350666,23,23.985066688913687,20.00956824771143,71.62198572448713,125.3915198680935,0.24788412519094788,94956,95893,Benton,Benton,41,3,Oregon,OR
41005,41CS003,2989,2807,3170,3188,18,199,381,56.715649296752964,116,33.01535498621988,-26.09535818570731,23.753349879488443,78.68067313355526,0.5792140671402298,3680,3462,3898,4005,107,325,543,76.95192605577996,302,71.48233534209741,-42.38455090169737,5.887258668155475,59.31265180072441,0.9260734678083392,421622,422482,Clackamas,Clackamas,41,5,Oregon,OR
41007,41CS004,350,333,368,348,-20,-2,15,-7.091730757184452,5,14.621308119699776,-76.32368118313656,-22.137582165112438,30.279413843428646,-3.508438251662984,433,412,455,542,87,109,130,260.36843492331286,29,69.53602685529313,135.63050511875974,191.1590554085145,242.80095490065005,0.26463075994359303,41036,41705,Clatsop+Lincoln+Tillamook,Clatsop,41,7,Oregon,OR
41041,41CS004,538,517,560,592,32,54,75,127.43453428951258,14,33.29237842336807,43.55768514121605,93.8346370273266,149.1145890929623,0.25646499911023696,658,632,685,729,44,71,97,138.99551868074394,34,66.92254699340616,18.302663588071816,70.33829694983662,122.79794155225663,0.47474978171401955,50462,50805,Clatsop+Lincoln+Tillamook,Lincoln,41,41,Oregon,OR
41057,41CS004,266,254,278,303,25,37,49,160.78002199006121,1,4.371584699453551,106.3660466845576,156.2289513349935,207.70439437176546,0.02647013121508492,327,312,341,412,71,85,100,308.0118728446693,42,151.580770896492,103.81655631957595,156.8224523847059,205.5891819445009,0.48642678335819206,27450,27708,Clatsop+Lincoln+Tillamook,Tillamook,41,57,Oregon,OR
41009,41CS005,402,380,425,447,22,45,67,101.59879656301595,22,50.118652112007595,-3.574384661102491,51.378182955146684,101.35792672481325,0.4824811277101745,497,469,524,629,105,132,160,249.5613029536571,58,109.41538229357279,91.25057055549138,138.75079541859918,194.18855702608897,0.43514158065833497,52675,53009,Columbia+Washington,Columbia,41,9,Oregon,OR
41067,41CS005,2960,2701,3218,3194,-24,234,493,46.8122643649176,131,26.16785714880222,-32.900464408624664,22.003130497354302,70.03580040334984,0.5566205771550012,3675,3365,3986,4156,170,481,791,79.98729596451068,243,40.44654315213393,-9.068258275568985,40.034863256158395,90.47040950399747,0.5046120345459173,600737,600793,Columbia+Washington,Washington,41,67,Oregon,OR
41011,41CS006,783,755,811,777,-34,-6,22,-11.253365578643175,10,18.4991058765493,-80.1040305737969,-31.38917645260409,23.968166963878318,-1.9672669135203842,953,919,986,1139,153,186,220,286.5185799853895,98,150.80867303756366,84.22419674974442,135.22688791366838,187.55379559735226,0.5235368020542108,64868,64983,Coos+Curry,Coos,41,11,Oregon,OR
41015,41CS006,336,326,346,393,47,57,67,293.6763288575175,5,25.590719099206687,217.89061988534635,268.3718984911281,321.93250785359805,0.08564656122953047,410,398,422,512,90,102,114,431.20554844562133,36,152.17483197362304,232.35495864629445,278.8665659527521,331.2939078925291,0.3494796266946637,23446,23657,Coos+Curry,Curry,41,15,Oregon,OR
41017,41CS007,1368,1282,1454,1333,-121,-35,51,-20.770327245011078,24,14.425966740132237,-88.31787889751517,-35.11204121915952,16.674711805435894,-0.7152457381197287,1713,1608,1818,1824,6,111,216,54.40715857780534,167,81.85993617866053,-75.27737537249092,-27.41966122178324,21.468091106131535,1.4911458260994612,199640,204007,Deschutes,Deschutes,41,17,Oregon,OR
41019,41CS008,1302,1254,1350,1421,71,119,167,128.3058141424602,35,37.74704090161504,40.48432425053121,92.0076569846308,141.73979247512017,0.2917435933298847,1596,1539,1654,2054,400,458,515,408.9772537050084,244,218.11030660588185,138.03335551379374,190.51958528043156,241.70880798415436,0.5321435955057333,111267,111870,Douglas,Douglas,41,19,Oregon,OR
41027,41CS009,166,155,176,156,-20,-10,1,-48.52133692278152,12,60.331825037707375,-161.2327712027245,-110.14421822555384,-57.46723168045236,-1.3871398862794446,204,192,217,200,-17,-4,8,-17.132308298314385,17,70.71547420965058,-140.35349832781336,-86.73540684737272,-35.51677862289971,-5.451151896924642,23868,24040,Hood River+Jefferson+Sherman+Wasco,Hood River,41,27,Oregon,OR
41031,41CS009,182,171,192,272,80,90,101,439.5836418359744,19,92.70553793608197,295.2058855069647,346.7629448445593,397.5787752115902,0.20857880819057512,226,213,239,327,88,101,114,403.81267073392655,37,148.07107411557547,206.01536685952237,253.66359558127613,305.4970806117661,0.3630842965042498,24594,24988,Hood River+Jefferson+Sherman+Wasco,Jefferson,41,31,Oregon,OR
41055,41CS009,17,16,17,16,-1,-1,0,-44.3560116708063,2,128.75536480686694,-225.43159208554968,-174.66719756316735,-121.47401597459437,6.430800232722243,21,20,22,26,4,5,6,278.3013783586351,5,262.88117770767616,-34.593624242517656,16.54397190943701,66.71851515140372,0.7944967161996958,1864,1902,Hood River+Jefferson+Sherman+Wasco,Sherman,41,55,Oregon,OR
41065,41CS009,278,266,289,295,6,17,29,78.1924385959429,27,121.75416181278418,-93.40730391871281,-44.42951299615148,9.255535817132143,1.4722059890274282,339,325,353,374,21,35,49,130.984857554456,28,104.83357669699353,-25.870594099722645,25.291490391588802,75.19314048486089,0.7781074877660565,26611,26709,Hood River+Jefferson+Sherman+Wasco,Wasco,41,65,Oregon,OR
41029,41CS010,2084,1988,2180,2242,62,158,254,85.09642379826983,68,36.58323358125647,-0.8028474842019213,47.420974045598875,101.96727451144184,0.4272024820576492,2551,2435,2666,2929,263,378,494,169.02229628209386,292,130.5412993329876,-10.697397431868874,38.1757546680957,92.66548204558433,0.7702944224194177,223053,223684,Jackson,Jackson,41,29,Oregon,OR
41033,41CS011,1068,1030,1106,1112,6,44,82,59.613595655666686,25,34.06458645592043,-26.97230608499906,24.619283975852497,77.37568756243938,0.5586540014632234,1305,1259,1350,1583,233,278,324,315.0422681034353,224,253.64903579395545,10.535198349429102,60.45766242074512,112.53467395448175,0.8022434813885864,88068,88311,Josephine,Josephine,41,33,Oregon,OR
41035,41CS012,719,689,748,779,31,60,90,104.48106970115617,25,43.22579715574255,13.933657989997613,60.884256199126035,116.36447177127211,0.40698386038335443,887,851,924,1074,150,187,223,266.2847333693582,150,214.0777530399041,-1.0309034793756124,52.193917857311085,103.03077735395398,0.7996571625486553,69403,70068,Klamath,Klamath,41,35,Oregon,OR
41039,41CS013,3182,3017,3346,3372,26,190,355,59.609098021666256,76,23.822086626719393,-15.193817789967738,34.3235772244482,88.392354530296,0.39754796827313926,3910,3712,4108,4528,420,618,816,161.2653554348974,233,60.81121640702278,46.466380355727964,101.48677289966504,150.8973874056205,0.3764786193881578,382838,383153,Lane,Lane,41,39,Oregon,OR
41043,41CS014,1155,1099,1210,1247,37,92,148,85.96080945600544,35,32.52611769808018,1.976011604628743,53.78467110719125,104.93765337295821,0.3743361735327399,1420,1353,1487,1726,239,306,373,235.85129830060114,152,117.18719884046351,67.67499811823103,117.66070346492849,168.98390091971865,0.4952500898070279,129127,129707,Linn,Linn,41,43,Oregon,OR
41047,41CS015,2445,2296,2594,2685,91,240,389,83.1130255620398,182,63.031212571609984,-29.90064329924297,20.441638492508353,68.13919174210423,0.7552324800934862,3013,2834,3192,3458,266,445,624,128.27503035381184,304,87.61185642030635,-13.553818131682743,42.041056960039924,90.77729886330913,0.6814690195197568,346495,346985,Marion,Marion,41,47,Oregon,OR
41051,41CS016,4978,4628,5328,5449,121,471,821,69.47000368063603,389,57.34157669681562,-38.748750255072565,12.406955074440608,61.98258241304138,0.8236671774922589,6081,5665,6497,6896,399,815,1231,101.226361120992,422,52.40940438326426,-0.7057668737574757,48.007853467498535,101.00073528672088,0.5171101913433485,814069,805199,Multnomah,Multnomah,41,51,Oregon,OR
41053,41CS017,631,593,668,669,1,38,76,52.63816057245575,25,34.20557550880793,-31.975771563450163,19.86939447826635,68.44312818758615,0.6333617108434386,786,740,832,842,10,56,102,62.77184913270274,68,76.42682131858746,-65.97222684301913,-13.099412391577733,34.39427130712993,1.1961170161873622,87705,88974,Polk,Polk,41,53,Oregon,OR
41013,41CS018,245,234,256,211,-45,-34,-23,-163.41373002423921,2,9.626955475330925,-225.64652082053337,-173.93354488752215,-120.64118500368757,-0.06069949660569293,308,295,321,321,0,13,26,51.66855739033317,46,179.5472287275566,-179.91862216555577,-125.85119814110426,-71.7456249002697,3.2309078413461907,24930,25620,Umatilla and Nearby Counties,Crook,41,13,Oregon,OR
41021,41CS018,18,18,18,14,-4,-4,-4,-239.61909495177864,5,300,-552.0511619061093,-539.8180172505092,-527.7283605088227,-1.6702010444966298,22,22,22,37,15,15,15,747.3595367930144,5,249.1280518186348,485.5670037291671,498.1519706431523,510.0787200520299,0.31250965062154074,2000,2007,Umatilla and Nearby Counties,Gilliam,41,21,Oregon,OR
41023,41CS018,77,77,78,85,7,8,8,125.33292736174772,5,83.10249307479225,29.90737918310645,42.595077129163116,54.74873742101107,0.5854208343547054,95,94,96,115,19,20,21,276.15027002122895,14,192.70474879559532,70.92374078133851,83.64451391398066,96.0950051663477,0.6646941987532841,7220,7265,Umatilla and Nearby Counties,Grant,41,23,Oregon,OR
41049,41CS018,77,75,78,96,18,19,21,192.62228647283007,11,108.92886614952963,71.45836827876703,83.80820430024215,96.29362175597126,0.5378541621873228,95,93,96,122,26,27,29,222.71880020050338,14,113.94156425490357,95.80892033551186,109.15720026285595,120.66980560508762,0.49355802807764654,12118,12287,Umatilla and Nearby Counties,Morrow,41,49,Oregon,OR
41059,41CS018,593,559,627,709,82,116,150,174.50586984297573,60,90.36371394864328,27.451036723803636,83.84166199380368,134.1066827636887,0.5133953877685848,733,692,775,885,110,152,193,189.76266660961056,101,126.26420472303134,10.31937206444304,64.41651533751818,118.576275621991,0.6610248105379088,79678,79991,Umatilla and Nearby Counties,Umatilla,41,59,Oregon,OR
41061,41CS018,242,231,254,247,-7,5,16,21.55393169451207,5,22.86498227963873,-54.15406837668173,-1.0993963433543992,48.01133225675974,0.8751500424382584,297,284,311,374,63,77,90,293.0954299878469,49,187.0014883791932,50.06921787417924,105.75372308010054,155.33173928585143,0.6298217067624905,26241,26203,Umatilla and Nearby Counties,Union,41,61,Oregon,OR
41063,41CS018,77,76,78,61,-17,-16,-15,-260.48033583103353,3,48.833423765599555,-321.64986874675037,-309.7590810106572,-297.00914078928525,-0.19997100023372208,96,95,97,103,6,7,8,96.94116796647172,1,13.294336612603033,70.37085552703128,83.76894778340538,96.6454118950641,0.12059940817948235,7372,7522,Umatilla and Nearby Counties,Wallowa,41,63,Oregon,OR
41069,41CS018,16,15,16,17,1,1,2,120.32215924385689,6,500,-432.02495301532565,-380.063745638935,-327.8592736935394,2.455126516219484,19,18,20,21,1,2,3,131.43010877004602,1,68.87052341597796,13.311541228102053,63.33850857960226,115.23329092820856,0.3438357765741661,1440,1452,Umatilla and Nearby Counties,Wheeler,41,69,Oregon,OR
41071,41CS019,828,781,874,883,9,55,102,61.64120193093674,37,41.209556161942416,-31.627783650601973,21.615289339015483,72.561382549373,0.6566739450231287,1018,962,1074,1251,177,233,289,215.2730186186624,102,94.28729894620078,69.61003257677764,119.78105051259479,168.28976789490866,0.4361167028108466,107742,108180,Yamhill,Yamhill,41,71,Oregon,OR
42001,42CS001,907,862,952,996,44,89,134,102.90016364020039,81,93.74909578418416,-40.667921808558795,9.405705831459365,56.93468384642478,0.9009349814495708,1114,1060,1168,1234,66,120,174,115.14120606176876,172,165.25908204344776,-99.38645482771993,-51.31073831511536,2.346387807086945,1.423395472519176,103681,104079,Adams,Adams,42,1,Pennsylvania,PA
42003,42CS002,11874,11339,12410,12850,440,976,1511,94.19354238750451,1108,106.98448741025284,-61.97570525363368,-13.842936040384995,39.711000884745864,1.1346311944718364,14463,13823,15103,15249,146,786,1426,63.37353628625279,1390,112.12932786938143,-100.36784612039705,-49.43419398539374,0.600998585074261,1.7670905829424957,1242797,1239640,Allegheny,Allegheny,42,3,Pennsylvania,PA
42005,42CS003,727,699,755,785,30,58,86,105.91937817196339,43,79.0199081163859,-24.853292780684175,26.869338517418676,79.74409146025982,0.733315433038038,885,851,919,1101,182,216,250,331.5437283595405,185,283.9862458553359,-2.52561185939549,47.21116930700214,102.81735210977479,0.8526098181808693,65300,65144,Armstrong,Armstrong,42,5,Pennsylvania,PA
42007,42CS004,1872,1800,1944,2109,165,237,309,170.2805402514962,243,174.54179785234578,-55.98644925387258,-4.943878904180778,47.662426078351935,1.020719316149537,2279,2193,2366,2444,78,165,251,98.64343682932366,310,185.86691928579137,-140.1975734589185,-86.84261605643464,-36.00645260969932,1.8728464997099485,167066,166786,Beaver,Beaver,42,7,Pennsylvania,PA
42009,42CS005,479,459,500,635,135,156,176,392.34060771847663,98,247.1990414731045,91.8161924224915,147.46245813725784,193.35551355708975,0.6260374157649443,582,558,607,709,102,127,151,267.1425579825802,138,290.7099220560354,-75.80053745771389,-22.80756518278038,31.524433078165355,1.0797059909239866,47573,47470,Bedford+Fulton,Bedford,42,9,Pennsylvania,PA
42057,42CS005,146,139,152,146,-6,0,7,2.485277277730058,13,107.29761331590893,-153.57052052470056,-103.70350328586522,-54.26565248677515,9.991453058646645,177,170,185,237,52,60,67,412.73577472690033,44,302.88428443587804,58.35282612978297,110.82874212400664,161.91107951535363,0.7218069663741712,14539,14527,Bedford+Fulton,Fulton,42,57,Pennsylvania,PA
42011,42CS006,3470,3286,3654,3927,273,457,641,128.19809981339546,575,161.38538830727776,-82.41770478601896,-33.23708154952586,14.164769875978346,1.2561249476433742,4268,4046,4489,4822,333,554,776,129.1229290070497,678,157.9506485761145,-80.86640647627358,-26.65784820997966,21.977889939340685,1.2210548974730426,427548,429248,Berks,Berks,42,11,Pennsylvania,PA
42013,42CS007,1353,1300,1406,1613,207,260,313,254.93150715770105,193,189.2837294452254,10.720521337811514,64.67342575486464,114.08930475011803,0.7396430927484009,1643,1580,1706,1874,168,231,294,189.28296588144065,302,247.79080548421769,-109.45848718485662,-60.6381962001419,-7.517078600256791,1.3034523341005122,122356,121877,Blair,Blair,42,13,Pennsylvania,PA
42015,42CS008,587,562,613,592,-21,5,30,9.28672568986278,57,114.10459587955626,-150.79830869922296,-106.09809229142834,-54.193859888772195,10.107984432953327,720,689,751,841,90,121,152,202.42157418464404,106,177.00001669811476,-31.44892434851949,26.34675273832447,74.3137301194449,0.8672586357488076,59945,59887,Bradford+Sullivan,Bradford,42,15,Pennsylvania,PA
42113,42CS008,80,79,80,88,8,8,9,172.22418069620235,3,61.443932411674346,98.2898640533377,110.8797519693321,123.16678247254077,0.31884889181606135,98,97,98,131,33,33,34,569.6530259576218,23,392.22373806275584,164.3168000278013,177.8023971230099,190.42299037815658,0.6685181044561707,5859,5864,Bradford+Sullivan,Sullivan,42,113,Pennsylvania,PA
42017,42CS009,5337,5060,5614,6046,432,709,986,132.20658457777628,875,163.1792920816083,-81.23886569178651,-32.211865991793246,16.343657306473688,1.232536458862604,6569,6235,6902,6909,7,340,674,52.68767171229475,589,91.16447526254285,-92.73030177261242,-37.80523851009613,15.469872473589025,1.7252128747939781,643464,646085,Bucks,Bucks,42,17,Pennsylvania,PA
42019,42CS010,1774,1691,1857,1973,116,199,282,123.73959584217938,226,140.4548208838503,-67.82019109850872,-16.182548665119697,31.66260538613436,1.1294114193621418,2184,2084,2284,2421,137,237,337,122.13236837428653,332,170.94809253852767,-96.49629041915148,-49.23816686370363,3.468300701327249,1.3938189523344322,193087,194211,Butler,Butler,42,19,Pennsylvania,PA
42021,42CS011,1594,1537,1651,1844,193,250,307,226.54660611152767,280,253.66339773061853,-80.74172954758451,-27.791905836408237,24.63866168278122,1.1152365681529024,1938,1869,2006,2071,65,133,202,100.76810757409065,297,224.52034290379643,-174.16120690936432,-123.02798269158673,-69.64783394957941,2.2114986781846175,132459,132282,Cambria,Cambria,42,21,Pennsylvania,PA
42025,42CS012,685,657,712,827,115,142,170,263.9846887814044,93,172.4111294782864,38.06982958007139,90.70589408870133,143.48804929355308,0.6485557315850509,839,805,873,996,123,157,191,240.34356801030205,143,218.93563598505725,-28.1120633398766,22.636592937859824,76.35062332326487,0.9051617997741153,64729,65316,Carbon,Carbon,42,25,Pennsylvania,PA
42027,42CS013,826,758,894,1047,153,221,289,167.54404911807902,141,106.75415628253256,6.992235963013129,61.23211763367527,111.64394144070178,0.6343042997205273,1021,940,1102,1222,120,201,282,127.58762039976925,127,80.59091543665046,-3.2294881428198488,46.74767318609939,97.56596068509891,0.6285254727359523,158495,157586,Centre,Centre,42,27,Pennsylvania,PA
42029,42CS014,3516,3286,3745,3919,174,403,633,90.68498544255297,555,124.79762547220724,-85.71497621287705,-34.75178674959381,16.637329709432077,1.3727624775913896,4368,4090,4645,4407,-238,39,317,7.314592800736435,351,65.2337542861922,-108.17014897787148,-57.25251362862362,-8.231142018994948,8.697319078562433,533664,538065,Chester,Chester,42,29,Pennsylvania,PA
42031,42CS015,341,325,357,451,94,110,126,352.76874861056075,48,154.1425818882466,146.5197423898401,198.34726275243332,249.7017124858868,0.43300904320078765,416,397,436,599,163,183,202,491.52080576211796,116,312.17201754622033,129.38388872159945,179.90087291792474,228.34851008226676,0.6316561577162082,37368,37159,Clarion+Jefferson,Clarion,42,31,Pennsylvania,PA
42065,42CS015,475,456,494,526,32,51,70,138.5493874507062,58,157.3485858974069,-69.32683692395145,-17.5094761393262,30.40991485075816,1.1138753401629,578,555,601,656,55,78,101,176.21893885203494,123,278.5326086956522,-152.78267205839012,-102.64383648547962,-52.517072982150296,1.5605516220185807,44233,44160,Clarion+Jefferson,Jefferson,42,65,Pennsylvania,PA
42033,42CS016,826,792,861,878,17,52,86,77.79097521472964,54,80.81311966078444,-51.798317610569676,-4.605261413707723,49.35408772121586,1.0192414304234327,1011,969,1052,1231,179,220,262,275.1596131718087,206,257.08865814696486,-34.50819827892171,17.915157043636963,68.53520505837592,0.9301069975072522,80185,80128,Clearfield,Clearfield,42,33,Pennsylvania,PA
42035,42CS017,346,330,362,371,9,25,41,79.15012722660131,29,92.79752539932268,-60.422903654616256,-13.989859025499548,36.21671277084305,1.126866766103547,426,407,445,491,46,65,84,173.73183634292508,74,197.60734885708183,-73.10951199940942,-25.976130061194663,29.039176863944515,1.120209057614474,37501,37448,Clinton+Potter+Tioga,Clinton,42,35,Pennsylvania,PA
42105,42CS017,181,174,188,188,0,7,14,54.00403223194732,15,109.9370915531668,-107.95555284757427,-56.424371362651726,-6.472681636932009,1.7924573042917729,220,212,229,298,69,78,86,478.4712629287557,63,387.14434953604126,43.71262214075093,90.78107659783569,140.1848015439788,0.7988676001918306,16373,16273,Clinton+Potter+Tioga,Potter,42,105,Pennsylvania,PA
42117,42CS017,396,379,414,463,49,67,84,196.02235238956442,79,231.6715542521994,-86.18530273082955,-34.917458989737874,15.592818586654124,1.1644425441797843,487,466,508,596,88,109,130,266.94049499715845,103,251.61841944546234,-33.399940991970915,14.429984864558172,66.69696954775134,0.9340531995014728,40920,40935,Clinton+Potter+Tioga,Tioga,42,117,Pennsylvania,PA
42037,42CS018,592,564,620,659,39,67,95,123.9537067934932,83,153.84615384615384,-79.35453617346131,-29.612676875581894,18.561248813306722,1.2228716817339687,727,693,760,871,111,144,178,222.6368288897686,113,174.26976342494063,-3.3445147615451534,47.05692687906733,96.3927320993234,0.7773686784369193,64740,64842,Columbia,Columbia,42,37,Pennsylvania,PA
42039,42CS019,836,800,872,921,49,85,121,121.58057844154618,90,128.89981619841024,-57.67620238876418,-7.546562380086815,45.42854232188986,1.0478569518200638,1018,975,1061,1217,156,199,242,238.34152845150547,153,183.44223967388047,3.0914433056473305,54.383359621287795,102.44011958667548,0.7658088787168033,83786,83405,Crawford,Crawford,42,39,Pennsylvania,PA
42041,42CS020,2098,1986,2209,2361,152,263,375,121.88455283367509,321,148.55379868877748,-78.81685486928185,-26.412805749339693,23.600866541957206,1.2141972357049524,2593,2458,2729,2793,64,200,335,76.16149637506558,365,139.05132708300792,-110.94914243292057,-62.42796688302001,-7.524601800174509,1.816656128559825,259300,262493,Cumberland+Perry,Cumberland,42,41,Pennsylvania,PA
42099,42CS020,386,367,406,450,44,64,83,166.12023503551853,42,109.7752221641401,3.3465367934571533,56.38333401371161,106.88865096903766,0.6505817866199672,473,449,497,580,83,107,131,232.31631872219802,102,221.92245768243333,-37.92259386957978,12.582152286620056,62.918490914492374,0.9463965941277754,45912,45962,Cumberland+Perry,Perry,42,99,Pennsylvania,PA
42043,42CS021,2247,2124,2370,2589,219,342,465,143.68049439245692,329,138.30841936738258,-49.60156011824891,4.06120234132554,56.84315236327619,0.9598027078837369,2770,2622,2919,3175,256,405,553,140.86581322812646,386,134.36602558524064,-46.12863426535075,7.26154968173399,55.75876827911092,0.9515070004761811,285449,287275,Dauphin,Dauphin,42,43,Pennsylvania,PA
42045,42CS022,4758,4511,5006,5578,572,820,1067,171.13858187661165,979,204.42609999965197,-84.25600460101485,-32.858497168619195,16.747551327005343,1.1930505414063628,5828,5531,6124,5923,-201,95,392,16.614376929616245,544,94.73737371978287,-127.96885823733557,-77.68913237120717,-22.822509287812515,5.642983238743431,574682,574219,Delaware,Delaware,42,45,Pennsylvania,PA
42049,42CS023,2451,2335,2567,2777,210,326,442,144.82110257164442,259,115.04762186793214,-19.09468471131521,29.156090411728197,82.53238511850155,0.7919828092182707,2994,2855,3133,3389,256,395,534,146.5445225880453,358,132.9777355154559,-38.25321086902891,14.271256041996377,69.49729265879566,0.9051278538524895,270149,269218,Erie,Erie,42,49,Pennsylvania,PA
42051,42CS024,1507,1452,1562,1679,117,172,227,160.90262929143347,164,153.2817720868285,-44.71913634111228,8.862785510841473,56.66924535403621,0.9471351566172691,1821,1756,1887,2307,420,486,551,382.01968375213846,378,297.3006984206883,33.358440744516805,84.16084972043116,134.65985536894297,0.7766350269159917,128391,127144,Fayette+Greene,Fayette,42,51,Pennsylvania,PA
42059,42CS024,375,359,390,401,11,26,42,88.5149397220935,34,113.95693098343713,-76.12633597257536,-24.562301259591454,24.89311681479926,1.240460770454775,453,435,472,540,68,87,105,244.53518681775478,68,191.9060789072642,3.8133100573007783,52.90765588778564,103.47931280444075,0.775825300990467,35803,35434,Fayette+Greene,Greene,42,59,Pennsylvania,PA
42055,42CS025,1363,1296,1430,1699,269,336,403,259.0034918980227,235,180.92464039623778,27.71692740700274,78.09021213151105,127.53358113784023,0.6964710457281243,1673,1592,1754,2038,284,365,446,233.72430632107523,289,184.9860460352818,-1.653193716688159,47.58682540615639,96.6818504782236,0.7893095062248081,155866,156228,Franklin,Franklin,42,55,Pennsylvania,PA
42061,42CS026,395,376,414,489,75,94,113,254.72174211787672,75,203.89207312929022,-0.4091392502680028,50.861476470194674,104.52388399708688,0.7919974871055321,482,459,504,593,89,111,134,253.82076893576252,101,230.01594169892962,-26.521284227935766,24.312773333617557,76.36302378396522,0.8981554051046474,44141,43910,Huntingdon+Juniata+Mifflin,Huntingdon,42,61,Pennsylvania,PA
42067,42CS026,208,198,218,295,77,87,97,442.9202912982804,64,325.0656056886481,66.99322050990396,118.23787651344043,169.90177166418434,0.725593774586257,252,240,264,354,90,102,114,438.21342947431873,73,313.0494446588619,77.40473208238292,125.42335280612987,180.745678799105,0.7074535294561597,23626,23319,Huntingdon+Juniata+Mifflin,Juniata,42,67,Pennsylvania,PA
42087,42CS026,474,454,494,614,120,140,160,364.3932911429727,126,328.11075908163707,-13.414081186306534,38.013477485465955,87.05546460128333,0.8940412342016664,579,555,603,658,55,79,103,171.36691567904077,105,227.63240618292974,-107.600943961412,-54.504812037449696,-7.863285107558545,1.3117389094861702,46082,46127,Huntingdon+Juniata+Mifflin,Mifflin,42,87,Pennsylvania,PA
42063,42CS027,761,725,797,935,138,174,210,251.19494631125224,116,167.25944439104106,29.058897319330036,80.76815321233398,135.84962912047015,0.6620548518049039,929,886,972,1115,143,186,229,224.4261731597902,159,191.75108538350216,-17.152048814255004,32.18816123370159,84.08815891892371,0.8498393570230988,83224,82920,Indiana,Indiana,42,63,Pennsylvania,PA
42069,42CS028,2323,2231,2415,2524,109,201,293,112.34042296685321,267,149.23218086716753,-85.78226503469416,-36.33199997848837,13.099023617835627,1.3218161795091434,2853,2741,2964,2941,-23,88,200,41.0008174590066,315,146.07543984938,-156.25491257845474,-104.06398761455694,-55.45179960782757,3.522899520739114,214699,215642,Lackawanna+Wyoming,Lackawanna,42,69,Pennsylvania,PA
42131,42CS028,269,258,280,278,-2,9,20,41.211624206617806,30,137.82542113323123,-151.40000371609278,-95.93945330665973,-48.685228373355635,3.008907307727633,329,316,343,394,51,65,78,248.89418661794934,54,207.46090898613085,-7.745629912746664,39.663453427994554,93.9998313060528,0.8208599629265824,26120,26029,Lackawanna+Wyoming,Wyoming,42,131,Pennsylvania,PA
42071,42CS029,4410,4172,4647,5188,541,778,1016,169.34246144842223,748,162.70803008358362,-42.04586107745362,7.300183602620458,56.19938927907374,0.9595897850139045,5424,5138,5710,5904,194,480,766,86.74244883941535,739,133.51448424384552,-98.87597304352343,-47.240906132830624,4.785562036914167,1.5360066156013625,551663,553498,Lancaster,Lancaster,42,71,Pennsylvania,PA
42073,42CS030,994,957,1031,1217,186,223,260,312.24390450531536,140,195.86354839461842,65.18219821430056,116.43882292049625,167.5176728278342,0.6244793991934439,1210,1166,1254,1387,133,177,221,207.1482893754295,196,229.10310808757347,-74.75479464279441,-20.02729269625897,28.467292447087818,1.0997801766793405,85774,85551,Lawrence,Lawrence,42,73,Pennsylvania,PA
42075,42CS031,1321,1260,1383,1523,140,202,263,169.2609180343309,156,130.9200772092763,-10.731882198356919,38.23932742986945,94.4401381740099,0.7696646813609601,1622,1548,1696,1877,181,255,329,177.71890368712792,226,157.53959402186035,-34.25530507777434,18.809797707128695,70.36389564202611,0.8829903726386868,142988,143456,Lebanon,Lebanon,42,75,Pennsylvania,PA
42077,42CS032,2961,2800,3122,3397,275,436,597,140.03032008043766,518,166.26811536054183,-82.31370282373783,-25.831482282299636,29.30177328025085,1.1846567447405882,3646,3452,3840,3976,136,330,524,87.86041636471437,472,125.73657122763647,-88.74741018545454,-37.150266326006296,12.564089837875368,1.4267687089712877,373854,375388,Lehigh,Lehigh,42,77,Pennsylvania,PA
42079,42CS033,3543,3404,3683,3970,287,427,566,157.94024450783903,463,171.45502237309057,-63.40681691340147,-14.38233104097062,37.84319608660024,1.0830296148934653,4351,4183,4519,4602,83,251,419,76.99177077394057,534,163.8499208365551,-137.74048724360622,-87.54971830851291,-35.430539339332185,2.1197008545448863,324050,325908,Luzerne,Luzerne,42,79,Pennsylvania,PA
42081,42CS034,1096,1047,1145,1268,123,172,221,181.24094778338082,130,136.9826927636258,-7.59491260580065,42.74118939045372,97.08327790223572,0.7514355722706914,1341,1282,1399,1563,164,222,281,195.56034666007267,261,229.6322364948091,-87.1559404506656,-32.954460298421644,15.189708301229794,1.1689678537146602,113883,113660,Lycoming,Lycoming,42,81,Pennsylvania,PA
42023,42CS035,53,52,53,57,4,4,5,112.80169595513944,5,133.3629695487886,-33.12361694626484,-20.803969252490003,-7.805436337785783,0.9561831766841881,64,64,65,77,12,13,13,283.9514318491641,3,67.14413607878245,204.07930622121378,216.5264255932264,228.2621200336196,0.2191868901015307,4499,4468,McKean and Nearby Counties,Cameron,42,23,Pennsylvania,PA
42047,42CS035,334,321,347,317,-30,-17,-4,-66.04686283640041,21,81.92191411202496,-198.75605494607896,-145.21870397721364,-92.6439467982523,-1.3182208397155928,408,392,424,468,44,60,76,195.0729676891477,57,185.04090377873004,-39.31897361349581,9.426352541862235,58.80300722260238,0.9330453687552128,30761,30804,McKean and Nearby Counties,Elk,42,47,Pennsylvania,PA
42053,42CS035,71,70,72,87,15,16,17,277.096147058298,4,68.84681583476764,195.87854867669944,207.52508106494514,220.7787742729209,0.23392789419944227,88,87,89,109,20,21,22,302.84751801036134,21,299.1452991452992,-8.23446598675941,3.6635429145114466,16.558641805524893,0.9434006440251883,6972,7020,McKean and Nearby Counties,Forest,42,53,Pennsylvania,PA
42083,42CS035,435,418,452,444,-8,9,26,27.282213683867035,26,77.39054942329157,-101.4454099411732,-51.03813470696116,-1.5792519893098413,2.5576234936773345,528,507,548,631,83,103,124,258.439171652442,97,242.53638045706856,-33.959040978120555,16.420656785087175,67.80251173258979,0.9294734489894082,40315,39994,McKean and Nearby Counties,McKean,42,83,Pennsylvania,PA
42123,42CS035,414,398,431,501,70,87,103,269.4617646925092,40,124.52977039823581,94.74971181038701,144.83762875193392,196.7478199661894,0.4568642256559655,503,483,522,683,161,180,200,472.6480912825522,90,235.7008170961659,183.00281847711173,236.04111255712337,289.00008581021376,0.49593349091628164,38545,38184,McKean and Nearby Counties,Warren,42,123,Pennsylvania,PA
42085,42CS036,1251,1204,1298,1446,148,195,242,212.54902320492727,170,185.21208599651362,-23.543031594446315,27.903711596475013,80.0516623825867,0.8669414957491943,1526,1470,1583,1842,259,316,372,286.9116851308984,244,221.76778004998863,13.131117205777036,64.28370841077204,119.86214591728248,0.7705070574150527,110144,110025,Mercer,Mercer,42,85,Pennsylvania,PA
42089,42CS037,1281,1209,1354,1540,186,259,331,184.2865700074739,213,151.58164415082254,-17.528154668493023,31.69987041444529,86.79846275998196,0.8193681182329188,1579,1492,1667,1808,141,229,316,135.17791231350304,202,119.43899150918853,-37.946168466062254,16.00658460051445,66.80084316451655,0.8797208526817164,168622,169124,Monroe,Monroe,42,89,Pennsylvania,PA
42091,42CS038,6737,6369,7105,7627,522,890,1258,125.12886130464364,1168,164.22696973354124,-89.10009865561268,-39.22281287439006,12.315803337850738,1.3109896146923483,8327,7883,8771,8373,-398,46,490,5.307586979490341,715,83.1348947965695,-131.4748633202612,-79.15037329065886,-25.545999332602662,15.327626735658175,853453,860048,Montgomery,Montgomery,42,91,Pennsylvania,PA
42093,42CS039,197,189,205,217,12,20,28,133.6219999755669,28,185.40999889636905,-104.64322612665755,-52.316051823466324,-6.294290001816565,1.3220550061199168,240,231,249,253,4,13,22,71.36999158165888,48,265.32529987286495,-242.50826445977302,-196.70246837733828,-140.26300550453942,3.4503715718961074,18122,18091,Montour+Northumberland,Montour,42,93,Pennsylvania,PA
42097,42CS039,996,957,1035,1265,230,269,308,353.6483081558933,239,314.00886845130566,-14.59231924165369,41.1299050390357,89.61449934001405,0.8846263354553933,1215,1168,1262,1308,46,93,140,101.50136524860405,206,225.639677532422,-174.35337068158157,-126.29791035772593,-74.92977332293462,2.1992877924825165,91335,91296,Montour+Northumberland,Northumberland,42,97,Pennsylvania,PA
42095,42CS040,2661,2527,2795,3032,237,371,505,142.78567738504492,417,160.45404261459285,-64.97262994345232,-16.635838182255267,33.653942182962425,1.120720317877639,3275,3113,3437,3550,113,275,437,87.80103991840376,381,121.52528587148942,-83.42864248844357,-33.903391620342276,18.45767100180323,1.3790885208907127,311865,313515,Northampton,Northampton,42,95,Pennsylvania,PA
42101,42CS041,12228,11541,12914,15527,2613,3299,3986,248.06891431636097,2461,185.0363186719891,12.091649574693383,64.11675230338135,113.43607104413688,0.7456809061894608,14859,14044,15675,16427,752,1568,2383,99.22426083651844,1576,99.75561141138365,-52.00752971028069,-2.6678742595202456,51.28372716184205,1.0047141240926205,1596011,1579861,Philadelphia,Philadelphia,42,101,Pennsylvania,PA
42103,42CS042,477,452,502,525,23,48,73,99.42096262615841,45,92.57671866963827,-44.720743155345644,7.833657482095096,60.253907178399835,0.9122816294506743,597,566,628,684,56,87,118,145.59274971114118,77,128.86166616460824,-36.61255479823962,16.578447530016213,67.20602730883746,0.8750249415677952,58330,59754,Pike,Pike,42,103,Pennsylvania,PA
42107,42CS043,1647,1585,1708,1916,208,269,331,226.72106734477694,239,201.13189286991644,-24.292963748344697,26.376937746078674,77.76792578044602,0.8838529363074807,2014,1940,2088,2133,45,119,193,83.19777877273246,261,182.27147975110515,-150.02076432157014,-98.49937781266621,-50.70287279965152,2.1725848938351433,142593,143193,Schuylkill,Schuylkill,42,107,Pennsylvania,PA
42109,42CS044,304,287,321,361,40,57,74,171.8259830050991,42,126.61407827965633,-7.103590399979095,44.73303868866197,95.92556327380179,0.724168616691065,374,354,394,435,41,61,81,153.9312986208531,79,199.31878390311593,-94.2594369676799,-45.06188346644046,0.6723116617393298,1.27397429723845,39806,39635,Snyder+Union,Snyder,42,109,Pennsylvania,PA
42119,42CS044,306,288,325,390,65,84,102,233.99116215271394,42,117.50442973048587,62.859171669566734,115.20806919036177,170.6966301321282,0.49624132020263545,377,355,399,484,85,107,129,251.26708616244616,78,183.20180383314542,18.807216359156094,67.80757777941895,120.35601595064946,0.7223595066162019,42892,42576,Snyder+Union,Union,42,119,Pennsylvania,PA
42111,42CS045,824,793,856,950,94,126,157,204.2194094523724,103,167.43883605624643,-11.334199403581854,36.64151061315557,90.30017949468827,0.813421809070589,1003,965,1041,1190,149,187,225,253.57250940063344,212,287.7736904260951,-83.72000630788972,-34.326804542849764,14.69157074352957,1.1288344512524005,73818,73669,Somerset,Somerset,42,111,Pennsylvania,PA
42115,42CS046,394,378,411,465,54,71,87,219.73869204583434,37,114.92765252504336,57.52704467323309,106.436727230135,156.74268982287887,0.515729464684429,480,460,500,577,77,97,117,253.4468875184789,56,145.89412255106294,56.4296816349593,106.20306316105341,155.01166921250493,0.5697828681223737,38633,38384,Susquehanna+Wayne,Susquehanna,42,115,Pennsylvania,PA
42127,42CS046,517,495,539,594,55,77,99,181.1363709849243,29,68.02189210320563,66.11889448284806,112.72099367287828,162.0680388943529,0.37072796978841366,634,607,660,833,173,199,226,387.4506612739115,109,212.13241733647314,120.5953840126788,175.67142788792677,228.53465257975174,0.5447718133852395,51160,51383,Susquehanna+Wayne,Wayne,42,127,Pennsylvania,PA
42121,42CS047,538,516,559,635,76,97,119,232.13334575500065,58,138.29554712182326,47.783413994062,91.49793159731583,144.86536451396546,0.5897018289482345,654,628,680,870,190,216,242,432.5573770723086,136,272.07073839198193,105.88116356131725,160.20025640657755,212.2859477729359,0.6260862824960736,50327,49987,Venango,Venango,42,121,Pennsylvania,PA
42125,42CS048,2203,2113,2293,2308,15,105,195,60.306451387875455,135,77.56540391465889,-69.15915317982812,-16.558805121788936,35.99514845737604,1.27404923139372,2696,2588,2804,2991,187,295,403,140.91232349869617,354,169.03506761402704,-82.10714502355302,-28.82937050142469,25.46324325119097,1.1955249904335614,208856,209424,Washington,Washington,42,125,Pennsylvania,PA
42129,42CS049,3880,3728,4032,4253,221,373,525,126.70146079315573,425,144.40964769709086,-70.17520188740293,-19.400817377393487,34.11809732771542,1.1367146477521552,4736,4554,4918,5235,317,499,681,141.2765934978429,589,166.76387481101037,-77.85944909274723,-25.376532716960867,22.089778141314312,1.1780460577397616,353162,353194,Westmoreland,Westmoreland,42,129,Pennsylvania,PA
42133,42CS050,3645,3449,3841,4231,390,586,782,154.3017198325035,424,111.67666444981464,-9.123077637074514,42.30088312199006,92.44164680560911,0.7225218275721758,4495,4259,4732,5253,521,758,994,165.32433860178065,684,149.22768129854262,-35.54648013935603,14.922160670352152,70.43294057778927,0.9014463013034737,455601,458360,York,York,42,133,Pennsylvania,PA
44001,44CS001,460,438,481,495,14,35,57,84.08604527084826,63,149.9018499791803,-114.98654518858983,-65.56689430648541,-14.619003515768709,1.7336620327536583,564,537,590,594,4,30,57,59.581850598273036,66,129.90080302314595,-124.1975051438228,-70.38401675003169,-18.076320668207,2.1104908030891614,50433,50808,Bristol+Providence,Bristol,44,1,Rhode Island,RI
44007,44CS001,4959,4676,5242,5966,724,1007,1290,184.0693138540568,1192,217.8896811626876,-89.55795336172018,-34.040052921499495,19.143411397862227,1.182562763928002,6080,5741,6420,6267,-153,187,526,28.324960110347927,626,95.06699489584393,-116.4272749126218,-65.70991721105729,-14.597185412844775,3.338398756455544,656479,658483,Bristol+Providence,Providence,44,7,Rhode Island,RI
44003,44CS002,1556,1483,1629,1691,62,135,208,95.84019780813715,205,145.15329604191743,-102.14215235588341,-50.69780649333588,4.720372449862295,1.503427322589344,1917,1828,2005,2106,101,189,278,110.9985992623872,163,95.51266275240539,-36.241733322889225,13.37281701457588,65.16756495015052,0.8559666066053894,169476,170658,Kent,Kent,44,3,Rhode Island,RI
44005,44CS003,721,684,757,719,-38,-2,35,-2.163311909460421,38,53.67863449087698,-105.67252388625057,-58.040955256035176,-5.586684096391675,-71.50322564740961,885,841,929,887,-42,2,46,1.9976790552501318,52,60.97417978002392,-110.5280339964759,-59.12313121738339,-7.157321140805392,19.233182967502742,84950,85282,Newport,Newport,44,5,Rhode Island,RI
44009,44CS004,1055,999,1111,1163,52,108,164,100.28703098487725,87,80.75807387352543,-34.73951916084734,19.014489445197935,73.95540055459647,0.7978841743799617,1307,1239,1374,1380,6,73,141,56.32656164260612,71,54.41864030045221,-48.00219896954756,2.841638153298489,52.271852703796725,0.9531574787820205,129275,130470,Washington,Washington,44,9,Rhode Island,RI
45001,45CS001,262,251,272,301,29,39,50,193.544502812524,34,168.07415036045313,-24.929594814946057,25.122135304204736,78.8441810765962,0.8467729472793177,322,310,335,418,83,96,108,393.9553824517126,41,168.82154327596146,171.96773505538283,225.7009499538125,276.56185076504096,0.4240969653929822,24275,24286,Abbeville+Edgefield+Greenwood+McCormick,Abbeville,45,1,South Carolina,SC
45037,45CS001,196,185,207,275,68,79,90,363.39031448136114,27,124.76414186145018,186.8572282414935,238.45697113882665,290.289259398233,0.33902266816224785,246,232,259,370,111,124,138,476.4593408202405,56,214.69922938312308,210.1840852425694,261.95608745853895,311.6121205335846,0.44701695654920315,25969,26083,Abbeville+Edgefield+Greenwood+McCormick,Edgefield,45,37,South Carolina,SC
45047,45CS001,687,657,717,838,121,151,181,260.473815283189,84,144.83591010977642,61.317979501417746,116.52533405655092,165.97982527101738,0.5523912509444243,843,808,879,1014,135,171,206,246.17176697588505,131,189.13963124990977,4.911774513851459,57.498311311308946,110.81298059296178,0.7638438200072929,69596,69261,Abbeville+Edgefield+Greenwood+McCormick,Greenwood,45,47,South Carolina,SC
45065,45CS001,138,134,142,136,-6,-2,2,-24.537783633217515,13,163.67642429965375,-240.60081656291192,-187.82472519224888,-139.6191131231178,-13.699879365779976,172,167,177,180,3,8,13,84.324292766969,19,195.39284245166598,-160.19440441233982,-113.0072115261945,-63.21017952465065,2.0652860331823604,9531,9724,Abbeville+Edgefield+Greenwood+McCormick,McCormick,45,65,South Carolina,SC
45003,45CS002,1553,1480,1625,1928,303,375,448,265.76185634000836,157,111.12159675364506,103.07024452782315,154.78418838055617,209.82290250937612,0.4170141030575801,1919,1831,2007,2501,494,582,670,341.2628494994344,390,228.70949203035386,61.63406178679068,113.18162496424091,165.1344390114996,0.6690360421150028,169544,170522,Aiken,Aiken,45,3,South Carolina,SC
45007,45CS003,1947,1860,2035,2446,411,499,586,293.1017542522828,295,173.44693944545975,69.13300206398458,118.05721223039562,169.10728663264095,0.5905788781559083,2405,2298,2512,3032,520,627,734,303.6906019764075,504,244.0807984928979,6.313093378934328,60.35904851377096,108.5666294048933,0.8024357272707824,204097,206489,Anderson,Anderson,45,7,South Carolina,SC
45013,45CS004,1381,1300,1462,1638,176,257,338,163.55742124046716,100,63.54754150448804,49.39524370533358,101.04827106136138,157.62971143102766,0.3870297850814773,1723,1624,1821,2109,288,386,485,202.1725251308714,184,96.25646069179099,53.62815590674811,105.883514299344,154.57151450737908,0.4748817098925113,188835,191156,Beaufort,Beaufort,45,13,South Carolina,SC
45015,45CS005,1399,1299,1499,1617,118,218,318,112.76208023708027,126,65.25088360571549,-1.3132130938810282,46.58010786052956,97.57098840188092,0.5760144388800674,1760,1638,1882,2139,257,379,501,160.50139599085915,282,119.51583372889401,-12.66233047860022,41.48444811819857,91.0468154593009,0.7426793662918502,231721,235952,Berkeley,Berkeley,45,15,South Carolina,SC
45017,45CS006,149,143,156,193,37,44,50,368.3099913202544,15,126.88566192020302,192.6865233643694,239.8941347887999,292.87880564897307,0.3367730624923528,183,175,190,235,45,52,60,369.395098416461,39,275.44318101560845,43.50476688223771,93.16815625485046,144.7909785981359,0.7316709121927203,14186,14159,Calhoun+Richland,Calhoun,45,17,South Carolina,SC
45079,45CS006,2673,2494,2852,3272,420,599,778,172.46337107161355,304,87.52714229158919,35.74382235149128,85.79882130123067,136.8377045412155,0.5066656384726174,3317,3102,3533,3987,454,670,885,160.16597355521773,429,102.62004033039346,2.3497098874445617,56.58014510177528,107.64439330485196,0.6397551476907802,416785,418047,Calhoun+Richland,Richland,45,79,South Carolina,SC
45019,45CS007,2865,2688,3041,3276,235,411,588,120.28256467468722,274,80.14429873738605,-12.013106089621878,40.261624215656546,93.5104890989481,0.6646838685492442,3549,3336,3762,3835,73,286,499,69.28612726890942,378,91.63680793603848,-75.91012343816196,-22.480054886732663,29.181746206740137,1.3179737589091003,410260,412498,Charleston,Charleston,45,19,South Carolina,SC
45021,45CS008,561,537,585,680,95,119,143,253.71236795098588,85,181.06294600063902,19.79702789172502,71.8037444167416,123.20045137563584,0.7077124858637448,685,656,714,935,221,250,279,446.4529881715489,187,333.505733801787,61.359034056709525,112.62335615727466,161.2064575264155,0.7440397591043331,56334,56071,Cherokee,Cherokee,45,21,South Carolina,SC
45023,45CS009,365,351,379,474,95,109,123,405.72274715946736,46,171.13095238095238,182.13720367829148,236.14394163044716,287.87748299721284,0.41796039630400694,447,430,463,546,83,99,116,307.80105292087364,85,263.81948539681554,-7.0164087561057435,44.79201332650555,95.49964714817042,0.8485538839440244,32256,32219,Chester+Fairfield,Chester,45,23,South Carolina,SC
45039,45CS009,236,227,245,329,84,93,102,528.3402889866703,41,233.68481048731832,242.81557826848615,295.1418180662866,348.0425162316772,0.4375792939579924,286,276,297,392,95,106,116,510.21075965256716,50,241.38263976054841,216.0096557227808,270.37567103744044,317.2651940137489,0.46866919811543806,21054,20714,Chester+Fairfield,Fairfield,45,39,South Carolina,SC
45025,45CS010,432,413,450,597,147,165,184,455.383384071605,67,184.38252493980048,221.44244618642614,271.7060998139758,322.10630064277336,0.4024629841111253,526,504,549,694,145,168,190,387.2221606681767,113,261.16902026948947,75.90650510085977,128.27038154729786,176.7430048704696,0.6704663229046953,43605,43267,Chesterfield+Marlboro,Chesterfield,45,25,South Carolina,SC
45069,45CS010,300,289,312,356,44,56,67,253.05435634583452,38,172.303041753259,25.041608153385457,79.68125815836922,133.0849919882619,0.6689077481272547,366,352,379,458,79,92,106,349.05741673741215,73,276.462791138042,22.721944255912433,72.3063751892796,124.23915512744274,0.7835256885666019,26465,26405,Chesterfield+Marlboro,Marlboro,45,69,South Carolina,SC
45027,45CS011,321,308,335,501,166,180,193,684.6367381718186,77,293.51037133509095,338.90582657063334,389.2412566654888,443.21360391195594,0.426335949970826,391,375,407,563,156,172,188,553.6396842933742,70,225.55906425211057,274.01129707742325,328.5779659805703,381.0201898718011,0.40505382269810475,31481,31034,Clarendon+Williamsburg,Clarendon,45,27,South Carolina,SC
45089,45CS011,357,344,370,469,99,112,125,437.03881524379483,79,308.152385905604,77.86698078481706,129.60799798030655,182.73058242983942,0.6988541535318042,434,418,450,540,90,106,122,347.8758008561843,72,235.71779341954496,59.50193074915427,114.96099187905922,160.94130226113043,0.6712744475530812,30764,30545,Clarendon+Williamsburg,Williamsburg,45,89,South Carolina,SC
45031,45CS012,690,663,717,879,162,189,216,357.3807002947879,101,191.2214824398094,117.80025169394997,164.70768898389863,219.44165161823278,0.5322441698007304,840,807,872,1099,227,259,292,413.37308841928507,154,245.35576586049774,116.92801993070428,168.23868234735454,216.19342744511874,0.591266715684337,63382,62766,Darlington,Darlington,45,31,South Carolina,SC
45033,45CS013,304,292,316,461,145,157,169,659.4205665611786,48,201.64537020829684,407.02913024479864,457.66020563138807,509.0778595030465,0.30385598813592024,368,354,383,503,120,135,149,478.71720560678995,65,231.1850903400199,200.23251702232406,245.61391004017923,299.39515985377824,0.4793647150996564,28565,28116,Dillon+Marion,Dillon,45,33,South Carolina,SC
45067,45CS013,340,328,353,468,115,128,140,525.0019321705788,80,328.3398317258362,148.96429401046893,196.3212277148395,244.73077855185568,0.6205556542245733,412,397,426,517,91,105,120,366.0028972165573,80,277.5657483866491,39.48488530651972,88.51237728818722,138.8170359347971,0.7512487982778958,29238,28822,Dillon+Marion,Marion,45,67,South Carolina,SC
45035,45CS014,1037,967,1107,1252,145,215,285,158.71858190927148,103,76.13603464312773,29.939977810119434,82.46795752803055,131.59869574434603,0.4774683366838717,1288,1204,1372,1589,217,301,385,184.38074815432242,229,140.3788389627904,-5.428879038361436,44.05381712965027,98.28920218843831,0.7588301457191535,162341,163130,Dorchester,Dorchester,45,35,South Carolina,SC
45041,45CS015,1317,1259,1376,1751,375,434,492,379.8638903951153,240,210.26962699044293,120.11469326743955,171.44482274001993,222.1059497395135,0.5522656388784594,1616,1546,1687,2061,374,445,515,325.7389921152107,275,201.39438146292878,74.1454521041482,123.16252798944545,172.41740483269663,0.6168822793131264,136967,136548,Florence,Florence,45,41,South Carolina,SC
45043,45CS016,687,660,714,885,171,198,225,374.68974550585676,91,172.15828472331705,149.4551445453592,204.7375258664651,254.37014736204722,0.4571606448796111,845,812,878,1053,175,208,241,326.16310427365227,126,197.33441919468765,77.41143623301289,129.10905132226713,181.92020294925598,0.6021263555787958,63430,63851,Georgetown,Georgetown,45,43,South Carolina,SC
45045,45CS017,3872,3645,4099,4546,447,674,901,153.38836910885055,449,102.16774624171356,-0.62979356789476,50.91216700504334,101.89333819753837,0.665085689678147,4801,4526,5076,5780,704,979,1254,183.72794349106977,881,165.34230172999472,-30.706598986455916,18.093212038584483,75.32666268394415,0.8990117448806004,527368,532834,Greenville,Greenville,45,45,South Carolina,SC
45005,45CS018,91,90,92,119,27,28,29,411.72653969207073,14,208.20423844342542,191.88500697552905,203.85019810225904,216.0892823811149,0.48805692050920024,110,109,111,155,44,45,46,572.7277574155777,17,215.81820490034278,344.36278477750915,356.7926046040255,369.7655960517345,0.36865347762228595,8069,7877,Hampton and Nearby Counties,Allendale,45,5,South Carolina,SC
45009,45CS018,160,154,166,205,39,45,51,405.70730161632895,31,278.2348541510845,80.48793316638321,128.00704292037568,178.68075976825793,0.6709585622175752,195,188,201,237,36,42,49,321.4144729400869,24,181.84573420215185,91.103751879688,139.0392461487741,193.22599041729146,0.5527370808732329,13370,13198,Hampton and Nearby Counties,Bamberg,45,9,South Carolina,SC
45011,45CS018,219,210,228,296,68,77,86,446.1820756227928,34,197.86614936954413,195.3130779479107,249.63592386760064,300.6902260521546,0.437755351954879,270,259,281,317,36,47,58,228.5430031254046,51,247.83749635533093,-71.75650940887502,-19.85098515523762,30.284483824107163,1.0618456556849576,20620,20578,Hampton and Nearby Counties,Barnwell,45,11,South Carolina,SC
45029,45CS018,474,458,491,558,67,84,100,261.1445074328778,59,184.31740081224615,23.596107347964548,77.25116728004734,129.61552210479962,0.6974625393057889,583,563,603,729,126,146,166,380.41125324691154,122,317.097260487602,9.90775556347496,64.83364029989978,116.2364254745937,0.8279076789598055,38412,38474,Hampton and Nearby Counties,Colleton,45,29,South Carolina,SC
45049,45CS018,199,191,207,250,43,51,59,329.33781373122997,31,200.05377789728422,81.68243857507095,130.55644138926868,180.78167521475086,0.5957684444701565,241,232,250,294,44,53,62,290.60456942247345,36,197.49835418038185,40.628512711385355,94.32953480748247,140.83071092172622,0.6670199288905735,18595,18228,Hampton and Nearby Counties,Hampton,45,49,South Carolina,SC
45053,45CS018,227,214,240,269,29,42,55,171.21721966288308,24,98.02253156802014,20.99500590962791,73.29623520226043,122.45276595645683,0.5591654158505083,290,275,306,387,81,97,112,321.17103678826174,68,225.5988321942804,47.735800226018384,95.07195698393883,144.3603530642607,0.6952441036139398,29381,30142,Hampton and Nearby Counties,Jasper,45,53,South Carolina,SC
45051,45CS019,3289,3137,3442,4023,581,734,886,248.0218076011851,353,119.36059240724617,77.89909082051953,130.0523041688041,180.05481361706126,0.48059519020582014,4129,3941,4317,5256,939,1127,1315,309.82477919052866,639,175.63775194672047,82.22610621627814,134.8674942837951,190.4596274480012,0.5663913393920471,354891,363817,Horry,Horry,45,51,South Carolina,SC
45055,45CS020,598,569,626,716,90,118,147,215.9967365795995,73,133.1812998859749,30.089811218348565,82.71211217935738,132.91655659992682,0.6114250487380606,739,705,773,985,212,246,280,372.33733145501463,124,187.756461699196,132.6298912149911,183.6306811809307,232.95024206762594,0.502222041298975,65775,66043,Kershaw+Lee,Kershaw,45,55,South Carolina,SC
45061,45CS020,202,195,209,267,58,65,72,469.91569387341536,51,370.95405503697424,46.315964254293114,99.93371056688201,148.36608716724007,0.7773729479342175,245,237,253,296,43,51,59,312.6018385395444,53,325.03372991536855,-66.61185746962678,-11.295640571800455,39.54467190933337,1.0197630896375505,16498,16306,Kershaw+Lee,Lee,45,61,South Carolina,SC
45057,45CS021,816,774,858,968,110,152,194,187.31009420721514,94,115.96229169450926,18.908082121609574,70.82312760241318,122.06606272114001,0.6150418698368746,1026,975,1078,1295,217,269,320,269.1087827086174,174,174.3504443932304,43.38656016015764,93.81737606523795,144.20940223717162,0.6454775095501845,97273,99799,Lancaster,Lancaster,45,57,South Carolina,SC
45059,45CS022,745,716,774,851,77,106,135,188.45206920576618,79,140.315562002309,-3.6789017453862924,47.52438549807283,97.54673895733073,0.7376169806833173,915,880,950,1127,177,212,247,312.5657537649736,180,265.61992739721984,-3.932619898983702,47.38426442915832,98.46077013802827,0.8458117638536042,67562,67766,Laurens,Laurens,45,59,South Carolina,SC
45063,45CS023,2200,2073,2327,2618,291,418,545,169.4291510815314,235,95.23873852575836,25.380351778714285,73.24474727615028,126.14283663623773,0.5607740599977467,2740,2585,2894,3290,396,550,705,183.76361074481292,405,135.28319281696352,-5.182170518854152,46.603774573597136,101.52696245334211,0.7348447833308543,296098,299372,Lexington,Lexington,45,63,South Carolina,SC
45071,45CS024,364,348,381,488,107,124,140,391.770700860987,67,212.44550138723739,125.37085483907151,179.68771595867895,229.6476014791392,0.5379163386441205,444,425,464,562,98,118,137,310.18002964995395,71,187.0636279805032,74.25443318225517,124.2331879313042,173.72199560905597,0.5980013434674875,37845,37955,Newberry+Saluda,Newberry,45,71,South Carolina,SC
45081,45CS024,168,160,177,267,90,99,107,620.7102360590877,30,188.92679086853843,381.1927017046799,431.5119539580164,481.83294940104366,0.30131489934847516,203,194,213,285,72,82,91,434.29008574545884,44,233.76899373074062,148.78346286432838,200.309983924754,254.10953754401018,0.5317729507456507,19055,18822,Newberry+Saluda,Saluda,45,81,South Carolina,SC
45073,45CS025,801,767,835,869,34,68,102,103.99239074898232,75,114.191461016304,-58.9317949297269,-9.935840066141274,42.820167874801356,1.0822302240879165,985,944,1025,1193,168,208,249,263.46249969090974,205,259.0968263798486,-43.16220872079441,6.104631600418259,56.52124311629326,0.9787344195632496,78815,79121,Oconee,Oconee,45,73,South Carolina,SC
45075,45CS026,881,845,918,1155,237,274,310,389.881707340018,132,188.15480008552493,148.15555422137956,201.5660011343855,250.91020531690748,0.48083663514017566,1069,1026,1112,1417,305,348,391,418.51177659894006,190,228.6209344579879,140.3516347120089,189.15043023731144,242.11962805299686,0.5447051216260264,84186,83107,Orangeburg,Orangeburg,45,75,South Carolina,SC
45077,45CS027,1108,1052,1165,1319,154,211,267,193.14812286959676,145,132.83253939171857,4.812015962329109,59.520781968697804,109.63865530046364,0.6844772657353357,1370,1302,1438,1697,259,327,395,247.5161054967665,296,224.0082338161619,-28.728626741879012,25.10403072382514,76.45449711784256,0.9022661868260342,130992,132138,Pickens,Pickens,45,77,South Carolina,SC
45083,45CS028,2833,2691,2975,3356,381,523,665,190.96206294600142,382,139.45295744311906,-3.864355705517458,52.18207033876335,104.8127514753262,0.7288718673255442,3518,3345,3691,4304,613,786,959,234.5997693436643,803,239.76161186685616,-54.38660477836202,-4.286203348709453,49.098981003376416,1.020703679516805,328713,334916,Spartanburg+Union,Spartanburg,45,83,South Carolina,SC
45087,45CS028,328,317,340,409,69,81,92,356.1929157502264,43,190.09025603241852,112.91060447790025,167.97269632745068,219.10808540735974,0.5271299968088438,398,384,412,516,104,118,132,437.66625704386354,71,262.6225263547254,121.0568545678451,173.86362076164704,227.53096083677596,0.5950232294376413,27145,27035,Spartanburg+Union,Union,45,87,South Carolina,SC
45085,45CS029,963,917,1008,1223,215,260,306,296.1406916026439,127,144.41938479616397,98.96380141238126,151.94954663609283,203.6425301950521,0.48580606920336866,1173,1119,1227,1514,287,341,395,325.22767955176687,206,196.46365422396855,77.90637672354615,127.72083605595164,182.31971690884146,0.6023141181204328,105526,104854,Sumter,Sumter,45,85,South Carolina,SC
45091,45CS030,1932,1810,2055,2240,185,308,430,129.9385267370902,224,94.63522486427873,-16.935603866477663,33.62906989914897,88.74254266165588,0.7259473380074761,2408,2259,2556,2837,281,429,578,149.17263246737488,370,128.512382341704,-30.676923137824645,21.35293494823424,73.43129139051146,0.8594998257431563,284038,287910,York,York,45,91,South Carolina,SC
46005,46CS001,174,166,182,195,13,21,29,132.50672702297993,36,226.97420270057268,-141.9393822567908,-92.86045042188196,-44.62194224613527,1.6351245739999631,213,204,223,184,-39,-29,-20,-153.70874749229571,13,67.97385620915033,-275.97012726714956,-224.28410124191532,-172.87712144245063,-0.45779809467506116,19033,19125,Clark and Nearby Counties,Beadle,46,5,South Dakota,SD
46025,46CS001,35,35,36,34,-2,-1,-1,-41.533040714290294,0,0,-53.61375103634918,-41.19612136027063,-29.841486262734968,-0,43,43,44,31,-13,-12,-12,-319.2007972672459,6,155.68240788790868,-488.0092535502364,-474.77099561466576,-460.66229957018095,-0.5308795501663185,3834,3854,Clark and Nearby Counties,Clark,46,25,South Dakota,SD
46029,46CS001,210,198,223,300,77,90,102,379.98463908924043,68,288.441145281018,41.353405181618754,91.88620674764084,141.60337956660678,0.7507061716434018,260,245,274,280,6,20,35,72.06915009477835,17,59.8380851812742,-38.8363816841735,11.446103652016744,60.1213955803563,0.7916238543746432,28290,28410,Clark and Nearby Counties,Codington,46,29,South Dakota,SD
46039,46CS001,40,40,40,40,-0,-0,0,-0.7550733576320152,4,111.6019530341781,-124.06690390169982,-112.22632668010837,-99.60076970072629,4.111263483779964,49,48,49,41,-8,-8,-7,-175.9171252065025,4,93.54536950420955,-281.0536650491805,-269.0351829679866,-257.65113522165615,-0.61328846393054,4301,4276,Clark and Nearby Counties,Deuel,46,39,South Dakota,SD
46057,46CS001,54,54,55,90,35,36,36,689.2715159453571,28,543.3376455368692,134.2684530156614,146.25348395245913,158.00747144893637,0.7666935446305471,67,66,68,53,-15,-14,-13,-225.2949228519024,5,80.10253123998719,-318.226506562727,-305.46648181545976,-292.49821593821565,-0.38276313244536597,6184,6242,Clark and Nearby Counties,Hamlin,46,57,South Dakota,SD
46077,46CS001,56,56,57,57,0,1,1,16.821853815588746,12,278.7996127783156,-274.1290496945504,-262.6580848172472,-249.7094289252435,6.9603928285995105,69,68,70,72,2,3,4,57.78029967928361,8,153.99422521655438,-108.2767331902641,-96.55040681366562,-82.69675495407785,1.9991570712448459,5165,5195,Clark and Nearby Counties,Kingsbury,46,77,South Dakota,SD
46115,46CS001,61,60,61,95,34,34,35,646.5235879968129,20,378.5488958990536,255.10786489243193,267.6485891366412,278.7317368806182,0.5688606332323628,73,73,74,68,-6,-5,-5,-87.16969401153202,10,159.26102882624622,-258.61497298798247,-246.32578546136548,-233.6195482988297,-2.2354435859090964,6340,6279,Clark and Nearby Counties,Spink,46,115,South Dakota,SD
46027,46CS002,94,93,96,98,2,4,5,31.201364597386757,12,96.76118801236393,-78.05332606509502,-65.67539941408509,-54.18943067364695,2.4643241675374767,118,116,119,115,-4,-3,-1,-16.536486286980672,5,33.051295610787946,-62.46568217566195,-49.71844351892275,-35.388759940203975,-3.3296936552002667,14882,15128,Clay+Turner+Union+Yankton,Clay,46,27,South Dakota,SD
46125,46CS002,92,92,93,127,34,35,35,481.49755635900993,37,514.7826086956521,-45.347235532928174,-32.99001140253405,-20.28878866984194,1.0391029357562083,114,113,115,109,-6,-5,-4,-57.950141010109874,4,45.96116281741928,-116.60241748483693,-104.11470841854566,-90.38268069939414,-0.9892662700147787,8625,8703,Clay+Turner+Union+Yankton,Turner,46,125,South Dakota,SD
46127,46CS002,119,117,121,142,21,23,25,165.96047420083943,26,186.65868979958123,-32.76065880491935,-20.68549956803567,-9.037140187016426,1.078081680680287,147,145,149,129,-20,-18,-16,-107.63524878779143,8,47.43270484999407,-168.3887990562499,-154.6226554344839,-142.67863611145847,-0.4663700264776807,16715,16866,Clay+Turner+Union+Yankton,Union,46,127,South Dakota,SD
46135,46CS002,215,205,225,228,3,13,23,67.5292996291857,27,139.7394979729147,-123.41022525935247,-73.68870591891093,-17.613936409013547,1.9220110315182677,263,251,275,268,-7,5,17,19.763091764751362,13,55.8227413260048,-86.17876373177123,-34.21881043450048,15.153934086290917,2.3204221669696214,23186,23288,Clay+Turner+Union+Yankton,Yankton,46,135,South Dakota,SD
46003,46CS003,25,24,25,41,16,16,17,714.02577289073065,11,482.2798684691268,220.3262556575706,231.77578019739607,243.57656451117134,0.6363627693494497,31,30,31,46,15,15,16,563.4220724148414,6,218.49963583394026,332.3410544490354,345.28091227620985,358.04889245234165,0.3642639991496348,2737,2746,Douglas and Nearby Counties,Aurora,46,3,South Dakota,SD
46009,46CS003,69,68,69,95,26,26,27,452.0519598143733,21,361.3939480854725,78.15168177159221,91.08639985144139,101.66547965987866,0.7701338862007242,85,84,86,106,20,21,22,299.9240444975466,2,28.534741047224998,258.927473731569,270.9221122606344,284.6664187635447,0.09081960767547813,6973,7009,Douglas and Nearby Counties,Bon Homme,46,9,South Dakota,SD
46015,46CS003,47,46,47,48,1,1,2,33.36215937362409,4,91.34157944814463,-69.87567693883541,-57.79138044673155,-45.57320362435583,1.6253657421657628,57,57,58,49,-9,-8,-8,-156.49070022939856,5,95.32888465204957,-263.8659113870847,-251.85343731361334,-239.53033085340826,-0.6936797370055444,5255,5245,Douglas and Nearby Counties,Brule,46,15,South Dakota,SD
46023,46CS003,97,96,98,130,32,33,34,424.5397129718138,16,205.9643853250375,206.97864111881375,218.52163291181793,231.55555952690443,0.47086992580372894,118,116,119,117,-2,-1,1,-6.326739649027179,13,141.45810663764962,-160.36471048487383,-147.85768053002644,-136.26587312024648,31.057931609934737,9322,9190,Douglas and Nearby Counties,Charles Mix,46,23,South Dakota,SD
46035,46CS003,193,184,201,221,20,28,37,170.6422387302199,52,313.2530120481928,-196.6694541424664,-142.27151031666764,-89.04800636683721,1.7731335845220946,236,225,246,235,-11,-1,10,-3.3070383765539333,14,70.40128733782561,-120.32036552317267,-72.53662687312342,-19.448397694317833,40.89234713996449,19920,19886,Douglas and Nearby Counties,Davison,46,35,South Dakota,SD
46043,46CS003,38,37,39,44,5,6,7,261.4389038977951,10,423.1311706629055,-208.74601553838326,-161.69144551672846,-106.86063162477572,1.3930151619071358,46,44,47,47,-0,1,3,38.18618913633315,7,248.13895781637717,-261.5228434379447,-209.3015688637987,-159.81018342294206,3.3698684918660202,2836,2821,Douglas and Nearby Counties,Douglas,46,43,South Dakota,SD
46067,46CS003,96,95,97,103,6,7,8,114.53941458460872,16,259.70512647098604,-156.8880826954101,-145.25632436848883,-133.27742328991397,1.9859537380768486,118,117,119,109,-10,-9,-8,-121.20048493165338,5,67.46727836999055,-201.72205068425447,-188.40612522627933,-175.59289353820012,-0.6263962420558111,7393,7411,Douglas and Nearby Counties,Hutchinson,46,67,South Dakota,SD
46083,46CS004,267,239,295,323,28,56,84,102.79081140386765,66,121.45376476000614,-70.93955483289692,-19.444769608417744,37.84250636629085,1.1607816191170202,345,310,380,310,-70,-35,-0,-52.344488334272455,14,20.72815030870138,-125.50145817854575,-72.05726172999475,-21.184647144467924,-0.40752179432860236,65210,67541,Lincoln+Minnehaha,Lincoln,46,83,South Dakota,SD
46099,46CS004,1301,1216,1386,1619,233,318,403,193.40477879953622,267,162.43510707332902,-21.749875230730247,27.883194367191155,84.36536910315533,0.8372376155129114,1620,1517,1723,1681,-42,61,164,30.409699975928405,124,62.1965410697805,-80.39923821584641,-31.944349706216833,20.57120850772645,2.012098206232967,197248,199368,Lincoln+Minnehaha,Minnehaha,46,99,South Dakota,SD
46011,46CS005,166,152,181,221,40,55,69,189.67178377937475,29,100.77025540047488,34.15316430794073,88.73878937434601,140.06108546899586,0.5217293230939243,208,190,226,203,-23,-5,13,-15.351956438054605,5,14.452955629426219,-81.67371862495133,-28.19651518205764,22.824599733574928,-1.1598211967441427,34534,34595,Miner and Nearby Counties,Brookings,46,11,South Dakota,SD
46061,46CS005,21,21,22,19,-3,-2,-2,-78.56568917656622,4,138.4881708020773,-228.94874323706043,-217.27336374122,-204.3785649454054,-3.151494741738499,27,26,27,34,7,7,8,213.53016068476182,2,57.15918833952558,143.76428832829953,156.61175049392617,168.45606112504305,0.236087919604357,3466,3499,Miner and Nearby Counties,Hanson,46,61,South Dakota,SD
46073,46CS005,20,19,21,32,11,12,13,831.9763103397831,15,1054.481546572935,-271.0851315562837,-221.16017422683848,-172.57478095426654,1.168691865503861,24,23,25,12,-13,-12,-11,-727.3263142231323,2,122.02562538133007,-903.3786960649131,-849.7291539323406,-797.9974537779706,-0.18313545365759662,1707,1639,Miner and Nearby Counties,Jerauld,46,73,South Dakota,SD
46079,46CS005,89,88,90,91,1,2,3,24.094504907680708,14,149.33333333333334,-136.42581451283033,-125.27901279048746,-113.85750470332599,4.29598102048829,106,104,107,118,11,12,14,113.85090643275474,4,36.78499172337686,64.6780044292326,76.66851168324312,89.75793066423375,0.29895036511513967,11250,10874,Miner and Nearby Counties,Lake,46,79,South Dakota,SD
46087,46CS005,63,63,64,80,16,17,17,355.0419144359033,23,488.4955752212389,-145.28214334506646,-133.61181051409073,-122.02907773082508,1.2982206561667087,78,77,79,74,-5,-4,-3,-73.72185356323587,2,35.149384885764505,-120.47959005608399,-108.98884672502557,-96.54609333449287,-0.6260224770833993,5650,5690,Miner and Nearby Counties,McCook,46,87,South Dakota,SD
46097,46CS005,27,26,28,26,-2,-1,-0,-74.31374475915479,2,105.03282275711159,-230.78393216588586,-178.75278131424497,-123.399084478667,-4.818608814351461,34,33,35,40,5,6,7,271.5164749035338,3,129.81393336218088,86.77783271172865,141.28389401957156,191.03931816895195,0.41238554710688835,2285,2311,Miner and Nearby Counties,Miner,46,97,South Dakota,SD
46101,46CS005,49,48,49,67,18,18,19,342.533058826847,15,283.15243039169417,47.18036908441826,59.39977735376926,71.14345798168307,0.7834661977152393,60,59,61,71,10,11,12,177.4485594386474,11,174.16086130462318,-9.070742621431062,3.602495929683544,15.414100327668404,0.9010742514882126,6357,6316,Miner and Nearby Counties,Moody,46,101,South Dakota,SD
46111,46CS005,22,22,22,18,-4,-4,-4,-209.6372495255089,3,154.63917525773198,-376.1579668117606,-363.9251788153653,-351.5090357427159,-0.9781664634892591,28,27,28,30,2,2,3,101.54424699861666,6,253.2714225411566,-164.21671268484042,-151.67902093765053,-139.935044600172,1.7618127726024186,2328,2369,Miner and Nearby Counties,Sanborn,46,111,South Dakota,SD
46017,46CS006,26,25,27,31,4,5,6,323.8187816808736,12,739.5993836671803,-468.1255887295962,-413.95895121527815,-361.2311325678519,1.918784340282408,31,30,32,53,21,22,23,1136.2313621478643,3,155.76323987538942,934.7806422712105,979.6589473890601,1031.9438438963705,0.13109701613646155,1947,1926,North Central South Dakota,Buffalo,46,17,South Dakota,SD
46021,46CS006,13,12,13,16,3,3,4,298.1863906954534,8,697.6744186046511,-411.74300809230385,-400.0045645931882,-387.35317783087277,1.8102807873532005,15,15,15,26,11,11,11,778.3265124459231,8,580.1305293691081,185.17765025491667,198.26255366925852,210.5619346384086,0.681830427262386,1376,1379,North Central South Dakota,Campbell,46,21,South Dakota,SD
46045,46CS006,34,34,35,42,7,8,8,227.17741800347332,10,302.6481715006305,-87.95194559444113,-75.67674318455246,-62.69035152536004,1.175596425816198,42,42,43,59,16,17,17,413.3193359558581,4,99.37888198757764,301.1779230800593,313.612775674241,327.0574307226164,0.226807472050811,3965,4025,North Central South Dakota,Edmunds,46,45,South Dakota,SD
46049,46CS006,28,27,29,38,9,10,11,535.0836190998451,4,222.73781902552201,265.37051002661633,312.96750641261565,361.934227895209,0.37703090075874585,35,33,36,30,-6,-5,-3,-210.70338523511973,6,280.8988764044944,-544.5555343744256,-491.1790488792423,-440.16949122269585,-1.7139799850049018,2155,2136,North Central South Dakota,Faulk,46,49,South Dakota,SD
46059,46CS006,41,40,43,42,-1,1,2,21.935885119066732,3,114.94252873563218,-143.5263435053556,-94.2736331143695,-37.00980697578933,1.9077578699991522,50,48,52,58,6,8,10,255.37746362634985,4,129.03225806451613,77.50226273070268,127.8101892506341,182.45353532343316,0.44859638479917063,3132,3100,North Central South Dakota,Hand,46,59,South Dakota,SD
46065,46CS006,156,148,163,175,12,19,27,131.06141966041034,28,190.1420406315432,-110.99734272964392,-56.561044033215545,-1.299262062704109,1.3793180755661696,192,183,201,209,8,17,26,97.89508977642244,20,113.02627860977678,-67.36221322869068,-15.435811720840624,31.18892675971362,1.0915519473732602,17671,17695,North Central South Dakota,Hughes,46,65,South Dakota,SD
46069,46CS006,18,18,18,20,2,2,2,162.7177139901567,5,475.81284694686747,-324.92411372683426,-313.4516346972202,-300.7410814515039,1.8450919966091373,22,22,22,36,14,14,14,1146.7035633836429,8,645.682001614205,488.17519264333146,500.98102642141174,513.8624187813837,0.5260507861876613,1261,1239,North Central South Dakota,Hyde,46,69,South Dakota,SD
46085,46CS006,30,29,30,51,21,21,22,681.7935453432541,3,96.51474530831098,572.8815661343892,585.4812538201065,597.1970690973376,0.13518131578585804,36,36,37,50,13,14,14,364.3781858555416,1,26.616981634282673,324.4676428492957,337.94308022431164,351.4020509155459,0.06807496318985934,3730,3757,North Central South Dakota,Lyman,46,85,South Dakota,SD
46089,46CS006,32,31,33,30,-3,-2,-1,-88.3142580588508,2,100.0834028356964,-237.8993116765917,-189.54251309666037,-136.48880667406786,-2.615017433365659,39,38,40,37,-3,-2,-1,-84.33921583377109,1,41.37360364087712,-176.87265120406894,-125.5109161709348,-71.28206323235902,-0.9629469133392179,2398,2417,North Central South Dakota,McPherson,46,89,South Dakota,SD
46107,46CS006,32,31,33,34,1,2,3,81.12008140544644,5,247.52475247524748,-218.5926096597408,-166.09947306745204,-114.07637892075678,1.894925871970698,40,39,41,32,-9,-8,-7,-322.2713492355454,1,40.42037186742118,-417.4145479028225,-361.1429407720088,-311.27610695253935,-0.14341043712127466,2424,2474,North Central South Dakota,Potter,46,107,South Dakota,SD
46117,46CS006,17,16,17,18,1,1,2,57.393587240537144,6,239.68042609853526,-195.28181411744248,-182.25229032880517,-170.4641249472835,2.4622932611596435,20,20,20,34,14,14,14,459.2533434654943,2,66.13756613756614,379.76995053882723,392.74280967511066,405.95564622587415,0.13433799249110406,3004,3024,North Central South Dakota,Stanley,46,117,South Dakota,SD
46119,46CS006,11,11,11,10,-1,-1,-1,-90.63445492021806,3,250.17373175816536,-352.68625789743925,-340.9827657236701,-328.43105278377396,-34.539064474238224,14,14,14,15,1,1,1,87.67011757675095,8,543.4782608695652,-468.5577715481035,-455.2291716948721,-442.903108655041,3.4926808874390165,1439,1472,North Central South Dakota,Sully,46,119,South Dakota,SD
46129,46CS006,61,61,62,69,7,8,8,178.69414834298726,14,316.7420814479638,-150.6958125302843,-138.21182483884274,-125.11646380001605,1.5733375287537048,73,73,74,86,12,13,13,241.1459664175537,5,95.1655881233346,133.61449619003506,146.21762644277646,158.11439384357874,0.36576955627951857,5304,5254,North Central South Dakota,Walworth,46,129,South Dakota,SD
46013,46CS007,299,283,316,390,74,91,107,284.053026306189,58,181.73747290910515,56.02162506652998,100.82989040356176,155.02434796722358,0.6328205419350613,366,346,385,372,-13,6,26,16.94247843140542,38,99.69305034499043,-138.2878322783804,-81.78921945153903,-26.51893005601661,5.0952240361500465,38297,38117,Northeast South Dakota,Brown,46,13,South Dakota,SD
46037,46CS007,63,63,64,93,29,30,30,654.2623781614262,25,553.3013648100332,89.7422195277112,101.45654632218721,113.05719229276997,0.8180158469923511,77,77,78,71,-7,-6,-6,-119.75836117003558,6,110.78286558345643,-243.61786845068625,-231.03389515491054,-218.13050273027187,-1.0936705412242476,5422,5416,Northeast South Dakota,Day,46,37,South Dakota,SD
46051,46CS007,78,77,78,94,16,16,17,263.47568805305286,33,530.262453133369,-278.6717808380326,-267.0147071472994,-254.92532410041866,1.896882008379089,96,95,97,96,-1,0,1,4.759932449298238,2,26.592208482914504,-34.31024011865186,-21.44225082610644,-9.182733772426555,1.4727599936994729,7468,7521,Northeast South Dakota,Grant,46,51,South Dakota,SD
46091,46CS007,33,33,34,41,7,8,8,205.54514061523543,7,191.34396355353076,2.256182087322021,13.89742138587266,25.946504982064628,0.8216419171829624,40,40,41,53,12,13,13,296.1935285722187,5,116.19800139437602,167.23079688377211,180.08559258973855,191.6516230566778,0.36376315071735266,4390,4303,Northeast South Dakota,Marshall,46,91,South Dakota,SD
46109,46CS007,95,94,96,108,12,13,14,149.59969675515606,29,338.91702376314765,-202.24962217473185,-189.37001127071218,-176.65329270956127,2.1013354704314873,116,114,117,121,4,5,7,53.52863246900132,10,98.26078412105728,-55.669578907647164,-44.79389216468369,-32.58435003432684,1.5509625528156192,10268,10177,Northeast South Dakota,Roberts,46,109,South Dakota,SD
46019,46CS008,95,94,96,101,5,6,7,74.49098996433837,19,221.46673142302086,-159.17309269356664,-147.2825909552312,-135.32103153298783,2.5707962859680062,117,116,119,141,22,24,25,226.30937747903297,22,211.01093420295416,1.9865306201030453,15.33353339216518,27.80091445806952,0.8944901793093867,10295,10426,Northwest South Dakota,Butte,46,19,South Dakota,SD
46031,46CS008,40,40,40,56,16,16,16,487.3249017520383,14,428.7901990811638,47.27382077525345,58.22911518049527,70.8066267513697,0.827855784036855,49,48,49,57,8,8,9,217.9095549747721,4,103.22580645161291,101.66848930680904,114.79779780925085,126.83148103828738,0.4235495562925944,3918,3875,Northwest South Dakota,Corson,46,31,South Dakota,SD
46041,46CS008,46,45,47,82,35,36,37,811.4206032624364,16,360.7666290868095,438.5294605409189,450.86968366433314,461.9926953216111,0.43259022550817766,56,55,56,92,36,36,37,694.7985859620205,11,209.8035475872592,473.0471409353065,484.8639305388527,497.90598651343055,0.29389534067842443,5322,5243,Northwest South Dakota,Dewey,46,41,South Dakota,SD
46063,46CS008,11,11,11,11,0,0,0,18.532756067676242,6,546.6970387243736,-539.8834052323695,-528.236828850972,-516.5051656936274,4.985885797252127,13,13,14,11,-3,-2,-2,-175.873589810919,5,377.0739064856712,-565.8405290075458,-553.5249964852707,-539.9849926031198,-3.753517606511627,1317,1326,Northwest South Dakota,Harding,46,63,South Dakota,SD
46081,46CS008,210,199,221,248,27,38,49,177.90392777408098,36,167.03398677647604,-38.87860131737133,10.292358207794075,59.69168753821158,0.9150353104333103,261,247,274,305,31,44,58,170.3270261563732,36,137.85708815194914,-24.7574570813375,32.0398218080126,79.58072171031372,0.7915706588580347,25863,26114,Northwest South Dakota,Lawrence,46,81,South Dakota,SD
46093,46CS008,195,182,208,193,-15,-2,11,-9.064891428659754,18,72.7664735210888,-129.2322219440072,-81.11394689352107,-27.378275622546383,-14.488647615081309,245,229,260,246,-14,1,17,4.704099092543606,28,92.94297284737436,-144.7612185443378,-88.19121086748139,-35.48688484115597,11.583857086601409,29684,30126,Northwest South Dakota,Meade,46,93,South Dakota,SD
46105,46CS008,32,32,32,45,13,13,13,549.7539919987559,11,467.2566371681416,69.75029683322917,82.33148440549824,94.63957623032032,0.7889758426261151,39,39,40,34,-6,-5,-5,-182.90984135345582,2,70.92198581560284,-266.80324321801345,-254.04893623464835,-241.91820568877478,-0.480993826423424,2825,2820,Northwest South Dakota,Perkins,46,105,South Dakota,SD
46137,46CS008,14,13,14,23,9,9,10,457.2978064815263,3,147.11892112791173,298.6856031332354,310.59116860242204,322.28879773494776,0.29055508740461916,16,16,17,41,24,25,25,1033.949506503992,4,167.99664006719865,853.4236052729859,865.9453278731145,878.9055646315011,0.15613815537356054,2447,2381,Northwest South Dakota,Ziebach,46,137,South Dakota,SD
46103,46CS009,815,768,862,1003,141,188,235,204.23361786191145,129,140.1704139011382,13.612490091377618,62.84689138631023,115.7450503184215,0.6826917513502097,1017,960,1075,1252,177,235,292,210.6145361982208,130,116.62749179121884,42.06267739664419,95.73337517872697,142.79705237297694,0.5513997945239373,110437,111466,Pennington,Pennington,46,103,South Dakota,SD
46007,46CS010,32,31,32,32,0,0,1,12.768216279112334,2,70.90103397341211,-69.87587571151509,-58.05012257541252,-45.23620382426875,1.4704043256912536,39,38,39,50,11,11,12,328.02504028496423,3,88.15750808110491,227.2970757000353,240.2953838127383,253.12801266032457,0.2466559187867256,3385,3403,Southwest Central South Dakota,Bennett,46,7,South Dakota,SD
46033,46CS010,82,81,83,91,8,9,10,123.97347916256322,11,156.30550621669624,-44.55458539284703,-32.17982251479277,-20.206006148610168,1.1311480161525704,102,101,103,96,-7,-6,-5,-68.85968121674505,5,58.356676003734826,-140.06169832489965,-127.3697565840065,-114.91016015477165,-1.0204295117646858,8445,8568,Southwest Central South Dakota,Custer,46,33,South Dakota,SD
46047,46CS010,100,100,101,109,8,9,9,150.97451704816402,3,51.80601525399338,87.61826059510797,99.26773538195218,111.52463770063103,0.3079234031621543,126,125,127,149,22,23,24,319.6338986180605,18,251.15110925073253,55.32326162204404,68.52169094450329,80.77712867012846,0.7528809770459552,6949,7167,Southwest Central South Dakota,Fall River,46,47,South Dakota,SD
46053,46CS010,48,47,48,76,28,28,29,840.9856055025313,26,776.1194029850745,52.971461815817506,65.15728029285633,76.83403136867743,0.891234502793241,58,57,58,75,17,17,18,433.2637834094947,3,75.39582809751194,344.3232879011924,357.79665766581434,371.1357526509037,0.16447759829165362,4020,3979,Southwest Central South Dakota,Gregory,46,53,South Dakota,SD
46055,46CS010,22,21,22,24,2,2,3,153.83136708609126,5,321.71581769436995,-179.9216665369706,-168.42330339304706,-156.74877314563824,1.474580083994262,26,26,26,28,2,2,2,108.1782055015452,7,380.4347826086957,-283.77318677727914,-272.1361751460785,-261.13209321234325,2.3407621467797557,1865,1840,Southwest Central South Dakota,Haakon,46,55,South Dakota,SD
46071,46CS010,25,25,25,42,17,17,17,712.2431643389767,13,539.0463026952315,161.57549185282946,173.26416440535039,185.19650191438032,0.7151922408860842,30,30,30,70,40,40,40,1392.9838042297367,3,104.60251046025104,1274.764893139859,1288.3893171716538,1301.3490620475177,0.07325868589743999,2894,2868,Southwest Central South Dakota,Jackson,46,71,South Dakota,SD
46075,46CS010,10,10,11,4,-7,-6,-6,-838.2143471327213,4,522.8758169934641,-1372.7954581618199,-1360.99659049341,-1348.4793077354946,-0.7390519037329356,12,12,12,13,1,1,1,84.07898835639153,2,225.7336343115124,-154.48622965985834,-141.56551738950697,-128.9359267219036,1.1461713222300083,918,886,Southwest Central South Dakota,Jones,46,75,South Dakota,SD
46095,46CS010,23,23,23,27,4,4,4,235.6844974554287,3,185.8544140423335,38.1431185909277,49.81999308251156,62.15138125938586,0.6244353288006882,28,28,28,30,2,2,2,110.78328657244506,4,209.53378732320587,-111.53759971650805,-99.06247930170127,-86.77617735283272,1.2841697750078067,1937,1909,Southwest Central South Dakota,Mellette,46,95,South Dakota,SD
46102,46CS010,134,128,140,191,51,57,63,499.10350568891533,33,288.2935352358765,157.18124378659056,211.41704899759608,260.2730903502812,0.5676861228515218,162,155,169,194,25,32,39,232.90205400192335,6,44.12089124200309,133.33184180536787,189.39787794544733,241.1089538562136,0.1836415176916041,13736,13599,Southwest Central South Dakota,Southwest Central South Dakota,46,102,South Dakota,SD
46121,46CS010,72,71,73,118,45,46,47,578.8884765116685,23,291.7856010149064,274.9803093186993,287.2301537878021,298.22361855492983,0.49323533992135327,87,86,88,140,52,53,54,571.9812458625056,15,161.44656118824668,398.1603429520389,410.7152883228979,422.35286301856223,0.2770452621366339,9459,9291,Southwest Central South Dakota,Todd,46,121,South Dakota,SD
46123,46CS010,65,64,66,81,15,16,17,344.8070085178284,13,279.9210479095639,53.21184040911138,65.22013255491918,77.8283653199863,0.7641030430811122,79,79,80,68,-12,-11,-11,-202.67586837350694,2,35.88087549336204,-250.78655604340258,-238.65421811257812,-225.93764294972794,-0.19422844535893635,5573,5574,Southwest Central South Dakota,Tripp,46,123,South Dakota,SD
47001,47CS001,863,830,897,928,31,65,98,100.43490923351837,69,107.23305057307516,-56.72489272688781,-8.343732193617752,40.2354040423649,1.0514176878915131,1062,1022,1102,1271,169,209,249,270.111657243561,140,180.59389592631769,39.541311870385904,88.4318478923081,143.95331874055287,0.6654120198557356,77215,77522,Anderson,Anderson,47,1,Tennessee,TN
47003,47CS002,450,428,472,514,42,64,86,152.52334647130075,68,162.2363162812891,-58.6286028851892,-10.49241488260253,42.77832396739814,1.0472995976245163,560,533,586,668,82,108,135,212.35068370463713,112,219.6078431372549,-58.90154449991079,-5.740749857627046,42.800194765185815,1.0247134470584582,50297,51000,Bedford+Lincoln+Moore,Bedford,47,3,Tennessee,TN
47103,47CS002,385,369,400,461,61,76,92,260.51180112033154,42,143.2021593976417,66.78451746994146,116.54035861623517,168.77899326203288,0.5425940156167695,473,454,491,550,59,77,96,218.83091902833428,94,265.424255259071,-98.31974070280744,-45.938841721784016,7.8597335663657235,1.1974679416974818,35195,35415,Bedford+Lincoln+Moore,Lincoln,47,103,Tennessee,TN
47127,47CS002,59,58,60,68,8,9,10,164.92058991599598,4,74.14272474513439,78.40603514585361,91.12281668991297,102.8107831727981,0.40414385564284533,74,73,75,95,20,21,22,314.1233205321792,17,256.91400936980506,44.815007066540126,57.28644629113195,71.0348359217528,0.7803341072408986,6474,6617,Bedford+Lincoln+Moore,Moore,47,127,Tennessee,TN
47005,47CS003,215,208,222,264,42,49,56,372.2989231207245,34,257.00787401574803,65.83637303484254,116.68450296970731,168.69658878626737,0.6765893800818236,261,253,269,331,62,70,78,440.8157158008669,56,353.02275735989406,36.69454578804564,87.31667221723806,140.15093871479291,0.7895486653896644,15875,15863,Benton+Carroll+Henry,Benton,47,5,Tennessee,TN
47017,47CS003,367,355,379,459,80,92,104,390.48240552332305,53,224.62386098749732,115.55984828947778,164.9559434881912,213.964980393383,0.5690705419966609,447,432,462,484,22,37,52,129.79650065903516,73,256.7710165318326,-180.0854282304765,-126.00309269503681,-77.6018195373765,1.9260631765987237,28314,28430,Benton+Carroll+Henry,Carroll,47,17,Tennessee,TN
47079,47CS003,401,387,415,473,58,72,86,268.63497520824177,46,171.6631421818634,42.742619618534924,96.50967051984424,147.86651460577187,0.630264603170647,489,472,505,567,62,78,95,242.63736649007382,71,220.35318581049623,-31.913400145050318,23.36603033587179,73.36988609629324,0.8966889788366466,32156,32221,Benton+Carroll+Henry,Henry,47,79,Tennessee,TN
47007,47CS004,141,135,148,150,2,9,15,69.04506715410103,6,48.05125467164975,-30.717678750513198,20.96724327570104,72.58048385918873,0.6236080946951367,174,167,182,184,2,10,17,62.891219777861416,37,243.5813034891376,-230.92247180278824,-179.97817007131343,-132.86679209893174,3.506053438640581,14984,15190,Bledsoe+Rhea+Van Buren+White,Bledsoe,47,7,Tennessee,TN
47143,47CS004,360,346,374,431,57,71,85,258.08402207437956,46,167.41985381092476,38.3236960855141,88.52503070161964,145.22574782295376,0.6396819544476455,439,422,456,552,96,113,130,340.3520392074738,66,199.3837230378829,90.17729111979455,142.25056986369734,194.04820436731563,0.5806621962242154,32971,33102,Bledsoe+Rhea+Van Buren+White,Rhea,47,143,Tennessee,TN
47175,47CS004,78,77,79,77,-2,-1,-0,-20.627525186873438,7,136.71875,-169.5475548495973,-157.4678957402001,-145.15466620102882,-124.7120719660906,98,97,99,146,47,48,49,758.8123009388287,36,571.2472231037766,174.92477990253684,187.63613072089078,200.04335663730754,0.737397399062368,6144,6302,Bledsoe+Rhea+Van Buren+White,Van Buren,47,175,Tennessee,TN
47185,47CS004,320,308,332,346,14,26,38,113.92879139977614,32,139.93659123209798,-81.72946292538026,-26.513047074703756,27.49101007760192,1.1828778560449411,391,376,405,483,78,92,107,334.03768637787323,73,264.3299417025745,18.103373164302365,70.6167385503513,121.36554042354703,0.782831851105115,27441,27617,Bledsoe+Rhea+Van Buren+White,White,47,185,Tennessee,TN
47009,47CS005,1284,1226,1342,1417,75,133,191,117.68494089753162,105,93.01501528103823,-26.184400568767984,24.76686215147153,76.61781973517597,0.7844681549262068,1594,1523,1665,1917,252,323,394,235.0875256924672,192,139.83161942494246,44.18692789156827,94.27544155944236,142.97400689609353,0.5929696411642682,135462,137308,Blount+Loudon,Blount,47,9,Tennessee,TN
47105,47CS005,596,572,620,600,-20,4,28,8.64945806212322,47,102.34263006042569,-144.83140124461215,-95.37524550892608,-41.47082060022183,9.45257230291611,745,716,775,834,59,89,118,156.83803597031434,94,166.4954479436041,-66.31839883062825,-10.242638175426197,45.335801875704625,1.0497208271310032,55109,56458,Blount+Loudon,Loudon,47,105,Tennessee,TN
47011,47CS006,970,923,1017,1194,177,224,271,246.9533972287919,72,79.40081790194367,116.14130303680358,167.34733379522876,216.02824185286386,0.3200920689181599,1204,1147,1261,1597,336,393,450,357.23649820268287,219,199.17238870447002,103.41985389302998,156.37270197193402,206.27323233296607,0.5561207169744383,108815,109955,Bradley+Polk,Bradley,47,11,Tennessee,TN
47139,47CS006,216,209,224,246,22,30,37,205.42540529939765,13,89.28060436101414,67.82760679577628,115.20437051102618,169.08034432376328,0.4205534038370703,267,258,276,347,71,80,89,449.8770173973569,41,231.03798038994705,168.10398858949736,219.85976204502876,265.8588576042253,0.5072049357557178,17473,17746,Bradley+Polk,Polk,47,139,Tennessee,TN
47013,47CS007,505,488,522,548,26,43,60,131.627123464715,41,124.93334349051571,-45.40749340063107,5.739595279573263,59.647767200350714,0.9276704146862269,616,596,637,779,142,163,183,411.8370411736783,80,202.3574644609703,159.8853413774453,210.1069468608245,261.06058765154523,0.48835381197961086,39381,39534,Campbell+Claiborne+Hancock+Scott,Campbell,47,13,Tennessee,TN
47025,47CS007,368,354,382,409,27,41,55,153.2210785748821,24,89.8764199226064,11.674557989933554,65.66490418089307,115.14911002103051,0.5725855302695312,450,434,467,598,131,148,164,457.84367005785185,111,344.3568902401191,62.29327707592281,113.58544808286611,165.43660955455172,0.7470656040101054,32044,32234,Campbell+Claiborne+Hancock+Scott,Claiborne,47,25,Tennessee,TN
47067,47CS007,85,85,86,94,8,9,9,154.30657326759476,5,90.40229019135151,51.8224945154188,64.10817703372236,75.72900676213935,0.5244146819313303,106,106,107,126,19,20,20,289.40575778216834,18,266.1540736359604,10.153998878076928,22.928054614697714,36.059350610189234,0.8749539446624346,6637,6763,Campbell+Claiborne+Hancock+Scott,Hancock,47,67,Tennessee,TN
47151,47CS007,232,223,242,242,0,10,19,53.21827833794913,28,153.50877192982455,-151.71004300182864,-100.8433647890848,-49.177086471851545,2.615108197437843,283,272,295,377,82,94,105,427.09967790246895,56,255.63772482424906,118.1185596461905,170.7782355870734,221.31082249533213,0.5922137297102398,21888,21906,Campbell+Claiborne+Hancock+Scott,Scott,47,151,Tennessee,TN
47015,47CS008,159,152,165,181,16,22,29,183.90686354577875,16,131.93156050298907,2.0730646400162396,53.195225184829404,99.21452963909599,0.6865978917919586,193,186,201,215,14,22,29,150.07134575248253,27,185.54150632215504,-90.16899310637415,-35.90774782624924,17.530636855730812,1.1822203395790987,14553,14552,Cannon+DeKalb+Warren,Cannon,47,15,Tennessee,TN
47041,47CS008,215,206,224,274,50,59,68,350.03317875723127,30,177.8831900385414,120.07020886225509,171.7384729730393,223.21259535586347,0.4997243553986538,264,254,275,335,60,71,81,345.85355956791904,45,220.23197768315958,74.02792314329855,126.01411493588623,179.54895851880144,0.6278930361183237,20238,20433,Cannon+DeKalb+Warren,DeKalb,47,41,Tennessee,TN
47177,47CS008,434,416,451,503,52,69,87,201.99892726537138,51,148.86526720342488,1.661676995281092,55.57694448856897,102.30514283228041,0.7264631375174778,533,511,554,612,58,79,101,191.60964854738276,90,217.12907117008442,-78.46241282599051,-25.095655589335575,21.625688948502543,1.1190939909347115,41111,41450,Cannon+DeKalb+Warren,Warren,47,177,Tennessee,TN
47019,47CS009,654,630,678,786,108,132,156,281.1063635085986,87,185.40882290260708,46.19533312160869,95.68490368272835,149.48366689593882,0.6546054928910605,804,775,833,955,122,151,180,269.2671789519842,128,227.92022792022792,-10.466719524330268,42.177610312333506,97.15846328086236,0.8408857149910726,56308,56160,Carter+Johnson+Unicoi,Carter,47,19,Tennessee,TN
47091,47CS009,224,216,232,258,26,34,42,225.9383730498713,33,220.50225513670026,-51.52539324344994,3.997833194316334,58.02198430887109,0.9479064959565057,278,269,288,303,15,25,34,136.7712373290827,44,242.55788313120178,-160.03860666969905,-106.15250653318427,-49.7336122695744,1.7047456178666507,17959,18140,Carter+Johnson+Unicoi,Johnson,47,91,Tennessee,TN
47171,47CS009,251,244,259,291,32,40,47,267.1920654671387,26,174.7311827956989,43.90914357998421,93.43366282459871,142.53179609352867,0.637908768744247,306,297,315,375,60,69,78,389.79820683393325,34,191.8411104214862,144.9979548569134,197.6602729102852,247.01629313165697,0.48513256881494976,17856,17723,Carter+Johnson+Unicoi,Unicoi,47,171,Tennessee,TN
47021,47CS010,374,356,392,434,42,60,78,175.01634598083868,29,84.68183477308675,38.4026053563293,90.22533568630695,139.4324743442207,0.47591066454895087,461,440,483,565,82,104,125,249.9766862679688,64,154.3693769748426,40.86803159275559,94.41619909428688,145.71276610380434,0.6116334535356641,41095,41459,Cheatham+Dickson,Cheatham,47,21,Tennessee,TN
47043,47CS010,516,492,539,565,26,49,73,108.75483128811474,68,149.8952937286454,-92.59939847285725,-39.7053223681052,8.660827103055858,1.350904918783985,638,610,667,771,104,133,161,240.8629664749403,140,253.77490166222563,-66.36655330766892,-12.454972211395479,45.001387580565,1.0457370056573863,54438,55167,Cheatham+Dickson,Dickson,47,43,Tennessee,TN
47023,47CS011,167,160,174,195,21,28,35,193.65457096778533,27,186.6682030304776,-44.68535249261139,6.920541630756406,56.98720034040348,0.9306968675789739,206,197,215,263,48,57,66,324.57686765643916,41,234.54035810308335,38.25958831726823,89.8382277967859,139.82167945035292,0.7100884945731312,17357,17481,Chester+Madison,Chester,47,23,Tennessee,TN
47113,47CS011,909,867,952,1128,176,219,261,265.80998972217856,155,188.50714502888414,27.446418754100574,77.85931682472606,131.6143749755918,0.705950089699226,1118,1067,1169,1300,131,182,233,184.6874109108627,171,173.12072892938497,-35.64142549278925,13.30702209266152,59.67156801926064,0.9322611923348725,98670,98775,Chester+Madison,Madison,47,113,Tennessee,TN
47029,47CS012,461,445,476,571,95,110,126,367.62946409207444,65,216.2881623824973,101.68651800061807,152.70176236537043,202.7335518163244,0.5830545787710166,566,547,585,737,152,171,190,470.95482906992345,97,266.77667766776676,151.93011300906622,203.89702673145501,256.712030410509,0.5631703677250208,36063,36360,Cocke+Jefferson,Cocke,47,29,Tennessee,TN
47089,47CS012,565,541,589,642,53,77,101,168.27574756299887,61,133.323619408422,-16.798944462846972,32.054691702942414,87.20165889796955,0.7821338703576937,698,670,727,891,164,193,221,346.9389044247001,132,237.77785783766257,60.03039949255054,107.79059094188302,164.21517301788037,0.6818193672459283,54904,55514,Cocke+Jefferson,Jefferson,47,89,Tennessee,TN
47031,47CS013,604,579,629,669,40,65,90,134.83854969026126,70,144.83507767643152,-64.85679407503417,-11.386932546192847,35.86826289818384,1.0579036821975096,745,715,776,875,99,130,160,220.16416319180493,129,219.03015484922577,-48.48891219688297,1.56138787165618,53.31021026935656,0.9872356888122809,57997,58896,Coffee+Franklin,Coffee,47,31,Tennessee,TN
47051,47CS013,436,418,455,546,91,110,128,308.02816292629194,51,143.1578947368421,111.6481495569892,164.37791630800777,213.30795682843518,0.46055885476125835,536,514,558,650,92,114,136,264.4645737200463,81,187.70856507230255,24.307789556578584,76.22385905928462,134.58480048805774,0.7036029073007803,42750,43152,Coffee+Franklin,Franklin,47,51,Tennessee,TN
47033,47CS014,167,161,173,208,35,41,47,351.5579081790337,27,232.45802841153682,67.82255136092607,120.35412293603919,174.3480607357733,0.6454165107586701,205,198,212,212,-0,7,14,49.58832447557468,23,164.69745793054065,-166.79747598175817,-115.93755926974302,-60.00978401684386,2.902204718143328,13938,13965,Crockett+Gibson+Haywood,Crockett,47,33,Tennessee,TN
47053,47CS014,597,575,618,724,106,127,149,304.5552458025829,87,207.93499043977053,45.19962059468192,96.67446215653248,146.32991115152254,0.6774333677577039,733,707,759,919,160,186,212,368.03263584608777,102,201.91222756695765,111.86936568139765,167.93394871422316,216.5776706947677,0.5456907780553304,50208,50517,Crockett+Gibson+Haywood,Gibson,47,53,Tennessee,TN
47075,47CS014,190,182,197,230,33,40,48,272.71152078321677,40,271.1251694532309,-49.52977692235272,3.0138236139570815,51.865015258214584,0.9700723065568561,232,223,241,286,45,54,63,303.3565377176277,41,231.52069569145635,24.620084875859792,72.89784938172185,125.51515165907576,0.7492497095951489,17704,17709,Crockett+Gibson+Haywood,Haywood,47,75,Tennessee,TN
47035,47CS015,738,712,765,865,100,127,153,247.71678616031215,64,125.2221551906866,73.85037393748301,122.62189275733019,172.88967219623242,0.5015438731173427,912,880,944,1248,304,336,368,539.8592223057997,182,292.2333370799146,196.38174730452593,249.08596153382325,301.0901157885233,0.539708736595106,61331,62279,Cumberland+Fentress,Cumberland,47,35,Tennessee,TN
47049,47CS015,222,214,230,273,43,51,59,330.14388022265797,32,206.86311479825457,70.04129569797179,125.10441445325658,170.13957673646925,0.614551342011984,274,264,283,378,95,104,114,555.555751924239,62,329.75215402616743,175.0487483890162,223.9008100202327,279.8789628200424,0.5879251971738015,18563,18802,Cumberland+Fentress,Fentress,47,49,Tennessee,TN
47037,47CS016,4782,4476,5088,5572,484,790,1096,133.3566607361085,539,90.96982440348519,-8.327383517137362,43.188456803072555,95.27503433755142,0.6812920982158568,5843,5478,6207,5938,-269,95,460,13.491890649853104,687,97.35911625698839,-132.92722661084505,-84.0050933924078,-33.81787532027584,7.141112137555218,711005,705635,Davidson,Davidson,47,37,Tennessee,TN
47039,47CS017,151,146,156,199,43,48,53,499.69255924560963,22,230.95092292887762,219.44311904729926,268.5133753550999,323.92172452216613,0.45267601136546537,183,178,189,210,21,27,32,233.41178520455227,22,193.10102694637058,-10.919039603811841,40.0141506394151,87.22022068135554,0.7973150867226761,11431,11393,Decatur+Henderson+Lewis+Perry,Decatur,47,39,Tennessee,TN
47077,47CS017,293,281,305,366,61,73,85,314.9494105241175,55,236.84777147778655,23.48200117063036,77.97365417735212,129.44621165980166,0.7418747622038175,358,343,372,436,64,78,93,280.5169408414662,74,264.91962911251926,-36.1802925180593,16.352087815763582,68.44397102354259,0.9324973123664207,27866,27933,Decatur+Henderson+Lewis+Perry,Henderson,47,77,Tennessee,TN
47101,47CS017,152,147,158,171,13,19,24,179.22907667820712,15,143.08426073131955,-9.819922746931368,34.69051825867637,86.12065652200359,0.7579899133710455,188,182,195,224,29,36,42,279.76171304957353,27,210.60842433697348,16.599471246394355,68.07570195676536,121.77467339613123,0.7323930351774562,12580,12820,Decatur+Henderson+Lewis+Perry,Lewis,47,101,Tennessee,TN
47135,47CS017,109,108,110,112,2,3,4,44.79305009693836,17,244.86856319769532,-211.69085874831177,-200.5374483055705,-186.7889257223527,4.136497101756847,135,134,136,145,9,10,11,114.85245840089581,21,248.34437086092717,-146.1038984386553,-133.9759395186004,-121.64766858533808,1.9604321530461306,8331,8456,Decatur+Henderson+Lewis+Perry,Perry,47,135,Tennessee,TN
47045,47CS018,407,392,423,533,110,126,141,410.3537666531367,63,205.927217258662,154.8020851070002,203.85052677008406,256.37729502782406,0.4978627633573142,498,480,517,627,110,129,147,351.0464196197044,85,232.11359912616055,65.8002021624416,118.77721068215159,172.85833185436942,0.6561011286857303,36712,36620,Dyer+Lake+Lauderdale,Dyer,47,45,Tennessee,TN
47095,47CS018,80,79,81,93,12,13,14,220.88705079121155,12,205.7142857142857,3.835012056285372,14.886294696736444,27.187885945874584,0.8642371351555789,100,99,101,137,36,37,38,524.0763343634636,16,225.1618350689558,286.6620534152646,298.72032136487775,311.6617990471625,0.4184005849388538,7000,7106,Dyer+Lake+Lauderdale,Lake,47,95,Tennessee,TN
47097,47CS018,255,244,265,296,31,41,52,197.04890195734436,32,152.53227408142996,-7.76772214177441,45.92073309437937,94.00412349293907,0.7558004575148692,312,299,325,358,33,46,59,182.33148097312676,51,203.13060102760187,-69.34373665578153,-20.42735856591163,29.894613266592394,1.090256920722877,25175,25107,Dyer+Lake+Lauderdale,Lauderdale,47,97,Tennessee,TN
47047,47CS019,378,360,396,461,65,83,101,237.81806509877595,41,116.9980024731285,70.09528132288492,119.88400633068991,174.87284772162891,0.4861311681748818,468,446,491,565,74,97,119,225.88908460950853,83,194.2383749502703,-19.698896332866518,32.631448372933754,80.8757514219238,0.8510667554454747,42052,42731,Fayette+Hardeman,Fayette,47,47,Tennessee,TN
47069,47CS019,259,248,270,333,63,74,85,348.67367456856334,50,236.6023896841358,60.155941601496465,111.63452653106421,164.0536172961581,0.6694922428041923,317,304,330,383,53,66,79,259.61052210978625,42,165.19823788546256,42.82039353570605,94.84426057126372,145.42743596612777,0.6268340573017371,25359,25424,Fayette+Hardeman,Hardeman,47,69,Tennessee,TN
47055,47CS020,343,330,356,413,57,70,83,279.8871109289837,43,170.84961260843653,61.33794821950894,108.8661585058034,157.56567354832347,0.6018790858025974,423,407,439,526,87,103,119,338.03041653268065,79,258.96544941978624,28.61351350107224,77.44648910612594,130.75493254743634,0.7587431301026175,30202,30506,Giles+Marshall,Giles,47,55,Tennessee,TN
47117,47CS020,325,310,340,369,29,44,59,153.966583736876,31,107.80421363781261,-4.191577396782927,45.489125403642426,94.79691408082756,0.6847140472290886,404,386,422,466,44,62,80,178.50531636592146,67,191.94957742443776,-60.7212776263851,-13.923241072420169,36.75202085151698,1.0583300890980474,34507,34905,Giles+Marshall,Marshall,47,117,Tennessee,TN
47057,47CS021,258,248,269,332,63,74,84,375.38183791252453,27,137.68485466598673,185.83508763662675,235.105632216143,288.1787682106616,0.36187024959788744,319,306,331,394,63,75,88,317.8571254223581,59,248.65138233310856,17.777721584343393,67.70311408791096,121.32687234925638,0.7720376977893895,23532,23728,Grainger+Hamblen,Grainger,47,57,Tennessee,TN
47063,47CS021,664,636,692,859,167,195,223,362.8964785104619,79,146.97218690893305,164.0196134913314,216.0057585956615,265.96797212714097,0.4029319049873518,813,780,846,1111,265,298,331,462.0077586650865,169,262.1658936133906,149.51206068084488,201.1238804600648,249.22669135827974,0.5655501741379759,64502,64463,Grainger+Hamblen,Hamblen,47,63,Tennessee,TN
47059,47CS022,837,807,867,931,64,94,124,160.55438172366232,88,150.63764229265925,-40.7019037347225,11.413144044866645,64.30933497534086,0.9283366915138302,1030,993,1066,1286,220,256,293,363.155997695362,167,236.6679421226422,75.62757440399123,126.68415302190955,174.50852637961592,0.6491644502323453,70102,70563,Greene,Greene,47,59,Tennessee,TN
47061,47CS023,181,175,186,197,11,16,22,146.20375931201633,17,150.8541004215041,-55.687503912807045,-7.042368104904634,44.78326419961761,0.9727656901320055,220,213,227,246,19,26,33,192.41904362410742,42,308.6192960540819,-169.66623800697946,-114.64489744097482,-64.0781866158094,1.5448953401708556,13523,13609,Grundy+Marion+Sequatchie,Grundy,47,61,Tennessee,TN
47115,47CS023,314,301,326,359,33,45,58,189.1265692179563,36,149.76599063962558,-12.811531215456679,37.16156983355759,91.02126844956116,0.7748384293192793,381,366,396,476,80,95,110,329.8385453165163,72,249.38519621765784,27.43893965722248,80.72444376918654,130.8110737161775,0.7482254087144297,28845,28871,Grundy+Marion+Sequatchie,Marion,47,115,Tennessee,TN
47153,47CS023,155,148,162,165,3,10,17,76.77473391169572,12,91.121938872366,-67.66525055717857,-15.227166382571914,40.249026694338816,1.0800503951461502,194,185,202,229,27,35,44,217.42846754925893,48,294.15369530579727,-128.70695399862416,-78.05985985462435,-23.299845225477156,1.3157902911951036,15803,16318,Grundy+Marion+Sequatchie,Sequatchie,47,153,Tennessee,TN
47065,47CS024,3189,3031,3347,3584,237,395,553,128.89371518840287,257,83.95743325465726,-5.941690692323803,44.25489692725197,96.672597256857415,0.649722758007277,3932,3741,4122,4514,392,582,773,157.87878082554053,527,142.88735487579376,-38.699607714488835,15.327567713805452,68.79218448893727,0.9034930906192326,367329,368822,Hamilton,Hamilton,47,65,Tennessee,TN
47071,47CS025,348,336,359,404,45,56,68,253.41647989873027,36,162.16824955891738,41.44565439470666,91.35031160106053,143.6386939431394,0.6287512573505656,427,413,441,530,89,103,117,382.40855272325985,71,264.1467316492429,67.8510112814007,119.2242295167215,169.69025339519843,0.6840894624993903,26639,26879,Hardin+McNairy,Hardin,47,71,Tennessee,TN
47109,47CS025,329,318,340,404,64,75,86,349.7898441937925,35,162.69610691458453,134.70052593880774,188.24252376938443,237.4260139335708,0.4590251812483114,402,389,415,464,49,62,75,239.73705072423195,50,193.37123409521598,-1.5112918431614715,46.14905729914269,99.83356260747495,0.7937917962009046,25815,25857,Hardin+McNairy,McNairy,47,109,Tennessee,TN
47073,47CS026,639,614,663,767,104,128,153,271.3880411379706,55,116.27702119412976,104.77074064224598,153.59386495496173,207.68582882755803,0.42514113034635254,787,758,817,1039,222,252,281,440.0050314618305,155,270.9884961012623,116.7059806958563,168.85147498296587,221.30464463652584,0.6134384709779415,56761,57198,Hawkins,Hawkins,47,73,Tennessee,TN
47081,47CS027,252,241,262,326,64,74,85,356.3526773988909,34,163.12822358162407,140.47207580903824,194.08592974728532,243.9387534607635,0.4516903441141971,311,298,324,378,54,67,80,264.4169124773827,60,237.58612497030174,-27.313906666567068,27.57156872343637,82.38997528722588,0.8852711192499044,25011,25254,Hickman+Houston+Humphreys+Stewart,Hickman,47,81,Tennessee,TN
47083,47CS027,102,101,103,128,25,26,27,380.1977211533895,17,246.46611090974986,122.22509288843551,133.85937103112906,145.49710927990833,0.6244458544307792,125,124,126,141,15,16,17,188.16104408657432,23,276.7083734359961,-101.07004830139279,-88.50232369343169,-74.71713093479082,1.382216025307861,8277,8312,Hickman+Houston+Humphreys+Stewart,Houston,47,83,Tennessee,TN
47085,47CS027,223,215,231,241,10,18,26,114.55887465475149,19,120.35472972972971,-56.966125853161,-6.5129135511437415,45.97298657466509,0.9955447966719787,275,265,285,350,65,75,85,390.7721095151844,43,224.2386316228619,116.54458591500571,166.03132631713052,215.73215361756388,0.5662778158717404,18944,19176,Hickman+Houston+Humphreys+Stewart,Humphreys,47,85,Tennessee,TN
47161,47CS027,151,146,157,158,1,7,12,57.294833359673405,20,175.1441290228417,-173.16410248042502,-117.70223534331578,-67.5243721469355,2.6516081793156565,187,180,194,208,14,21,28,153.52375312920879,25,180.76644974692695,-81.59915526410042,-28.76176329805069,25.053037007878434,1.1244882705770127,13703,13830,Hickman+Houston+Humphreys+Stewart,Stewart,47,161,Tennessee,TN
47087,47CS028,146,141,151,170,19,24,29,243.29991842915084,23,236.64580296664667,-43.84896499683604,5.911841787929746,59.2791062886812,0.9331868797745061,179,173,185,182,-3,3,9,23.551303871856835,21,179.01287187793028,-207.3986606698353,-153.1030599045109,-102.89140937944589,5.580945228424088,11663,11731,Jackson+Putnam+Smith,Jackson,47,87,Tennessee,TN
47141,47CS028,734,700,769,924,155,190,224,284.3976270450217,118,176.77019874163585,53.7804884708184,106.9296774760897,162.6817205049385,0.6183031482089717,907,866,949,1043,94,136,177,167.305959512273,91,112.32903767343109,4.61383147206267,55.94317316199686,104.3956787439828,0.666481595127339,80104,81012,Jackson+Putnam+Smith,Putnam,47,141,Tennessee,TN
47159,47CS028,184,175,193,217,24,33,42,198.0319984883967,21,126.06933813597479,21.48977266316925,72.74702462150856,123.64767571075674,0.6178800332486333,227,216,237,286,49,59,70,294.44286461146714,39,193.6637203297249,46.6661038355178,100.71796710682187,154.50988175301396,0.6468208316774611,19989,20138,Jackson+Putnam+Smith,Smith,47,159,Tennessee,TN
47093,47CS029,3993,3787,4200,4556,356,563,769,140.8704142721515,287,71.84699344114554,21.20342052543888,71.1356253324178,120.58326672565065,0.5091171376755919,4946,4696,5197,5783,586,837,1087,172.25792733028834,606,124.76272435673081,-5.76615387095416,45.48855721988541,98.04426719096367,0.7234139553761334,479352,485722,Knox+Union,Knox,47,93,Tennessee,TN
47173,47CS029,194,185,202,247,45,53,62,321.9200874671056,17,102.71903323262839,168.62567309461065,218.23107176659514,269.67611549275574,0.31320370380288265,238,228,249,349,100,111,121,553.3955226741846,48,239.90403838464613,262.6717981781299,315.0799612627136,365.0099662138133,0.4296325589382928,19860,20008,Knox+Union,Union,47,173,Tennessee,TN
47099,47CS030,484,465,503,595,92,111,130,300.3968731744777,62,168.12799421495072,81.41244798228269,130.9756235337167,182.27521717632123,0.5546790354530601,597,574,620,694,74,97,120,216.97664025652807,102,228.00938862188443,-63.01469263117473,-10.665974049441393,36.43449241231131,1.0401317498227125,44252,44735,Lawrence+Wayne,Lawrence,47,99,Tennessee,TN
47181,47CS030,176,169,183,196,13,20,27,148.42452610576575,19,139.98035363457763,-46.51719326233779,8.220267975160535,62.26544794965267,0.8985084707801043,216,208,225,264,39,48,56,292.71111576119404,32,195.37212284022223,52.79316380476115,97.08753686455266,146.81442094947474,0.6538197401110075,16288,16379,Lawrence+Wayne,Wayne,47,181,Tennessee,TN
47107,47CS031,600,577,623,708,85,108,131,242.86009811122557,61,136.911998503694,54.05294363532252,104.64257005634138,155.53452027852111,0.5585860994257634,743,715,771,948,177,205,233,379.58834385927366,123,227.98887859128823,97.38228381600835,151.74238140935373,202.51992772818747,0.5977027469506189,53465,53950,McMinn+Meigs+Monroe,McMinn,47,107,Tennessee,TN
47121,47CS031,162,157,168,156,-12,-6,-1,-57.432088295848665,17,160,-265.48550150097094,-218.73611777432288,-165.0642680728829,-3.3319225702475577,202,195,209,211,2,9,16,68.96624778661155,29,222.9054573405073,-206.9480796946405,-153.47470679635688,-104.46362365161902,2.9079944148350343,12750,13010,McMinn+Meigs+Monroe,Meigs,47,121,Tennessee,TN
47123,47CS031,516,496,536,606,70,90,110,232.96376392396792,53,136.90373686929564,44.473135704499526,96.97781908265323,144.30356023305472,0.5812165815503089,636,612,660,824,164,188,212,402.52980132098196,127,272.2284146446026,81.64166210678795,129.7674290309815,182.88328935369222,0.6727115256191123,46456,46652,McMinn+Meigs+Monroe,Monroe,47,123,Tennessee,TN
47119,47CS032,894,850,938,909,-29,15,59,17.625684662553297,105,124.3793372358173,-156.827509353107,-107.06363036542186,-56.936189771044205,6.612317151371091,1124,1070,1178,1199,21,75,129,72.19540024502436,143,137.08610541250454,-117.41886275075348,-67.24352793582743,-12.079512335727674,1.8739374788026841,101303,104314,Maury,Maury,47,119,Tennessee,TN
47125,47CS033,1274,1179,1369,1493,124,219,314,119.48435184037295,112,61.03375929811176,6.1621305936665225,58.39585085071812,110.1197220105566,0.5084905208240514,1621,1504,1739,1949,210,328,445,144.34384574514058,304,133.9696893577828,-43.24272555332533,11.062296991273842,59.148260182223204,0.9253038584771467,220206,226917,Montgomery,Montgomery,47,125,Tennessee,TN
47129,47CS034,214,205,223,227,4,13,22,73.35405412619922,11,62.56517205422315,-40.56019810821373,12.390107829671955,65.38452486062324,0.7915454151730329,265,254,276,335,59,70,81,330.8638564253585,42,197.92648444863337,81.23025551886917,131.78397377683078,182.97576376018682,0.5898105149919463,21098,21220,Morgan+Roane,Morgan,47,129,Tennessee,TN
47145,47CS034,659,636,682,750,68,91,114,203.14180901794884,54,120.9903282422794,27.88462009049102,81.44533609087968,133.84342704606496,0.589097924316236,812,784,840,923,83,111,139,205.6921132419112,114,211.41649048625794,-58.55842228206702,-6.608687030276944,42.801150845733396,1.0186456719032888,53558,53922,Morgan+Roane,Roane,47,145,Tennessee,TN
47027,47CS035,96,95,97,137,40,41,42,652.0988587895425,19,301.58730158730157,337.8373183467871,350.41971722179375,363.46051332358974,0.4514970061271749,117,116,118,139,21,22,23,291.43392313834295,16,211.78027796161484,66.43812269028611,79.46116551287894,91.64332497568797,0.6951132226177131,7560,7555,North Central Tennessee,Clay,47,27,Tennessee,TN
47111,47CS035,241,230,252,301,49,60,71,285.1660207514206,41,195.2380952380952,34.77024599568051,91.21527282464241,145.04930103319077,0.6734021736347776,298,285,312,342,30,44,57,170.5654614424361,59,230.18102372034957,-111.06492613176118,-58.92877235329898,-10.096311239834785,1.3193397133734355,25200,25632,North Central Tennessee,Macon,47,111,Tennessee,TN
47133,47CS035,268,259,278,343,65,75,84,397.63925762126894,42,223.32506203473943,124.27930042303096,174.6665434671234,229.26416875409313,0.5542162749440899,329,317,341,404,63,75,87,329.3878243769684,55,241.20691167441453,36.98538815118158,89.92341803957518,142.18668827366696,0.7226666605485358,22568,22802,North Central Tennessee,Overton,47,133,Tennessee,TN
47137,47CS035,63,63,64,79,15,16,16,376.3799675456571,18,430.793777423215,-67.12427347500338,-54.25276181388347,-42.08234561646665,1.0761424826463781,78,77,79,80,1,2,3,38.81647537014649,1,19.73554371422933,6.702855063717666,18.900195162642138,32.30137663757745,0.3370600027607863,5014,5067,North Central Tennessee,Pickett,47,137,Tennessee,TN
47169,47CS035,98,96,99,107,8,9,11,97.16186526761065,13,133.97457918241153,-49.03739337631392,-37.04909804475268,-24.38623860592729,1.2466508652821189,123,121,124,152,28,29,31,244.20869825225034,20,166.9449081803005,64.75702023460711,77.20755617442937,89.546840584204,0.6610214978912211,11644,11980,North Central Tennessee,Trousdale,47,169,Tennessee,TN
47131,47CS036,336,323,349,455,106,119,132,466.9248130837427,72,282.1500881719025,134.10935154695426,186.01456397506735,235.75141556223866,0.5992438031650024,410,395,426,497,71,87,102,284.1754699072711,74,242.60704216116977,-13.588807469441184,41.27808609940329,95.59817956060552,0.8439857851641467,30622,30502,Obion+Weakley,Obion,47,131,Tennessee,TN
47183,47CS036,338,323,352,380,28,42,57,154.44284299995502,35,127.50068303937341,-24.253461767230604,24.650358974422964,74.30343805324884,0.8065287827074232,416,399,433,496,63,80,97,241.9346019823873,59,178.7283026869831,16.30161871872623,63.69667065352488,108.5139357102886,0.7296107963414112,32941,33011,Obion+Weakley,Weakley,47,183,Tennessee,TN
47147,47CS037,608,576,639,769,130,161,193,265.97986431327314,73,120.298273802167,96.1487801033027,145.96844954670055,196.82667213064286,0.4494984457989343,755,717,794,959,165,204,242,275.38105526185035,116,156.93277595140495,62.993667064042775,118.48095568860349,171.26124957476048,0.5670890423251239,72819,73917,Robertson,Robertson,47,147,Tennessee,TN
47149,47CS038,1913,1766,2061,2287,226,374,521,130.88816124814565,235,82.34370026893102,-1.3906965560050926,48.94364907987628,102.34277639154774,0.6274352620606596,2426,2245,2607,2886,279,460,641,131.1798436810614,432,123.12533132684646,-44.222410199247,8.417629427610958,59.87161581032591,0.9365646078534656,342467,350862,Rutherford,Rutherford,47,149,Tennessee,TN
47155,47CS039,942,899,984,1105,121,163,206,198.80174811962902,86,104.67699236223106,44.38020069562349,94.08180713789345,146.5692944784152,0.5233354478684392,1164,1112,1215,1479,264,315,367,317.43887202939703,219,220.39288302069076,44.9722109285586,95.77549740846462,145.80984552955766,0.6920903838949302,98589,99368,Sevier,Sevier,47,155,Tennessee,TN
47157,47CS040,7068,6669,7468,9054,1586,1986,2385,256.39372926610287,955,123.30058228861373,81.87877603387898,133.08342760268482,183.41565897893972,0.48066122444872106,8666,8188,9143,12568,3425,3902,4380,421.8398794129341,1620,175.1228292065963,201.0341315581726,247.42973316662503,298.7202854054283,0.41503416899355927,929436,925065,Shelby,Shelby,47,157,Tennessee,TN
47163,47CS041,1807,1739,1875,2145,270,338,406,256.0350738353637,184,139.50931641698628,64.93261428117577,117.06744859097508,163.85518255530684,0.5432748015887142,2218,2136,2300,2690,390,472,554,296.6520102858802,319,200.51039008384979,45.74354377955371,96.87718066177905,144.274560825542,0.674481989924341,158269,159094,Sullivan,Sullivan,47,163,Tennessee,TN
47165,47CS042,1486,1402,1571,1729,158,243,327,147.93849058779367,188,114.65045839855263,-16.50699858917687,34.71341603702444,88.4928296363057,0.7718057532829601,1855,1752,1959,2298,339,443,546,221.2839067459041,337,168.43431061885863,3.037957269708231,52.452586601872945,104.24679573367793,0.7594530240079067,196772,200078,Sumner,Sumner,47,165,Tennessee,TN
47167,47CS043,519,492,545,598,53,79,106,155.99652675667843,64,125.74703233729022,-20.818812779519074,30.557322218351604,84.35780931840272,0.7960621565078211,635,603,666,804,138,169,201,277.31458340536045,126,206.56414964425065,15.592857294410797,71.21871805130894,128.3431976674929,0.7404954343864333,61075,60998,Tipton,Tipton,47,167,Tennessee,TN
47179,47CS044,1297,1240,1354,1539,185,242,299,219.0871156734588,151,136.5455189407926,32.499063108518286,81.52785159965389,133.08019491256482,0.6206857393268559,1602,1532,1671,1902,231,300,370,224.10365142848934,199,148.4332460635354,26.27982051611749,76.41409263766968,125.49137615093403,0.660144741020375,132703,134067,Washington,Washington,47,179,Tennessee,TN
47187,47CS045,1254,1147,1362,1390,28,136,243,65.44013197431445,138,66.64091172493721,-51.25600564152773,-0.3660745546601193,47.170612430687406,1.0108895861663818,1598,1466,1729,1670,-59,72,204,28.316507216699097,173,67.89239252006357,-91.78701138553822,-39.71100764574405,14.456660299056978,2.3648512180661236,248496,254815,Williamson,Williamson,47,187,Tennessee,TN
47189,47CS046,1045,981,1109,1283,174,238,302,192.75734554234174,144,116.5032833969337,23.484584213028135,77.72538138722808,127.5779810548836,0.6018776282005752,1312,1234,1390,1558,168,246,324,162.6140033289099,244,161.13268351956046,-48.99950251949981,1.7954838559976534,57.79136784309827,0.9868828188590599,148322,151428,Wilson,Wilson,47,189,Tennessee,TN
48001,48CS001,566,541,591,612,21,46,71,94.90165261468535,76,157.44225391016124,-115.63677095345571,-63.773434065866105,-9.97123949780794,1.623563567228909,697,667,727,884,157,187,217,320.8659358044977,138,236.6011727188561,30.915217501208254,83.68163198044954,137.99936626443005,0.7334641086053235,57926,58326,Anderson+Houston,Anderson,48,1,Texas,TX
48225,48CS001,237,227,246,308,62,71,81,384.01229816926735,27,145.91965411637543,186.48512249857487,238.4840915386137,288.49825108839315,0.37471336732275556,290,279,301,394,93,104,115,468.191526149244,70,315.0882247029168,97.95725514096011,153.74680395112281,206.70673864643484,0.6665814112259326,22204,22216,Anderson+Houston,Houston,48,225,Texas,TX
48005,48CS002,769,732,807,990,183,221,258,306.22313413589524,163,226.33125824442848,23.83910976038627,78.40839428186173,129.39545860169892,0.7357694155097207,945,901,990,1257,267,312,356,360.33933002030517,262,302.9497126602916,5.922163233975704,55.94908736476519,107.7009208317275,0.8380453049503274,86422,86483,Angelina,Angelina,48,5,Texas,TX
48007,48CS003,285,274,295,380,85,95,106,479.1260982196581,23,115.49566891241578,310.1218304851798,364.71765735613735,413.20395142696066,0.23855464162836718,354,341,366,429,63,75,88,307.877169284426,46,188.34704991196824,69.04635960591861,118.60543987245617,168.08489964890572,0.6037312608831064,23897,24423,Aransas+Calhoun+Refugio,Aransas,48,7,Texas,TX
48057,48CS003,163,154,172,216,44,53,62,314.5100595451768,11,65.3886164363204,199.55691239632725,250.3268090831493,297.04998761287874,0.20404962537965776,197,187,207,268,61,71,81,359.3653328302688,29,146.65722666127238,162.81211928599976,213.0921326956507,264.11977958685605,0.4024373777212003,20187,19774,Aransas+Calhoun+Refugio,Calhoun,48,57,Texas,TX
48391,48CS003,72,71,73,100,27,28,29,495.96568036515544,17,301.81979582778513,181.84220288215434,194.20484443282893,205.50176101249357,0.5875183398650734,88,87,89,112,23,24,25,353.8145441155961,13,192.4500370096225,149.28814699891237,160.65736978097905,173.06672062781593,0.5220847375049056,6759,6755,Aransas+Calhoun+Refugio,Refugio,48,391,Texas,TX
48009,48CS004,76,75,77,76,-1,0,1,0.518161256148675,4,55.878928987194406,-67.46441047239726,-55.397761591308665,-43.672974873486716,3.8569395182140824,94,93,95,112,17,18,19,207.41042956211757,22,253.95359575204895,-59.80208741972612,-46.68813065347228,-33.712478363144996,1.1598502741351515,8590,8663,Archer+Wichita,Archer,48,9,Texas,TX
48485,48CS004,1163,1107,1219,1403,184,240,296,221.25707274679814,240,221.52823715828498,-51.88719568601796,-1.346527392033816,49.84019765158831,0.9970660293641607,1430,1362,1497,1775,278,345,413,265.72178063682446,306,235.39729062334126,-20.928582608733336,30.60184133372863,83.24174736947528,0.8833215529187604,130006,129993,Archer+Wichita,Wichita,48,485,Texas,TX
48013,48CS005,350,328,371,485,114,135,157,328.5502024825172,89,215.85787335529636,62.6578374458379,113.05032732799569,164.31045948573112,0.6521867222747609,434,409,460,627,167,193,218,386.4972818290539,136,273.01013750878246,63.147602019201166,114.361026238787,162.623055568326,0.7027202784572217,49477,49815,Atascosa+Live Oak+McMullen,Atascosa,48,13,Texas,TX
48297,48CS005,101,100,102,131,29,30,31,314.864178182357,17,177.74679794371352,123.95298116883424,137.29220529057707,149.64094415788938,0.5463754696358886,122,121,124,155,31,33,34,286.3745299178454,30,263.8058389025677,9.808686855635072,22.37477365845559,34.761236637707434,0.8937479237969832,11477,11372,Atascosa+Live Oak+McMullen,Live Oak,48,297,Texas,TX
48311,48CS005,8,8,8,17,9,9,9,1822.6047423599755,6,1163.1663974151857,647.7677886789689,659.3362538945898,671.4430054065709,0.5768341781233343,9,9,9,14,5,5,5,807.8647943061889,3,494.23393739703454,300.65697396781115,313.4021500794358,326.62004949416973,0.508152519415786,619,607,Atascosa+Live Oak+McMullen,McMullen,48,311,Texas,TX
48015,48CS006,241,228,254,271,17,30,43,118.1120423313879,19,75.65451106613133,-6.916195688974671,42.98099923447038,97.48959759152768,0.6196422315555253,297,282,313,365,52,68,83,223.50364254956702,42,138.43111404087014,32.805791374294834,84.5828099939174,135.0726632822777,0.6103674827700377,30137,30340,Austin+Waller+Washington,Austin,48,15,Texas,TX
48473,48CS006,305,280,329,395,66,90,115,189.34113355150393,27,56.539568973038996,80.84134117151895,132.45822319571917,187.09013277245978,0.2953457432893485,389,358,420,501,81,112,143,188.7095560093396,78,131.2556793322788,9.68909598879505,57.33752343546531,112.28601274342488,0.6893958671965432,57305,59426,Austin+Waller+Washington,Waller,48,473,Texas,TX
48477,48CS006,320,305,336,416,80,96,111,320.45145970166925,65,217.80408801519042,51.205262592577604,103.51551593113452,152.99494421621986,0.6726452947186577,392,373,410,522,112,130,149,362.83673603429094,76,211.79945935401165,97.69370676262412,149.71921519169382,203.19967312797462,0.5792828366064816,35812,35883,Austin+Waller+Washington,Washington,48,477,Texas,TX
48019,48CS007,204,194,213,264,51,60,70,339.7689629515754,15,84.24205550615434,200.1079509724603,255.56498501930054,307.73346843311197,0.24390761358765956,251,240,262,329,67,78,89,362.70920310542897,49,228.10856105395465,81.71748195942362,134.56696486739412,187.79746739092266,0.6209325439951945,21367,21481,Bandera+Kendall+Kerr,Bandera,48,19,Texas,TX
48259,48CS007,329,310,349,379,30,50,69,132.23579017544327,38,100.92067988668555,-17.841979769207732,31.600680080054286,81.70483098496032,0.7481613512368622,416,392,440,457,17,41,65,87.60753710422622,58,124.84394506866417,-87.70408400191015,-36.67978136077929,15.9715813153747,1.3908636225426556,45184,46458,Bandera+Kendall+Kerr,Kendall,48,259,Texas,TX
48265,48CS007,635,612,657,699,42,64,87,146.20815688059793,51,116.15327677503842,-22.264841210907857,29.967325837974244,79.86751181757774,0.7822524228993093,778,750,805,863,58,85,113,160.79106707727263,92,173.29063853833114,-65.21720167647159,-11.022935409187768,38.81484948613033,1.0652589499822072,52689,53090,Bandera+Kendall+Kerr,Kerr,48,265,Texas,TX
48021,48CS008,680,638,722,697,-25,17,59,20.593390590675465,53,65.52715358699348,-96.33088619097938,-44.70945014326954,-0.4993362663631933,3.001736054981377,870,817,922,945,23,75,128,74.16020573378704,144,141.9222581408184,-116.70019371206642,-67.61990352087358,-20.114411259767934,1.8886258664385447,97059,101464,Bastrop+Caldwell,Bastrop,48,21,Texas,TX
48055,48CS008,332,312,352,414,62,82,102,215.7227869918002,50,131.27666557269444,32.79760148624548,86.24064860205536,134.58741757987164,0.6012259008467308,415,391,439,489,50,74,98,157.79229203061038,102,218.55113453750724,-109.14596044130384,-62.14767056197253,-5.903502299035133,1.366500156765798,45705,46671,Bastrop+Caldwell,Caldwell,48,55,Texas,TX
48025,48CS009,224,211,238,276,38,52,65,198.95525478089652,49,188.33477467089457,-39.19488852718115,10.536254344204798,63.894076565052934,0.9286778551022817,276,260,292,398,106,122,138,394.8531044369357,90,290.942005560225,52.816965424567876,104.44882297629562,151.89172514526499,0.730852520720183,31221,30934,Bee+Goliad+Karnes,Bee,48,25,Texas,TX
48175,48CS009,67,67,68,64,-4,-3,-3,-56.81405945212961,4,67.52004501336334,-136.7758394533385,-124.6050229189933,-113.76664828556615,-1.6907888896525962,83,82,84,98,14,15,16,210.35844143649385,19,266.1064425770308,-68.35831769882323,-55.46079704817433,-42.657997338109055,1.1860476314095203,7109,7140,Bee+Goliad+Karnes,Goliad,48,175,Texas,TX
48255,48CS009,133,127,140,156,16,23,29,183.34820922854306,24,194.37133022879124,-63.27273984548004,-10.25947534275895,39.92602455390203,1.015274803732627,164,156,171,175,4,11,19,76.58340115404424,30,203.40362058444643,-172.4005611565296,-126.12633597793958,-74.63496710710355,2.439959542188853,14817,14749,Bee+Goliad+Karnes,Karnes,48,255,Texas,TX
48027,48CS010,2089,1929,2249,2385,136,296,456,95.475435361876,202,65.23704947681178,-24.713103448012525,29.636211236023414,81.88825418474461,0.6809827259119493,2632,2437,2828,3353,525,721,916,190.4413667453453,551,145.5734829050232,-6.6383849951832365,43.96871239146135,96.49145631357712,0.7633415551673806,371568,378503,Bell,Bell,48,27,Texas,TX
48029,48CS011,11851,10985,12718,14275,1557,2424,3290,144.4195156768855,1952,116.31527278523535,-22.441187008280913,29.337956017834838,84.72570333457847,0.8050664077547547,14736,13690,15782,18960,3178,4224,5270,208.46118632598547,3396,167.60702962439444,-7.387685365194716,40.93863729124111,97.68633302304065,0.8038300086038769,2013837,2026168,Bexar+Wilson,Bexar,48,29,Texas,TX
48493,48CS011,356,334,377,382,5,26,48,63.08692826397706,37,88.33184124142048,-77.02015331162958,-26.126110270118925,29.478521319941702,1.3491075816197968,445,418,471,641,170,196,223,384.3882994720323,115,225.16789693184268,111.40738822850284,159.31460729846154,210.79986190053282,0.5828136775162159,50265,51073,Bexar+Wilson,Wilson,48,493,Texas,TX
48035,48CS012,209,201,217,274,57,65,73,427.28252863233763,20,131.01867016049786,243.7366512269714,296.50450933190444,345.5999820171601,0.3020022234202581,255,246,265,305,40,50,59,269.03208895966367,36,194.97400346620452,23.272613044077175,74.28244818717322,123.6231711816708,0.7104223010070367,18318,18464,Bosque+Hamilton+Hill,Bosque,48,35,Texas,TX
48193,48CS012,115,115,116,105,-11,-10,-10,-151.436837390702,16,232.33301064859631,-396.9023752534308,-383.7306158419789,-372.50786291659307,-1.6969015275123231,140,139,141,157,16,17,18,201.518617048507,6,72.91286912139992,116.30729059536233,128.55586828004778,141.15833847344487,0.3412393369702882,8264,8229,Bosque+Hamilton+Hill,Hamilton,48,193,Texas,TX
48217,48CS012,381,365,396,451,55,70,86,232.97119946035968,40,132.96030580870337,47.36390294957251,98.74118983447246,150.55624581822696,0.562687273421066,466,447,485,673,188,207,226,568.101292861037,139,381.8996071104761,135.95692931261536,185.39410843939945,237.78370952888343,0.6690031157284749,36101,36397,Bosque+Hamilton+Hill,Hill,48,217,Texas,TX
48037,48CS013,891,851,931,1063,132,172,212,221.9969941528811,126,162.80121454874345,9.890978766204292,60.730856292625326,110.461088837398,0.7291051753175043,1089,1042,1137,1381,244,292,339,314.83363966915556,228,246.18839891158814,16.04766513324136,68.50794757939302,122.162249237371,0.7792907439480365,92874,92612,Bowie,Bowie,48,37,Texas,TX
48039,48CS014,2077,1916,2238,2443,205,366,527,117.31908821239463,239,76.63920517555134,-12.299254765670169,40.82102734402129,92.53519126927216,0.6514736927467779,2603,2408,2799,3459,660,856,1051,225.94318808536585,605,159.72880425169035,9.797494493413023,65.16671340566548,115.53339848987216,0.7061172340626666,374221,378767,Brazoria,Brazoria,48,39,Texas,TX
48041,48CS015,931,830,1032,1141,109,210,311,107.69756862827144,146,74.86923523982087,-18.482078140538775,30.11503291160909,82.67457997094432,0.6918859451855037,1172,1050,1294,1414,120,242,364,102.3132578014149,216,91.27017662469365,-40.11789554059738,11.327354296983524,61.42006167678977,0.8883969585855285,234008,236660,Brazos+Burleson+Grimes+Robertson,Brazos,48,41,Texas,TX
48051,48CS015,193,186,201,211,10,18,25,120.13785303336384,20,134.8314606741573,-63.35694502978674,-15.708825130636027,35.164607015172606,1.0626739484373293,238,229,247,297,50,59,68,327.2398078842647,41,227.87905735882612,46.59710569499846,98.23191980603907,146.19450172515786,0.6847372016922137,17800,17992,Brazos+Burleson+Grimes+Robertson,Burleson,48,51,Texas,TX
48185,48CS015,252,240,265,314,49,62,74,251.33066124177736,47,191.60211985324094,5.006133471771281,58.42986953619473,113.90103284458434,0.7501826231496528,315,300,331,396,65,81,96,267.60724422075197,64,212.20159151193633,4.0230661892974116,56.68691259866662,106.41728041387748,0.7832545574495128,29436,30160,Brazos+Burleson+Grimes+Robertson,Grimes,48,185,Texas,TX
48395,48CS015,162,154,169,202,33,40,48,288.22524710473215,23,164.12940057088488,73.76571963086418,123.97847844726131,174.54504583061455,0.5556902550396843,199,190,207,267,60,68,77,404.5255492238781,48,283.58738036157393,69.93207262738387,120.86585714005875,172.9362497993549,0.6909457870550011,16816,16926,Brazos+Burleson+Grimes+Robertson,Robertson,48,395,Texas,TX
48049,48CS016,432,416,448,584,136,152,168,480.15568170227596,73,230.59913656944298,200.28131034624099,248.78149938369242,301.20415692546425,0.47712018006941675,531,512,551,647,96,116,135,302.8982443740924,107,280.36893407399646,-24.47305529114919,20.631624735769687,72.6296948728043,0.9176823023978806,37988,38164,Brown+Coleman+Mills,Brown,48,49,Texas,TX
48083,48CS016,127,124,130,124,-6,-3,0,-47.22276374353549,16,247.93388429752065,-348.1451635493275,-294.21239059828775,-244.13323841315855,-7.814627831646428,155,151,159,214,55,59,63,766.0630388157782,42,543.6189490033653,171.30803356431377,222.65499556506364,272.39003225559566,0.6978363539775743,7744,7726,Brown+Coleman+Mills,Coleman,48,83,Texas,TX
48333,48CS016,57,57,58,74,16,17,17,444.716012986363,14,372.8362183754993,58.92718428893929,71.449142843743,84.0329351965761,0.7910012851781174,70,70,71,92,21,22,22,488.86457996311646,14,312.9190880643719,162.82597233901558,176.32636639025597,188.28430438611827,0.6121074510812007,4506,4474,Brown+Coleman+Mills,Mills,48,333,Texas,TX
48053,48CS017,473,452,495,498,3,25,46,59.49766275525882,30,72.846476051721,-69.46153285265048,-13.037986294369372,39.43597882150576,1.1763494950865485,596,570,622,692,70,96,122,189.7794363926049,114,224.71467150263152,-85.12916222915926,-36.00100063363482,11.269188024017607,1.1719110695586934,49419,50731,Burnet+Lampasas+Llano,Burnet,48,53,Texas,TX
48281,48CS017,197,187,206,252,46,55,65,306.5072668333924,13,71.81328545780968,185.1963262940385,232.72548985310303,291.3134690105028,0.23014764971883134,246,235,258,331,73,85,96,381.7672071572128,54,243.5394398592883,86.86148007404613,136.2564145738787,186.46718287040625,0.6304784281514875,21723,22173,Burnet+Lampasas+Llano,Lampasas,48,281,Texas,TX
48299,48CS017,283,274,292,302,10,19,28,106.47094340126723,17,95.29593123744569,-38.39548815939419,9.459209711571527,62.931847605975655,0.8502751046001884,353,342,364,412,48,59,70,269.0121398884532,67,306.32772494513534,-87.7654749635703,-36.61189297866156,10.065395190465393,1.119683556290529,21407,21872,Burnet+Lampasas+Llano,Llano,48,299,Texas,TX
48059,48CS018,146,140,152,196,44,50,56,431.844418698389,26,225.82513028372898,157.7803137512502,204.80043690267033,257.14027421492074,0.5126214558816838,181,173,188,231,43,50,58,358.7815035041578,36,256.0091025458683,52.87504781740865,101.9816229518075,154.68501690613172,0.6996832278268478,13816,14062,Callahan and Nearby Counties,Callahan,48,59,Texas,TX
48133,48CS018,210,202,217,230,13,20,28,137.54603207935415,18,121.07623318385652,-38.41226533697286,17.738214130764113,69.2871287477223,0.8392191305601304,254,245,264,383,119,129,138,720.8537759060877,70,392.2008068130883,279.2581575642969,329.75788289393574,380.1834860373915,0.5398819182700452,17840,17848,Callahan and Nearby Counties,Eastland,48,133,Texas,TX
48253,48CS018,153,145,162,221,59,68,76,411.92438471448804,39,237.27438653417153,123.69240090981273,175.19534134121244,225.37580347825715,0.5676307430523009,188,178,198,261,63,73,83,369.0794317424479,62,312.43700866760736,3.088447487373466,56.30548947638492,109.81098118002635,0.8351279330702509,19724,19844,Callahan and Nearby Counties,Jones,48,253,Texas,TX
48417,48CS018,25,24,25,38,13,13,14,513.5822639679542,8,304.4719314938154,196.62782825187978,209.52062689542385,220.7963667197265,0.5519382905298778,30,30,31,42,11,12,12,361.5099214033948,6,187.5586120662707,161.18143773415798,173.54661603107724,185.77281109266707,0.47752822277997076,3153,3199,Callahan and Nearby Counties,Shackelford,48,417,Texas,TX
48429,48CS018,91,90,92,123,31,32,33,419.01379775760984,17,223.4392113910186,182.83282935180162,195.6857398940922,207.61037103218356,0.5170321578000899,112,111,113,144,31,32,33,352.1403952247411,24,262.0373403209957,76.85108727923377,89.65547222179421,102.57796199091683,0.7217494022136405,9130,9159,Callahan and Nearby Counties,Stephens,48,429,Texas,TX
48061,48CS019,2342,2161,2523,3734,1211,1392,1573,396.2191903627471,1075,305.98085840676475,41.96034599347839,90.59828381982928,141.75590108744913,0.7716971189243801,2911,2693,3130,3808,678,897,1115,212.1150305940382,740,175.0397978999955,-16.34206553319657,37.05433919628655,85.36793046056042,0.824292456090114,421595,422761,Cameron,Cameron,48,61,Texas,TX
48067,48CS020,331,319,343,455,112,124,136,518.4694201809991,60,251.30890052356023,214.2291361460641,266.7034172562524,315.54928710771753,0.48082866370326327,403,388,418,589,171,186,201,651.4182389656651,111,388.9687072922872,208.25337112902054,264.3195560158967,313.29558016605876,0.593915661969222,28650,28537,Cass+Marion+Morris,Cass,48,67,Texas,TX
48315,48CS020,144,140,148,163,15,19,23,232.07384331500725,21,258.32906201947713,-76.34208021869304,-26.598283656056743,27.1432169402717,1.0571000381563993,173,168,178,212,34,39,44,399.0519023434427,40,414.03581409791946,-69.02052524057302,-15.32826745698779,38.06368361612714,1.0113165235511414,9755,9661,Cass+Marion+Morris,Marion,48,315,Texas,TX
48343,48CS020,155,150,160,168,8,13,18,129.3288846260467,15,149.68814968814968,-71.92677765767417,-22.234954443202735,31.281135539581875,1.0745114999405163,189,183,195,228,33,39,45,326.1673086678394,43,357.73710482529117,-82.41834493364975,-31.151381397385666,19.61302221375962,1.069510456783947,12025,12020,Cass+Marion+Morris,Morris,48,343,Texas,TX
48071,48CS021,277,257,297,334,37,57,77,146.9696872014196,28,71.86397176772537,22.82210947137924,76.11701848609482,122.66684948944385,0.48057891049761686,352,327,377,418,41,66,91,136.08370851768981,86,176.95473251028807,-91.00182155634471,-40.66765947038415,8.421961599675532,1.2809688683302294,46755,48600,Chambers+Liberty,Chambers,48,71,Texas,TX
48291,48CS021,764,724,804,768,-36,4,44,5.38419049626309,92,119.56851362474549,-165.47903045573463,-114.70570468650183,-59.207467843763986,17.889172389590904,975,925,1025,1155,130,180,230,186.3510480952099,240,247.80076818238135,-113.65718162715315,-62.45126783241349,-8.158106668207793,1.3224254021687494,92332,96852,Chambers+Liberty,Liberty,48,291,Texas,TX
48073,48CS022,464,442,486,601,115,137,159,323.9707357103868,97,228.92656256146006,43.91998997345754,93.81973482576976,146.17682779526874,0.701516866322128,570,544,597,794,197,224,250,438.53675458427074,148,290.15625306330503,95.96461067030383,146.92979884337643,194.93299653227365,0.6587015923844254,50846,51007,Cherokee,Cherokee,48,73,Texas,TX
48077,48CS023,108,107,109,128,19,20,21,233.14087395156886,13,151.7657359665337,68.8032609479155,81.42744517737108,93.47431120221582,0.6199196779309037,132,131,134,151,17,19,20,180.33361796143453,16,155.94541910331384,12.228421819598665,24.023575133602854,37.42418402213162,0.8204190317723986,10279,10260,Clay+Cooke+Montague,Clay,48,77,Texas,TX
48097,48CS023,373,355,391,424,33,51,69,147.86484110541414,39,112.32988502988263,-15.700327842362205,36.75501706994784,85.46017132113451,0.7451644469891585,463,442,485,520,35,57,78,134.32881098499405,85,201.59377668152925,-122.24719109813341,-67.31615318702319,-16.445173159896054,1.4747113070623776,41663,42164,Clay+Cooke+Montague,Cooke,48,97,Texas,TX
48337,48CS023,245,237,254,325,71,80,88,477.6685674528059,41,246.03690553583039,177.00393866468968,231.20824923885294,279.59770946200564,0.5086881062864574,305,294,315,368,53,63,74,310.65164723800456,55,270.33669206193167,-10.675320072985967,39.42155411309024,89.15311991827225,0.8566700958881407,19997,20345,Clay+Cooke+Montague,Montague,48,337,Texas,TX
48085,48CS024,4222,3759,4684,4832,148,610,1073,68.37635167264591,443,49.61829567314648,-36.247470086773944,19.49268708961934,72.83728103884108,0.7244778229732565,5448,4878,6018,6213,195,765,1335,69.25467802348268,819,74.17362968973868,-58.15122645516644,-5.251680921977067,45.59277806962545,1.0696282151054053,1071379,1104166,Collin,Collin,48,85,Texas,TX
48091,48CS025,1215,1144,1285,1357,72,142,213,104.32995212557586,137,100.41472993690485,-48.16278857094561,3.956514715591867,56.0030074962329,0.9557581587747257,1574,1484,1663,1784,121,210,300,121.25960643037308,289,166.74167157083346,-97.28594791836233,-45.98139580477232,4.8171439862176895,1.3685683646502949,163721,173322,Comal,Comal,48,91,Texas,TX
48093,48CS026,158,152,164,194,30,36,42,318.65938783341585,36,317.13404786374986,-47.455262380743264,2.0691883066405454,51.60836787115041,0.9684408918461118,193,186,200,220,20,27,34,194.8642837519125,32,232.74419957815115,-88.88115947724687,-37.696621412650856,18.44629590075754,1.151415019650125,13622,13749,Comanche+Erath+Somervell,Comanche,48,93,Texas,TX
48143,48CS026,288,270,307,315,8,27,45,75.39076404159367,37,103.84021703540857,-75.92774891571389,-26.813124185149746,21.584895278662394,1.327926602850816,356,334,379,462,83,106,128,244.16784657487267,79,182.5281301263834,10.679829406960947,60.44861448681057,109.20316704519595,0.7405443338289487,42758,43281,Comanche+Erath+Somervell,Erath,48,143,Texas,TX
48425,48CS026,82,82,83,99,16,17,17,215.20322491296255,3,39.01593150536469,163.67656023276007,176.07203225225607,188.7575101669607,0.1709661360143973,103,102,104,123,19,20,21,209.19015906160624,17,180.23748939779475,15.696391305217936,29.007738225048314,42.03406266397357,0.8200352635323465,9227,9432,Comanche+Erath+Somervell,Somervell,48,425,Texas,TX
48099,48CS027,464,429,500,534,34,70,105,101.77832479728127,40,58.352277562333605,-4.87112153476081,43.731587768732005,96.33656764048168,0.5652256758872497,585,542,628,705,77,120,163,142.83982938827583,130,154.6404015892275,-59.54504812617125,-11.153655040691696,39.8126471464882,1.0736726862103851,82259,84066,Coryell,Coryell,48,99,Texas,TX
48105,48CS028,30,29,32,56,24,26,27,974.5199057520986,10,379.8670465337132,544.8661481989242,595.6965232635661,648.7528538232363,0.3751748804697592,37,35,38,55,17,18,20,601.222286416351,6,195.1854261548471,354.61022644820815,407.94240216645676,454.5314680841358,0.3079833427205446,3159,3074,Crockett+Kinney+Terrell+Val Verde,Crockett,48,105,Texas,TX
48271,48CS028,31,29,32,45,13,14,16,534.9039804801464,4,149.71927635683093,332.2984688373097,383.1403780572239,434.3638345113621,0.26159432916505276,37,36,39,53,14,16,17,505.6821769636308,2,63.89776357827476,390.7049830881431,441.165084632241,493.5574878007727,0.11885058078026403,3206,3130,Crockett+Kinney+Terrell+Val Verde,Kinney,48,271,Texas,TX
48443,48CS028,9,9,9,12,3,3,3,420.7623420004934,3,484.5222072678331,-76.20974053191838,-64.00541520737708,-51.27300653378937,0.8321267108732969,11,11,11,20,9,9,9,1199.3788585403315,4,550.2063273727648,636.3261005844403,649.3022231013476,661.1034381075565,0.4115444683980179,743,727,Crockett+Kinney+Terrell+Val Verde,Terrell,48,443,Texas,TX
48465,48CS028,328,308,349,498,149,170,190,425.7391363139211,162,406.7541271734354,-31.598226661138348,19.388166762645206,70.70326744473759,0.949805396660866,406,381,430,503,73,97,122,204.70699531465073,99,208.12748333928982,-54.2551073660221,-2.6496134674609566,47.119084643756366,1.0063739409056778,47793,47567,Crockett+Kinney+Terrell+Val Verde,Val Verde,48,465,Texas,TX
48107,48CS029,55,54,55,83,28,28,29,654.5851173409833,23,532.0994794679006,110.50674024438803,122.47080898012204,134.64117553019022,0.7851318771610228,66,65,67,99,32,33,34,645.2190738072621,20,391.77277179236046,241.43648708380704,253.73715880477988,266.67493081013356,0.589302386971224,5187,5105,Crosby+Floyd+Hale+Swisher,Crosby,48,107,Texas,TX
48153,48CS029,50,50,51,93,42,43,43,945.028682099565,27,596.6850828729281,335.77871364612673,348.3374629320313,360.0394571068762,0.6169659061736331,61,60,62,93,31,32,33,600.4358740386898,15,280.1643630930146,306.9181225662769,319.78176758803613,332.71662250469035,0.4525250440948961,5430,5354,Crosby+Floyd+Hale+Swisher,Floyd,48,153,Texas,TX
48189,48CS029,265,251,279,392,113,127,141,468.8119015271576,129,476.13188976377944,-63.48987176354928,-8.053421360916726,44.054912609130845,1.0076804687682037,326,309,342,395,53,69,86,215.23368634357112,76,235.6443011286122,-72.53773986797388,-21.81218199161783,29.88882917036661,1.0792822488868345,32512,32252,Crosby+Floyd+Hale+Swisher,Hale,48,189,Texas,TX
48437,48CS029,69,69,70,99,29,30,30,504.46664019107345,12,204.92386509178883,286.8731789458337,299.5640893052042,311.11414615587586,0.3929179721835633,85,84,86,96,10,11,12,157.75290910253136,13,185.68775889158692,-41.40018438498358,-27.9600566536706,-14.969933521236115,1.0793504253627366,7027,7001,Crosby+Floyd+Hale+Swisher,Swisher,48,437,Texas,TX
48113,48CS030,13906,12784,15028,17173,2145,3267,4389,150.0886429847665,2301,105.71383832122811,-5.736858978832323,44.925721414152804,93.01302067440511,0.7041271532156845,17124,15787,18461,20576,2115,3452,4789,133.31263324689357,3389,130.86548850399393,-52.18815624595906,2.884361582633937,55.72565718509457,0.9813593081473592,2611957,2589682,Dallas,Dallas,48,113,Texas,TX
48121,48CS031,3553,3160,3947,4109,162,556,949,73.00689639750706,405,53.22381930184805,-31.760607588461212,21.770917205652122,71.61595598737512,0.727714612868149,4571,4087,5056,5340,284,769,1253,81.9660488584603,693,73.91203720985793,-44.61366468562814,8.771093929808828,62.653720492505414,0.9005678328632841,913125,937601,Denton,Denton,48,121,Texas,TX
48127,48CS032,67,66,68,91,23,24,25,326.5379830133523,13,177.717019822283,136.66957249799626,148.67448069946246,160.85705754417964,0.5223767419326212,79,78,81,156,75,77,78,901.4892504358038,35,412.4440254536885,476.2872173121897,489.2029508903899,500.8653881604858,0.45161070174319684,8778,8486,Dimmit+La Salle+Maverick,Dimmit,48,127,Texas,TX
48283,48CS032,44,43,45,68,23,24,25,422.9262540886294,19,336.43204957945994,74.67510369391917,86.56197227733945,98.66891649220182,0.7635195134515763,53,52,54,86,32,33,34,491.4426122409608,25,375.03750375037504,103.58817298362479,116.88856610417571,129.08816768360347,0.7405308790732774,6777,6666,Dimmit+La Salle+Maverick,La Salle,48,283,Texas,TX
48323,48CS032,344,338,350,611,261,267,273,552.6544744422965,216,447.35161629933896,93.2188848618109,105.10479165872285,118.28286218526328,0.8064377401191332,423,416,431,614,183,191,198,328.8007511814193,201,346.40241275312366,-30.468255911963816,-17.27751566168711,-4.238075731009122,1.0480396565956847,57941,58025,Dimmit+La Salle+Maverick,Maverick,48,323,Texas,TX
48047,48CS033,67,67,68,101,33,34,34,574.3760806064729,28,477.6119402985074,85.10742293769881,96.38438938223645,108.96052698415778,0.807549486534901,82,81,83,97,14,15,16,211.48541663093874,20,285.7551078725532,-87.5474644623824,-74.54309070104718,-62.61781735842111,1.2656734425534855,7035,6999,Duval and Nearby Counties,Brooks,48,47,Texas,TX
48131,48CS033,98,97,99,123,24,25,26,302.3617006335597,25,300.0900270081024,-11.02936640639054,1.98153158711186,14.637051681670485,0.95459017064557,117,116,118,172,54,55,56,561.1382510005349,31,317.4928308070463,230.81152458869983,243.72023910201324,255.74043243802342,0.5556597285334172,9997,9764,Duval and Nearby Counties,Duval,48,131,Texas,TX
48247,48CS033,40,39,40,54,14,14,15,346.16508427709266,12,294.9610815239656,40.009966747223665,51.40081007387802,63.337306788683875,0.7955898063894309,48,48,49,69,20,21,21,430.59917507756893,4,83.21198252548366,335.1606327195874,347.7431827453706,360.16764270024635,0.18434112178680245,4882,4807,Duval and Nearby Counties,Jim Hogg,48,247,Texas,TX
48249,48CS033,330,313,346,429,83,99,116,305.05060090138136,68,208.83986384459857,42.27025674458553,96.89419048405914,148.54282550473158,0.6777835276134985,403,383,423,594,171,191,211,492.0389747567492,109,280.6240667318882,161.0002385512854,210.67878634210982,265.26045980178384,0.5673602974616876,39073,38842,Duval and Nearby Counties,Jim Wells,48,249,Texas,TX
48505,48CS033,82,81,84,115,31,33,34,281.17648081227367,22,189.43742824339836,79.32256830394552,91.97252876586673,103.3069734508232,0.6537120360010712,101,100,103,141,38,40,41,284.9450349934457,23,165.42002301495972,106.2845283950642,119.54377044440666,132.48119031855492,0.5662408532878818,13936,13904,Duval and Nearby Counties,Zapata,48,505,Texas,TX
48011,48CS034,24,24,24,34,10,10,10,644.1946595849854,7,454.79155387114236,177.94145759104657,189.30401897600711,201.77929697192724,0.6413058030545553,29,29,29,31,2,2,2,99.79828638251018,4,217.3913043478261,-130.1632789998643,-117.8478380771319,-103.77060014750018,1.4102937846770998,1847,1840,Eastern Central Panhandle,Armstrong,48,11,Texas,TX
48023,48CS034,51,51,52,57,5,6,6,191.26090599266735,6,207.25388601036266,-28.85882027545597,-16.073451150483653,-3.988678004452599,0.9178517724838342,63,62,63,81,18,18,19,530.3809719268269,17,489.2086330935252,28.308564489384562,41.328290257707714,54.199140699315066,0.8749024006409591,3474,3475,Eastern Central Panhandle,Baylor,48,23,Texas,TX
48045,48CS034,15,15,15,22,7,7,7,578.2860854285806,3,250.5219206680584,316.5122157089314,327.25492672582214,339.88171412923333,0.37855004836268413,18,18,18,16,-2,-2,-2,-136.6806076965785,5,355.6187766714083,-504.51864083065317,-492.67102342303093,-479.0791786460337,-5.424585895401107,1437,1406,Eastern Central Panhandle,Briscoe,48,45,Texas,TX
48075,48CS034,61,61,62,72,10,11,11,190.62850140740014,13,231.4196706720071,-52.96362358369006,-40.892869941092584,-28.052680177388176,1.1102991629452605,74,73,75,84,9,10,11,144.67364489097284,13,193.36605681987209,-61.45169281281272,-48.20755905737144,-36.175950107681956,1.2119619737629983,6741,6723,Eastern Central Panhandle,Childress,48,75,Texas,TX
48101,48CS034,21,21,22,27,5,6,6,490.3380271136066,6,523.2558139534883,-81.5224732686349,-33.607822931102504,16.373321321538263,0.9059964219063779,26,26,27,21,-6,-5,-5,-378.0438589217558,8,579.7101449275362,-1007.1910007786564,-956.3068864648732,-905.8693616406454,-1.897080871331775,1376,1380,Eastern Central Panhandle,Cottle,48,101,Texas,TX
48125,48CS034,19,19,19,38,19,19,19,1237.4153863326642,7,461.53846153846155,764.5656212717337,775.8890099794237,788.0875466094187,0.3541172022098704,22,22,23,30,7,8,8,437.0313422796771,4,229.48938611589213,194.76017191708317,207.5955610345623,220.7300847951,0.4641740976263463,1820,1743,Eastern Central Panhandle,Dickens,48,125,Texas,TX
48129,48CS034,41,40,41,47,6,6,7,231.10124004307315,5,183.5985312117503,35.87381645101136,47.19541889533654,60.00880789537071,0.6855271544596999,49,49,50,64,14,15,15,444.4708863800705,12,367.1970624235006,65.61478636783157,76.83205879623799,89.4279038584476,0.772931497515192,3268,3268,Eastern Central Panhandle,Donley,48,129,Texas,TX
48155,48CS034,17,16,17,27,10,10,11,1099.8732508619098,4,437.956204379562,613.1530915756184,662.4229677104214,711.9036488320153,0.3621381315350495,21,20,21,25,4,4,5,413.0116574968797,3,277.5208140610546,83.41036354929513,133.66161714776732,190.45627000932618,0.54898240444964,1096,1081,Eastern Central Panhandle,Foard,48,155,Texas,TX
48191,48CS034,35,34,35,47,12,12,13,529.3368524265097,7,296.5054712319096,220.6723300334509,232.6175907225867,244.00591296313513,0.5186429598776764,42,42,42,52,10,10,10,351.9127180844093,5,176.11835153222964,163.8465343733553,176.370131800335,188.66782123074546,0.45492585252518175,2833,2839,Eastern Central Panhandle,Hall,48,191,Texas,TX
48197,48CS034,37,37,37,68,31,31,31,1029.6845910719055,10,332.22591362126246,685.3633621407633,697.620738924366,710.4901592049215,0.31256342897267203,44,44,45,46,1,2,2,49.67771394426149,4,112.5809175344779,-75.09025408462117,-63.368497643714164,-50.00425376947825,1.446628882438381,3612,3553,Eastern Central Panhandle,Hardeman,48,197,Texas,TX
48207,48CS034,59,58,59,71,12,12,13,267.59635347897347,15,329.7911322828874,-74.19911992162695,-61.90117617274309,-50.504437372406635,1.1388506321401064,71,70,72,111,39,40,41,740.7866560666233,20,369.48087936449286,358.78489571033754,371.56001492534267,383.804934218555,0.4866324298722886,5458,5413,Eastern Central Panhandle,Haskell,48,207,Texas,TX
48269,48CS034,4,4,4,4,-0,-0,-0,-75.11296402756354,4,1791.044776119403,-1917.6954139633203,-1866.4401304661403,-1814.5942155742055,4.806261326153113,5,5,5,8,3,3,3,1178.6015456213543,8,3076.923076923077,-1945.4337363650532,-1897.2854823280295,-1848.2955796221042,1.9683276309303388,268,260,Eastern Central Panhandle,King,48,269,Texas,TX
48275,48CS034,41,40,41,66,25,25,26,895.9249207209756,12,423.03172737955344,460.9612407746141,472.96863832392944,485.52860009482106,0.4542975941756098,49,48,49,71,22,22,23,668.9303110377571,10,298.32935560859187,358.0831718206447,370.9230118291452,383.6766564137534,0.4269391057139534,3404,3352,Eastern Central Panhandle,Knox,48,275,Texas,TX
48345,48CS034,17,16,17,18,1,1,2,159.63440928773235,5,558.1395348837209,-447.16666203941253,-397.7452875608528,-348.24731491408653,2.057563846574043,20,20,21,31,10,11,11,1011.3801540568871,2,187.79342723004694,767.7938952288868,824.0755172268925,872.671564180127,0.1699062313912385,1075,1065,Eastern Central Panhandle,Motley,48,345,Texas,TX
48433,48CS034,19,19,20,25,5,6,6,534.5581613139188,6,573.7051792828685,-86.73842648898591,-38.24513607166837,11.042653516323545,0.9103892569951443,23,23,24,24,0,1,1,65.47659839691556,6,491.4004914004914,-479.0334711401503,-425.55962482511734,-373.9322324231217,3.3343164631623394,1255,1221,Eastern Central Panhandle,Stonewall,48,433,Texas,TX
48447,48CS034,18,18,18,15,-3,-3,-3,-260.93207901996493,6,495.5264969029594,-768.3727327901704,-756.5986086127253,-744.7702627520325,-2.7784819298252463,23,22,23,23,0,0,1,27.147481773876603,8,537.9959650302623,-523.7898444698423,-510.96464540713436,-498.10641193561554,5.699292284914894,1453,1487,Eastern Central Panhandle,Throckmorton,48,447,Texas,TX
48487,48CS034,151,146,157,182,25,31,36,290.0948572902643,38,355.91632844208556,-118.19945225049237,-66.34862719008208,-15.679707617997664,1.1885228379250572,185,178,191,198,7,13,20,104.0391257849927,37,290.241606526514,-237.75233167304884,-186.65393938248056,-133.63833428394224,2.5941414356301538,12812,12748,Eastern Central Panhandle,Wilbarger,48,487,Texas,TX
48135,48CS035,1070,999,1141,1393,252,323,394,234.49334584107885,268,194.76862141849213,-12.594402750507228,39.97544045662098,88.01348563350848,0.828027137272186,1295,1212,1379,1614,235,319,402,197.1253193309787,317,196.0069004322045,-48.06655578256953,-1.7616319706723134,48.77955774233594,0.9912172284403551,165119,161729,Ector,Ector,48,135,Texas,TX
48139,48CS036,1211,1127,1294,1420,126,209,293,129.596650490621,184,113.95482062953845,-36.077058488889115,15.483755026137516,65.58379087026817,0.8751216957686296,1545,1441,1649,1822,173,277,381,137.30382047089608,283,140.48011436967616,-57.17747848347233,-3.766707901414152,49.080773601241695,1.019447703351824,193761,201452,Ellis,Ellis,48,139,Texas,TX
48141,48CS037,4833,4462,5205,7370,2165,2537,2908,353.11770267374715,2091,291.05132023996765,11.236025486598589,62.58842021158051,115.77382011414583,0.8239083915815472,6026,5578,6474,7301,827,1275,1723,146.92922045831816,1193,137.49356039171258,-48.394640869372886,11.04742457868962,60.97895582486329,0.9350474704685262,862116,867677,El Paso,El Paso,48,141,Texas,TX
48145,48CS038,157,150,165,168,3,11,18,74.15612871654913,22,154.89321755456464,-130.03548223963298,-80.60011685348363,-23.658667497392372,1.9076287737295472,195,186,204,245,41,50,59,291.75692284366346,38,220.13671648708146,19.416730888570772,70.81034240917637,121.26406967533747,0.7398310222880216,17044,17262,Falls+Lee+Milam,Falls,48,145,Texas,TX
48287,48CS038,163,155,170,196,26,33,41,227.91937166835623,29,198.9594648676462,-27.122218100187446,29.704685225182775,82.31198707410883,0.8474292040964838,200,191,210,209,-1,9,18,48.45462973669616,27,152.74949083503054,-156.26200065462368,-105.08462027225616,-54.63878638393697,2.8228385425821414,17491,17676,Falls+Lee+Milam,Lee,48,287,Texas,TX
48331,48CS038,249,238,259,256,-3,7,18,34.84231883699014,19,92.0728506239147,-106.87851525766973,-57.66483968599862,-6.161227924867105,2.3199015141203922,306,294,319,415,96,109,121,433.17141175339225,74,295.40918163672654,84.89535613400288,136.83027973601503,190.69148889240935,0.6757408394760552,24763,25050,Falls+Lee+Milam,Milam,48,331,Texas,TX
48147,48CS039,395,380,411,427,16,32,47,106.19704183026727,65,217.9197049702456,-164.9640252801762,-112.6103383942121,-57.73282500751752,1.989232276389134,492,473,511,597,86,105,124,288.37215782616425,103,282.6021346064148,-44.298705910519075,5.7009968078627065,57.81606789690973,0.970754829248099,35793,36447,Fannin+Lamar+Red River,Fannin,48,147,Texas,TX
48277,48CS039,535,514,557,675,118,140,161,334.8711274845531,97,232.63250459669038,47.258530728488,104.86825268841031,151.92582679616208,0.689752773583005,656,630,682,824,142,168,194,335.8653179771215,126,251.52210799480986,33.50051596033697,84.44095743754772,133.7608632797359,0.7444532426657791,50036,50095,Fannin+Lamar+Red River,Lamar,48,277,Texas,TX
48387,48CS039,156,151,161,213,52,57,62,584.9413306699884,28,288.90799656061904,241.5079138090736,294.50081145165996,348.53255168288183,0.4853480027933881,190,184,196,231,35,41,47,356.3105353480809,29,250.99532629392417,50.16772340439916,104.17142782929604,158.93539287215867,0.6877233443881531,11630,11554,Fannin+Lamar+Red River,Red River,48,387,Texas,TX
48157,48CS040,3118,2761,3476,3864,388,746,1103,107.88168579525427,429,62.06687018041349,-2.8834644165215306,45.980882429751475,97.9489552352685,0.5745529886305797,4031,3590,4472,4860,388,829,1270,97.01451376938918,640,74.92680002856584,-28.062141843665195,23.270088133664263,69.83198276687237,0.7713947895240201,829428,854167,Fort Bend,Fort Bend,48,157,Texas,TX
48161,48CS041,187,179,196,245,49,58,66,354.3071987638693,31,190.53472649047328,114.71026071974117,161.41963466156955,221.08313224546103,0.5285972723890892,232,222,242,256,14,24,34,120.3219730422375,46,233.1947683260671,-160.20130957690597,-112.37843995273343,-62.25354501953092,1.8597345807708165,19524,19726,Freestone+Leon+Limestone+Navarro,Freestone,48,161,Texas,TX
48289,48CS041,172,165,179,217,38,45,52,338.34480326414024,22,165.0206275784473,119.96693481921612,172.21274546243419,225.74575041119527,0.4771509608819063,211,202,219,274,55,63,72,397.9988754861518,38,238.61852433281007,107.78328789685348,159.19801517193818,210.54420614972364,0.5902333076782983,15998,15925,Freestone+Leon+Limestone+Navarro,Leon,48,289,Texas,TX
48293,48CS041,226,217,236,297,61,71,80,379.7613307885206,28,150.72671810514984,174.33201546271312,228.97256614798724,285.0045248702416,0.3913511586840073,276,265,288,400,112,124,135,559.9272730594744,78,352.669891938328,157.32710853309783,206.0182999267605,256.04052205163663,0.624804173042192,22292,22117,Freestone+Leon+Limestone+Navarro,Limestone,48,293,Texas,TX
48349,48CS041,512,490,535,527,-8,15,37,33.48232719014141,74,169.27505289845405,-187.71916796599297,-136.6056769027808,-84.09765153797596,4.73234183144788,638,610,666,685,19,47,75,87.88048150930666,136,254.3339629345651,-218.20769593482856,-165.58038213208187,-116.50556187229066,2.8337861559799125,52459,53473,Freestone+Leon+Limestone+Navarro,Navarro,48,349,Texas,TX
48163,48CS042,129,121,137,157,20,28,36,177.7308619560613,21,135.18588058580548,-8.081605871468689,43.85636059334949,91.24305018109447,0.7340345309858526,159,150,169,222,53,63,72,341.54945693406006,57,309.34549006838165,-16.929052100527677,32.123762449833514,83.16879544616249,0.891545758722798,18641,18426,Frio+Medina+Uvalde+Zavala,Frio,48,163,Texas,TX
48325,48CS042,386,364,408,447,39,61,83,142.7929392589585,57,133.77403140951674,-43.90906685716936,7.8664025864355835,53.973574859371396,0.9216905590196917,483,456,510,587,77,104,131,200.70722714970046,120,231.5440126577394,-82.19582243917597,-29.667066610162923,22.475911727611027,1.1426555181067322,51131,51826,Frio+Medina+Uvalde+Zavala,Medina,48,325,Texas,TX
48463,48CS042,202,192,213,281,68,79,89,379.5330181261288,40,192.86403085824492,134.35066877484812,184.66756138898575,235.6641838229146,0.5017866870220583,248,236,261,350,89,102,114,410.9967385289636,72,291.48617464879965,68.71172122612809,120.16687678100472,169.90778331502722,0.7022999047124289,24888,24701,Frio+Medina+Uvalde+Zavala,Uvalde,48,463,Texas,TX
48507,48CS042,79,78,80,140,60,61,62,735.8961911186101,27,325.497287522604,398.83284634743313,410.5725576248069,422.9323199016963,0.4351849336398511,93,92,94,151,57,58,59,604.8712382107364,26,272.22280389488014,320.5435321197745,333.2489349002791,345.073735235501,0.4423931621710024,9954,9551,Frio+Medina+Uvalde+Zavala,Zavala,48,507,Texas,TX
48003,48CS043,117,116,119,128,9,11,12,68.141643081370745,32,206.1744966442953,-149.18080024164783,-138.19632098581894,-125.24919647423367,2.7643039906484805,143,141,146,158,12,15,17,78.74750082266414,35,189.54779312212293,-122.8551124639794,-110.481792026541,-97.80584664900537,2.2521470322175507,18625,18465,Gaines and Nearby Counties,Andrews,48,3,Texas,TX
48115,48CS043,124,119,129,169,40,45,50,431.74908092292,52,498.56184084372006,-117.55219722638623,-67.35033464292657,-17.516674029857203,1.1296629492330739,151,145,157,166,9,15,21,120.31468445697882,31,249.65772730933398,-180.21420336025722,-129.708421100164,-76.64971760847413,1.9448571064705698,12516,12417,Gaines and Nearby Counties,Dawson,48,115,Texas,TX
48165,48CS043,112,110,114,147,33,35,37,192.83470063563936,33,182.50530002765234,-1.6122594543350783,10.271494659963798,21.76354102355602,0.9200471297300252,140,137,142,176,34,36,39,166.23095359783647,40,182.92404079206108,-28.251588134730188,-17.18184813408912,-4.697720179222438,1.070958421927131,21698,21867,Gaines and Nearby Counties,Gaines,48,165,Texas,TX
48305,48CS043,50,49,50,82,32,32,33,680.4976332706357,16,338.86339569361104,330.05475562962516,341.83992163501733,353.095532092712,0.4829338727643129,61,61,62,85,23,24,24,416.8465699056256,14,246.65257223396756,159.00857593022062,169.98913091911842,182.18610506863993,0.567716141002702,5666,5676,Gaines and Nearby Counties,Lynn,48,305,Texas,TX
48317,48CS043,41,40,41,56,15,15,16,346.2493092338826,17,383.60285821737494,-49.4789369797236,-37.504391249898816,-26.20355519922467,1.0400979019855499,49,48,50,53,3,4,5,76.01795032042976,2,38.336208548974504,24.61290965158363,37.37725671513097,49.76665680569108,0.40275026328301755,5318,5217,Gaines and Nearby Counties,Martin,48,317,Texas,TX
48445,48CS043,123,118,129,155,26,32,37,319.1831330963135,44,444.81887110362254,-176.70423145186294,-125.54130058839348,-73.60042688870999,1.3508314479359016,150,144,156,148,-8,-2,4,-17.724731482903852,26,221.08843537414967,-289.0030239617457,-240.67459031442132,-189.92892218239425,-23.975764064455333,11870,11760,Gaines and Nearby Counties,Terry,48,445,Texas,TX
48501,48CS043,50,49,50,81,31,31,32,481.35252388756186,22,337.9848930994751,132.0848084315257,143.53086298945612,155.19643325614973,0.680439630091752,60,59,61,79,18,19,20,253.78898035779736,13,170.69327731092437,71.3242518836165,83.62240602036519,95.86931909214881,0.6394941111535503,7811,7616,Gaines and Nearby Counties,Yoakum,48,501,Texas,TX
48167,48CS044,2504,2353,2655,2863,208,359,510,123.08352844326866,220,75.3452610970156,-2.312750491418953,47.555617548445504,97.39430547405938,0.6104488266913705,3110,2927,3293,3693,400,583,766,164.46884884658027,474,133.69587291558545,-20.443693909011678,31.769680640296514,84.15478532424439,0.8115031038217373,350387,354536,Galveston,Galveston,48,167,Texas,TX
48181,48CS045,1290,1232,1349,1533,184,243,301,213.5333591564664,192,168.94096598449906,-3.9696569744521732,44.83876573385158,98.02415606614014,0.787922192722489,1605,1534,1677,1971,294,366,437,263.44264222500004,339,244.14484487079767,-31.86544122405452,18.505812536674387,69.61996725455015,0.9242210254516533,136379,138852,Grayson,Grayson,48,181,Texas,TX
48183,48CS046,1128,1074,1181,1404,223,276,330,267.16639015567756,175,169.12842485060324,50.418367188784075,97.761684787348,148.4043591668948,0.630763564524077,1384,1320,1448,1828,380,444,508,357.30306248548686,325,261.6810389945007,43.72830617958907,95.35464454900716,149.1570338981567,0.7307316991969083,124166,124197,Gregg,Gregg,48,183,Texas,TX
48187,48CS047,1041,967,1116,1169,53,128,202,88.71847086766094,119,82.56864819858107,-44.10093791267658,4.964462999637456,56.71069803464817,0.9234593569569542,1311,1220,1402,1617,215,306,397,173.46617671146137,249,141.05570850752864,-19.518797416973417,33.22243685857811,82.37224588338196,0.8105128316097832,172947,176526,Guadalupe,Guadalupe,48,187,Texas,TX
48199,48CS048,504,480,528,574,46,70,94,148.56003234280348,54,114.54632232062363,-20.633254629326252,34.56383707543873,84.61359402300015,0.7601895677985342,623,594,653,806,153,183,212,321.42024730726774,162,284.8501899001266,-15.34687919692528,35.725080042069095,92.5965072025776,0.8814018190880724,56571,56872,Hardin,Hardin,48,199,Texas,TX
48201,48CS049,22991,20958,25025,28388,3363,5397,7430,136.94910857481275,3653,92.7032658043461,-5.316744968526566,43.800491548303796,93.75025425223448,0.6767922158227888,28606,26165,31047,36243,5196,7637,10078,161.50573568142045,6096,128.91544174792082,-17.754200594167376,31.74766684674072,83.34844426296709,0.798105177119285,4728636,4728681,Harris,Harris,48,201,Texas,TX
48203,48CS050,585,556,615,669,54,84,113,146.66630616091462,84,147.19196285155223,-55.76768839718402,-2.362358172615791,51.30668913649229,0.9917353441400987,721,685,756,951,195,230,266,333.5819410656217,159,230.1146231330323,50.035841885107494,105.01849411534829,153.71923156951695,0.6868494482810165,68482,69096,Harrison+Upshur,Harrison,48,203,Texas,TX
48459,48CS050,403,385,421,474,53,71,89,207.33345132828978,49,142.83979108465928,18.39435005486977,65.51198888823413,115.24987784958479,0.679385383120838,498,476,519,659,140,161,183,387.52294045909713,137,328.87629930143794,6.047764647618665,59.66958756423636,112.7338056417524,0.8434380115695541,41165,41657,Harrison+Upshur,Upshur,48,459,Texas,TX
48209,48CS051,1093,988,1198,1140,-58,47,152,23.200972147401693,102,50.35772912972463,-81.53766985315615,-26.892202819186707,20.99718019282142,2.12527617848835,1415,1284,1546,1649,103,234,365,92.20068722650795,238,93.80900014583753,-54.018684194518364,-0.6524575580052272,53.58867895629561,1.013112581881109,243061,253707,Hays,Hays,48,209,Texas,TX
48213,48CS052,953,917,988,1130,142,177,213,257.39614982246263,99,143.90406395736176,60.44760839841093,115.20507554642862,166.17492573751994,0.5559367052669001,1175,1132,1218,1570,352,395,438,473.0962291115283,288,345.0134770889488,77.40111973666804,127.29965319882241,179.2300789337381,0.727425050719716,82555,83475,Henderson,Henderson,48,213,Texas,TX
48215,48CS053,3904,3529,4280,6443,2163,2539,2914,349.2179076978666,2012,276.77725987761454,20.73110499074765,74.08846721607271,126.81646681058231,0.7922511106705173,4917,4464,5371,6410,1039,1493,1946,169.7649538081507,1202,136.72032730982852,-15.59118264576001,32.492429166788035,85.37903103047807,0.8048114863578171,872326,879167,Hidalgo,Hidalgo,48,215,Texas,TX
48221,48CS054,651,624,678,767,89,116,143,223.97362987540586,74,142.85254657186061,29.229930013718064,81.7746941597186,131.7911978270149,0.6323593318411557,814,781,847,991,144,177,210,276.4143319117523,128,200.34120611666745,25.94206338038266,75.29994285870359,124.74262012731029,0.7207049723360981,62162,63891,Hood,Hood,48,221,Texas,TX
48063,48CS055,136,131,142,173,31,37,42,349.2820118515916,23,219.7627199617804,79.35875320526006,129.55884928592374,182.55003057403226,0.6124306395801876,168,162,175,232,57,64,70,507.41683865141067,41,325.6035578144854,131.62334404684714,182.47199728901683,238.57593349000499,0.6318002478743096,12559,12592,Hopkins and Nearby Counties,Camp,48,63,Texas,TX
48119,48CS055,59,59,60,79,19,20,20,449.0992000547884,1,22.800684020520617,413.6694706649085,426.444020456088,439.23436365859664,0.048316782414979206,74,73,75,91,16,17,18,315.68401645140904,17,316.6325200223505,-13.338064479790766,-1.5096927616511089,12.446019606221991,0.9471240244100001,5263,5369,Hopkins and Nearby Counties,Delta,48,119,Texas,TX
48159,48CS055,100,99,102,137,35,37,38,419.9583758522204,14,161.0429447852761,246.32606744935586,258.99050388443237,270.85256806559045,0.3732499097480989,123,122,125,128,3,5,6,44.432002105729296,23,220.09569377990428,-188.66167873733815,-175.01192997400355,-163.05752656930076,4.075742015999985,10432,10450,Hopkins and Nearby Counties,Franklin,48,159,Texas,TX
48223,48CS055,357,341,373,448,75,91,107,296.816913778527,87,283.103289313122,-38.89731679641949,12.331277470842165,64.63322957370151,0.9434544267864413,442,423,461,524,63,82,101,221.5368508627517,67,180.349932705249,-12.395109719571453,41.78805534253023,90.21967898882436,0.8043126514920274,36877,37150,Hopkins and Nearby Counties,Hopkins,48,223,Texas,TX
48449,48CS055,250,236,263,288,25,38,52,145.4709134630968,57,217.3429506529821,-125.14195599196867,-72.57875497083843,-25.315094787374726,1.4559030225505332,307,291,323,358,35,51,67,164.35233032092137,60,192.3385157877865,-84.95704711702504,-27.046889219872998,20.112982135113036,1.1478923575178472,31471,31195,Hopkins and Nearby Counties,Titus,48,449,Texas,TX
48499,48CS055,550,531,570,644,74,94,113,248.8941343174569,77,204.4745402642236,-1.9236436315014454,44.608942703464585,99.67817912991143,0.8128595767485943,681,658,705,912,207,231,254,503.96800598438716,155,338.8052197862248,111.86847521867911,165.1576997742979,217.6937193200197,0.6693720148305032,45189,45749,Hopkins and Nearby Counties,Wood,48,499,Texas,TX
48231,48CS056,863,819,906,981,75,118,162,141.66963029449278,97,116.03217799575346,-25.24169877514316,27.447701693392915,76.26340521814922,0.8121758102861736,1080,1027,1133,1303,170,223,276,216.56754859133508,244,237.04739976489563,-74.4652648383383,-21.088623334758047,35.04644764241413,1.089677439745592,100317,102933,Hunt,Hunt,48,231,Texas,TX
48237,48CS057,81,80,81,97,16,16,17,229.75549941042817,12,167.8126092530008,49.33146789363402,61.89292339123671,74.05403556401343,0.6884905614668525,100,99,101,108,7,8,9,93.48829277814866,10,115.2073732718894,-33.999408215752986,-21.650368282176288,-10.169628552384099,1.0971187254688624,8581,8680,Jack+Palo Pinto+Young,Jack,48,237,Texas,TX
48363,48CS057,283,270,295,389,94,106,119,446.7926165995693,49,205.9256146249212,191.6638503617665,240.65572529125907,290.7693260303668,0.45660269484551524,346,331,361,457,96,111,126,387.8295277905217,83,289.7235409103602,48.89315350136265,97.06223958732166,147.19361945400192,0.7403746624959486,28554,28648,Jack+Palo Pinto+Young,Palo Pinto,48,363,Texas,TX
48503,48CS057,212,204,220,272,52,60,68,403.8858560115919,30,201.47750167897917,152.69565434070995,202.52130590577553,254.39369649665542,0.4906883385751773,259,249,268,323,55,64,74,357.7433666977654,39,217.18549869131814,87.52609569686446,140.1563411509407,191.58768747928028,0.5977929818067268,17868,17957,Jack+Palo Pinto+Young,Young,48,503,Texas,TX
48239,48CS058,147,141,153,158,5,11,17,87.9069753871749,23,184.270263052477,-149.92984247310636,-96.14041592730854,-44.810840615938226,1.9211083260171045,181,173,189,171,-18,-10,-2,-65.92853125549286,28,185.3936304045554,-300.8447484702974,-252.807148596347,-198.2310807219129,-3.1259817272896835,14978,15103,Jackson+Matagorda+Wharton,Jackson,48,239,Texas,TX
48321,48CS058,340,325,356,408,52,68,83,223.64083438156555,67,221.28643382049373,-49.921498951070475,1.8099676108093212,48.866492914155515,0.9750722966753093,416,398,435,468,33,52,70,141.9782403541878,95,261.4702887182451,-172.24296168251945,-118.91821472556296,-69.96716203329495,1.806600418008452,36333,36333,Jackson+Matagorda+Wharton,Matagorda,48,321,Texas,TX
48481,48CS058,367,349,385,465,80,98,116,282.47701787202357,77,222.19550318624505,3.7936780651302677,59.76646732327048,115.76892769158171,0.7786424911865654,451,429,472,569,97,118,140,283.68019145214487,116,278.20414428242515,-46.31392567600278,7.190366202702611,58.84681754577415,0.9724748323461456,41585,41696,Jackson+Matagorda+Wharton,Wharton,48,481,Texas,TX
48241,48CS059,348,333,362,447,85,99,114,357.84675820851135,53,190.97378614539232,118.59426827746388,165.98058273977645,219.75552436338435,0.5283545898315787,422,405,440,606,166,184,201,556.7005781873237,122,370.10071593253247,133.40553435431525,186.06695242474962,235.89018594363958,0.6612079843241518,33303,32964,Jasper+Newton,Jasper,48,241,Texas,TX
48351,48CS059,128,123,133,174,41,46,51,447.07607353350977,19,184.00451940924862,212.61083414755967,263.39078823313173,314.5926213240838,0.4028468104782454,155,149,162,232,70,77,83,627.3215351748183,45,367.9476696647588,209.1500760806289,259.3170618335401,310.57207272967145,0.5789909374750914,12391,12230,Jasper+Newton,Newton,48,351,Texas,TX
48245,48CS060,2130,2021,2240,2570,330,440,549,206.82983624644024,271,127.49841215077119,28.520061577529994,79.47555279231796,128.93061967306386,0.615042071544312,2598,2467,2729,3184,455,586,717,230.64780973222327,474,186.5877277236297,-10.928696014126244,43.061102376110256,99.4992182794984,0.8075941520700823,255062,254036,Jefferson,Jefferson,48,245,Texas,TX
48251,48CS061,1325,1247,1403,1556,153,231,309,153.4575096965302,175,116.19928731103782,-13.540662919103191,37.51906224043454,85.80029226001845,0.7539459651692285,1677,1581,1773,2034,261,357,453,191.65291402561206,388,208.23829330470952,-69.57335358669418,-15.531084311200548,33.236883396754095,1.0835044235322409,180724,186325,Johnson,Johnson,48,251,Texas,TX
48257,48CS062,999,936,1062,1078,16,79,142,64.66644168606312,132,108.06827950386835,-96.96485634179251,-43.89531292533019,10.415851659135816,1.650271775060047,1305,1224,1385,1469,84,164,245,105.20276727538685,261,167.09774898204822,-115.88652300759713,-61.67069277593939,-8.615731578048484,1.5787323401723825,146574,156196,Kaufman,Kaufman,48,257,Texas,TX
48261,48CS063,3,3,4,5,1,2,2,558.5021811265052,5,1709.4017094017092,-1200.648471058745,-1151.3291196240414,-1098.5175523928444,1.8985283096045946,4,4,4,5,1,1,1,278.33161943535816,5,1466.275659824047,-1238.370558858589,-1187.5707777480566,-1134.795148421549,2.565272298968155,351,341,Kenedy+Kleberg+Willacy,Kenedy,48,261,Texas,TX
48273,48CS063,243,230,257,295,38,52,65,200.47192864572156,62,241.10441376628424,-92.91525964481434,-42.771074958646615,14.307118753465744,1.1797982808972467,299,283,315,335,20,36,52,116.33621432811938,69,224.88755622188904,-160.26330993203874,-107.95273301532856,-54.2026719552609,1.8804022074940618,30858,30682,Kenedy+Kleberg+Willacy,Kleberg,48,273,Texas,TX
48489,48CS063,149,140,158,222,64,73,82,430.64228072029516,64,378.0271707028943,2.151283118669723,54.95999707119281,98.72551156008227,0.8659445089624821,185,175,196,228,32,43,53,211.08588211742344,46,226.72384050470697,-64.82872466956837,-14.88394407897932,38.476996199480745,1.0495761685038827,20316,20289,Kenedy+Kleberg+Willacy,Willacy,48,489,Texas,TX
48089,48CS064,212,203,221,260,39,48,57,277.9559937800229,16,92.73570324574962,132.38008747082623,184.1781187519817,238.21746015111339,0.3268195866112972,258,247,269,343,74,85,96,411.9040245255173,41,198.82643906697058,160.75278481753892,213.60583371676296,261.67336644703033,0.4770840868375599,20704,20621,Lavaca and Nearby Counties,Colorado,48,89,Texas,TX
48123,48CS064,220,211,228,259,31,39,48,237.0219328202137,50,302.05396697543296,-115.17878230561409,-65.17313565279379,-11.561533062806292,1.2426981970294444,268,258,279,289,10,21,31,104.12770717342308,38,190.93558436338054,-138.54115272010827,-85.87016394144229,-36.9439136801163,1.7492580157131856,19864,19902,Lavaca and Nearby Counties,DeWitt,48,123,Texas,TX
48149,48CS064,260,249,271,323,52,63,74,307.1429003108848,39,190.23616926141216,66.02248173750438,116.84374052147732,168.5413161204422,0.609690761818735,318,305,331,391,60,73,86,295.9684699569303,52,210.9276761448911,36.127213932643656,86.22539548215633,138.91835936845266,0.7030342032949484,24601,24653,Lavaca and Nearby Counties,Fayette,48,149,Texas,TX
48177,48CS064,170,162,179,222,43,52,60,312.1311713388532,24,145.21252458024506,113.65083721437634,166.89263243716763,216.5022841128056,0.45638239938156405,207,197,217,272,55,65,75,330.4012785690291,63,320.72494018225325,-44.706358207435436,7.681821064969675,60.36000808661029,0.9559834397758871,19833,19643,Lavaca and Nearby Counties,Gonzales,48,177,Texas,TX
48285,48CS064,221,212,230,274,44,53,62,311.3665461363248,48,283.28333251364774,-25.526300012432593,29.028708598798932,81.21397413637688,0.8928826119087568,272,261,282,296,14,24,35,118.95274195844658,38,185.23934873744759,-116.53455945321257,-67.63042037107608,-13.325157853566035,1.495947233764531,20333,20514,Lavaca and Nearby Counties,Lavaca,48,285,Texas,TX
48303,48CS065,2220,2086,2354,3014,660,794,928,305.5701430799529,616,237.16175894971218,14.470801352134472,68.4991239401139,117.67055292092249,0.7751520512088207,2756,2594,2918,3349,431,593,755,188.8545317855167,519,165.28188682489994,-31.271189596430094,23.46997828695928,76.37829325496203,0.8737076225007833,311686,314009,Lubbock,Lubbock,48,303,Texas,TX
48309,48CS066,1922,1809,2034,2338,304,416,529,191.68741309591476,304,139.94920703122003,0.22439353224759204,51.925143998617166,103.72909833469315,0.7283415536620452,2382,2246,2518,2940,422,558,694,212.3154976575898,462,175.79239754956052,-14.338281036915115,38.330819795685976,90.32113385779253,0.8264960177220237,260666,262810,McLennan,McLennan,48,309,Texas,TX
48313,48CS067,129,123,135,140,5,11,17,99.38866459116949,21,185.1579720793534,-138.01584506546482,-85.9869984505712,-29.053847495115207,1.711166356862252,159,152,166,177,11,18,25,131.18166379941187,30,219.33031144904226,-139.91697361147163,-87.14026871156108,-40.06204883287322,1.5836961250551018,13610,13678,Madison+Trinity+Walker,Madison,48,313,Texas,TX
48455,48CS067,194,188,200,216,16,22,28,191.1896464711305,12,104.36295115234091,35.34383099010969,86.20608007956267,137.8210735163081,0.5221108994991331,237,230,244,326,82,89,96,644.3976357781459,48,347.9017177647314,244.53591270426244,297.138294099349,344.6363296978306,0.5338817971726931,13798,13797,Madison+Trinity+Walker,Trinity,48,455,Texas,TX
48471,48CS067,490,458,523,579,56,89,121,139.9830735397464,93,146.86916010844104,-57.40898571094522,-6.596400900565913,45.156937280549485,1.03748771985787,618,578,658,712,54,94,134,120.77283738381784,105,135.01697356239072,-66.44462521513826,-12.275122302819137,37.41110481063679,1.106164155652245,75986,77768,Madison+Trinity+Walker,Walker,48,471,Texas,TX
48031,48CS068,111,109,112,111,-1,0,2,4.059536467585377,7,72.57646448937273,-80.87185307645838,-68.9006037386792,-57.141434964309575,5.030389689728437,139,138,141,157,16,18,19,150.30679476413218,22,186.0779835913051,-49.161720514632805,-35.674042030121875,-23.179417752602774,1.172034884643579,11574,11823,Menard and Nearby Counties,Blanco,48,31,Texas,TX
48081,48CS068,45,44,46,55,9,10,11,363.1684273560288,10,364.0776699029126,-50.49353155612785,-2.524592654016407,50.97064289697008,0.9111595611908745,55,53,57,69,12,14,16,415.8742733069305,7,211.09770808202654,150.69887837151788,203.6630644814238,252.2322926751155,0.47328025648378585,3296,3316,Menard and Nearby Counties,Coke,48,81,Texas,TX
48095,48CS068,29,29,29,28,-1,-1,-1,-32.48643320092363,4,148.23965410747377,-193.88963778314218,-180.94742892961003,-168.87457482289378,32.412876746517945,37,36,37,34,-3,-3,-2,-81.28047623247095,7,209.7064110245656,-303.85216507991356,-290.8656434522196,-278.0948994058779,-4.0860587084503415,3238,3338,Menard and Nearby Counties,Concho,48,95,Texas,TX
48137,48CS068,20,19,21,28,7,8,9,648.6344115502905,8,644.2953020134227,-42.306747899825794,5.159211082137388,54.89892281423805,0.8835993415267711,24,23,25,31,6,7,8,496.3974356391828,0,0,446.57988586333005,497.84793025227646,548.4718310649112,0,1490,1434,Menard and Nearby Counties,Edwards,48,137,Texas,TX
48171,48CS068,306,295,318,329,11,23,34,100.68154039481428,25,111.86099407136732,-65.86825516571861,-11.59621595065275,39.90920949081721,1.0637625544799731,380,366,394,417,23,37,51,136.11971134148547,58,213.1177659379019,-127.97537343605313,-76.39593971096241,-25.187213669918094,1.5245112719551843,26819,27215,Menard and Nearby Counties,Gillespie,48,171,Texas,TX
48173,48CS068,12,12,12,6,-6,-6,-6,-610.4750534289585,6,618.5567010309279,-1241.032228646651,-1229.005060092796,-1216.7979633322861,-1.2191137485427301,14,14,15,12,-3,-2,-2,-212.23163662289832,2,174.82517482517483,-400.57571519653357,-387.3939133308111,-376.0589611602663,-1.4006289579293885,1164,1144,Menard and Nearby Counties,Glasscock,48,173,Texas,TX
48235,48CS068,12,11,12,14,2,2,3,184.1776922990634,2,156.76028739386024,15.678110539219825,27.456909451344686,39.41482281822339,0.59705050050859,15,14,15,24,9,9,10,610.0312109818263,5,322.99741602067184,274.08898422281175,287.1954121270081,298.7743898859567,0.47877663854357355,1531,1548,Menard and Nearby Counties,Irion,48,235,Texas,TX
48267,48CS068,50,49,50,51,1,1,2,38.02461646351298,4,111.42061281337047,-86.65494448308637,-73.63705642119984,-61.52557095186836,1.6912720456797026,62,61,62,63,1,1,2,30.177394905732353,1,22.967386311437757,-5.782953779550295,7.571541526361116,20.152376764691077,0.4321663535989384,4308,4354,Menard and Nearby Counties,Kimble,48,267,Texas,TX
48307,48CS068,87,87,88,109,21,22,22,341.42977596324806,12,188.77818563188254,140.48567608867276,152.7389713384978,164.74118642701222,0.5285516380420019,106,105,107,166,59,60,61,794.9777631728023,28,371.45131334571505,410.603949335741,423.61277545143827,436.8071410802768,0.459578255827096,7628,7538,Menard and Nearby Counties,McCulloch,48,307,Texas,TX
48319,48CS068,41,41,42,39,-3,-2,-2,-65.8677803863265,6,179.5959092042903,-257.87154165925,-245.1451142979301,-232.96050042226128,-4.997781138967722,50,49,50,67,17,17,18,432.6016178721315,6,152.05271160669034,267.93981483834375,280.6529265146202,293.61337339887245,0.3320336091452871,4009,3946,Menard and Nearby Counties,Mason,48,319,Texas,TX
48327,48CS068,27,26,28,33,5,6,7,355.36353518648934,6,361.6273229532898,-55.684232880246746,-5.558974973762456,44.713258906685375,0.8700603547043992,33,32,34,38,4,5,6,253.9783352661631,6,303.030303030303,-102.90562811360861,-49.13759204721062,3.833713797445902,0.9952277109070167,1991,1980,Menard and Nearby Counties,Menard,48,327,Texas,TX
48383,48CS068,23,22,23,28,5,5,6,191.08425647389657,7,244.82658117167009,-65.37758135004269,-53.4828488470881,-41.731527425121726,1.0830184101129101,27,26,27,32,5,5,6,164.1415760189402,5,152.85845307245492,-2.235107866528992,10.894808004300653,24.20409231651749,0.7850438530222366,3431,3271,Menard and Nearby Counties,Reagan,48,383,Texas,TX
48385,48CS068,36,35,36,64,28,28,29,1187.2911757570719,12,504.2016806722689,671.5189832160999,683.217821150935,694.9696421159229,0.41015082294934163,43,43,44,63,19,20,20,701.5036204551735,11,390.9026297085999,298.0767787160126,311.0195597804387,323.06978894701655,0.5303681094022004,2856,2814,Menard and Nearby Counties,Real,48,385,Texas,TX
48399,48CS068,127,123,132,137,5,10,14,115.76038824347671,20,240.64975433670915,-179.168871742158,-125.49387700807554,-75.2356821242582,1.8831233942293166,155,150,160,190,30,35,40,350.803416521881,36,362.1730382293763,-61.67135395368352,-11.76709018075085,41.99816282735783,1.0036281267662608,9973,9940,Menard and Nearby Counties,Runnels,48,399,Texas,TX
48411,48CS068,58,57,59,83,24,25,26,517.5194135858363,15,311.3648157758173,195.14070051457054,206.2114515095064,217.72730950919632,0.5784471126543616,72,71,73,90,17,18,19,311.22106317668204,14,240.8394976776191,57.10512463645908,70.40594054716519,83.27715624014259,0.7333190705320974,5781,5813,Menard and Nearby Counties,San Saba,48,411,Texas,TX
48413,48CS068,21,21,21,25,4,4,4,193.53103649953687,8,385.07821901323706,-203.60306832967794,-191.8711891314845,-179.3212319313471,1.5934327360448155,25,25,26,33,7,8,8,318.67778712704785,2,82.27067050596463,223.37579853600192,235.86200518954584,249.64288272202657,0.22864833267273493,2493,2431,Menard and Nearby Counties,Schleicher,48,413,Texas,TX
48431,48CS068,13,13,13,13,0,0,0,18.729695959850435,7,613.1386861313869,-605.3991284792629,-594.1468265816726,-582.089105671301,5.7668668503036296,16,16,16,16,-0,0,0,7.854579682984977,3,217.23388848660392,-221.47023220727627,-209.55992756850208,-196.2869234700445,2.7064289300922377,1370,1381,Menard and Nearby Counties,Sterling,48,431,Texas,TX
48435,48CS068,25,25,25,38,13,13,13,459.8751293849032,3,105.32475131655937,342.4164914406845,354.3595006676901,367.1370375799745,0.21278441986084726,30,30,30,47,17,17,17,512.1584804009996,4,120.30075187969925,378.9637639619568,391.433112207867,405.3618596497551,0.22186145733282908,3418,3325,Menard and Nearby Counties,Sutton,48,435,Texas,TX
48329,48CS069,967,894,1041,1106,65,139,212,97.41614253277918,200,140.4379322855103,-93.67459302072899,-42.701515276688994,10.617274675955128,1.4313118572739285,1182,1095,1269,1403,134,221,308,131.50306009321994,233,138.44572392853112,-57.9165723315631,-5.631211746297723,46.303150787899916,1.04805911014135,170894,168297,Midland,Midland,48,329,Texas,TX
48339,48CS070,3578,3308,3847,4026,179,448,718,86.06556816934008,290,55.68873199317653,-21.480040098006953,31.74455402372014,82.00413348210498,0.6456095822726765,4558,4224,4891,5408,517,850,1184,131.7726350077477,850,131.70249491008593,-53.566792279231684,0.5566688049177427,53.55356788984929,0.9982938805455001,624902,645394,Montgomery,Montgomery,48,339,Texas,TX
48347,48CS071,492,465,520,635,115,143,170,264.71975638691174,103,191.1507709438456,19.758603927617575,73.10053836147351,122.92352532743601,0.7170602964014325,606,573,640,792,152,186,219,287.39287470713316,128,197.95242955677213,41.82281266394317,88.10552399723184,142.6510766673096,0.6851002133519499,64661,64662,Nacogdoches,Nacogdoches,48,347,Texas,TX
48087,48CS072,30,29,31,43,12,13,14,587.2414887460654,4,179.4392523364486,357.4414310235726,407.2103221753714,457.20840685451526,0.28387736556925697,36,35,37,42,5,6,7,225.9993513491761,8,305.57677616501144,-132.26697531386625,-80.0503682262604,-27.699264610621874,1.1566271161120525,2675,2618,Northeast Panhandle,Collingsworth,48,87,Texas,TX
48179,48CS072,218,209,227,245,18,27,36,151.81062301548184,41,231.40962325384504,-131.1141980175753,-77.7912051716463,-28.26175619456124,1.4696895985038223,265,255,276,349,73,84,94,396.8809327211845,63,299.25897776933306,45.72254279067388,97.18881437756656,149.47801761549354,0.7451091218510447,21261,21052,Northeast Panhandle,Gray,48,179,Texas,TX
48195,48CS072,41,41,42,50,8,9,9,200.92678566887,19,433.2129963898917,-244.6257651835063,-232.84826549938904,-220.60403724246856,1.936342448208697,50,49,50,62,12,12,13,237.0489103347919,10,193.31142470520007,31.45932512301196,43.627548705504005,56.063549469128745,0.7540033734683547,5263,5173,Northeast Panhandle,Hansford,48,195,Texas,TX
48211,48CS072,26,26,27,20,-7,-6,-6,-219.77085115906704,4,140.14598540145985,-371.1868607932109,-359.56666971056364,-348.0436561123118,-0.7586352064649002,31,31,31,24,-7,-7,-7,-211.99838789890052,6,182.64840182648402,-407.61552390367206,-394.847915971373,-382.46434479413716,-1.0060114140824765,3425,3285,Northeast Panhandle,Hemphill,48,211,Texas,TX
48295,48CS072,22,22,22,34,12,12,12,466.0541716679742,2,78.53403141361257,374.7705152371505,387.6359113838481,399.91073335193676,0.1554140878628277,26,26,27,40,13,14,14,466.63067493655456,2,67.86562606040042,386.4300003758085,398.6388237832544,411.2828007970597,0.13557845846101294,3056,2947,Northeast Panhandle,Lipscomb,48,295,Texas,TX
48357,48CS072,63,62,64,93,29,30,31,362.3225411588258,20,241.93548387096772,107.40624238757795,119.99989596583418,133.13145006833213,0.6461618670588001,77,76,78,90,12,13,14,134.95233323724028,24,244.69820554649263,-122.97555799785833,-109.38092722019508,-97.32729700311758,1.6858520322873765,9920,9808,Northeast Panhandle,Ochiltree,48,357,Texas,TX
48393,48CS072,9,9,10,12,2,3,3,402.71851434537615,1,145.98540145985402,209.21550492702693,257.0856923016468,307.26639477024884,0.26605496562862785,11,11,11,1,-10,-10,-10,-1253.2832782964865,1,124.84394506866417,-1429.600053646054,-1377.7876418155745,-1324.1576717557734,-0.11063416649219122,822,801,Northeast Panhandle,Roberts,48,393,Texas,TX
48483,48CS072,52,51,52,62,10,10,11,242.42285699754905,11,265.0070267014656,-34.45894900233371,-22.579098800536688,-10.68087357601658,0.9943441024183424,63,62,64,92,28,29,30,586.4380585355648,5,101.31712259371835,473.21955634294164,485.15391456178816,497.47612804113913,0.16699666215361633,4981,4935,Northeast Panhandle,Wheeler,48,483,Texas,TX
48065,48CS073,49,49,50,80,30,31,31,633.2327312231457,12,247.84853700516348,373.24961660421354,385.21036417498283,397.6927517625507,0.3790389194461691,60,59,60,85,25,25,26,439.1721417771871,13,225.89052997393568,200.8766645921603,213.54262344326276,225.94661948902362,0.4947790014082791,5810,5755,Northwest Panhandle,Carson,48,65,Texas,TX
48111,48CS073,37,36,38,68,30,31,32,517.8284068775463,14,235.22822738728647,271.21841358001734,282.15568716877874,294.31724035101024,0.4399828689410565,46,45,47,79,32,33,34,464.6836995317126,2,27.917364600781685,422.9779920077926,437.0622697266939,449.41510860765896,0.058326144237211414,7142,7164,Northwest Panhandle,Dallam,48,111,Texas,TX
48205,48CS073,37,36,37,48,11,11,12,256.0421942882616,11,245.0343419342862,-1.4461105874350673,10.956082167354813,22.927660280490972,0.8804112690805491,45,44,45,46,1,1,2,23.969875959712,4,74.1839762611276,-62.70948058259559,-50.271612666887165,-37.75546936486908,1.7448537738382608,5387,5392,Northwest Panhandle,Hartley,48,205,Texas,TX
48233,48CS073,209,200,218,274,56,65,74,379.1554497423703,56,326.4195851751105,-0.9890981033904963,53.51928612234855,102.64608694420114,0.8478774980053193,255,244,265,348,83,93,104,454.44993640035653,64,312.1798936637237,92.7750878526168,141.55287810921533,195.3142107076485,0.6796451891711844,20587,20501,Northwest Panhandle,Hutchinson,48,233,Texas,TX
48341,48CS073,145,136,154,175,21,30,39,171.1014722045444,63,356.48606592162963,-238.41411905744292,-183.84317217342408,-134.22936269171933,2.0167804020279325,178,167,189,190,1,12,23,56.53808270912221,35,165.555082541034,-163.92656241054473,-108.77962218263609,-59.53818610174264,2.7021359707812707,21207,21141,Northwest Panhandle,Moore,48,341,Texas,TX
48359,48CS073,12,12,12,17,5,5,5,325.6037845436723,2,132.7433628318584,180.55170480867346,192.67668189526424,204.60840767153277,0.3386522228040146,14,14,14,19,5,5,5,284.04499934196645,1,58.03830528148578,212.92330449968594,226.43504231797388,238.878014249665,0.16966132078667615,1808,1723,Northwest Panhandle,Oldham,48,359,Texas,TX
48421,48CS073,21,20,21,27,6,6,7,267.5951030831976,12,511.3636363636363,-255.61652529410105,-243.80340781214483,-231.5951360808718,1.6484501283732462,25,25,26,33,7,8,8,280.84452586815496,7,250.44722719141325,18.071283337705843,30.039109582002336,43.12552179166997,0.79099580117622,2816,2795,Northwest Panhandle,Sherman,48,421,Texas,TX
48355,48CS074,2465,2313,2617,3260,643,795,947,269.20270985335287,510,172.66722905775043,40.80031653569765,95.92995374838137,149.83861089086366,0.6405966221999271,3029,2846,3211,4057,846,1028,1211,291.24822204606255,621,175.88032207906966,58.33213373940435,116.3354337187908,167.30106967631906,0.60329795017175,354439,353081,Nueces,Nueces,48,355,Texas,TX
48361,48CS075,840,804,877,977,100,137,173,194.14998407809992,75,106.54670297146916,35.37956065268601,87.9638760381028,139.8792954989712,0.5447991634496251,1029,985,1073,1237,164,208,252,245.51316527486196,234,276.15181268882174,-79.5064849284183,-29.79309196874083,20.035121755409612,1.119413503795339,84470,84736,Orange,Orange,48,361,Texas,TX
48365,48CS076,227,218,237,333,96,106,115,561.0503813457985,45,238.76901308807925,271.1754251328892,322.12174895279566,371.1148120126905,0.42158794391388416,278,267,290,369,79,91,102,400.38673545453196,74,326.69639309522756,21.759022874806206,73.23086798209563,124.5512551925644,0.8070532136602472,22616,22651,Panola+Sabine+San Augustine+Shelby,Panola,48,365,Texas,TX
48403,48CS076,142,138,146,156,10,14,18,166.37596475392286,16,192.2691768475866,-76.63303804493975,-25.4635797743728,25.018474115222826,1.0777855914041627,174,169,179,258,79,84,89,840.8490310605965,52,519.1693290734825,272.3361748309842,321.13984882162356,373.22425951146056,0.6101894196919246,9986,10016,Panola+Sabine+San Augustine+Shelby,Sabine,48,403,Texas,TX
48405,48CS076,104,103,105,149,44,45,46,676.913566046523,28,421.9515258068567,242.0036561223843,254.7769729718725,266.59429168479045,0.6097712880158477,127,126,128,190,62,63,64,799.6957237613522,13,164.09997475385003,623.0062588784915,635.8852029420124,647.2773974739926,0.20201425229589617,7963,7922,Panola+Sabine+San Augustine+Shelby,San Augustine,48,405,Texas,TX
48419,48CS076,237,227,247,295,48,58,68,287.85599549486136,44,218.84196128818334,21.73450402823631,68.32075290773915,123.23077191938754,0.7473353245946831,288,276,301,386,85,98,110,407.9887068489359,75,313.3224714876551,45.5706481334416,95.96338933933428,147.58862915914992,0.760184520740078,24127,23937,Panola+Sabine+San Augustine+Shelby,Shelby,48,419,Texas,TX
48367,48CS077,1100,1036,1165,1222,57,122,186,97.93845268056977,109,87.62116573664078,-38.72942250513223,10.694728968622258,66.12215412316468,0.8873719876722004,1406,1325,1486,1615,129,209,290,134.3109191263747,287,184.3347570570667,-101.94227457163059,-49.613014700054,2.499854876653911,1.3659161573097636,149279,155695,Parker,Parker,48,367,Texas,TX
48373,48CS078,580,558,602,719,117,139,161,328.4379120869926,66,156.03144269981675,121.59986249093288,172.1601045833864,221.05379934452225,0.4716762020067104,719,692,745,963,218,244,271,472.5923226863479,163,315.3048591767255,110.21224657961776,155.29684834339415,206.14193930132075,0.6644617755855878,50759,51696,Polk+San Jacinto+Tyler,Polk,48,373,Texas,TX
48407,48CS078,268,256,280,323,43,55,67,238.70478031408172,24,103.87362042847867,85.68437147774888,135.7041446117729,183.47632544666598,0.42740568345029073,329,314,343,484,141,155,170,558.7557144550898,79,283.9683680805176,229.2319233042381,273.9529753691039,323.6281982085762,0.5049670871432703,27726,27820,Polk+San Jacinto+Tyler,San Jacinto,48,407,Texas,TX
48457,48CS078,218,209,226,272,46,54,63,324.56946361924463,17,101.60374539296743,171.62055438978317,222.32697405705832,270.18055851073274,0.307381417094571,266,255,276,410,134,144,155,720.2026869824005,60,299.4609702535436,367.5123758748656,419.5015493826572,469.96356422437606,0.4129392863609062,20078,20036,Polk+San Jacinto+Tyler,Tyler,48,457,Texas,TX
48375,48CS079,1049,998,1099,1402,303,353,404,360.0460088083502,299,304.5685279187817,5.401838825096455,55.11416508186444,107.04129675674321,0.8435291091389975,1278,1218,1338,1581,243,303,363,259.52276607887484,269,230.33977257158514,-21.903575942430745,30.94255920709007,78.78556278865672,0.8846325176776494,117806,116784,Potter,Potter,48,375,Texas,TX
48379,48CS080,147,142,152,170,18,23,28,226.2500956764441,20,195.74259848299485,-17.487626747495508,31.201858009235583,80.82512363356548,0.8292869821060226,181,175,188,205,17,24,30,189.51352344307503,32,256.73940949935815,-115.16691982831072,-65.0808077061444,-15.203382651692458,1.2997053230706945,12261,12464,Rains+Van Zandt,Rains,48,379,Texas,TX
48467,48CS080,590,564,615,698,83,108,134,218.41339798958793,71,143.37400084139674,22.359565441939985,73.7484455865899,123.63403647105613,0.6504205966090528,735,703,766,986,220,251,283,411.4093281320246,174,285.04029880086495,76.652348272434807,127.84660748899874,177.78410630939035,0.6900908616351001,59425,61044,Rains+Van Zandt,Van Zandt,48,467,Texas,TX
48381,48CS081,955,894,1016,1200,184,245,306,208.31368278127306,206,175.3191489361702,-19.676897258771323,31.618093735998755,86.23581475116175,0.8381868922786228,1195,1121,1269,1480,211,285,359,198.79756545154748,218,151.9470833827045,-1.3336245257575436,47.185362651250394,100.7447229800979,0.761660244997639,141000,143471,Randall,Randall,48,381,Texas,TX
48397,48CS082,583,536,630,632,2,49,96,53.90501070187226,54,59.32273214138584,-52.43572702914097,-4.941371715542979,43.991835362124284,1.078524931291092,762,702,821,877,56,115,175,99.913484102978515,168,145.68410829185382,-95.03402466497218,-45.702274454831425,10.059365973074511,1.44555632700812,109233,115318,Rockwall,Rockwall,48,397,Texas,TX
48401,48CS083,450,428,473,577,104,127,149,288.64644418090853,76,173.40381032056888,64.58981488607337,115.47434136338592,163.90134079768936,0.5960367054820837,554,527,581,767,186,213,240,404.20344185845966,151,286.7070461579357,64.86792133970646,119.09601249151004,169.35062428051896,0.7059973365345399,52594,52667,Rusk,Rusk,48,401,Texas,TX
48409,48CS084,557,527,586,661,75,104,134,182.524841113053,98,171.52858809801634,-41.49834563771322,10.294685123640601,62.93260475216813,0.9308287312852106,692,656,728,883,155,191,227,275.001107673867,195,280.3174055545972,-53.55902108544361,-6.1926646675781925,47.70970492711195,1.014031225246355,68560,69564,San Patricio,San Patricio,48,409,Texas,TX
48033,48CS085,8,8,8,7,-1,-1,-1,-244.34884093752217,7,1310.4524180967237,-1566.5883397545037,-1554.6317621095804,-1543.3452068091929,-22.9335211295904,10,10,10,3,-7,-7,-7,-1100.4078130624605,3,483.8709677419355,-1596.8649394072806,-1584.2346344272278,-1570.667540056614,-0.515240076610313,641,620,Scurry and Nearby Counties,Borden,48,33,Texas,TX
48151,48CS085,38,36,40,59,19,21,23,682.1926608816976,12,389.29440389294405,245.94359071372702,293.3133929968802,342.84927741350026,0.5447466528327105,47,45,49,66,17,19,21,523.3875339408249,13,351.16153430578066,118.33026625945881,172.46285899408605,223.0799926928945,0.6380115553148645,3699,3702,Scurry and Nearby Counties,Fisher,48,151,Texas,TX
48169,48CS085,38,38,39,53,14,15,15,303.2603886224451,15,306.85305148312307,-16.003969510668348,-3.580898600508546,8.088512955467431,0.9479045161051644,47,46,47,64,17,17,18,295.596343586748,11,187.93780967025455,94.82677106937044,107.79161128178366,121.33897451122128,0.6010517096768867,5866,5853,Scurry and Nearby Counties,Garza,48,169,Texas,TX
48227,48CS085,311,296,326,414,88,103,118,351.837454333358,85,291.3453299057412,10.259260271224948,61.150069343336384,110.28518798028871,0.8200787913618469,375,358,393,459,66,84,101,244.32483288390674,70,204.5228773447087,-11.489493910692607,40.28984924979749,91.62619382609455,0.8272020203474119,35010,34226,Scurry and Nearby Counties,Howard,48,227,Texas,TX
48263,48CS085,12,11,12,16,4,4,5,706.0963985761765,7,1108.179419525066,-414.05056446367155,-402.0814795244259,-389.5828165066344,1.2820100547822857,14,14,14,20,6,6,6,807.0545309864983,3,400,394.8357068498795,407.5588016586992,421.1502739182861,0.4253564036466102,758,750,Scurry and Nearby Counties,Kent,48,263,Texas,TX
48335,48CS085,84,83,85,76,-9,-8,-7,-105.32517358227591,16,216.36240703177822,-332.7140756263757,-321.57194621060574,-309.69324016362083,-2.35682418766691,105,103,106,109,3,4,6,48.6240361910526,27,298.07904614705234,-263.39243921919325,-249.69959744847804,-236.05257325991087,4.995961414499699,8874,9058,Scurry and Nearby Counties,Mitchell,48,335,Texas,TX
48353,48CS085,162,156,168,202,34,40,46,325.6372781668387,32,260.79869600651995,13.170161067674307,63.750078821380335,117.35644531282696,0.7813321384743996,197,189,204,214,10,17,25,117.30896323906774,51,348.956551488197,-283.9685634701358,-230.53621806814758,-175.42211158412402,2.8107373508443083,14724,14615,Scurry and Nearby Counties,Nolan,48,353,Texas,TX
48415,48CS085,150,143,157,201,44,51,58,364.11051224194426,38,270.1421800947867,44.14118210954555,93.04844323900419,145.88692339624376,0.7277154560502513,183,175,192,223,31,40,48,234.88532119604338,55,326.603325415677,-141.12047051133243,-92.73720987039694,-40.57062554271227,1.3561933919634082,16880,16840,Scurry and Nearby Counties,Scurry,48,415,Texas,TX
48423,48CS086,1862,1762,1963,2318,355,456,556,233.4420602069408,286,146.5282788477549,33.13656049091499,87.53337082146847,141.99743293111214,0.6263112846904031,2310,2187,2432,2978,546,668,791,282.32920633017267,531,224.30522407289288,7.563105444511538,55.738340431117315,112.57792399752779,0.7932941949062091,234221,236731,Smith,Smith,48,423,Texas,TX
48427,48CS087,380,373,386,641,255,261,268,477.9965960496011,210,383.95319427726906,82.06273766775195,93.68440277153464,106.35675969232922,0.8001943179555309,471,462,479,632,153,161,170,244.12307882051752,126,190.85703898936654,40.269377890888265,53.42300389503574,65.27351669896345,0.7769855682050507,65633,66018,Starr,Starr,48,427,Texas,TX
48439,48CS088,11529,10620,12439,13952,1513,2423,3332,137.5275127799481,1732,98.31705832182658,-16.82601883649141,37.74508343146708,92.1588496754831,0.7145951548821609,14368,13271,15465,17744,2279,3376,4473,158.90056740229014,2929,137.8507982780181,-28.45887643827857,20.27249444589667,75.07140036391777,0.8672717986452737,2113977,2124761,Tarrant,Tarrant,48,439,Texas,TX
48441,48CS089,1235,1174,1297,1390,93,155,216,130.05481073788266,218,183.4334878307027,-104.92380263330216,-54.52803518509613,-1.656326228374202,1.4013655056945138,1521,1447,1595,1838,243,317,391,220.9808487400718,391,272.78942888637727,-102.18598721127188,-51.54757199468821,-0.9464806739379348,1.2305632002260838,142613,143334,Taylor,Taylor,48,441,Texas,TX
48451,48CS090,928,876,979,1222,243,294,346,294.4069177817015,190,190.10455750662865,55.91881171627384,104.14405067507569,152.3826222253128,0.6435333498486064,1139,1077,1201,1459,258,320,382,267.91231279057286,211,176.5513086551978,41.00931532168665,91.56685794185313,142.45087420104988,0.6569374269799818,119934,119512,Tom Green,Tom Green,48,451,Texas,TX
48453,48CS091,5142,4585,5699,5943,244,801,1358,74.31904544691795,586,54.35332910276041,-31.9566050697687,18.907326372539085,71.57739952260819,0.7304396634480643,6490,5817,7163,7406,243,916,1589,70.23386124101913,874,67.0330732286472,-48.83842060609665,3.3534693004503495,54.68179207677459,0.9533855941400834,1293757,1303834,Travis,Travis,48,453,Texas,TX
48469,48CS092,705,666,744,906,162,201,240,264.1858226899352,129,169.51008519305316,41.0338960385896,94.46320719743451,146.189684789216,0.6384564149870414,864,817,911,1119,208,255,302,280.32098556834507,231,253.8349962639005,-23.52823865576276,26.76583429642098,73.52357130439941,0.901979752876391,91322,91004,Victoria,Victoria,48,469,Texas,TX
48479,48CS093,1176,1061,1291,1897,606,721,836,322.1295398358951,526,234.95866261171886,34.30441020911643,87.02251850952742,139.08237485672694,0.7283818250196707,1467,1329,1605,1980,375,513,651,191.56590014570122,423,157.92951788561123,-16.544614031688887,34.35254258876391,81.79101665388764,0.8228098888854282,268643,267841,Webb,Webb,48,479,Texas,TX
48017,48CS094,49,49,50,59,9,10,10,170.42620953394157,14,245.0408401400233,-87.0329837459617,-74.75484057644456,-62.17807625497887,1.303900275918402,60,60,61,82,21,22,22,314.73092445364756,19,277.85902310617143,23.385637210822782,36.41120630855078,49.130844455879796,0.8436457700880069,6856,6838,Western Central Panhandle,Bailey,48,17,Texas,TX
48069,48CS094,51,51,52,75,23,24,24,387.1270521542985,24,391.1980440097799,-15.413724663539185,-4.003732812970876,7.285684073382005,0.9696873844971737,63,62,64,96,32,33,34,445.6298585230341,19,257.8368842448093,175.7386139131721,187.68152312186206,200.8182508489077,0.5614912026100132,7362,7369,Western Central Panhandle,Castro,48,69,Texas,TX
48079,48CS094,21,21,22,34,12,13,13,582.7973308267638,10,462.78441959120704,107.31661732011017,120.2554135720628,132.4734724751474,0.7356576737039956,26,25,26,46,20,20,21,809.3415021426233,10,396.51070578905626,400.72888611062126,412.7240631141369,427.0340141162056,0.4670367192000306,2593,2522,Western Central Panhandle,Cochran,48,79,Texas,TX
48117,48CS094,138,130,146,173,27,35,43,229.34016757511085,60,389.3365057048613,-211.59724304594033,-159.80888821709976,-110.71600101258467,1.6509264136206891,169,160,179,216,37,47,56,255.68010388380722,41,223.38454832734007,-18.522555557508305,31.417608632247912,86.89704840654028,0.8554582970073327,18493,18354,Western Central Panhandle,Deaf Smith,48,117,Texas,TX
48219,48CS094,177,167,186,285,99,108,118,599.7217839760464,91,503.10988251554943,46.763307106439655,97.40363274465967,144.03310858097794,0.8312424565319826,215,204,227,294,67,79,90,367.1456615363496,58,271.2561968010476,47.371772395921816,95.33160504076452,146.060308922262,0.7295314357283267,21705,21382,Western Central Panhandle,Hockley,48,219,Texas,TX
48279,48CS094,140,134,146,194,48,54,60,499.3944310944324,67,620.2267993520019,-168.36988644377962,-121.24473158054704,-65.72332118369137,1.2193549835779172,171,164,178,174,-4,3,10,24.04472562004987,28,216.86933622492447,-243.41336973632477,-193.8960953098368,-139.9332363418432,6.821923036960488,12963,12911,Western Central Panhandle,Lamb,48,279,Texas,TX
48369,48CS094,67,66,68,105,37,38,39,466.81265591243226,36,440.6364749082007,13.450647597342181,25.919992065170252,37.364131802181504,0.9198082080055214,82,81,84,103,19,21,22,209.0316460005485,10,101.84336490477645,95.38937202877037,106.85596280133208,118.85793688646905,0.4645800171479081,9804,9819,Western Central Panhandle,Parmer,48,369,Texas,TX
48043,48CS095,77,76,78,81,3,4,5,56.306637295351976,12,151.70670037926675,-108.09992753126537,-95.16725651013125,-83.53857008018853,2.2002785145296393,95,93,96,109,13,14,16,152.57155460750752,14,147.88211682687228,-8.207086749713278,4.702315729839904,17.471765115882555,0.9065038956222105,9492,9467,"West Texas, excluding El Paso",Brewster,48,43,Texas,TX
48103,48CS095,32,32,33,39,6,7,7,170.00293163306276,4,102.49839846252402,54.89652373811512,67.050218322156,79.36839211103627,0.5239466950703464,40,40,41,48,7,8,8,167.3427799927663,10,213.76656690893546,-58.18993484263897,-46.24559566705276,-33.572076543541044,1.1327215185962045,4683,4678,"West Texas, excluding El Paso",Crane,48,103,Texas,TX
48109,48CS095,18,17,18,27,9,9,10,517.5967681752384,2,109.78956999085086,395.87358643812803,407.81259435218993,419.63059254577087,0.19177500415996845,22,22,22,31,9,9,9,418.0040392666006,5,227.99817601459188,177.7718198463814,190.23224404439978,201.81751864634703,0.49179544634860806,2186,2193,"West Texas, excluding El Paso",Culberson,48,109,Texas,TX
48229,48CS095,18,17,18,35,17,17,18,603.8681904574951,6,208.69565217391303,382.44243375649376,395.368095112522,407.38946127618027,0.3267758412745182,21,21,21,39,18,18,18,551.4806962357213,5,152.71838729383018,384.9993379436032,398.91727235550303,410.93791123666733,0.26239173855285,3450,3274,"West Texas, excluding El Paso",Hudspeth,48,229,Texas,TX
48243,48CS095,16,16,16,19,3,3,3,195.9070998618492,5,297.3240832507433,-113.12032149513888,-101.4057182486758,-88.68777750261054,1.1642787010872218,19,19,19,28,9,9,9,469.1202614216192,3,153.60983102918587,303.5757136146413,315.3430376125282,328.4123040841704,0.2952198385878969,2018,1953,"West Texas, excluding El Paso",Jeff Davis,48,243,Texas,TX
48301,48CS095,1,1,1,7,6,6,6,9363.374113751226,7,10500,-1183.0883972781182,-1138.2313319441644,-1088.2107244183333,0.9665505293340442,1,1,1,5,4,4,4,7362.938580438852,5,8620.689655172415,-1309.666961573577,-1256.9073835055924,-1204.1927838669176,0.9486758083623417,80,58,"West Texas, excluding El Paso",Loving,48,301,Texas,TX
48371,48CS095,106,104,107,164,57,58,60,459.68021282178296,28,220.38567493112947,227.4124414434474,239.28896049776836,251.26208387757003,0.47136165628158755,130,128,132,176,44,46,48,303.2458921810575,33,218.1818181818182,72.18869318324634,85.08380862393348,97.46118288604563,0.7041360775095674,15246,15125,"West Texas, excluding El Paso",Pecos,48,371,Texas,TX
48377,48CS095,37,36,38,55,17,18,19,351.4781556998786,20,388.34951456310677,-48.86629111164924,-37.217073997076135,-24.93385682587696,1.047058745523293,46,45,46,70,24,24,25,396.96779069214665,14,228.23606129768504,155.87098036112897,168.83507735518333,180.9935648159139,0.5522681513100184,6180,6134,"West Texas, excluding El Paso",Presidio,48,377,Texas,TX
48389,48CS095,97,96,99,128,29,31,32,245.96792227777442,28,225.76093529530337,8.347238093512695,19.99576509782364,31.889224367413032,0.8887147696200375,118,116,120,158,38,40,42,273.2246522239432,32,220.35532295827022,40.28621050225116,52.71895556440318,64.82629722000688,0.7866721223159446,14883,14522,"West Texas, excluding El Paso",Reeves,48,389,Texas,TX
48461,48CS095,25,25,25,34,9,9,9,317.2850643489207,5,179.42583732057415,126.2552615204126,137.69268090508876,149.44911838365496,0.5080434905271413,31,30,31,32,1,1,2,45.54074592873366,5,152.90519877675843,-119.60641201839128,-107.62461438806183,-95.26061892799457,2.0086916958481975,3344,3270,"West Texas, excluding El Paso",Upton,48,461,Texas,TX
48475,48CS095,101,100,102,115,13,14,15,145.17932898200053,13,133.8366506520247,-0.7735505490117062,11.60718846084996,24.12371843626199,0.8608272647087518,121,119,122,122,-0,1,3,12.479344868907328,24,213.12494449871235,-213.26590198335379,-200.1183581540133,-188.06505082155658,9.977969368336067,11656,11261,"West Texas, excluding El Paso",Ward,48,475,Texas,TX
48495,48CS095,61,61,62,75,13,14,14,212.12056128480887,15,232.37800154918668,-31.344697134030184,-20.248966221095856,-8.387257592954734,1.0209372288462457,73,72,74,88,14,15,16,198.42950896656595,17,227.7599142550911,-42.065697874509766,-28.984343023451913,-16.16554222496325,1.0752158691635612,7746,7464,"West Texas, excluding El Paso",Winkler,48,495,Texas,TX
48491,48CS096,2781,2515,3046,3106,60,325,591,63.519620878573335,256,49.972427322815044,-38.0937364315183,14.408784586502758,69.22850441031869,0.7843139613916571,3594,3264,3924,4068,144,474,804,74.13309796150854,564,88.26594968840868,-61.96698184622771,-13.840764050143171,34.59710636020608,1.1881333620910028,614739,638978,Williamson,Williamson,48,491,Texas,TX
48497,48CS097,552,523,582,665,83,113,142,194.89077202648633,78,135.04544798730342,6.4760943780488605,61.1970083368335,113.18253276844354,0.686827327934203,698,661,734,833,99,135,172,189.94148207114927,153,214.58926492657682,-77.24900900491741,-23.163461473023123,26.574493241156105,1.1214840049693193,69310,71299,Wise,Wise,48,497,Texas,TX
49001,49CS001,55,54,55,43,-12,-12,-11,-197.60783699243126,5,85.19096975720574,-295.06368483137726,-282.7410142494975,-270.19191715574436,-0.4717900989474017,69,68,69,90,21,21,22,296.93054687484874,13,179.95570321151718,104.0628838685067,116.51126625713951,129.9682530400319,0.5790578119331858,7043,7224,Beaver+Iron+Millard,Beaver,49,1,Utah,UT
49021,49CS001,307,282,332,337,5,30,55,62.376206685683876,16,33.33680591728305,-23.730407055249014,27.40066206643439,77.62590209366921,0.5171723791725232,393,362,424,447,23,54,85,89.55061706210469,65,108.1548777849881,-73.14121154038935,-18.208601296020525,32.67949826647982,1.1857197311916179,57594,60099,Beaver+Iron+Millard,Iron,49,21,Utah,UT
49027,49CS001,90,88,91,111,20,21,23,196.17308596056415,7,64.40236141991873,118.99111112365847,131.6293221842695,144.21044466087434,0.313586638344522,111,109,112,154,42,43,45,329.48498589153047,31,235.88494901841426,81.88376088702641,93.70285849350142,104.97192945743352,0.6997597839308275,13043,13142,Beaver+Iron+Millard,Millard,49,27,Utah,UT
49003,49CS002,357,332,382,417,35,60,85,124.40335062300493,29,60.19823902852496,8.03097836591588,63.26055839487933,114.78025411381435,0.4759538476615265,452,421,483,511,28,59,90,99.30040815577097,77,129.56855354378408,-82.66888747914875,-29.774314983895295,22.241387614792128,1.283071446501183,57809,59428,Box Elder+Cache+Rich,Box Elder,49,3,Utah,UT
49005,49CS002,525,468,582,529,-53,4,61,3.5953296925750067,31,27.934009656757098,-78.3535598175599,-24.98562628754512,26.423462313421375,6.212490725238089,675,604,745,732,-13,57,128,41.84001205987287,60,43.843624406284256,-53.55984684655629,-1.444788410277896,50.222804863481194,1.0299004738674435,133171,136850,Box Elder+Cache+Rich,Cache,49,5,Utah,UT
49033,49CS002,15,15,15,11,-4,-4,-4,-192.60948854424592,5,239.23444976076553,-443.77683844050705,-432.38182413142664,-419.4087232260116,-1.6525984756247178,19,19,19,20,1,1,1,39.06660110386055,2,77.42934572202864,-50.227107110776466,-38.35352431695048,-26.234977534885232,0.9954754116909277,2508,2583,Box Elder+Cache+Rich,Rich,49,33,Utah,UT
49007,49CS003,191,182,199,220,21,29,38,172.70292905364815,6,35.19577650681918,86.42850521008124,137.62077407055176,189.57888678607267,0.19709914840764062,233,222,243,292,49,59,70,291.8453783417838,30,147.15981555969785,89.62351014049602,143.31255784335266,189.47944716494578,0.4959038439295483,20457,20386,Carbon+Daggett+Duchesne+Uintah,Carbon,49,7,Utah,UT
49009,49CS003,10,10,10,3,-7,-7,-7,-852.1464746835316,3,376.56903765690373,-1240.6430039966747,-1228.4613405592531,-1216.2608368329904,-0.5182450846720585,12,12,12,5,-7,-7,-7,-741.1598313035541,5,514.40329218107,-1269.1192140405383,-1255.1697299794398,-1243.2178597359234,-0.8059221012495476,956,972,Carbon+Daggett+Duchesne+Uintah,Daggett,49,9,Utah,UT
49013,49CS003,135,127,144,137,-7,2,10,9.757783478767175,1,6.108113610913163,-52.74494650561309,2.624363025281649,54.13844769418644,0.38498381631922124,168,158,178,194,16,26,36,131.74527297882466,16,80.97165991902834,-2.1427408462535826,52.24602589618188,103.48391228037583,0.5918721320613168,19646,19760,Carbon+Daggett+Duchesne+Uintah,Duchesne,49,13,Utah,UT
49047,49CS003,213,198,228,254,26,41,56,137.51995755310662,15,50.4116955133591,35.33069558243896,87.4801515511846,138.5610220047739,0.35783242262901177,267,248,285,340,55,73,92,202.8680749899476,43,119.05091503087019,31.187736549944127,84.16873803315653,137.90538565488322,0.5789380713546134,35706,36119,Carbon+Daggett+Duchesne+Uintah,Uintah,49,47,Utah,UT
49011,49CS004,1636,1480,1792,1840,48,204,360,67.53623310150091,92,30.438966288293404,-15.796848024049963,38.45533894547295,90.39779941504439,0.44850848395890663,2061,1872,2250,2338,88,277,466,75.57231656892333,212,57.807881504750064,-33.587952784792485,18.188072898102078,70.97140775962484,0.762184522659536,362693,366732,Davis,Davis,49,11,Utah,UT
49023,49CS005,67,66,68,72,4,5,6,49.712919808764504,7,70.68327162571525,-32.50113696885935,-20.951522330146105,-8.864244756120362,1.1817864108084435,84,83,86,85,-1,1,2,5.464154638534581,3,24.779053440158588,-32.36203906857512,-19.1234146360526,-6.555297283495487,1.8055482307860968,11884,12107,Juab+Sanpete+Tooele,Juab,49,23,Utah,UT
49039,49CS005,161,149,174,208,34,47,59,193.07725325825314,14,58.06719203649938,85.73636919804186,136.10890532432626,185.87411548878728,0.2944211868869764,201,186,216,282,66,81,96,278.17941122988276,32,110.27258003377099,112.85000842855342,166.32530863997428,220.53113761837267,0.3915576099997728,28932,29019,Juab+Sanpete+Tooele,Sanpete,49,39,Utah,UT
49045,49CS005,351,319,382,352,-30,1,33,2.2956834922800367,20,32.67084127416281,-79.71096518232726,-29.827984920821173,20.28091106513661,8.314829680462639,451,412,490,526,36,75,114,98.48421975984577,64,84.0446487196323,-36.57079986592623,16.144377826874134,65.2242447112089,0.8421525417442827,73460,76150,Juab+Sanpete+Tooele,Tooele,49,45,Utah,UT
49029,49CS006,59,57,60,72,12,13,15,129.30825495433595,8,77.5506906858389,38.79814197332052,52.13741083874157,63.20565297127385,0.5579102441272501,74,72,75,65,-10,-9,-7,-69.08995743349405,2,15.850372483753368,-98.55559687338697,-84.91967781934402,-73.07046647837534,-0.25914218552534474,12379,12618,Morgan+Summit+Wasatch,Morgan,49,29,Utah,UT
49043,49CS006,143,124,161,147,-14,4,23,12.33613754496333,5,14.129282938890851,-48.7093663413634,-1.5509640247648244,47.50347363882452,0.9318881682178886,181,159,203,207,4,26,48,59.87846060810252,13,30.232558139534884,-24.426118661729888,29.745176673882142,82.16680488929192,0.4860224057121151,42465,43000,Morgan+Summit+Wasatch,Summit,49,43,Utah,UT
49051,49CS006,138,135,142,166,24,28,31,95.58121196225126,16,54.80859809882676,28.018494238856135,40.43753362222106,51.771663722666396,0.5535844622946905,175,171,180,173,-7,-2,2,-6.862979567779383,12,33.326853111894906,-52.702384598633365,-40.22196246278847,-27.16639969437505,-8.156867142933548,35031,36007,Morgan+Summit+Wasatch,Wasatch,49,51,Utah,UT
49035,49CS007,5972,5463,6482,6695,213,723,1232,73.3393356224531,576,58.46612694897663,-31.970044631086054,15.990628227567788,67.38423757670296,0.7960982948213278,7437,6825,8050,7949,-101,512,1124,43.119378052912836,623,52.51206597470992,-58.624914118333,-10.128137447957739,43.91732444663546,1.2154539074976605,1182223,1186394,Salt Lake,Salt Lake,49,35,Utah,UT
49049,49CS008,2406,2120,2691,2649,-42,243,529,44.12113916257448,223,40.45883585596291,-48.142931541025575,2.8473584442268765,57.400637276282396,0.9132390478129271,3108,2756,3460,3248,-212,140,492,20.516507964912076,389,57.054771113565394,-89.04794482184761,-38.26748051612875,18.45627507616165,2.7611807926546477,661413,681801,Utah (county),Utah (county),49,49,Utah,UT
49053,49CS009,1283,1204,1361,1478,117,195,274,128.5665631507574,111,73.06156479003027,6.131759957142041,53.809236044784136,105.91996880192744,0.5653835693486562,1642,1543,1740,1889,149,247,346,130.34415381807878,249,131.14305126165937,-51.89558471702304,-2.255862589100757,49.9662512099617,1.002080054945431,182312,189869,Washington,Washington,49,53,Utah,UT
49015,49CS010,84,83,85,96,11,12,13,143.11757004091538,7,84.99443488819185,46.146836233697776,58.40934818272535,70.09090254935181,0.5474342152011054,104,103,106,127,21,23,24,227.67312616585943,20,201.0454362685967,13.73027634460081,26.397494418949996,38.81965087336627,0.845704489202756,9883,9948,Wayne and Nearby Counties,Emery,49,15,Utah,UT
49017,49CS010,43,42,43,51,8,8,9,193.3018110389002,4,94.46959259988192,86.95541779009956,98.90137783193762,112.58423366592109,0.43550588697577086,53,53,54,61,7,8,8,153.13890288677575,3,58.559437829396835,82.26119352207623,95.0239155242397,107.4007834971714,0.3391629415345591,5081,5123,Wayne and Nearby Counties,Garfield,49,17,Utah,UT
49019,49CS010,76,75,77,61,-16,-15,-14,-186.6053331017762,4,49.52027236149799,-247.12730606836368,-236.4657156425036,-224.36366075150784,-0.28423129308058315,93,92,95,85,-10,-8,-7,-87.79046586200093,7,72.41878750258638,-172.6892500751184,-160.35685456149258,-147.50035958187314,-0.9351004949487365,9693,9666,Wayne and Nearby Counties,Grand,49,19,Utah,UT
49025,49CS010,67,67,68,57,-11,-10,-10,-160.58700973972188,4,62.05559146735617,-234.73058514832604,-222.47100297252138,-211.79453595059798,-0.4277539143279082,85,84,86,109,23,24,25,300.2758339897042,13,163.62492133417243,124.22266001791958,137.09247862102916,149.3202032349413,0.5229932996318323,7735,7945,Wayne and Nearby Counties,Kane,49,25,Utah,UT
49031,49CS010,15,15,16,15,-1,-0,0,-25.09576464985206,1,82.930200414651,-160.51029210997459,-110.41657543013545,-58.33770319780506,1.4339242584108802,19,18,20,23,3,4,5,255.59599092605168,2,135.13513513513513,70.46469534775609,120.01319719479558,170.6520766194661,0.4181632847622061,1447,1480,Wayne and Nearby Counties,Piute,49,31,Utah,UT
49037,49CS010,99,97,100,147,47,48,50,397.38184333414625,43,352.8446389496717,31.378996609233717,44.71134273669026,57.542608574853254,0.8699592827158626,121,119,122,160,38,39,41,271.46720462524513,27,186.28397957775633,73.29159106504758,84.83679955651651,97.81721098353306,0.6692037479770635,14624,14494,Wayne and Nearby Counties,San Juan,49,37,Utah,UT
49041,49CS010,182,172,191,198,7,16,26,90.52612043958476,2,11.112654535352132,25.139300226933088,79.90629463087446,132.1592605225041,0.11565748792338856,227,216,238,230,-8,3,14,13.764599381453998,14,64.0614990390775,-100.52982994738903,-50.810935438858756,0.6800672841608648,3.4929132729497554,21597,21854,Wayne and Nearby Counties,Sevier,49,41,Utah,UT
49055,49CS010,21,20,21,33,12,12,13,588.5637008355096,2,94.749309119621,482.2304574993269,493.7710956077519,506.1580067103592,0.14899134218869647,26,25,26,33,7,7,8,294.1255792066137,1,39.23107100823852,242.89452750185623,254.86260061043197,267.7015256994192,0.11768498088444806,2533,2549,Wayne and Nearby Counties,Wayne,49,55,Utah,UT
49057,49CS011,1592,1479,1705,1773,68,181,294,82.63485258867105,110,50.22639929987443,-21.511608962837233,32.3512267162897,82.09225835268774,0.6044712848417864,1987,1850,2125,2141,16,154,291,57.66886819227862,213,79.94055125202667,-71.61627953312824,-22.166443762913655,26.937633177704594,1.3772363885099617,262810,266448,Weber,Weber,49,57,Utah,UT
50001,50CS001,272,256,288,287,-1,15,31,48.860985622906334,3,9.665726943213853,-11.365954207257557,39.21684990415855,89.87789239056714,0.18558352059172367,334,315,353,370,17,36,55,96.0964978042026,7,18.784382128002147,28.839244029692008,77.44643358432421,127.63331044357666,0.19016385652667955,37245,37265,Addison+Chittenden,Addison,50,1,Vermont,VT
50007,50CS001,1011,938,1083,1048,-35,37,110,26.77765391334006,62,44.36176302232399,-69.31442443585932,-18.325155334395266,34.887891422542125,1.6135559894083071,1254,1167,1342,1318,-24,64,151,37.63767371980447,42,24.884317547591255,-37.767905344834055,13.816370556685424,64.33375829083151,0.6509080577684833,167712,168781,Addison+Chittenden,Chittenden,50,7,Vermont,VT
50003,50CS002,407,391,423,399,-24,-8,8,-24.90208219995693,2,6.48263194857112,-79.96667848252838,-33.28198652956484,18.628424175115633,-0.29927989993669724,498,479,518,547,29,49,68,130.15977441555762,25,67.01334905913258,6.9893689876106775,64.35170630278637,114.66225291597891,0.5044654734501482,37022,37306,Bennington+Windham,Bennington,50,3,Vermont,VT
50025,50CS002,414,394,434,390,-44,-24,-4,-63.69691962098741,6,15.879317189360858,-132.85126480357934,-79.79769709205952,-28.58619420731991,-0.26010191311055164,512,488,536,536,0,24,48,51.741440505217355,24,52.11273722152256,-51.262400646938396,-0.6055327061388189,50.37013472137144,0.9666115063126052,45342,46054,Bennington+Windham,Windham,50,25,Vermont,VT
50005,50CS003,271,258,284,268,-16,-3,10,-13.727045979148386,2,7.957559681697612,-72.15136200471267,-19.8664644463256,29.3269434610336,-0.8163051325028425,336,320,351,387,36,51,67,169.50002270458936,14,46.09660531428007,71.13073102987214,123.70540342613704,173.45287045378404,0.266774128897643,30160,30371,Caledonia+Essex+Orange,Caledonia,50,5,Vermont,VT
50009,50CS003,61,61,62,68,6,7,7,138.31813806383354,5,100.90817356205852,26.173150764569762,37.3227941366542,49.58227548035495,0.6366455408394244,75,74,76,87,11,12,13,206.2348049937297,6,101.30001688333614,91.74418551631405,104.83267509916578,117.67732201072663,0.45401963446504773,5946,5923,Caledonia+Essex+Orange,Essex,50,9,Vermont,VT
50017,50CS003,241,229,254,240,-14,-1,11,-5.856359822275505,7,28.744482086028125,-87.045307413005375,-35.38371282382723,15.454484675493013,-16.425369166166973,300,284,315,295,-20,-5,11,-15.79410783142174,3,10.169491525423728,-79.23537261424795,-24.219489304756124,26.444688836019974,-0.8198374851399673,29223,29500,Caledonia+Essex+Orange,Orange,50,17,Vermont,VT
50011,50CS004,380,359,402,404,2,24,45,56.6973990061736,25,60.070883642698384,-53.83560432709124,-3.5220197461935125,48.47457753443099,1.0164237807423508,470,444,496,481,-15,11,37,21.010740089772444,24,47.735545080255385,-76.91833071157212,-28.18340884949933,25.106575770470243,2.075483646106633,49941,50277,Franklin+Grand Isle,Franklin,50,11,Vermont,VT
50013,50CS004,53,52,54,57,3,4,5,62.17059262405159,4,65.9069064945764,-15.316676462766011,-3.6213413629382347,8.167788491457165,0.8380057594462438,66,65,67,95,28,29,30,388.1569455857015,5,67.56756756756756,308.12355582274427,320.6168481820966,333.13641409161056,0.1682164222858071,7283,7400,Franklin+Grand Isle,Grand Isle,50,13,Vermont,VT
50015,50CS005,181,170,192,214,22,33,44,153.14571822308582,5,23.198267862666256,79.8607875476669,129.00997873134273,181.34453429617983,0.1470241987496483,223,210,237,246,9,23,36,86.54362682203853,6,22.99291051925656,11.703349076995222,64.68240281802932,111.08404375642857,0.2544145221400487,25864,26095,Lamoille+Orleans,Lamoille,50,15,Vermont,VT
50019,50CS005,275,263,287,277,-10,2,14,7.841180546575073,4,17.573405579556272,-58.72468299656482,-9.28739381207609,39.55088911660893,1.4363774326337828,337,323,351,428,77,91,105,329.9683243386861,24,87.21564067156044,188.37266010918958,242.00026528548884,293.72692872414393,0.2614359619905997,27314,27518,Lamoille+Orleans,Orleans,50,19,Vermont,VT
50021,50CS006,612,586,638,650,12,38,64,75.0836816855089,2,3.9914184503317864,23.454743580255137,69.63527430142736,119.75878351902176,0.05178321212939179,754,722,785,803,18,49,81,81.39036268770661,34,56.132472635419596,-25.682582715945376,24.539830495853256,75.08781337190992,0.6759583559851712,60129,60571,Rutland,Rutland,50,21,Vermont,VT
50023,50CS007,472,446,498,536,38,64,90,129.03043268793462,2,4.027994562207342,69.77504126713421,124.21369908608514,174.57798405062752,0.030737625118130014,582,551,613,610,-3,28,59,46.091073476803615,20,33.36837012196139,-38.553154550200844,13.901623125533153,60.30100404266332,0.6986751478409268,59583,59937,Washington,Washington,50,23,Vermont,VT
50027,50CS008,522,497,547,554,7,32,57,67.07238641190868,6,12.551644788452485,-2.9216955383341228,54.175792886620684,106.51885590964437,0.181475701344502,645,615,675,675,0,30,60,52.25463192488372,27,46.45241208450898,-43.943717146276406,6.706337590250528,57.183336646860354,0.8606268313810912,57363,58124,Windsor,Windsor,50,27,Vermont,VT
51001,51CS001,375,361,390,423,33,48,62,172.5492758860409,32,115.70447149572135,2.0951589236743002,55.55257233343066,110.48493439208177,0.6567958721453618,459,441,476,555,79,96,114,289.86757474159396,50,150.32620787108024,85.36166361337523,140.2726500118243,188.15445146893813,0.5132792842938066,33188,33261,Accomack+Northampton+Virginia Beach (city),Accomack,51,1,Virginia,VA
51131,51CS001,162,157,167,194,27,32,37,315.6646826577737,23,227.08573309198616,36.81722023337015,88.12319729703013,143.72968103846708,0.6975706376877463,196,190,203,213,10,17,23,138.2850370884091,20,165.20733520568314,-80.60629335169406,-26.6878261402194,20.237600545422026,1.1273457294932165,12154,12106,Accomack+Northampton+Virginia Beach (city),Northampton,51,131,Virginia,VA
51810,51CS001,2761,2564,2958,3056,98,295,492,77.37568846466702,163,42.712925900934835,-16.00707319442251,33.96066941059711,85.32903226587995,0.5501568036006961,3421,3184,3657,4058,401,637,874,139.19914871268728,403,88.00663871418588,-0.9261526178871627,50.72810779643026,103.47062627439689,0.6312451548380783,457941,457920,Accomack+Northampton+Virginia Beach (city),Virginia Beach (city),51,810,Virginia,VA
51003,51CS002,746,697,794,852,58,106,155,113.58564911232698,46,49.19040787046526,14.674870326334146,65.40195112300195,117.4206594550981,0.4290297447113303,925,866,983,1023,40,98,157,86.5679797134438,73,64.38354956210367,-30.409585258770967,21.48985762386899,72.85259936136781,0.7362331527884517,112217,113383,Albemarle+Charlottesville (city),Albemarle,51,3,Virginia,VA
51540,51CS002,242,222,262,259,-3,17,37,44.106509954645084,26,67.1400903808909,-74.47747640112354,-24.18248380025415,25.21211572397873,1.4380335327767255,295,272,319,329,10,34,57,73.34050848777906,23,50.23808483683544,-30.466852082606305,23.224538371606126,77.07411744156056,0.6651868361961419,46470,45782,Albemarle+Charlottesville (city),Charlottesville (city),51,540,Virginia,VA
51510,51CS003,629,560,697,705,8,76,145,57.81185891297116,87,65.81228369885207,-57.41902188296406,-8.694287480079623,42.04930664447116,1.1236839560093057,774,693,854,798,-56,24,105,15.709587194985325,58,37.336011226552344,-74.60017666702429,-22.283078566119283,30.303712407433064,2.2830856714312384,158633,155346,Alexandria (city),Alexandria (city),51,510,Virginia,VA
51005,51CS004,182,175,188,211,23,29,36,234.01491909960947,25,198.62288135593218,-19.36302691828062,36.11634812021143,87.86084277410701,0.8208919545938449,220,213,228,318,90,98,105,649.700308067799,49,326.40554223288035,274.70006623935194,323.03404572519605,369.84676790576293,0.4972952706620802,15104,15012,Alleghany and Nearby Counties and Independent Cities,Alleghany,51,5,Virginia,VA
51017,51CS004,55,55,56,65,9,10,10,273.32027220003124,1,28.680688336520078,232.09262375007808,244.53882736625238,256.46940617193536,0.09496886462070983,67,67,68,77,9,10,10,238.25955307208426,12,290.838584585555,-65.46798866983188,-52.60155899761733,-40.03567711770249,1.1079729664745535,4184,4126,Alleghany and Nearby Counties and Independent Cities,Bath,51,17,Virginia,VA
51023,51CS004,308,293,322,321,-1,13,28,48.075987430792054,20,71.3775874375446,-75.04174532767716,-23.634540526609968,26.175464778425436,1.3820848393369356,380,363,398,484,86,104,121,306.2326918087813,56,165.5384433474238,90.77643435572485,139.34797603045723,193.64876893054205,0.5353961007404019,33624,33829,Alleghany and Nearby Counties and Independent Cities,Botetourt,51,23,Virginia,VA
51091,51CS004,25,25,26,25,-1,-0,-0,-17.414518470508966,3,161.72506738544473,-191.26540819970472,-178.90082678462468,-167.3657794275855,4.431571992464986,31,31,31,33,2,2,2,82.7416669018507,7,314.3242029636282,-244.96760872408245,-231.30939543253305,-219.09251401120056,2.4624849893285394,2226,2227,Alleghany and Nearby Counties and Independent Cities,Highland,51,91,Virginia,VA
51580,51CS004,97,96,97,88,-9,-9,-8,-186.97756945242017,4,84.12197686645636,-283.6167183655397,-270.9484272728444,-259.0121943300439,-0.5069205151517218,119,118,120,117,-3,-2,-1,-34.22515331303867,25,437.2158097236796,-483.1949916427808,-471.8335231101304,-458.6553951519549,-26.12345849574547,5706,5718,Alleghany and Nearby Counties and Independent Cities,Covington (city),51,580,Virginia,VA
51007,51CS005,144,138,150,156,6,12,18,110.45106885183802,3,27.22940776038121,32.98617387662287,83.94404187377796,132.04633437082217,0.2278086555785439,177,170,184,224,40,47,54,353.7036852795803,29,218.6204297022239,83.86576267364812,135.26290266672453,190.47216719098012,0.605190524815058,13221,13265,Amelia+Brunswick+Lunenburg+Nottoway,Amelia,51,7,Virginia,VA
51025,51CS005,180,173,187,193,6,13,20,96.85739280451456,13,98.27390701776488,-54.10115906034756,-2.3137261616027893,52.00972186083292,0.9411683771767995,222,214,230,275,45,53,61,332.9236309965179,27,169.59798994974872,105.3575355857614,163.4752991262877,214.24219149151074,0.4999866479987313,15874,15920,Amelia+Brunswick+Lunenburg+Nottoway,Brunswick,51,25,Virginia,VA
51111,51CS005,134,129,139,136,-3,2,7,17.798043287665244,2,20.04008016032064,-54.97781427167903,-2.1920504028133316,47.39140664552425,0.7203975879768564,164,158,170,177,7,13,19,106.31722634673088,18,150.9180850171879,-96.85941332809374,-44.05888865039279,11.114015511497989,1.3157456552782913,11976,11927,Amelia+Brunswick+Lunenburg+Nottoway,Lunenburg,51,111,Virginia,VA
51135,51CS005,180,173,186,184,-2,4,11,32.56221539872096,21,162.03703703703704,-182.6305823962264,-129.98123128753573,-75.61229456973535,4.022939863877027,221,213,229,262,33,41,49,264.1574557244526,29,185.93319228056677,25.85618793668428,77.62811028909564,129.95102626214006,0.6871933961327793,15552,15597,Amelia+Brunswick+Lunenburg+Nottoway,Nottoway,51,135,Virginia,VA
51009,51CS006,294,280,307,324,17,30,44,116.28263356962647,18,68.95671050951347,-3.5779754415683467,47.332479502907056,100.495492687569,0.5740959588641067,360,344,376,478,102,118,134,376.8794250563346,49,156.69470116081993,170.45095839076566,222.2372355841805,277.5580329591762,0.4122706381410036,31324,31271,Amherst+Lynchburg (city)+Nelson,Amherst,51,9,Virginia,VA
51125,51CS006,166,159,172,186,14,20,27,165.33258541867806,4,32.52473234855671,85.90166029416743,133.29975640056492,183.83121495980276,0.18750158969056396,203,195,211,206,-5,3,11,20.092878837989122,24,162.35962657285887,-199.03044946143282,-143.26289208881826,-87.6819383945269,6.045143088604479,14758,14782,Amherst+Lynchburg (city)+Nelson,Nelson,51,125,Virginia,VA
51680,51CS006,674,640,708,779,71,105,139,158.3227611695584,56,84.73507679116335,18.7479826808228,72.38006594842922,126.46419980552774,0.5301379940066229,828,787,869,976,107,148,189,187.1824023713475,116,146.8558913266404,-12.832113843716686,42.29130753681836,92.0603944453375,0.7792896634237436,79306,78989,Amherst+Lynchburg (city)+Nelson,Lynchburg (city),51,680,Virginia,VA
51011,51CS007,165,158,172,156,-16,-9,-2,-69.51389926652293,3,22.32973576479345,-146.44952143441375,-91.83079651605195,-42.48604966675667,-0.35974706760175823,204,196,213,201,-12,-3,5,-20.867781096642283,24,147.04981312419582,-218.9158231058325,-167.96377154120546,-119.06169365542432,-9.975764906733591,16122,16321,Appomattox+Campbell,Appomattox,51,11,Virginia,VA
51031,51CS007,492,468,516,603,87,111,135,240.44475353473473,46,99.3091537132988,88.54645838910533,140.5537676147249,191.29140027751941,0.4093473220952537,602,573,631,767,136,165,194,297.1903909366883,105,189.14488498189613,58.132563869043935,108.2454513968843,156.53370909425192,0.6326089995046367,55584,55513,Appomattox+Campbell,Campbell,51,31,Virginia,VA
51013,51CS008,779,677,882,986,104,207,309,104.21039411495155,152,76.60421575174186,-23.362548935872574,26.07890725264635,79.99026796642312,0.7315540008825125,965,844,1086,1017,-69,52,173,22.21523777833189,75,32.07719055134275,-62.79287921868276,-9.222692218394094,39.04036366867084,1.416653470961079,238107,233811,Arlington,Arlington,51,13,Virginia,VA
51015,51CS009,602,568,635,715,80,113,147,175.85002597430363,50,77.60560829862638,46.12473243060062,97.88926450926208,151.8508283973426,0.4374558791239694,733,693,773,967,194,234,274,301.6031252728901,97,125.07091649904586,123.90118626717684,177.93727503760672,228.00726653865385,0.41292177859906376,77314,77556,Augusta+Rockbridge and Independent Cities,Augusta,51,15,Virginia,VA
51163,51CS009,220,210,230,271,41,51,61,271.3997667692503,21,111.32217166585677,109.499417346979,161.4747773004806,209.45356694490994,0.40231962678956606,267,255,278,347,69,80,92,354.923199018862,63,278.3177239795017,26.686647833484678,77.2320849774313,127.70831050949351,0.7745227233531758,22637,22636,Augusta+Rockbridge and Independent Cities,Rockbridge,51,163,Virginia,VA
51530,51CS009,69,68,69,89,20,20,21,370.62199124307284,10,181.87329493785998,176.23709157029333,188.82156666598465,201.86098614197314,0.467769894490131,84,83,85,112,27,28,29,424.3580586891586,17,257.419745608722,154.4686078293406,166.74189269966882,179.2193027259735,0.585709927821216,6598,6604,Augusta+Rockbridge and Independent Cities,Buena Vista (city),51,530,Virginia,VA
51678,51CS009,74,73,75,67,-8,-7,-6,-112.5729121626074,1,16.397922929762228,-140.1339515169952,-129.15985610584994,-117.50911657332996,-0.17050090736232804,92,91,93,72,-21,-20,-19,-265.87312535761896,14,188.2985877605918,-466.21708243166984,-454.25460155962037,-441.2439930115691,-0.7459637948990907,7318,7435,Augusta+Rockbridge and Independent Cities,Lexington (city),51,678,Virginia,VA
51790,51CS009,330,319,341,345,4,15,26,70.95271124187184,36,168.37510231126006,-147.47965561094102,-96.834529311088815,-46.677348766714935,2.226306403843439,399,385,412,423,11,24,38,95.09839077382314,43,167.4389626572174,-123.21885682737954,-69.32331254310895,-18.34074144809792,1.691433865009866,25657,25681,Augusta+Rockbridge and Independent Cities,Staunton (city),51,790,Virginia,VA
51820,51CS009,236,227,246,225,-21,-11,-2,-60.04957105902804,15,80.61987727863125,-190.77211258610367,-140.48358773631875,-88.09368805557934,-1.4745314346837144,289,277,300,317,17,28,40,126.49545140466839,28,124.38916037316748,-51.34401339705463,2.8223096739195075,54.25345501498526,0.9499857568082009,22327,22510,Augusta+Rockbridge and Independent Cities,Waynesboro (city),51,820,Virginia,VA
51019,51CS010,704,670,738,817,79,113,147,170.77977106885754,42,63.34921253409419,54.57096623163721,106.83374494871632,160.36762557176368,0.36769351922385896,869,827,910,1067,157,198,240,247.8827642498508,126,157.42128935532233,35.540164146884244,88.58534558723163,140.38465725786884,0.63187868747871,79559,80040,Bedford (county)+Bedford (city),Bedford (county),51,19,Virginia,VA
51021,51CS011,69,69,70,80,10,11,11,203.99193400309952,6,115.27377521613832,76.34057374856236,88.56299277520417,99.49992206139338,0.5164497791193673,84,83,85,98,13,14,15,223.55499547833656,7,113.1953428201811,97.6556352131211,110.71477180974559,122.23609021854102,0.47218681636846094,6246,6184,Bland+Smyth+Wythe,Bland,51,21,Virginia,VA
51173,51CS011,376,363,388,441,53,65,78,263.41923571579645,46,185.4215653342291,24.03071558773958,79.02845249158952,130.9626182317892,0.693293956819723,456,440,471,604,133,148,164,503.04265397203955,77,260.8931354611371,192.86782855903905,241.71487684627579,299.9882034825708,0.5151604050266276,29770,29514,Bland+Smyth+Wythe,Smyth,51,173,Virginia,VA
51197,51CS011,344,332,356,398,42,54,66,228.33139668571926,39,165.2892561983471,13.185629297897886,63.659864526753125,116.89586554836961,0.710708830662727,419,405,434,505,71,86,100,304.1486234665817,75,266.0329171396141,-12.161197230814256,38.85131594287664,91.8287449631131,0.8645973669495495,28314,28192,Bland+Smyth+Wythe,Wythe,51,197,Virginia,VA
51191,51CS012,540,517,563,687,124,147,170,328.39883955329435,65,144.92753623188403,133.9369198560294,185.3952667145756,234.4249428606336,0.4383395226994356,651,624,679,888,209,237,264,441.08032674768424,111,206.83872169943166,179.23489912978437,233.68475140620095,285.52339822401075,0.4669638684306751,53820,53665,Bristol (city)+Washington,Washington,51,191,Virginia,VA
51520,51CS012,232,225,240,249,9,17,24,117.22738683481745,20,139.49433304272014,-75.22874184808403,-22.322657589173023,30.867578939318147,1.1231237565744852,278,269,287,306,19,28,37,162.35757120059637,38,222.43034418169046,-110.34948028444545,-60.689936948866006,-7.119857178666896,1.3223293509258705,17205,17084,Bristol (city)+Washington,Bristol (city),51,520,Virginia,VA
51027,51CS013,254,246,263,333,70,79,87,464.64815435240143,29,171.4877051199921,239.15757295358492,292.07326969047847,340.6383429628347,0.364432059481819,306,295,316,395,79,89,100,449.3633643280523,64,322.0287813223307,79.27867814681784,125.98108021577774,174.86405079205147,0.7086977980391664,20293,19874,Buchanan+Dickenson+Russell+Tazewell,Buchanan,51,27,Virginia,VA
51051,51CS013,179,173,185,195,10,16,22,140.30506727237682,16,136.6061899679829,-50.26697278389242,4.688148072790903,54.10221475071487,0.9177874139380418,215,208,222,230,8,15,22,107.51192232556188,24,173.59855334538878,-118.6087687712361,-66.03418453158964,-14.029570568725687,1.5129047692849749,14055,13825,Buchanan+Dickenson+Russell+Tazewell,Dickenson,51,51,Virginia,VA
51167,51CS013,296,285,307,341,34,45,56,209.47830179590608,23,106.74917810868303,49.2021770160167,100.80034287597282,153.09680053790993,0.4985493754943244,360,346,373,463,90,103,117,404.45344944822716,59,230.6850172036284,125.85187226495104,174.49409978927795,226.10584587899095,0.5649013525172337,25855,25576,Buchanan+Dickenson+Russell+Tazewell,Russell,51,167,Virginia,VA
51185,51CS013,511,493,528,609,81,98,116,292.25356625467657,31,92.17960154623847,149.32938322253747,200.09691050913796,250.34987541914234,0.3122328573082656,619,599,640,790,150,171,191,426.6163967690023,94,235.08227879757916,141.70892459794095,192.45609171166154,239.63906533601536,0.5478275848945441,40356,39986,Buchanan+Dickenson+Russell+Tazewell,Tazewell,51,185,Virginia,VA
51035,51CS014,303,290,315,394,79,91,104,374.8249785200999,49,201.01189662245318,119.74639980649087,174.64364137015988,225.70020428280966,0.5304762066877489,369,354,384,530,146,161,176,552.6758016065735,70,240.88093599449414,255.73803120981535,312.42603445028493,361.38631804418816,0.433147978317782,29252,29060,Carroll+Galax (city)+Grayson,Carroll,51,35,Virginia,VA
51077,51CS014,171,165,178,214,36,43,49,335.2832612859077,29,226.76919066857815,58.76340434650209,108.56195851276647,162.62568118450878,0.6609364078125668,210,202,218,282,64,72,80,470.43421282275,41,267.1009771986971,154.7311549831017,202.65155732877915,255.8738963921404,0.5600201479644674,15346,15350,Carroll+Galax (city)+Grayson,Grayson,51,77,Virginia,VA
51640,51CS014,140,139,141,123,-18,-17,-16,-307.07474232165333,19,343.684051854085,-661.9327027184582,-650.8095915781332,-639.0208386723497,-1.1892753399688607,172,171,173,173,0,1,2,19.74846282225557,24,360.0900225056264,-353.8540483635628,-340.41735491968535,-329.00619475534825,10.361642714116696,6634,6665,Carroll+Galax (city)+Grayson,Galax (city),51,640,Virginia,VA
51036,51CS015,71,70,72,89,17,18,19,320.30442900175234,2,35.53976010661928,272.7839524548244,284.99336669652894,296.68335088701843,0.1051241077914351,86,85,86,115,29,29,30,445.3007919696873,14,211.672210462655,221.47422417475934,233.58116627448695,246.05905791858885,0.45973698397224266,6753,6614,Charles City+Goochland+Henrico+New Kent,Charles City,51,36,Virginia,VA
51075,51CS015,191,180,201,207,6,16,27,79.09238364927698,12,58.13718761354919,-30.232166169654242,19.479885845585933,71.89747965669785,0.6926276161348229,240,227,253,277,24,37,50,145.6281973155656,33,129.96219281663517,-36.708123327074965,16.086878842358573,65.60111590497061,0.86892613052533485,24769,25392,Charles City+Goochland+Henrico+New Kent,Goochland,51,75,Virginia,VA
51087,51CS015,2453,2310,2597,2929,332,476,619,170.93783475886386,275,98.81422924901186,21.63367995814554,71.22438097056443,121.857820067483,0.5768585404092537,3021,2849,3194,3588,394,567,739,169.8353346627623,364,109.09243485922879,9.49724348771039,60.13049208815761,109.43851190792691,0.6412108605117876,333960,333662,Charles City+Goochland+Henrico+New Kent,Henrico,51,87,Virginia,VA
51127,51CS015,170,160,180,178,-2,8,18,42.269672520636355,12,62.18690620141647,-69.35898290617673,-20.626847274076123,29.464548913021048,1.3105246983017824,215,202,227,245,18,30,43,127.13706846600972,20,84.10782623323101,-6.836080499310408,41.96952303457802,92.33193768522915,0.640370420773326,23156,23779,Charles City+Goochland+Henrico+New Kent,New Kent,51,127,Virginia,VA
51550,51CS016,1615,1508,1723,1810,87,195,302,93.67977778155769,138,66.44704900469863,-24.396016613382624,28.359839063106843,81.69431678913953,0.7056727597543699,2007,1878,2137,2391,254,384,513,152.7666585895222,237,94.40839398176364,6.961172076530887,60.50549358519658,109.59345795551157,0.6163835741416208,249221,251037,Chesapeake (city),Chesapeake (city),51,550,Virginia,VA
51041,51CS017,2286,2129,2443,2583,140,297,454,97.85787654308001,185,60.93510685602296,-10.373542518052679,36.958918483951926,87.55890738636437,0.6206009786739303,2851,2660,3042,3334,292,483,674,130.46284860884217,362,97.85344149472483,-19.259918394496225,34.01887738361751,86.22832186694399,0.7484974738647165,364322,369941,Chesterfield+Colonial Heights (city)+Powhatan,Chesterfield,51,41,Virginia,VA
51145,51CS017,195,182,208,245,37,50,63,196.83060889403623,10,39.468490988027895,102.58406518022585,156.91696223541257,209.62429734156356,0.19657829809477706,245,229,261,315,54,70,86,226.85268526630205,30,96.67128540585827,78.79729860193798,130.8418888633084,177.53679820052562,0.4201728114211051,30404,31033,Chesterfield+Colonial Heights (city)+Powhatan,Powhatan,51,145,Virginia,VA
51570,51CS017,229,221,236,229,-7,0,8,3.153171597471622,13,86.4792948611342,-134.16726567812512,-81.92977737146093,-32.645175036662394,8.819535556582485,280,271,290,320,30,40,49,218.2890371661212,38,208.09375171129727,-39.46559217111901,10.584600016613829,57.08895455175636,0.9299648130309579,18039,18261,Chesterfield+Colonial Heights (city)+Powhatan,Colonial Heights (city),51,570,Virginia,VA
51043,51CS018,145,139,152,153,1,8,14,61.71189123590922,10,81.26227398930045,-71.80311105450616,-19.30416621642225,34.159435826261436,1.1635805141629654,179,171,187,185,-2,6,14,40.011433226144014,19,127.79982511602879,-140.37821910118666,-89.67652166089566,-34.86682422203506,2.734403196052893,14767,14867,Clarke+Warren,Clarke,51,43,Virginia,VA
51187,51CS018,340,323,358,351,-7,11,28,32.284809871604224,29,85.46798634476998,-107.84748265682117,-52.932835082015416,-0.4809224647425199,2.4258637165147685,419,398,440,532,92,113,134,275.40904070906026,77,188.24564834734988,34.00078000341068,87.22003631244526,136.6523704500592,0.6774989420204498,40717,40904,Clarke+Warren,Warren,51,187,Virginia,VA
51045,51CS019,45,45,46,55,9,10,10,236.17495972761222,7,170.94017094017096,54.256178374727426,64.99291997656282,77.67522376882047,0.6559610941833287,55,54,56,72,16,17,18,346.92951046689564,7,143.82576535853707,189.96733328704758,203.1554436161864,215.76641839865093,0.3913881353477099,4914,4867,Craig+Franklin (county)+Roanoke (county)+Salem (city),Craig,51,45,Virginia,VA
51067,51CS019,503,480,527,618,91,115,138,251.20027561218473,41,89.83347940403155,111.15459656061829,160.08236107591262,213.28246146038987,0.35452466841145697,618,590,646,796,150,178,206,324.3777161730077,88,160.37907782030254,114.45431585233437,165.61739056268053,216.93451348314173,0.49165842026139306,54768,54870,Craig+Franklin (county)+Roanoke (county)+Salem (city),Franklin (county),51,67,Virginia,VA
51161,51CS019,888,846,929,1003,74,115,157,143.5120882971663,92,114.44565386409577,-21.140017529770784,26.762766968377015,75.3470121358471,0.790610435610052,1086,1036,1136,1352,216,266,316,274.9559048448424,113,116.94574959120735,111.641737590209,159.12210768567826,212.12903155795553,0.4237305730940481,96465,96626,Craig+Franklin (county)+Roanoke (county)+Salem (city),Roanoke (county),51,161,Virginia,VA
51775,51CS019,301,291,312,348,36,47,57,220.1592632662806,25,118.34319526627219,51.018803807380294,99.52633724557063,154.75164095273374,0.526220024463943,367,354,381,395,14,28,41,108.49736418733706,51,201.00106412328066,-140.81570010451844,-92.46615462373168,-43.11910925633217,1.7876523979009458,25350,25373,Craig+Franklin (county)+Roanoke (county)+Salem (city),Salem (city),51,775,Virginia,VA
51047,51CS020,389,366,412,406,-6,17,40,38.50517772383567,33,74.98721808782594,-91.60125664256722,-35.744915297148644,12.887306734899639,1.8389353344710873,484,457,512,557,45,73,100,135.6610736647703,56,104.73554275454477,-20.246943888295927,30.665114256560745,82.65958362792314,0.761539400508084,52809,53468,Culpeper+Madison+Rappahannock,Culpeper,51,47,Virginia,VA
51113,51CS020,133,131,134,121,-13,-12,-10,-103.18888204321014,7,61.059824089554404,-176.39181639684514,-164.0201141751543,-152.2836982025501,-0.6463679181027898,165,163,167,177,10,12,14,84.69599681061318,27,193.86802613628205,-121.01608277393849,-109.06085478701098,-96.8901958199224,2.1100984545392483,13757,13927,Culpeper+Madison+Rappahannock,Madison,51,113,Virginia,VA
51157,51CS020,59,58,59,63,4,4,5,73.51908942962694,7,114.58191242668121,-52.20470417258451,-40.81574688961991,-28.075226370665643,1.2747196119518764,73,72,74,96,22,23,24,315.8879756834978,1,13.526308670363857,289.9256429461521,301.68301742425194,314.66360685120395,0.04106169438552245,7331,7393,Culpeper+Madison+Rappahannock,Rappahannock,51,157,Virginia,VA
51143,51CS021,615,589,641,694,53,79,105,157.14239189625383,55,109.45273631840796,-2.9419897388556984,47.17354876705888,99.13650960259265,0.687809067624704,754,723,785,895,110,141,172,235.02017770523233,105,174.93585685248743,8.242658895261455,59.83773934525418,113.02892668606536,0.7391044856173974,60300,60022,Danville (city)+Pittsylvania,Pittsylvania,51,143,Virginia,VA
51590,51CS021,612,594,630,669,39,57,75,163.36340958337271,69,196.74468337887606,-80.61981210476385,-30.312677861908604,18.396900190350784,1.1836774156958414,748,726,770,890,120,142,164,336.3340533077098,109,257.9820595962226,26.5267925887069,79.36119916425744,132.27993340132696,0.7616811444967723,42085,42251,Danville (city)+Pittsylvania,Danville (city),51,590,Virginia,VA
51053,51CS022,229,217,241,277,36,48,60,204.66766988501251,18,77.05204580316057,78.64085110614467,127.6955986741592,179.03396525401735,0.36876122651374194,283,269,298,371,73,88,102,314.20505546867594,42,150.48369759942673,110.5826847765699,164.501238691294,215.688936970254,0.47353486378280973,28033,27910,Dinwiddie+Petersburg (city),Dinwiddie,51,53,Virginia,VA
51730,51CS022,489,475,503,522,19,33,47,120.52009633559065,38,138.11903680145386,-72.21595139980577,-16.29974257811392,35.636113762502305,1.1124743311605592,602,584,619,668,49,66,84,198.65663893369702,73,218.3732687187771,-72.53983758686034,-19.452960653456792,29.145710260650805,1.0829426064307912,33015,33429,Dinwiddie+Petersburg (city),Petersburg (city),51,730,Virginia,VA
51059,51CS023,4547,4053,5040,5343,303,796,1290,83.2428373928485,688,71.90842128092102,-40.13376892566727,11.883708120203295,63.51989154078736,0.8627558834379109,5720,5131,6309,6034,-275,314,903,27.52422614323098,423,37.0728731739638,-58.27680297488189,-10.359906994101074,39.95743951048491,1.3426426638956872,1148127,1140996,Fairfax (county)+Fairfax (city)+Falls Church (city),Fairfax (county),51,59,Virginia,VA
51600,51CS023,217,207,227,217,-10,0,10,0.2268655101503294,15,74.92819381426132,-129.98049028954603,-73.0810708877001,-25.86884677752529,14.34834708111854,269,256,281,233,-48,-36,-23,-146.52080406072,19,78.33436404864976,-280.3035806707758,-224.7710620798299,-176.51494186728775,-0.5501088183655939,24023,24255,Fairfax (county)+Fairfax (city)+Falls Church (city),Fairfax (city),51,600,Virginia,VA
51610,51CS023,83,82,85,84,-1,1,2,5.417524400758995,10,82.06811653672547,-88.90447236964636,-76.67839474924156,-64.33217582996274,6.02364153444611,102,101,104,99,-5,-3,-2,-23.831672826287505,3,20.666850372003307,-57.70939306215095,-44.2944424909253,-31.083929123031,-1.219806918590147,14622,14516,Fairfax (county)+Fairfax (city)+Falls Church (city),Falls Church (city),51,610,Virginia,VA
51061,51CS024,494,463,526,524,-2,30,61,49.13723135199595,23,37.917296331913725,-43.15092300906828,9.791486741476529,58.1089243000952,0.7466120308019931,615,577,653,708,55,93,131,125.82303853350635,58,78.71130592913268,-3.8489828306432647,46.980875466287436,100.15314786877165,0.6188962530532289,72790,73687,Fauquier,Fauquier,51,61,Virginia,VA
51063,51CS025,147,140,153,198,45,51,58,397.25598579626546,12,92.71779022599961,255.18032215839557,306.2022830486892,358.05714510594095,0.22894272587093825,180,172,188,213,25,33,41,212.38577684496175,15,96.44441586832123,65.52154100180894,117.52566686391431,169.61156088793945,0.44075697530555413,15531,15553,Floyd+Giles+Montgomery,Floyd,51,63,Virginia,VA
51071,51CS025,198,191,205,244,39,46,53,328.04158373208855,13,93.27354260089685,185.2587042996267,235.30800595677619,284.3828159307629,0.2782486855400976,240,231,248,300,52,60,69,362.2572332950498,31,186.85955394816153,127.11265960478968,175.59734818767078,227.67215984415557,0.5073776391006274,16725,16590,Floyd+Giles+Montgomery,Giles,51,71,Virginia,VA
51121,51CS025,554,511,597,604,7,50,93,60.46800300950641,54,65.25219773027078,-56.7394303941346,-2.6335355958654865,48.12096662811928,1.0579771520352672,683,632,734,799,65,116,167,117.46438483512557,74,75.03244646333549,-7.24157282739588,44.551713287346274,94.71004195764462,0.6333009770461379,99307,98624,Floyd+Giles+Montgomery,Montgomery,51,121,Virginia,VA
51069,51CS026,661,621,700,762,62,101,141,132.32712488299197,53,69.40503732157667,11.850736889927715,64.14260536251584,113.95705667837848,0.5193562941136968,830,782,879,1026,147,196,244,209.30719664070895,132,141.27921911122527,15.500178905021041,67.09045143716293,117.6826519628626,0.6715510133209832,91636,93432,Frederick+Winchester (city),Frederick,51,69,Virginia,VA
51840,51CS026,221,209,233,269,36,48,60,203.89304396653034,25,107.04727921498662,46.29557312343102,97.14012184890505,155.37726877707834,0.5142179059429054,274,259,288,325,37,51,66,182.87978101400947,41,145.81925525482805,-13.105660481382666,38.870551202389514,89.2753715560844,0.7821396237948022,28025,28117,Frederick+Winchester (city),Winchester (city),51,840,Virginia,VA
51177,51CS027,849,788,909,982,73,133,194,114.13232102786787,71,60.76122692036142,6.440111436320717,51.92025432367102,103.54512112947357,0.5284131146968258,1070,996,1144,1227,83,157,231,109.5823292706889,115,80.3022156428716,-21.54968291841445,28.678948500718732,81.04218538845481,0.7281626033341708,140221,143209,Fredericksburg (city)+Spotsylvania,Spotsylvania,51,177,Virginia,VA
51630,51CS027,174,162,187,202,15,28,40,117.12608677291993,1,4.252755431123081,61.55818687216909,113.60178930797278,158.92485147599294,0.03503704067282186,217,202,232,257,25,40,55,141.41169180839432,11,38.85141101260905,51.94699318241943,104.35853078825461,154.15518046916057,0.2680449551143605,28217,28313,Fredericksburg (city)+Spotsylvania,Fredericksburg (city),51,630,Virginia,VA
51079,51CS028,149,140,158,154,-4,5,14,29.870585625817036,5,29.22552362396493,-55.47448217429508,0.34028635321304174,50.60614878609299,0.8182824785708155,187,176,198,236,38,49,60,234.69022642690027,37,176.9234447472864,10.621130730781955,57.42831610121552,110.20793200740911,0.7388065754084034,20530,20913,Greene+Louisa+Orange,Greene,51,79,Virginia,VA
51109,51CS028,314,297,330,341,11,27,44,86.76650879943836,14,44.4091990483743,-13.703468752406197,43.09922930114873,97.76706586061778,0.49377243798446346,394,374,414,492,78,98,118,252.31538308490417,41,105.97327405722557,97.91142384132307,144.93123278320436,197.79614775951885,0.41574434560276713,37830,38689,Greene+Louisa+Orange,Louisa,51,109,Virginia,VA
51137,51CS028,352,336,367,379,12,27,43,89.97248465329618,12,39.38946331856228,-4.2336643772617215,51.55104447016503,100.61938374765384,0.42238473745407495,438,418,457,472,15,34,54,93.03213344721213,52,140.26758739749675,-93.85642153085159,-44.32118621006934,6.732218033408748,1.4652480149397724,36558,37072,Greene+Louisa+Orange,Orange,51,137,Virginia,VA
51083,51CS029,403,388,418,494,76,91,106,322.2661282116794,64,226.52194431335536,46.46884968495668,95.56001242784714,148.251021634339,0.6952673326823217,492,475,510,613,103,121,138,357.8846185249565,70,207.33368876251407,101.68113779107037,150.42098645465484,202.70737041666007,0.5745758167669734,33904,33762,Halifax+Mecklenburg,Halifax,51,83,Virginia,VA
51117,51CS029,393,380,406,443,37,50,63,198.66687393891772,51,201.66738063070486,-54.556177668595105,-1.975245895883805,47.617866705784806,0.9952929112385945,480,464,495,557,62,77,93,255.55628824764608,49,161.96205460434985,40.5226087947412,93.99717770207239,147.97622990715894,0.6256703655235751,30347,30254,Halifax+Mecklenburg,Mecklenburg,51,117,Virginia,VA
51650,51CS030,1105,1047,1164,1250,86,145,203,126.71461778272928,73,63.992519595882854,10.625968579038146,62.21638028845484,118.02369320042396,0.5015432548100763,1362,1291,1433,1624,191,262,333,190.03095377541933,179,130.0342883710118,9.718016013657838,59.82792811641042,112.45811842565635,0.6816736168230016,136891,137656,Hampton (city)+Poquoson (city),Hampton (city),51,650,Virginia,VA
51735,51CS030,107,105,108,110,2,3,5,32.54856779704749,4,38.60382821296445,-18.06746569121465,-5.947897695714738,6.643304976661799,0.9147929591605446,132,131,134,137,3,5,6,38.357016910199704,12,95.56422712431313,-69.07111713276026,-57.466791017865255,-44.91348215697452,2.063099693194044,12434,12557,Hampton (city)+Poquoson (city),Poquoson (city),51,735,Virginia,VA
51085,51CS031,842,794,889,955,66,113,161,123.68540682374595,75,81.90455389319645,-5.412580656034842,42.076583191678814,91.74808681842316,0.6564050024930677,1048,991,1106,1252,146,204,261,182.86628022700125,103,92.47288659053365,37.03828721869358,91.39902497984473,139.04175122450889,0.5032152583062411,109884,111384,Hanover,Hanover,51,85,Virginia,VA
51165,51CS032,641,605,677,788,111,147,183,211.08126876453113,76,109.1065703210987,48.48555736489036,103.31250867158349,154.25432002819284,0.5134018979321132,792,749,836,1018,182,226,269,267.9831742577162,145,172.00270459425155,45.431116705564534,98.4141230401379,148.98313553989016,0.6390128473660445,83588,84301,Harrisonburg (city)+Rockingham,Rockingham,51,165,Virginia,VA
51660,51CS032,261,239,283,292,9,31,53,72.01137739455709,37,85.55242976607961,-68.57151856720692,-13.855596911792174,37.482944332600425,1.1510801918966627,322,295,348,368,20,46,73,89.91477246862081,40,77.72121400536277,-40.602445962817065,12.091337158875897,64.09117865551656,0.8461035602899724,51898,51466,Harrisonburg (city)+Rockingham,Harrisonburg (city),51,660,Virginia,VA
51089,51CS033,575,553,597,732,135,157,179,370.8600020712466,76,179.8178161599432,143.22458844703027,190.6712375688601,242.84073665674373,0.4817933467890533,697,671,723,979,256,282,308,559.7249039847111,148,294.0825815681755,211.91976231583016,265.2264375209349,317.53999262632414,0.5235469574346386,50718,50326,Henry+Martinsville (city)+Patrick,Henry,51,89,Virginia,VA
51141,51CS033,221,214,229,273,44,52,59,353.4759745727673,32,218.56679378450679,86.89494270532377,135.45737074386957,187.14139255364788,0.606614045898108,270,261,279,362,83,92,101,521.8361168231188,47,267.10616049102066,204.3613198849839,255.61334418015934,307.37117328336916,0.5063439340439931,17569,17596,Henry+Martinsville (city)+Patrick,Patrick,51,141,Virginia,VA
51690,51CS033,277,271,282,261,-21,-16,-10,-141.43492972400114,31,279.93076980961695,-471.5048589877168,-423.6950815557817,-371.89509907058704,-2.1142024159841353,339,332,346,295,-51,-44,-37,-326.0814550042558,57,422.1284159075761,-792.2344132942601,-746.4945934014793,-699.7435537388963,-1.324633239226958,13289,13503,Henry+Martinsville (city)+Patrick,Martinsville (city),51,690,Virginia,VA
51149,51CS034,231,213,250,243,-7,12,30,33.02831803017671,12,33.99995277784336,-50.58105537951879,-0.47910099109985843,50.024663219364236,0.9480867504983542,289,267,311,364,53,75,97,174.15092145077261,48,111.88550383440946,11.49720743812821,62.37729239171512,113.36437880062769,0.6339773268766602,42353,42901,Hopewell (city)+Prince George,Prince George,51,149,Virginia,VA
51670,51CS034,269,259,279,273,-6,4,14,20.53212642096133,19,99.47643979057592,-128.03489528549687,-78.4338369334585,-31.712704672116978,3.860504806696014,330,319,342,426,84,96,107,413.31195646953654,62,268.22409690677046,93.49882104655421,145.33701197211084,196.3060786681616,0.6422404080935362,22920,23115,Hopewell (city)+Prince George,Hopewell (city),51,670,Virginia,VA
51095,51CS035,682,649,716,762,46,80,113,122.16022461877478,35,53.61519607843137,17.742570542363925,70.55840393909266,117.44564095604795,0.4334569593017552,846,805,887,956,69,110,151,137.8534685436864,56,70.29171059898579,17.108005141353452,67.25928824140998,118.81857056702496,0.5053006885021021,78336,79668,James City +Williamsburg (city),James City,51,95,Virginia,VA
51830,51CS035,69,68,71,84,13,15,16,114.04167453745079,4,31.172879594752562,70.54747830971928,83.22703961709087,94.69843332645837,0.25586167032871,88,86,89,84,-5,-4,-2,-22.594644964087117,3,19.26906031215878,-54.41922542078525,-41.55236344177368,-28.27453188553525,-1.191535203106241,15398,15569,James City +Williamsburg (city),Williamsburg (city),51,830,Virginia,VA
51033,51CS036,250,236,263,278,15,28,42,109.69900152730317,23,89.24529522084977,-33.08660190840861,18.55796862346327,71.43661413299237,0.7857536438872211,311,294,327,377,50,66,83,212.29891589963484,38,121.52222577550367,38.80679208294383,89.67450917665347,140.3043726072243,0.56391643285246,30926,31270,King and Queen and Nearby Counties,Caroline,51,33,Virginia,VA
51057,51CS036,111,110,112,132,20,21,22,233.19321529580446,5,56.396277845662176,164.35484460385484,176.7708583170577,189.26613940239363,0.23068559681232698,136,135,137,183,46,47,48,443.80322918875504,18,170.19667170953102,261.49551148986654,273.3644658168333,287.21347774266434,0.3754957363630364,10639,10576,King and Queen and Nearby Counties,Essex,51,57,Virginia,VA
51073,51CS036,362,345,378,417,39,55,72,172.66619459242455,13,40.46272760284277,79.58014297008783,132.08647309597848,183.13554343170085,0.23019128493640575,448,428,468,497,29,49,69,126.04759806611769,56,143.54189629097993,-68.83336831960293,-17.811520132568873,32.08521348970225,1.1160947969500559,38554,39013,King and Queen and Nearby Counties,Gloucester,51,73,Virginia,VA
51097,51CS036,74,74,75,93,18,19,19,337.7255263730078,5,90.10361916203634,235.49683928063686,247.37907791160632,258.809551583635,0.2532805872444437,91,90,92,102,10,11,12,163.17176088574018,5,75.1653638003608,74.70012276547222,88.15662188385882,100.42660900788617,0.42179194729226194,6659,6652,King and Queen and Nearby Counties,King and Queen,51,97,Virginia,VA
51101,51CS036,148,141,156,152,-4,4,11,24.27902501822855,7,47.11160964666293,-71.95483324071841,-23.620712844276735,31.97190311396641,1.5192757676911877,185,176,194,221,27,36,45,197.86892385147414,17,93.75689388925656,53.22084353532368,104.14066560262116,157.37502430622357,0.460984529935747,17830,18132,King and Queen and Nearby Counties,King William,51,101,Virginia,VA
51115,51CS036,122,118,126,119,-7,-3,1,-43.14739507904685,10,140.12143858010273,-235.44933300620647,-183.03748905796382,-132.8709810949713,-4.809343757397589,149,144,153,178,25,29,34,344.9244294818828,15,175.58234812126886,115.91129861773497,170.807439656178,220.2276508979254,0.49233768282263635,8564,8543,King and Queen and Nearby Counties,Mathews,51,115,Virginia,VA
51119,51CS036,141,137,146,162,16,21,25,233.6611269959196,4,45.155221072436504,136.15272723056395,190.08562298472015,238.04656895951194,0.18434469711861035,174,169,180,212,32,38,43,351.723318354716,24,223.0897936419409,78.66113311856559,128.69435292724222,179.85780423241704,0.6179452125717977,10630,10758,King and Queen and Nearby Counties,Middlesex,51,119,Virginia,VA
51105,51CS037,244,234,254,315,61,71,81,382.40864118570704,33,177.69002961500493,154.57250903638587,205.56243521477333,253.92158829182634,0.45820822883264567,296,285,308,412,104,116,127,525.5987449212547,53,240.9309937267024,233.70667217756562,283.5550972611886,336.69133775639335,0.45446277853733547,22286,21998,Lee+Norton (city)+Scott+Wise,Lee,51,105,Virginia,VA
51169,51CS037,277,267,286,302,16,25,35,140.64675993503297,37,206.14727458445535,-120.60126900474899,-66.66282959871154,-17.02933254115257,1.4098595281925166,337,326,348,392,44,55,66,258.0466740081653,56,261.2183972385484,-54.385471783301575,-0.6772453578564357,48.043742726626895,0.9943173701594815,21538,21438,Lee+Norton (city)+Scott+Wise,Scott,51,169,Virginia,VA
51195,51CS037,414,398,429,490,61,76,92,253.07738615154733,43,142.6005250794528,57.21253636749182,110.04912983380484,160.6967941026499,0.5561780091750288,501,483,520,659,139,158,176,442.1456233969223,73,204.4760650962158,185.1763792790565,237.5778100511105,288.75519229275534,0.45955185419694955,36185,35701,Lee+Norton (city)+Scott+Wise,Wise,51,195,Virginia,VA
51720,51CS037,43,43,43,58,15,15,15,482.8467434043169,3,96.72219236969372,373.2674068910596,386.3884519913932,398.80926841010717,0.18777818761949627,52,52,53,95,42,43,43,1170.8059465704748,13,354.4165757906216,804.7171434808306,816.7033604141816,829.6281544618533,0.2958232345221657,3722,3668,Lee+Norton (city)+Scott+Wise,Norton (city),51,720,Virginia,VA
51107,51CS038,1324,1142,1505,1543,38,219,401,62.379577780978835,162,46.06733318957039,-35.361406444363965,17.329705723835346,66.48579550573189,0.7351489584451802,1697,1477,1918,1753,-165,56,276,13.062605582589361,130,30.454664717568125,-71.89439412880601,-16.2798647934844,33.46574216765627,2.2903630403466995,421991,426864,Loudoun,Loudoun,51,107,Virginia,VA
51683,51CS039,222,204,241,251,10,29,47,80.79865906245934,45,127.17852096090438,-99.7932369769605,-45.73500551577893,5.199381646239878,1.5208221404061548,278,256,300,288,-12,10,32,22.49963393766324,27,63.21556507691228,-88.589865446473,-42.314820830267614,11.359442973759904,2.544812582367904,42460,42711,Manassas (city)+Manassas Park (city),Manassas (city),51,683,Virginia,VA
51685,51CS039,37,36,39,33,-6,-4,-3,-30.957713264004028,8,55.61670818608423,-99.1015706494578,-86.50195429302194,-74.90181240930103,-2.3168198614589226,47,44,49,49,0,2,5,13.782395073566015,5,29.37375161555634,-27.583436145915215,-15.70599098377466,-2.9132598245730223,1.4943040315773157,17261,17022,Manassas (city)+Manassas Park (city),Manassas Park (city),51,685,Virginia,VA
51700,51CS040,1376,1297,1456,1599,143,223,302,144.43425622458813,94,61.013868755273805,28.210127547386172,82.37108403772058,132.44754959817664,0.4205435908955089,1690,1594,1785,1974,189,284,380,153.8661031334521,201,108.7774175916355,-6.501444338837995,43.55415015415687,93.40327158870771,0.7044837170335232,184876,184781,Newport News (city),Newport News (city),51,700,Virginia,VA
51710,51CS041,1663,1561,1765,1896,131,233,335,117.37779722879816,123,61.963694984131244,7.265641399646982,55.903819737188606,107.2207796973698,0.5256436311882048,2030,1909,2152,2450,298,420,541,178.20829699994746,216,91.73766425713728,36.393770930410724,87.17697641736152,136.50029076061531,0.5135538222998924,238204,235454,Norfolk (city),Norfolk (city),51,710,Virginia,VA
51139,51CS042,252,242,262,319,57,67,77,339.20738102905574,36,181.97135636057288,105.64464583414183,156.78628171311271,208.33055253767745,0.528583700403617,309,297,321,358,37,49,61,205.1309792794798,53,222.78268179907525,-75.77800675319227,-18.501595914205623,38.351519857992855,1.0642429243166909,23740,23790,Page+Shenandoah,Page,51,139,Virginia,VA
51171,51CS042,431,412,450,544,94,113,132,305.806395081058,62,168.30675262979304,81.52240381427585,137.25456909104838,192.57475450085758,0.5455276679768352,534,511,557,639,82,105,128,234.9045954888709,103,230.5282005371531,-49.07745090242579,6.312617499480703,56.327530395109534,0.9721073771591371,44205,44680,Page+Shenandoah,Shenandoah,51,171,Virginia,VA
51740,51CS043,914,872,956,1065,109,151,193,186.08484198481705,85,104.61967670468532,35.26141320029951,81.0920931384456,133.72939455674978,0.5585207117717412,1116,1066,1167,1345,178,229,279,233.82193200048584,151,154.29260417305295,31.203143736978898,81.2356666229019,131.98499189555557,0.6570011443770448,97496,97866,Portsmouth (city),Portsmouth (city),51,740,Virginia,VA
51029,51CS044,146,139,153,174,21,28,35,197.36562084140718,23,163.51679601872146,-18.22861030852528,36.12481227115889,88.05622784368343,0.7996907134318159,181,173,190,223,33,42,50,246.48316452644016,21,124.05482041587901,72.22468788932773,123.36462367391896,171.65078723269409,0.49151930150084605,16879,16928,Prince Edward and Nearby Counties,Buckingham,51,29,Virginia,VA
51037,51CS044,144,140,149,161,12,17,21,171.64940616165853,13,135.06493506493504,-16.835002058925344,35.89589724514184,88.60820789332693,0.7419559697901124,176,170,182,236,54,60,66,525.7640109025546,32,279.3296089385475,193.03574462358353,246.55619839258563,295.73022141509045,0.5226066140519898,11550,11456,Prince Edward and Nearby Counties,Charlotte,51,37,Virginia,VA
51049,51CS044,83,82,84,102,18,19,20,232.5569373193516,8,98.9282769991756,121.61910134495568,133.6420777240878,145.70712837075277,0.4039158769545491,102,101,103,130,27,28,29,287.53785301783626,13,134.33915469670353,140.07736536277602,152.839099035637,165.76324541624348,0.45099680297116607,9704,9677,Prince Edward and Nearby Counties,Cumberland,51,49,Virginia,VA
51065,51CS044,209,197,221,223,2,14,26,61.548870138527576,14,61.48440931049626,-52.026592931994124,1.5405232099389163,48.82282179289339,0.9324209451076875,262,248,276,290,14,28,42,100.96517732893756,19,68.69621809241448,-22.34401607198921,34.01384133683437,83.98323049750665,0.6568723826300841,27324,27658,Prince Edward and Nearby Counties,Fluvanna,51,65,Virginia,VA
51147,51CS044,199,190,209,222,13,23,32,122.94423765194182,17,92.71462982320593,-20.322248072419054,30.755709438701942,81.16771339497446,0.7220875821153253,246,234,257,273,16,27,39,124.60363845230148,25,114.05109489051094,-41.63941935205594,12.52132792267783,60.9391846058904,0.8829829479907838,22003,21920,Prince Edward and Nearby Counties,Prince Edward,51,147,Virginia,VA
51153,51CS045,1768,1561,1975,2300,325,532,739,132.58224359454206,324,80.77786088257292,1.3404726402085858,52.937012433340136,103.0610868252597,0.6081225132866864,2242,1992,2492,2644,152,402,652,83.0986081085675,274,56.585966267329454,-25.206004108594065,26.432746688760666,78.39097761814931,0.6792615151753456,481320,484219,Prince William,Prince William,51,153,Virginia,VA
51155,51CS046,385,370,399,452,53,67,82,238.16175754961074,47,166.88365487039886,18.051359126236637,71.58810703817224,127.06027477625996,0.6904221878892022,471,454,489,580,91,109,126,322.1270149929631,60,177.7303830089754,93.60936942292318,143.59664086555114,194.4152838348625,0.5467126854597364,33796,33759,Pulaski+Radford (city),Pulaski,51,155,Virginia,VA
51750,51CS046,102,100,103,103,-0,1,3,10.58318639691789,3,21.916473882868623,-23.525590050253165,-11.286076889822274,0.9429005137018458,1.2251589670957577,126,123,128,140,12,14,17,87.74582584826186,16,97.3295212604173,-21.60186433735108,-9.682870164679835,3.8390415554359474,1.0373083298709302,16426,16439,Pulaski+Radford (city),Radford (city),51,750,Virginia,VA
51760,51CS047,1575,1477,1673,1732,59,157,255,82.89533043421822,138,72.85557789519532,-40.631838660827434,10.943986054877762,62.72712799271481,0.8733244143424653,1941,1824,2058,2299,241,358,475,157.88652969058634,224,98.84649668599468,6.265769131383943,59.28720856564027,114.23827295845172,0.6243154471824621,227299,226614,Richmond (city),Richmond (city),51,760,Virginia,VA
51770,51CS048,1042,1000,1085,1284,199,242,284,290.83939774635235,107,128.819953046933,110.09144913646676,162.4594341131279,208.0051569131238,0.4410987792017296,1269,1218,1320,1468,148,199,250,201.36632066425813,117,118.1674948491092,29.59443648364762,83.0478796517735,134.2983451577203,0.583899870120417,99674,99012,Roanoke (city),Roanoke (city),51,770,Virginia,VA
51081,51CS049,128,126,129,138,9,10,12,110.54184417503853,21,221.4022140221402,-121.8036182176969,-111.36778192428672,-98.217699151981,1.8284888085405668,157,156,159,161,2,4,5,31.932613209031555,16,139.9702563205319,-120.03623678422001,-107.61967097532056,-95.44523173998931,3.4406996372876644,11382,11431,Southampton and Nearby Counties and Independent Cities,Greensville,51,81,Virginia,VA
51093,51CS049,314,297,330,352,22,38,55,119.17411800142716,27,84.07068164716262,-17.7011441949782,34.441475548428066,81.10000882954219,0.687481902274621,390,370,411,476,65,86,106,218.5849285487643,55,140.34908645503725,26.494680611995456,79.68217806163479,126.60642063695832,0.634671076028161,38539,39188,Southampton and Nearby Counties and Independent Cities,Isle of Wight,51,93,Virginia,VA
51175,51CS049,159,151,167,194,27,35,43,234.53430399249527,33,220.82194836335248,-35.78338307249982,14.834765099868783,67.01445897651338,0.9154156677738524,195,186,204,258,54,63,72,348.8954058321291,29,161.1290143349261,137.2648327363136,187.77593770121848,236.68491412085984,0.4545868152360922,17933,17998,Southampton and Nearby Counties and Independent Cities,Southampton,51,175,Virginia,VA
51181,51CS049,69,68,69,74,5,5,6,95.46228521496961,6,110.3617412630288,-26.285585535187693,-14.762718466630934,-3.303714282401075,0.9693106178338009,85,84,86,101,15,16,17,249.3537852884477,3,45.92774035517453,190.5109753751295,203.51408268405044,216.41802777661607,0.173532888198828,6524,6532,Southampton and Nearby Counties and Independent Cities,Surry,51,181,Virginia,VA
51183,51CS049,127,123,132,125,-7,-2,2,-26.536963287035604,17,188.62690707350905,-262.62922051387227,-214.47298072410257,-158.88906250140292,-12.215769438678212,155,149,160,176,16,21,27,197.36567868945372,20,185.80453363062057,-37.30757149517695,13.02577395429513,62.832004775123195,0.8991010118828582,10815,10764,Southampton and Nearby Counties and Independent Cities,Sussex,51,183,Virginia,VA
51595,51CS049,51,50,51,110,59,59,60,1251.129189743133,21,444.7582068478644,793.9774754896932,806.3708208113321,818.3139754737067,0.34956799275224554,63,62,64,95,31,32,33,567.1275094622383,7,123.36975678533663,432.03009687383224,444.1073737792579,455.4755080563106,0.21097799978282136,5666,5674,Southampton and Nearby Counties and Independent Cities,Emporia (city),51,595,Virginia,VA
51620,51CS049,118,117,119,132,13,14,15,206.1234645350876,20,295.1666461689829,-100.61113891850735,-88.76177090315926,-75.71387162991734,1.3363104175491036,146,145,147,180,33,34,35,412.8689730291767,18,219.2448233861145,180.59415844886723,193.89858020865861,206.4621885532246,0.5158104102782209,8131,8210,Southampton and Nearby Counties and Independent Cities,Franklin (city),51,620,Virginia,VA
51179,51CS050,719,651,787,751,-36,32,100,24.49299700630841,36,27.44826446911117,-52.774661827783476,-4.417713734944707,51.28273359387896,1.0868254486233653,915,832,998,1028,30,113,196,70.52836474480287,87,54.239401496259354,-36.42762070530181,15.723371458461257,67.80428797231477,0.762305336122273,157387,160400,Stafford,Stafford,51,179,Virginia,VA
51800,51CS051,685,644,725,838,113,153,194,194.6886063250759,83,105.40686414579166,36.267129802407446,88.70282218743155,142.47560119226745,0.5379038279833388,855,805,905,1062,157,207,257,215.71062609801118,140,145.87284056098525,20.836747376986285,69.00249103407329,124.29373265682548,0.672992422758851,94491,95974,Suffolk (city),Suffolk (city),51,800,Virginia,VA
51099,51CS052,170,158,181,196,15,26,38,117.74356193313817,16,71.36750548265992,-8.605668504440835,45.65566286587744,102.92154171130272,0.5840028752209497,216,202,230,201,-29,-15,-1,-54.93075620556498,17,62.06871371718573,-172.85869751219693,-117.82734688408965,-62.66138116362399,-1.2103964668762868,26903,27389,Westmoreland and Nearby Counties,King George,51,99,Virginia,VA
51103,51CS052,189,185,194,196,2,7,11,74.08922924610766,5,55.20287054926856,-32.92015918755262,18.41215367799257,72.02771746841745,0.6484552809131195,231,226,237,241,4,10,15,87.00247227006803,17,155.60640732265446,-118.89974956343231,-68.79324258245062,-17.219397416172328,1.6182739152754455,10869,10925,Westmoreland and Nearby Counties,Lancaster,51,103,Virginia,VA
51133,51CS052,154,149,160,177,17,23,28,227.46040207034426,12,121.08980827447022,54.234522230520014,106.02201648875808,156.1534552399602,0.5097418929979887,191,185,197,245,48,54,60,449.1000997727103,28,233.3138905091242,163.8752242860504,215.37673650293547,264.49033527693143,0.510050704202463,11892,12001,Westmoreland and Nearby Counties,Northumberland,51,133,Virginia,VA
51159,51CS052,106,105,107,106,-1,-0,1,-0.9158841828998884,5,67.03161657915317,-79.03690620501892,-67.4726074039815,-55.342791948850305,5.366634100351677,131,130,132,132,-0,1,2,11.256091853177834,10,111.07408641563923,-113.35073615897767,-99.76506494933928,-87.7619010070418,4.966757616579553,8951,9003,Westmoreland and Nearby Counties,Richmond (county),51,159,Virginia,VA
51193,51CS052,214,206,221,230,9,16,24,107.01845493491291,16,104.05376110990677,-48.120099699157116,3.9398425168182927,53.78497754252532,0.9165970532270105,265,256,275,257,-18,-8,1,-44.146565613115435,28,149.7566454511419,-243.4017414688523,-194.0963092483589,-143.28018775003562,-3.859894980727151,18452,18697,Westmoreland and Nearby Counties,Westmoreland,51,193,Virginia,VA
51199,51CS053,401,371,431,453,22,52,82,89.66367480549688,21,35.997942974687156,2.369950435677843,52.33320869256812,108.14066046979768,0.39394599483665316,504,467,540,628,88,124,161,175.28940206426557,63,88.97802384046099,32.97304339882066,87.29348604389575,134.5630576503041,0.5035491895812625,70004,70804,York,York,51,199,Virginia,VA
53001,53CS001,110,108,112,110,-2,0,2,1.3203816494246012,18,105.30421216848674,-116.17211131279271,-103.98950601977661,-92.09058902368675,14.685518953937352,136,133,138,155,17,19,22,93.78627287429413,18,87.29812309035356,-6.950946598216445,6.669217930661275,19.049484894151647,0.8850518458701987,20512,20619,Adams+Grant,Adams,53,1,Washington,WA
53025,53CS001,614,571,657,710,53,96,139,115.83494660490395,82,99.13658482525162,-31.684603287330113,15.546521381265917,66.38409634940372,0.8470032181815813,763,712,815,912,97,149,200,148.36304710752952,120,119.80711055201127,-20.115616229973643,28.487787433147105,80.07200708876094,0.8021287876997517,99257,100161,Adams+Grant,Grant,53,25,Washington,WA
53003,53CS002,217,208,227,266,39,49,58,260.47732640966535,22,118.0732590902992,91.00673585542187,140.94637751519068,196.39136001438277,0.444144419565747,266,255,278,290,12,24,35,106.01462290206703,29,129.57419239533533,-75.65597574333374,-22.31371284739775,28.650653289801234,1.1728007566098664,22359,22381,Asotin+Columbia+Garfield+Whitman,Asotin,53,3,Washington,WA
53013,53CS002,48,47,48,52,4,4,5,132.05799803433547,3,90.70294784580499,29.464792962957198,41.18047888781877,53.41899137007554,0.5588862813019057,59,59,60,74,14,15,15,371.4018273699727,1,24.826216484607745,333.52986560510874,346.54146521967425,359.51025087806147,0.06265638404362718,3969,4028,Asotin+Columbia+Garfield+Whitman,Columbia,53,13,Washington,WA
53023,53CS002,24,23,25,24,-1,0,1,7.532182503656001,5,261.55187445510023,-306.0359614334402,-253.83103673072873,-202.38651758761048,4.370666726859662,30,28,31,32,1,2,4,100.8211099231112,5,213.85799828913602,-164.74445051693846,-112.26984785614727,-56.59549714607642,1.4893374386015845,2294,2338,Asotin+Columbia+Garfield+Whitman,Garfield,53,23,Washington,WA
53075,53CS002,230,209,250,270,20,40,61,100.0655850031615,25,62.3208276205908,-12.008446042387627,38.62797175457829,91.5070712704961,0.6076617480095332,285,261,310,396,86,111,135,231.32689089844803,44,91.9348098620978,86.47143367774096,138.41843946447867,187.6144845371733,0.39386624934421677,48138,47860,Asotin+Columbia+Garfield+Whitman,Whitman,53,75,Washington,WA
53005,53CS003,1299,1210,1388,1520,132,221,310,128.2664739813256,149,86.34552698297719,-7.691172846109734,42.38515674424499,93.82584818377204,0.6701453230826799,1618,1510,1726,1904,178,286,394,136.54022137724021,227,108.29274343206897,-21.144679607914206,29.71147817169899,82.97971241206811,0.790358281187567,207075,209617,Benton,Benton,53,5,Washington,WA
53007,53CS004,616,582,650,653,3,37,71,55.61739955572842,40,60.819543346595374,-57.1186069181328,-6.423447689086569,49.208009939685184,1.0644345691989932,763,722,804,832,28,69,110,86.75773510183764,73,91.73274356300028,-55.95438350816401,-7.253296485161633,45.69924295905128,1.0422476064298776,78922,79579,Chelan+Kittitas,Chelan,53,7,Washington,WA
53037,53CS004,268,249,288,302,14,34,53,89.24578754000883,29,77.0593445527015,-34.343064879809184,11.161355447490122,64.91145057716568,0.8384855690827409,335,312,359,384,25,49,72,107.45690315157046,30,66.12881893929374,-12.171302808738805,41.53863169786992,92.89812238503109,0.6030284246232844,45160,45366,Chelan+Kittitas,Kittitas,53,37,Washington,WA
53009,53CS005,895,861,928,917,-11,22,56,34.52815530717079,6,9.301965040114725,-26.343415923584924,25.286994040149903,76.2406395017908,0.2578258373032843,1105,1065,1145,1255,110,150,190,191.98273348470633,75,96.06270973691626,47.43950541249077,93.52278615510622,148.6708770586579,0.497055445723761,77403,78074,Clallam+Jefferson,Clallam,53,9,Washington,WA
53031,53CS005,347,333,361,350,-11,3,17,10.058972902486495,3,10.907768755302389,-50.955802910689854,-0.26852608017110075,47.01976996160621,0.7964842447826027,432,415,449,448,-1,16,33,47.454920270610025,18,53.6928767450185,-56.216713430233426,-6.734340155787906,45.99579668477395,1.0645352323647514,33004,33524,Clallam+Jefferson,Jefferson,53,31,Washington,WA
53011,53CS006,3225,3008,3442,3577,135,352,569,83.99240971603244,137,32.659029009720236,1.7380120480914307,49.68520424160533,103.7715750585225,0.3877326376419608,4033,3769,4296,4646,350,613,877,120.14655411853846,409,80.12192637402246,-8.840457328736791,38.85086740190132,93.58584188217544,0.6657827353725557,503383,510472,Clark,Clark,53,11,Washington,WA
53015,53CS007,1055,1007,1103,1084,-19,29,77,31.2641845698648,25,27.049446387997257,-45.396314198922475,4.107043620056525,55.809072785584505,0.8362490125496104,1300,1242,1358,1588,230,288,346,258.4649464599244,229,205.49912057144908,4.348308627156816,51.736693090710844,107.30233510508646,0.792324492490099,110908,111436,Cowlitz+Klickitat+Skamania+Wahkiakum,Cowlitz,53,15,Washington,WA
53039,53CS007,183,173,193,177,-16,-6,4,-30.62393345415736,5,26.353933324548688,-108.72362225009431,-56.003761851386486,-5.991063471688707,-1.0394738587529302,228,216,240,296,56,68,80,295.38109934679824,26,112.70536217434653,134.43680918099625,183.12853321801367,232.69767304722632,0.3760406247689649,22767,23069,Cowlitz+Klickitat+Skamania+Wahkiakum,Klickitat,53,39,Washington,WA
53059,53CS007,82,81,83,86,3,4,5,37.27219511361005,7,69.66907190843493,-44.10467966459237,-32.296573105404214,-20.85176969434681,1.47526078164627,102,101,104,105,1,3,4,22.349286550277295,2,16.46090534979424,-6.396529508533619,6.4499450604818955,19.43650360007295,0.5382944971696486,12057,12150,Cowlitz+Klickitat+Skamania+Wahkiakum,Skamania,53,59,Washington,WA
53069,53CS007,43,43,44,41,-3,-2,-2,-64.74332426320197,2,53.884149079479116,-130.83913545963384,-118.6812680197853,-107.05233117769488,-1.4254594616228895,55,54,55,68,13,13,14,293.3510533996224,2,43.84042086804033,237.27510616063566,249.07712217028325,261.6823034113504,0.13905619032622446,4454,4562,Cowlitz+Klickitat+Skamania+Wahkiakum,Wahkiakum,53,69,Washington,WA
53017,53CS008,267,249,286,283,-3,16,34,44.12810265600867,13,36.1881785283474,-44.63238989174152,7.2845663386855755,62.509748958125215,0.7714087248767927,333,311,356,387,31,54,76,122.9209642647803,42,96.3435335137863,-26.779220731329758,24.67960037453901,77.15690760094724,0.7694257304148365,43108,43594,Douglas+Okanogan,Douglas,53,17,Washington,WA
53047,53CS008,385,366,403,413,10,28,47,80.88102784215147,33,93.80996375524128,-65.88582460947528,-12.613407754650778,41.99963601895162,1.1204701085989819,474,452,496,563,67,89,111,208.37940612412513,76,178.57562442726567,-26.580779352964505,31.480331000966302,85.38364397247264,0.8474180206036152,42213,42559,Douglas+Okanogan,Okanogan,53,47,Washington,WA
53019,53CS009,67,67,68,85,17,18,18,292.40161747057886,6,99.15989533122158,180.9690783189054,193.59927536951258,205.81340780991965,0.3209803246329005,83,82,83,133,50,50,51,695.0488136234719,12,165.31202644992422,516.8395633827578,529.8745439442195,542.0570513405868,0.23321986301637018,7261,7259,Ferry+Lincoln+Pend Oreille+Stevens,Ferry,53,19,Washington,WA
53043,53CS009,100,99,101,102,1,2,3,18.0907722650693,9,98.5851209493382,-92.13661025714676,-80.39691459645032,-67.12226764691954,3.394258063881585,126,124,127,144,17,18,20,163.55895306852582,20,178.79492222420882,-27.473981348734554,-15.307648319580913,-2.5759268671517956,1.036500118982997,10955,11186,Ferry+Lincoln+Pend Oreille+Stevens,Lincoln,53,43,Washington,WA
53051,53CS009,141,135,146,144,-2,3,9,29.609794129872583,5,44.24778761061946,-65.72181305241679,-15.136543914480654,36.05805279357826,1.1505078923586718,175,168,182,236,54,61,68,442.9728304559935,23,166.3412164605482,224.10080193437568,277.38189707016267,325.59009213070703,0.36947878256505534,13560,13827,Ferry+Lincoln+Pend Oreille+Stevens,Pend Oreille,53,51,Washington,WA
53065,53CS009,408,388,428,432,4,24,44,61.9103642182561,21,54.13999054698577,-44.45338522463928,7.651884103503584,60.269173306673075,0.8395299156051185,506,481,530,631,101,125,150,265.0360604536644,101,213.52614109638276,-2.2921325598418836,52.341050155337506,106.1416502214732,0.7992738038463321,46546,47301,Ferry+Lincoln+Pend Oreille+Stevens,Stevens,53,65,Washington,WA
53021,53CS010,366,324,408,454,46,88,130,109.1152543163937,69,85.39427817082982,-24.839997835369577,23.338641590929836,80.52884275778892,0.773829368221861,466,416,517,554,37,88,138,89.55015983698009,95,96.84588252084735,-57.51329025297205,-8.090486570068114,44.303311209814396,1.069298009730607,96962,98094,Franklin,Franklin,53,21,Washington,WA
53027,53CS011,756,723,788,800,12,44,77,70.39466990654749,28,44.323083620246145,-27.248382060853043,26.17020473997435,78.27653516788128,0.6157896446392797,935,895,974,1133,159,198,238,258.6468991920095,116,151.2563403789232,56.06242192214946,109.24887251724645,160.21723244483059,0.5818651878886772,75807,76691,Grays Harbor+Pacific,Grays Harbor,53,27,Washington,WA
53049,53CS011,298,288,308,268,-40,-30,-20,-153.90706164440283,4,20.529489756640007,-221.64839139377005,-175.04013462193953,-122.36126794093184,-0.13799047315312116,370,357,382,413,31,43,56,180.91347262859824,30,125.6386632046235,3.892184245448021,53.883428843558065,106.68890023063551,0.6787557746877968,23381,23878,Grays Harbor+Pacific,Pacific,53,49,Washington,WA
53029,53CS012,689,651,726,704,-22,15,53,21.2705644295313,30,41.49186298464801,-73.83525119147825,-19.822323635206608,29.08881308586402,1.8315770736087857,851,806,896,907,11,56,101,63.88296650168637,41,46.9316972104257,-35.510404991501765,16.318103621180068,62.013657577356284,0.7217191910341784,86764,87361,Island,Island,53,29,Washington,WA
53033,53CS013,11600,10625,12576,12136,-440,536,1511,28.35390346774233,973,51.50150984642175,-72.19305527158376,-22.11623965032131,26.2382640211905,1.8129971702034648,14326,13162,15491,15083,-408,757,1921,33.55270599256657,734,32.54613658735578,-48.91589914648764,1.0034323085097383,55.12129267277225,0.9687201616947794,2267118,2255260,King,King,53,33,Washington,WA
53035,53CS014,1972,1854,2091,2012,-79,40,158,17.357633082516365,41,17.88895756826528,-54.05652524680268,0.15557356886349086,49.05691748225749,1.0053393682792797,2423,2281,2565,2649,84,226,368,82.4093193131754,192,69.94280718370915,-33.35754004894909,11.231466005589272,63.37942722951386,0.8449892617383803,275030,274510,Kitsap,Kitsap,53,35,Washington,WA
53041,53CS015,816,781,852,863,11,47,82,68.11069079201397,31,45.14508319073797,-32.116326403637046,23.739807348067153,70.76802951075193,0.6489440928144367,1016,973,1060,1132,72,116,159,137.36114615292556,145,172.3789483695329,-84.86123629761514,-34.70982546578971,15.944524677656261,1.2441644898291513,82401,84117,Lewis,Lewis,53,41,Washington,WA
53045,53CS016,604,576,633,623,-10,19,47,33.63421577007899,13,23.520188161505292,-41.76173864206034,10.101493906799794,63.185081750685256,0.663597388322157,751,716,786,875,89,124,159,184.31762287146051,75,111.30238632316278,23.877744316656642,72.66700563243977,124.35175021945923,0.5990387249747711,66326,67384,Mason,Mason,53,45,Washington,WA
53053,53CS017,6022,5625,6418,6198,-220,176,573,22.961035808403132,304,39.62491025196794,-68.98690511653669,-18.478371792529156,39.213946757627994,1.7160043572094787,7454,6976,7932,8226,294,772,1250,83.41344664399818,627,67.76268577999498,-39.02350441829604,13.100300784836774,70.15519097594145,0.8113200632020018,920633,925288,Pierce,Pierce,53,53,Washington,WA
53055,53CS018,131,130,133,124,-9,-7,-6,-49.27643082847045,7,47.11953777977225,-107.88127507484316,-96.2913563007581,-84.23015779281145,-1.1075205582054601,167,164,169,159,-10,-8,-5,-41.21062392951219,7,37.94243590438506,-92.21161479402608,-79.26911644733033,-67.06123875101882,-1.0601325333347762,17827,18449,San Juan+Skagit,San Juan,53,55,Washington,WA
53057,53CS018,1063,1007,1119,1128,9,65,121,59.87367437561861,43,39.74060781565287,-36.50459842476469,19.740165692145375,75.02785830546526,0.6536512683210278,1305,1237,1372,1535,163,230,298,176.27054254228653,96,73.52209109080744,50.46511368616911,102.97779365226467,153.422005420282,0.41529364618520065,129842,130573,San Juan+Skagit,Skagit,53,57,Washington,WA
53061,53CS019,4825,4468,5182,5226,44,401,758,58.065057716274566,366,52.99477171343729,-44.42420355791676,6.681747462541772,56.800820460304266,0.910408972600783,5994,5564,6424,6384,-40,390,820,46.81845738816822,348,41.78042227040577,-43.09968710397438,3.5270578298833604,56.800382513970696,0.8901095681328818,828761,832926,Snohomish,Snohomish,53,61,Washington,WA
53063,53CS020,4176,3944,4408,4498,90,322,554,71.80854824278254,289,64.3935806952947,-44.679572335873765,7.214410781688226,59.80145479149143,0.8939658734058079,5174,4893,5456,5866,410,692,973,126.87188895347828,641,117.5583802986093,-44.40369106873787,8.264487751353448,60.540868387861465,0.9252537437740613,538563,545261,Spokane,Spokane,53,63,Washington,WA
53067,53CS021,2063,1935,2190,2101,-89,38,166,15.636698466209355,57,23.180311646412132,-59.128634305659794,-6.3069142855523594,45.21453386470471,1.4448529691071534,2560,2406,2714,2910,196,350,504,117.59549479503876,201,67.52920386092343,0.5917371285745912,49.9273991691475,99.02111953696725,0.5726139852573177,295078,297649,Thurston,Thurston,53,67,Washington,WA
53071,53CS022,508,481,535,541,6,33,60,62.98603718682418,37,71.19377856169325,-59.40879158642632,-7.750116492348319,45.918863139392776,1.096804290233324,624,591,656,711,55,87,120,139.1866807502189,63,100.53298439345099,-9.665951379885634,37.59646849056035,88.72393149638403,0.7141017208852473,62365,62666,Walla Walla,Walla Walla,53,71,Washington,WA
53073,53CS023,1489,1391,1587,1570,-17,81,179,42.51316185965414,56,29.517312870339047,-41.69805762155767,13.831536142901413,59.301744854920784,0.6858070818188429,1845,1727,1963,2082,119,237,355,103.87510016266192,129,56.428471444568864,1.106022101126471,48.52158439849677,98.34650061370023,0.5409558310062867,227663,228608,Whatcom,Whatcom,53,73,Washington,WA
53077,53CS024,1765,1655,1875,2127,252,362,472,169.97017068675225,303,142.16730855701746,-20.70576919476444,26.462874367586764,75.10569749084684,0.8341224729150863,2176,2043,2308,2537,229,361,494,141.07856680108563,308,120.26176456807285,-26.99551101888999,20.412388942630656,72.56360280524154,0.8500925400706768,255755,256108,Yakima,Yakima,53,77,Washington,WA
54001,54CS001,155,149,162,211,49,56,62,428.3876179564918,12,92.34913102032964,284.14410068373667,335.00414530683145,391.327591933907,0.2117694356033506,189,181,197,266,69,77,85,495.9456447450047,35,226.33212622866012,219.1053495271065,270.21679660401566,320.6823220428839,0.4504908351659628,15593,15464,Barbour+Pocahontas+Randolph+Tucker,Barbour,54,1,West Virginia,WV
54075,54CS001,84,83,85,99,14,15,16,228.95460598712663,3,45.51776457200658,171.94960812969111,183.37068803153701,194.79935421889667,0.18645102085127158,102,101,103,136,33,34,35,428.0923349999608,14,178.52588625350674,237.14495098064594,249.71421070785615,262.1653101762447,0.4049636872292041,7909,7842,Barbour+Pocahontas+Randolph+Tucker,Pocahontas,54,75,West Virginia,WV
54083,54CS001,300,288,312,323,11,23,35,97.54465895415751,4,17.163698777086463,29.034358194010192,79.57748285283007,131.44577432812247,0.16854323569589738,366,351,380,472,92,106,121,382.3001516027439,55,197.7492539459965,136.74910844276673,184.32707525254153,242.08263287023394,0.5124423749492979,27966,27813,Barbour+Pocahontas+Randolph+Tucker,Randolph,54,83,West Virginia,WV
54093,54CS001,76,76,77,101,24,25,25,438.2422575307976,4,70.96392667060911,355.5395143754061,367.3700311171403,379.6799939812109,0.15562836650608702,93,92,94,115,21,22,23,332.90124193463663,24,359.0664272890485,-38.90690582955364,-26.29930095111372,-14.101593780595824,1.0322083848410677,6764,6684,Barbour+Pocahontas+Randolph+Tucker,Tucker,54,93,West Virginia,WV
54003,54CS002,958,905,1011,1158,147,200,253,196.04955377769954,65,63.63814372429997,83.36195772026834,131.03262120137987,183.3187880076578,0.32298936820458696,1204,1139,1269,1515,246,311,376,247.73562910876024,186,148.1233724347182,47.98548652172464,97.78472107666065,156.41084198173436,0.595993182384051,122568,125571,Berkeley+Morgan,Berkeley,54,3,West Virginia,WV
54065,54CS002,186,179,194,203,9,17,24,115.59779397746966,4,27.94271742926999,34.17044919756265,87.4142248042081,141.9924396587291,0.22794848823508018,229,220,237,281,44,52,61,305.08376881881077,48,279.16715133185994,-24.823510617030315,25.114786339769847,75.75203704309534,0.8979330163816812,17178,17194,Berkeley+Morgan,Morgan,54,65,West Virginia,WV
54005,54CS003,273,263,282,298,16,25,35,139.87583757420455,14,77.70942226744994,7.468207003355443,60.41458512262498,112.6512521721011,0.5343552695475715,331,320,342,396,54,65,76,304.56722577643984,35,163.77333770062233,85.65320827832142,142.18527193887027,190.57490132767091,0.52958839232677,21619,21371,Boone+Lincoln+Logan,Boone,54,5,West Virginia,WV
54043,54CS003,242,233,251,271,20,29,38,170.87973819734154,11,64.92228998622859,53.54848487787433,107.48124899992793,156.27504841306998,0.36724540083598106,295,285,306,378,72,83,93,410.7970921504881,46,228.20856278216004,131.45411752441188,183.8565199736449,237.93266332531113,0.5488973913201096,20332,20157,Boone+Lincoln+Logan,Lincoln,54,43,West Virginia,WV
54045,54CS003,467,453,481,518,37,51,65,190.16671008912914,56,207.76651001731386,-65.24854831808162,-17.82943676825732,34.948657292218975,1.0716417941232317,565,548,581,700,119,135,152,422.1807987724309,77,240.69269482041824,128.37351365273827,181.91745997781157,235.04211151937318,0.5659273820815229,32344,31991,Boone+Lincoln+Logan,Logan,54,45,West Virginia,WV
54007,54CS004,138,132,143,153,10,15,21,145.349920173252,4,38.12246842983083,54.681815287317974,107.11731395044055,159.88757578969367,0.24614111688376075,165,158,171,209,38,44,51,360.601275545172,22,179.3429526371566,131.93118915106734,180.2723066859082,236.67800973313814,0.4863495124913784,12591,12267,Braxton+Gilmer+Lewis+Upshur,Braxton,54,7,West Virginia,WV
54021,54CS004,69,68,70,80,10,11,12,177.07634220970073,1,16.103059581320448,148.36575956258443,160.89375660708018,173.18648316831545,0.08335805697721602,84,83,85,90,5,6,7,82.28931262697765,13,176.2233970448692,-106.70556337096198,-94.38881407392498,-81.60286527317525,1.8386298007160322,7452,7377,Braxton+Gilmer+Lewis+Upshur,Gilmer,54,21,West Virginia,WV
54041,54CS004,209,202,217,214,-3,5,12,32.94204767351364,5,35.64638783269962,-54.51673374590619,-3.7419893752882225,45.102289616017174,0.8895734697855469,255,246,264,344,80,89,98,527.1787233281274,59,348.9266071322964,124.05565730527567,178.86398184051794,228.8396427030117,0.654532664071158,16832,16909,Braxton+Gilmer+Lewis+Upshur,Lewis,54,41,West Virginia,WV
54097,54CS004,224,213,234,255,21,31,42,157.67537565855605,8,40.23301621893466,66.82989138016201,115.91503895497254,168.37212379764668,0.24727659993896164,273,260,285,345,60,72,85,303.65356101975294,61,256.4102564102564,-2.794253852926689,48.095185039321336,95.43444587444316,0.8328875090554888,23861,23790,Braxton+Gilmer+Lewis+Upshur,Upshur,54,97,West Virginia,WV
54009,54CS005,275,266,285,350,65,75,84,400.76635293920674,37,198.61328561842987,152.65955032655123,202.43530797194083,255.21067770596255,0.48903354285933626,333,321,344,427,83,94,106,424.8208514995632,57,256.89561925365064,118.34720465988954,166.9339040602535,218.32838739698212,0.598367084376927,22355,22188,Brooke+Hancock,Brooke,54,9,West Virginia,WV
54029,54CS005,362,350,374,452,78,90,102,373.1220110954254,63,261.1038198521793,57.677565428643405,113.61788610132609,164.39358879784788,0.6920938081153001,437,423,452,522,70,85,99,294.88411101695567,84,292.59117349959945,-48.560751081821074,4.449059560595648,53.91817511577357,0.9806407571707416,28954,28709,Brooke+Hancock,Hancock,54,29,West Virginia,WV
54011,54CS006,1100,1059,1140,1171,31,71,112,91.42712319149041,95,121.61945911345815,-79.89738133772181,-31.337887446491003,23.775863753036763,1.3118645710685084,1341,1293,1389,1559,170,218,266,233.0933476333692,154,164.66537643146606,18.131622960917632,67.30052629103987,121.34947855768725,0.7032095394126054,93735,93523,Cabell,Cabell,54,11,West Virginia,WV
54015,54CS007,96,95,96,112,16,16,17,245.07610409054814,6,89.25251022685013,143.87518502282373,156.01172982738714,168.18414460454136,0.3433429024829183,115,114,116,155,39,40,41,504.82852619539,20,252.87646984448097,239.94831283417733,251.8661811779981,263.54904303143684,0.4886762935201013,8067,7909,Clay+Fayette+Nicholas+Webster,Clay,54,15,West Virginia,WV
54019,54CS007,518,500,535,574,39,56,74,165.8113485676776,39,115.19999999999999,-0.4171842720544,50.896680655563976,104.27912864567126,0.6826052029868441,627,607,648,787,139,160,180,399.16772663511136,82,205.05126281570395,141.3044776532712,195.03959974256477,246.66102349134343,0.5104989275385923,40625,39990,Clay+Fayette+Nicholas+Webster,Fayette,54,19,West Virginia,WV
54067,54CS007,284,274,295,291,-4,7,17,33.52660127244909,4,19.587039908593816,-40.76452324406673,15.062397050074624,67.9100111610934,0.5097690381993577,347,334,359,427,68,80,93,329.1598791705672,70,287.6751736325155,-6.052891305831908,42.7634942617011,95.40243222857103,0.8631907584621027,24506,24333,Clay+Fayette+Nicholas+Webster,Nicholas,54,67,West Virginia,WV
54101,54CS007,105,104,106,103,-3,-2,-1,-26.720043104551333,8,115.67658754066755,-154.18247996993946,-142.41840022616694,-129.6336569978739,-9.434923027418565,128,127,129,151,22,23,24,276.4706530340205,26,314.7318726546423,-51.466288227016335,-38.35424617395837,-25.96530700353658,1.0906387659255732,8299,8261,Clay+Fayette+Nicholas+Webster,Webster,54,101,West Virginia,WV
54025,54CS008,408,394,422,472,50,64,78,231.48985137571935,41,148.65395655195334,31.19764960622267,82.49966190363638,133.02421024392837,0.6322591241875167,495,478,512,641,129,146,163,447.03375931901456,78,238.92666789193163,153.24018543471763,206.70936017716988,258.1966304604543,0.5308338190243815,33097,32646,Greenbrier+Monroe+Summers,Greenbrier,54,25,West Virginia,WV
54063,54CS008,148,142,153,183,30,35,41,339.69110915727384,16,153.95718065912914,132.6771006411435,186.04085207800816,235.17148198000888,0.4407422278599887,180,174,186,227,41,47,53,381.37450559964867,18,145.96172559195588,186.57423095117997,234.94592354963376,287.04517980214945,0.3747571571236769,12471,12332,Greenbrier+Monroe+Summers,Monroe,54,63,West Virginia,WV
54089,54CS008,163,158,168,187,19,24,29,242.74702703128827,10,99.95835068721365,90.56973331396988,144.23671330477768,193.6866953471998,0.39549425790573034,198,192,204,255,51,57,63,478.07987764603865,23,193.1312452766815,235.81998460697014,286.31782724483986,336.9956837314315,0.39699983682167317,12005,11909,Greenbrier+Monroe+Summers,Summers,54,89,West Virginia,WV
54023,54CS009,129,125,134,143,9,14,18,148.93737372224894,22,239.23878568192112,-139.86059325877878,-90.61979487363989,-40.89880963944341,1.4970026612735436,158,152,164,176,12,18,24,164.0576941883273,27,245.92403679752255,-132.62978968477643,-81.27069882926648,-28.765103494625667,1.420163590863181,11035,10979,Hardy and Nearby Counties,Grant,54,23,West Virginia,WV
54027,54CS009,238,228,247,268,21,30,40,158.25496697578544,23,119.41331718080735,-15.895605242964878,36.92905590451656,93.1448463562047,0.7305941774872707,294,282,306,349,43,55,67,237.7985422026478,46,197.69640708268867,-11.626439463794291,38.982923467861355,89.28140870676026,0.8166023813644162,23113,23268,Hardy and Nearby Counties,Hampshire,54,27,West Virginia,WV
54031,54CS009,150,144,157,171,14,21,27,173.98656377964267,9,76.21198221720415,45.10925205201616,95.84624437909459,146.30980995065508,0.4177039009809329,184,177,192,207,15,23,30,159.8577248990917,36,254.0220152413209,-144.11036323901493,-95.22630987981215,-43.237382178838956,1.5218746157921124,14171,14172,Hardy and Nearby Counties,Hardy,54,31,West Virginia,WV
54057,54CS009,287,276,299,353,54,66,77,294.2923109129783,70,312.51162617656905,-68.07258724228207,-18.00281588578247,32.178259516050964,1.0460403417684867,352,338,366,429,63,77,91,286.5730355508684,69,256.88756515264333,-18.076579556076755,29.73719867035297,79.70062397326235,0.8849158322715763,26879,26860,Hardy and Nearby Counties,Mineral,54,57,West Virginia,WV
54071,54CS009,73,73,74,100,26,27,27,508.4875583444706,0,0,495.90568770785154,508.5042383257275,521.3451463637797,0,89,88,89,114,25,25,26,413.55110218829725,10,162.83992835043153,237.85075820974217,250.79509618158605,262.6094183152338,0.37884279398263,6255,6141,Hardy and Nearby Counties,Pendleton,54,71,West Virginia,WV
54033,54CS010,715,686,743,724,-19,9,38,17.144695868437335,27,49.138558602281,-89.03322660371997,-31.687371405186582,15.798768337945901,2.591061689955759,865,831,898,1082,184,217,251,333.3106847006857,149,228.36298986926604,57.16105261798388,104.77704691158624,157.49174970938415,0.6819995344615352,65936,65247,Harrison+Taylor,Harrison,54,33,West Virginia,WV
54091,54CS010,172,165,179,209,30,37,44,264.95072148765973,10,71.94244604316546,141.91002807687815,193.0653637876657,244.3997170073095,0.264353396192716,208,200,217,257,40,49,57,294.0851521526816,35,211.8387604406246,28.807971218068914,80.78187451028751,133.4172257360061,0.7058052646956339,16680,16522,Harrison+Taylor,Taylor,54,91,West Virginia,WV
54013,54CS011,70,69,71,86,15,16,17,301.2203089312166,3,56.91699604743082,232.42883713046052,244.1326761070599,256.81708538409185,0.1777586014440827,84,83,85,125,40,41,42,660.3888889086567,5,80.9192425958893,567.2418182744444,579.4610703519616,593.0728261873271,0.11960168969196815,6325,6179,Jackson and Nearby Counties,Calhoun,54,13,West Virginia,WV
54035,54CS011,305,293,317,347,30,42,54,179.7439876658822,28,120.55974165769643,7.355190064585202,58.77951321740775,111.45645708618774,0.6550390814168655,375,360,389,452,63,77,92,278.88025536827917,62,223.52008075564208,2.6704725312271957,55.84620371946764,103.74768673518811,0.7912623680504904,27870,27738,Jackson and Nearby Counties,Jackson,54,35,West Virginia,WV
54053,54CS011,297,286,308,332,24,35,46,163.99573726308537,22,103.47665895817818,12.54486604588264,60.393168791419804,113.89710684623869,0.6133795869234228,362,349,375,483,108,121,134,482.07983892647866,54,214.40482807909157,213.5892073716628,267.95252973374096,317.50402618804185,0.4411165442136738,25513,25186,Jackson and Nearby Counties,Mason,54,53,West Virginia,WV
54087,54CS011,180,174,186,170,-16,-10,-4,-89.27359749872296,5,43.10035198620788,-185.8681433286654,-132.44346519371766,-81.88962300624648,-0.5343889292278236,221,213,228,228,0,7,15,52.78485262059381,22,158.15959741193387,-158.6764054793233,-103.86523415212416,-52.642220303690934,2.637139336883366,13921,13910,Jackson and Nearby Counties,Roane,54,87,West Virginia,WV
54105,54CS011,48,48,49,53,4,5,5,110.15493343832296,7,159.7565614302016,-61.49519540372647,-49.32996462030367,-37.77634226636757,1.201382207360073,57,57,58,86,28,29,29,564.4751952167167,13,255.90551181102362,295.3066301050639,308.22505892715583,320.88969094355076,0.43807417324809506,5258,5080,Jackson and Nearby Counties,Wirt,54,105,West Virginia,WV
54037,54CS012,430,405,455,505,50,75,100,155.69501655223004,36,74.81555886529735,31.329919280042475,82.61609996929366,131.9534008866701,0.47419679824749283,534,504,564,604,40,70,100,119.50147265336899,66,113.25222643581516,-45.365999920769454,6.974583249620054,58.44889935434541,0.9342900604593868,57742,58277,Jefferson,Jefferson,54,37,West Virginia,WV
54039,54CS013,2135,2058,2213,2484,271,349,426,233.00867903004453,189,126.28906162995301,53.05200843072728,105.60135805863868,156.4151509640486,0.5404431292711486,2589,2497,2681,3092,411,503,595,282.3822012757456,303,169.97834599288672,62.84263672135322,110.51495003926814,161.70230713601222,0.6007508024715537,179588,178258,Kanawha,Kanawha,54,39,West Virginia,WV
54047,54CS014,285,277,293,309,16,24,32,153.13253041917028,5,32.14400514304082,74.23927954011329,118.82087531677315,174.99765483896132,0.20145234971018638,342,333,352,420,68,78,87,421.6381373992421,60,325.3090435914118,47.462387681966334,98.03137009992066,147.61424294215703,0.7617409217156046,18666,18444,McDowell+Mercer,McDowell,54,47,West Virginia,WV
54055,54CS014,754,729,780,884,104,130,155,262.562520771581,50,101.12757243262374,109.37345957360525,159.79797293865903,216.4288925337415,0.38221193502726375,919,888,949,1150,201,231,262,390.8501973280182,149,251.9019442096365,87.36393383262399,139.01408034666983,192.86186897112427,0.6417216629883022,59331,59150,McDowell+Mercer,Mercer,54,55,West Virginia,WV
54049,54CS015,602,578,626,608,-18,6,30,12.743356727744935,18,38.4827807372303,-75.8866602572457,-25.874595379828254,25.034367639601008,2.5859843700837795,734,705,763,868,105,134,163,239.214479451084,118,210.6240182778809,-21.411951266117782,30.078696167908145,82.66222595485553,0.8739606536118462,56129,56024,Marion,Marion,54,49,West Virginia,WV
54051,54CS016,331,318,344,398,54,67,80,263.3707061808321,58,228.75172549792939,-13.817799879735,35.20066458468806,83.94745529748764,0.8557394122313003,402,386,417,501,84,99,115,328.56824350569207,76,251.9643271557869,24.007807124515363,76.96244660287768,129.5132518828277,0.75919495507039,30426,30163,Marshall+Ohio,Marshall,54,51,West Virginia,WV
54069,54CS016,499,481,517,600,83,101,119,288.23177219106304,47,133.9031339031339,101.51070262119157,154.33411521032065,207.9120718961943,0.4600205351408136,605,583,627,715,88,110,132,262.901625734514,73,174.44500203120893,37.744122064643626,90.38465588805629,139.7826571996431,0.6575602479791474,42120,41847,Marshall+Ohio,Ohio,54,69,West Virginia,WV
54059,54CS017,294,284,304,337,33,43,53,218.52381481970008,25,128.21060729090985,37.58090216820662,90.31251788869496,141.128647497147,0.5732587690619331,356,344,368,488,120,132,144,573.3015224422065,89,385.76567985783015,139.7751658261251,188.9596685166766,235.25620003737487,0.6678352821488924,23399,23071,Mingo+Wayne,Mingo,54,59,West Virginia,WV
54099,54CS017,438,421,455,527,72,89,106,274.92511832036587,29,89.4578545538675,136.30330439531585,186.66326280004634,242.11699365037248,0.3217794171632324,534,514,553,704,151,170,190,442.15158094948634,88,228.2986561510922,160.78730848175954,214.97056385758117,266.13680104293155,0.5133238202667807,38901,38546,Mingo+Wayne,Wayne,54,99,West Virginia,WV
54061,54CS018,606,560,652,671,19,65,111,73.48315536305479,33,37.35214774849553,-14.34261885637905,37.687836914444865,86.24521839895355,0.5005981158119823,749,694,804,827,23,78,133,73.12094525108519,99,93.11687578773115,-70.54534512483465,-19.347309240911255,30.295667164442396,1.2572909129739078,106018,106318,Monongalia+Preston,Monongalia,54,61,West Virginia,WV
54077,54CS018,320,305,335,343,8,23,38,81.1964415463287,36,126.71222831666323,-96.15170179927006,-45.364853609737445,4.660559398733475,1.4957256100606107,392,375,410,481,71,89,106,257.8475123043192,78,227.19990678978183,-25.1234187530183,31.613313630016492,80.4414053119783,0.8712978134995362,34093,34331,Monongalia+Preston,Preston,54,77,West Virginia,WV
54079,54CS019,528,504,553,595,42,67,91,139.56655969432802,54,113.1798651622594,-24.844944224068186,27.28581415539482,79.80628345109567,0.7989402886844995,648,619,678,733,55,85,114,147.61099572759747,62,108.24022346368714,-10.219347527570594,38.9375904846951,89.13455815308491,0.7247090140680512,57254,57280,Putnam,Putnam,54,79,West Virginia,WV
54081,54CS020,900,868,932,1019,87,119,151,192.285328643789,28,45.29034345177117,99.67832748393792,147.53004606345857,198.7679706255004,0.23357235633700962,1093,1055,1131,1351,220,258,296,349.57241277503744,140,189.56062555006432,109.00474609614203,159.5960370472963,207.0299885267973,0.5401720025502278,74188,73855,Raleigh+Wyoming,Raleigh,54,81,West Virginia,WV
54109,54CS020,270,261,280,319,39,49,58,275.3755199143259,23,130.3793282630261,92.49274442448448,146.63616098800685,194.74194373491054,0.46391042615542954,328,317,339,408,69,80,91,380.66004627606793,58,274.99881466028165,56.52679593984077,107.37430386407341,157.05282329671462,0.7135386923501033,21169,21091,Raleigh+Wyoming,Wyoming,54,109,West Virginia,WV
54017,54CS021,64,63,65,78,13,14,15,213.66527295477871,2,30.464584920030468,171.77962176838417,182.8985376728218,196.36724671378067,0.13309265594338862,77,76,78,94,16,17,18,214.64739166393733,12,154.99870834409714,47.84746397491767,59.497347511031485,72.21019621286358,0.6811215391205159,7878,7742,Tyler and Nearby Counties,Doddridge,54,17,West Virginia,WV
54073,54CS021,83,82,84,88,4,5,6,74.76384467473416,7,110.38107752956635,-48.04117861722167,-35.5854777273037,-24.36752005022337,1.2192416219439124,102,101,103,123,20,21,22,274.2782270909725,19,249.73711882229233,11.655534441018228,24.3503170668505,37.5969761312149,0.8688857162691831,7610,7608,Tyler and Nearby Counties,Pleasants,54,73,West Virginia,WV
54085,54CS021,90,89,91,113,22,23,24,320.0741414837243,5,69.81615080288573,238.01269932587635,250.43210864261007,262.4474949924919,0.2090070055910667,108,107,109,146,37,38,39,453.7307000898166,16,190.72595064966026,250.80514520244571,263.2952344092956,275.3646741606007,0.40958984552158434,8594,8389,Tyler and Nearby Counties,Ritchie,54,85,West Virginia,WV
54095,54CS021,92,91,93,86,-7,-6,-5,-88.34182548402268,9,129.87012987012986,-231.03294867039804,-218.01636185789152,-206.6501947197857,-1.7570957607199233,111,110,112,142,30,31,32,378.3237945543311,21,256.94359476324485,108.56741747969963,121.22268807048488,133.74498424395247,0.6578864157964995,8316,8173,Tyler and Nearby Counties,Tyler,54,95,West Virginia,WV
54103,54CS021,178,172,184,195,11,17,23,140.94736694526978,14,116.11030478955006,-24.863119543403343,25.352948826400254,76.35575888959815,0.7780056137209924,214,207,222,317,95,103,110,721.843150318699,49,345.0461235124287,321.36029082174224,377.4310793533083,427.4200871814471,0.473389035433518,14469,14201,Tyler and Nearby Counties,Wetzel,54,103,West Virginia,WV
54107,54CS022,928,892,964,1004,40,76,112,108.80477521979316,74,105.828933725822,-51.14412483059848,3.225969357804651,53.124553259497006,0.9600311481932059,1132,1088,1175,1338,163,206,250,246.68900498544437,167,199.57455962140588,-7.248180348659796,47.944157535691915,99.54159579715687,0.8051125103690113,83909,83678,Wood,Wood,54,107,West Virginia,WV
55001,55CS001,229,221,238,241,3,12,20,67.17022656770897,16,93.04579597770777,-76.5459805565145,-26.619506182234392,25.534997083174602,1.2748516177882458,282,271,292,322,30,40,51,194.2438082321832,30,143.91250119927082,-2.7933253429683056,50.192259711500235,103.00349859917813,0.7230298258737292,20635,20846,Adams+Juneau+Monroe+Vernon,Adams,55,1,Wisconsin,WI
55057,55CS001,254,243,266,257,-9,3,14,11.574795300008404,18,80.7386087541584,-118.09399154782297,-68.10902600654987,-17.240552611551724,5.027224999111686,311,297,324,382,58,71,85,266.5817801239662,37,138.0803104941036,77.07067764222002,125.60650062265307,178.5847552462614,0.5108151029792504,26753,26796,Adams+Juneau+Monroe+Vernon,Juneau,55,57,Wisconsin,WI
55081,55CS001,362,342,381,419,38,57,77,148.92163107139916,27,69.93459819983164,26.909611873613933,78.68540330689011,130.5409827879701,0.46157855404738457,441,417,465,547,82,106,130,228.87947390216394,41,88.73306496991732,89.67234994578293,139.67246788240038,192.7969036478744,0.38405317647947407,46329,46206,Adams+Juneau+Monroe+Vernon,Monroe,55,81,Wisconsin,WI
55123,55CS001,253,240,266,318,52,65,78,253.80203166468385,22,85.87320690888981,112.55380712211202,168.03880717513908,220.87864370045315,0.3332224333957313,311,295,327,355,28,44,60,143.84958211182408,33,106.85490399248776,-17.768595456043865,36.681358693173436,88.8514154940569,0.7264711443180137,30743,30883,Adams+Juneau+Monroe+Vernon,Vernon,55,123,Wisconsin,WI
55003,55CS002,166,159,173,163,-10,-3,4,-23.707653428154032,11,82.9041577691245,-157.9365484950276,-105.71649613818403,-54.79600121191417,-5.126746019578771,205,196,213,206,-7,1,10,8.180904951043047,18,111.88463451019393,-158.54069004518388,-103.77344890520317,-49.66970794798467,7.771537559490117,15922,16088,Ashland+Bayfield+Douglas+Price,Ashland,55,3,Wisconsin,WI
55007,55CS002,150,148,152,163,11,13,15,97.69672750556843,17,126.83412086545634,-40.66725684401752,-29.19566695887053,-17.155757542411216,1.206134139125912,186,184,188,190,2,4,6,22.433587014828593,13,79.72036548721408,-69.68744127416313,-57.25177331008083,-44.020454838562884,2.790750573165753,16084,16307,Ashland+Bayfield+Douglas+Price,Bayfield,55,7,Wisconsin,WI
55031,55CS002,363,344,382,466,84,103,122,281.188895303186,53,144.03804778620767,89.81286517292112,134.64453005995836,189.93848112927824,0.5073430863140233,445,422,468,498,30,53,76,119.4879897611356,36,81.42217397204506,-15.548777694338611,39.38584145532832,89.40473000781373,0.6687668448145572,44155,44214,Ashland+Bayfield+Douglas+Price,Douglas,55,31,Wisconsin,WI
55099,55CS002,169,163,175,177,2,8,14,68.76771520886196,3,25.86021119172473,-6.779280951832931,43.90419458012059,93.91381586406118,0.3341639896940681,207,200,214,213,-1,6,13,41.35416227340357,18,128.15948736205056,-134.60868380574692,-87.38452869060949,-35.92924220543351,2.6438736978357205,13921,14045,Ashland+Bayfield+Douglas+Price,Price,55,99,Wisconsin,WI
55005,55CS003,459,439,479,503,24,44,64,114.11374470342291,55,142.10662302988544,-83.57134172581304,-27.782463653610716,23.20412018312024,1.2177349233753407,565,541,589,618,29,53,77,112.9185734497907,51,109.18900402500643,-47.16212181578786,4.578532975561459,55.01964720644234,0.9489783239340376,46444,46708,Barron+Sawyer+Washburn,Barron,55,5,Wisconsin,WI
55113,55CS003,199,191,207,217,10,18,26,121.59986704764785,16,107.27455581629232,-37.067086856731066,15.942761097109184,65.94084836041458,0.8360933047598345,247,238,257,278,21,31,40,169.02108841776547,34,186.11780162031968,-70.30560201556004,-16.70861485072142,31.408945742875776,1.0666073572022206,17898,18268,Barron+Sawyer+Washburn,Sawyer,55,113,Wisconsin,WI
55129,55CS003,184,177,191,203,12,19,26,140.68279901033978,13,94.59131700218288,-9.170930348326156,46.35451338196334,98.02378661890866,0.6393073917403543,227,219,236,278,42,51,59,302.8346177520985,25,149.441090322195,102.58855787973104,154.43985273945398,208.64877034288926,0.48392213981934495,16492,16729,Barron+Sawyer+Washburn,Washburn,55,129,Wisconsin,WI
55009,55CS004,1802,1687,1918,2060,142,258,373,115.42764048128794,216,96.6720497682034,-31.130854180820293,19.182980423229054,67.9487959257775,0.8342773335653408,2232,2093,2371,2375,4,143,282,53.15137532443259,196,72.73617919819496,-69.61687354430016,-17.29775410731215,35.59187749224426,1.3589837678727141,268123,269467,Brown,Brown,55,9,Wisconsin,WI
55011,55CS005,113,112,114,109,-5,-4,-3,-36.49504028141564,11,99.45001130113764,-147.99268996499984,-135.60767328291578,-123.50277233766553,-3.6224061993664733,139,137,141,143,2,4,6,29.848785915140216,5,37.579857196542655,-20.02576090128286,-7.7594783091539155,4.2058485032737725,1.00575675736506,13273,13305,Buffalo+Jackson+Pepin+Trempealeau,Buffalo,55,11,Wisconsin,WI
55053,55CS005,183,174,193,224,31,41,50,231.29395817449262,18,102.65183917878528,74.17729253496567,128.0115739044732,177.6543822144848,0.4331359016822294,225,214,236,236,0,11,22,51.862024913038915,15,71.02945354673737,-67.78737827913997,-18.195305817407114,33.756921188805016,1.2549967254186085,21042,21118,Buffalo+Jackson+Pepin+Trempealeau,Jackson,55,53,Wisconsin,WI
55091,55CS005,60,59,60,61,1,1,2,23.030285132502065,3,49.126637554585145,-38.201763283335126,-26.353762416507166,-13.899658912187185,1.2466844709985723,73,73,74,81,7,8,8,102.27137128748284,10,135.8695652173913,-46.54530414715945,-33.512761683273524,-20.934977317656053,1.172721614290177,7328,7360,Buffalo+Jackson+Pepin+Trempealeau,Pepin,55,91,Wisconsin,WI
55121,55CS005,260,247,273,269,-4,9,22,35.50691678202306,33,129.42445337778213,-146.27713334066453,-92.39208346441588,-40.28211771255124,3.282479402981445,319,303,335,303,-32,-16,-0,-52.01868763568637,16,52.06299622543278,-156.60630579373702,-103.52066217028336,-53.906760328674736,-1.0676358605079015,30597,30732,Buffalo+Jackson+Pepin+Trempealeau,Trempealeau,55,121,Wisconsin,WI
55013,55CS006,178,171,185,170,-15,-8,-1,-55.56824558533397,27,197.2002434570907,-302.5502611118151,-252.35186538891782,-195.5900889414044,-4.085821031561587,220,212,229,230,1,10,18,58.03865732415303,23,137.5515818431912,-129.35333899452448,-79.80484441432613,-27.95375420738939,2.148600199486191,16430,16721,Burnett+Polk,Burnett,55,13,Wisconsin,WI
55095,55CS006,407,388,426,423,-3,16,35,43.15818555945311,29,77.5729475490961,-85.52745650819203,-34.111263889476305,18.333594731728645,1.6925087442235769,505,481,528,580,52,75,99,165.9797911934849,83,182.944301174811,-67.42212499175953,-16.20351948754205,37.32237897685271,1.0877632063264933,44861,45369,Burnett+Polk,Polk,55,95,Wisconsin,WI
55015,55CS007,323,300,345,353,8,30,53,69.12287231419262,34,78.25386474356515,-57.575562560579705,-9.94716292399198,42.76074773223278,1.0956172227279877,401,374,428,404,-24,3,30,5.6160007750603125,57,108.50942318675044,-153.8475721738855,-101.8707219045544,-50.2335899910929,14.430068469657595,52138,52530,Calumet+Winnebago,Calumet,55,15,Wisconsin,WI
55139,55CS007,1306,1233,1380,1525,145,219,292,152.8071736096359,172,120.23347663486071,-17.264547482364215,34.4498611842624,81.39123680648265,0.7832483141771303,1605,1517,1694,1730,36,125,213,72.57687993486616,137,79.82473517998439,-58.514349287827095,-7.918229171508187,45.46424946110513,1.0911049022570938,171666,171626,Calumet+Winnebago,Winnebago,55,139,Wisconsin,WI
55017,55CS008,535,507,564,584,20,49,77,88.2546862809533,56,101.65030479964905,-65.40293404942246,-11.900345427340262,39.72024775744298,1.1285716795911636,662,628,697,674,-23,12,46,17.400358984330673,64,95.83707696915245,-128.15651699415938,-78.13105657454852,-27.927228792115756,5.0713315549810165,66109,66780,Chippewa+Rusk,Chippewa,55,17,Wisconsin,WI
55107,55CS008,160,154,166,163,-3,3,9,27.107139581539897,17,144.14923685698133,-164.6449452766966,-116.10636937128248,-65.63757717004852,4.0506712013812685,194,187,202,234,32,40,47,279.66781067732666,28,198.1599433828733,30.268472736302442,81.11315261217081,129.5340071083962,0.6910668952938265,14152,14130,Chippewa+Rusk,Rusk,55,107,Wisconsin,WI
55019,55CS009,290,275,305,332,27,42,57,145.68420357208174,52,180.01904047543488,-89.71999678506394,-32.47608807619973,19.116406858199824,1.2069979073012609,355,338,373,389,16,34,51,96.65354273980431,45,129.57470701719024,-81.92739906692485,-33.17862744083038,17.234674170021886,1.3018268531735337,34663,34729,Clark+Taylor,Clark,55,19,Wisconsin,WI
55119,55CS009,162,153,170,175,5,13,22,80.33456153464552,24,144.25966740132236,-117.66600568651128,-61.93401889200204,-8.66529935674041,1.670728251058563,198,187,208,226,18,28,39,142.1612674864587,29,145.58963803403785,-53.151089369006726,-2.408622686868206,48.99359487157289,0.9891836900792333,19964,19919,Clark+Taylor,Taylor,55,119,Wisconsin,WI
55021,55CS010,484,459,509,528,19,44,69,91.18256960875247,40,82.23966007607169,-48.746864637913944,10.629728911223953,55.566882041690526,0.8820348479903155,595,564,625,631,6,36,67,62.31170824197004,50,85.48323673727582,-72.39020772923294,-23.024956279194573,26.8541862637878,1.3352296703846995,58366,58491,Columbia,Columbia,55,21,Wisconsin,WI
55023,55CS011,155,148,162,165,3,10,17,74.72759705881418,11,82.03853325046613,-55.828313601550896,-7.108575927200068,45.51283798569266,0.998210000241484,190,182,199,197,-2,7,15,42.29328009064938,11,68.42072525968774,-77.18670988157895,-27.505697565152726,27.045335640142266,1.4103485095989576,16090,16077,Crawford+Grant+Richland,Crawford,55,23,Wisconsin,WI
55043,55CS011,436,413,458,503,45,67,90,155.61528972404724,51,117.94179996145692,-14.420002616462535,35.565460353264754,94.04318427353682,0.746808001314653,539,512,565,578,13,39,66,75.67004603260771,35,67.1991398510099,-41.07761023553824,9.47737608272198,59.06386073214508,0.8660796657765927,51890,52084,Crawford+Grant+Richland,Grant,55,43,Wisconsin,WI
55103,55CS011,167,160,174,191,17,24,31,166.46025090557842,11,76.41984600243154,40.622580979990275,89.52100793755008,150.84310386030972,0.4406951357766156,205,196,213,227,14,22,31,130.36529800754735,24,139.3647291098078,-59.67460040481253,-7.556873403666532,40.588208153149985,1.0234450812046718,17273,17221,Crawford+Grant+Richland,Richland,55,103,Wisconsin,WI
55025,55CS012,2977,2735,3218,3366,148,389,631,83.3934217170788,216,46.2577944026641,-11.82796952032573,37.58160538757488,89.00031700874345,0.5532727464864896,3713,3422,4004,3768,-236,55,346,9.816676176313383,147,26.07719203634486,-69.44342755700643,-16.733173718646565,32.985228012076014,2.6092659659299433,560338,563711,Dane,Dane,55,25,Wisconsin,WI
55027,55CS013,818,780,856,1019,163,201,239,270.9974176819858,126,169.8323018342338,50.58139090265258,102.47700862978175,149.75180683491513,0.6235918377925109,1005,959,1051,1111,60,106,152,118.36734482228816,112,125.4115065057219,-59.5049287097718,-8.310380535520745,42.16990504137964,1.0495820600284274,89029,89306,Dodge,Dodge,55,27,Wisconsin,WI
55029,55CS014,311,298,324,325,1,14,27,55.74839118028004,25,100.71507704703393,-97.54058633031019,-43.007141424689316,4.885418848726837,1.6848467924856199,384,368,400,381,-19,-3,13,-9.819106844787193,22,72.53544345532477,-135.14974600970115,-83.1105824536337,-31.040302974124003,-11.121586151018732,29787,30330,Door+Kewaunee+Manitowoc,Door,55,29,Wisconsin,WI
55061,55CS014,163,154,172,191,19,28,37,162.90415026925052,26,151.99493350221658,-38.849492417211756,11.068265465900275,61.876745459469355,0.9007101339231994,200,189,210,206,-4,6,17,30.62259572691342,15,73.02112744620777,-94.2902769579284,-43.40701005013565,12.792311194779275,2.0574738548206755,20527,20542,Door+Kewaunee+Manitowoc,Kewaunee,55,61,Wisconsin,WI
55071,55CS014,763,728,798,844,46,81,116,120.50803838580848,56,83.04806159397901,-14.657406148242327,36.64315465455489,88.6121850819399,0.6807718168817916,935,893,977,949,-28,14,56,17.17705025555745,71,87.15078312957235,-117.90970886839693,-71.18442478685006,-20.767467204116777,4.7352908071534605,80917,81468,Door+Kewaunee+Manitowoc,Manitowoc,55,71,Wisconsin,WI
55033,55CS015,302,283,322,306,-16,4,23,9.956631923156094,23,60.73542679840679,-102.47305459267928,-50.85906599815428,2.6700028613615756,4.821304089366152,373,349,396,414,18,41,65,91.1313838319557,33,72.47809184950913,-36.882961574206476,19.067313872207738,68.52779209203992,0.7765979434908669,45443,45531,Dunn+Eau Claire,Dunn,55,33,Wisconsin,WI
55035,55CS015,758,712,803,846,43,88,134,100.43676499550496,81,91.9696840671038,-36.44876192693445,8.717633929575703,60.70818486592924,0.9054612406721122,935,880,990,998,8,63,118,58.84760392799889,68,63.93380970289583,-55.183458124995944,-5.201980571025038,41.468072735804064,1.0693452879147758,105687,106360,Dunn+Eau Claire,Eau Claire,55,35,Wisconsin,WI
55037,55CS016,59,58,59,63,4,4,5,112.51830259856949,13,344.90382489498126,-244.32373069186497,-232.3155074045912,-219.98880428626174,2.4804415488375895,73,72,74,67,-7,-6,-5,-132.2925116277892,8,174.3679163034002,-319.24613033474475,-306.89368401349344,-294.5731403092017,-1.5780398604907302,4523,4588,Florence+Forest+Marinette+Oconto,Florence,55,37,Wisconsin,WI
55041,55CS016,107,106,108,99,-9,-8,-7,-101.6402107718455,21,275.34965034965035,-389.43241150958727,-376.58680582510607,-364.81271680622757,-3.110300094663319,132,131,133,152,19,20,21,213.1226247717112,15,162.26741670272608,38.237867812955315,51.16367966705328,63.628449736804356,0.7246007358367932,9152,9244,Florence+Forest+Marinette+Oconto,Forest,55,41,Wisconsin,WI
55075,55CS016,475,457,492,538,46,63,81,182.95470309849262,63,181.58236057068743,-47.6375814690448,1.0901011715988271,49.85015046374212,0.9771057266782327,583,561,604,615,11,32,54,76.89272993634974,44,105.07713617041601,-78.77431448664736,-27.582605693463748,23.127863496767553,1.3253785824350524,41634,41874,Florence+Forest+Marinette+Oconto,Marinette,55,75,Wisconsin,WI
55083,55CS016,332,315,348,396,48,64,81,198.77519235991988,49,151.03256960854822,-3.842137413236407,47.11373791413826,100.93824767080066,0.7482138504439839,412,391,432,414,-18,2,23,5.812102217194584,34,86.49198677181379,-132.46615651299317,-81.37544961030855,-25.442317783749537,10.350903603640283,38932,39310,Florence+Forest+Marinette+Oconto,Oconto,55,83,Wisconsin,WI
55039,55CS017,836,792,881,999,118,163,207,187.82013350319616,108,124.66333205078875,13.1635504459453,63.54733434548808,115.97298254788618,0.6596836210222485,1033,979,1087,1182,95,149,203,142.86874225795825,106,101.61042944785277,-10.637606834258579,40.712071645651,90.39227240045807,0.7064751086561644,103960,104320,Fond du Lac,Fond du Lac,55,39,Wisconsin,WI
55045,55CS018,296,280,312,340,28,44,60,141.6292171937095,14,45.44102134105109,44.175782104003154,96.31790491216752,146.32894527036407,0.31365673822821577,362,343,381,397,16,35,54,93.84035256584886,29,78.40168698802347,-35.24660125473795,16.09841673404702,69.28928747168055,0.8120836248827425,36971,36989,Green+Iowa+Lafayette,Green,55,45,Wisconsin,WI
55049,55CS018,178,168,188,197,9,19,29,97.8538913162337,3,15.202702702702702,34.0219722540959,82.8184666070846,131.98420551561645,0.14771169071618595,218,206,230,212,-18,-6,6,-25.191434086777157,12,50.539083557951486,-126.65054517049849,-75.34173355495598,-26.298310581712585,-2.4089351695441814,23680,23744,Green+Iowa+Lafayette,Iowa,55,49,Wisconsin,WI
55065,55CS018,121,120,123,142,19,21,22,148.2326776218009,3,21.643720315036372,114.21305341342959,126.76127577735905,138.30286775865113,0.139235143545008,150,148,152,165,13,15,17,87.61270004411243,14,83.5421888053467,-8.874233202767458,3.9292862343066397,16.010295428911192,0.8927355148516076,16633,16758,Green+Iowa+Lafayette,Lafayette,55,65,Wisconsin,WI
55047,55CS019,203,195,212,221,9,18,26,110.98399233454441,19,119.94949494949495,-59.778443192524314,-10.929147402324874,40.01525468392476,1.0226124155421417,251,241,260,286,26,35,45,184.58458096443556,31,161.50039072675176,-29.498038038256652,22.99099927258914,72.37032453396967,0.8509234229576175,19008,19195,Green Lake+Marquette+Waushara,Green Lake,55,47,Wisconsin,WI
55077,55CS019,173,166,180,210,30,37,44,285.3273814876227,24,184.62721969357008,48.364457625906525,101.79027681677039,149.5112349429689,0.6300836285037383,213,205,221,250,29,37,45,234.69527400698615,25,158.609313538891,24.263528392662373,75.06249299003376,130.25639061350378,0.6580216815367319,15599,15762,Green Lake+Marquette+Waushara,Marquette,55,77,Wisconsin,WI
55137,55CS019,246,235,257,289,32,43,54,210.36100660628568,25,122.31917149147843,35.42307170498112,86.20050209563492,140.55487812171773,0.5682556431970307,304,291,316,331,15,27,40,110.83687417116458,41,165.44265999515778,-107.02319980332531,-54.958784673983466,-1.9574604633328214,1.4402341052686818,24526,24782,Green Lake+Marquette+Waushara,Waushara,55,137,Wisconsin,WI
55051,55CS020,79,79,80,93,13,14,14,269.7682583167805,19,375.67968363816107,-117.78131474165197,-106.15164502928377,-93.99911496294517,1.2975013835788822,99,98,100,109,9,10,11,164.91971316527818,5,81.02414519526819,70.99677219173611,84.17700181647197,97.47619171242935,0.44733940640613196,6069,6171,Iron+Oneida+Vilas,Iron,55,51,Wisconsin,WI
55085,55CS020,424,408,441,499,58,75,91,238.1869150567279,46,146.97659557472642,40.99339510335514,90.39859141618066,142.44265094468463,0.6088961065513436,526,506,545,531,-14,5,25,13.813012567715717,45,117.80721503743652,-155.4857040690068,-106.17057713209854,-48.336320688814034,7.169835594679249,37557,38198,Iron+Oneida+Vilas,Oneida,55,85,Wisconsin,WI
55125,55CS020,280,270,290,282,-8,2,12,12.301363483914338,29,151.38333043326952,-190.7115307509836,-139.22557944629085,-88.27665786132943,8.639872025228815,347,335,359,365,6,18,30,75.24556038950855,42,179.06629716478363,-157.7216595740885,-104.5763080944788,-49.48069406053164,2.252150056552271,22988,23455,Iron+Oneida+Vilas,Vilas,55,125,Wisconsin,WI
55055,55CS021,608,571,644,713,69,105,142,148.5096772288208,83,117.36563637863378,-19.587057161236935,30.714852370387852,84.44292238767974,0.7828356684586396,751,707,795,892,97,141,185,165.98778655979459,85,100.08124242031768,14.683155306702604,64.87626400486543,116.80760259013289,0.5986965868043072,84863,84931,Jefferson,Jefferson,55,55,Wisconsin,WI
55059,55CS022,1250,1177,1323,1488,165,238,311,168.83019132491248,229,162.4708817651858,-45.59672875521022,4.978135068316654,55.58391120988993,0.9583059861772593,1538,1451,1625,1708,83,170,257,100.54437020490796,180,106.64644334111458,-57.19964269633966,-4.963569116359366,47.76232545723519,1.0544766113552366,169138,168782,Kenosha,Kenosha,55,59,Wisconsin,WI
55063,55CS023,893,842,945,1004,59,111,162,110.15047609468522,68,67.7662065872739,-9.768860232040106,43.446264694583135,97.07939010844296,0.6096987183224841,1101,1039,1163,1140,-23,39,101,32.19556798843751,68,56.43434527860308,-74.1335905348036,-24.473667118082286,28.55544823921784,1.7088120149571004,120414,120494,La Crosse,La Crosse,55,63,Wisconsin,WI
55067,55CS024,200,192,209,256,47,56,64,343.8976911266893,35,216.37216011539846,76.63253804997191,128.3268763957112,180.1739991236136,0.618065336133988,246,236,256,306,50,60,70,307.6284897020649,18,92.34084030164675,166.39852542576605,214.93789501180308,262.5201247333374,0.295246426744472,19411,19493,Langlade+Lincoln+Menominee+Shawano,Langlade,55,67,Wisconsin,WI
55069,55CS024,294,281,306,372,66,78,91,332.47738687902245,68,288.56354763420325,-8.888012757051236,42.7285193649001,93.1735411024507,0.8569812238077855,362,347,376,437,61,75,90,264.0902912164503,50,175.3340112915103,41.165957671597674,89.29053988129219,137.8104015331917,0.655216725161365,28278,28517,Langlade+Lincoln+Menominee+Shawano,Lincoln,55,69,Wisconsin,WI
55078,55CS024,41,39,43,59,16,18,20,493.1223183477471,14,390.5160390516039,52.99558949772325,102.44996864168766,150.77215177251057,0.7495274585626813,51,48,53,65,12,14,17,335.56081739503594,5,116.71335200746965,171.4980092785867,220.79413367867494,269.21424051387424,0.32519425409885394,4302,4284,Langlade+Lincoln+Menominee+Shawano,Menominee,55,78,Wisconsin,WI
55115,55CS024,407,389,424,477,53,70,88,206.4021408756264,63,185.1398344516824,-28.90264932967404,21.169646995255786,75.58626651061616,0.8843941264831429,498,477,519,505,-14,7,28,16.27838224157487,39,95.45721558644996,-132.96112563741585,-79.55771674424574,-29.099398993781435,5.097575537138328,40834,40856,Langlade+Lincoln+Menominee+Shawano,Shawano,55,115,Wisconsin,WI
55073,55CS025,1065,1006,1124,1209,85,144,203,125.69981996696916,156,136.05343295080417,-62.04272275411335,-11.099145360491953,41.665830114139204,1.074909765093788,1309,1238,1381,1444,63,135,206,97.70509300655247,190,137.98813302056024,-92.27469553877019,-40.33726780577033,11.849880754857967,1.4018718442231972,137593,137693,Marathon,Marathon,55,73,Wisconsin,WI
55079,55CS026,7061,6658,7464,8848,1384,1787,2190,228.50401670295804,898,114.83498332249916,61.233511612712825,114.454577773793,162.7826187944831,0.5022701805014568,8623,8143,9103,9500,397,877,1357,94.39189801128377,274,29.47726270265618,16.18227402556789,64.25957156865688,115.02966164359282,0.31193042472671323,938390,929530,Milwaukee,Milwaukee,55,79,Wisconsin,WI
55087,55CS027,1295,1213,1377,1498,121,203,285,127.72456655594448,164,103.31630644204468,-26.611849045786542,25.54538720817348,73.46103671100678,0.8049290908974455,1604,1505,1702,1674,-28,70,169,36.760670421557855,140,73.12958039291479,-87.87628419072466,-36.892925682468125,15.025991780396689,1.961471239036996,190483,191441,Outagamie,Outagamie,55,87,Wisconsin,WI
55089,55CS028,703,664,742,781,39,78,117,102.50557259163442,85,111.62424215894417,-60.845122235141154,-8.537982807102454,39.94859768379696,1.0751833315970705,872,824,920,906,-14,34,82,36.685950081751805,71,76.8714406357593,-90.37848781118818,-41.27074471894807,9.892574799917558,2.035324214777144,91378,92362,Ozaukee,Ozaukee,55,89,Wisconsin,WI
55093,55CS029,247,229,265,287,22,40,58,113.72964022120343,25,70.89516967577275,-6.841598727537948,42.48006295917776,93.70590296223946,0.6082005559569005,306,284,328,371,43,65,87,152.85274972751964,30,70.5401020480143,30.30298415242239,81.44126691666222,134.23062508903504,0.45449899970951585,42316,42529,Pierce+St. Croix,Pierce,55,93,Wisconsin,WI
55109,55CS029,545,505,586,628,42,83,123,106.17660230102982,41,52.63495731433339,4.072249146290168,55.717278138346636,102.87147451700798,0.4898080246718436,680,632,729,812,83,132,180,138.62646064593898,90,94.87466003246821,-7.155492962498818,43.78643459639946,96.39679383645108,0.6792256336725702,93474,94862,Pierce+St. Croix,St. Croix,55,109,Wisconsin,WI
55097,55CS030,455,425,486,520,34,65,95,110.27623865187934,45,76.62835249042146,-19.903960705349302,32.696813255537016,84.13522247753316,0.6843094711199559,562,526,599,717,118,155,191,219.462996006057,76,107.87027180469804,57.422247865875306,108.93847708044764,159.17223891182456,0.4883607760606513,70470,70455,Portage,Portage,55,97,Wisconsin,WI
55101,55CS031,1611,1526,1695,1934,239,323,408,196.84312432733375,267,162.47217334421887,-19.192308527929008,34.44196062790539,89.10798839628946,0.8228454218037392,1977,1876,2079,2230,151,253,354,128.20477240688146,217,110.16626475441045,-34.33945586584769,18.380306983446353,66.49773581340075,0.85590992836256,197203,196975,Racine,Racine,55,101,Wisconsin,WI
55105,55CS032,1326,1256,1397,1564,167,238,308,174.38286590685343,139,101.92857666642223,23.155807421291875,71.46501776437627,123.17408993293783,0.5820626362793876,1636,1551,1720,1771,51,135,220,82.42563800245159,127,77.31033097344056,-46.573719733565035,5.22489884287019,56.673361816646164,0.931064099716587,163644,164273,Rock,Rock,55,105,Wisconsin,WI
55111,55CS033,565,537,593,631,38,66,94,120.67744719881108,44,80.5774718818197,-9.838951034518852,43.21661249402153,93.995932200925,0.65772828193946,692,658,726,753,27,61,95,92.60144647267424,67,101.97869101978691,-61.39902248542172,-10.83083551054223,44.490704285168114,1.0834560248596556,65527,65700,Sauk,Sauk,55,111,Wisconsin,WI
55117,55CS034,986,935,1037,1137,100,151,202,154.1797897033155,127,129.67674412668157,-26.10766820082219,23.775767232209855,77.8385335127511,0.8355413672013033,1211,1150,1272,1251,-21,40,101,34.16531692459611,102,86.60581617490979,-102.23767178497677,-52.47542438980347,2.9577197228755905,2.47343470455752,117523,117775,Sheboygan,Sheboygan,55,117,Wisconsin,WI
55127,55CS035,835,790,881,998,117,163,208,184.00827755767222,116,131.13395069288092,-0.460014275407687,52.723439433524995,101.80888175414962,0.7083009683223943,1033,978,1088,1095,7,62,117,58.25198026778627,95,88.98880614491124,-82.34516566373559,-31.361798309113745,20.57131767156822,1.5034761587030172,106151,106755,Walworth,Walworth,55,127,Wisconsin,WI
55131,55CS036,1017,958,1076,1188,112,171,230,149.85040768160098,117,102.6953882163625,-6.122939944677796,47.19607953556167,102.29905013977363,0.6813285435585297,1258,1187,1329,1387,58,129,200,94.16022104176065,129,94.08504120778936,-49.23124459160909,1.124748171991943,50.943832197629035,0.991521499120236,136715,137110,Washington,Washington,55,131,Wisconsin,WI
55133,55CS037,3024,2848,3199,3670,471,646,822,190.6397793415598,421,124.1472860597244,12.326123653891573,67.32393638375508,119.86031070682374,0.6502082029216886,3739,3528,3950,4148,198,409,620,100.18210124103598,329,80.53421847538199,-37.70930305248752,20.614959520974796,72.44711715685742,0.8019189044205931,406936,408522,Waukesha,Waukesha,55,133,Wisconsin,WI
55135,55CS038,621,599,643,716,73,95,117,220.5220161957021,118,274.55694729902666,-104.70262103362577,-52.877620180558935,-3.658127430395025,1.232032590154377,756,729,783,759,-24,3,30,5.580516451724988,71,137.62090287065573,-186.05118818019565,-133.44379210316103,-81.86992643948044,18.303477753643303,51574,51591,Waupaca,Waupaca,55,135,Wisconsin,WI
55141,55CS039,721,689,753,824,71,103,135,167.3561654092048,52,84.43843031123139,32.290117778138246,82.62333741606587,135.30291413873988,0.49969487286770436,885,847,923,1051,128,166,204,224.43838719124852,122,164.7023881846287,6.953851779338811,58.74971445684525,111.55836631105271,0.729454583356588,73900,74073,Wood,Wood,55,141,Wisconsin,WI
56003,56CS001,118,117,119,127,8,9,10,96.33202407144434,14,145.7700650759219,-62.082643144113675,-49.342648399676435,-37.53246891779285,1.3656021019466313,146,145,147,190,43,44,45,379.04824121762033,32,275.67195037904895,90.61836820799728,103.22407655472624,116.25762682917892,0.7111123778307386,11525,11608,Big Horn+Hot Springs+Park+Washakie,Big Horn,56,3,Wyoming,WY
56017,56CS001,63,63,64,80,16,17,17,435.96395118053806,2,52.298975811723686,372.13467164623944,383.7338114422494,395.82814120946773,0.1131734578313043,78,77,78,87,9,9,10,197.51957042474757,10,217.3440556400782,-33.31822060025971,-20.20164447096546,-7.046064303718809,0.9912890047258476,4589,4601,Big Horn+Hot Springs+Park+Washakie,Hot Springs,56,17,Wyoming,WY
56029,56CS001,257,244,270,303,33,46,59,185.72976866371786,14,56.68972498734604,75.30968671639934,129.11422497732968,181.10283514981126,0.29871437098798403,322,307,338,440,102,118,133,391.7620029299309,103,342.8533386592104,-4.296706803701945,50.11519183852043,99.47770855676323,0.8677839275416988,29635,30042,Big Horn+Hot Springs+Park+Washakie,Park,56,29,Wyoming,WY
56043,56CS001,72,71,73,87,14,15,16,230.6595065467227,21,327.82620007805383,-109.2919238234807,-96.90359159385764,-84.63597081365104,1.3311642913969248,89,88,90,113,23,24,25,310.0333840944091,18,233.82696804364772,62.983517710256876,76.46721019989961,88.69169921543059,0.7238692284758284,7687,7698,Big Horn+Hot Springs+Park+Washakie,Washakie,56,43,Wyoming,WY
56013,56CS002,362,345,379,486,107,124,141,380.2747831926924,64,195.7386074013661,133.2084232193769,184.28108194015448,234.64536659975818,0.5106226331192484,445,425,466,579,113,134,154,340.0989244141069,91,231.47559331518835,54.586170436271914,107.82789643214377,154.50652863564568,0.6755598546057386,39236,39313,Fremont+Lincoln+Sublette+Teton,Fremont,56,13,Wyoming,WY
56023,56CS002,123,121,125,155,30,32,34,193.853082419569,10,60.72259892723409,121.31470098491889,132.79465543172014,144.33787627187488,0.30372637217938403,155,152,157,172,15,17,20,86.60055820683915,15,74.69003634915101,-1.1998898564624836,11.696326308541371,24.76154065334088,0.8155724266175808,19762,20083,Fremont+Lincoln+Sublette+Teton,Lincoln,56,23,Wyoming,WY
56035,56CS002,47,46,48,67,19,20,21,265.385585436054,4,54.01147743895577,199.47000659237472,211.53586071444124,224.32359499831156,0.19366695361593203,57,56,59,78,19,21,22,236.1512994453059,16,183.88690955062637,39.35103947654813,52.00319874250124,65.0632794704427,0.7425446924044838,8887,8701,Fremont+Lincoln+Sublette+Teton,Sublette,56,35,Wyoming,WY
56039,56CS002,87,85,90,79,-11,-8,-6,-42.47468476616288,8,41.067761806981515,-95.99798921321351,-83.58984440904686,-71.80676844415771,-1.099797162801721,110,107,113,89,-24,-21,-18,-88.37422221659283,5,21.23863732902897,-122.29439760989129,-109.86924171420041,-96.9818088067772,-0.25246074250383854,23376,23542,Fremont+Lincoln+Sublette+Teton,Teton,56,39,Wyoming,WY
56021,56CS003,744,700,787,821,34,77,121,92.2394495582732,63,75.15807054519425,-35.633045641732295,17.16741849404816,67.06341205023224,0.8044109168516955,919,867,971,1259,288,340,392,337.30781675577566,173,171.56230786013208,112.28092964959157,165.76919200519976,215.41753186975262,0.507131416440824,100588,100838,Laramie,Laramie,56,21,Wyoming,WY
56025,56CS004,622,587,656,761,105,139,174,208.9206502398617,95,142.34519959543994,18.032392695510172,66.47104130329875,115.56229796701734,0.6764844693222771,761,720,802,934,132,173,214,217.06847756174068,131,164.46335982323328,-0.15586674691472327,53.70587828314328,106.19636708304539,0.753299764499998,80087,79653,Natrona,Natrona,56,25,Wyoming,WY
56005,56CS005,218,198,238,276,38,58,78,147.53525835381822,39,99.70174691095013,-1.7632802707703634,47.58011810438864,98.60381459573344,0.6642721616707117,270,246,294,367,73,97,121,208.26121352521469,86,184.92635200516074,-25.17805922609398,23.7452632069511,74.24233981001277,0.8788794076221873,46940,46505,Northeast Wyoming,Campbell,56,5,Wyoming,WY
56011,56CS005,53,52,53,99,46,46,47,766.078500657165,10,165.51724137931032,589.1332018002129,600.5249937197358,612.7131916175105,0.21148843494083705,65,64,66,82,16,17,18,229.79769221466856,13,178.20424948594928,38.49843189196706,51.68245706762132,64.0504941732401,0.7318278017261932,7250,7295,Northeast Wyoming,Crook,56,11,Wyoming,WY
56019,56CS005,83,82,83,84,1,1,2,19.87319314286206,6,84.81564377429615,-77.16718423075675,-64.91521435384743,-52.85680321892998,2.493907793804101,103,102,104,110,6,7,8,85.95731793879924,0,0,73.45997404785876,85.45713740335347,99.63174621838769,0,8489,8599,Northeast Wyoming,Johnson,56,19,Wyoming,WY
56033,56CS005,286,272,299,300,1,14,28,56.06385411825017,18,69.6639360123847,-62.26910830382466,-14.887646785304618,42.50707807934182,1.1623427672199973,355,339,372,384,12,29,45,90.56626322363374,43,136.28728091027224,-93.78185306140836,-46.337337507572286,5.436136973773283,1.4539522317219369,31006,31551,Northeast Wyoming,Sheridan,56,33,Wyoming,WY
56045,56CS005,55,54,56,68,12,13,14,230.8243370498792,7,123.29370321444296,95.4795106007303,107.70714757099431,120.43057949122012,0.49627609533190437,67,66,68,106,38,39,40,579.4774465539925,11,162.86644951140065,402.9910185064219,416.9834469394453,429.52381426111197,0.2740551486948236,6813,6754,Northeast Wyoming,Weston,56,45,Wyoming,WY
56001,56CS006,172,156,188,213,25,41,57,131.71061724158795,10,32.0958596341072,47.63255830212561,100.35390168572943,151.3601366429153,0.23788772082814413,218,199,237,267,30,49,68,130.25845015637375,34,90.59177746396313,-10.018847419725962,40.8497353963486,90.00513255685803,0.6815361971980491,37388,37531,"Southeast Wyoming, excluding Laramie",Albany,56,1,Wyoming,WY
56007,56CS006,108,107,110,137,27,29,30,237.1481550451052,17,140.08102726086656,85.12320534154154,97.1339297284813,109.52299671423934,0.5708547453727572,133,131,135,162,27,29,31,196.67271591786553,31,211.93682915156901,-28.10472394257004,-15.044528842478837,-2.1355662862663896,1.0414105777409866,14563,14627,"Southeast Wyoming, excluding Laramie",Carbon,56,7,Wyoming,WY
56009,56CS006,103,101,104,127,23,24,26,212.8875402189004,4,34.93704054152413,166.32152716895604,177.822785074731,190.27047386819478,0.15764261677178992,125,124,127,163,36,38,39,275.9997505546271,36,263.1578947368421,-0.031229130593744697,12.843049503430935,25.941964915894513,0.9288700743322564,13739,13680,"Southeast Wyoming, excluding Laramie",Converse,56,9,Wyoming,WY
56015,56CS006,135,129,140,160,20,25,31,241.2804862795025,19,180.7802093244529,14.610419835286892,61.36290023837749,112.34451730927661,0.7208279293875474,165,158,171,188,17,23,30,186.67487725459068,31,247.36674114267475,-115.15066696133867,-59.636200787699835,-10.003759176953919,1.2707993149663412,12612,12532,"Southeast Wyoming, excluding Laramie",Goshen,56,15,Wyoming,WY
56027,56CS006,24,23,25,33,8,9,10,458.29659616744505,6,297.029702970297,112.52551764139864,163.01734004995518,212.03615413800242,0.5849326472566162,29,28,31,36,5,7,8,276.274446104898,8,328.1378178835111,-101.51152116699089,-51.39255309901408,4.3405034252899215,1.0341835145845137,2424,2438,"Southeast Wyoming, excluding Laramie",Niobrara,56,27,Wyoming,WY
56031,56CS006,84,83,85,96,11,12,13,164.24769699390868,6,83.63340689975605,69.06636018703368,80.48325766319634,92.232417906915785,0.46935857001002057,104,103,105,171,66,67,68,771.4331604318782,25,287.75322283609574,471.717275586446,483.5524783012083,496.73566315140926,0.36752754222685524,8609,8688,"Southeast Wyoming, excluding Laramie",Platte,56,31,Wyoming,WY
56037,56CS007,253,235,271,357,86,104,122,295.4585447279476,22,62.54145740547712,182.19464900826574,233.4798656663762,285.2160782498819,0.2096586551476405,311,289,332,414,82,103,125,247.3777807708895,82,196.6757009569952,-0.4654348991773112,50.5420373012305,106.87517413097271,0.7874074865078896,42212,41693,Sweetwater+Uinta,Sweetwater,56,37,Wyoming,WY
56041,56CS007,139,130,148,154,6,15,24,87.01079917407222,2,11.750305997552019,23.98382205017381,74.42314544228965,125.53753977797267,0.12650250896590137,174,163,184,186,2,12,23,60.61954665710058,23,111.61255883922938,-105.44380216454584,-49.89333948297145,-0.06967670103795101,1.704730332765402,20425,20607,Sweetwater+Uinta,Uinta,56,41,Wyoming,WY
