FIPSCode,csCode,expDeathsLow2020,expDeathsMed2020,expDeathsUp2020,deaths2020,excDeathsLow2020,excDeathsMed2020,excDeathsUp2020,COVIDDeaths2020,nonCovidExcCDRLow2020,nonCovidExcCDRMed2020,nonCovidExcCDRUp2020,COVIDExcRatio2020,expDeathsLow2021,expDeathsMed2021,expDeathsUp2021,deaths2021,excDeathsLow2021,excDeathsMed2021,excDeathsUp2021,COVIDDeaths2021,nonCovidExcCDRLow2021,nonCovidExcCDRMed2021,nonCovidExcCDRUp2021,COVIDExcRatio2021,pop2020,pop2021,csName,countyName,stateFIPS,countyFIPS,state,stateStr
01001,01CS001,373,470,588,565,-23,95,192,55,-160.14657289613356,82.12644763904284,281.3857412232705,0.493283462033462,448,576,742,707,-35,131,259,107,-240.42039707460296,40.6344333083836,257.35141095309615,0.7157270693512304,58446,59063,Autauga,Autauga,1,1,Alabama,AL
01003,01CS002,1614,1997,2496,2277,-219,280,663,165,-198.34353328465323,59.3842914025908,257.2372588017443,0.44,1976,2484,3166,3096,-70,612,1120,435,-211.97874619615743,74.45577807424151,287.4202768251846,0.6551204819277109,232385,238397,Baldwin,Baldwin,1,3,Alabama,AL
01005,01CS003,200,256,326,324,-2,68,124,38,-191.3781803955315,143.53363529664864,411.46308785039275,0.5205479452054794,241,313,408,373,-35,60,132,52,-348.26268728371105,32.005761036986655,320.05761036986655,0.6933333333333334,25081,24996,Barbour+Bullock+Henry,Barbour,1,5,Alabama,AL
01007,01CS004,169,217,276,252,-24,35,83,40,-344.9734419859929,-26.9510501551557,232.04854183589032,0.851063829787234,204,268,344,339,-5,71,135,46,-227.2731492742671,111.40840650699367,396.61392716489746,0.601332877648667,22263,22440,Bibb+Chilton+Coosa+Perry,Bibb,1,7,Alabama,AL
01009,01CS005,478,596,745,731,-14,135,253,92,-216.07632965110378,87.61227887786386,328.1385468204644,0.6195356430255758,572,734,929,841,-88,106,269,98,-315.0041915880332,14.395352841388615,289.6006277502886,0.6125,58896,59047,Blount,Blount,1,9,Alabama,AL
01011,01CS003,83,100,118,132,14,32,49,20,-74.54342192135356,136.467623677181,337.8872581121459,0.6309617091685047,100,123,149,141,-8,18,41,13,-203.52000775314315,48.457144703129316,271.3600103375242,0.5652173913043478,10286,10318,Barbour+Bullock+Henry,Bullock,1,11,Alabama,AL
01013,01CS006,166,213,273,256,-17,43,90,52,-433.6275171922443,-56.560110938118825,238.80935729427947,1,199,257,339,308,-31,51,109,47,-412.79960862048625,21.155649384778286,327.91256546406345,0.746031746031746,19095,18907,Butler+Crenshaw+Pike,Butler,1,13,Alabama,AL
01015,01CS007,1008,1252,1555,1535,-20,283,527,175,-201.975367752914,111.80594421996264,364.50808296156333,0.5654295855517277,1186,1522,1917,1865,-52,343,679,302,-305.1332857101298,35.34029580258566,325.04452554036703,0.7814039738646101,115915,116015,Calhoun,Calhoun,1,15,Alabama,AL
01017,01CS008,295,372,471,516,45,144,221,73,-97.69376492377349,247.28190052006838,515.4608630559172,0.5,352,449,581,576,-5,127,224,77,-237.2617963297963,144.6718270303636,425.33517146926897,0.5703703703703704,34455,34561,Chambers+Cleburne+Randolph,Chambers,1,17,Alabama,AL
01019,01CS009,231,290,367,398,31,108,167,34,-14.313569893791321,353.06805738018596,634.5682652914153,0.3090909090909091,272,352,453,469,16,118,197,64,-192.07330797921207,214.08170785183012,532.2031241924001,0.5203252032520326,25151,24990,Cherokee+Etowah,Cherokee,1,19,Alabama,AL
01021,01CS004,339,425,538,529,-9,104,190,76,-227.20419018042338,74.75578525325331,304.36283995967415,0.672566371681416,403,522,672,653,-19,131,250,107,-278.64025178202843,53.05328078356749,316.10913133542294,0.7456536519036518,44946,45238,Bibb+Chilton+Coosa+Perry,Chilton,1,21,Alabama,AL
01023,01CS010,116,152,196,160,-36,8,44,31,-637.8969500221491,-218.97955000760342,123.77105000429759,0.96875,137,184,238,210,-28,26,73,23,-406.51891608240646,23.912877416612147,398.5479569435358,0.5348837209302325,12604,12546,Choctaw+Clarke+Washington,Choctaw,1,23,Alabama,AL
01025,01CS010,198,252,320,371,51,119,173,43,41.61936167387871,395.3839359018476,676.314627200529,0.3598389355742297,234,307,400,389,-11,82,155,53,-280.7723066377242,127.22495144521879,447.70021706843346,0.5824175824175825,23066,22794,Choctaw+Clarke+Washington,Clarke,1,25,Alabama,AL
01027,01CS011,125,161,209,218,9,57,93,40,-264.63016837272306,145.1197697527836,452.8590461991273,0.6896551724137931,147,198,258,235,-23,37,88,24,-331.20895673583004,91.61098803331468,451.3602910410617,0.5106382978723404,14057,14190,Clay+Talladega,Clay,1,27,Alabama,AL
01029,01CS008,140,164,189,189,-0,25,49,25,-200.35640133216157,3.130220703742115,193.488673576039,0.9246806718815931,170,201,233,262,29,61,92,41,-79.83789484145603,132.5110287824997,338.23440096733015,0.6612903225806451,15030,15093,Chambers+Cleburne+Randolph,Cleburne,1,29,Alabama,AL
01031,01CS012,380,479,598,616,18,137,236,70,-116.76207693862519,150.29892708718327,372.38241636526,0.4794520547945205,456,588,753,716,-37,128,260,128,-305.0742867444067,-0.9244675355891112,244.05942939552534,0.847682119205298,53493,54085,Coffee+Geneva,Coffee,1,31,Alabama,AL
01033,01CS013,516,647,809,675,-134,28,159,83,-457.08384514763475,-115.8507441618429,160.0846646600011,0.6916666666666667,614,786,1006,884,-122,98,270,117,-416.0914820937758,-32.2079180700203,266.4552357090057,0.7267080745341615,56970,57439,Colbert,Colbert,1,33,Alabama,AL
01035,01CS014,127,147,170,183,13,36,56,27,-147.14248589853517,91.38134273756089,303.96942530092645,0.7365534165944377,151,179,211,224,13,45,73,35,-193.65060735872308,88.02300334487413,334.92752772724566,0.7608695652173914,11602,11361,Conecuh+Marengo+Monroe+Wilcox,Conecuh,1,35,Alabama,AL
01037,01CS004,95,114,136,144,8,30,49,19,-122.55313590863383,123.31528862344783,350.27075742229243,0.6392767563315823,114,140,167,184,17,44,70,21,-38.313335235696854,220.3016776052569,469.3383566372865,0.4666666666666667,10433,10440,Bibb+Chilton+Coosa+Perry,Coosa,1,37,Alabama,AL
01039,01CS015,366,461,581,591,10,130,225,90,-256.5590135840426,128.2795067920213,433.1036848065618,0.6666666666666666,438,566,719,723,4,157,285,126,-325.328040773737,82.63145648493115,423.8194058420662,0.7544910179640718,37418,37516,Convington+Escambia,Covington,1,39,Alabama,AL
01041,01CS006,129,151,175,209,34,58,80,29,44.23172009759308,260.24950694534493,461.36951538980344,0.5023879328793467,154,184,219,241,22,57,87,30,-61.097657604908186,206.20459441656513,435.32081043497084,0.5263157894736842,13245,13094,Butler+Crenshaw+Pike,Crenshaw,1,41,Alabama,AL
01043,01CS016,756,944,1176,1043,-133,99,287,121,-348.26672808936996,-30.152963470941128,227.51781528073758,0.7076023391812866,910,1168,1483,1308,-175,140,398,187,-405.6706529987092,-52.080854126007665,236.32387571156167,0.7791666666666667,87554,89284,Cullman,Cullman,1,43,Alabama,AL
01045,01CS017,358,450,566,555,-11,105,197,86,-236.39797721318467,46.30475842320112,270.51727289343813,0.7543859649122807,432,547,704,736,32,189,304,96,-129.8574035277421,188.55173345948504,421.7071027911063,0.49230769230769234,49239,49323,Dale,Dale,1,45,Alabama,AL
01047,01CS018,340,427,532,560,28,133,220,100,-227.62502817833828,104.25573809694885,379.11177489799576,0.7352941176470589,398,511,656,678,22,167,280,101,-209.80168634846817,175.0557686346258,474.905081424693,0.5788013136288999,37984,37702,Dallas+Lowndes,Dallas,1,47,Alabama,AL
01049,01CS019,556,694,857,868,11,174,312,123,-187.9633666415863,85.43789392799378,316.70654602131805,0.6577540106951871,665,847,1080,1119,39,272,454,172,-185.3417390675973,139.30232173438355,392.9021984518287,0.6131926792069141,71631,71786,DeKalb,DeKalb,1,49,Alabama,AL
01051,01CS020,576,718,898,850,-48,132,274,93,-194.0520621778872,52.929538744942676,248.9750510833536,0.6,695,888,1129,1087,-42,198,392,157,-223.37969780350778,46.560810943473484,263.7137015003239,0.6870930054393627,87286,89131,Elmore,Elmore,1,51,Alabama,AL
01053,01CS015,321,402,511,515,4,114,194,58,-176.78573255474254,181.69644734792988,445.2381412489812,0.4853641456582633,378,484,629,658,29,174,280,108,-215.43007095838675,181.2283329377953,468.8772132623711,0.6067415730337079,36655,36694,Convington+Escambia,Escambia,1,53,Alabama,AL
01055,01CS009,940,1178,1475,1446,-29,268,506,222,-291.76752076312897,53.47133846654953,330.12739401087106,0.7589765767450558,1128,1424,1824,1820,-4,396,692,287,-282.085431137808,105.62456885613557,392.50671206585054,0.6768867924528302,103233,103196,Cherokee+Etowah,Etowah,1,55,Alabama,AL
01057,01CS021,151,194,244,236,-8,42,85,41,-361.40685261818106,11.052197327773122,324.1977882813449,0.8541666666666666,179,233,309,316,7,83,137,51,-272.088861748712,197.88280854451781,532.1192398517421,0.5930232558139535,16286,16171,Fayette+Lamar+Marion,Fayette,1,57,Alabama,AL
01059,01CS022,249,316,402,385,-17,68,136,49,-247.58994478462876,73.1515745954585,326.3685635797379,0.6242291463810451,298,382,495,491,-4,109,193,57,-190.50419850953887,162.39702168026264,424.73067208684074,0.48717948717948717,31988,32020,Franklin+Lawrence,Franklin,1,59,Alabama,AL
01061,01CS012,247,312,395,402,7,90,155,54,-212.28700562142396,162.2575839144642,455.44802373768334,0.574468085106383,292,378,488,528,40,150,236,81,-153.57410965253857,258.45398941524786,580.5850486864264,0.5364238410596026,26624,26697,Coffee+Geneva,Geneva,1,61,Alabama,AL
01063,01CS023,70,86,104,133,29,47,63,21,117.40597471454522,410.02692481104077,651.7572748907546,0.4421392124159185,83,103,128,137,9,34,54,23,-183.24757237870074,143.9802354404077,405.7624816956945,0.6764705882352942,7755,7640,Greene+Hale+Pickens+Sumter,Greene,1,63,Alabama,AL
01065,01CS023,141,164,188,216,28,52,75,37,-75.33423399471305,118.37351163692884,305.40167983299716,0.7174726621227534,171,201,239,262,23,61,91,40,-115.17972836780726,142.2808409249384,345.5391851034218,0.6557377049180327,14770,14760,Greene+Hale+Pickens+Sumter,Hale,1,65,Alabama,AL
01067,01CS003,148,188,242,228,-14,40,80,24,-265.2505750246612,111.68445264196262,390.89558424686913,0.5106382978723404,174,234,301,271,-30,37,97,37,-384.6945171461791,0,344.7896381287767,0.7115384615384616,17191,17416,Barbour+Bullock+Henry,Henry,1,67,Alabama,AL
01069,01CS024,778,972,1200,1210,10,238,432,171,-180.5389693393335,74.52415556217059,292.60536868094334,0.684,939,1182,1510,1602,92,420,663,244,-141.54862543608473,163.37904481442203,390.20129136162376,0.5700934579439252,107079,107419,Houston,Houston,1,69,Alabama,AL
01071,01CS025,485,604,757,747,-10,143,262,69,-180.95477680503507,169.3947309749854,441.7997713266511,0.44660661918726435,577,734,945,985,40,250,408,159,-225.84210804929904,173.50590164996527,472.1636012113809,0.62109375,52422,52736,Jackson,Jackson,1,71,Alabama,AL
01073,01CS026,4987,6152,7600,7235,-365,1082,2248,747,-199.01066660693633,60.03513792800176,268.65500544919644,0.5799703425078664,5881,7416,9388,9012,-376,1596,3131,1033,-210.78327801199768,84.12785601997282,313.7856859070293,0.5705606621292225,670607,668625,Jefferson,Jefferson,1,73,Alabama,AL
01075,01CS021,134,158,182,220,38,62,86,45,-57.80834743066944,148.05215557592763,353.912658582525,0.7240883443705581,157,188,221,242,21,54,85,34,-94.71048038248463,145.70843135766867,371.5564999620551,0.6296296296296297,13898,13726,Fayette+Lamar+Marion,Lamar,1,75,Alabama,AL
01077,01CS027,757,955,1180,1121,-59,166,364,130,-242.3847862935393,46.168530722578915,300.2878185747735,0.6326071513142316,927,1154,1470,1306,-164,152,379,174,-359.7579534443663,-23.409272332966747,218.1318558299174,0.7310924369747899,93570,93980,Lauderdale,Lauderdale,1,77,Alabama,AL
01079,01CS022,274,347,438,461,23,114,187,59,-130.77080738486762,199.78873350465886,465.1444968231193,0.5086206896551724,320,423,541,583,42,160,263,96,-163.36183853850844,193.4349244489277,504.8953770186463,0.5907748239036583,33035,33086,Franklin+Lawrence,Lawrence,1,79,Alabama,AL
01081,01CS028,814,1014,1264,1123,-141,108,309,130,-187.49605942524832,-14.872404639892414,123.821415373988,0.7065426081819525,992,1264,1617,1442,-175,178,450,189,-205.92485166075747,-5.937693100200338,147.5940856335513,0.7078651685393258,173476,176836,Lee,Lee,1,81,Alabama,AL
01083,01CS029,614,764,951,925,-26,162,311,91,-135.13185642480875,81.42560579443604,254.0940890039139,0.5041589932473911,752,956,1208,1149,-59,194,397,122,-169.49855121708853,66.79055614230825,256.8867543934933,0.5304347826086957,103899,107051,Limestone,Limestone,1,83,Alabama,AL
01085,01CS018,101,120,141,156,15,36,55,39,-278.07120243919366,-35.76684771212586,187.6377673462302,1.0843564333825062,118,145,174,184,10,39,66,33,-229.69183012791171,59.91960785945523,329.5578432270038,0.8461538461538461,10179,10013,Dallas+Lowndes,Lowndes,1,85,Alabama,AL
01087,01CS030,168,215,277,289,12,74,121,38,-162.41787464237916,224.88628796637119,518.4878305891335,0.5,202,260,341,246,-95,-14,44,30,-658.5973851488485,-231.82627957239467,73.76290713667103,-0.4724702380952381,19210,18980,Macon+Tallapoosa,Macon,1,87,Alabama,AL
01089,01CS031,2354,2911,3586,3158,-428,247,804,217,-199.68043737313934,9.283863806577575,181.66974158837883,0.43141153081510936,2822,3585,4562,4090,-472,505,1268,466,-237.8509114137304,9.888269422380862,203.35606385180947,0.6263440860215054,387770,394407,Madison,Madison,1,89,Alabama,AL
01091,01CS014,180,231,292,281,-11,50,101,35,-288.0259567366006,93.81952988162885,413.1186632454388,0.6140350877192983,213,279,362,350,-12,71,137,60,-378.2489350803998,57.78803174839441,404.7788951103443,0.759493670886076,19186,19035,Conecuh+Marengo+Monroe+Wilcox,Marengo,1,91,Alabama,AL
01093,01CS021,273,350,437,444,7,94,171,61,-220.69842423141546,134.87125925253167,449.57086417510556,0.6224489795918368,327,424,550,510,-40,86,183,72,-383.0510043836064,47.860009472293534,379.4615036731845,0.6956684092606422,29361,29252,Fayette+Lamar+Marion,Marion,1,93,Alabama,AL
01095,01CS032,779,975,1211,1227,16,252,448,147,-161.39812078931547,129.16770337559547,370.280749676707,0.5485074626865671,925,1182,1516,1424,-92,242,499,152,-248.6305365511514,91.19849598904938,353.6361791396602,0.5314685314685315,97548,98138,Marshall,Marshall,1,95,Alabama,AL
01097,01CS033,3029,3736,4657,4423,-234,686,1394,473,-204.98992174146832,61.8810156123061,266.9578896005364,0.5991136031830069,3619,4576,5778,5832,54,1256,2213,844,-191.20634906390956,99.57781767993265,331.34125603462394,0.6350671938907233,414020,413245,Mobile,Mobile,1,97,Alabama,AL
01099,01CS014,163,213,267,283,16,70,120,30,-84.60891981982833,241.7397709137952,543.9144845560393,0.4166666666666667,194,256,329,374,45,118,180,52,-35.861551520777745,333.1817907249565,651.1033467602203,0.4369747899159664,19856,19659,Conecuh+Marengo+Monroe+Wilcox,Monroe,1,99,Alabama,AL
01101,01CS034,1415,1760,2169,2377,208,618,962,337,-68.00114329407586,147.63406109898048,329.0318477576742,0.5404975408486644,1674,2112,2661,2780,119,668,1106,384,-116.48555052989171,125.00995520842774,317.4242236997123,0.5541125541125541,227996,227582,Montgomery,Montgomery,1,101,Alabama,AL
01103,01CS035,979,1203,1494,1492,-2,289,513,169,-167.20653829832057,117.23508382003195,336.07390695075827,0.544284825225599,1158,1484,1886,1693,-193,208,535,214,-329.2763080283261,-4.449133261652853,259.6675958164665,0.6782901346192485,122830,123620,Morgan,Morgan,1,103,Alabama,AL
01105,01CS004,78,95,113,141,28,46,63,23,64.04140428213503,330.5888722224996,562.3692791271643,0.49512732542494714,91,113,136,160,24,47,69,21,35.845952021188936,310.6649175169708,573.535232339023,0.44680851063829785,8513,8369,Bibb+Chilton+Coosa+Perry,Perry,1,105,Alabama,AL
01107,01CS023,156,205,260,277,17,72,121,37,-125.55540939121583,219.17403135623715,526.0176752549692,0.5,187,245,317,340,23,95,153,48,-132.96840009952723,249.4816289292527,557.3525752674794,0.4948453608247423,19163,18839,Greene+Hale+Pickens+Sumter,Pickens,1,107,Alabama,AL
01109,01CS006,209,268,340,359,19,91,150,45,-94.57477033600692,167.32459367139685,381.93657251079713,0.4838709677419355,250,327,421,457,36,130,207,74,-115.64271000026521,169.75076697286642,403.30963474535474,0.5584985190248348,32990,32990,Butler+Crenshaw+Pike,Pike,1,109,Alabama,AL
01111,01CS008,192,251,321,306,-15,55,114,54,-375.08487619392514,5.432076411208183,325.9245846724911,0.8852459016393442,234,300,388,356,-32,56,122,55,-395.9270229858264,4.548271372611447,304.9615955335973,0.7534246575342466,22091,21986,Chambers+Cleburne+Randolph,Randolph,1,111,Alabama,AL
01113,01CS036,425,535,674,637,-37,102,212,70,-217.6956057550543,65.07481909539223,288.769509735803,0.5714380914300946,506,642,818,854,36,212,348,124,-150.01148047044416,149.6713183832096,380.98153770271534,0.5688073394495413,59009,58796,Russell,Russell,1,113,Alabama,AL
01115,01CS037,658,825,1028,1035,7,210,377,136,-169.84602064945716,97.3178902675945,316.94069668230105,0.6167832167832168,792,1013,1293,1312,19,299,520,219,-216.17294375797925,86.44756561178875,325.3129953428625,0.7008017940525928,91247,92542,St. Clair,St. Clair,1,115,Alabama,AL
01117,01CS038,1095,1358,1673,1592,-81,234,497,148,-123.12642845743862,45.960749325959405,187.68649856325987,0.5333350648001455,1328,1681,2139,1935,-204,254,607,225,-189.47941372008927,12.807139023150192,168.74509726709266,0.6130835709194583,223234,226436,Shelby,Shelby,1,117,Alabama,AL
01119,01CS023,111,133,155,171,16,38,60,27,-103.54687251683322,105.56045487030505,322.29357730611076,0.6988703200413082,131,161,192,163,-29,2,32,14,-352.9478153658841,-98.49706475326998,147.74559712990498,0.44455645161290325,12291,12183,Greene+Hale+Pickens+Sumter,Sumter,1,119,Alabama,AL
01121,01CS011,687,863,1069,1038,-31,175,351,130,-236.71618982762635,66.060332044919,324.5030310784298,0.6532663316582915,816,1038,1331,1366,35,328,550,203,-205.93484703853773,152.56702443497738,425.2269677023064,0.5935672514619883,81743,81603,Clay+Talladega,Talladega,1,121,Alabama,AL
01123,01CS030,379,479,599,534,-65,55,155,79,-420.6686757436915,-70.11144595728193,222.3117098895478,0.8777777777777778,460,580,752,729,-23,149,269,99,-297.1765185892641,121.79365515953448,414.2202211975766,0.6111111111111112,41077,41053,Macon+Tallapoosa,Tallapoosa,1,123,Alabama,AL
01125,01CS039,1262,1578,1945,1887,-58,309,625,252,-165.59321043803354,30.44287371381362,199.26730144954138,0.7283297832351836,1504,1914,2444,2344,-100,430,840,362,-203.54291379616967,29.95221410547401,210.54644621200848,0.7494824016563147,224683,227028,Tuscaloosa,Tuscaloosa,1,125,Alabama,AL
01127,01CS040,691,863,1060,1111,51,248,420,165,-211.27430984920264,153.55313237726637,472.1296311166066,0.6432772981517509,815,1040,1330,1294,-36,254,479,201,-366.1011461378796,81.71556430957094,428.92962247023814,0.7178571428571429,64864,64859,Walker+Winston,Walker,1,127,Alabama,AL
01129,01CS010,137,159,183,188,5,29,51,24,-144.06847207214528,41.42909646590862,207.73726136209507,0.7960961361523939,161,189,223,243,20,54,82,32,-79.11012101376323,145.03522185856593,329.9551297282372,0.5925925925925926,15424,15169,Choctaw+Clarke+Washington,Washington,1,129,Alabama,AL
01131,01CS014,106,127,150,150,0,23,44,22,-247.38759897411984,6.480838727684657,251.416868436277,0.94061994381557,129,157,185,182,-3,25,53,25,-267.77602448237934,0,267.77602448237934,0.8928571428571429,10493,10456,Conecuh+Marengo+Monroe+Wilcox,Wilcox,1,131,Alabama,AL
01133,01CS040,208,263,336,327,-9,64,119,37,-234.5119114632566,137.648295858868,418.2978768600042,0.5285714285714286,250,322,417,424,7,102,174,71,-270.8591047718638,133.3134656299017,436.12548041782117,0.6574074074074074,23538,23629,Walker+Winston,Winston,1,133,Alabama,AL
02010,02CS007,52,100,197,19,-178,-81,-33,8,-2574.4686986360625,-1231.8694310677934,-567.4904120649385,-0.09876543209876543,62,122,231,28,-203,-94,-34,5,-2453.0280885766574,-1161.371145036293,-459.8322300143698,-0.05319148936170213,8670,8481,Southwest Alaska,Southwest Alaska,2,10,Alaska,AK
02020,02CS001,1180,1474,1835,1748,-87,274,568,117,-84.40375906270326,65.1486991050025,186.59414708740712,0.365625,1408,1796,2283,2370,87,574,962,278,-66.27660603924774,102.43063328764492,237.11565042441117,0.4688026981450253,290106,288488,Anchorage,Anchorage,2,20,Alaska,AK
02050,02CS007,90,107,127,115,-12,8,25,15,-176.8378376644556,-44.346303297257975,66.94658557118804,0.9178833702324984,108,133,160,146,-14,13,38,22,-193.85823891906082,-48.464559729765206,86.15921729736037,1.0476190476190477,18616,18570,Southwest Alaska,Bethel,2,50,Alaska,AK
02060,02CS007,3,9,20,1,-19,-8,-2,1,-2881.0083529235235,-1296.4537588155856,-432.1512529385285,-0.1111111111111111,4,12,26,15,-11,3,11,2,-1553.2047293092721,119.47728686994401,1075.295581829496,0.25,833,837,Southwest Alaska,Bristol Bay,2,60,Alaska,AK
02070,02CS007,34,73,138,53,-85,-20,19,5,-1710.3661252486859,-475.10170145796826,266.05695281646223,-0.125,40,87,170,65,-105,-22,25,11,-1869.968665934531,-531.9738446193062,225.68587347485717,-0.21568627450980393,6314,6203,Southwest Alaska,Dillingham,2,70,Alaska,AK
02090,02CS002,310,387,485,473,-12,86,163,19,-38.9199623268017,84.11733793211981,180.7895024212724,0.20430107526881722,364,466,601,684,83,218,320,90,-7.378472695399244,133.96375957604306,240.71613048820237,0.41284403669724773,95581,95548,Fairbanks North Star,Fairbanks North Star,2,90,Alaska,AK
02100,02CS006,5,9,15,19,4,10,14,7,-155.992327408113,164.77857228689348,393.90064349761235,0.7030692485939118,5,10,17,21,4,11,16,6,-96.47659437621853,241.19148594054633,482.38297188109266,0.5454545454545454,2153,2073,Southeast Alaska,Haines,2,100,Alaska,AK
02110,02CS006,137,162,188,171,-17,9,34,4,-79.40203855880709,18.798832082868213,110.86214830943887,0.19468067311448567,166,197,232,218,-14,21,52,13,-84.3608300168331,24.995801486469066,121.8545322465367,0.4482758620689655,32149,32005,Southeast Alaska,Juneau,2,110,Alaska,AK
02122,02CS003,307,384,487,393,-94,8,86,18,-227.84641134485258,-19.326258105143747,138.3353211736605,0.22784810126582278,364,473,610,589,-21,116,225,66,-145.87637256881447,83.83699572920372,266.68548341459694,0.5038167938931297,58987,59640,Kenai Peninsula,Kenai Peninsula,2,122,Alaska,AK
02140,02CS005,39,52,65,52,-13,0,13,6,-294.2637148591035,-89.80041386076714,114.02592981358688,0.42309897266850427,46,63,84,69,-15,6,23,3,-237.0708578452893,39.51180964088155,263.41206427254366,0.1875,7744,7593,Northern Alaska,Northern Alaska,2,140,Alaska,AK
02150,02CS007,40,53,67,66,-1,13,26,3,-40.68625195073956,95.64934365630366,209.64104998330333,0.21120035794045527,47,64,83,104,21,40,57,1,155.98900277530436,304.1785554118435,436.7692077708522,0.025,13026,12821,Southwest Alaska,Kodiak Island,2,150,Alaska,AK
02158,02CS007,38,50,64,52,-12,2,14,5,-245.8159069509807,-45.22545376316595,131.76612257902363,0.4590324008536038,46,61,80,84,4,23,38,10,-71.77409104842508,155.510530604921,334.9457582259837,0.4166666666666667,8361,8360,Southwest Alaska,Southwest Alaska,2,158,Alaska,AK
02170,02CS004,419,524,658,639,-19,115,220,33,-57.910828871123236,91.14564236913832,207.8565258905959,0.2619047619047619,511,646,836,991,155,345,480,165,-9.07313056650737,163.31635019713266,285.8036128449821,0.4782608695652174,107959,110216,Matanuska-Susitna,Matanuska-Susitna,2,170,Alaska,AK
02180,02CS005,47,60,76,66,-10,6,19,7,-209.18999691087382,-12.184581842070923,145.91226375064286,0.5963501656806083,55,73,94,94,0,21,39,4,-40.44753512299633,171.9020242727344,353.91593232621784,0.18181818181818182,10016,9889,Northern Alaska,Nome,2,180,Alaska,AK
02185,02CS005,38,51,67,45,-22,-6,7,8,-329.94511824608963,-155.78841363102794,-9.130136060449667,-0.6821060609125499,46,64,88,59,-29,-5,13,4,-300.68165898827453,-82.00408881498397,82.45966708617792,-0.21052631578947367,10763,10975,Northern Alaska,North Slope,2,185,Alaska,AK
02195,02CS006,183,211,241,231,-10,20,48,5,-70.78700372576338,69.91821647796283,206.71495834269652,0.1902259119753311,224,261,308,348,40,87,124,16,96.25990173468365,284.7688759651058,433.1695578060764,0.1839080459770115,25242,24932,Southeast Alaska,Petersburg,2,195,Alaska,AK
02220,02CS006,35,49,62,56,-6,7,21,3,-123.19791639923875,63.91008672654454,251.01808985232793,0.27824861010906593,43,58,76,76,0,18,33,8,-95.12414444006808,118.90518055008509,297.2629513752127,0.42105263157894735,8436,8410,Southeast Alaska,Sitka,2,220,Alaska,AK
02232,02CS006,33,70,133,18,-115,-52,-15,1,-3302.29869725668,-1522.3867324707658,-455.29322840247204,-0.018867924528301886,40,84,163,42,-121,-42,2,5,-3010.9175631879484,-1123.1200434113775,-71.68851340923688,-0.10869565217391304,4217,4185,Southeast Alaska,Southeast Alaska,2,232,Alaska,AK
02240,02CS005,45,84,140,107,-33,23,62,5,-330.21750528847025,156.21327451228555,494.6753692889041,0.13157894736842105,57,103,178,145,-33,42,88,10,-311.05324074074076,231.48148148148147,564.2361111111111,0.18693221523410203,13827,13824,Northern Alaska,Southeast Fairbanks,2,240,Alaska,AK
02261,02CS005,42,53,68,5,-63,-48,-37,5,-849.9854877315292,-665.6512855728844,-522.2802394494939,-0.1032209487480663,49,67,86,3,-83,-64,-46,3,-896.9350373940213,-698.7749709930165,-511.0443817710121,-0.046875,9634,9588,Northern Alaska,Valdez-Cordova,2,261,Alaska,AK
04001,04CS001,445,556,688,1042,354,486,597,300,96.99339575204434,333.49907158487906,534.0479742010151,0.6179203258241059,527,671,854,1194,340,523,667,270,106.605004978073,385.3009465636067,604.7549639541826,0.5162523900573613,66747,65663,Apache,Apache,4,1,Arizona,AZ
04003,04CS002,910,1135,1398,1387,-11,252,477,171,-173.84083081675618,77.3050084883736,292.0888623193424,0.6162182167623302,1082,1387,1762,1833,71,446,751,311,-190.70315503099985,107.1812070324104,349.37103818231253,0.6820175438596491,125736,125955,Cochise+Graham+Greenee,Cochise,4,3,Arizona,AZ
04005,04CS003,588,732,914,1027,113,295,439,207,-77.86575212315863,72.85684409184434,192.11853035809634,0.6946308724832215,703,887,1139,1194,55,307,491,184,-88.92790176109415,84.79172028383395,211.6346189198132,0.5822784810126582,144942,145061,Coconino,Coconino,4,5,Arizona,AZ
04007,04CS004,515,645,807,834,27,189,319,118,-204.3110504774898,159.40752290001947,451.5049697914635,0.6113989637305699,609,783,1010,1054,44,271,445,157,-211.12006383712972,212.89418202063501,537.8379335258147,0.5678137916601266,53448,53548,Gila,Gila,4,7,Arizona,AZ
04009,04CS002,198,254,320,322,2,68,124,50,-148.99353138269925,57.36483518376558,229.4593407350623,0.6803035912624953,240,310,403,489,86,180,249,88,-5.129991856137929,234.69712741831023,412.96434441910327,0.4888888888888889,38700,38986,Cochise+Graham+Greenee,Graham,4,9,Arizona,AZ
04011,04CS002,39,51,65,62,-3,11,23,7,-126.17960854135302,50.85418986995589,207.12156031512842,0.5187827827058248,46,61,79,96,17,35,50,25,-84.91479773029822,106.14349716287278,265.3587429071819,0.7142857142857143,9502,9421,Cochise+Graham+Greenee,Greenlee,4,11,Arizona,AZ
04013,04CS006,21858,26966,33391,34979,1588,8014,13120,4403,-75.88349580599706,97.31210343197445,234.95866546689848,0.5379355364686929,26384,33050,41898,44161,2263,11111,17777,6755,-100.0926052022587,97.05679520530668,245.58087490205907,0.5978405590050747,4452272,4488094,Maricopa,Maricopa,4,13,Arizona,AZ
04015,04CS007,2291,2860,3555,3445,-110,585,1154,326,-244.04118888811803,144.95279881211462,463.429208711859,0.4988549618320611,2805,3528,4468,4621,153,1092,1816,767,-282.59775503551367,149.88686534798717,483.22972809885613,0.6823843416370107,214415,217164,Mohave,Mohave,4,15,Arizona,AZ
04017,04CS008,752,937,1157,1519,362,582,767,365,-3.4585441497028917,242.09809047920285,448.4950800582467,0.627147766323024,922,1167,1478,1845,367,678,923,366,0.6947605980422163,289.0204087855565,516.2071243453568,0.5394254955882545,107560,107951,Navajo,Navajo,4,17,Arizona,AZ
04019,04CS009,6654,8220,10205,10505,300,2285,3851,1182,-101.13651405377337,126.44213658408843,305.9601654967651,0.5042665787214897,7926,10012,12757,12824,67,2812,4898,1745,-159.60541677056818,101.5134595220531,299.99272780219104,0.5911252717517597,1046803,1051092,Pima+Santa Cruz,Pima,4,19,Arizona,AZ
04021,04CS010,2084,2572,3193,3650,457,1078,1566,389,18.632318851381335,189.48586994246105,323.70731961650773,0.35968569870097,2523,3174,4030,4938,908,1764,2415,880,6.257778494231847,197.92043609663511,343.7076442010739,0.49830140552880875,436339,446644,Pinal,Pinal,4,21,Arizona,AZ
04023,04CS009,203,258,327,413,86,155,210,103,-42.909371043799375,131.25219378103336,270.2028335434542,0.6645161290322581,248,318,414,427,13,109,179,79,-137.9325958931963,62.6966344969074,208.98878165635801,0.6929824561403509,47542,47849,Pima+Santa Cruz,Santa Cruz,4,23,Arizona,AZ
04025,04CS005,2103,2612,3217,3143,-74,531,1040,252,-164.79362238181395,140.99178363853449,398.2386204170146,0.4186058062433258,2534,3201,4047,4118,71,917,1584,595,-217.0215915641362,133.33515070339985,409.5500956621044,0.6217345872518286,237461,241497,La Paz+Yavapai,Yavapai,4,25,Arizona,AZ
04027,04CS011,1248,1546,1913,2445,532,898,1197,576,-23.664959066563757,173.256510759746,333.80754406377713,0.6410686459342353,1503,1887,2413,2633,220,746,1130,468,-111.2078649507768,124.63530117442431,296.97274639546265,0.6194575843582466,223368,223051,Yuma,Yuma,4,27,Arizona,AZ
05001,05CS001,157,200,254,259,5,59,102,22,-119.12481219472139,259.2716500708642,560.5873515045712,0.36065573770491804,181,240,315,336,21,96,155,30,-53.94015176255404,393.37569241199645,745.3277323654565,0.30612244897959184,17125,16778,Arkansas (county)+Monroe+Phillips+Prairie,Arkansas (county),5,1,Arkansas,AR
05003,05CS029,162,205,264,248,-16,43,86,21,-233.14123685626896,138.6245192118356,409.887498851359,0.42,186,247,326,323,-3,76,137,37,-213.7242111684258,208.38110588921515,534.3105279210645,0.4567901234567901,19044,18716,Southeast Arkansas,Ashley,5,3,Arkansas,AR
05005,05CS002,463,579,731,708,-23,129,245,75,-281.656126849042,155.19827397804352,488.7308609253018,0.5208333333333334,555,704,909,928,19,224,373,125,-251.9449227007426,235.30705044692,589.4560455640016,0.5319148936170213,41753,42073,Baxter+Marion,Baxter,5,5,Arkansas,AR
05007,05CS003,1325,1656,2048,1959,-89,303,634,282,-155.61546134238515,8.806048742091319,147.6061503436259,0.7768653997935766,1598,2036,2618,2520,-98,484,922,372,-160.65109086012137,38.44553865510244,187.9730536643475,0.6908083950038278,286167,292622,Benton,Benton,5,7,Arkansas,AR
05009,05CS004,305,381,477,478,1,97,173,63,-198.8766558308952,108.97351004432613,352.7216111875907,0.6176470588235294,365,468,601,582,-19,114,217,68,-230.40076270597314,123.14523523939943,394.72682392327914,0.5354330708661418,37440,37760,Boone+Carroll+Madison,Boone,5,9,Arkansas,AR
05011,05CS005,98,117,138,167,29,50,69,27,21.406907074900957,264.97234574283,480.434079949075,0.5372638709840762,115,140,169,165,-4,25,50,18,-211.1096450719092,67.17125070469838,307.06857465004975,0.6428571428571429,10532,10421,Bradley+Calhoun+Cleveland+Union,Bradley,5,11,Arkansas,AR
05013,05CS005,53,67,82,69,-13,2,16,4,-431.5674416408243,-39.96498992680101,310.416151080483,0.2874405806734211,64,83,106,89,-17,6,25,2,-400.9566685424873,84.41193021947102,485.36859876195837,0.11764705882352941,4787,4739,Bradley+Calhoun+Cleveland+Union,Calhoun,5,13,Arkansas,AR
05015,05CS004,220,280,353,314,-39,34,94,38,-327.31351836514347,-19.116298931124536,238.10412335322874,0.71698113207547165,263,342,444,394,-50,52,131,40,-317.2421179109612,44.012502484872535,320.5870680998114,0.5194805194805194,28248,28401,Boone+Carroll+Madison,Carroll,5,15,Arkansas,AR
05017,05CS029,107,127,149,149,0,22,42,25,-294.17994051687634,-40.64387066667549,202.6728950244961,1.058653551645387,128,154,182,171,-11,17,43,13,-239.11328822284028,39.852214703806716,298.89161027855033,0.5416666666666666,10137,10037,Southeast Arkansas,Chicot,5,17,Arkansas,AR
05019,05CS006,153,197,250,243,-7,46,90,18,-139.50892857142856,156.24999999999997,401.7857142857142,0.34615384615384615,179,239,308,291,-17,52,112,35,-243.82262294921827,79.71124211801366,361.0450378286501,0.5645161290322581,21504,21327,Clark+Dallas+Ouachita,Clark,5,19,Arkansas,AR
05021,05CS007,153,196,252,216,-36,20,63,27,-522.1712274405603,-57.973014941854444,298.14693398668004,0.6585365853658537,181,240,311,280,-31,40,99,41,-500.9378089188962,-6.957469568318003,403.88110844085975,0.7321428571428571,14490,14373,Clay+Greene,Clay,5,21,Arkansas,AR
05023,05CS030,246,316,396,368,-28,52,122,38,-320.202533691089,67.87033265216118,407.2219959129671,0.5757575757575758,296,384,494,457,-37,73,161,61,-393.16681549233476,48.06929990736646,400.5774992280538,0.6630434782608695,24753,24964,Van Buren and Nearby Counties,Cleburne,5,23,Arkansas,AR
05025,05CS005,72,90,108,110,2,20,38,20,-279.56734960399734,6.08988105533138,278.762692139236,0.9078569914312965,86,109,134,135,1,26,49,11,-133.0074650439756,199.5111975659634,505.4283671671073,0.39285714285714285,7598,7518,Bradley+Calhoun+Cleveland+Union,Cleveland,5,25,Arkansas,AR
05027,05CS008,179,235,300,319,19,84,140,30,-57.78343614456073,283.66414107329814,577.8343614456073,0.35294117647058826,216,279,372,306,-66,27,90,24,-397.23019015576733,13.226310438038869,291.19926814415555,0.4,22844,22682,Columbia+Lafayette+Miller,Columbia,5,27,Arkansas,AR
05029,05CS009,182,233,288,229,-59,-4,47,11,-404.724839108315,-86.6648477747998,208.28451748543517,-0.17055288461538462,216,284,370,301,-69,17,85,27,-460.62727795894875,-47.957030500671394,278.1507769038941,0.4576271186440678,20770,20852,Conway+Pope,Conway,5,29,Arkansas,AR
05031,05CS010,656,824,1027,1005,-22,180,349,99,-130.24809320727857,87.69285085826687,268.9964750253585,0.49748743718592964,791,1004,1273,1190,-83,186,399,104,-166.779079036115,73.13307209070284,263.18987285324874,0.4444444444444444,111526,112124,Craighead,Craighead,5,31,Arkansas,AR
05033,05CS011,403,510,644,663,19,153,260,56,-73.34656775676521,192.02745134699666,403.95053038509957,0.3522012578616352,477,617,790,874,84,257,397,123,-65.38116396840458,222.080506255164,454.18778163602747,0.4749105545617174,60616,60338,Crawford,Crawford,5,33,Arkansas,AR
05035,05CS012,345,434,554,555,1,121,210,68,-167.66102092246382,132.52847291410265,355.2013127820429,0.5271317829457365,408,524,676,687,11,162,279,87,-159.65030980387695,158.59997881832513,403.43213155045476,0.5117647058823529,47990,47604,Crittenden,Crittenden,5,35,Arkansas,AR
05037,05CS013,154,198,252,223,-29,24,69,29,-416.99119285842664,-32.352764963153795,287.5801330058115,0.7073170731707317,183,242,316,266,-50,24,83,29,-473.2575771758054,-29.95301121365857,323.4925211075126,0.5471698113207547,16691,16693,Cross+Lee+St. Francis,Cross,5,37,Arkansas,AR
05039,05CS006,68,85,101,105,4,20,37,14,-186.7840439285165,116.56821534062145,420.6788552579315,0.6622311789596316,79,100,122,120,-2,20,41,1,-47.40849994897002,300.2538330101434,632.1133326529335,0.043478260869565216,6505,6328,Clark+Dallas+Ouachita,Dallas,5,39,Arkansas,AR
05041,05CS029,117,139,161,151,-10,12,34,13,-245.4200225652758,-10.005225650147134,225.84552459260186,0.641086406071352,142,170,201,192,-9,22,50,24,-296.6292134831461,-17.97752808988764,233.7078651685393,0.8571428571428571,11315,11125,Southeast Arkansas,Desha,5,41,Arkansas,AR
05043,05CS029,130,167,213,238,25,71,108,23,13.446376110654887,330.987719646889,586.1240868746993,0.323943661971831,152,202,261,223,-38,21,71,24,-362.039352209201,-17.50391710922809,274.22803471124007,0.5333333333333333,17402,17139,Southeast Arkansas,Drew,5,43,Arkansas,AR
05045,05CS014,676,848,1053,954,-99,106,278,70,-163.61708419613504,34.80186133566241,201.07742105049388,0.43478260869565216,830,1042,1326,1189,-137,147,359,117,-203.4092364847553,24.019984627209837,193.76120932615936,0.5294226044226045,124131,124896,Faulkner,Faulkner,5,45,Arkansas,AR
05047,05CS015,146,187,241,242,1,55,96,22,-146.3669628855201,230.0052273915316,515.769297787071,0.3793103448275862,172,229,298,275,-23,46,103,31,-314.58334091877265,87.38426136632575,419.7357354295844,0.5344827586206896,17217,17166,Franklin+Johnson+Logan,Franklin,5,47,Arkansas,AR
05049,05CS028,136,159,183,183,-0,24,47,35,-350.03794420599615,-105.73615408803292,122.27885002206625,1.3063886962960047,166,197,232,255,23,58,89,43,-164.89858736876823,123.67394052657617,379.26675094816693,0.7413793103448276,12115,12129,Sharp and Nearby Counties,Fulton,5,49,Arkansas,AR
05051,05CS016,966,1203,1482,1365,-117,162,399,137,-304.9194947485171,29.97635614908741,314.2121651547342,0.5930735930735931,1152,1467,1866,1705,-161,238,553,229,-388.9617219394749,8.972588741395038,323.1627378359111,0.7351543820595268,100079,100306,Garland,Garland,5,51,Arkansas,AR
05053,05CS017,147,169,194,201,7,32,54,14,-47.03922072461114,117.36826372090822,265.3623553765252,0.44251974457486487,178,208,241,306,65,98,128,39,143.582531714149,326.44968674893227,492.7177051693628,0.3979591836734694,18032,18073,Grant+Hot Spring,Grant,5,53,Arkansas,AR
05055,05CS007,335,428,538,495,-43,66,160,56,-259.537949591606,27.512856847166717,272.6393099950186,0.6292134831460674,413,523,680,612,-68,89,199,73,-305.0110306556269,34.59891166600518,272.4664293697908,0.6134453781512605,45797,46244,Clay+Greene,Greene,5,55,Arkansas,AR
05057,05CS018,148,190,243,226,-17,36,78,20,-219.8940562983262,95.08932164251945,344.698790954133,0.45454545454545453,172,229,300,280,-20,51,108,29,-248.2570811849209,111.4623629809849,400.5045360748569,0.4603174603174603,20192,19738,Hempstead+Howard+Nevada+Pike,Hempstead,5,57,Arkansas,AR
05059,05CS017,281,355,451,441,-10,86,160,51,-220.96048137172843,126.67677064718256,394.6886239735787,0.5483870967741935,336,432,556,526,-30,94,190,53,-250.5178248714398,125.2589124357199,413.6562397425399,0.49303392177223954,33155,33131,Grant+Hot Spring,Hot Spring,5,59,Arkansas,AR
05061,05CS018,122,141,166,171,5,30,49,18,-122.41243387231191,108.51556631355967,293.64284646256624,0.5918663298484232,144,174,204,164,-40,-10,20,14,-424.9856124662446,-188.88249442944206,47.220623607360515,-0.5384615384615384,12817,12706,Hempstead+Howard+Nevada+Pike,Howard,5,61,Arkansas,AR
05063,05CS019,272,349,434,452,18,103,180,72,-171.29840546697037,98.24700406061206,342.27988511439037,0.6728971962616822,320,415,533,545,12,130,225,76,-169.67945572764745,143.05527883361378,394.7266027075639,0.5588235294117647,37864,37748,Independence+Jackson+Woodruff,Independence,5,63,Arkansas,AR
05065,05CS028,134,176,221,191,-30,15,57,10,-352.4924613428677,44.061557667858466,414.1786420778696,0.2777777777777778,163,217,283,263,-20,46,100,35,-396.7639690223525,79.35279380447051,468.90287248096206,0.625,13617,13862,Sharp and Nearby Counties,Izard,5,65,Arkansas,AR
05067,05CS019,145,189,240,239,-1,50,94,22,-164.76361868067224,200.58179665473145,515.7817628264522,0.4074074074074074,176,232,301,254,-47,22,78,22,-410.7091925943379,2.9761535695241874,333.62681514366113,0.4489795918367347,16751,16800,Independence+Jackson+Woodruff,Jackson,5,67,Arkansas,AR
05069,05CS020,541,670,837,901,64,230,360,132,-122.22964243585504,177.05323205781943,409.91867584554024,0.5653130846263894,629,803,1026,999,-27,196,370,102,-195.45590278720368,142.42523148834997,406.2149421492193,0.4722222222222222,66760,66000,Jefferson,Jefferson,5,69,Arkansas,AR
05071,05CS015,181,228,290,272,-18,44,91,20,-176.70435351190713,111.45609682748412,329.9564866496975,0.38461538461538464,210,277,357,354,-3,77,144,46,-189.7556170325029,120.04947200015489,379.5112340650058,0.5542168674698795,25840,25823,Franklin+Johnson+Logan,Johnson,5,71,Arkansas,AR
05073,05CS008,62,78,95,105,10,27,43,8,30.895495172724456,358.0345188571234,654.0174450477699,0.29744524084746765,74,93,115,105,-10,12,31,13,-372.04161204552116,-16.175722262848748,291.16300073127746,0.7434640522875817,6333,6182,Columbia+Lafayette+Miller,Lafayette,5,73,Arkansas,AR
05075,05CS028,155,199,256,230,-26,31,75,32,-428.5296486898342,-7.388442218790245,318.0724375189197,0.7272727272727273,183,242,313,251,-62,9,68,18,-491.46086742843096,-55.289347585698486,307.16304214276937,0.32727272727272727,16242,16278,Sharp and Nearby Counties,Lawrence,5,75,Arkansas,AR
05077,05CS013,79,95,115,144,29,49,65,17,166.2080251681114,453.3093230939401,671.5063095175697,0.3437628434949444,95,117,142,155,13,38,60,27,-162.67956483216406,127.81965808241462,383.4589742472439,0.6923076923076923,8591,8606,Cross+Lee+St. Francis,Lee,5,77,Arkansas,AR
05079,05CS029,103,125,146,151,5,26,48,27,-207.60077261949493,-8.983785990883744,197.27231550805857,1.005388831828613,129,158,187,176,-11,18,47,28,-299.6782301054957,-76.84057182192197,145.99708646165175,1.0769230769230769,12915,13014,Southeast Arkansas,Lincoln,5,79,Arkansas,AR
05081,05CS021,121,142,167,192,25,50,71,28,-28.902599163206844,217.20758927849377,430.5030859279679,0.5626108359708157,146,175,207,200,-7,25,54,35,-351.52510632065156,-83.69645388586942,159.02326238315192,1.206896551724138,12026,11948,Little River+Polk+Sevier,Little River,5,81,Arkansas,AR
05083,05CS015,187,238,301,285,-16,48,98,12,-158.73515794778118,201.25350382665113,487.5436994110422,0.21428571428571427,223,290,374,375,1,85,152,37,-169.82901127672497,226.43868170229996,542.7452152052,0.4111111111111111,21167,21198,Franklin+Johnson+Logan,Logan,5,83,Arkansas,AR
05085,05CS022,470,587,745,674,-71,87,204,75,-236.7417624986707,19.4449086241208,209.03276770929858,0.638309430682312,560,714,921,836,-85,122,276,85,-227.94631669931235,49.58267911742831,256.0208336590453,0.5279503105590062,74055,74623,Lonoke,Lonoke,5,85,Arkansas,AR
05087,05CS004,142,165,191,154,-37,-11,12,10,-338.0969183201866,-153.73311021644233,12.78903903855242,-0.5361471652686751,174,207,238,260,22,53,86,32,-59.17035762317604,124.25775100866969,319.51993116515064,0.6037735849056604,16589,16900,Boone+Carroll+Madison,Madison,5,87,Arkansas,AR
05089,05CS002,173,223,283,268,-15,45,95,23,-271.10090211111066,156.7469079223242,513.3461234456114,0.4339622641509434,208,272,349,305,-44,33,97,43,-513.233726226214,-58.95849813052429,318.67068239548354,0.7166666666666667,16842,16961,Baxter+Marion,Marion,5,89,Arkansas,AR
05091,05CS008,330,418,520,503,-17,86,173,61,-219.51101688092103,68.86069031475756,314.7917271531774,0.6288659793814433,391,505,644,656,12,151,265,102,-211.19916505382832,114.92236632579221,382.41003733511053,0.6538461538461539,42695,42637,Columbia+Lafayette+Miller,Miller,5,91,Arkansas,AR
05093,05CS023,336,426,535,571,36,144,235,82,-136.6249242826944,185.4301361057199,453.93297318680226,0.5559385916528774,401,514,655,594,-61,80,193,61,-306.7832272564937,49.01493594020178,332.04477116413597,0.5304347826086957,40446,39784,Mississippi+Poinsett,Mississippi,5,93,Arkansas,AR
05095,05CS001,90,109,128,116,-12,7,26,11,-413.41017786594864,-62.64330586370511,273.50827980511167,0.7394712342313282,111,135,164,136,-28,1,25,20,-716.9574119828976,-283.7956422432303,74.6830637482185,0.8,6750,6695,Arkansas (county)+Monroe+Phillips+Prairie,Monroe,5,95,Arkansas,AR
05097,05CS024,97,116,136,135,-1,19,38,21,-315.0763147895137,-21.19676334832391,238.1087232174317,0.9747838589660047,119,144,172,173,1,29,54,34,-384.21982030931633,-58.21512428929035,232.8604971571614,1.096774193548387,8561,8589,Montgomery+Perry+Scott+Yell,Montgomery,5,97,Arkansas,AR
05099,05CS018,82,99,118,118,-0,19,36,22,-325.77712250539423,-50.54534513887348,200.20811797162244,1.091048171154949,98,120,146,115,-31,-5,17,18,-598.0871575364215,-280.448616174061,-12.193418094524391,-0.782608695652174,8262,8201,Hempstead+Howard+Nevada+Pike,Nevada,5,99,Arkansas,AR
05101,05CS030,61,76,92,124,32,48,63,17,246.13698812912642,517.4147063910805,761.5646528268388,0.3515145028737647,73,91,114,139,25,48,66,15,138.8286334056399,458.1344902386117,708.7201735357911,0.3125,7274,7203,Van Buren and Nearby Counties,Newton,5,101,Arkansas,AR
05103,05CS006,220,280,352,341,-11,61,121,38,-259.30546853036344,121.7148117591502,439.23171200041156,0.5588235294117647,257,335,437,393,-44,58,136,46,-402.7258574238597,53.69678098984795,402.7258574238597,0.5897435897435898,22676,22348,Clark+Dallas+Ouachita,Ouachita,5,103,Arkansas,AR
05105,05CS024,90,107,127,111,-16,4,21,7,-279.66692063875223,-34.36633817452884,171.68615109541878,0.4478410041375984,105,130,158,152,-6,22,47,20,-260.813411828139,20.06257014062608,270.844696898452,0.8,10055,9969,Montgomery+Perry+Scott+Yell,Perry,5,105,Arkansas,AR
05107,05CS001,148,191,242,266,24,75,118,38,-101.31506043850425,267.7612311589041,578.9432025057386,0.4935064935064935,172,226,292,311,19,85,139,52,-206.76145405539967,206.4486530659059,544.2737217192064,0.5909090909090909,16582,15985,Arkansas (county)+Monroe+Phillips+Prairie,Phillips,5,107,Arkansas,AR
05109,05CS018,97,116,136,129,-7,13,32,18,-289.59104868995325,-57.730912637776314,164.00643161170677,1.0472703985155203,118,141,171,177,6,36,59,27,-208.3242914804045,89.28183920588764,317.94254961652166,0.75,10233,10080,Hempstead+Howard+Nevada+Pike,Pike,5,109,Arkansas,AR
05111,05CS023,220,280,350,352,2,72,132,49,-245.93225537722714,120.22193142776248,433.84436123931675,0.6447368421052632,259,338,430,423,-7,85,164,40,-207.3237119610469,198.2904790275688,546.4004310981896,0.42105263157894735,22958,22694,Mississippi+Poinsett,Poinsett,5,111,Arkansas,AR
05113,05CS021,178,226,292,258,-34,32,80,51,-528.8194837770046,-118.06780483857918,180.51945950319578,1.1333333333333333,213,278,361,374,13,96,161,72,-305.51432664293174,124.17178390229232,460.72905652079686,0.7272727272727273,19311,19328,Little River+Polk+Sevier,Polk,5,113,Arkansas,AR
05115,05CS009,410,511,638,642,4,131,232,56,-98.34878179356096,141.71294206564983,332.6475126754353,0.4,487,626,795,753,-42,127,266,93,-211.928254844838,53.35476241928539,271.5600481369804,0.6305157198014342,63509,63724,Conway+Pope,Pope,5,115,Arkansas,AR
05117,05CS001,75,94,113,127,14,33,52,14,5.338268030781108,281.6030419634929,557.8678158962047,0.42073820774258563,92,115,138,145,7,30,53,20,-160.09364353606577,122.67712148357532,404.83450089579856,0.6451612903225806,8214,8151,Arkansas (county)+Monroe+Phillips+Prairie,Prairie,5,117,Arkansas,AR
05119,05CS025,2625,3226,4008,3803,-205,576,1178,342,-164.95732191656364,70.71107209475215,252.1173875412464,0.5066677786947131,3130,3961,5008,4725,-283,764,1595,479,-191.4932507935963,71.60739549455481,280.41204821648387,0.5200868621064061,397957,398004,Pulaski,Pulaski,5,119,Arkansas,AR
05121,05CS028,167,218,276,258,-18,40,91,44,-401.09258194364577,-25.876940770557795,304.05405405405406,0.8979591836734694,206,266,349,285,-64,19,79,24,-467.49866081112793,-26.562423909723176,292.4522872460519,0.4102863822326125,18549,18824,Sharp and Nearby Counties,Randolph,5,121,Arkansas,AR
05123,05CS013,159,205,262,271,9,66,112,32,-118.47718187427895,175.14018190110804,412.094545649666,0.47058823529411764,187,246,319,337,18,91,150,46,-122.89449452781174,197.50900906255458,456.68471984352874,0.4946236559139785,23296,22784,Cross+Lee+St. Francis,St. Francis,5,123,Arkansas,AR
05125,05CS026,814,1012,1263,1101,-162,90,287,98,-252.3170518270687,-8.247240686522145,183.37982232384533,0.5414364640883977,979,1252,1604,1581,-23,329,602,165,-150.3919790944483,131.19300303983786,349.62135352781183,0.4628340100084978,123678,125007,Saline,Saline,5,125,Arkansas,AR
05127,05CS024,93,111,132,141,9,30,48,14,-55.23950542470257,194.61996888604617,414.4963062795053,0.4665160026308078,114,138,166,181,15,43,67,19,-40.731555712070325,244.38933427242196,488.7786685448439,0.4368393234672304,9871,9820,Montgomery+Perry+Scott+Yell,Scott,5,127,Arkansas,AR
05129,05CS030,85,103,121,91,-30,-12,6,15,-686.7812651629922,-409.85079205662026,-132.92031895024851,-0.9446106121462077,102,126,153,158,5,32,56,15,-127.02814996731671,215.9478549444384,520.8154148659985,0.45454545454545453,7838,7872,Van Buren and Nearby Counties,Searcy,5,129,Arkansas,AR
05131,05CS027,882,1102,1355,1345,-10,243,463,111,-113.66160125977679,123.94325787931051,330.56230254857013,0.4188679245283019,1062,1347,1721,1711,-10,364,649,217,-177.0410125852206,114.57199581786236,336.70137546473836,0.5528671392221011,127800,128304,Sebastian,Sebastian,5,131,Arkansas,AR
05133,05CS021,100,120,141,175,34,55,75,29,34.5281045892346,195.32333844138054,343.74970815105377,0.5275985560620138,118,143,170,229,59,86,111,35,151.75255990041572,323.1474135666472,481.5530084522585,0.4069767441860465,15953,15782,Little River+Polk+Sevier,Sevier,5,133,Arkansas,AR
05135,05CS028,192,245,312,240,-72,-5,48,26,-679.1194354145962,-214.82349487604577,152.45538346041957,-0.33988380041011623,231,302,395,347,-48,45,116,42,-512.1663212705519,17.072210709018393,421.11453082245373,0.6131713554987213,17317,17572,Sharp and Nearby Counties,Sharp,5,135,Arkansas,AR
05137,05CS030,118,140,164,197,33,57,79,19,131.18791265909138,369.6335813040531,584.2346830845187,0.33196805487411823,144,171,201,243,42,72,99,25,136.39349523374938,377.0878985874247,593.7128616057325,0.3472222222222222,12413,12464,Van Buren and Nearby Counties,Stone,5,137,Arkansas,AR
05139,05CS005,345,438,546,539,-7,102,194,70,-238.12776359779986,97.35268725932116,383.2296260366929,0.6422018348623854,407,526,667,617,-50,91,210,70,-312.42426460422416,54.65147485788177,364.3431657192118,0.5645161290322581,38828,38425,Bradley+Calhoun+Cleveland+Union,Union,5,139,Arkansas,AR
05141,05CS030,155,200,258,201,-57,1,46,13,-529.3332265564588,-90.7428388382501,249.9209019670135,0.23214285714285715,182,242,314,323,9,81,141,35,-166.1959461879601,292.9123955803128,674.9720419894165,0.42168674698795183,15869,15704,Van Buren and Nearby Counties,Van Buren,5,141,Arkansas,AR
05143,05CS031,1167,1461,1800,1646,-154,185,479,217,-181.1791617739697,-15.612584291819122,127.90121787813688,0.8112177874671586,1416,1790,2300,2046,-254,256,630,237,-196.76481393936092,7.613341746966412,157.49599861290255,0.6388140161725068,245955,249562,Washington,Washington,5,143,Arkansas,AR
05145,05CS032,566,703,873,841,-32,138,275,55,-135.38141671768145,129.15698376514436,342.34381238953927,0.3470066077541597,671,858,1092,1095,3,236,424,111,-140.18309242627302,162.67201201569364,405.7726961076724,0.43359375,77115,77149,White,White,5,145,Arkansas,AR
05147,05CS019,70,87,107,95,-12,8,25,6,-345.46210132746177,35.70256274048233,368.5282569370241,0.4158218702130727,83,106,131,105,-26,-1,22,16,-685.3506302778118,-277.40382654101904,97.90723289683027,-0.43843843843843844,6225,6128,Independence+Jackson+Woodruff,Woodruff,5,147,Arkansas,AR
05149,05CS024,165,210,267,252,-15,42,87,37,-306.20037354973454,29.442343610551397,294.423436105514,0.74,194,256,333,298,-35,42,104,40,-372.19989936633857,9.91871817098837,317.39898147162785,0.6779661016949152,20379,20164,Montgomery+Perry+Scott+Yell,Yell,5,149,Arkansas,AR
06001,06CS001,6720,8269,10244,9396,-848,1127,2676,635,-106.23566969361478,35.24949385571788,146.2639059074147,0.40954569126739565,7843,9898,12435,11273,-1162,1376,3430,805,-118.95999007129251,34.51052571034165,158.8179837444635,0.3921094807470334,1674918,1653119,Alameda,Alameda,6,1,California,CA
06003,06CS002,17,29,44,19,-25,-10,2,6,-3084.493829131188,-1591.5075416227064,-430.2959846716657,-0.5254139759265223,24,42,69,27,-42,-15,3,6,-3903.6952948950375,-1707.8666915165788,-243.98095593093984,-0.3157894736842105,1189,1230,Alpine and Nearby Counties,Alpine,6,3,California,CA
06005,06CS002,307,391,487,426,-61,35,119,19,-237.3794904564776,47.416627307161576,296.3539206697598,0.25333333333333335,370,482,614,550,-64,68,180,43,-259.99718538872514,60.74700593194513,333.01508651892317,0.4174757281553398,40492,41154,Alpine and Nearby Counties,Amador,6,5,California,CA
06007,06CS003,1456,1811,2232,1992,-240,181,536,132,-211.4334453311417,27.84636156760098,229.61882431406477,0.4086687306501548,1692,2142,2723,2569,-154,427,877,293,-214.46272942939189,64.24772131352228,280.00499438132096,0.5790513833992095,211159,208568,Butte,Butte,6,7,California,CA
06009,06CS002,342,430,536,466,-70,36,124,17,-229.4028027505936,50.07068641311061,281.9770234843598,0.21656929568321975,413,528,682,619,-63,90,206,59,-265.02135738016136,68.343616516374,319.04535900739023,0.5,45536,46091,Alpine and Nearby Counties,Calaveras,6,9,California,CA
06011,06CS004,113,135,158,155,-3,20,42,15,-98.2529615964592,28.438259177186005,146.08010703842783,0.6627263355740063,139,167,198,183,-15,16,44,23,-173.68348979809198,-31.952284588348068,95.85685376504419,0.92,21804,21908,Colusa+Lake,Colusa,6,11,California,CA
06013,06CS005,5267,6508,7990,7277,-713,768,2010,422,-117.07233625415529,35.74373470091181,163.76613571264798,0.3630124315524641,6209,7824,9886,9112,-774,1288,2903,650,-122.57124445516095,54.94751076642581,193.9169512694214,0.3906251410761332,1163281,1162018,Contra Costa,Contra Costa,6,13,California,CA
06015,06CS006,204,257,327,283,-44,26,79,6,-215.99811001653734,86.39924400661494,315.3572406241445,0.11538461538461539,242,317,412,380,-32,63,138,45,-274.7568278750697,64.18718886114542,331.633809115918,0.5769230769230769,27778,28043,Del Norte+Humboldt+Trinity,Del Norte,6,15,California,CA
06017,06CS007,1062,1315,1638,1514,-124,199,452,72,-122.77626965619754,79.53372224604483,238.037541934816,0.2748091603053435,1243,1600,2023,1903,-120,303,660,159,-144.62423239921904,74.64476510927435,259.7274969305688,0.43922651933701656,191617,192914,El Dorado,El Dorado,6,17,California,CA
06019,06CS008,4820,5956,7407,7507,100,1551,2687,937,-99.6244181727114,73.10791533171364,208.36946552198512,0.5746704005597079,5819,7280,9250,9355,105,2075,3536,1402,-128.03236095217025,66.44236335799096,210.72003023966698,0.6456366909190543,1007825,1012908,Fresno,Fresno,6,19,California,CA
06021,06CS009,178,228,290,223,-67,-5,45,22,-370.59527733920913,-112.42778076582749,95.77181324496416,-0.3308457711442786,210,276,355,330,-25,54,120,59,-291.48617464879965,-17.35036753861903,211.67448397115214,0.8676470588235294,28818,28818,Glenn+Tehama,Glenn,6,21,California,CA
06023,06CS006,905,1131,1405,1200,-205,69,295,23,-200.7748286630651,40.507202274127174,239.52084822962155,0.11414462341756565,1089,1386,1772,1602,-170,216,513,93,-193.04413290995018,90.23153466815076,308.40111523976054,0.31313131313131315,136272,136316,Del Norte+Humboldt+Trinity,Humboldt,6,23,California,CA
06025,06CS010,741,922,1147,1660,513,738,919,529,-10.753331542966707,139.59293742112067,260.4844286805601,0.7168021680216802,886,1125,1439,1587,148,462,701,344,-109.09452425485328,65.62913006409731,198.58373635072834,0.7350427350427351,179665,179798,Imperial,Imperial,6,25,California,CA
06027,06CS002,145,187,243,204,-39,17,59,28,-426.1347637940039,-69.96242390647826,197.166831009166,0.7777777777777778,174,230,301,245,-56,15,71,22,-411.2715452652286,-36.885340382531716,258.4608493947398,0.4230769230769231,18867,18978,Alpine and Nearby Counties,Inyo,6,27,California,CA
06029,06CS011,4317,5316,6574,6535,-39,1218,2218,678,-94.66133361356205,71.33916734262449,203.3199266104455,0.5130534219136698,5183,6528,8281,8615,334,2087,3432,1345,-110.32088231248164,80.9554415031018,227.65172030767792,0.6270397633222518,909178,916554,Kern,Kern,6,29,California,CA
06031,06CS012,594,738,925,920,-5,182,326,113,-92.79327600139464,53.82167151647361,167.3578982921004,0.5885416666666666,702,907,1168,1302,134,395,600,225,-59.38404946388041,110.87631421043021,244.580104875949,0.5667506297229219,152727,153324,Kings,Kings,6,31,California,CA
06033,06CS004,612,764,960,719,-241,-46,107,39,-496.3477142246028,-149.79064947135333,120.63022126065783,-0.2565789473684211,734,934,1192,957,-235,23,223,89,-471.97375254199443,-96.0983114847189,195.1086930144293,0.42788461538461536,67694,68680,Colusa+Lake,Lake,6,33,California,CA
06035,06CS013,174,222,281,247,-34,26,73,16,-184.7886832330577,35.109849814280956,210.65909888568575,0.35555555555555557,211,273,358,364,6,91,153,65,-178.27556164355966,78.56211191072121,265.90253262090255,0.6701030927835051,32470,33095,Lassen+Plumas+Sierra,Lassen,6,35,California,CA
06037,06CS014,42826,52910,65512,69724,4212,16814,26898,11176,-83.77244659547,67.82607211627517,189.11787851209422,0.6528228049612034,50783,63384,80141,82276,2135,18892,31493,13943,-119.84231446684566,50.23433863520054,178.12460114140015,0.7143113526619929,9975810,9852822,Los Angeles,Los Angeles,6,37,California,CA
06039,06CS015,741,926,1150,1137,-13,212,396,170,-140.01613565098668,31.734951553882837,172.82166388379568,0.7359307359307359,882,1130,1453,1496,43,366,614,269,-142.1984630805212,60.690631080363985,216.97686759301115,0.7078947368421052,156925,159003,Madera,Madera,6,39,California,CA
06041,06CS016,1318,1623,2013,1754,-259,131,436,114,-171.41871383805525,7.8095086031004675,147.94424974285323,0.3864451185879757,1556,1960,2501,2166,-335,206,610,76,-157.8321138723216,49.91649386547089,205.04159787816505,0.19663681032520652,261220,260435,Marin,Marin,6,41,California,CA
06043,06CS017,132,172,222,175,-47,3,43,7,-378.38587476186655,-28.028583315693815,252.25724984124432,0.1573232323232323,157,209,274,243,-31,34,86,22,-309.44409675596523,69.9967796620468,373.316158197583,0.4489795918367347,17125,17144,Mariposa+Tuolumne,Mariposa,6,43,California,CA
06045,06CS018,591,743,928,870,-58,127,279,35,-123.1698429392486,121.71456015478915,322.80818128009304,0.2229299363057325,724,901,1162,1057,-105,156,333,65,-186.33884731015385,99.65815518791655,293.55349997935195,0.31863510753334134,90704,91312,Mendocino,Mendocino,6,45,California,CA
06047,06CS019,1205,1506,1882,1948,66,442,743,260,-82.68612091291267,77.3584069365652,205.88417890197147,0.5771372259177137,1454,1836,2326,2342,16,506,888,384,-128.77467297291247,42.69160353993294,176.40030610229667,0.7218045112781954,281547,285770,Merced,Merced,6,47,California,CA
06049,06CS020,79,95,113,101,-12,6,22,9,-284.9872714049524,-46.53594256620427,180.56056108974624,0.5807818227894944,92,116,143,141,-2,25,49,12,-161.65231761793763,150.10572350237064,427.223982275978,0.42857142857142855,8689,8661,Modoc+Siskiyou,Modoc,6,49,California,CA
06051,06CS002,33,44,58,39,-19,-5,6,7,-228.95276012765012,-111.0789766926742,-7.9394161870702185,-0.6277363863835135,40,55,71,64,-7,9,24,3,-75.5228779251348,45.31372675508088,158.9756580324084,0.22252747252747251,13392,13241,Alpine and Nearby Counties,Mono,6,51,California,CA
06053,06CS021,1757,2176,2687,2539,-148,363,782,256,-110.65488257442951,29.339790448430076,144.23111940069364,0.572067753275807,2074,2634,3351,3157,-194,523,1083,367,-128.25249734223974,35.65744000247621,163.6585066780318,0.5825396825396826,437631,437496,Monterey,Monterey,6,53,California,CA
06055,06CS022,809,1006,1260,1043,-217,38,234,38,-222.59034359808015,-0.43645165411388265,171.13269357805333,0.21468926553672316,960,1216,1546,1345,-201,129,385,73,-200.9364142728265,41.05231375147131,228.79334146132484,0.3060810098097817,137472,136411,Napa,Napa,6,55,California,CA
06057,06CS023,723,900,1120,988,-132,88,265,63,-229.5580322161117,29.422972598835134,238.03184832457598,0.3772455089820359,861,1104,1406,1207,-199,103,346,67,-257.69810985890496,34.850232738244095,270.13770682241704,0.3031674208144796,101961,103299,Nevada,Nevada,6,57,California,CA
06059,06CS024,13770,17014,21032,19959,-1073,2944,6189,2459,-133.24816252683908,18.31803797337761,140.74893688133437,0.6991782033495995,16523,20654,26204,25162,-1042,4508,8639,3517,-143.80391427745056,31.244234202005934,161.57417105453283,0.694921952183363,3180472,3170185,Orange,Orange,6,59,California,CA
06061,06CS025,2229,2767,3424,2988,-436,221,759,157,-175.53249380466235,18.942887789391097,178.1963374000455,0.3267433298683299,2634,3351,4276,3895,-381,544,1261,306,-167.03801927089825,57.859188744686044,232.1660724839293,0.427076272176901,405429,411343,Placer,Placer,6,61,California,CA
06063,06CS013,159,184,211,232,21,48,73,7,83.58280449535197,249.01849508110257,399.6652375690359,0.146326275329864,187,223,258,278,20,55,91,30,-50.267148952034674,125.66787238008668,306.88094435217147,0.5357142857142857,19680,19894,Lassen+Plumas+Sierra,Plumas,6,63,California,CA
06065,06CS026,11555,14238,17667,18545,878,4307,6990,2657,-87.76356472752501,81.39044615580949,213.71404696506204,0.603932460042301,13957,17504,22178,23082,904,5578,9125,3945,-123.9483724069347,66.54576839356756,211.14472963246632,0.692348384269106,2432718,2453199,Riverside,Riverside,6,65,California,CA
06067,06CS027,8080,9972,12325,11312,-1013,1340,3232,948,-148.82415899661103,29.744344623178687,173.32151017414478,0.5150783749587446,9652,12128,15403,13886,-1517,1758,4234,1326,-178.94844301036775,27.226426609671982,183.07489911271225,0.5271319703818331,1581477,1588530,Sacramento,Sacramento,6,67,California,CA
06069,06CS028,249,315,394,352,-42,37,103,32,-137.70742212765464,9.304555549165853,132.12468879815512,0.5161290322580645,305,395,510,475,-35,80,170,60,-143.23270668500922,30.138391727513774,165.76115450132576,0.6185567010309279,64485,66361,San Benito,San Benito,6,69,California,CA
06071,06CS029,9994,12319,15255,16663,1408,4344,6669,2747,-73.60145691975285,87.77978917952676,215.5496758027383,0.6249575449056113,12102,15036,19196,19934,738,4898,7832,3626,-131.69844585368605,57.98087805233954,191.77922121967885,0.7242584712205948,2183190,2192964,San Bernardino,San Bernardino,6,71,California,CA
06073,06CS030,14559,18040,22194,20772,-1422,2732,6213,1748,-115.23298706936296,35.78991601040691,162.33244383227122,0.48854123704897956,17385,21736,27677,26447,-1230,4712,9062,2869,-124.67987291495011,56.04222044980498,188.3779017160255,0.5452315456024207,3300930,3287700,San Diego,San Diego,6,73,California,CA
06075,06CS031,3794,4706,5774,5343,-432,638,1549,222,-90.59722817480026,57.60236925268478,183.96713356994633,0.25241622711759226,4265,5405,6865,6569,-296,1164,2304,342,-77.54545876267252,99.85488697879974,238.33369283218502,0.25801617350086625,865589,823195,San Francisco,San Francisco,6,75,California,CA
06077,06CS032,3837,4739,5896,5976,80,1237,2139,793,-109.89361034114899,68.42345111691229,207.47408161869146,0.6192894345238096,4580,5794,7300,7229,-71,1435,2649,1092,-147.59937296436595,43.5216719765979,197.56047599872576,0.6973191450493241,778680,788113,San Joaquin,San Joaquin,6,77,California,CA
06079,06CS033,1649,2022,2509,2068,-441,46,419,116,-236.72792307782538,-29.532562652861003,128.81721393114833,0.29479081902842896,1945,2468,3140,2671,-469,202,726,248,-253.3533709195108,-16.076394082473666,168.94346880296223,0.5204622729594983,282400,283024,San Luis Obispo,San Luis Obispo,6,79,California,CA
06081,06CS034,3108,3844,4756,4151,-605,308,1043,248,-134.64996071131026,9.391797271347471,125.4949314384001,0.37920843932365705,3587,4502,5710,5116,-594,614,1529,357,-128.29912095557648,34.593424287927434,158.07104458738925,0.3925234831175425,760238,741470,San Mateo,San Mateo,6,81,California,CA
06083,06CS035,2176,2681,3324,2900,-424,219,724,177,-161.14641418086208,11.261479859561076,146.70758821806766,0.3885881876632703,2589,3256,4139,3666,-473,410,1077,378,-190.48092525436005,7.275390845888707,156.49925354956292,0.5710021905805038,447543,446711,Santa Barbara,Santa Barbara,6,83,California,CA
06085,06CS036,6781,8350,10396,9579,-817,1229,2798,851,-104.01686100629269,23.56722118283252,121.37430644888674,0.5233751826407766,7856,9895,12466,11365,-1101,1470,3508,1085,-115.51286481854099,20.347937845506166,128.0863048534654,0.526188166828322,1924707,1892084,Santa Clara,Santa Clara,6,85,California,CA
06087,06CS037,1153,1440,1788,1583,-205,143,430,122,-145.1119332219873,9.317690254278348,136.70382701634088,0.46037735849056605,1358,1731,2233,2004,-229,273,646,147,-140.28651307731863,46.98591347087226,186.09777871141907,0.392524064171123,270453,268165,Santa Cruz,Santa Cruz,6,87,California,CA
06089,06CS038,1521,1883,2324,2068,-256,185,547,102,-236.60891395236405,54.84859616826202,294.10081596006034,0.30088757396449706,1808,2272,2885,2782,-103,510,974,346,-246.56358862595025,90.05886087896624,344.91445437852855,0.6012167874396135,181591,182103,Shasta,Shasta,6,89,California,CA
06091,06CS013,21,30,40,36,-4,6,15,2,-236.10726909512155,165.3811355583918,474.21836990724796,0.2255036763268371,24,37,50,37,-13,0,13,2,-458.0181807772314,-61.06909077029752,335.87999923663637,0.16025641025641024,3194,3275,Lassen+Plumas+Sierra,Sierra,6,91,California,CA
06093,06CS020,389,490,614,542,-72,52,153,14,-234.89434828151468,103.79052598485534,379.6548187340761,0.15555555555555556,466,592,766,743,-23,151,277,75,-222.35955119882524,172.3541651311649,458.21261927305085,0.45454545454545453,43935,44095,Modoc+Siskiyou,Siskiyou,6,93,California,CA
06095,06CS039,2388,2938,3629,3118,-511,180,730,171,-180.98437283638714,2.3880066786797896,148.4013483761784,0.34510630498533723,2854,3581,4556,4082,-474,501,1228,358,-184.0939269932238,31.64114370196034,192.54631642969147,0.48740662477525065,452260,451943,Solano,Solano,6,95,California,CA
06097,06CS040,2714,3354,4136,3693,-443,338,979,196,-157.00218634135854,34.99305787697442,192.30220086637658,0.33880751325217684,3210,4020,5073,4558,-515,538,1348,232,-153.66724504967527,62.828350324780246,229.55484331430344,0.2873066117020624,488668,486245,Sonoma,Sonoma,6,97,California,CA
06099,06CS041,2905,3598,4506,4541,35,943,1636,634,-130.22033744482738,67.1362046724813,217.7689901075339,0.6333666333666333,3454,4337,5500,5581,81,1244,2127,860,-140.85185745165697,69.44483952164894,229.13180123419065,0.6582480930788428,552310,552957,Stanislaus,Stanislaus,6,99,California,CA
06101,06CS042,576,723,901,799,-102,76,223,62,-198.72449113715874,16.959115366779777,195.09039498713446,0.4696969696969697,689,880,1117,1013,-104,133,324,146,-252.26027297931063,-13.114911212681616,179.62384164753544,0.7684210526315789,99062,99124,Sutter,Sutter,6,101,California,CA
06103,06CS009,491,614,767,679,-88,66,188,44,-241.6835456074702,39.36512295879249,263.65477702633115,0.39285714285714285,590,750,970,941,-29,191,351,129,-241.47118840037734,94.6347261746106,339.0060110222743,0.6128300609343263,65540,65515,Glenn+Tehama,Tehama,6,103,California,CA
06105,06CS006,141,168,192,147,-45,-21,6,3,-373.66208019704277,-183.17876637446918,20.0034350362763,-0.12289315357294868,179,212,251,198,-53,-14,19,19,-448.20484621489965,-205.42722118182903,0,-0.6129032258064516,15538,16064,Del Norte+Humboldt+Trinity,Trinity,6,105,California,CA
06107,06CS043,2097,2605,3234,3323,89,718,1226,451,-91.91884959764137,67.7497110906011,196.68984476359336,0.6074076828476381,2497,3170,4015,4334,319,1164,1837,783,-97.38335989902849,79.84134548929184,221.18465776678715,0.6629974597798476,472917,476570,Tulare,Tulare,6,107,California,CA
06109,06CS017,461,580,727,647,-80,67,186,33,-245.01590875568542,73.68899511449186,331.60047801521335,0.3128032345013477,559,704,909,847,-62,143,288,115,-317.4809531601279,50.20879236647039,310.3979270941436,0.6845238095238095,55368,55767,Mariposa+Tuolumne,Tuolumne,6,109,California,CA
06111,06CS044,3871,4802,5953,5547,-406,746,1676,376,-111.37410444392484,52.61152082847127,185.10142646011545,0.3922822722146997,4642,5836,7455,7127,-328,1290,2485,818,-136.34175750716108,56.23383416736523,198.40724855114195,0.5587431693989071,842781,840241,Ventura,Ventura,6,111,California,CA
06113,06CS045,877,1092,1369,1253,-116,161,376,110,-125.07373747183425,28.21836147340653,147.26111580680674,0.5092592592592593,1036,1317,1680,1542,-138,225,506,131,-124.17039385657023,43.34206098224137,172.93021246159174,0.4540741541714725,216880,216879,Yolo,Yolo,6,113,California,CA
06115,06CS046,461,573,717,561,-156,-12,100,29,-272.1531980084259,-60.29873611643049,104.49329758713131,-0.1939821029082774,547,703,905,810,-95,107,263,85,-216.3962256355813,26.44108283245092,213.93239746255745,0.5483870967741935,81594,83204,Yuba,Yuba,6,115,California,CA
08003,08CS023,102,121,145,140,-5,19,38,21,-188.52453621159017,-13.616507879099153,125.10365252253175,0.9717572820394337,125,150,178,187,9,37,62,26,-102.90543923345537,66.585872445177,217.9174007296702,0.6842105263157895,16358,16520,Southwest Colorado,Alamosa,8,3,Colorado,CO
08005,08CS002,2647,3282,4035,4174,139,892,1527,492,-64.658522053224,73.34864206859146,189.60761331738502,0.5304583751813414,3131,3936,4991,4870,-121,934,1739,392,-78.37467844891019,82.75682002592895,205.70871915116746,0.38563708297524757,655227,654931,Arapahoe,Arapahoe,8,5,Colorado,CO
08007,08CS023,76,91,110,90,-20,-1,14,4,-214.26268123617845,-46.62097619536434,91.86564970791689,-0.20676097621753073,93,117,141,136,-5,19,43,11,-116.84092708361769,58.23846832828297,232.95387331313188,0.4782608695652174,13536,13737,Southwest Colorado,Archuleta,8,7,Colorado,CO
08009,08CS022,30,40,53,60,7,20,30,3,149.89048214942522,571.6913636451815,937.2521276081704,0.15217127299934952,34,48,64,78,14,30,44,4,284.9070490752392,740.758327595622,1139.6281963009567,0.13333333333333333,3508,3510,Southeast Colorado,Baca,8,9,Colorado,CO
08011,08CS022,45,58,74,67,-7,9,22,5,-255.19963167866413,77.18239024079982,357.0830402782432,0.4196067263850762,57,76,96,85,-11,9,28,22,-574.8210941922747,-226.44467346968398,105.3838672685829,1.2941176470588236,5640,5741,Southeast Colorado,Bent,8,11,Colorado,CO
08015,08CS005,124,146,170,182,12,36,58,15,-19.61994656592667,125.6236621761827,260.61772193649097,0.42067217696771697,151,180,210,167,-43,-13,16,12,-274.99112007841416,-124.99596367200643,19.99935418752103,-0.46153846153846156,19732,20001,Central Colorado,Chaffee,8,15,Colorado,CO
08017,08CS022,8,14,21,23,2,9,15,7,-369.5181569219467,139.08313366033488,534.6619152243316,0.7757571650413231,9,16,26,24,-2,8,15,6,-467.50021305348247,116.87505326337062,525.9377396851678,0.6666666666666666,1746,1711,Southeast Colorado,Cheyenne,8,17,Colorado,CO
08019,08CS020,41,54,68,57,-11,3,16,2,-168.3453046157823,9.385560101626774,176.66166807095289,0.18248883557652884,51,68,86,68,-18,0,17,3,-222.46057283597506,-31.78008183371072,148.3070485573167,0.15789473684210525,9437,9440,Park and Nearby Counties,Clear Creek,8,19,Colorado,CO
08021,08CS022,54,68,83,79,-4,11,25,2,-95.54756125967229,138.66390112086444,360.51420298687236,0.14234759831797525,64,82,104,140,36,58,76,48,-158.09408793983638,125.15781961903716,368.8862051929516,0.8348457350272231,7582,7590,Southeast Colorado,Conejos,8,21,Colorado,CO
08023,08CS022,24,34,45,35,-10,1,11,6,-544.8818216549872,-158.1793069560299,173.27999135736192,0.5805242041015494,29,42,57,58,1,16,29,10,-249.47016463875912,166.31344309250608,526.6592364596027,0.5882352941176471,3572,3608,Southeast Colorado,Costilla,8,23,Colorado,CO
08025,08CS022,31,42,55,63,8,21,32,4,79.38484954834651,337.7219988121725,562.7253223645372,0.18984043445918689,39,54,70,69,-1,15,30,13,-233.54173689716174,33.3631052710231,284.4204724354712,0.7647058823529411,5919,5995,Southeast Colorado,Crowley,8,25,Colorado,CO
08027,08CS006,26,37,49,46,-3,9,20,1,-108.08963109236379,199.82921779217548,466.692220158776,0.09391849153830695,34,48,64,61,-3,13,27,17,-400.2852032072852,-80.05704064145704,201.1433146116599,1.1333333333333333,4806,4996,Custer+Fremont,Custer,8,27,Colorado,CO
08029,08CS007,271,345,436,371,-65,26,100,23,-338.15618574160357,11.521505476715623,295.71864056903433,0.3709677419354839,330,427,547,506,-41,79,176,93,-424.2298373139495,-44.30598823122188,262.8294516144982,0.93,31246,31598,Delta+Montrose,Delta,8,29,Colorado,CO
08031,08CS008,3022,3744,4629,4938,309,1194,1916,647,-56.47951493435657,91.3196890876505,212.09060452790558,0.5344899714053681,3527,4446,5648,5239,-408,793,1712,408,-114.61863407354748,54.04552862010506,183.05992622609872,0.41046319209339754,718136,712362,Denver,Denver,8,31,Colorado,CO
08033,08CS023,14,21,30,21,-9,-0,7,0,-493.39035143970074,-19.604444049202012,366.28453029600087,0,16,27,40,47,7,20,31,3,167.47642682065194,711.7748139877707,1172.3349877445635,0.15,2301,2388,Southwest Colorado,Dolores,8,33,Colorado,CO
08035,08CS009,1021,1277,1582,1611,29,334,590,166,-45.80582271990484,56.02750795008382,141.40275815973536,0.4689265536723164,1255,1592,2058,1995,-63,403,740,165,-62.07610226442923,64.7277649022307,156.39370255053683,0.3745748299319728,359823,367694,Douglas,Douglas,8,35,Colorado,CO
08037,08CS010,111,133,157,130,-27,-3,19,13,-86.4841801519642,-34.938202694743744,13.058998345456326,-0.5671906105773133,143,171,204,188,-16,17,45,16,-57.52184925416774,1.7947534868695085,52.137588793559146,0.6153846153846154,55601,55718,Eagle,Eagle,8,37,Colorado,CO
08039,08CS011,109,131,155,150,-5,19,41,13,-83.65359579116738,26.693365863836316,125.81860260477174,0.5978515294686565,138,166,198,210,12,44,72,25,-48.15966782177835,70.38720681644529,174.300951616513,0.5681818181818182,26375,26994,East Central Colorado,Elbert,8,39,Colorado,CO
08041,08CS012,3454,4261,5252,5200,-51,939,1746,530,-95.45465815391744,67.13835801367537,199.65864267000816,0.5155642023346303,4190,5248,6692,6487,-205,1239,2297,828,-140.23274202727333,55.76744748254412,199.36523256959137,0.612199713982078,731028,736989,El Paso,El Paso,8,41,Colorado,CO
08043,08CS006,385,483,614,533,-81,50,148,26,-262.52255414272105,58.88356354603089,299.3247813589904,0.2736842105263158,471,597,775,754,-21,157,283,137,-318.89457949833707,40.35363233133022,294.6824000995388,0.7873563218390804,48910,49562,Custer+Fremont,Fremont,8,43,Colorado,CO
08045,08CS013,246,307,391,338,-53,31,92,36,-173.48469927491357,-9.746331419938965,109.25637521751568,0.6,294,380,489,423,-66,44,129,40,-170.75959910541076,5.635630333511907,143.30602848073133,0.5161505161505161,61562,62105,Garfield,Garfield,8,45,Colorado,CO
08047,08CS020,18,26,37,27,-10,1,9,7,-346.98474120951346,-128.79284254621473,39.047079502476684,0.6151606499224341,22,33,47,40,-7,7,18,7,-238.75251809296427,0,187.59126421590048,0.7,5878,5864,Park and Nearby Counties,Gilpin,8,47,Colorado,CO
08049,08CS019,54,68,85,64,-21,-4,10,1,-165.2089648046592,-39.91630002323614,66.58246504097352,-0.07528905707931617,67,85,107,100,-7,15,33,13,-126.56646383242304,12.625083674057162,126.25083674057163,0.6842105263157895,15748,15841,Northwest Colorado,Grand,8,49,Colorado,CO
08051,08CS005,50,64,79,70,-9,6,20,4,-90.9351236218493,13.171032571790395,111.4935134213389,0.3212988647748583,60,78,100,89,-11,11,29,3,-81.24419684308263,46.425255338904364,151.17223769730708,0.2,17058,17232,Central Colorado,Gunnison,8,51,Colorado,CO
08053,08CS023,2,6,12,2,-10,-4,0,2,-1818.3731453225298,-909.1865726612649,-303.0621908870883,-0.4,3,8,15,1,-14,-7,-2,1,-1915.9637031320683,-1021.8473083371032,-383.1927406264137,-0.14285714285714285,792,783,Southwest Colorado,Hinsdale,8,53,Colorado,CO
08055,08CS022,73,90,109,113,4,23,40,10,-111.49788311639335,235.1817945232771,524.0815258896689,0.42761356531045563,89,112,136,139,3,27,50,5,-28.968888620658436,318.6577748272428,651.7999939648148,0.17857142857142858,6830,6904,Southeast Colorado,Huerfano,8,55,Colorado,CO
08057,08CS019,6,11,18,11,-7,0,5,5,-1052.8187746175065,-408.32641790338886,21.33515323935635,0.7257686465848913,6,13,23,14,-9,1,8,1,-732.656643516752,0,512.8596504617263,0.16666666666666666,1378,1365,Northwest Colorado,Jackson,8,57,Colorado,CO
08059,08CS014,7945,9798,12056,11827,-229,2029,3882,1405,-106.68509784348836,40.74642003570617,161.77112339176034,0.6270921981577102,9469,11904,15168,14167,-1001,2262,4698,1420,-131.15876823890218,45.648474507900644,177.6091387975054,0.5318352059925093,1837707,1845626,Jefferson,Jefferson,8,59,Colorado,CO
08061,08CS022,11,17,26,17,-9,-0,6,3,-1020.8459450774208,-270.7998293594633,274.68825479905104,-0.21064875427116228,13,21,32,20,-12,-1,7,8,-1377.4104683195592,-619.8347107438017,-68.87052341597796,-0.6666666666666666,1447,1452,Southeast Colorado,Kiowa,8,61,Colorado,CO
08063,08CS011,45,58,73,81,8,23,36,2,98.98193330866269,364.25665599543134,573.6840686428801,0.08528978068352118,53,71,89,103,14,32,50,15,-14.35415283584232,244.02059820931945,502.3953492544812,0.46875,7066,6967,East Central Colorado,Kit Carson,8,63,Colorado,CO
08065,08CS005,20,28,38,31,-7,3,11,2,-140.99972621150283,16.737924891550918,148.18596747742905,0.27942183273544074,22,33,46,58,12,25,36,7,67.50105470397975,243.00379693432708,391.5061172830825,0.28,7505,7407,Central Colorado,Lake,8,65,Colorado,CO
08067,08CS015,226,286,363,362,-1,76,136,24,-53.74253296022082,111.78446855725932,240.87403272770962,0.3,273,354,448,440,-8,86,167,36,-78.43474751311696,89.91951758030436,233.34559958215607,0.375,55822,56161,La Plata+Montezuma,La Plata,8,67,Colorado,CO
08069,08CS016,1603,1976,2453,2213,-240,238,610,114,-118.13940037705837,41.209478736242644,165.52195892399322,0.31666666666666665,1890,2402,3059,2778,-281,376,888,241,-144.17959624673253,37.41876133199054,178.68494110601088,0.46036336169778,359626,362118,Larimer,Larimer,8,69,Colorado,CO
08071,08CS022,127,150,173,164,-9,14,37,3,-102.88008446055044,86.98440829709146,276.84890105473335,0.14907817138351676,155,186,219,239,20,53,84,27,-47.86999876050896,177.8028525390333,389.79856133557297,0.5094339622641509,14549,14623,Southeast Colorado,Las Animas,8,71,Colorado,CO
08073,08CS011,38,50,65,50,-15,-0,12,3,-379.58214093559144,-66.637235989562555,194.15018479879484,-0.17225206177812227,46,63,80,67,-13,4,21,5,-317.4894005298818,-17.58944047256963,281.4310475611141,0.3333333333333333,5675,5685,East Central Colorado,Lincoln,8,73,Colorado,CO
08075,08CS017,136,177,229,264,35,87,128,55,-110.97004386784546,177.55207018855273,405.0406601176359,0.632183908045977,165,215,282,272,-10,57,107,46,-260.608551993733,51.19096557019755,283.8771727074591,0.7301587301587301,21627,21488,Logan+Morgan+Phillips+Sedgwick,Logan,8,75,Colorado,CO
08077,08CS018,1070,1322,1647,1536,-111,214,466,108,-168.6273938524336,81.98501458700838,275.63130960449143,0.40601503759398494,1287,1628,2071,1998,-73,370,711,319,-249.66363081433428,32.13870343136345,249.5681693189935,0.7649880095923262,155882,157131,Mesa,Mesa,8,77,Colorado,CO
08079,08CS023,3,8,16,6,-10,-2,3,6,-2241.027137437992,-1120.513568718996,-420.1925882696235,-1,4,11,20,5,-15,-6,1,5,-2184.151252474234,-1201.2831888608287,-436.8302504948468,-0.7142857142857143,857,916,Southwest Colorado,Mineral,8,79,Colorado,CO
08081,08CS019,75,92,112,139,27,47,64,21,56.03808198242018,234.7394637413493,391.1031727804123,0.447578449166795,92,115,142,157,15,42,65,32,-128.81756212763673,75.77503654566867,250.0576206007066,0.7619047619047619,13250,13197,Northwest Colorado,Moffat,8,81,Colorado,CO
08083,08CS015,180,230,288,251,-37,21,71,16,-244.94000863323663,23.107547984267608,254.1830278269437,0.3595959595959596,215,280,364,371,7,90,156,47,-153.0879514200901,166.483147169348,417.3560275590204,0.5,25966,26129,La Plata+Montezuma,Montezuma,8,83,Colorado,CO
08085,08CS007,295,372,472,417,-55,45,122,27,-229.71589485945512,50.425440335002335,266.13426843473457,0.36486486486486486,353,455,584,614,30,159,261,114,-194.83211676010427,104.37434826434158,340.95620433018246,0.6909090909090909,42836,43114,Delta+Montrose,Montrose,8,85,Colorado,CO
08087,08CS017,181,231,296,296,-0,65,115,71,-293.5895651624955,-24.792925981350777,181.8147905299057,1.0441176470588236,215,282,357,331,-26,49,116,44,-241.5882445434787,17.23168648669606,248.13628540842325,0.676923076923077,29041,29016,Logan+Morgan+Phillips+Sedgwick,Morgan,8,87,Colorado,CO
08089,08CS022,165,210,266,264,-2,54,99,36,-245.19342252512928,116.14425277506125,406.50488471271433,0.6,192,254,327,313,-14,59,121,62,-408.5001170182627,-16.125004619141947,317.125090843125,0.9117647058823529,18598,18605,Southeast Colorado,Otero,8,89,Colorado,CO
08091,08CS023,16,25,35,24,-11,-1,8,3,-330.9410766205855,-89.63115195439671,111.46045193409401,-0.26425968297786073,20,31,45,32,-13,1,12,5,-359.22467341321646,-79.827705202937,139.69848410513973,0.5,4906,5011,Southwest Colorado,Ouray,8,91,Colorado,CO
08093,08CS020,70,85,102,113,11,28,43,1,68.29306380432976,185.57649514048185,286.1051505714693,0.03531260083161935,84,105,128,118,-10,13,34,10,-113.14523723374039,16.971785585061056,135.77428468048845,0.5263157894736842,17665,17676,Park and Nearby Counties,Park,8,93,Colorado,CO
08095,08CS017,33,44,57,67,10,23,34,2,220.27362124207914,548.6822410989164,855.1969529652979,0.08692776607560465,39,53,70,71,1,18,32,5,-88.58948922622619,287.9158399852351,597.9790522770268,0.2631578947368421,4506,4515,Logan+Morgan+Phillips+Sedgwick,Phillips,8,95,Colorado,CO
08097,08CS005,37,49,62,60,-2,11,23,4,-38.9889070644571,51.604667836705715,130.87404587522323,0.3044736903969564,44,59,76,72,-4,13,28,4,-46.405384177493374,51.88179597483733,138.35145593289954,0.25,17424,17347,Central Colorado,Pitkin,8,97,Colorado,CO
08099,08CS022,86,104,125,148,23,44,62,18,49.90134800405874,255.77212043067706,436.5767908253119,0.4129681894518906,103,127,155,181,26,54,78,22,33.34850227012981,266.7880181610385,467.29588806019365,0.4074074074074074,12005,11995,Southeast Colorado,Prowers,8,99,Colorado,CO
08101,08CS021,1263,1562,1939,1998,59,436,735,262,-144.57329254299268,123.85895077538517,336.6970328549263,0.5874439461883408,1522,1922,2414,2471,57,549,949,365,-181.84923081803015,108.58432085191481,344.6962054869752,0.6409135756790922,168579,169454,Pueblo,Pueblo,8,101,Colorado,CO
08103,08CS019,35,46,61,56,-5,10,21,1,-107.98004876511378,165.68473365614614,363.3315209603895,0.08617810512087926,43,59,77,70,-7,11,27,10,-262.25967564648937,15.427039743911141,262.25967564648937,0.6666666666666666,6489,6482,Northwest Colorado,Rio Blanco,8,103,Colorado,CO
08105,08CS023,95,115,135,142,7,27,47,6,12.195214403440701,218.3341410661031,433.0621896730432,0.2164417301223312,116,141,168,174,6,33,58,28,-192.52717440847118,43.75617600192527,262.9746177715705,0.8235294117647058,11486,11427,Southwest Colorado,Rio Grande,8,105,Colorado,CO
08107,08CS019,88,105,125,115,-10,10,27,21,-148.80068417181667,-53.98718535084973,28.974626117496374,1.3531106535471404,108,133,158,132,-26,-1,24,3,-115.94839198938303,-15.965355179261003,83.81811469112027,-0.06976744186046512,24973,25054,Northwest Colorado,Routt,8,107,Colorado,CO
08109,08CS005,30,41,54,53,-1,12,23,5,-116.37097009274885,128.08898701521818,341.99144948468944,0.3693641077669869,38,52,69,68,-1,16,30,5,-92.90562337092568,170.3269761800304,387.1067640455237,0.2777777777777778,6457,6458,Central Colorado,Saguache,8,109,Colorado,CO
08111,08CS023,2,5,11,5,-6,0,3,5,-1847.9846001283324,-839.9930000583329,-335.99720002333316,1.125,2,7,13,2,-11,-5,0,2,-1781.686320418011,-959.3695571481597,-274.10558775661707,-0.4,714,730,Southwest Colorado,San Juan,8,111,Colorado,CO
08113,08CS023,12,19,27,24,-3,5,12,7,-150.5790690036295,-28.380788686556567,81.59766359880905,1.0393713171520682,14,23,34,31,-3,8,17,4,-86.72780632854867,49.55874647345638,161.06592603873324,0.4444444444444444,8074,8071,Southwest Colorado,San Miguel,8,113,Colorado,CO
08115,08CS017,21,30,40,41,1,11,20,6,-267.90109130721726,273.8422165295197,732.2404000836815,0.49080822132393337,24,35,49,34,-15,-1,10,3,-767.9590421844168,-170.6575649298704,298.6507386272732,-0.2,2367,2344,Logan+Morgan+Phillips+Sedgwick,Sedgwick,8,115,Colorado,CO
08117,08CS020,50,65,80,72,-8,7,22,6,-53.465077255497725,4.071475498870998,61.44864722067918,0.468560844463335,61,80,102,88,-14,8,27,4,-58.16701203330061,12.926002674066803,74.32451537588412,0.25,30950,30945,Park and Nearby Counties,Summit,8,117,Colorado,CO
08119,08CS020,127,150,176,183,7,33,56,2,24.437302049696076,147.5301052303856,258.71070165165355,0.061450602552568526,156,188,220,288,68,100,132,42,104.430951727462,232.96135385356908,361.49175597967616,0.42,24846,24897,Park and Nearby Counties,Teller,8,119,Colorado,CO
08121,08CS011,33,44,55,65,10,21,32,14,-101.51687889671837,184.5867107970722,450.25432979844936,0.6534109521737971,39,54,70,67,-3,13,28,14,-350.2055741053878,-20.600327888552226,288.4045904397311,0.9333333333333333,4828,4854,East Central Colorado,Washington,8,121,Colorado,CO
08125,08CS011,63,78,97,101,4,23,38,12,-96.84213181893577,130.997103715376,308.919283308331,0.5059478960957324,75,94,118,103,-15,9,28,4,-191.021167323651,50.26872824306606,241.28989556671706,0.23529411764705882,9981,9947,East Central Colorado,Yuma,8,125,Colorado,CO
09001,09CS001,4629,5697,7057,7546,489,1849,2917,1629,-143.3093296078266,27.654973478112236,161.91986971434713,0.8683371337240278,5477,6936,8755,7409,-1346,474,1932,517,-194.2289208666751,-4.535014120769902,147.52870074256296,0.3858208955223881,954620,959203,Fairfield,Fairfield,9,1,Connecticut,CT
09003,09CS002,5588,6902,8535,8610,75,1708,3022,1731,-221.53298087667702,-3.0105043605274098,172.7360501973727,0.961666963477458,6742,8416,10728,8844,-1884,428,2102,731,-291.52367057472196,-33.83458279901649,152.86319582870317,0.44505364363015254,896860,897011,Hartford,Hartford,9,3,Connecticut,CT
09005,09CS003,1297,1608,1994,1890,-104,282,593,249,-229.95744996514847,21.82006677193733,224.12790973801884,0.7455089820359282,1547,1980,2500,2043,-456,64,496,143,-324.08624370123243,-42.97724165846203,190.82976484826534,0.351370441922241,184234,184982,Litchfield,Litchfield,9,5,Connecticut,CT
09007,09CS004,1083,1345,1671,1526,-145,181,443,214,-263.1737924036878,-24.174628112238544,167.83052425799542,0.8359375,1296,1650,2108,1696,-412,46,400,134,-331.6385281768739,-53.45089831422143,161.62822774334452,0.359732191761077,163808,164637,Middlesex,Middlesex,9,7,Connecticut,CT
09009,09CS005,5369,6632,8196,8319,123,1688,2950,1488,-190.06913146984735,27.769162744953896,203.53613144766328,0.8402043465244161,6375,8054,10141,8576,-1565,522,2201,717,-264.273225713528,-22.520161406068567,171.77846510047976,0.46392758010022733,862107,863671,New Haven,New Haven,9,9,Connecticut,CT
09011,09CS006,1730,2138,2673,2348,-325,210,618,274,-268.35188996318533,-28.886343295436333,154.06049757566043,0.7548209366391184,2089,2625,3311,2954,-357,329,865,243,-223.27760515541792,32.0031234056099,231.48305714487952,0.45849056603773586,267947,268724,New London,New London,9,11,Connecticut,CT
09013,09CS007,733,927,1154,1042,-112,115,309,113,-180.16711791097052,1.6011296859450836,156.95073746476677,0.6348314606741573,901,1132,1448,1280,-168,148,379,87,-169.87437380046475,40.27983388174845,194.44174355644023,0.375,149894,150199,Tolland,Tolland,9,13,Connecticut,CT
09015,09CS008,739,926,1148,1084,-64,158,345,84,-152.69123020248463,76.31983137442663,269.28524286301064,0.4409479195370626,885,1136,1458,1242,-216,106,357,147,-311.9629098352586,-34.796193468267624,180.42470687249877,0.6853184090415128,116352,116392,Windham,Windham,9,15,Connecticut,CT
10001,10CS001,1143,1420,1761,1740,-21,320,597,191,-139.518223848188,84.56647058722716,267.19056076586946,0.5426136363636364,1375,1742,2217,2234,17,492,859,250,-126.71794075188471,131.34069824712515,331.3429416441448,0.477555354458278,182342,183873,Kent,Kent,10,1,Delaware,DE
10003,10CS002,3380,4186,5189,4893,-296,707,1513,499,-167.62070672367398,43.84720744328012,213.7867568682814,0.5802356962449771,4052,5128,6489,5717,-772,589,1665,523,-226.54520745612527,11.547270874699208,199.81152579470046,0.5224780439121757,569249,571564,New Castle,New Castle,10,3,Delaware,DE
10005,10CS003,1870,2320,2859,2784,-75,464,914,318,-197.12197843608317,72.970990618115,298.95537805813296,0.6011342155009451,2294,2886,3666,3314,-352,428,1020,338,-280.0780408343091,36.74818803262772,276.9310965552719,0.5609993278310983,239273,246271,Sussex,Sussex,10,5,Delaware,DE
11001,11CS001,3203,3974,4914,5284,370,1310,2081,831,-80.15017419039314,83.2255223004516,217.18560099282774,0.6285934005194306,3665,4640,5896,5828,-68,1188,2163,463,-78.91847805544187,107.73092937336726,252.62531452091267,0.35975157694425397,690654,672973,District of Columbia,District of Columbia,11,1,District of Columbia,DC
12001,12CS001,1384,1718,2110,1931,-179,214,547,133,-135.01043954380987,34.82326300312942,179.1126962291396,0.4143302180685358,1651,2070,2627,2438,-189,368,787,290,-171.6774583258269,27.941245173530508,178.10752692665852,0.643729982754373,277401,279157,Alachua,Alachua,12,1,Florida,FL
12003,12CS002,175,223,283,257,-26,34,82,36,-261.10702887662995,-8.422807383117096,193.72456981169321,0.782608695652174,209,272,354,368,14,96,159,80,-230.31993241622183,55.83513513120529,275.86046450761097,0.8163265306122449,28494,28656,Baker+Bradford+Union,Baker,12,3,Florida,FL
12005,12CS003,1267,1572,1970,1811,-159,240,544,179,-232.11691719778912,41.51684697846635,250.47353962215234,0.5774193548387097,1536,1946,2473,2549,76,602,1013,420,-192.76500899077456,102.25145804626177,332.359259797493,0.6703914884510143,174869,178482,Bay,Bay,12,5,Florida,FL
12007,12CS002,221,278,353,294,-59,16,73,20,-334.0380549682875,-16.913319238900634,224.31289640591945,0.36363636363636365,259,340,438,408,-30,68,149,87,-410.49530645406406,-64.87965116958723,217.60985703096674,1.0235294117647058,28380,28514,Baker+Bradford+Union,Bradford,12,7,Florida,FL
12009,12CS004,5202,6432,7926,7028,-898,596,1826,478,-271.659190857945,23.392518342234847,266.11210422995515,0.43873345633145466,6286,7854,9976,9279,-697,1426,2993,1073,-287.6558465074426,57.282538707947644,312.01514452821243,0.6184440094823508,607887,615371,Brevard,Brevard,12,9,Florida,FL
12011,12CS005,10059,12412,15407,15293,-114,2882,5234,1736,-114.31928006550477,70.76613634965453,216.1255257201649,0.5589196711878697,11822,14860,18725,18771,46,3910,6949,2673,-135.93915066491095,64.03559085203072,221.26819253561692,0.6520308227504416,1942454,1932519,Broward,Broward,12,11,Florida,FL
12013,12CS028,127,150,173,180,7,30,53,20,-118.06758620933702,90.85800140978138,285.7351443441657,0.6412153796033043,155,184,220,239,19,55,84,42,-168.65621935085687,95.32742832874519,307.9809222928691,0.7636363636363637,13694,13637,Liberty and Nearby Counties,Calhoun,12,13,Florida,FL
12015,12CS006,1830,2278,2807,2695,-112,416,865,245,-226.97750819378552,108.93141921151314,393.9315813118392,0.5020491803278688,2235,2808,3543,3342,-201,534,1107,388,-304.09221215648756,75.32015094553768,370.9775379790146,0.598304133614868,188926,193839,Charlotte,Charlotte,12,15,Florida,FL
12017,12CS007,1844,2292,2830,2726,-104,434,882,204,-240.12992442966845,178.6379826794454,527.7798873890979,0.4112903225806452,2255,2806,3601,3563,-38,758,1308,478,-327.5544337221431,177.40812755612632,527.0195646148538,0.5890328791918995,154167,157546,Citrus,Citrus,12,17,Florida,FL
12019,12CS008,1276,1582,1963,1861,-102,278,585,148,-136.88875118268663,71.44163978940455,239.2336903292704,0.4391691394658754,1543,1950,2480,2768,288,818,1225,476,-84.79036247767266,153.93890901714627,337.6738996917841,0.578020856681098,219200,221841,Clay,Clay,12,19,Florida,FL
12021,12CS009,2380,2958,3645,3412,-233,454,1032,318,-174.41830000093924,43.185376292632334,225.94019398815658,0.5473321858864028,2920,3652,4630,4462,-168,810,1542,498,-173.0780510067489,80.97598811745613,271.4190343288473,0.5436681222707423,379295,384682,Collier,Collier,12,21,Florida,FL
12023,12CS010,547,684,853,813,-40,129,266,96,-232.60187325070743,56.39869079554258,290.6241627206671,0.6486486486486487,660,834,1065,1137,72,303,477,178,-150.8974200950042,177.7773563795997,425.24343646000244,0.5760517799352751,70214,70313,Columbia,Columbia,12,23,Florida,FL
12027,12CS011,223,283,360,374,14,91,151,55,-141.95148428140968,124.64032766172556,332.37420709793486,0.5851063829787234,270,343,442,470,28,127,200,78,-145.66285572926012,142.6069916230519,355.20782301211176,0.6046511627906976,34660,34360,DeSoto+Hardee,DeSoto,12,27,Florida,FL
12029,12CS012,149,193,246,212,-34,19,63,14,-342.23858320586527,35.61275579665612,349.0050068072299,0.358974358974359,181,239,308,313,5,74,132,50,-263.7952069876419,140.6907770600757,480.69348828859194,0.6410256410256411,16848,17059,Dixie+Gilchrist+Levy,Dixie,12,29,Florida,FL
12031,12CS013,6164,7578,9358,8614,-744,1036,2450,709,-175.89953314773783,39.51914506983409,210.75263520856083,0.49876896779372304,7342,9318,11862,11537,-325,2220,4195,1831,-215.75610045087603,38.87271948484224,236.56826429346847,0.7603821909357704,991418,999416,Duval,Duval,12,31,Florida,FL
12033,12CS014,2457,3055,3797,3586,-211,531,1129,327,-200.53022779167233,76.03041812006535,298.9411685005118,0.5023041474654378,2962,3752,4764,4583,-181,830,1621,557,-228.97380399998502,84.83383282849621,330.0765016615877,0.5950854700854701,321976,322395,Escambia,Escambia,12,33,Florida,FL
12035,12CS015,993,1240,1545,1360,-185,120,367,53,-245.58888665190253,69.06382122005235,323.7753170928125,0.23766816143497757,1227,1566,2016,1844,-172,278,617,221,-326.9746834828773,47.41777625880678,329.4287613769734,0.634147646806969,116414,120208,Flagler,Flagler,12,35,Florida,FL
12037,12CS028,99,120,143,143,-0,23,44,7,-68.16695319556774,154.28526319139127,353.3005496375809,0.2844333536346617,121,147,179,205,26,58,84,38,-95.57881601741659,159.29802669569432,366.3854614000969,0.6551724137931034,12418,12555,Liberty and Nearby Counties,Franklin,12,37,Florida,FL
12039,12CS016,305,382,477,481,4,99,176,54,-136.39618545334682,122.75656690801213,332.80669250616626,0.5142857142857142,355,465,594,664,70,199,309,96,-59.480092518233654,235.6326742068487,487.393604269603,0.47880597014925375,43990,43712,Gadsden+Leon,Gadsden,12,39,Florida,FL
12041,12CS012,134,173,223,191,-32,18,57,13,-298.88885301402655,33.20987255711406,292.57897722817455,0.34210526315789475,162,213,277,301,24,88,139,42,-98.65005192107995,251.40733453571625,530.1415532600973,0.4666666666666667,18067,18297,Dixie+Gilchrist+Levy,Gilchrist,12,41,Florida,FL
12043,12CS017,81,99,118,129,11,30,48,16,-44.067600275140464,138.3717680827273,312.87898999025293,0.5273228114762525,96,120,146,167,21,47,71,16,40.896519876560674,253.55842323467618,449.86171864216743,0.3404255319148936,12438,12226,Glades+Hendry+Okeechobee,Glades,12,43,Florida,FL
12045,12CS028,128,151,174,197,23,46,69,22,5.642378881596108,201.90400439625688,397.81578744119435,0.48114442654330053,157,190,224,242,18,52,85,32,-98.00188912301095,139.5044685025067,370.0356027028987,0.6037735849056604,14100,14336,Liberty and Nearby Counties,Gulf,12,45,Florida,FL
12047,12CS018,113,133,157,176,19,43,63,19,-0.26235586638276387,203.24584092260778,378.6839416027722,0.4438046763049201,138,166,198,226,28,60,88,33,-35.73401386777521,192.96367488598617,393.07415254552734,0.55,14059,13992,Hamilton+Lafayette+Suwannee,Hamilton,12,47,Florida,FL
12049,12CS011,139,180,228,217,-11,37,78,21,-150.57318918301678,75.16914280587423,267.7900712459269,0.4772727272727273,167,220,284,352,68,132,185,74,-23.810773226982906,230.23640227743812,436.85881457770313,0.556390977443609,25542,25409,DeSoto+Hardee,Hardee,12,49,Florida,FL
12051,12CS017,203,260,330,315,-15,55,112,51,-197.58400415476495,11.965723188782132,182.47727862892754,0.8225806451612904,246,318,411,480,69,162,234,79,-25.23329925387742,206.34126483466284,385.3360969803945,0.48466257668711654,40115,40225,Glades+Hendry+Okeechobee,Hendry,12,51,Florida,FL
12053,12CS019,1932,2410,3003,2676,-327,266,744,203,-324.7138650522873,38.59806320432849,331.4838428047926,0.4603174603174603,2365,2966,3797,3688,-109,722,1323,557,-333.20847291539906,82.29531385719262,383.3360744259807,0.70062893081761,195865,199890,Hernando,Hernando,12,53,Florida,FL
12055,12CS020,1073,1341,1666,1582,-84,241,509,185,-316.1612027822173,65.8057140152543,380.7330596596855,0.6479879769353454,1310,1656,2095,2130,35,474,820,284,-241.8598253531269,184.96305391317009,520.469527822335,0.5685691382765531,102119,102994,Highlands,Highlands,12,55,Florida,FL
12057,12CS021,7202,8920,11066,10901,-165,1980,3699,945,-90.83283500928955,84.71350144296076,225.31500724203798,0.43871904118186644,8617,10790,13618,14310,692,3520,5693,1769,-72.94888014492219,118.59485924651615,265.87808932875765,0.48532294385770774,1466826,1476034,Hillsborough,Hillsborough,12,57,Florida,FL
12059,12CS022,189,237,302,286,-16,49,97,28,-269.08209332735197,128.27977207433355,421.7961077015583,0.4745762711864407,223,292,374,362,-12,70,139,47,-299.3364245364776,116.39455222889242,465.5782089155697,0.5949367088607594,19645,19760,Holmes+Walton,Holmes,12,59,Florida,FL
12061,12CS023,1450,1806,2218,2023,-195,217,573,141,-251.1672542772947,56.78628982619187,322.8225857816605,0.4345156695156695,1766,2211,2828,2716,-112,505,950,358,-288.0285454673359,90.08552379510293,363.03853262733975,0.6392857142857142,160602,163178,Indian River,Indian River,12,61,Florida,FL
12063,12CS024,418,532,661,666,5,134,248,102,-247.00560086260975,81.48638378972693,371.78162604062913,0.6986301369863014,511,652,850,761,-89,109,250,99,-394.75894506971275,20.99781622711238,317.067025029397,0.668918918918919,47124,47624,Jackson+Washington,Jackson,12,63,Florida,FL
12065,12CS025,121,142,165,184,19,42,63,13,47.50656850897722,237.77400516030258,414.4509106222477,0.31124326992427487,144,174,206,225,19,51,81,32,-89.31191183311267,130.53279421762622,336.63720614019394,0.6274509803921569,14519,14556,Jefferson+Madison+Taylor,Jefferson,12,65,Florida,FL
12067,12CS018,53,67,83,97,14,30,44,16,-29.507501892961375,196.75081710424953,411.1008035226598,0.540839048072307,65,84,105,118,13,34,53,22,-108.21421631882338,149.4671496116345,370.6785310368536,0.6285714285714286,8285,8363,Hamilton+Lafayette+Suwannee,Lafayette,12,67,Florida,FL
12069,12CS026,3186,3944,4892,4366,-526,422,1180,292,-255.55771220374174,40.45315209679081,277.4711378376403,0.4325925925925926,3874,4900,6213,5756,-457,856,1882,778,-313.2195109865034,19.779081814238396,279.9500810630665,0.7140891820624932,384148,394356,Lake,Lake,12,69,Florida,FL
12071,12CS027,4990,6200,7609,7250,-359,1050,2260,599,-149.5836113054656,70.4492572042241,259.5375628488211,0.47091224073429694,6066,7597,9669,9408,-261,1811,3341,1019,-163.1640385260993,100.94591923811322,296.0188098870176,0.5200309247903058,768212,784579,Lee,Lee,12,71,Florida,FL
12073,12CS016,1337,1670,2070,2057,-13,386,720,158,-70.22262437125156,93.69850901507144,230.49423158587155,0.37889688249400477,1622,2049,2579,2572,-7,523,950,309,-107.97499000686228,73.09917071011873,219.00716495697483,0.5430579964850615,292641,292753,Gadsden+Leon,Leon,12,73,Florida,FL
12075,12CS012,387,486,608,552,-56,66,165,30,-240.37641745790182,100.56421880865155,377.25549305856634,0.3191489361702128,465,601,775,757,-18,156,292,111,-293.3183700431141,102.28071795381742,411.5094219008586,0.6529411764705882,42958,43997,Dixie+Gilchrist+Levy,Levy,12,75,Florida,FL
12077,12CS028,45,59,74,78,4,19,33,15,-164.49572931372063,56.93650257815444,266.0669438093698,0.7976531007037778,55,72,92,117,25,45,62,17,101.12767896175583,353.9468763661454,569.475242153387,0.37777777777777777,8020,7911,Liberty and Nearby Counties,Liberty,12,77,Florida,FL
12079,12CS025,150,192,251,273,22,81,123,38,-106.08113318960505,285.09304544706356,563.5560200697769,0.4634146341463415,183,236,311,303,-8,67,120,51,-323.42058380156226,87.70727696313553,378.237631903522,0.6891891891891891,18099,18242,Jefferson+Madison+Taylor,Madison,12,79,Florida,FL
12081,12CS029,2883,3557,4407,4106,-301,549,1223,379,-202.63647102739702,50.640499925994114,251.4300821325608,0.5465035284920011,3465,4384,5545,5302,-243,918,1837,694,-228.00756822133621,54.61477627707654,278.073140416536,0.6587578613518823,402840,411061,Manatee,Manatee,12,81,Florida,FL
12083,12CS030,3693,4567,5707,5251,-456,684,1558,441,-285.8511930768561,77.42931659533612,355.9518089244854,0.49550624353773964,4519,5676,7229,7072,-157,1396,2553,1110,-329.38720831581054,74.34966384777383,375.12784941376793,0.7324316204707542,376602,384669,Marion,Marion,12,83,Florida,FL
12085,12CS031,1303,1616,1992,1995,3,379,692,167,-123.83425375869093,159.93214618850126,396.2092602745322,0.4143920595533499,1558,1950,2503,2462,-41,512,904,225,-166.77524429967426,179.67152820573017,425.17044732028444,0.4124659743925799,159067,159736,Martin,Martin,12,85,Florida,FL
12086,12CS032,13276,16340,20219,22009,1790,5668,8733,3655,-83.11243666438165,89.74948580056444,226.32827866945414,0.6386510766370361,15613,19537,24851,26100,1249,6563,10487,4101,-106.91927508495282,92.30980494070235,239.4280878920946,0.6077806895396258,2692160,2667106,Miami-Dade,Miami-Dade,12,86,Florida,FL
12087,12CS033,511,638,793,662,-131,24,151,40,-252.029735604219,-23.574836420154952,163.55042766482495,0.32786885245901637,594,772,977,855,-122,82,261,56,-216.3786809257786,32.21368002546704,249.38250781979468,0.36363636363636365,81443,82263,Monroe,Monroe,12,87,Florida,FL
12089,12CS034,656,823,1018,901,-117,78,245,67,-242.70548464381255,14.509567016749664,234.85712793929792,0.4393489852081183,801,1027,1299,1209,-90,182,408,169,-276.45319759041496,13.8706737501945,255.11369951319259,0.7444933920704846,90974,93723,Nassau,Nassau,12,89,Florida,FL
12091,12CS035,1276,1579,1976,1896,-80,317,620,200,-158.5641762154522,66.25717363288538,237.87457935464528,0.5555555555555556,1504,1920,2448,2362,-86,442,858,305,-183.67087099914158,64.54062039964725,259.5941099056357,0.6161616161616161,211902,213044,Okaloosa,Okaloosa,12,91,Florida,FL
12093,12CS017,303,382,479,467,-12,85,164,55,-200.64542191845345,89.84123369482991,326.5728844807066,0.5851063829787234,363,471,600,657,57,186,294,103,-114.49948221135423,206.59689181613916,475.42176309497086,0.544973544973545,40071,40175,Glades+Hendry+Okeechobee,Okeechobee,12,93,Florida,FL
12095,12CS036,5805,7183,8880,8379,-501,1196,2574,745,-104.96176648213586,38.002453886278865,154.12902112214408,0.5094017689416925,6840,8626,10934,10777,-157,2150,3937,1451,-112.9626535436639,49.12946569701427,174.60801743540003,0.6255665814262035,1424119,1423789,Orange,Orange,12,95,Florida,FL
12097,12CS037,1774,2190,2745,2531,-214,340,757,276,-150.92519236752378,19.86060370846738,148.1231537047788,0.6359447004608295,2183,2744,3492,3533,41,789,1350,605,-140.4838170914401,45.83159990217195,185.59307112558866,0.7210965435041716,389716,401470,Osceola,Osceola,12,97,Florida,FL
12099,12CS038,9747,12070,14971,14606,-365,2536,4859,1572,-155.57708346271485,77.47926731026408,264.0641239007777,0.5603287993700274,11496,14446,18420,17803,-617,3356,6307,1994,-174.3976520109051,91.00430894270818,288.05785937076297,0.5438441257106199,1493819,1497182,Palm Beach,Palm Beach,12,99,Florida,FL
12101,12CS039,4493,5544,6857,6147,-710,604,1654,352,-225.28675193524813,53.32669939926109,276.0266293358173,0.35323641607553585,5459,6834,8617,8130,-487,1296,2671,1049,-264.24373960877574,42.57002249116188,279.04434742843017,0.6789644012944984,565945,581395,Pasco,Pasco,12,101,Florida,FL
12103,12CS040,7991,9866,12267,11173,-1094,1308,3182,747,-229.93438194000066,69.9930598367297,304.12327908362437,0.41247979627510545,9514,11914,15090,13923,-1167,2009,4409,1235,-250.98057520474785,80.8839427107777,331.67119066227616,0.48526642467225223,960952,956927,Pinellas,Pinellas,12,103,Florida,FL
12105,12CS041,4902,6088,7575,7210,-365,1122,2308,718,-177.81527878936444,66.38940397849171,260.98667672780863,0.5533726085592907,5978,7499,9564,9804,240,2305,3826,1555,-175.3784436663168,100.00291397379885,302.7554886252101,0.6552891296144199,731141,749978,Polk,Polk,12,105,Florida,FL
12107,12CS042,686,855,1070,994,-76,139,308,71,-239.84437163916647,110.91069208747584,386.8010386550717,0.3901098901098901,814,1042,1320,1489,169,446,675,265,-129.7141808908481,245.11321011649065,553.7667868224075,0.5888888888888889,73573,74047,Putnam,Putnam,12,107,Florida,FL
12109,12CS043,1493,1850,2296,1984,-312,134,491,101,-179.06277080484952,14.089190294534827,169.0919592117941,0.3079268292682927,1847,2337,2974,2677,-297,340,830,300,-205.6352560081404,13.783678659950759,182.65097184267248,0.6172839506172839,276808,290198,St. Johns,St. Johns,12,109,Florida,FL
12111,12CS044,2359,2893,3606,3405,-201,512,1046,362,-203.33149396282457,54.20245973773537,247.2535538369694,0.5838709677419355,2864,3606,4584,4440,-144,834,1576,522,-194.84490234592147,91.43183719964031,308.32278413113886,0.5708038885102414,332088,341785,St. Lucie,St. Lucie,12,111,Florida,FL
12113,12CS045,1176,1444,1798,1572,-226,128,396,130,-226.3134795968685,-1.2699970796681734,169.00486137684211,0.5088082107843137,1442,1818,2291,2097,-194,279,655,332,-272.23551493454994,-27.420148786642248,167.2111714687315,0.8567756200218439,188977,193289,Santa Rosa,Santa Rosa,12,113,Florida,FL
12115,12CS046,3956,4911,6105,5783,-322,872,1826,387,-194.80037211954019,133.2555436924922,395.5079487532835,0.37941322342646455,4804,6072,7696,7121,-575,1049,2317,682,-282.1986170063733,82.39867327658446,367.11190919494067,0.5184341303870468,436755,445396,Sarasota,Sarasota,12,115,Florida,FL
12117,12CS047,2377,2950,3641,3358,-283,408,981,248,-135.31908457310107,40.88613153987712,186.7770195952517,0.4316800484775034,2838,3555,4488,4398,-90,843,1560,530,-131.87059148201078,66.56264333796061,219.13570551949357,0.5683647746666115,471064,470234,Seminole,Seminole,12,117,Florida,FL
12119,12CS048,1379,1703,2122,2017,-105,314,638,117,-202.1089047597823,179.3488929625095,474.36416587875925,0.31923661053289853,1705,2132,2733,2742,9,610,1037,320,-230.68383374473575,214.529296078063,531.3953651729843,0.49420878890224584,131810,134947,Sumter,Sumter,12,119,Florida,FL
12121,12CS018,374,476,607,587,-20,111,213,71,-249.63268999511837,109.72865494290917,389.53672504732754,0.5941526610644258,452,586,750,785,35,200,333,161,-284.1497706082581,86.82354101918997,387.8869884493682,0.7740384615384616,43744,44343,Hamilton+Lafayette+Suwannee,Suwannee,12,121,Florida,FL
12123,12CS025,172,222,281,284,3,62,112,31,-154.60211619315297,171.16662864241937,447.24183613019244,0.47692307692307695,208,272,347,330,-17,58,122,49,-302.65539988631315,41.271190893588155,334.7552150257706,0.7101449275362319,21733,21807,Jefferson+Madison+Taylor,Taylor,12,123,Florida,FL
12125,12CS002,169,216,273,259,-14,43,90,58,-539.5068570135111,-112.3972618778148,239.78082533933826,1.1372549019607843,203,265,345,249,-96,-16,46,27,-755.0053218879732,-263.73053485932456,116.5320967983062,-0.42857142857142855,16015,16305,Baker+Bradford+Union,Union,12,125,Florida,FL
12127,12CS049,4975,6138,7620,6918,-702,780,1943,402,-238.26411046749683,81.61652356747965,332.727679411339,0.36298153356976887,5991,7520,9552,9312,-240,1792,3321,1137,-244.50957789432005,116.42467461571698,387.9046367059129,0.5805472824369687,555770,563025,Volusia,Volusia,12,127,Florida,FL
12129,12CS028,197,252,320,321,1,69,124,30,-102.68331089365556,137.85367039079404,332.26269273678565,0.40540540540540543,240,312,406,414,8,102,174,60,-150.3941519812441,121.4721996771587,329.7102562665736,0.5607476635514018,33949,34576,Liberty and Nearby Counties,Wakulla,12,129,Florida,FL
12131,12CS022,492,616,766,665,-101,49,173,49,-236.79032463985072,0,195.83924883575776,0.44545454545454544,604,777,1004,892,-112,115,288,127,-300.9271034193068,-15.102991388672862,202.6318011313609,0.7839506172839507,76042,79454,Holmes+Walton,Walton,12,131,Florida,FL
12133,12CS024,231,292,373,299,-74,7,68,22,-453.40905456963617,-70.84516477650564,217.4946558638721,0.3728813559322034,275,359,466,418,-48,59,143,62,-432.8505582300522,-11.799651746389427,318.5905971525146,0.7560975609756098,25408,25424,Jackson+Washington,Washington,12,133,Florida,FL
13001,13CS001,137,177,229,232,3,55,95,48,-293.02339778265394,45.58141743285728,306.0466599063274,0.8275862068965517,162,215,281,269,-12,54,107,58,-378.80325229649475,-21.64590013122827,265.4328503591864,0.9354838709677419,18429,18479,Appling+Jeff Davis+Long+Wayne,Appling,13,1,Georgia,GA
13003,13CS053,56,72,88,80,-8,8,24,11,-274.07798847540516,-36.511123487388794,189.17739825122683,0.8205395549447668,69,88,111,139,28,51,70,28,0,274.5326231293735,501.3204422362473,0.5490196078431373,8306,8378,Lanier and Nearby Counties,Atkinson,13,3,Georgia,GA
13005,13CS002,90,109,129,146,17,37,56,25,-87.6534006715076,125.82164497816167,338.85287556411055,0.6820539942662678,108,132,159,185,26,53,77,40,-126.29205036647248,117.27118962601016,333.77184739710583,0.7547169811320755,11115,11085,Bacon+Ben Hill+Coffee+Irwin,Bacon,13,5,Georgia,GA
13007,13CS014,20,29,39,38,-1,9,18,4,-193.9841734931664,218.37969071892186,596.3798995800029,0.39813336942540994,24,37,52,46,-6,9,22,2,-283.42202572940573,247.99427251323002,708.5550643235143,0.16666666666666666,2871,2823,Calhoun and Nearby Counties,Baker,13,7,Georgia,GA
13009,13CS066,307,384,476,498,22,114,191,45,-62.929933286724875,188.38027751774476,398.60174663174973,0.3813559322033898,364,468,604,620,16,152,256,88,-164.57349083862815,145.04395098199703,383.852534842907,0.5605095541401274,43954,43780,Washington and Nearby Counties,Baldwin,13,9,Georgia,GA
13011,13CS003,127,151,175,168,-7,17,41,18,-164.8738652248849,-8.373536591844303,148.39662019401146,0.8639280374833136,158,189,222,268,46,79,110,41,27.04149178896369,205.51533759612403,373.1725866876989,0.5189873417721519,18282,18490,Banks+Habersham,Banks,13,11,Georgia,GA
13013,13CS004,444,559,705,619,-86,60,175,55,-200.97871208418655,7.126904683836402,171.18825050575026,0.5445544554455446,544,698,893,889,-4,191,345,114,-136.90375995086845,89.25986042520634,267.837542223947,0.5560975609756098,84188,86265,Barrow,Barrow,13,13,Georgia,GA
13015,13CS005,656,815,1024,1038,14,223,382,119,-115.33818613157479,114.23972721603597,289.0045406782601,0.5085470085470085,789,1010,1292,1338,46,328,549,182,-122.94387295799795,132.4358631496081,331.8128571267143,0.533724340175953,109244,110620,Bartow,Bartow,13,15,Georgia,GA
13017,13CS002,149,195,247,267,20,72,118,50,-211.0121605559111,154.4847764469233,477.4983999268538,0.684931506849315,183,236,312,287,-25,50,104,39,-373.01969888859077,67.02697714404366,379.13955332348144,0.6290322580645161,17089,17157,Bacon+Ben Hill+Coffee+Irwin,Ben Hill,13,17,Georgia,GA
13019,13CS053,142,184,233,227,-6,43,85,30,-235.61012523605325,85.08143411301921,359.95991355508136,0.625,170,225,290,286,-4,61,116,37,-226.18637647220885,132.24051243198568,435.2916867552862,0.5441176470588235,18335,18149,Lanier and Nearby Counties,Berrien,13,19,Georgia,GA
13021,13CS006,1197,1482,1824,1827,3,346,630,199,-150.48141672982206,112.33389834863152,330.52236780326024,0.5385666153958837,1424,1802,2286,2317,31,514,893,332,-192.01351938429409,116.38149215421345,357.7535183480205,0.6036383591350716,156498,156812,Bibb,Bibb,13,21,Georgia,GA
13023,13CS007,90,109,129,175,46,66,85,30,151.27452082573254,338.73960029335876,518.3936347831675,0.45694100527833115,106,130,155,197,42,67,91,43,-7.934854841749238,190.43651620198173,380.87303240396346,0.6417910447761194,12631,12603,Bleckley+Dodge+Pulaski+Twiggs,Bleckley,13,23,Georgia,GA
13025,13CS008,129,165,211,207,-4,42,78,29,-217.8589698253516,85.69339206443483,322.99817008902363,0.6304347826086957,152,201,266,294,28,93,142,67,-215.56364942809995,143.70909961873332,414.545479669423,0.7127659574468085,18204,18092,Brantley+Pierce+Ware,Brantley,13,25,Georgia,GA
13027,13CS009,136,180,228,200,-28,20,64,28,-416.5676560837268,-59.50966515481811,268.1654286038987,0.7368421052631579,170,222,287,231,-56,9,61,35,-559.5021865160998,-159.8577675760285,160.47260514362804,0.7,16132,16264,Brooks+Thomas,Brooks,13,27,Georgia,GA
13029,13CS010,218,279,352,295,-57,16,77,19,-205.28038009883244,-8.103172898638123,156.6613427070037,0.3584905660377358,272,350,447,369,-78,19,97,54,-283.03365423043414,-75.01838620268987,92.27261502930844,0.7397260273972602,44427,46655,Bryan+Liberty,Bryan,13,29,Georgia,GA
13031,13CS011,378,474,592,559,-33,84,181,53,-127.02046543400196,46.52493792059374,189.05371599479363,0.5247524752475248,451,579,746,748,2,169,297,146,-175.17990930100197,27.951008768109926,183.5652119314349,0.8111111111111111,81247,82287,Bulloch,Bulloch,13,31,Georgia,GA
13033,13CS012,167,217,275,248,-27,31,81,25,-257.01377656311,29.655435757281925,276.7840670679646,0.5555555555555556,201,263,344,286,-58,23,85,52,-451.6460702942628,-119.07032762303292,135.49382108827885,0.9454545454545454,24279,24355,Burke+Emanuel+Jenkins+Screven,Burke,13,33,Georgia,GA
13035,13CS013,190,243,307,290,-17,47,100,41,-273.43650334141284,28.26217088800133,277.91134706534643,0.7454545454545455,230,297,387,361,-26,64,131,55,-314.8044003350016,34.956688501110605,295.38401783438445,0.7142857142857143,25476,25746,Butts+Lamar+Monroe,Butts,13,35,Georgia,GA
13037,13CS014,36,48,62,70,8,22,34,7,28.45462338188907,325.52861600309177,570.1777863970235,0.3136864960344257,43,57,75,68,-7,11,25,5,-217.531695047755,108.7658475238775,362.5528250795917,0.35714285714285715,5646,5516,Calhoun and Nearby Counties,Calhoun,13,37,Georgia,GA
13039,13CS015,257,322,418,357,-61,35,100,22,-181.29586705697406,28.378642645883957,170.27185587530374,0.3384615384615385,312,400,516,529,13,129,217,82,-124.29306071662015,84.60208332630192,243.18598845496555,0.6074074074074074,54971,55554,Camden+Charlton,Camden,13,39,Georgia,GA
13043,13CS016,95,113,133,174,41,61,79,35,63.51190953109664,288.1321002003688,485.7978679893284,0.5703540916949845,110,137,164,234,70,97,124,42,253.81285834069845,498.56097174065764,743.3090851406168,0.4329896907216495,10981,11032,Candler+Evans+Tattnall+Toombs,Candler,13,43,Georgia,GA
13045,13CS017,750,940,1170,1159,-11,219,409,126,-137.25700548726874,93.14047070642825,283.477529391984,0.5361702127659574,904,1154,1475,1501,26,347,597,207,-148.84539455593858,115.1290344631569,320.75771351681675,0.5602175346077785,119819,121603,Carroll+Heard,Carroll,13,45,Georgia,GA
13047,13CS018,442,556,697,645,-52,89,203,60,-198.01999622342606,51.204457338202005,252.4909448056168,0.5357142857142857,525,677,860,901,41,224,376,151,-161.1165970399154,106.82571829167871,329.33051919920945,0.6551006964050442,67963,68336,Catoosa,Catoosa,13,47,Georgia,GA
13049,13CS015,82,99,117,141,24,42,59,17,68.74519895755279,240.14122916481756,396.3453385128016,0.40149312471048093,97,121,148,178,30,57,81,45,-117.81723928026756,94.25379142421404,282.7613742726422,0.7894736842105263,12664,12732,Camden+Charlton,Charlton,13,49,Georgia,GA
13051,13CS019,1707,2103,2600,2425,-175,322,718,193,-150.0386001357162,52.58790766881508,214.02055446610788,0.44936032959288774,2034,2563,3238,3199,-39,636,1164,396,-147.01751120054521,81.04789867493018,259.52212554868254,0.5743295260932668,294364,296121,Chatham,Chatham,13,51,Georgia,GA
13053,13CS055,22,31,42,35,-7,4,13,6,-160.66938087410455,-27.856491031287533,84.5236465280191,0.762482311127194,25,36,50,39,-11,3,14,4,-164.63088383919222,-10.975392255946149,109.75392255946149,0.4,9657,9111,Marion and Nearby Counties,Chattahoochee,13,53,Georgia,GA
13055,13CS020,220,276,354,336,-18,60,116,36,-260.1238732899682,115.61061035109698,385.3687011703233,0.5373134328358209,256,339,442,380,-62,41,124,48,-441.2284535527665,-28.078174316994232,304.84874972736594,0.6713615023474178,24911,24930,Chattooga+Dade+Walker,Chattooga,13,55,Georgia,GA
13057,13CS021,1160,1437,1799,1630,-169,193,470,116,-127.90580661281594,34.54488638788786,158.88404563987635,0.42962962962962964,1411,1786,2288,2243,-45,456,832,260,-111.45355842891898,71.80532534846748,209.03937081725604,0.5215652187909956,267478,273657,Cherokee+Pickens,Cherokee,13,57,Georgia,GA
13059,13CS022,514,644,803,698,-105,54,184,50,-144.77466119113157,3.269105252702971,125.25343268213373,0.43478260869565216,610,777,1001,967,-34,190,357,86,-93.44986395370637,80.82150395996227,210.64104469565163,0.41545893719806765,128476,128679,Clarke+Madison+Oconee,Clarke,13,59,Georgia,GA
13061,13CS014,26,36,49,37,-12,1,11,6,-771.8782909165825,-217.915374155826,197.55681341474116,0.561209981869077,32,46,62,57,-5,11,25,5,-347.8084444991921,208.68506669951523,695.6168889983842,0.38461538461538464,2850,2875,Calhoun and Nearby Counties,Clay,13,61,Georgia,GA
13063,13CS023,1213,1509,1889,1920,31,411,707,204,-70.04144855028392,83.73421801853176,203.51055596677932,0.4755244755244755,1461,1845,2327,2628,301,783,1167,432,-44.1701718268762,118.12365951416037,247.40344242688028,0.5475285171102662,296653,297146,Clayton,Clayton,13,63,Georgia,GA
13065,13CS053,58,73,90,92,2,19,34,13,-189.8064685906359,104.2270735693346,383.5589386213067,0.6759953413312616,70,91,112,116,4,25,46,19,-223.05800127638744,89.22320051055499,401.5044022974974,0.7307692307692307,6711,6725,Lanier and Nearby Counties,Clinch,13,65,Georgia,GA
13067,13CS024,3055,3803,4675,4574,-101,771,1519,451,-86.56078328469263,50.16198958910113,167.415640253625,0.5104711941273685,3640,4618,5887,5655,-232,1038,2015,629,-112.3428411966683,53.2792135935903,180.78413209810407,0.5448247015838004,765520,766716,Cobb,Cobb,13,67,Georgia,GA
13069,13CS002,280,356,446,479,33,123,199,94,-170.0528806011689,80.71249652101308,292.2349011967715,0.752,331,433,553,551,-2,118,220,113,-265.48021661847315,11.53760176525307,246.90467777641572,0.8862881397637795,43116,43337,Bacon+Ben Hill+Coffee+Irwin,Coffee,13,69,Georgia,GA
13071,13CS025,328,417,522,525,3,108,197,55,-136.32475892578228,138.81291494844305,371.91384759771535,0.4782608695652174,390,505,647,640,-7,135,250,108,-250.9827885824656,58.92639384110061,309.9091824235662,0.7346938775510204,45817,45820,Colquitt+Mitchell,Colquitt,13,71,Georgia,GA
13073,13CS026,672,831,1040,1012,-28,181,340,101,-98.5594395914253,61.09845150960113,182.60799694932027,0.5101140218860801,805,1034,1321,1356,35,322,551,175,-87.99088269583297,92.32448077292968,236.18109520177006,0.5223880597014925,157123,159221,Columbia,Columbia,13,73,Georgia,GA
13075,13CS053,139,160,187,213,26,53,74,32,-39.191940136222776,146.87341696330992,292.86315868755844,0.602766466798783,165,197,230,230,0,33,65,29,-168.34996474567907,23.22068479250746,208.98616313256713,0.8055555555555556,17233,17226,Lanier and Nearby Counties,Cook,13,75,Georgia,GA
13077,13CS027,728,910,1126,1100,-26,190,372,95,-98.67791154841207,77.41041781254457,225.8347083868075,0.4418604651162791,878,1121,1431,1579,148,458,701,247,-66.36591822424337,141.16137848100155,303.7311176795009,0.5334798104194656,147267,149474,Coweta,Coweta,13,77,Georgia,GA
13079,13CS028,103,123,145,140,-5,17,37,5,-95.85648876702297,115.41577869565963,318.9684825395131,0.2504253013441126,128,156,187,213,26,57,85,30,-32.93462990567316,222.30875186329382,452.851161203006,0.5263157894736842,12141,12145,Crawford+Peach+Pike+Upson,Crawford,13,79,Georgia,GA
13081,13CS029,154,197,252,318,66,121,164,45,123.73399237505637,447.7992105002041,701.1592901253194,0.371900826446281,181,239,308,346,38,107,165,66,-140.68392905929136,206.0014675511052,497.4181777453516,0.6111111111111112,20366,19903,Crisp+Dooly+Turner+Wilcox,Crisp,13,81,Georgia,GA
13083,13CS020,132,155,179,207,28,52,75,8,146.30000395504473,322.72519088198857,493.06675067352063,0.15499801521017734,158,188,220,247,27,59,89,31,-24.523139881522578,171.66197917065804,355.89206753059614,0.5254237288135594,16217,16311,Chattooga+Dade+Walker,Dade,13,83,Georgia,GA
13085,13CS030,173,222,283,230,-53,8,57,18,-314.8718754186512,-44.34815146741566,172.9577907229211,0.375,217,282,364,317,-47,35,100,56,-364.1436363984544,-74.24287732395672,155.73327362477573,0.8960573476702509,27059,28286,Dawson+Lumpkin+White,Dawson,13,85,Georgia,GA
13087,13CS031,226,295,370,367,-3,72,141,39,-174.44099132554095,137.06077889863934,423.64240750488517,0.5,274,358,460,397,-63,39,123,51,-391.9984182519965,-41.262991394947,247.74987750049416,0.6710526315789473,28892,29082,Decatur+Grady+Seminole,Decatur,13,87,Georgia,GA
13089,13CS032,3204,3939,4895,4797,-98,858,1593,479,-90.83880442648383,59.63607635135522,175.35209363047557,0.5031518156731247,3822,4788,6094,5888,-206,1100,2066,564,-101.48831792159201,70.6555895648439,198.0070169502836,0.4602203948463562,762626,758609,DeKalb,DeKalb,13,89,Georgia,GA
13091,13CS007,144,185,233,289,56,104,145,67,-66.13343798894228,222.44883687189673,468.9461966488634,0.6442307692307693,170,223,291,320,29,97,150,64,-177.01688614653207,166.90163550958738,435.20865865454505,0.6530612244897959,19960,19772,Bleckley+Dodge+Pulaski+Twiggs,Dodge,13,91,Georgia,GA
13093,13CS029,72,90,106,170,64,80,98,20,460.7541936135751,633.1651769120468,814.1967093754419,0.2488007787404203,84,103,128,174,46,71,90,25,192.26404261852946,421.14980764058834,595.1029890573532,0.352112676056338,11445,10922,Crisp+Dooly+Turner+Wilcox,Dooly,13,93,Georgia,GA
13095,13CS033,622,777,981,1089,108,312,467,173,-91.04230305901166,194.69046346465572,411.79133998999123,0.550080881609544,744,947,1199,1205,6,258,461,149,-168.51129222902108,128.35591092217538,367.40407530017177,0.5321428571428571,85674,84920,Dougherty,Dougherty,13,95,Georgia,GA
13097,13CS034,672,828,1035,1034,-1,206,362,108,-90.27782368999507,81.13000203227435,210.27571955303762,0.4931506849315068,799,1012,1297,1309,12,296,510,164,-104.41421300276271,90.98903796689285,237.63589878070394,0.5222929936305732,144953,145622,Douglas,Douglas,13,97,Georgia,GA
13099,13CS014,106,127,148,172,24,45,66,35,-123.2208082050879,116.51137772332292,347.0230949621794,0.7711148308433572,127,155,184,194,10,39,67,23,-122.09677734948245,150.27295673782456,413.25063102901754,0.575,10700,10647,Calhoun and Nearby Counties,Early,13,99,Georgia,GA
13101,13CS053,12,18,26,36,10,18,24,1,279.21618515286826,543.3432302308206,754.6448662931825,0.05582634432155049,13,21,32,42,10,21,29,3,189.26272031363536,486.6755665207766,702.9758183077885,0.14285714285714285,3735,3699,Lanier and Nearby Counties,Echols,13,101,Georgia,GA
13103,13CS035,333,416,520,470,-50,54,137,31,-149.08456593211884,42.332654523934984,195.09832084943946,0.3875,403,519,660,658,-2,139,255,143,-218.31638647789097,-6.014225522806914,168.39831463859358,0.9533333333333334,65198,66509,Effingham,Effingham,13,103,Georgia,GA
13105,13CS036,177,223,287,296,9,73,119,27,-110.42686031129979,282.20197635109946,564.4039527021989,0.36,208,272,354,331,-23,59,123,39,-316.55263964055956,102.11375472276116,429.13305422240353,0.5532193158953722,19560,19586,Elbert+Franklin+Hart+Stephens,Elbert,13,105,Georgia,GA
13107,13CS012,199,253,318,304,-14,51,105,47,-322.5950865089995,21.136451204520853,306.4785424655523,0.7966101694915254,238,310,403,407,4,97,169,82,-343.5595424341519,66.02681789253401,383.1756331696722,0.803921568627451,22710,22718,Burke+Emanuel+Jenkins+Screven,Emanuel,13,107,Georgia,GA
13109,13CS016,80,98,119,126,7,28,46,11,-47.54461277099747,191.88219956800017,394.0852656508388,0.390568190892271,94,119,145,179,34,60,85,33,8.891471402025177,252.70497668913583,486.6910662161134,0.55,10734,10684,Candler+Evans+Tattnall+Toombs,Evans,13,109,Georgia,GA
13111,13CS037,224,286,363,352,-11,66,128,26,-173.85955652434254,187.95627732361353,479.28850717521453,0.35135135135135137,272,354,459,470,11,116,198,79,-264.02020919395375,143.65805500259248,462.03536608941903,0.6370967741935484,25538,25756,Fannin+Rabun+Towns+Union,Fannin,13,111,Georgia,GA
13113,13CS038,626,774,973,868,-105,94,242,70,-176.88095251032334,24.735064706066908,173.65025018136768,0.4560308972073678,744,949,1203,1189,-14,240,445,145,-132.05018114509585,78.89790697348495,249.15128517942614,0.5598455598455598,118860,120409,Fayette,Fayette,13,113,Georgia,GA
13115,13CS039,771,964,1191,1143,-48,178,372,107,-188.87628770544848,87.04256893934622,322.66619436886316,0.5169082125603864,922,1176,1500,1454,-46,278,532,207,-256.2660319231219,71.90234446370935,329.2317209176325,0.6731725115275604,98572,98745,Floyd,Floyd,13,115,Georgia,GA
13117,13CS040,828,1043,1290,1196,-94,153,368,71,-78.50421184487573,38.99058371459606,141.22199223457352,0.34889645513377765,1011,1277,1639,1702,63,425,691,201,-53.333556306876346,86.44512744385167,189.09871628342555,0.4610115994634262,252369,259124,Forsyth,Forsyth,13,117,Georgia,GA
13119,13CS036,207,263,333,323,-10,60,116,33,-220.29400607485806,138.163488130573,424.98065515718827,0.4852941176470588,247,322,416,369,-47,47,122,43,-379.21747771219503,16.854110120542,333.0793512572111,0.5972222222222222,23450,23733,Elbert+Franklin+Hart+Stephens,Franklin,13,119,Georgia,GA
13121,13CS041,4609,5660,6984,7006,22,1346,2397,687,-74.72650192285894,74.04114383876717,192.13620649267926,0.4853409295082949,5430,6839,8592,8396,-196,1557,2966,877,-100.71566013390249,63.79753040619813,195.97100222421557,0.4991462720546386,1068055,1065872,Fulton,Fulton,13,121,Georgia,GA
13123,13CS042,242,306,386,363,-23,56,121,33,-213.2488518106914,89.48835745627228,335.10533855965787,0.4714285714285714,287,378,487,506,19,128,219,93,-231.69211561906218,108.01862147104926,394.50279145948423,0.7018967874231032,31512,31939,Gilmer+Murray,Gilmer,13,123,Georgia,GA
13125,13CS066,22,32,43,38,-5,6,16,10,-610.8766899393543,-168.2857741980596,240.2596864862121,1.084042086320077,28,39,54,51,-3,12,23,5,-274.56027456027454,240.24024024024024,617.7606177606177,0.35714285714285715,2898,2914,Washington and Nearby Counties,Glascock,13,125,Georgia,GA
13127,13CS043,593,742,924,945,21,203,352,107,-122.02377362104453,136.13343716002643,347.42387608548415,0.5071090047393365,714,906,1151,1142,-9,236,428,189,-233.76686625234376,55.490114716465435,282.17313653691997,0.7529880478087649,84623,84700,Glynn+McIntosh,Glynn,13,127,Georgia,GA
13129,13CS044,380,481,607,593,-14,112,213,61,-155.80399507958546,105.87613256574097,315.55239509789465,0.5,463,593,754,774,20,181,311,122,-175.72787398144925,101.44759848244136,325.0621778492463,0.64380395433027,57803,58158,Gordon,Gordon,13,129,Georgia,GA
13131,13CS031,180,232,294,273,-21,41,93,38,-272.818790329961,13.872141881184461,254.32260115504843,0.71698113207547165,216,282,367,349,-18,67,133,49,-258.26021016141266,69.33160004333224,323.7400546467818,0.6447368421052632,25951,25962,Decatur+Grady+Seminole,Grady,13,131,Georgia,GA
13133,13CS062,157,185,213,212,-1,27,55,23,-151.33483819326077,25.39098036421353,202.11679892168783,0.7801211786609644,197,229,268,275,7,46,78,33,-133.59724498501848,66.79862249250924,231.2260009356089,0.6875,18981,19461,Taliaferro and Nearby Counties,Greene,13,133,Georgia,GA
13135,13CS045,3008,3742,4584,4746,162,1004,1738,531,-46.39109005992953,59.401693552643934,151.5936242862505,0.5115611684330401,3584,4538,5774,6005,231,1466,2421,761,-55.01460260539703,73.21788745162726,172.28776039467954,0.5044746991086198,955528,963562,Gwinnett,Gwinnett,13,135,Georgia,GA
13137,13CS003,317,402,505,508,3,106,191,74,-184.84535653783777,83.31058322832125,304.60431992854956,0.6607142857142857,380,490,633,608,-25,118,228,94,-254.94662055132207,52.48901011350748,287.40411047865393,0.7175572519083969,46093,46676,Banks+Habersham,Habersham,13,137,Georgia,GA
13139,13CS046,1047,1316,1625,1728,103,412,681,183,-47.185551895072976,134.64786771304315,292.8444127269919,0.4346793349168646,1262,1610,2037,2032,-5,422,770,332,-163.0662745339798,43.27481562873593,211.82901370892966,0.7377777777777778,204088,206818,Hall,Hall,13,139,Georgia,GA
13141,13CS047,86,104,125,159,34,55,73,40,-83.09408682031778,213.1167326749429,463.2755821527063,0.72190382663867525,108,132,161,168,7,36,60,30,-266.0984757185141,69.41699366569934,347.08496832849664,0.8108108108108109,8676,8643,Hancock+Jasper+Morgan+Putnam,Hancock,13,141,Georgia,GA
13143,13CS048,242,306,385,392,7,86,150,50,-172.0198569831038,143.8493577559056,399.5815493219601,0.5494505494505495,291,373,478,448,-30,75,157,68,-321.4548565719546,22.961061183711042,292.0974997727811,0.7640449438202247,30031,30486,Haralson+Polk,Haralson,13,143,Georgia,GA
13145,13CS049,194,249,317,284,-33,35,90,29,-212.34164457747505,20.54919141072339,209.08802260411034,0.5686274509803921,235,307,400,347,-53,40,112,58,-312.46426277963,-50.66988045075082,152.1503910201711,0.8529411764705882,35038,35524,Harris+Meriwether+Talbot,Harris,13,145,Georgia,GA
13147,13CS036,195,254,318,324,6,70,129,36,-138.57190743268276,157.04816175704045,429.57291304131655,0.4864864864864865,235,308,396,408,12,100,173,52,-152.10894494596192,182.30285536594687,459.9349121836698,0.5,25979,26330,Elbert+Franklin+Hart+Stephens,Hart,13,147,Georgia,GA
13149,13CS017,93,113,133,135,2,22,42,5,-33.189416798140414,180.76523208914514,386.16169502093936,0.2156330677625023,113,140,167,178,11,38,65,28,-147.18083763212007,86.5769633130118,320.33476425814365,0.717948717948718,11528,11550,Carroll+Heard,Heard,13,149,Georgia,GA
13151,13CS050,1132,1394,1733,1751,18,357,619,151,-66.21278831067397,102.5166057271615,232.9266859737764,0.4037433155080214,1347,1731,2176,2218,42,487,871,326,-116.06351417990814,65.78498779427991,222.7087428402004,0.6269230769230769,241132,244737,Henry,Henry,13,151,Georgia,GA
13153,13CS051,867,1089,1344,1304,-40,215,437,106,-107.36457308501146,79.99137707632434,242.9462879001575,0.42570967741935484,1057,1348,1721,1705,-16,357,648,247,-158.03380434492834,66.08522515849502,240.94072318013116,0.64155844155844155,163518,166452,Houston,Houston,13,153,Georgia,GA
13155,13CS002,87,105,127,121,-6,16,34,18,-294.79927461825747,-27.908506078676062,197.92214422404663,0.9873188105048414,107,132,160,155,-5,23,48,27,-332.5834327547045,-41.572929094338065,218.25787774527487,1.0192307692307692,9611,9622,Bacon+Ben Hill+Coffee+Irwin,Irwin,13,155,Georgia,GA
13157,13CS052,452,561,707,680,-27,119,228,77,-163.041037601176,65.84349595432109,236.72304497863053,0.5703703703703704,552,700,899,865,-34,166,313,139,-216.95035664753925,33.222678134410806,218.1413583165087,0.7354497354497355,76545,79765,Jackson,Jackson,13,157,Georgia,GA
13159,13CS047,109,130,154,144,-10,14,35,16,-210.97498645627252,-15.569972161114684,152.88262636919387,0.8406394114341608,135,164,198,225,27,61,90,53,-171.22535891469465,52.68472581990605,243.66685691706547,0.8688524590163934,14642,15185,Hancock+Jasper+Morgan+Putnam,Jasper,13,159,Georgia,GA
13161,13CS001,121,141,164,186,22,45,65,26,-35.836974270123875,150.38375979798977,316.65227235880525,0.5830887854192551,143,173,204,216,12,43,73,35,-154.7972422534777,53.84251904468789,255.75196546226746,0.813953488372093,14834,14858,Appling+Jeff Davis+Long+Wayne,Jeff Davis,13,161,Georgia,GA
13163,13CS066,146,190,241,257,16,67,111,33,-131.16856057570558,261.567804080586,600.0673152436972,0.4782608695652174,173,229,299,278,-21,49,105,47,-437.8024098969293,12.867080379042743,373.14533099223956,0.8245614035087719,15598,15544,Washington and Nearby Counties,Jefferson,13,163,Georgia,GA
13165,13CS012,66,82,99,110,11,28,44,26,-203.44616516099475,24.70495678117485,252.28712330703004,0.9088651219853179,77,98,120,133,13,35,56,20,-80.99644917352285,173.56381965754895,416.5531671781175,0.5714285714285714,8670,8642,Burke+Emanuel+Jenkins+Screven,Jenkins,13,165,Georgia,GA
13167,13CS066,75,91,110,124,14,33,49,24,-131.93623709430955,113.42210137978769,326.7771783137852,0.7330191626786391,91,113,137,142,5,29,51,25,-218.3128058653374,43.66256117306748,283.8066476249386,0.8333333333333334,9248,9161,Washington and Nearby Counties,Johnson,13,167,Georgia,GA
13169,13CS066,165,214,273,263,-10,49,98,18,-118.27177134124207,130.94374684208944,337.9193466892631,0.32727272727272727,197,263,338,387,49,124,190,60,-38.74114750104924,225.40304000610467,457.8499250124001,0.48,28409,28394,Washington and Nearby Counties,Jones,13,169,Georgia,GA
13171,13CS013,137,178,234,236,2,58,99,28,-167.1042515847343,192.81259798238574,456.32314855831294,0.45901639344262296,170,220,286,307,21,87,137,55,-179.18498459649393,168.39704866630854,431.51743720741564,0.6179775280898876,18671,19003,Butts+Lamar+Monroe,Lamar,13,171,Georgia,GA
13173,13CS053,65,81,96,84,-12,3,19,10,-265.9789548076689,-78.75410116139135,108.96344946816563,0.752159019860425,78,98,121,114,-7,16,36,5,-121.11043126667634,111.01789532778665,312.86861410558055,0.23809523809523808,10012,9908,Lanier and Nearby Counties,Lanier,13,173,Georgia,GA
13175,13CS067,398,502,619,642,23,140,244,103,-195.0396936251479,90.20585830163091,343.8793598228388,0.7152777777777778,478,609,788,811,23,202,333,116,-187.7281944702608,173.59811531658525,438.13338290075376,0.5523809523809524,49221,49540,Wheeler and Nearby Counties,Laurens,13,175,Georgia,GA
13177,13CS014,169,215,277,267,-10,52,98,32,-154.09456844130412,73.29111459752872,241.86067817184477,0.5423728813559322,204,268,350,310,-40,42,106,43,-248.82279802060293,-4.49409027129325,188.75179139431648,0.7166666666666667,32746,33377,Calhoun and Nearby Counties,Lee,13,177,Georgia,GA
13179,13CS010,264,333,422,384,-38,51,120,35,-134.93504518051992,29.574804423127652,157.11614849786565,0.5072463768115942,318,407,525,602,77,195,284,102,-38.16305692941644,141.68320536669577,277.2725094272971,0.5204081632653061,64920,65639,Bryan+Liberty,Liberty,13,179,Georgia,GA
13181,13CS062,62,77,94,96,2,19,34,17,-228.08082967721444,26.608236270833636,255.8283956240767,0.8700098902323297,75,95,117,122,5,27,47,17,-154.98994987043807,129.1582915586984,387.4748746760952,0.6071428571428571,7747,7742,Taliaferro and Nearby Counties,Lincoln,13,181,Georgia,GA
13183,13CS001,55,69,85,105,20,36,50,5,108.98257146121801,220.11623241569035,319.55161326969187,0.13912322712098768,65,82,101,149,48,67,84,29,111.5949885040031,223.1899770080062,323.03812461685106,0.43283582089552236,16867,17026,Appling+Jeff Davis+Long+Wayne,Long,13,183,Georgia,GA
13185,13CS054,644,807,995,989,-6,182,345,107,-114.66332896398562,76.07031996726158,241.3964820294434,0.5245098039215687,769,988,1249,1238,-11,250,469,156,-140.17593338705345,78.90142358313189,262.8088906795594,0.5777777777777777,118312,119136,Lowndes,Lowndes,13,185,Georgia,GA
13187,13CS030,199,254,321,287,-34,33,88,20,-192.57124123981714,46.316857282472206,242.2727919390854,0.38838612368024134,240,312,412,425,13,112,185,67,-158.14015860341223,133.12446283913522,345.39215028922865,0.5775862068965517,33681,34179,Dawson+Lumpkin+White,Lumpkin,13,187,Georgia,GA
13189,13CS062,169,216,279,238,-41,22,69,23,-356.34054959033983,-5.56782108734906,256.39816107242393,0.5348837209302325,202,265,343,311,-32,46,109,37,-319.2872872718585,41.61601137504311,332.92809100034486,0.6065573770491803,21552,21626,Taliaferro and Nearby Counties,McDuffie,13,189,Georgia,GA
13191,13CS043,80,97,117,148,31,51,68,12,201.27344574411234,407.532832883859,588.0097966311374,0.2353575885317117,92,115,141,226,85,111,134,25,540.4218668197863,774.6046757750269,981.7663913892783,0.22522522522522523,11480,11102,Glynn+McIntosh,McIntosh,13,191,Georgia,GA
13193,13CS055,109,130,150,147,-3,17,38,11,-143.12896685277158,60.237392854214825,263.19783168354274,0.5395110939348081,135,161,190,174,-16,13,39,23,-324.82461726394257,-83.28836340101093,133.26138144161746,1,12152,12006,Marion and Nearby Counties,Macon,13,193,Georgia,GA
13195,13CS022,203,261,332,282,-50,21,79,26,-301.20382449592944,-19.81604108525851,210.05003550374028,0.5306122448979592,250,323,425,400,-25,77,150,50,-243.71400002435513,87.67858761702317,324.8978774475246,0.5747126436781609,30278,30794,Clarke+Madison+Oconee,Madison,13,195,Georgia,GA
13197,13CS055,55,70,86,87,1,17,32,8,-102.12618522238662,143.16674687512642,375.5495246517177,0.44594674386244254,65,84,106,127,21,43,62,30,-121.44934019235065,174.4576157459181,429.43413106687535,0.6976744186046512,7642,7452,Marion and Nearby Counties,Marion,13,197,Georgia,GA
13199,13CS049,177,229,289,284,-5,55,107,19,-139.35955848548286,208.60474451049413,510.2124376152499,0.3114754098360656,212,279,357,401,44,122,189,68,-115.80524975773588,260.020103406143,582.6376391137647,0.5551112888178062,20709,20768,Harris+Meriwether+Talbot,Meriwether,13,199,Georgia,GA
13201,13CS014,63,81,98,95,-3,14,32,3,-118.86257780170267,231.15672822673378,580.3446344783811,0.17755989895452698,79,99,125,128,3,29,49,20,-286.73029080635865,151.79838925042517,489.9714675249827,0.6666666666666666,5933,5929,Calhoun and Nearby Counties,Miller,13,201,Georgia,GA
13205,13CS025,173,218,275,288,13,70,115,50,-205.02277358321987,107.9067229385368,359.6890764617893,0.6944444444444444,204,266,346,288,-58,22,84,35,-431.67972149695385,-60.34232666086452,227.44415433710472,0.6140350877192983,21685,21544,Colquitt+Mitchell,Mitchell,13,205,Georgia,GA
13207,13CS013,189,245,307,303,-4,58,114,43,-200.986669933294,64.14468189360447,303.61816096306114,0.671875,232,303,393,372,-21,69,140,65,-300.5429868206658,13.978743573054224,262.2761762894297,0.8125,28062,28615,Butts+Lamar+Monroe,Monroe,13,207,Georgia,GA
13209,13CS067,63,80,96,101,5,21,38,14,-127.24602207679878,100.38646628998406,328.018954656767,0.6342430622763309,78,97,122,151,29,54,73,30,-11.571507092369556,277.71617021686933,497.57480497189096,0.5555555555555556,8668,8642,Wheeler and Nearby Counties,Montgomery,13,209,Georgia,GA
13211,13CS047,141,164,187,209,22,45,68,12,57.05379811946106,199.49784184232433,332.1181584118866,0.2643634174308015,171,202,239,294,55,92,123,38,82.65358525119701,262.5466825626258,413.26792625598506,0.41304347826086957,20086,20568,Hancock+Jasper+Morgan+Putnam,Morgan,13,211,Georgia,GA
13213,13CS042,253,322,406,406,-0,84,153,41,-123.31088216657669,129.16852455938604,336.4389476895637,0.45555555555555555,304,391,500,545,45,154,241,92,-117.64969698423567,155.19747261750237,373.09973054256,0.5859872611464968,39948,39949,Gilmer+Murray,Murray,13,213,Georgia,GA
13215,13CS056,1430,1779,2216,1981,-235,202,551,190,-248.61551879712067,7.016430445826548,211.1360861656638,0.5855175688509022,1711,2166,2749,2572,-177,406,861,369,-265.4353160845862,17.977497153816014,239.05212431560753,0.7719665271966527,205233,205813,Muscogee,Muscogee,13,215,Georgia,GA
13217,13CS057,627,786,981,999,18,213,372,104,-91.44606394737524,115.83522336157935,284.8590057070765,0.4727272727272727,764,973,1256,1256,0,283,492,199,-173.07436200119042,73.05651461356783,254.82808073542108,0.6689094524664994,112919,114979,Newton,Newton,13,217,Georgia,GA
13219,13CS022,192,245,311,292,-19,47,100,27,-131.96792147837024,57.31505818821727,209.19996238699304,0.47368421052631576,233,304,393,350,-43,46,117,29,-168.0392985729487,39.64841187703162,205.23883795169309,0.4393939393939394,41874,42877,Clarke+Madison+Oconee,Oconee,13,219,Georgia,GA
13221,13CS062,114,136,159,151,-8,15,37,6,-109.7977081018845,68.43188212121997,246.66147234432447,0.2958860335713932,142,171,205,195,-10,24,53,20,-199.00799536420638,26.490248966949274,218.5445539773315,0.6896551724137931,14946,15100,Taliaferro and Nearby Counties,Ogelthorpe,13,221,Georgia,GA
13223,13CS058,670,834,1053,1046,-7,212,376,106,-79.88851443325923,74.80726616541942,190.5820964902973,0.4711111111111111,816,1039,1335,1297,-38,258,481,188,-130.70278853788224,40.42056636912639,169.21781392103554,0.6584958900748374,170037,173179,Paulding,Paulding,13,223,Georgia,GA
13225,13CS028,210,268,339,319,-20,51,109,36,-239.99571818522415,64.22722163743734,312.5724786355284,0.5714285714285714,257,328,430,408,-22,80,151,68,-317.51022153140065,42.311189987527015,292.82869403867636,0.7472527472527473,28026,28361,Crawford+Peach+Pike+Upson,Peach,13,225,Georgia,GA
13227,13CS021,234,301,379,334,-45,33,100,23,-245.00764397827157,36.03053587915758,277.615278948909,0.3898305084745763,286,371,480,470,-10,99,184,86,-283.43410212397475,38.3218234801006,289.03498401722015,0.7889908256880734,33305,33923,Cherokee+Pickens,Pickens,13,227,Georgia,GA
13229,13CS008,147,189,239,252,13,63,105,37,-146.13524910330423,158.3131865285796,414.04987245936195,0.578125,180,234,304,346,42,112,166,78,-180.55105687149322,170.52044260085472,441.34702790809456,0.6933470290771175,19708,19939,Brantley+Pierce+Ware,Pierce,13,229,Georgia,GA
13231,13CS028,146,169,196,190,-6,21,44,32,-238.0013236068757,-71.7886304748347,78.84162267607744,1.3374790593899453,181,213,250,264,14,51,83,55,-211.3624500860271,-20.62072683766118,144.34508786362827,1.0784313725490196,18994,19398,Crawford+Peach+Pike+Upson,Pike,13,231,Georgia,GA
13233,13CS048,340,427,538,504,-34,77,164,46,-223.71053790903073,86.63368738513371,329.76693907889603,0.4842105263157895,408,524,675,668,-7,144,260,88,-219.06017388333203,128.99442415842896,396.19715991517467,0.5641025641025641,42939,43413,Haralson+Polk,Polk,13,233,Georgia,GA
13235,13CS007,74,90,110,111,1,21,37,22,-253.04566460248577,-17.139334328842512,179.04056610661988,1.0287295891547685,88,110,133,174,41,64,86,34,70.64195880060045,302.7512520025734,524.7688368044605,0.53125,10058,9909,Bleckley+Dodge+Pulaski+Twiggs,Pulaski,13,235,Georgia,GA
13237,13CS047,164,208,265,258,-7,50,94,30,-200.1980186858999,105.50976660473103,346.288464753989,0.5454545454545454,195,254,332,367,35,113,172,51,-71.04762873913586,275.3095613641515,537.2976923397149,0.4473684210526316,22178,22520,Hancock+Jasper+Morgan+Putnam,Putnam,13,237,Georgia,GA
13239,13CS014,25,35,49,33,-16,-2,8,5,-1100.0252412490875,-394.3995056230714,134.8197960964404,-0.4387456443210676,33,46,64,51,-13,5,18,3,-714.2126456556715,89.27658070695894,671.8062698198639,0.2727272727272727,2237,2240,Calhoun and Nearby Counties,Quitman,13,239,Georgia,GA
13241,13CS037,142,183,232,234,2,51,92,24,-155.75393533114303,191.1525569973119,481.42125465989665,0.4444444444444444,170,223,291,286,-5,63,116,46,-298.4867162437495,99.49557208124985,409.6876497463229,0.6666666666666666,16950,17086,Fannin+Rabun+Towns+Union,Rabun,13,241,Georgia,GA
13243,13CS014,58,73,89,104,15,31,46,25,-182.74270966066743,108.77336755202678,400.28944476472105,0.8004027483099729,68,87,109,115,6,28,47,1,79.36350469236721,428.562925338783,730.1442431697784,0.034482758620689655,6430,6300,Calhoun and Nearby Counties,Randolph,13,243,Georgia,GA
13245,13CS059,1411,1751,2165,2116,-49,365,705,236,-166.2730998154263,75.24725443322221,273.71917940146903,0.5885286783042394,1682,2113,2692,2658,-34,545,976,391,-206.54276867949005,74.84137970974463,284.30004630000394,0.666098807495741,205722,205769,Richmond,Richmond,13,245,Georgia,GA
13247,13CS060,532,660,826,777,-49,117,245,71,-154.4585492650593,59.209110551606074,224.0292541631964,0.4965034965034965,632,811,1041,1011,-30,200,379,151,-192.57821329326828,52.120035633085585,242.51771682333703,0.6894977168949772,93229,94014,Rockdale,Rockdale,13,247,Georgia,GA
13249,13CS055,21,30,41,40,-1,10,19,3,-106.3168693181381,170.32433037966865,425.68543779302854,0.26726691012481757,25,36,50,58,8,22,33,8,0,312.02986571571853,557.1961887780687,0.36363636363636365,4636,4487,Marion and Nearby Counties,Schley,13,249,Georgia,GA
13251,13CS012,115,138,160,181,21,43,66,17,31.440916151169354,221.06102389032677,417.70409858278623,0.3964670246720188,139,168,200,252,52,84,113,43,63.836861354316746,290.8123683918874,496.5089216446858,0.5119047619047619,14048,14098,Burke+Emanuel+Jenkins+Screven,Screven,13,251,Georgia,GA
13253,13CS031,103,123,146,125,-21,2,22,14,-460.7197946635002,-153.48706013705797,109.85528374274965,0.7390752249919343,127,155,186,163,-23,8,36,28,-555.0479204975478,-217.66585117550895,87.06634047020358,1.1433333333333335,8991,9188,Decatur+Grady+Seminole,Seminole,13,253,Georgia,GA
13255,13CS061,517,654,808,839,31,186,322,94,-112.19884127982368,162.95545995402964,406.05294939364757,0.49086496509598604,627,797,1020,1108,88,311,481,205,-172.47309714510342,156.25767775539285,406.93332022996407,0.6487341772151899,67380,67837,Spalding,Spalding,13,255,Georgia,GA
13257,13CS036,256,326,410,330,-80,4,74,42,-548.4669586745382,-170.83397073469226,143.8601858818461,0.5185185185185185,307,401,518,488,-30,87,181,69,-368.8254665203074,67.02532455694633,417.04646390988825,0.6571428571428571,26693,26856,Elbert+Franklin+Hart+Stephens,Stephens,13,257,Georgia,GA
13259,13CS055,35,47,59,59,-0,12,24,12,-266.20217834688884,2.999844062703554,254.25506497832328,0.8707182872205885,40,55,71,78,7,23,38,12,-93.73315732329347,206.21294611124563,487.412418081126,0.5,5497,5334,Marion and Nearby Counties,Stewart,13,259,Georgia,GA
13261,13CS055,240,304,384,342,-42,38,102,69,-451.6873450883746,-128.12383043929583,134.4283363815467,1.1311475409836065,279,369,480,431,-49,62,152,58,-365.25008632486276,13.641459806717567,320.5743054578628,0.6823529411764706,29503,29322,Marion and Nearby Counties,Sumter,13,261,Georgia,GA
13263,13CS049,57,72,88,80,-8,8,23,2,-207.17156343014796,133.95019204715334,440.1941620517133,0.1491890099899576,69,89,111,98,-13,9,29,20,-575.7442685064547,-191.62441614435707,156.78361320901942,1.1111111111111112,5799,5740,Harris+Meriwether+Talbot,Talbot,13,263,Georgia,GA
13265,13CS062,13,21,30,23,-7,2,10,1,-585.9425346189788,111.53959409130893,682.2067903088174,0.1355171218464508,15,25,37,37,0,12,22,7,-449.3360257833291,320.9543041309493,962.862912392848,0.5384615384615384,1556,1558,Taliaferro and Nearby Counties,Taliaferro,13,265,Georgia,GA
13267,13CS016,151,192,245,242,-3,50,91,34,-191.11313176421848,82.64351643858096,294.4175273124447,0.6296296296296297,179,234,303,346,43,112,167,74,-134.86611117948124,165.05353381063728,403.9468064312965,0.6548672566371682,23232,23023,Candler+Evans+Tattnall+Toombs,Tattnall,13,267,Georgia,GA
13269,13CS055,67,83,99,98,-1,15,31,17,-270.0352416884234,-31.15375376410823,207.72773416020692,1.0236582458154984,81,101,126,138,12,37,57,15,-38.45568383018611,282.0083480880315,538.3795736226056,0.39473684210526316,7847,7801,Marion and Nearby Counties,Taylor,13,269,Georgia,GA
13271,13CS067,84,103,122,192,70,89,108,33,345.592632593902,521.2650262627557,696.5563518325446,0.3698258289582318,96,119,144,185,41,66,89,32,72.45878487288684,273.7331872975725,458.90563752828325,0.48484848484848486,12945,12421,Wheeler and Nearby Counties,Telfair,13,271,Georgia,GA
13273,13CS014,89,108,128,136,8,28,47,31,-308.403141765794,-35.828803713511086,214.93958729458936,1.0645443198834448,107,133,161,135,-26,2,28,15,-455.98303965523235,-144.57998818336634,144.57998818336634,0.5662393162393162,9049,8992,Calhoun and Nearby Counties,Terrell,13,273,Georgia,GA
13275,13CS009,372,470,599,539,-60,69,167,76,-358.06241501068433,-18.42968312554993,239.71752122590289,0.8085106382978723,452,576,745,693,-52,117,241,85,-299.14304572422907,69.82186333461219,340.3815837562344,0.6115107913669064,45579,45831,Brooks+Thomas,Thomas,13,275,Georgia,GA
13277,13CS063,299,381,483,450,-33,69,151,69,-296.853360442491,0,238.79233553241542,0.8023255813953488,355,467,604,546,-58,79,191,79,-332.26754409012455,0,271.75604609706886,0.7314814814814815,41232,41232,Tift+Worth,Tift,13,277,Georgia,GA
13279,13CS016,209,264,333,364,31,100,155,47,-71.31489931229194,235.49468308731923,480.0981227846195,0.46534653465346537,245,316,415,455,40,138,210,96,-208.12011928383285,157.8074053445655,423.4808136364162,0.6857142857142857,27007,26932,Candler+Evans+Tattnall+Toombs,Toombs,13,279,Georgia,GA
13281,13CS037,134,157,183,181,-2,24,47,26,-264.2366304589881,-19.500208009475852,201.5520445255674,1.0150871567666264,162,194,227,249,22,55,87,41,-148.13659753625447,109.15328239513487,358.6464992983003,0.7454545454545455,12497,12826,Fannin+Rabun+Towns+Union,Towns,13,281,Georgia,GA
13283,13CS067,47,61,76,93,17,32,46,13,65.86273670053627,356.4927496713068,616.5301296977856,0.40421796617222633,56,73,92,132,40,59,76,33,110.79017132908638,411.5063506508922,680.5681953072449,0.559322033898305,6450,6318,Wheeler and Nearby Counties,Treutlen,13,283,Georgia,GA
13285,13CS064,475,590,739,789,50,199,314,100,-86.39186138608518,170.88500054390482,369.47408450932136,0.4878048780487805,565,720,913,942,29,222,377,161,-189.46031320756072,88.27128228988624,310.02596706691753,0.6939655172413793,69520,69672,Troup,Troup,13,285,Georgia,GA
13287,13CS029,109,129,154,117,-37,-12,8,25,-840.169948442727,-504.542047650718,-236.0397270171111,-1.3401358662050529,137,168,199,135,-64,-32,-2,15,-881.5923680829362,-529.736084553314,-189.58975657697553,-0.4411764705882353,8819,8967,Crisp+Dooly+Turner+Wilcox,Turner,13,287,Georgia,GA
13289,13CS007,82,99,119,131,12,32,49,19,-108.19865236006449,200.16879905034637,446.86276017867493,0.5874723896088955,98,121,148,161,13,40,63,26,-165.08023851978052,177.7787184059175,469.84375578706766,0.65,7998,7875,Bleckley+Dodge+Pulaski+Twiggs,Twiggs,13,289,Georgia,GA
13291,13CS037,218,280,356,361,5,81,143,31,-125.69842952503015,241.72774908659642,541.470157953976,0.36687675070028014,264,344,449,436,-13,92,172,64,-303.01962002848194,108.22129286731497,425.2112979750319,0.64,24821,25411,Fannin+Rabun+Towns+Union,Union,13,291,Georgia,GA
13293,13CS028,269,341,429,421,-8,80,152,55,-274.9094278321875,109.0045312578063,423.15559034280386,0.6111111111111112,324,418,542,548,6,130,224,97,-328.4770282539549,119.05262968018135,458.35262426869804,0.7106322455989695,27522,27719,Crawford+Peach+Pike+Upson,Upson,13,293,Georgia,GA
13295,13CS020,554,701,872,830,-42,129,276,63,-185.03736696232463,116.30920209060405,375.44962886974525,0.4064516129032258,669,848,1085,1000,-85,152,331,156,-352.51898709885535,-5.848510777251851,255.8723465047685,0.8082901554404145,68094,68393,Chattooga+Dade+Walker,Walker,13,295,Georgia,GA
13297,13CS065,615,771,962,904,-58,133,289,91,-184.23936731024227,51.91582305957851,244.80782754641717,0.558282208588957,745,952,1225,1244,19,292,499,213,-195.11017994025033,78.92887980061661,287.5625429678516,0.7041341551373681,97080,99457,Walton,Walton,13,297,Georgia,GA
13299,13CS008,320,402,508,505,-3,103,185,72,-249.03082621164737,102.93274150081425,375.2064448255488,0.6575479566305255,379,491,635,650,15,159,271,144,-357.7373115047326,41.59736180287588,352.4683123430347,0.8700985761226725,36140,36060,Brantley+Pierce+Ware,Ware,13,299,Georgia,GA
13301,13CS062,53,66,81,89,8,23,36,5,78.97213966120613,419.7707927037828,723.6495916667458,0.21525778469353402,63,80,101,86,-15,6,23,13,-534.8721520246743,-133.71803800616857,191.0257685802408,0.8125,5211,5235,Taliaferro and Nearby Counties,Warren,13,301,Georgia,GA
13303,13CS066,151,193,249,271,22,78,120,53,-186.2403664729792,150.19384392982192,402.81988941978204,0.6708860759493671,177,233,305,312,7,79,135,58,-257.7539724448128,106.03003763645582,388.7768046670047,0.6987951807228916,19974,19806,Washington and Nearby Counties,Washington,13,303,Georgia,GA
13305,13CS001,240,300,378,336,-42,36,96,40,-326.47715285793925,-13.926508653294178,223.02308857632514,0.6666666666666666,285,369,473,512,39,143,227,103,-210.89268980856957,131.807931130356,408.9341063319292,0.7054794520547946,30158,30347,Appling+Jeff Davis+Long+Wayne,Wayne,13,305,Georgia,GA
13307,13CS055,16,25,35,27,-8,2,11,6,-680.9730169485011,-184.43281983073857,229.3506777673972,0.7416069054036274,22,32,46,25,-21,-7,3,6,-1141.8804021251663,-549.7942676898949,-126.87560023612959,-0.6,2384,2365,Marion and Nearby Counties,Webster,13,307,Georgia,GA
13309,13CS067,40,52,67,68,1,16,28,12,-169.5423100522095,67.28636008465021,251.4864368577632,0.7047766067396781,47,64,81,78,-3,14,31,12,-200.9371485344147,26.791619804588624,254.52038814359193,0.75,7498,7465,Wheeler and Nearby Counties,Wheeler,13,309,Georgia,GA
13311,13CS030,189,242,312,336,24,94,147,33,-37.90424061003599,256.90651969024395,480.1203810604558,0.3473684210526316,227,294,380,448,68,154,221,67,3.170055886911211,306.4387357347485,542.6078993096321,0.432258064516129,28493,28391,Dawson+Lumpkin+White,White,13,311,Georgia,GA
13313,13CS068,586,726,899,916,17,190,330,138,-141.36994217430987,60.60376746136946,223.82602963376925,0.6934673366834171,692,885,1143,1139,-4,254,447,199,-197.461150110305,53.486152455389195,241.17392379884583,0.737037037037037,102964,102830,Whitfield,Whitfield,13,313,Georgia,GA
13315,13CS029,62,78,94,117,23,39,55,25,-23.757649054954037,191.36248128411938,406.48261162319284,0.6427444576394324,73,93,114,171,57,78,98,17,457.2071642474298,698.1135674366261,927.003261678143,0.21794871794871795,8714,8738,Crisp+Dooly+Turner+Wilcox,Wilcox,13,315,Georgia,GA
13317,13CS062,97,116,138,135,-3,19,38,11,-177.35155560344552,101.1433222116537,337.94118504889167,0.5308601849123435,115,141,169,179,10,38,64,21,-115.55506921267167,178.58510696503802,451.7152705586256,0.5384615384615384,9583,9519,Taliaferro and Nearby Counties,Wilkes,13,317,Georgia,GA
13319,13CS066,85,103,122,130,8,27,45,13,-63.39070753913921,187.26314980849108,438.4740157280045,0.47739369688774774,103,126,155,193,38,67,90,26,135.85578531012146,464.173933142915,724.5641883206479,0.3880597014925373,8856,8833,Washington and Nearby Counties,Wilkinson,13,319,Georgia,GA
13321,13CS063,164,208,266,240,-26,32,76,40,-384.01978283729767,-46.547852465126994,209.75626017097824,0.9302325581395349,198,256,334,315,-19,59,117,41,-291.815616752063,87.47179186573081,369.3253434330856,0.5857142857142857,20624,20578,Tift+Worth,Worth,13,321,Georgia,GA
15001,15CS001,1193,1482,1837,1531,-306,49,338,47,-210.58969252033413,1.1929737573733699,173.66715472962824,0.17669172932330826,1407,1806,2307,2053,-254,246,646,107,-178.24088927938553,68.85794531840013,266.15200082925685,0.28381962864721483,201178,202591,Hawaii (county),Hawaii (county),15,1,Hawaii,HI
15003,15CS002,5464,6729,8286,6909,-1377,180,1445,275,-197.07655808019615,-11.330351620442165,139.51240850539173,0.22,6510,8133,10388,8768,-1620,635,2258,470,-208.46440880366734,16.455748093579768,178.33044343109077,0.29936609361529487,1006147,1002689,Honolulu,Honolulu,15,3,Hawaii,HI
15005,15CS003,0,1,3,6,3,5,6,6,-4351.5487282800295,-1450.51624276001,0,1.2,0,1,4,1,-3,0,1,1,-4878.048780487805,-1219.5121951219512,0,1,83,82,Kalawao+Maui,Kalawao,15,5,Hawaii,HI
15007,15CS004,397,496,626,487,-139,-9,90,4,-234.8114336017989,-21.346493963799904,141.29736966038314,-0.030418690724034234,479,610,781,591,-190,-19,112,18,-283.3127271375511,-50.39697550042976,128.2398714423096,-0.11145617667356797,73080,73417,Kauai,Kauai,15,7,Hawaii,HI
15009,15CS003,797,983,1214,1026,-188,43,229,16,-148.42664379834594,19.630268834461624,154.89736204377954,0.0898876404494382,934,1197,1518,1389,-129,192,455,84,-129.68373168158956,65.73969970247207,225.888912588772,0.3187867265814034,165051,164284,Kalawao+Maui,Maui,15,9,Hawaii,HI
16001,16CS001,2269,2795,3457,3261,-196,466,992,315,-123.35836200131942,36.45227526849165,163.43172421701223,0.5502187602972943,2747,3477,4445,4154,-291,677,1407,451,-145.56859699500623,44.32267149999516,187.48882280528926,0.5554195615938897,497088,509897,Ada,Ada,16,1,Idaho,ID
16003,16CS009,29,40,53,41,-12,1,12,5,-450.97879545779335,-116.29890227271235,196.0689980333634,0.4090068511032778,38,52,71,55,-16,3,17,3,-413.43106988889036,0,304.63341991812973,0.23076923076923078,4422,4596,Central Idaho,Adams,16,3,Idaho,ID
16005,16CS002,500,629,783,704,-79,75,204,59,-189.64529480805666,21.97193857298267,199.12069331765542,0.49789915966386555,606,772,979,937,-42,164,331,126,-190.79588614105106,43.698046498694026,232.79141134758805,0.6631578947368421,87384,88105,Bannock+Bear Lake+Caribou+Franklin,Bannock,16,5,Idaho,ID
16007,16CS002,39,51,66,69,3,18,30,7,-71.24471025547395,208.26735714639642,441.19407998128855,0.3713759879816417,48,63,82,79,-3,16,31,11,-214.74108041606084,76.69324300573601,306.77297202294403,0.6111111111111112,6353,6519,Bannock+Bear Lake+Caribou+Franklin,Bear Lake,16,7,Idaho,ID
16009,16CS003,96,115,136,102,-34,-13,6,2,-446.93455609628893,-184.13955025618802,47.73839607331277,-0.1161992444699984,121,146,175,158,-17,12,37,23,-404.8898889294248,-111.34471945559181,141.71146112529868,1,9573,9879,Benewah+Latah+Nez Perce,Benewah,16,9,Idaho,ID
16011,16CS004,268,344,430,406,-24,62,138,43,-167.75372768687083,47.536477644303446,237.80748421531788,0.5584415584415584,325,420,542,504,-38,84,179,75,-231.85859462859213,18.458446277375756,213.4001483512163,0.7009345794392523,47963,48758,Bingham+Oneida+Power,Bingham,16,11,Idaho,ID
16013,16CS013,89,108,128,121,-7,13,32,15,-110.44460964585875,-8.444873786814602,85.59888267522398,0.8616211818991211,111,138,165,156,-9,18,45,11,-80.96517232509203,28.33781031378221,137.64079295265645,0.4583333333333333,24181,24702,Lincoln and Nearby Counties,Blaine,16,13,Idaho,ID
16015,16CS005,36,49,63,57,-6,8,21,8,-222.05320502177406,7.654324288405066,199.0772653802211,0.6790177151324926,45,62,79,93,14,31,48,5,112.09627824787289,323.8336927160772,535.5711071842816,0.16129032258064516,7731,8029,Boise+Gem+Payette+Washington,Boise,16,15,Idaho,ID
16017,16CS006,326,410,509,414,-95,4,88,18,-286.3645179037193,-35.46309819241105,177.56879880628654,0.18462023984851672,398,513,660,618,-42,105,220,120,-329.47301853010407,-30.497348213215435,203.51897040952414,0.9448818897637795,47373,49185,Bonner+Boundary+Shoshone,Bonner,16,17,Idaho,ID
16019,16CS007,663,827,1039,942,-97,115,279,111,-201.02838561709513,3.86500140576006,162.37837155949444,0.7025316455696202,816,1032,1324,1104,-220,72,288,115,-262.96965171461864,-33.73920639632583,135.7414582921946,0.5582655826558266,124191,127448,Bonneville,Bonneville,16,19,Idaho,ID
16021,16CS006,78,96,116,113,-3,17,35,7,-97.66325493801638,96.53323580817201,274.5466856588446,0.3483107162382313,95,119,146,179,33,60,84,41,-64.02219436071172,152.05271160669034,344.5194334035796,0.6833333333333333,12193,12496,Bonner+Boundary+Shoshone,Boundary,16,21,Idaho,ID
16023,16CS011,19,28,39,31,-8,3,12,5,-585.3947595371218,-90.44672834329076,328.3554518976434,0.6265831186134485,23,36,48,45,-3,9,22,1,-151.3562942933947,302.7125885867894,794.6205450403222,0.09090909090909091,2591,2643,Jefferson and Nearby Counties,Butte,16,23,Idaho,ID
16025,16CS013,3,8,16,12,-4,4,9,5,-986.7519415258108,-109.63910461397897,438.5564184559159,1,4,11,20,8,-12,-3,4,8,-1767.2397923493247,-971.9818857921285,-353.44795846986494,-1.1428571428571428,1094,1132,Lincoln and Nearby Counties,Camas,16,25,Idaho,ID
16027,16CS008,1129,1399,1723,1649,-74,250,520,209,-145.47571750144957,21.075987341199404,159.86907471007353,0.706081081081081,1385,1734,2220,2131,-89,397,746,334,-175.10479046950633,26.07635456702257,170.61386273851903,0.734065934065934,233441,241598,Canyon,Canyon,16,27,Idaho,ID
16029,16CS002,42,54,69,74,5,20,32,2,50.07045704600981,302.15853676201095,512.2319365253453,0.10132702934871254,50,66,84,78,-6,12,28,15,-295.89967591940257,-42.27138227420036,183.17598985486825,1,7045,7097,Bannock+Bear Lake+Caribou+Franklin,Caribou,16,29,Idaho,ID
16031,16CS013,157,182,207,192,-15,10,35,18,-161.5144719779212,-37.456979917292934,82.59865756073445,0.8574406948335663,191,227,265,234,-31,7,43,25,-223.14146322026005,-71.7240417493693,71.7240417493693,0.78125,24653,25096,Lincoln and Nearby Counties,Cassia,16,31,Idaho,ID
16033,16CS011,2,7,14,5,-9,-2,3,5,-2103.396108299859,-1051.6980541499295,-300.4851583285513,-1,3,8,15,10,-5,2,7,4,-1136.3636363636363,-252.52525252525254,378.7878787878788,1,799,792,Jefferson and Nearby Counties,Clark,16,33,Idaho,ID
16035,16CS009,67,85,104,104,0,19,37,6,-76.5298494138919,182.3056413443919,418.63369812369444,0.28622125008178184,82,102,126,132,6,30,50,16,-112.69060559461904,157.76684783246665,383.14805902170474,0.5333333333333333,8767,8874,Central Idaho,Clearwater,16,35,Idaho,ID
16037,16CS009,31,43,56,40,-16,-3,9,8,-669.6586048018519,-301.1788532819349,21.240929297992587,-0.7290404405818361,40,55,73,69,-4,14,29,1,-114.65872002270463,295.1610614445863,635.7315169575706,0.058823529411764705,4284,4404,Central Idaho,Custer,16,37,Idaho,ID
16039,16CS010,164,189,216,209,-7,20,45,11,-76.75079739263147,37.50204941630588,141.36827378806697,0.442864478574035,202,239,275,239,-36,0,37,43,-274.2692482114998,-149.28579333031,-20.65698768175236,0.9451690821256039,28496,28804,Elmore+Gooding+Owyhee,Elmore,16,39,Idaho,ID
16041,16CS002,79,97,116,91,-25,-6,12,8,-277.1265715946791,-117.95882034220598,34.28859389928996,-0.5037923264779774,98,122,149,134,-15,12,36,16,-212.55324883875815,-27.38206104203004,136.9103052101502,0.7272727272727273,14256,14608,Bannock+Bear Lake+Caribou+Franklin,Franklin,16,41,Idaho,ID
16043,16CS011,73,90,107,111,4,21,38,13,-79.63742494540354,75.20729633256946,222.67845945444842,0.5853812047866611,89,111,135,164,29,53,75,4,184.3034864076179,361.23483335893104,523.4219013976348,0.07547169811320754,13380,13565,Jefferson and Nearby Counties,Fremont,16,43,Idaho,ID
16045,16CS005,153,198,252,227,-25,30,74,17,-263.4224647784692,78.30632127778514,357.0768250267003,0.38636363636363635,181,246,320,304,-16,58,123,37,-268.84277136317235,109.0588600812869,436.2354403251476,0.5522388059701493,19156,19714,Boise+Gem+Payette+Washington,Gem,16,45,Idaho,ID
16047,16CS010,93,113,135,169,34,56,76,20,108.94479969733686,273.32264438866383,431.37826428417054,0.3600798399317359,112,137,167,170,3,33,58,26,-146.00219796787158,44.43545155543918,203.4508889074034,0.7647058823529411,15605,15753,Elmore+Gooding+Owyhee,Gooding,16,47,Idaho,ID
16049,16CS009,145,168,193,181,-12,13,36,16,-203.9463573927425,-19.62962379367555,140.94260306155005,0.8056998850617105,180,211,248,257,9,46,77,30,-123.74672678858829,94.28322041035298,276.9569599554119,0.6382978723404256,16620,16970,Central Idaho,Idaho (county),16,49,Idaho,ID
16051,16CS011,136,161,186,176,-10,15,40,16,-99.86628426073545,-4.417432260791505,91.03141973915255,0.7188470216418091,171,206,242,251,9,45,80,37,-87.40514038475169,24.9728972527862,134.2293227337258,0.8043478260869565,31009,32035,Jefferson and Nearby Counties,Jefferson,16,51,Idaho,ID
16053,16CS013,123,144,167,158,-9,14,35,17,-128.05378442431848,-14.200395221953524,91.3321580494008,0.8551856885689125,150,179,211,242,31,63,92,39,-32.52318971183099,97.56956913549297,215.4661318408803,0.6190476190476191,24306,24598,Lincoln and Nearby Counties,Jerome,16,53,Idaho,ID
16055,16CS012,1120,1380,1719,1387,-332,6,267,115,-311.22461004281837,-75.5348846653524,105.95769074715778,0.344311377245509,1386,1765,2271,2018,-253,253,632,310,-315.0257154215955,-31.88859133196758,180.3383757168375,0.8333333333333334,172371,178747,Kootenai,Kootenai,16,55,Idaho,ID
16057,16CS003,142,183,235,213,-22,30,71,1,-69.35526512107593,87.44794297874792,211.08124167283978,0.024390243902439025,171,224,295,303,8,80,132,29,-52.225002720052224,125.58869701726844,256.2755490619704,0.35365853658536583,39795,40211,Benewah+Latah+Nez Perce,Latah,16,57,Idaho,ID
16059,16CS009,79,96,114,109,-5,13,30,11,-244.56136614359067,27.167907358081877,286.5458502460417,0.7201380888822092,98,122,150,148,-2,26,50,13,-184.483880720922,159.88602995813238,455.0602391116076,0.4642857142857143,7988,8131,Central Idaho,Lemhi,16,59,Idaho,ID
16061,16CS009,30,41,53,47,-6,6,17,4,-320.94795930120557,63.1534776857051,419.81909774497956,0.39987085939783507,38,53,71,67,-4,14,29,12,-433.8198743729947,54.22748429662434,460.9336165213069,0.75,3596,3688,Central Idaho,Lewis,16,61,Idaho,ID
16063,16CS013,21,32,43,39,-4,7,18,7,-249.24440105687307,-1.4805554239426448,246.2832902089876,0.7444762273235259,27,40,55,38,-17,-2,11,7,-457.2007936853695,-171.09385210679108,76.04171204746271,-0.4375,5177,5260,Lincoln and Nearby Counties,Lincoln,16,63,Idaho,ID
16065,16CS011,144,169,198,164,-34,-5,20,15,-115.41554918000816,-47.78845744172627,12.024376905969554,-0.6179844848979005,190,225,264,234,-30,9,44,20,-93.05019709194872,-20.47104336022872,44.75714480122725,0.6666666666666666,51133,53734,Jefferson and Nearby Counties,Madison,16,65,Idaho,ID
16067,16CS013,148,173,201,178,-23,5,30,23,-258.0243138276951,-102.67064074612671,38.97535529883266,1.0170886754133466,184,219,257,228,-29,9,44,29,-264.6707349651527,-91.26577067763886,68.44932800822914,1,21592,21914,Lincoln and Nearby Counties,Minidoka,16,67,Idaho,ID
16069,16CS003,351,444,558,463,-95,19,112,37,-377.95933179064895,-51.53990888054304,215.03595316270983,0.4157303370786517,418,542,696,609,-87,67,191,58,-342.21193673442315,21.22610220957828,313.7925443315988,0.5132743362831859,41909,42401,Benewah+Latah+Nez Perce,Nez Perce,16,69,Idaho,ID
16071,16CS004,29,40,53,39,-14,-1,10,7,-565.1885366969894,-207.57967270176866,85.00939783977586,-0.4586575884080246,36,50,66,63,-3,13,27,8,-240.07712885135035,108.63218500061105,412.802303002322,0.5333333333333333,4552,4603,Bingham+Oneida+Power,Oneida,16,71,Idaho,ID
16073,16CS010,72,89,108,118,10,29,46,17,-67.05795854092109,122.1519457272481,286.68229726478665,0.5820372830409515,91,113,137,140,3,27,49,19,-130.2529417152006,65.1264708576003,244.22426571600113,0.6785714285714286,11993,12284,Elmore+Gooding+Owyhee,Owyhee,16,73,Idaho,ID
16075,16CS005,172,219,282,220,-62,1,48,25,-410.5489920257821,-113.18984271819379,108.47359927160238,0.4425125313283208,208,276,363,338,-25,62,130,47,-274.40048337677746,57.16676737016197,316.51333533946325,0.648306697108067,25444,26239,Boise+Gem+Payette+Washington,Payette,16,75,Idaho,ID
16077,16CS004,44,57,72,63,-9,6,19,3,-176.188776437089,50.00590016557957,251.69615346962502,0.24944556907661236,52,69,88,88,-0,19,36,12,-151.76999393864645,88.16514170709755,302.2804858529059,0.6,7851,7940,Bingham+Oneida+Power,Power,16,77,Idaho,ID
16079,16CS006,135,155,181,158,-23,3,23,24,-426.56342726728786,-194.62487840805898,-7.5776615861000725,1.0740573726403757,165,195,228,246,18,51,81,42,-177.48668158022184,66.41913240008303,287.8162404003598,0.8076923076923077,13186,13550,Bonner+Boundary+Shoshone,Shoshone,16,79,Idaho,ID
16081,16CS011,33,44,57,37,-20,-7,4,2,-220.21891872439087,-86.89792720058144,21.842006511025325,-0.1871830812407332,42,57,75,70,-5,13,28,1,-49.225383889625746,98.45076777925149,221.51422750331588,0.06666666666666667,11840,12189,Jefferson and Nearby Counties,Teton,16,81,Idaho,ID
16083,16CS014,552,683,864,838,-26,155,286,98,-165.28940920329504,75.97980906925659,250.60007201789892,0.5697674418604651,657,851,1087,986,-101,135,329,130,-251.42299944085931,5.4373486038248124,216.51522140430393,0.6970559484790984,90024,91957,Twin Falls,Twin Falls,16,83,Idaho,ID
16085,16CS009,54,69,85,83,-2,14,29,7,-88.11931738017458,70.43622122709351,220.6467314866106,0.42667802644104,67,86,107,101,-6,15,34,4,-82.08678283086532,90.29546111395184,246.67078240674988,0.21052631578947367,11822,12182,Central Idaho,Valley,16,85,Idaho,ID
16087,16CS005,89,109,128,138,10,29,49,13,-37.134942829500396,187.94224963613803,413.0194421017765,0.4410346803933612,112,138,165,163,-2,25,51,28,-277.05108849730897,-27.659010498899402,212.0524138248954,1,10520,10846,Boise+Gem+Payette+Washington,Washington,16,87,Idaho,ID
17001,17CS001,542,672,842,745,-97,73,203,71,-308.01511555659675,3.6668466137690086,242.19521883944282,0.5634920634920635,637,812,1034,936,-98,124,299,103,-309.20385005688985,32.288815769242596,301.59291491128243,0.5786516853932584,65451,65038,Adams,Adams,17,1,Illinois,IL
17003,17CS046,62,77,95,99,4,22,37,11,-149.81016112315194,245.23748401496587,583.8497512762095,0.48802112762002164,73,93,116,103,-13,10,30,12,-495.0372515531794,-39.60298012425435,356.4268211182892,0.7058823529411765,5244,5050,Southern Illinois,Alexander,17,3,Illinois,IL
17005,17CS002,114,150,193,165,-28,15,51,11,-281.84558939620626,28.870226826756085,288.70226826756084,0.3333333333333333,138,182,236,219,-17,37,81,28,-271.29123033282855,54.19802603763501,319.1661533327395,0.5957446808510638,16626,16606,Bond+Effingham+Fayette,Bond,17,5,Illinois,IL
17007,17CS003,281,356,446,401,-45,46,120,57,-229.63473100233026,-25.890190260066646,141.94578225193052,0.8260869565217391,336,431,554,500,-54,69,164,37,-171.106169262704,60.169202378093715,238.7965219380594,0.3854166666666667,53302,53183,Boone,Boone,17,7,Illinois,IL
17009,17CS004,35,46,59,60,1,14,25,3,-41.827084850411474,208.85740105789603,428.2063262276652,0.20295330869415343,41,56,73,67,-6,11,26,8,-219.04948171327987,46.939174652845686,281.63504791707413,0.5714285714285714,6297,6391,Brown and Nearby Counties,Brown,17,9,Illinois,IL
17011,17CS005,268,343,431,417,-14,74,149,57,-258.19900189904166,61.77879003917957,334.3322755061483,0.6705882352941176,317,415,534,447,-87,32,130,51,-419.2328115496614,-57.720459561185265,240.1474909637733,0.5795454545454546,33021,32917,Bureau+Marshall+Putnam+Stark,Bureau,17,11,Illinois,IL
17013,17CS004,30,42,54,59,5,17,29,4,19.882440469518254,352.093959680327,662.1580442770819,0.22355764022961203,36,50,67,68,1,18,32,7,-137.13893888746037,251.421387960344,571.4122453644181,0.3684210526315789,4455,4375,Brown and Nearby Counties,Calhoun,17,13,Illinois,IL
17015,17CS006,141,165,188,216,28,51,75,26,13.396877586216629,191.9154101743008,376.80960464053106,0.5123378976839554,171,201,232,214,-18,13,43,13,-197.8583926527946,0,191.16752913313493,0.5,15474,15693,Carroll+Jo Daviess+Stephenson,Carroll,17,15,Illinois,IL
17017,17CS004,106,126,147,140,-7,14,34,27,-319.84436761456885,-119.72791099419825,64.99497203998997,1.4420159532717847,126,155,183,149,-34,-6,23,16,-390.63453697600033,-171.87919626944017,54.68883517664005,-0.6153846153846154,12818,12800,Brown and Nearby Counties,Cass,17,17,Illinois,IL
17019,17CS007,900,1120,1389,1277,-112,157,377,66,-103.685883489829,52.97818864443818,181.08643492145598,0.31354096140826,1085,1373,1761,1642,-119,269,557,128,-120.00065574128821,68.48853454572613,208.4042960769063,0.39324209532798493,206123,205874,Champaign,Champaign,17,19,Illinois,IL
17021,17CS008,293,368,462,418,-44,50,125,61,-374.32714880680123,-37.43271488068012,228.1613097489074,0.8472222222222222,350,448,577,501,-76,53,151,40,-344.24727439994757,38.57943592413205,329.4090298137429,0.43478260869565216,33660,33697,Christian+Shelby,Christian,17,21,Illinois,IL
17023,17CS009,136,159,182,191,9,32,55,18,-67.73622953416556,111.59183371804251,290.9198969702506,0.5430337212075701,160,190,222,234,12,44,74,30,-117.52719516723822,91.41004068562972,287.2886992976934,0.6818181818181818,15404,15316,Clark+Crawford+Cumberland+Jasper,Clark,17,23,Illinois,IL
17025,17CS010,113,136,159,176,17,40,63,29,-106.18094161247441,102.81891771913865,303.9952529046488,0.7187972283592484,135,161,190,182,-8,21,47,19,-205.15028524754166,15.196317425743826,212.74844396041357,0.7307692307692307,13241,13161,Clay+Hamilton+Wayne+White,Clay,17,25,Illinois,IL
17027,17CS011,228,293,367,347,-20,54,119,41,-198.02727947512852,42.202534970109355,253.37752726284876,0.6212121212121212,274,353,452,364,-88,11,90,35,-334.3021363663377,-65.20317978701426,149.55979363646384,0.4430379746835443,36965,36808,Clinton+Marion,Clinton,17,27,Illinois,IL
17029,17CS012,312,396,497,524,27,128,212,50,-58.442407368687455,199.03379516017208,410.7449021139857,0.3816793893129771,369,475,608,597,-11,122,228,64,-160.60420828647855,124.03520746492353,350.72024179736997,0.4830257461836409,47329,46761,Coles,Coles,17,29,Illinois,IL
17031,17CS013,27715,34376,42280,44691,2411,10316,16976,7636,-119.74481527314322,61.40612853686253,214.04602009357072,0.7197330203307741,32992,41058,52124,47087,-5037,6029,14095,4196,-178.02396260054496,35.343715646213894,190.872454101284,0.4983669303343329,5236285,5186212,Cook,Cook,17,31,Illinois,IL
17033,17CS009,142,186,235,195,-40,9,53,29,-444.3386835675527,-128.70056004853083,154.440672058237,0.7435897435897436,170,224,291,240,-51,16,70,27,-418.09418732942345,-58.96200077722638,230.48782122006676,0.5294117647058824,18648,18656,Clark+Crawford+Cumberland+Jasper,Crawford,17,33,Illinois,IL
17035,17CS009,72,89,109,103,-6,14,31,20,-292.7094782678716,-66.4259325654543,131.57216992416093,1.1430953798969243,85,106,128,157,29,51,72,19,96.55208482100653,308.9666714272209,512.2088099754392,0.37254901960784315,10464,10357,Clark+Crawford+Cumberland+Jasper,Cumberland,17,35,Illinois,IL
17037,17CS014,476,597,741,753,12,156,277,56,-52.41360810915375,118.85171906837586,262.7217250006448,0.3404286770140429,568,726,924,892,-32,166,324,69,-100.65983827269508,97.12354509240743,254.06523257249756,0.3641186299081036,100966,100388,DeKalb,DeKalb,17,37,Illinois,IL
17039,17CS015,130,170,217,205,-12,35,75,21,-256.1901154931134,108.68671566374508,419.220188988731,0.5,156,204,270,230,-40,26,74,21,-397.24964318081913,32.56144616236222,345.15132932103955,0.45652173913043476,15457,15356,De Witt+Logan+Mason+Menard,De Witt,17,39,Illinois,IL
17041,17CS016,126,166,215,200,-15,34,74,29,-268.05658972449737,30.460976105056524,274.1487849455087,0.725,154,204,265,247,-18,43,93,17,-177.4405468548663,131.81297766361496,385.29947317056684,0.3269230769230769,19697,19725,Douglas+Edgar+Moultrie+Piatt,Douglas,17,41,Illinois,IL
17043,17CS017,4311,5332,6597,6490,-107,1158,2179,821,-119.85456423749126,43.51773759417612,175.42038764038134,0.6401560427187157,5173,6494,8241,6994,-1247,500,1821,393,-177.14426699313537,11.61159067180613,154.2559315200588,0.32452518579686207,929276,925799,DuPage,DuPage,17,43,Illinois,IL
17045,17CS016,149,192,244,242,-2,50,93,36,-271.57574231075125,100.0542208513294,407.3636134661268,0.6666666666666666,177,231,305,278,-27,47,101,42,-416.8108682930513,30.203686108192123,356.40349607666707,0.711864406779661,16791,16554,Douglas+Edgar+Moultrie+Piatt,Edgar,17,45,Illinois,IL
17047,17CS018,46,60,75,81,6,21,35,10,-73.6072276756011,211.8697109325547,481.48681961803504,0.4586068919318121,53,70,88,90,2,20,37,18,-262.5551263204677,32.81939079005846,311.7842125055554,0.8571428571428571,6221,6094,Edwards+Lawrence+Richland+Wabash,Edwards,17,47,Illinois,IL
17049,17CS002,247,310,396,379,-17,69,132,44,-212.04369055960197,86.90315186868933,306.07290088152365,0.5641025641025641,290,376,484,430,-54,54,140,53,-310.5334694134206,2.902181957134772,252.48983027072518,0.654320987654321,34521,34457,Bond+Effingham+Fayette,Effingham,17,49,Illinois,IL
17051,17CS002,150,192,249,226,-23,34,76,34,-319.4077783523392,0,235.14683068883863,0.7817124735729386,176,231,299,244,-55,13,68,30,-397.5212373559346,-79.45750776073943,177.61089970047638,0.5769230769230769,21433,21395,Bond+Effingham+Fayette,Fayette,17,51,Illinois,IL
17053,17CS019,133,170,219,203,-16,33,70,24,-356.9066233752151,80.30399025942339,410.4426168814973,0.6,160,207,270,237,-33,30,77,20,-392.1798354201288,73.99619536228846,421.7783135650442,0.43478260869565216,13449,13514,Ford+Iroquois+Livingston,Ford,17,53,Illinois,IL
17055,17CS020,329,420,525,518,-7,98,189,60,-213.00176176830317,120.80696936112719,410.425782750566,0.5660377358490566,391,505,646,644,-2,139,253,88,-240.59060122074484,136.1078276456793,440.34885414778597,0.5945945945945946,37746,37470,Franklin+Gallatin+Saline,Franklin,17,55,Illinois,IL
17057,17CS021,309,388,485,450,-35,62,141,31,-236.19684312878803,110.94094146958226,393.6614052146467,0.3875,366,471,607,515,-92,44,149,55,-442.3389045717757,-33.10019013802403,283.0066256801053,0.5851063829787234,33531,33232,Fulton+McDonough,Fulton,17,57,Illinois,IL
17059,17CS020,49,62,77,68,-9,6,19,4,-323.5737993109929,56.97478304726086,377.43674713842194,0.33074883138588357,57,75,95,91,-4,16,34,5,-183.32116850270737,224.05920594775347,590.7015429531682,0.2777777777777778,4926,4909,Franklin+Gallatin+Saline,Gallatin,17,59,Illinois,IL
17061,17CS022,109,129,150,163,13,34,54,26,-133.9286994151958,78.86655961448096,283.4773856045546,0.7664556853724154,130,156,184,181,-3,24,51,19,-185.59919011262497,46.39979752815624,269.9624583456363,0.6785714285714286,12054,11854,Greene+Jersey+Morgan,Greene,17,61,Illinois,IL
17063,17CS023,291,366,461,466,5,100,175,44,-89.40304839560848,127.22741502451974,300.3025471749926,0.42106227106227107,347,451,574,527,-47,76,180,55,-192.8392333199614,39.682742770398725,236.2068022047543,0.5445544554455446,52347,52920,Grundy,Grundy,17,63,Illinois,IL
17065,17CS010,67,82,100,107,7,25,40,11,-64.59285933466278,206.9586411304798,441.48039153219395,0.4438176381452651,78,98,123,103,-20,5,25,18,-479.76011994002994,-164.1284620847471,88.3768641994792,1,7993,7921,Clay+Hamilton+Wayne+White,Hamilton,17,65,Illinois,IL
17067,17CS024,150,175,201,235,34,60,85,32,10.751756026721713,190.56168294832318,359.13348943732467,0.5343847063874214,183,214,251,239,-12,25,56,24,-206.63331196846926,5.739814221346368,183.67405508308377,0.75,17558,17422,Hancock+Henderson+Mercer+Warren,Hancock,17,67,Illinois,IL
17069,17CS046,41,53,67,62,-5,9,21,10,-504.50600853447577,-47.117380147466136,356.4608213704836,0.8439657339601684,50,66,84,84,-0,18,34,11,-302.9333820707301,191.9034999543087,630.5400712784428,0.5789473684210527,3667,3648,Southern Illinois,Hardin,17,69,Illinois,IL
17071,17CS024,58,72,90,95,5,23,37,15,-195.98707589249915,143.67296566059454,421.5766360222164,0.6622294344257639,70,89,112,109,-3,20,39,10,-205.8285092276483,158.32962248280637,459.15590520013853,0.45454545454545453,6390,6316,Hancock+Henderson+Mercer+Warren,Henderson,17,71,Illinois,IL
17073,17CS025,358,448,558,583,25,135,225,64,-95.46891089008054,173.57983798196457,393.61061852248315,0.46209988530914403,418,540,688,601,-87,61,183,41,-261.5410745915655,40.865792904932114,290.147129625018,0.36607142857142855,49084,48941,Henry,Henry,17,73,Illinois,IL
17075,17CS019,250,315,394,381,-13,66,131,44,-253.7102091552721,97.83741632631002,386.9025100176805,0.5714285714285714,296,379,491,418,-73,39,122,43,-432.03147125803565,-14.897636939932264,294.2283295636622,0.5308641975308642,26984,26850,Ford+Iroquois+Livingston,Iroquois,17,75,Illinois,IL
17077,17CS026,299,380,481,535,54,155,236,68,-31.551012499468797,195.3692588935079,377.3770569776321,0.43312101910828027,354,457,588,611,23,154,257,64,-78.02214032660486,171.05950376113123,366.92263556762646,0.39751552795031053,53437,52613,Jackson,Jackson,17,77,Illinois,IL
17079,17CS009,62,77,95,87,-8,10,25,13,-265.7861017590702,-42.37082533734489,159.28666882003185,0.8873259802709111,72,91,114,124,10,33,52,13,-32.60559457660277,217.37063051068512,423.872729495836,0.3939393939393939,9295,9201,Clark+Crawford+Cumberland+Jasper,Jasper,17,79,Illinois,IL
17081,17CS027,301,373,474,486,12,113,185,65,-171.58316646770072,155.24961339207601,388.12403348019006,0.5555555555555556,354,454,584,549,-35,96,195,67,-276.56451139366294,77.23751665575104,346.89130287495203,0.5677966101694916,37102,36899,Jefferson+Washington,Jefferson,17,81,Illinois,IL
17083,17CS022,180,232,296,271,-25,39,91,36,-341.02092751946486,16.771521025547454,307.47788546836995,0.7058823529411765,217,280,367,317,-50,37,100,29,-370.03750142716206,37.47215204325692,332.7995503341753,0.47540983606557374,21465,21349,Greene+Jersey+Morgan,Jersey,17,83,Illinois,IL
17085,17CS006,163,205,260,247,-13,42,84,23,-197.19968084388069,104.07760933427036,334.1439036521312,0.45098039215686275,191,248,321,259,-62,11,68,18,-364.64264565207486,-31.88630255545939,227.75930396756706,0.34615384615384615,21907,21953,Carroll+Jo Daviess+Stephenson,Jo Daviess,17,85,Illinois,IL
17087,17CS046,104,123,146,140,-6,17,36,16,-203.30004526958402,6.164045938414205,178.59787816499806,0.8013609643011604,129,155,185,175,-10,20,46,32,-312.4941872361005,-89.28405349602872,104.53674596826662,1.28,13188,13440,Southern Illinois,Johnson,17,87,Illinois,IL
17089,17CS028,2209,2712,3359,3584,225,872,1375,513,-66.71817978377912,83.09393423200937,199.5643178129205,0.5796610169491525,2627,3299,4185,3905,-280,606,1278,326,-117.54594835293987,54.29821915173334,184.70121011095856,0.4381720430107527,518449,515671,Kane,Kane,17,89,Illinois,IL
17091,17CS029,759,946,1173,1149,-24,203,390,124,-165.24961612127854,88.17777557298888,296.90238357487397,0.5486725663716814,895,1147,1466,1378,-88,231,483,132,-206.24479013405406,92.78906713597523,329.07314617617067,0.4731182795698925,107510,106694,Kankakee,Kankakee,17,91,Illinois,IL
17093,17CS030,411,521,642,630,-12,109,219,74,-78.23431392824641,31.80256663749854,131.79892259340463,0.6166666666666667,501,643,828,780,-48,137,279,61,-81.08329161234677,56.509217446477344,162.12940610795238,0.37888198757763975,132065,134491,Kendall,Kendall,17,93,Illinois,IL
17095,17CS031,453,566,706,694,-12,128,241,106,-285.15939692659185,53.14279315870412,326.1035034738662,0.75177304964539,533,680,875,730,-145,50,197,73,-441.96711343079386,-46.61886543869873,251.53918264967427,0.5367647058823529,49677,49336,Knox,Knox,17,95,Illinois,IL
17097,17CS032,3273,4066,5004,4865,-139,799,1592,699,-141.509609024053,16.885580696146175,150.80512119728147,0.7540461849258955,3939,4972,6309,5214,-1095,242,1275,373,-206.30967685189472,-18.41109551932846,126.78358219836794,0.3715143127830439,710666,711527,Lake,Lake,17,97,Illinois,IL
17099,17CS033,899,1106,1374,1295,-79,189,396,180,-284.6279826182783,9.890547658550211,237.48303877918883,0.7563025210084033,1063,1342,1715,1435,-280,93,372,129,-375.42723422047214,-33.02071935484241,223.3026146371214,0.4980694980694981,109195,109022,La Salle,La Salle,17,99,Illinois,IL
17101,17CS018,127,165,208,180,-28,15,53,30,-455.24972098784605,-117.73699680720158,180.5300617710424,0.9375,152,198,260,197,-63,-1,45,20,-547.3504884113921,-138.48626815227993,164.86460494319041,-0.20101010101010103,15288,15164,Edwards+Lawrence+Richland+Wabash,Lawrence,17,101,Illinois,IL
17103,17CS034,249,320,400,387,-13,66,138,64,-271.5271196526569,8.81581557313821,260.948140964891,0.8533333333333334,304,392,504,420,-84,28,116,39,-361.2874168684018,-33.778904829159515,226.17179755176375,0.4588235294117647,34030,34045,Lee+Whiteside,Lee,17,103,Illinois,IL
17105,17CS019,299,379,478,420,-58,41,121,54,-376.4868391655792,-43.67986532041525,225.1193058821402,0.7714285714285715,360,458,593,482,-111,24,122,64,-490.514386086209,-110.71610428803004,162.85077618062112,0.6736842105263158,35714,35677,Ford+Iroquois+Livingston,Livingston,17,105,Illinois,IL
17107,17CS015,221,282,361,351,-10,69,130,47,-244.27935284423396,94.28325899251135,355.7050225626565,0.6266666666666667,266,341,441,332,-109,-9,66,30,-496.8629568260942,-139.40759220300487,128.68393126431218,-0.3000300030003,28001,27976,De Witt+Logan+Mason+Menard,Logan,17,107,Illinois,IL
17109,17CS021,190,243,308,318,10,75,128,31,-92.02688671512102,192.36023826438603,424.0668889010329,0.3974358974358974,222,290,379,323,-56,32,101,32,-327.7546896047386,1.8611850630592763,257.0296572084859,0.5,27448,26865,Fulton+McDonough,McDonough,17,109,Illinois,IL
17111,17CS035,1473,1826,2251,2165,-86,339,692,234,-124.08143180449443,40.70150059191476,177.5748325824395,0.5916570771001151,1761,2232,2828,2536,-292,304,775,183,-152.86652883413944,39.07696876361865,190.2710676589035,0.4057669616519174,309571,310925,McHenry,McHenry,17,111,Illinois,IL
17113,17CS036,818,1018,1273,1220,-53,202,402,110,-114.50260821003262,64.58761468622318,205.03057466425517,0.4670934006491165,983,1232,1585,1412,-173,180,429,145,-186.08872204082178,20.188870787447648,166.22170281665223,0.5566239316239316,170931,170886,McLean,McLean,17,113,Illinois,IL
17115,17CS037,843,1048,1312,1242,-70,194,399,142,-245.68020828975187,60.826271800103626,297.8170126898406,0.6228070175438597,993,1263,1609,1433,-176,170,440,136,-304.1637962487521,33.135434387880714,296.51340919155,0.5343832020997376,103574,102609,Macon,Macon,17,115,Illinois,IL
17117,17CS038,368,462,585,568,-17,106,200,66,-222.4198800135581,107.12577002459149,358.8713295823815,0.5665340406719717,438,557,717,647,-70,90,209,70,-314.8549699294762,44.979281418496605,312.60600585855144,0.5737704918032787,44807,44465,Macoupin+Montgomery,Macoupin,17,117,Illinois,IL
17119,17CS039,2007,2472,3072,2909,-163,436,902,294,-206.87429419076022,64.49969789341064,275.1987110118854,0.5610687022900763,2405,3028,3844,3378,-466,350,973,319,-296.65163979337734,11.90309745046989,247.20655086023487,0.5242402882205515,265118,264637,Madison,Madison,17,119,Illinois,IL
17121,17CS011,343,436,550,567,17,131,224,51,-108.66833020656637,255.69018872133262,552.9300331098818,0.37777777777777777,406,522,676,593,-83,71,187,67,-400.96176489090516,10.688750813486308,320.66252440458925,0.6203703703703703,37545,37423,Clinton+Marion,Marion,17,121,Illinois,IL
17123,17CS005,117,137,159,148,-11,11,31,1,-128.67301767266605,99.88172829916579,311.50649308789895,0.05787680859387117,139,169,198,184,-14,15,45,17,-265.70479625727654,-17.142244919824293,240.4199850005353,0.7083333333333334,11655,11667,Bureau+Marshall+Putnam+Stark,Marshall,17,123,Illinois,IL
17125,17CS015,118,154,200,193,-7,39,75,33,-367.43481381070086,55.11522207160513,385.8065545012359,0.7857142857142857,140,187,240,222,-18,35,82,20,-294.524651099704,116.25973069725158,480.54022021530653,0.425531914893617,13064,12902,De Witt+Logan+Mason+Menard,Mason,17,125,Illinois,IL
17127,17CS046,136,176,224,200,-24,24,64,23,-401.66947283549524,8.537076999691715,350.0201569873604,0.6216216216216216,160,212,274,239,-35,26,79,29,-458.0214082996267,-17.87749446915015,357.549889383003,0.6237280296022202,14056,13984,Southern Illinois,Massac,17,127,Illinois,IL
17129,17CS015,84,103,122,111,-11,8,27,12,-222.25046067267186,-36.934878461874476,148.3807037489228,0.810351054303227,100,123,149,162,13,39,62,14,-8.621589212065413,205.2759336206056,394.1297925515628,0.358974358974359,12245,12179,De Witt+Logan+Mason+Menard,Menard,17,129,Illinois,IL
17131,17CS024,148,171,196,192,-4,21,44,16,-151.2553458869062,38.38861148532999,215.3896383660841,0.6589431031716588,181,213,249,206,-43,-7,25,16,-378.7821080779854,-147.53579146136607,57.73139665879542,-0.5,15607,15589,Hancock+Henderson+Mercer+Warren,Mercer,17,131,Illinois,IL
17133,17CS040,206,261,333,302,-31,41,96,45,-261.4813213121373,-13.762174805901964,175.6397559603237,0.8181818181818182,243,319,413,358,-55,39,115,35,-257.679997232326,11.45244432143671,229.0488864287342,0.5,34878,34927,Monroe+St. Clair,Monroe,17,133,Illinois,IL
17135,17CS038,236,299,376,360,-16,61,124,29,-192.23005161585027,136.2427829835484,404.4707619824093,0.4084507042253521,281,362,473,460,-13,98,179,69,-292.04852941285526,103.22251496615236,391.71164731120905,0.6330275229357798,28185,28095,Macoupin+Montgomery,Montgomery,17,135,Illinois,IL
17137,17CS022,266,333,415,414,-1,81,148,54,-200.5684037654692,98.46085275759397,342.7896355264383,0.6206896551724138,314,403,525,437,-88,34,123,31,-364.80357908929335,9.192866335723478,282.2209965067105,0.3875,32906,32634,Greene+Jersey+Morgan,Morgan,17,137,Illinois,IL
17139,17CS016,135,157,182,183,1,26,48,20,-154.8764152591116,49.45096063993071,233.34559894906874,0.7242817296905157,162,192,223,216,-7,24,54,19,-179.23000034467307,34.46730775859098,241.27115431013684,0.6551724137931034,14485,14506,Douglas+Edgar+Moultrie+Piatt,Moultrie,17,139,Illinois,IL
17141,17CS041,358,447,559,518,-41,71,160,52,-216.79159219066827,44.2669559551069,251.6226970079761,0.5416666666666666,426,546,692,592,-100,46,166,49,-289.5164406927125,-5.827234633197836,227.26215069471561,0.4394707207207207,51506,51482,Ogle,Ogle,17,141,Illinois,IL
17143,17CS042,1224,1522,1878,1770,-108,248,546,146,-168.7152585413955,67.37988881350245,265.5696997028734,0.48184818481848185,1450,1831,2340,2148,-192,317,698,211,-224.38209882175516,58.98934145611619,271.04489392642813,0.5121389394555298,180766,179693,Peoria+Woodford,Peoria,17,143,Illinois,IL
17145,17CS043,154,197,253,232,-21,35,78,29,-287.0956487065743,34.45147784478892,281.35373573244283,0.6444444444444445,179,239,312,302,-10,63,123,40,-238.43941403514,109.6821304561644,396.04786671236735,0.5714285714285714,20899,20970,Perry+Randolph,Perry,17,145,Illinois,IL
17147,17CS016,120,141,167,162,-5,21,42,5,-71.42957069161362,112.52371660631198,266.807118856185,0.21685789777087258,143,171,205,209,4,38,66,10,-35.845372026421025,167.2784027899648,334.5568055799296,0.2564102564102564,16626,16739,Douglas+Edgar+Moultrie+Piatt,Piatt,17,147,Illinois,IL
17149,17CS004,128,167,213,217,4,50,89,39,-284.3858619600054,89.37841375885884,406.26551708572197,0.75,153,200,263,236,-27,36,83,32,-403.55159603801246,27.359430239865254,349.17472843627996,0.6666666666666666,14769,14620,Brown and Nearby Counties,Pike,17,149,Illinois,IL
17151,17CS046,27,37,49,42,-7,5,15,1,-262.2871068262565,126.06460110368958,436.74596744764625,0.10972152663379743,31,44,59,71,12,27,40,12,-1.324890834515539,397.46725035468427,741.938867328744,0.4444444444444444,3811,3774,Southern Illinois,Pope,17,151,Illinois,IL
17153,17CS046,51,66,81,68,-13,2,17,2,-357.1034583160844,5.288583521572692,349.56102326734594,0.14558085650901006,60,78,98,107,9,29,47,16,-137.8224059854302,255.95589683008464,610.356369364048,0.5517241379310345,5173,5079,Southern Illinois,Pulaski,17,153,Illinois,IL
17155,17CS005,37,49,63,42,-21,-7,5,2,-495.52488687582354,-198.35439359442387,63.85486518328184,-0.1748285441298123,44,60,79,71,-8,11,27,3,-197.27182039297443,143.47041483125412,430.4112444937624,0.2,5644,5576,Bureau+Marshall+Putnam+Stark,Putnam,17,155,Illinois,IL
17157,17CS043,232,292,367,362,-5,70,130,51,-221.72653315140244,75.22864517636869,312.79278783858564,0.6710526315789473,274,354,455,444,-11,90,170,50,-202.6265949480261,132.76107777102447,398.2832333130734,0.49504950495049505,30308,30129,Perry+Randolph,Randolph,17,157,Illinois,IL
17159,17CS018,133,175,220,222,2,47,89,29,-205.57261463991085,137.04840975994057,456.82803253313523,0.58,158,212,273,265,-8,53,107,41,-310.18506917839204,75.96369041103478,417.8002972606913,0.6833333333333333,15761,15797,Edwards+Lawrence+Richland+Wabash,Richland,17,159,Illinois,IL
17161,17CS044,1099,1354,1683,1652,-31,298,553,192,-186.34949921615302,88.47949346881175,301.37284072560834,0.5791868379863867,1298,1645,2080,1776,-304,131,478,160,-324.302699989431,-20.264551389126265,222.28116540969182,0.4870635332493143,143762,143107,Rock Island,Rock Island,17,161,Illinois,IL
17163,17CS040,1764,2180,2724,2685,-39,505,921,324,-169.4954297052905,84.5026105953934,278.74189865182115,0.5950418240690771,2102,2660,3371,3073,-298,412,971,295,-232.50923154460833,46.06277981199035,265.1059987051784,0.5225900495201752,257033,255087,Monroe+St. Clair,St. Clair,17,163,Illinois,IL
17165,17CS020,244,310,388,330,-58,20,86,41,-504.16356063041644,-106.83587056749491,228.93400835891765,0.7130973986690865,284,369,478,423,-55,54,139,53,-462.2141699314703,4.279760832698799,368.0594316120967,0.654320987654321,23588,23366,Franklin+Gallatin+Saline,Saline,17,165,Illinois,IL
17167,17CS045,1342,1663,2069,1899,-170,236,557,190,-220.8527831202745,28.20440872718664,225.08344442935248,0.5882352941176471,1593,2018,2572,2118,-454,100,525,141,-305.38110754198993,-20.777715002856937,197.10612602710202,0.3477193942711184,195714,194920,Sangamon,Sangamon,17,167,Illinois,IL
17169,17CS004,63,79,97,80,-17,1,17,4,-367.322030238626,-51.15445952790403,221.899351540447,0.22835526779771723,78,98,119,108,-11,10,30,5,-233.6562332668062,80.31933018546462,365.81804020834284,0.29411764705882354,6865,6848,Brown and Nearby Counties,Schuyler,17,169,Illinois,IL
17171,17CS004,37,49,62,59,-3,10,22,0,-84.88633440150339,235.66782164954344,536.1873429474001,0,43,58,76,69,-7,11,26,2,-185.5949133245978,185.5949133245978,494.9197688655941,0.13333333333333333,4924,4849,Brown and Nearby Counties,Scott,17,171,Illinois,IL
17173,17CS008,155,198,254,234,-20,36,79,30,-285.7936728456317,31.437304013019485,280.0777993887191,0.6382978723404256,182,240,313,321,8,81,139,48,-192.25974291267502,158.6142879029569,437.3909151263357,0.5714285714285714,20994,20805,Christian+Shelby,Shelby,17,173,Illinois,IL
17175,17CS005,48,61,76,77,1,16,29,12,-256.1190212426996,92.99107737065879,386.97852883453936,0.7065882413242273,56,74,93,97,4,23,41,9,-95.13679839554767,263.74557971042935,602.8470393381242,0.38315217391304346,5369,5308,Bureau+Marshall+Putnam+Stark,Stark,17,175,Illinois,IL
17177,17CS006,371,464,582,573,-9,108,202,64,-197.30155587066912,120.27286624992844,372.9810234267444,0.5355742296918767,437,559,732,653,-79,94,216,93,-390.4993242157594,2.26836668147406,279.0091018213094,0.7410476190476191,44399,44085,Carroll+Jo Daviess+Stephenson,Stephenson,17,177,Illinois,IL
17179,17CS047,927,1157,1441,1421,-20,264,494,112,-120.9832271317106,139.15588743110112,349.81226702252457,0.38554331081881743,1098,1396,1771,1718,-53,322,620,165,-167.04823501822062,120.30538026541576,348.6940336928499,0.45454545454545453,131076,130501,Tazewell,Tazewell,17,179,Illinois,IL
17181,17CS046,150,195,252,231,-21,36,81,22,-302.0819358222244,98.3522581746777,414.4845165932846,0.4888888888888889,180,237,304,278,-26,41,98,32,-342.2692164069103,53.06499479176903,389.1432951396396,0.5614035087719298,17081,16960,Southern Illinois,Union,17,181,Illinois,IL
17183,17CS048,639,788,989,928,-61,140,289,84,-234.90928625772239,90.72358641677555,332.19413204928253,0.4898000815993472,741,954,1215,1186,-29,232,445,157,-254.26883197745292,103.12810536823903,393.4576258453145,0.6205533596837944,74071,73210,Vermilion,Vermilion,17,183,Illinois,IL
17185,17CS018,80,98,117,139,22,41,59,15,76.95865091854797,277.5540587856864,469.4279271803404,0.364395224938401,92,113,137,161,24,48,69,15,80.22373508339926,294.15369530579727,481.78809791752514,0.3125,11312,11219,Edwards+Lawrence+Richland+Wabash,Wabash,17,185,Illinois,IL
17187,17CS024,135,158,183,218,35,60,83,31,26.21305754863071,208.727128251357,373.578546950594,0.5154029606306848,162,192,226,215,-11,23,53,28,-235.4095144678764,-30.18070698306108,151.20534198513573,0.9655172413793104,16757,16567,Hancock+Henderson+Mercer+Warren,Warren,17,187,Illinois,IL
17189,17CS027,99,118,139,149,10,31,50,17,-60.6566409910388,118.8976575641974,291.269784177224,0.5408417431493808,118,142,170,167,-3,25,49,21,-175.65474084826604,29.275790141377673,204.9305309896437,0.75,13737,13663,Jefferson+Washington,Washington,17,189,Illinois,IL
17191,17CS010,130,171,219,215,-4,44,85,32,-268.0652529982173,89.3550843327391,394.65162246959767,0.6666666666666666,160,207,268,242,-26,35,82,29,-344.3629207772405,37.53274340896355,331.5392334458447,0.5918367346938775,16115,15986,Clay+Hamilton+Wayne+White,Wayne,17,191,Illinois,IL
17193,17CS010,149,191,245,215,-30,24,66,31,-531.9730237539824,-60.99608789971953,304.98043949859766,0.775,176,233,302,253,-49,20,77,22,-515.32184950136,-14.505893019038984,398.91205802357206,0.4583333333333333,13771,13788,Clay+Hamilton+Wayne+White,White,17,193,Illinois,IL
17195,17CS034,453,569,715,706,-9,137,253,148,-340.01339167957354,-23.807430353121003,227.36095987230547,1,542,694,885,757,-128,64,215,79,-374.177167150841,-28.0113310351994,245.77684005078183,0.5602836879432624,55445,55335,Lee+Whiteside,Whiteside,17,195,Illinois,IL
17197,17CS049,3312,4063,5043,4966,-77,903,1654,644,-124.50368594545999,44.70602337428828,174.379382679053,0.6632365933878284,3984,5023,6406,5525,-881,502,1541,461,-192.52418798808188,5.881886518264796,154.93749852990194,0.4767321613236815,695208,697055,Will,Will,17,197,Illinois,IL
17199,17CS050,504,629,788,744,-44,115,240,76,-215.0904325277267,69.84618541699702,293.8017107091887,0.5650635710337203,590,757,973,889,-84,132,299,97,-270.66065074009157,52.30879500774824,301.8964740447184,0.5672514619883041,67004,66910,Williamson,Williamson,17,199,Illinois,IL
17201,17CS051,2041,2509,3117,2933,-184,424,892,323,-213.9994188047865,42.62684409680197,240.20859720489938,0.6229513989629596,2411,3048,3870,3540,-330,492,1129,303,-223.29258040337788,66.520191870465,291.5772335966668,0.4535928143712575,284328,283373,Winnebago,Winnebago,17,201,Illinois,IL
17203,17CS042,253,323,404,383,-21,60,130,46,-209.5323311340547,43.78287516233978,262.6972509740387,0.6301369863013698,299,389,501,421,-80,32,122,58,-361.17843779105544,-67.97422643914183,167.4518924395012,0.6823529411764706,38371,38250,Peoria+Woodford,Woodford,17,203,Illinois,IL
18001,18CS001,212,268,340,336,-4,68,124,43,-157.45421108007235,83.75223993620871,271.3572573933162,0.589041095890411,252,327,420,382,-38,55,130,55,-258.89427382486383,0,208.67351463583864,0.7432432432432432,35820,35941,Adams+Wells,Adams,18,1,Indiana,IN
18003,18CS002,2372,2940,3640,3470,-170,530,1097,428,-186.36931222162644,31.62234234452538,208.5828394055145,0.6908801917765386,2846,3596,4573,3912,-661,316,1066,387,-269.89125140628727,-18.288980052346837,174.90447120483807,0.5568345323741007,385171,388212,Allen,Allen,18,3,Indiana,IN
18005,18CS003,501,623,783,726,-57,103,225,101,-229.9798811055186,2.910216780835414,180.43344041179566,0.7709923664122137,594,755,961,892,-69,137,298,87,-189.3153015715111,60.65853943335826,256.34298764537164,0.5014450867052023,82468,82429,Bartholomew+Brown,Bartholomew,18,5,Indiana,IN
18007,18CS004,54,68,85,95,10,27,41,11,-9.378777117278734,216.91035525916152,409.2561177791358,0.4110380563922747,64,83,104,107,3,24,43,11,-91.8093616858494,149.19021273950528,367.2374467433976,0.44,8720,8714,Benton+Jasper+Newton,Benton,18,7,Indiana,IN
18009,18CS005,111,132,155,173,18,41,62,22,-35.48931346152602,193.72116008888682,398.78267303309497,0.530684064358792,132,159,188,204,16,45,72,35,-157.12840940220565,82.69916284326614,305.9869025200847,0.7777777777777778,12052,12092,Blackford+Jay+Randolph,Blackford,18,9,Indiana,IN
18011,18CS006,382,479,599,511,-88,32,129,76,-277.6954750409154,-74.48095642670087,89.7156975139806,0.8941176470588236,464,594,763,640,-123,46,176,54,-243.27608589548896,-10.992424101462365,167.63446754730109,0.4576271186440678,70891,72777,Boone,Boone,18,11,Indiana,IN
18013,18CS003,116,137,159,172,13,35,56,18,-36.38250093366319,129.97105288695806,296.32460670757916,0.5187189212937169,138,168,199,204,5,36,66,23,-115.82980526113991,83.65485935526772,276.70453479050093,0.6216216216216216,15420,15540,Bartholomew+Brown,Brown,18,13,Indiana,IN
18015,18CS007,129,153,178,165,-13,12,36,18,-185.5885933760612,-34.98245260037399,105.90716296397864,0.8521246342145813,155,187,222,236,14,49,81,34,-97.92391108100858,73.44293331075644,230.12119104037018,0.6938775510204082,20307,20424,Carroll+Clinton,Carroll,18,15,Indiana,IN
18017,18CS008,279,353,443,450,7,97,171,75,-216.29728949145726,69.97853483547146,305.51992140668324,0.7352941176470589,329,432,556,495,-61,63,166,63,-329.9787196311403,0,274.117751374357,0.6702127659574468,37726,37593,Cass+White,Cass,18,17,Indiana,IN
18019,18CS009,854,1080,1329,1253,-76,173,399,129,-203.38412161912007,43.64253280293237,267.8064512907214,0.591743119266055,1031,1305,1662,1539,-123,234,508,181,-248.1112800855331,43.25624290964886,266.92366497359734,0.6156462585034014,120983,122526,Clark+Scott,Clark,18,19,Indiana,IN
18021,18CS010,202,257,323,317,-6,60,115,32,-172.88510218038996,127.22162578320419,377.3484293319678,0.48484848484848486,236,309,405,350,-55,41,114,36,-344.7138978762204,18.92992300253819,295.30679883959573,0.5217391304347826,26411,26413,Clay+Sullivan+Vermillion+Vigo,Clay,18,21,Indiana,IN
18023,18CS007,249,312,397,387,-10,75,138,35,-163.54891039955274,145.37680924404688,374.52700481497556,0.4268292682926829,294,376,486,435,-51,59,141,49,-302.4710875077627,30.23199275439907,278.13433334047147,0.6049382716049383,33018,33078,Carroll+Clinton,Clinton,18,23,Indiana,IN
18025,18CS011,87,105,125,124,-1,19,37,11,-136.18031757675269,88.36104139535091,294.1906204531125,0.5389767726238258,105,128,155,166,11,38,61,26,-142.6154888343957,114.09239106751656,333.24485890970413,0.6842105263157895,10545,10518,Crawford+Harrison+Perry,Crawford,18,25,Indiana,IN
18027,18CS012,225,288,365,336,-29,48,111,70,-355.88291434153354,-77.24868913016628,147.4911018043406,1.1111111111111112,269,347,452,343,-109,-4,74,38,-440.1708282023738,-125.7630937721068,107.79693751894868,-0.2900763358778626,33399,33396,Daviess+Knox+Martin,Daviess,18,27,Indiana,IN
18029,18CS013,338,431,536,474,-62,43,136,58,-284.8880636215731,-35.59617621260806,185.2187702262705,0.6987951807228916,405,523,668,616,-52,93,211,84,-267.79980463704067,17.71553283155727,249.98585217864144,0.7,50567,50803,Dearborn+Ohio+Ripley+Switzerland,Dearborn,18,29,Indiana,IN
18031,18CS014,193,244,312,332,20,88,139,61,-185.94162868993666,120.18178439715419,353.74261067841604,0.6853932584269663,229,298,380,332,-48,34,103,38,-326.46372875672523,-15.184359477056988,246.74584150217606,0.6031746031746031,26460,26343,Decatur+Shelby,Decatur,18,31,Indiana,IN
18033,18CS015,287,360,457,458,1,98,171,63,-171.87572134250493,95.56345505747657,299.1551636581875,0.6057692307692307,342,440,569,489,-80,49,147,55,-311.6027296014418,-13.849010204508525,212.35148980246407,0.5851063829787234,43322,43324,DeKalb+Steuben,DeKalb,18,33,Indiana,IN
18035,18CS016,898,1120,1380,1343,-37,223,445,120,-168.38057510088686,110.36079691626693,348.2258155124928,0.4743083003952569,1079,1378,1753,1554,-199,176,475,183,-341.86760509753935,-5.811793992765807,261.1283747057313,0.6332179930795848,111996,111842,Delaware,Delaware,18,35,Indiana,IN
18037,18CS017,285,358,448,412,-36,54,127,55,-251.33119319503143,-1.3809406219507223,198.85544956090402,0.7638888888888888,335,436,556,534,-22,98,199,62,-192.85065505608785,82.65028073832337,314.6450270885337,0.5585585585585585,43449,43557,Dubois+Pike+Spencer,Dubois,18,37,Indiana,IN
18039,18CS018,1176,1454,1806,1781,-25,327,605,331,-206.69690541656632,-2.321458996676303,159.10699598470208,0.9232932883086165,1386,1766,2254,2092,-162,326,706,219,-184.16265969770396,51.713435474752195,235.36862688041418,0.5302694526523146,206767,206909,Elkhart,Elkhart,18,39,Indiana,IN
18041,18CS019,216,279,352,344,-8,65,128,44,-268.15162773891063,108.18797660935876,432.751906437435,0.6197183098591549,262,337,442,390,-52,53,128,61,-484.0285043765404,-34.25234882806124,287.07749861518806,0.8133333333333334,23293,23356,Fayette+Franklin+Union,Fayette,18,41,Indiana,IN
18043,18CS020,575,725,907,830,-77,105,255,87,-245.77459280408107,26.942403596062483,251.53727357323882,0.6214285714285714,694,889,1136,955,-181,66,261,95,-343.25019233891635,-36.04655288006002,206.6461867693093,0.5397727272727273,80171,80452,Floyd,Floyd,18,43,Indiana,IN
18045,18CS021,162,186,212,227,15,41,65,26,-81.03660251610559,110.7773434499616,284.60873198170975,0.6311599184944534,196,231,264,258,-6,27,62,34,-243.40863365352556,-42.596510889366975,170.3860435574679,1.0625,16459,16433,Fountain+Montgomery+Warren,Fountain,18,45,Indiana,IN
18047,18CS019,141,184,238,249,11,65,108,30,-100.11315787307107,184.41897502934142,410.9908586368181,0.45454545454545453,172,226,295,263,-32,37,91,36,-297.8398399110861,4.379997645751265,240.8998705163196,0.6792452830188679,22774,22831,Fayette+Franklin+Union,Franklin,18,47,Indiana,IN
18049,18CS022,163,209,264,237,-27,28,74,31,-341.94271502319367,-17.671458140733527,253.29090001718058,0.6967171717171717,194,252,332,293,-39,41,99,41,-392.2914725641151,0,284.4113176089835,0.7192982456140351,20372,20393,Fulton+Miami+Wabash,Fulton,18,49,Indiana,IN
18051,18CS023,241,301,381,382,1,81,141,71,-253.87157805855136,36.241481521563365,253.69037065094358,0.8114550679205852,282,368,470,401,-69,32,119,48,-355.3630510723698,-47.05790082547401,215.7073453967694,0.5962962962962963,33111,32938,Gibson+Posey,Gibson,18,51,Indiana,IN
18053,18CS024,582,722,899,892,-7,170,310,120,-229.82309970124575,90.44592668289876,343.69452139501533,0.6521739130434783,688,882,1126,1121,-5,239,433,144,-224.77100981958918,143.31037538832868,435.9652472339683,0.5549153549153549,66338,66290,Grant,Grant,18,53,Indiana,IN
18055,18CS025,256,320,400,367,-33,47,111,55,-341.02457723934214,-30.984629391422338,217.08605967365258,0.8333333333333334,301,391,499,448,-51,57,147,40,-295.74571174131586,55.21885886438627,347.5539940287842,0.45977011494252873,30983,30787,Greene+Owen+Parke+Putnam,Greene,18,55,Indiana,IN
18057,18CS026,1319,1628,2046,1971,-75,343,652,274,-120.34917261799202,23.787146693329852,130.3639061171403,0.7277671957671958,1622,2046,2620,2313,-307,267,691,168,-133.65113509586968,27.84691649898158,147.13860626886122,0.4082630571894267,348087,355515,Hamilton,Hamilton,18,57,Indiana,IN
18059,18CS027,467,589,738,659,-79,70,192,81,-239.97038790902087,-16.492810165568446,166.50241535330684,0.7570093457943925,571,724,929,918,-11,194,347,104,-141.01630347730364,109.74747096711891,297.97358039117205,0.5024154589371981,80035,81551,Hancock,Hancock,18,59,Indiana,IN
18061,18CS011,275,346,432,403,-29,57,128,41,-211.53621643637823,48.24774715583823,262.49789936973224,0.5616438356164384,324,419,541,542,1,123,218,72,-178.63835430464445,128.31769112023758,367.4666429041312,0.5538461538461539,39795,39745,Crawford+Harrison+Perry,Harrison,18,61,Indiana,IN
18063,18CS028,875,1092,1360,1288,-72,196,413,189,-178.8596200161066,4.454358352891544,153.53830599466923,0.8111737400530504,1074,1359,1722,1460,-262,101,386,157,-234.48393667349043,-31.320454272428062,128.1062509124937,0.5880232297160812,175109,178797,Hendricks,Hendricks,18,63,Indiana,IN
18065,18CS029,405,509,636,622,-14,113,217,63,-189.48096944944055,123.03959055158478,379.08497848943256,0.5080645161290323,490,623,797,734,-63,111,244,109,-351.74343099726207,4.087663346859524,276.01946749668934,0.7595911033411034,48765,48928,Henry+Rush,Henry,18,65,Indiana,IN
18067,18CS030,737,918,1145,1064,-81,146,327,137,-313.488826375807,12.93626518744733,273.0989317349992,0.7061855670103093,886,1126,1442,1334,-108,208,448,184,-349.02029129839417,28.681688036848005,315.67782895555814,0.6956546598056033,83486,83677,Howard+Tipton,Howard,18,67,Indiana,IN
18069,18CS031,277,351,438,426,-12,75,149,44,-183.59015047038716,101.63026186753574,344.23153213197594,0.5116279069767442,326,427,545,520,-25,93,194,71,-261.7181069374826,59.94584437922559,335.2880068574412,0.6635514018691588,36603,36700,Huntington+Whitley,Huntington,18,69,Indiana,IN
18071,18CS032,343,432,547,474,-73,42,131,50,-320.9827362047174,-22.1637145226653,211.33753671317896,0.6493506493506493,413,524,670,567,-103,42,154,48,-327.4662300450266,-11.927577915547328,229.87695619054847,0.44240570846075433,46021,46112,Jackson+Washington,Jackson,18,71,Indiana,IN
18073,18CS004,213,274,347,350,3,76,137,34,-112.67868715698975,154.47884529587307,374.38402506999824,0.41975308641975306,258,333,431,425,-6,92,167,75,-244.97927946603588,51.4154043323779,278.3992922820814,0.75,33014,33064,Benton+Jasper+Newton,Jasper,18,73,Indiana,IN
18075,18CS005,149,193,248,226,-22,33,77,34,-328.8817652924515,-5.8728886659366335,252.53421263527522,0.7906976744186046,178,231,303,297,-6,66,119,38,-216.98035670255612,138.07840881071752,399.44111120243286,0.5277777777777778,20433,20278,Blackford+Jay+Randolph,Jay,18,75,Indiana,IN
18077,18CS033,258,327,411,382,-29,55,124,45,-269.5688445641045,36.40362519434226,287.5886390353039,0.6338028169014085,307,399,512,427,-85,28,120,75,-483.0768418153487,-141.85949119226112,135.8229170989734,0.9554527750730282,32964,33131,Jennings+Jefferson,Jefferson,18,77,Indiana,IN
18079,18CS033,200,261,331,300,-31,39,100,30,-265.58164390623307,39.184176969772096,304.7658208760052,0.5555555555555556,243,314,407,346,-61,32,103,32,-339.02501448678794,0,258.8255486942145,0.49230769230769234,27562,27432,Jennings+Jefferson,Jennings,18,79,Indiana,IN
18081,18CS034,947,1189,1482,1462,-20,273,515,223,-180.17855657883183,37.07377707383371,216.62207944241024,0.7408637873754153,1142,1448,1852,1742,-110,294,600,199,-188.61006789322155,57.93067070758503,244.5588998660734,0.5718390804597702,161839,163989,Johnson,Johnson,18,81,Indiana,IN
18083,18CS012,296,369,467,477,10,108,181,68,-191.91341837159672,132.35408163558395,373.9002806205247,0.5964912280701754,348,446,575,503,-72,56,155,43,-319.60108894938605,37.5020834490805,311.2672926273681,0.45263157894736844,36266,35998,Daviess+Knox+Martin,Knox,18,83,Indiana,IN
18085,18CS035,495,623,772,679,-93,56,184,67,-240.10029189275937,-16.50689506762721,175.5733384465803,0.5982142857142857,592,759,983,924,-59,165,332,97,-194.76182252120847,84.896179047706255,293.4536306641669,0.5091898594654175,79967,80098,Kosciusko,Kosciusko,18,85,Indiana,IN
18087,18CS036,191,245,309,308,-1,63,117,72,-216.7917725542482,-26.72775278066074,133.6387639033037,1.0588235294117647,227,299,385,313,-72,14,86,32,-256.6463539714635,-44.419561264291765,133.2586837928753,0.5,40407,40523,LaGrange+Noble,LaGrange,18,87,Indiana,IN
18089,18CS037,3572,4418,5458,5247,-211,828,1675,627,-202.50348171747112,48.67233442603977,253.1686040294406,0.657922350472193,4317,5446,6907,6032,-875,586,1715,617,-299.23960316504196,-6.11757349455981,220.30284746720542,0.569713758079409,496791,498564,Lake,Lake,18,89,Indiana,IN
18091,18CS038,840,1042,1293,1271,-22,229,431,130,-163.02443110428592,106.14546977523383,322.7251151752059,0.52,1004,1262,1609,1366,-243,104,362,107,-311.4835069483071,-2.6698586309854893,226.93798363376658,0.4262948207171315,111922,112366,LaPorte,LaPorte,18,91,Indiana,IN
18093,18CS039,375,464,577,545,-32,81,170,82,-303.5606436930328,-2.6616452756951583,234.2247842611739,0.8325087610801897,448,564,731,733,2,169,285,108,-235.55910614029244,135.36604309522224,393.0053480682598,0.6067415730337079,45085,45063,Lawrence+Orange,Lawrence,18,93,Indiana,IN
18095,18CS040,1042,1294,1621,1558,-63,264,516,227,-267.64572915601997,34.142016820454195,266.67683408408817,0.7566666666666667,1245,1588,2021,1950,-71,362,705,261,-254.17547692576997,76.90692587999362,339.7679113504196,0.6404917618152912,130045,130677,Madison,Madison,18,95,Indiana,IN
18097,18CS041,5626,6934,8545,8757,212,1824,3131,1268,-130.07594636047065,68.41888855528968,229.4403718185802,0.6592150172493386,6606,8320,10611,10250,-361,1930,3644,1003,-140.3498182265278,95.37737812183215,271.7380726618888,0.4742422802850356,974292,971929,Marion,Marion,18,97,Indiana,IN
18099,18CS042,302,386,479,515,36,129,213,74,-99.14268860669706,143.30743425409565,362.1769702058054,0.5606060606060606,361,467,596,541,-55,74,180,71,-273.50031878547924,6.506748266109737,236.52029947308884,0.6926994098610317,46055,46106,Marshall+Pulaski+Starke,Marshall,18,99,Indiana,IN
18101,18CS012,72,90,108,95,-13,5,23,10,-277.2756977090718,-56.25779970042677,154.23543649828275,0.6930364503551212,89,108,132,128,-4,20,39,3,-71.56823903791839,173.80858052065895,368.065229337866,0.13043478260869565,9843,9781,Daviess+Knox+Martin,Martin,18,101,Indiana,IN
18103,18CS022,257,325,412,387,-25,62,130,37,-207.37652322620542,83.61956581701831,311.232023970942,0.49008771929824563,309,393,509,521,12,128,212,77,-180.4032727270626,141.43838445934196,374.39572356884634,0.5789473684210527,35877,36058,Fulton+Miami+Wabash,Miami,18,103,Indiana,IN
18105,18CS043,626,781,981,1017,36,236,391,113,-65.65952083616588,104.81662638349647,236.94522736529424,0.4708333333333333,742,947,1208,1162,-46,215,420,116,-115.89669900621233,70.80390744594274,217.4538187771605,0.48333333333333334,140817,139823,Monroe,Monroe,18,105,Indiana,IN
18107,18CS021,274,349,436,405,-31,56,131,63,-296.8759595392457,-22.10778422100766,214.76133243264582,0.875,330,428,552,488,-64,60,158,63,-334.0877615605219,-7.88562773156228,249.84297196166474,0.6774193548387096,37996,38044,Fountain+Montgomery+Warren,Montgomery,18,107,Indiana,IN
18109,18CS044,503,625,792,720,-72,95,217,93,-276.38166842749473,3.3500808294241784,207.7887634450346,0.7380952380952381,604,767,999,903,-96,136,299,112,-288.29994282513155,33.26537801828441,259.26203993000405,0.6549707602339181,71640,72147,Morgan,Morgan,18,109,Indiana,IN
18111,18CS004,113,135,155,163,8,28,50,23,-133.57327888409475,44.85877147806153,237.56538586919004,0.8165489478442124,136,163,192,223,31,60,87,31,0,210.04979628791307,405.61339972838385,0.5166666666666667,13823,13806,Benton+Jasper+Newton,Newton,18,111,Indiana,IN
18113,18CS036,315,396,493,437,-56,42,122,47,-260.79166388538545,-13.912261409986614,189.71265559072657,0.6438356164383562,372,481,618,552,-66,71,180,59,-264.76657436639096,25.39727332051712,256.19499462071633,0.5592542677448338,47440,47249,LaGrange+Noble,Noble,18,113,Indiana,IN
18115,18CS013,44,57,72,66,-6,9,22,16,-452.1245768276266,-136.1149896609442,129.99834690047254,1.2738629895335845,53,70,90,89,-1,19,36,5,-101.32306146374137,234.46658851113716,519.176017417518,0.23809523809523808,5932,5971,Dearborn+Ohio+Ripley+Switzerland,Ohio,18,115,Indiana,IN
18117,18CS039,156,202,251,264,13,62,108,35,-133.25579707935094,166.56974634918865,442.1669630360281,0.546875,184,243,313,310,-3,67,126,39,-211.78628494710068,141.19085663140046,438.9522882058359,0.5492957746478874,19812,19831,Lawrence+Orange,Orange,18,117,Indiana,IN
18119,18CS025,160,205,263,259,-4,54,99,23,-152.45190540374952,175.03737287097167,429.1238818772209,0.39655172413793105,193,250,330,77,-253,-173,-116,21,-1279.3813911697323,-905.5089014481141,-639.2239384191714,-0.12138728323699421,21253,21424,Greene+Owen+Parke+Putnam,Owen,18,119,Indiana,IN
18121,18CS025,104,123,147,150,3,27,46,13,-74.88840844362655,100.76616081278095,246.13545950773883,0.4727344529044459,124,149,177,194,17,45,70,31,-85.82718751789656,85.52175268687203,238.23916819914353,0.6888888888888889,16288,16370,Greene+Owen+Parke+Putnam,Parke,18,121,Indiana,IN
18123,18CS011,148,190,242,210,-32,20,62,25,-356.7656378359348,-31.295231389117085,231.58471227946643,0.625,176,232,302,245,-57,13,69,32,-461.33610365375597,-98.48748280248724,191.79141387852775,0.6153846153846154,19172,19292,Crawford+Harrison+Perry,Perry,18,123,Indiana,IN
18125,18CS017,109,129,150,154,4,25,45,25,-210.23249982549356,-0.7606450750605819,200.65459987727863,0.9710801028996773,129,156,188,189,1,32,60,16,-123.3859151550464,135.72450667055102,361.93201778813614,0.47058823529411764,12246,12157,Dubois+Pike+Spencer,Pike,18,125,Indiana,IN
18127,18CS045,1075,1339,1656,1602,-54,263,527,180,-162.37372666761738,57.581795827439606,240.7682197820833,0.6112071947423037,1290,1640,2089,1902,-187,262,612,192,-217.80703155710557,39.91980140616782,241.27068461382436,0.5485714285714286,172971,174099,Porter,Porter,18,127,Indiana,IN
18129,18CS023,163,208,264,233,-31,25,70,23,-257.45927993966416,9.5267078608571385,223.87763473014274,0.5476190476190477,192,254,332,255,-77,1,63,20,-386.30613417719627,-75.6292277111461,171.16088376733066,0.2615384615384615,25192,25123,Gibson+Posey,Posey,18,129,Indiana,IN
18131,18CS042,115,135,159,163,4,28,48,28,-235.99268730499756,1.6119235405873404,191.69561221705516,0.9658677530041754,138,166,194,211,17,45,73,33,-129.442201865788,97.081651399341,324.01001154530024,0.7333333333333333,12457,12361,Marshall+Pulaski+Starke,Pulaski,18,131,Indiana,IN
18133,18CS025,240,303,383,363,-20,60,123,38,-188.97712623307746,71.6809789159949,276.94923672088936,0.5428571428571428,284,368,476,441,-35,73,157,51,-233.25799116764935,59.56675340323026,287.003448215564,0.5730337078651685,36830,36933,Greene+Owen+Parke+Putnam,Putnam,18,133,Indiana,IN
18135,18CS005,205,262,332,327,-5,65,122,56,-300.00870926922397,44.26358005611502,324.5995870781768,0.7887323943661971,249,320,412,415,3,95,166,54,-209.14282199280302,168.13442552362596,459.2940404547831,0.5373267326732674,24399,24385,Blackford+Jay+Randolph,Randolph,18,135,Indiana,IN
18137,18CS013,204,262,330,332,2,70,128,43,-170.15144746891073,112.05095321123392,352.75300085018085,0.581081081081081,246,322,417,421,4,99,175,74,-240.82896771099954,86.01034561107126,347.4817962687279,0.7115384615384616,28915,29066,Dearborn+Ohio+Ripley+Switzerland,Ripley,18,137,Indiana,IN
18139,18CS029,129,168,220,183,-37,15,54,17,-387.6472340377801,-14.357304964362227,265.6101418407012,0.4928571428571429,153,203,267,220,-47,17,67,21,-407.612767870523,-23.97722163944253,275.7380488535891,0.4666666666666667,16716,16682,Henry+Rush,Rush,18,139,Indiana,IN
18141,18CS046,1886,2320,2892,2802,-90,482,916,372,-203.5321834423748,48.23977075095246,239.65694327413826,0.6895279323850753,2249,2832,3619,3115,-504,282,866,250,-277.0134525407783,11.937068692091348,226.34518712311663,0.4500453691101173,272389,272261,St. Joseph,St. Joseph,18,141,Indiana,IN
18143,18CS009,222,281,354,333,-21,52,111,38,-291.9914564547034,69.22744098841402,361.21889744311716,0.5984623015873016,266,344,441,437,-4,93,171,55,-242.68825492532764,156.0432095966574,476.5477493076864,0.5339805825242718,24268,24352,Clark+Scott,Scott,18,143,Indiana,IN
18145,18CS014,316,401,507,492,-15,91,176,62,-205.3782122760159,77.3502357922657,304.0664441489066,0.6138613861386139,377,489,622,541,-81,52,164,69,-333.39177280214784,-37.746654263313445,211.04820516046715,0.696969696969697,44990,45037,Decatur+Shelby,Shelby,18,145,Indiana,IN
18147,18CS017,131,170,219,195,-24,25,64,12,-217.26261262063596,78.45594344634075,313.823773785363,0.32432432432432434,160,207,273,281,8,74,121,43,-176.75688983626844,156.55610242640918,393.91535449225535,0.5584415584415584,19884,19801,Dubois+Pike+Spencer,Spencer,18,147,Indiana,IN
18149,18CS042,182,233,292,296,4,63,114,49,-231.6865295556749,72.0802536395433,334.9157499465921,0.7313432835820896,220,284,372,374,2,90,154,42,-171.16204766863027,205.3944572023563,479.46768603175025,0.4375,23307,23370,Marshall+Pulaski+Starke,Starke,18,149,Indiana,IN
18151,18CS015,214,274,348,306,-42,32,92,32,-257.342664097909,0,208.6562141334397,0.6037735849056604,257,335,422,395,-27,60,138,60,-251.41602126921742,0,225.55195931106218,0.7317073170731707,34507,34604,DeKalb+Steuben,Steuben,18,151,Indiana,IN
18153,18CS010,153,197,251,225,-26,28,72,28,-312.0056575099934,0,254.2268320451798,0.6666666666666666,185,238,315,274,-41,36,89,30,-341.92870666068694,28.8953836614665,284.13793933775395,0.5555555555555556,20769,20765,Clay+Sullivan+Vermillion+Vigo,Sullivan,18,153,Indiana,IN
18155,18CS013,66,80,98,90,-8,10,24,4,-143.61086743269837,75.85139459063686,245.4358697904869,0.278509673990287,76,95,118,116,-2,21,40,12,-143.143795611109,92.02101146428436,286.287591222218,0.5217391304347826,9890,9780,Dearborn+Ohio+Ripley+Switzerland,Switzerland,18,155,Indiana,IN
18157,18CS047,814,1008,1258,1164,-94,156,350,83,-113.25613955516829,46.37712577096696,170.8917124098458,0.4213197969543147,955,1216,1560,1497,-63,281,542,167,-123.21139934999991,60.97720653744298,200.68989379691754,0.531002931958346,187592,186955,Tippecanoe,Tippecanoe,18,157,Indiana,IN
18159,18CS030,131,152,175,186,11,34,55,36,-196.91619006279984,-16.419370937153573,150.8860585554242,1.0367374715459572,154,185,220,230,10,45,76,36,-169.14992674235947,58.551897718509046,260.23065652670687,0.782608695652174,15332,15371,Howard+Tipton,Tipton,18,159,Indiana,IN
18161,18CS019,49,63,79,94,15,31,45,2,221.20816874826423,485.51739181277543,722.0045913968115,0.0651584335010879,60,77,98,89,-9,12,29,19,-396.97894298449006,-99.24473574612252,142.4870848926467,1.1176470588235294,7092,7053,Fayette+Franklin+Union,Union,18,161,Indiana,IN
18163,18CS048,1359,1683,2093,2038,-55,355,679,247,-200.7155275485037,71.86234700891232,287.4493880356493,0.6229518102943796,1612,2058,2582,2334,-248,276,722,219,-259.45501530974855,31.38680733326366,279.4536890088192,0.5140845070422535,180345,180012,Vanderburgh,Vanderburgh,18,163,Indiana,IN
18165,18CS010,137,177,223,195,-28,18,58,26,-421.21213761155093,-62.344072171922434,249.37628868768974,0.7647058823529411,162,215,278,233,-45,18,71,27,-469.44673318881445,-58.64011934350215,286.68502790156606,0.6,15398,15348,Clay+Sullivan+Vermillion+Vigo,Vermillion,18,165,Indiana,IN
18167,18CS010,784,968,1207,1144,-63,176,360,138,-227.23775488093258,42.960371569529535,250.9790128535673,0.6650641025641025,918,1177,1503,1348,-155,171,430,128,-267.1329845121755,40.56760845496573,285.0110352150033,0.5203252032520326,106144,105996,Clay+Sullivan+Vermillion+Vigo,Vigo,18,167,Indiana,IN
18169,18CS022,307,384,482,434,-48,50,127,54,-396.10475417395924,-15.533519771527814,283.4867358303826,0.7012987012987013,366,472,599,530,-69,58,164,62,-424.95904497753554,-12.97584870160414,330.88414189090554,0.6391752577319587,30901,30826,Fulton+Miami+Wabash,Wabash,18,169,Indiana,IN
18171,18CS021,58,73,90,105,15,32,47,4,162.70106900004978,397.67287918081536,609.1475083435045,0.12567309895327172,71,90,113,98,-15,8,27,11,-307.1123076241614,-35.43603549509555,188.99218930717626,0.6875,8397,8466,Fountain+Montgomery+Warren,Warren,18,171,Indiana,IN
18173,18CS049,419,528,660,661,1,134,242,85,-157.8441021980535,91.1361780548285,295.1120982167178,0.5985915492957746,511,655,835,722,-113,67,211,73,-288.74469903997493,-9.311841947002685,214.24996346395338,0.5793650793650794,63860,64434,Warrick,Warrick,18,173,Indiana,IN
18175,18CS032,212,269,339,293,-46,24,81,19,-276.7447894145118,21.288060724193215,264.1848335872376,0.40425531914893614,248,324,418,397,-21,73,149,44,-231.1587126830562,103.13234873551738,373.41022818032155,0.5057471264367817,28185,28119,Jackson+Washington,Washington,18,175,Indiana,IN
18177,18CS050,610,758,948,935,-13,177,325,131,-260.4984337441283,83.15702950888205,350.88650929726083,0.6822916666666666,728,929,1177,1028,-149,99,300,113,-394.3219198459127,-21.066616591653418,281.46504524776935,0.6174863387978142,66380,66456,Wayne,Wayne,18,177,Indiana,IN
18179,18CS001,203,260,329,315,-14,55,112,46,-255.55590063489672,38.333385095234505,281.1114906983864,0.7244543650793651,239,317,406,363,-43,46,124,54,-344.04025625678884,-28.374454124271242,248.45381392564988,0.7605633802816901,28174,28194,Adams+Wells,Wells,18,179,Indiana,IN
18181,18CS008,197,254,324,279,-45,25,82,31,-371.375039210533,-29.2998058548744,249.04834976643235,0.613921568627451,233,311,401,516,115,205,283,52,255.59040623153751,620.7195579908769,937.1648228489709,0.25365853658536586,24574,24649,Cass+White,White,18,181,Indiana,IN
18183,18CS031,214,276,351,305,-46,29,91,27,-255.67280107892367,7.004734276134895,224.15149683631665,0.4909090909090909,262,336,436,385,-51,49,123,40,-264.577362725975,26.15262234523641,241.18529496162463,0.5333333333333333,34263,34413,Huntington+Whitley,Whitley,18,183,Indiana,IN
19001,19CS002,68,85,103,98,-5,13,30,16,-335.4776959498497,-43.3141091923161,222.28915149635083,0.963443054885175,82,103,127,130,3,27,48,19,-212.43637973002876,106.21818986501438,385.04093826067714,0.6785714285714286,7429,7532,Audubon and Nearby Counties,Adair,19,1,Iowa,IA
19003,19CS031,25,35,46,40,-6,5,15,4,-327.64445575772004,47.959402543251315,369.9055668012266,0.45671053559543445,28,41,56,62,6,21,34,1,137.01758392327017,548.0703356930807,904.316053893583,0.047619047619047616,3677,3649,Taylor and Nearby Counties,Adams,19,3,Iowa,IA
19005,19CS001,136,159,184,169,-15,10,33,27,-361.52642934384284,-142.98442848493738,54.40834648439658,1.3372448387660092,165,198,231,169,-62,-29,4,20,-587.9585023191198,-351.3410562638643,-114.72361020860875,-0.625,13995,13947,Allamakee+Clayton+Winneshiek,Allamakee,19,5,Iowa,IA
19007,19CS020,118,141,165,180,15,39,62,40,-246.06658287927888,-13.738340715802003,210.57858275238237,1.0365346898841121,141,169,203,188,-15,19,47,16,-252.84149319214083,24.468531599239437,252.84149319214083,0.6153846153846154,12315,12261,Lucas and Nearby Counties,Appanoose,19,7,Iowa,IA
19009,19CS002,60,76,93,68,-25,-8,8,6,-658.2685805115226,-290.1154077596662,42.18436812086919,-0.4626487166105621,73,93,118,82,-36,-11,9,6,-744.6478436239528,-301.40507956207614,53.1891316874252,-0.3157894736842105,5641,5640,Audubon and Nearby Counties,Audubon,19,9,Iowa,IA
19011,19CS003,163,209,261,267,6,58,104,41,-164.36225244770125,79.8330940460263,295.85205440586225,0.6721311475409836,195,253,328,235,-93,-18,40,14,-417.2446174486622,-124.66692584833979,101.29187725177607,-0.2222222222222222,25553,25668,Benton+Iowa (county)+Keokuk+Washington,Benton,19,11,Iowa,IA
19013,19CS004,856,1056,1314,1302,-12,246,446,239,-230.31777114831903,5.957284172161058,189.76241351476102,0.9018867924528302,1018,1294,1633,1450,-183,156,432,141,-248.47220066343573,11.881286781685189,223.06157764325096,0.5351062910473556,130932,130457,Black Hawk,Black Hawk,19,13,Iowa,IA
19015,19CS005,200,254,319,284,-35,30,84,15,-225.6514997376563,69.81234023819708,310.7775146087483,0.3,234,308,405,334,-71,26,100,27,-366.97648306406336,-3.7427484249267047,273.2206350196494,0.39705882352941174,26643,26718,Boone+Carroll+Greene,Boone,19,15,Iowa,IA
19017,19CS006,154,196,250,272,22,76,118,44,-105.54203982979344,153.5156942978814,355.0050430638507,0.5714285714285714,181,239,307,254,-53,15,73,23,-303.40633958337315,-31.916511724746687,199.4781982796668,0.46938775510204084,25014,25065,Bremer+Butler+Grundy,Bremer,19,17,Iowa,IA
19019,19CS007,135,173,223,191,-32,18,56,22,-313.4166383687502,-23.21604728657409,197.33640193587976,0.6285714285714286,160,212,277,223,-54,11,63,20,-358.41172749003823,-43.590615505545195,208.26627408204925,0.4166666666666667,20675,20647,Buchanan+Delaware+Fayette,Buchanan,19,19,Iowa,IA
19021,19CS027,121,143,165,175,10,32,54,31,-123.69675859640843,7.8976921648624145,134.706890171178,0.9460457472746028,142,172,201,184,-17,12,42,14,-149.24130654344896,-9.628471389899932,134.79859945859906,0.6086956521739131,20617,20772,Pocahontas and Nearby Counties,Buena Vista,19,21,Iowa,IA
19023,19CS006,125,162,204,153,-51,-9,28,22,-611.8624251836599,-259.6541434728742,50.25564067216919,-0.5789473684210527,150,198,259,199,-60,1,49,21,-565.6385897419121,-139.57769025093452,195.75771057693532,0.35,14327,14329,Bremer+Butler+Grundy,Butler,19,23,Iowa,IA
19025,19CS027,93,112,133,111,-22,-1,18,8,-367.790364482401,-107.36380085405091,123.01354389410486,-0.3140090168270844,113,137,166,145,-21,8,32,10,-312.7910080993532,-20.180065038667948,221.98071542534743,0.45454545454545453,9850,9911,Pocahontas and Nearby Counties,Calhoun,19,25,Iowa,IA
19027,19CS005,157,201,260,239,-21,38,82,36,-331.78449368303825,11.641561181860991,267.7559071828028,0.7659574468085106,188,246,314,281,-33,35,93,10,-207.79513654677507,120.81112589928783,401.0929379856356,0.18867924528301888,20616,20693,Boone+Carroll+Greene,Carroll,19,27,Iowa,IA
19029,19CS002,132,170,220,205,-15,35,73,41,-514.6566083976335,-55.141779471175006,294.08949051293337,0.9534883720930233,156,208,269,203,-66,-5,47,25,-696.8974660884716,-229.74641739180382,168.86361678297544,-0.38170163170163174,13057,13058,Audubon and Nearby Counties,Cass,19,29,Iowa,IA
19031,19CS008,127,150,173,181,8,31,54,18,-67.96406281373599,81.41393484203128,230.79193249779857,0.5738219129977465,154,181,210,213,3,32,59,5,-10.856351248197676,146.56074185066862,293.12148370133724,0.15151515151515152,18493,18422,Cedar+Clinton+Jackson+Jones,Cedar,19,31,Iowa,IA
19033,19CS009,351,444,560,533,-27,88,182,67,-263.140373122396,60.18636193756929,321.92705222420784,0.6568627450980392,414,541,687,601,-86,60,187,63,-348.58880509391963,-7.01856654551516,290.10075054795993,0.5727272727272728,42867,42744,Cerro Gordo+Hancock+Winnebago,Cerro Gordo,19,33,Iowa,IA
19035,19CS032,119,141,164,152,-12,11,33,25,-388.54485500090965,-149.58243174645358,80.84561924891436,1.222139657292661,146,176,205,172,-33,-4,26,17,-434.3934602303239,-182.26299030642966,78.11271013132699,-0.5398185483870968,11560,11522,West Central Iowa,Cherokee,19,35,Iowa,IA
19037,19CS025,95,114,136,133,-3,19,38,11,-137.0345318124001,77.48583565810678,267.2538530358628,0.519173104791932,114,139,165,146,-19,7,32,13,-268.9278079407238,-50.423963988885724,159.6758859648048,0.6190476190476191,11957,11899,Mitchell and Nearby Counties,Chickasaw,19,37,Iowa,IA
19039,19CS020,81,99,117,100,-17,1,19,7,-294.30384963226464,-70.1268335576077,144.3698113683705,0.3456550138930203,99,122,147,159,12,37,60,22,-102.28718405513278,153.43077608269917,388.69129940950455,0.5789473684210527,9682,9776,Lucas and Nearby Counties,Clarke,19,39,Iowa,IA
19041,19CS026,133,156,181,187,6,31,54,16,-72.64398828704135,108.83180452322878,278.2092111461475,0.5061118679283971,158,192,224,198,-26,6,40,20,-280.0711847594597,-85.23905623113991,121.77008033019987,0.6666666666666666,16309,16424,Palo Alto and Nearby Counties,Clay,19,41,Iowa,IA
19043,19CS001,127,165,211,197,-14,32,70,43,-401.0716138284563,-77.33195008085924,189.81478656210905,1.1025641025641026,152,201,260,223,-37,22,71,16,-311.80673865349496,35.29887607398056,323.57303067815513,0.35555555555555557,17069,16998,Allamakee+Clayton+Winneshiek,Clayton,19,43,Iowa,IA
19045,19CS008,373,469,593,531,-62,62,158,71,-343.77439132704967,-23.254186561018013,224.9196600151797,0.7888888888888889,445,568,724,611,-113,43,166,47,-344.7315563101454,-8.610216829476002,256.15395067691105,0.42342342342342343,46443,46456,Cedar+Clinton+Jackson+Jones,Clinton,19,45,Iowa,IA
19047,19CS032,118,141,163,169,6,28,51,23,-122.14108506267279,39.38216883833432,200.90542273934142,0.7867437704553556,142,169,200,158,-42,-11,16,20,-381.987051460433,-190.9935257302165,-24.6443259006731,-0.8,16492,16231,West Central Iowa,Crawford,19,47,Iowa,IA
19049,19CS010,377,474,588,557,-31,83,180,63,-113.11103983331846,24.040603577751,140.75773394773202,0.6057692307692307,462,588,748,585,-163,-3,123,46,-202.39409337052868,-47.428553683194195,74.62737732600547,-0.17531505894651256,99831,103313,Dallas,Dallas,19,49,Iowa,IA
19051,19CS011,62,76,93,91,-2,15,29,20,-289.4682931368033,-72.02364182532926,123.18851396552037,1.235764864518686,74,94,118,82,-36,-12,8,3,-427.53426501011575,-169.69990032411766,54.74190333036054,-0.15789473684210525,9097,9134,Davis+Jefferson+Van Buren+Wapello,Davis,19,51,Iowa,IA
19053,19CS020,53,67,83,76,-7,9,23,4,-173.1235264999195,84.79268244415046,304.0214600466101,0.31509919861497554,63,81,100,99,-1,18,36,15,-209.0996463275513,39.20618368641587,275.0967221996841,0.75,7650,7652,Lucas and Nearby Counties,Decatur,19,53,Iowa,IA
19055,19CS007,132,153,178,187,9,34,55,32,-155.99439397458005,14.340865092446291,161.71912584927443,0.9168485427841851,161,189,222,189,-33,0,28,23,-320.2414904608411,-131.410424274743,28.853158373367226,0.6480158730158729,17405,17502,Buchanan+Delaware+Fayette,Delaware,19,55,Iowa,IA
19057,19CS012,312,392,495,434,-61,42,122,42,-318.329713348729,0,247.2463792999837,0.579337899543379,365,477,612,549,-63,72,184,63,-326.92810824952915,23.352007732109225,314.084503996869,0.6116504854368932,38828,38541,Des Moines+Henry+Lee,Des Moines,19,57,Iowa,IA
19059,19CS026,140,179,230,197,-33,18,57,28,-413.7653280764788,-67.83038165188177,196.7081067904571,0.76726726726726735,165,218,287,217,-70,-1,52,27,-543.848993131804,-156.98733822361353,140.16726627108352,-0.2621359223300971,17691,17836,Palo Alto and Nearby Counties,Dickinson,19,59,Iowa,IA
19061,19CS013,635,786,976,867,-109,81,232,151,-315.4871101873729,-84.92250610696445,98.26747135234457,1.0785714285714285,748,962,1224,1052,-172,90,304,100,-275.32448580684985,-9.616112555753947,206.54397547385182,0.5076142131979695,98914,98793,Dubuque,Dubuque,19,61,Iowa,IA
19063,19CS026,87,105,125,132,7,27,45,32,-321.63078719589987,-67.44218490643061,165.5640338589162,1.1599711791921068,103,129,156,131,-25,2,28,14,-418.874375677397,-128.71939841558935,150.17263148485424,0.56,9315,9323,Palo Alto and Nearby Counties,Emmet,19,63,Iowa,IA
19065,19CS007,160,205,261,250,-11,45,90,26,-228.74831352858652,117.46535019035524,395.67275853593344,0.49056603773584906,190,249,325,273,-52,24,83,30,-425.3429165167268,-31.122652428053183,274.9167631144698,0.5769230769230769,19410,19279,Buchanan+Delaware+Fayette,Fayette,19,65,Iowa,IA
19067,19CS025,115,136,158,202,44,66,87,30,109.15601899283374,280.43139821610356,439.0197123117239,0.4521805840388714,132,160,188,199,11,39,67,17,-39.201022682327256,142.549173390281,323.97539406882044,0.430448717948718,15553,15433,Mitchell and Nearby Counties,Floyd,19,67,Iowa,IA
19069,19CS014,83,102,121,135,14,33,52,18,-46.30021687958577,180.744805408463,407.7898276965118,0.544574254865676,100,124,151,168,17,44,68,16,10.043669035996091,281.22273300789055,522.2707898717968,0.36363636363636365,9994,9957,Franklin+Hamilton+Hardin+Wright,Franklin,19,69,Iowa,IA
19071,19CS015,61,76,94,70,-24,-6,9,5,-521.2652066188796,-207.96044076468257,75.505775960543275,-0.3607673752313559,73,93,116,97,-19,4,24,12,-472.1306481960357,-121.8401672763963,182.76025091459445,0.7058823529411765,6613,6566,Fremont+Harrison+Mills+Pottawattamie,Fremont,19,71,Iowa,IA
19073,19CS005,80,97,115,85,-30,-12,5,3,-453.30123612871665,-205.60526846891065,30.831791569995197,-0.1960482499201759,94,116,141,130,-11,14,36,10,-240.79174619403324,45.86509451314919,298.1231143354697,0.47619047619047616,8763,8721,Boone+Carroll+Greene,Greene,19,73,Iowa,IA
19075,19CS006,108,130,150,142,-8,12,34,26,-336.04323864278246,-135.57170772058285,80.93754567539285,1.3920543357448174,135,161,192,147,-45,-14,12,4,-397.0216623256489,-145.84469228289143,64.81986323684063,-0.15384615384615385,12303,12342,Bremer+Butler+Grundy,Grundy,19,75,Iowa,IA
19077,19CS002,86,104,125,133,8,29,47,20,-135.14091787333638,106.25558530456668,310.5141649166385,0.680062937175919,102,126,152,127,-25,1,25,14,-368.84446467309385,-122.9481548910313,104.03305413856494,0.4827586206896552,10626,10574,Audubon and Nearby Counties,Guthrie,19,77,Iowa,IA
19079,19CS014,136,159,183,176,-7,17,40,33,-317.0255034805796,-132.20997423616376,52.27611556218364,1.5394868153858603,167,197,232,193,-39,-4,26,22,-409.22031510523306,-174.42177365141083,27.16954551108484,-0.6470588235294118,14974,14906,Franklin+Hamilton+Hardin+Wright,Hamilton,19,79,Iowa,IA
19081,19CS009,79,97,118,120,2,23,41,20,-196.4012813591649,33.38563364775566,235.59811885384568,0.8400397610112844,96,118,143,154,11,36,58,16,-46.830913085727886,187.32365234291154,393.3796699201142,0.4444444444444444,10734,10677,Cerro Gordo+Hancock+Winnebago,Hancock,19,81,Iowa,IA
19083,19CS014,142,182,233,215,-18,33,73,28,-328.42521744411897,35.69839320044772,321.28553880402944,0.6511627906976745,168,220,288,280,-8,60,112,15,-137.522967207499,269.06667497119366,579.9881660490174,0.23076923076923078,16807,16724,Franklin+Hamilton+Hardin+Wright,Hardin,19,83,Iowa,IA
19085,19CS015,136,159,183,235,52,76,99,61,-77.3774421521116,126.96609798063206,317.6867354378596,0.7992142824779116,165,197,229,193,-36,-4,28,20,-382.22483864224864,-163.81064513239227,54.60354837746409,-0.625,14484,14651,Fremont+Harrison+Mills+Pottawattamie,Harrison,19,85,Iowa,IA
19087,19CS012,144,188,240,246,6,58,102,35,-171.21560620410574,138.74368088953395,395.8622895167338,0.5737704918032787,171,227,297,250,-47,23,79,23,-343.29466840902336,0,274.88094520465347,0.46938775510204084,20325,20391,Des Moines+Henry+Lee,Henry,19,87,Iowa,IA
19089,19CS025,90,109,128,99,-29,-10,9,15,-563.3108983058473,-311.8651166429719,-81.8523433962666,-0.9316154742521281,111,136,166,134,-32,-2,23,6,-400.8729536029116,-84.3943060216656,179.33790029603938,-0.16904761904761906,9436,9479,Mitchell and Nearby Counties,Howard,19,89,Iowa,IA
19091,19CS027,83,99,120,106,-14,7,23,20,-426.08756686358106,-168.76515891699194,37.09276744027936,1.3567324846277642,99,123,149,129,-20,6,30,10,-312.1003810376948,-41.54414389852843,208.2400212913733,0.47619047619047616,9585,9628,Pocahontas and Nearby Counties,Humboldt,19,91,Iowa,IA
19093,19CS032,73,91,110,117,7,26,44,31,-415.81370375689994,-90.4760487113863,220.71649089736582,1.1670170841891927,90,113,138,96,-42,-17,6,6,-689.3147242292331,-330.2966386931742,0.7180361710714647,-0.2727272727272727,6975,6963,West Central Iowa,Ida,19,93,Iowa,IA
19095,19CS003,131,170,214,195,-19,25,64,22,-296.93107925847596,21.700200676624313,303.80280947274036,0.6111111111111112,156,206,270,214,-56,8,58,14,-422.3903040170041,-36.179041029293714,265.31296754815395,0.30434782608695654,16590,16584,Benton+Iowa (county)+Keokuk+Washington,Iowa (county),19,95,Iowa,IA
19097,19CS008,149,193,247,223,-24,30,74,32,-346.33022848174795,-12.357902889625263,259.5159606821305,0.8205128205128205,177,233,302,269,-33,36,92,27,-309.6284780792713,46.4442717118907,335.43085125254396,0.5192307692307693,19421,19378,Cedar+Clinton+Jackson+Jones,Jackson,19,97,Iowa,IA
19099,19CS016,261,335,421,388,-33,53,127,58,-289.60892076806914,-15.912578064179625,219.75270306632046,0.834575569358178,317,408,527,448,-79,40,131,29,-285.944693089339,29.123996518358602,270.05887680659794,0.3515280634734058,37706,37770,Jasper+Poweshiek,Jasper,19,99,Iowa,IA
19101,19CS011,113,133,156,178,22,45,65,25,-24.02626190487811,148.35172832303542,302.26064816938685,0.5578909315295353,134,162,190,183,-7,21,49,15,-140.58630881060787,38.34172058471124,217.589264318236,0.5555555555555556,16025,15649,Davis+Jefferson+Van Buren+Wapello,Jefferson,19,101,Iowa,IA
19103,19CS017,509,637,791,727,-64,90,218,53,-91.78659551224165,29.001742390716828,129.33209444508856,0.42570967741935484,616,778,984,906,-78,128,290,59,-88.7108127832896,44.986512137458064,149.55587955913214,0.34705882352941175,153094,154491,Johnson,Johnson,19,103,Iowa,IA
19105,19CS008,146,169,194,210,16,41,64,48,-186.0121113786602,-37.98847135167738,95.71030028559736,1.157765946514607,174,206,237,242,5,36,68,14,-43.30679455537356,105.8610533575798,260.0813606353265,0.3684210526315789,20662,20782,Cedar+Clinton+Jackson+Jones,Jones,19,105,Iowa,IA
19107,19CS003,87,104,125,128,3,24,41,26,-275.1816300177785,-19.062337369656696,178.44504023014443,1.0304704885547036,104,128,154,156,2,28,52,18,-161.1958718744687,100.74741992154294,342.541227733246,0.6206896551724138,10015,9926,Benton+Iowa (county)+Keokuk+Washington,Keokuk,19,107,Iowa,IA
19109,19CS026,116,152,195,175,-20,23,59,44,-520.8463923289343,-170.7693089603063,121.97807782879022,1.2941176470588236,138,182,239,219,-20,37,81,30,-343.25384623085824,48.05553847232016,350.462177001706,0.6382978723404256,14757,14566,Palo Alto and Nearby Counties,Kossuth,19,109,Iowa,IA
19111,19CS012,288,360,450,439,-11,79,151,33,-157.79163355087144,164.77673424154565,422.68814435874754,0.375,337,435,568,509,-59,74,172,75,-403.0571304542285,-3.0067671052161775,291.80674756122994,0.7352941176470589,33500,33258,Des Moines+Henry+Lee,Lee,19,111,Iowa,IA
19113,19CS018,1227,1536,1902,1921,19,385,694,266,-129.07277650036056,62.172274452713644,223.61120559463393,0.6464165072165923,1463,1844,2343,2075,-268,232,612,177,-194.25476935610283,23.785407616058425,189.84683143092505,0.46825396825396826,229684,229132,Linn,Linn,19,113,Iowa,IA
19115,19CS019,77,94,114,111,-3,17,34,30,-368.95984620501264,-140.9083773770413,41.623836195845634,1.5856949912193283,94,115,143,122,-21,7,28,20,-381.60088776820413,-120.84802779504639,74.36801710464393,1.0526315789473684,10837,10757,Louisa+Muscatine,Louisa,19,115,Iowa,IA
19117,19CS020,76,93,111,98,-13,5,22,11,-334.6597760087224,-82.20476353030317,146.77937477211773,0.82591863564867,91,114,138,125,-13,11,34,12,-288.0586466705796,-11.49934717247823,252.985637794521,0.6666666666666666,8617,8696,Lucas and Nearby Counties,Lucas,19,117,Iowa,IA
19119,19CS021,74,90,107,112,5,22,38,35,-301.0382207723003,-127.09077731969748,30.290242946943174,1.5635050766054186,88,109,132,94,-38,-15,6,3,-341.7437963429246,-150.03386180908885,25.005643634848145,-0.15,11911,11997,Lyon+O'Brien+Osceola+Sioux,Lyon,19,119,Iowa,IA
19121,19CS022,109,129,152,122,-30,-7,13,10,-290.04149638979493,-123.52833915352875,19.197224191841972,-0.5628862981805287,131,159,192,180,-12,21,49,15,-161.4774741162205,35.81755433261822,202.96614121816995,0.5555555555555556,16590,16752,Madison+Warren,Madison,19,121,Iowa,IA
19123,19CS023,159,202,260,250,-10,48,91,38,-259.788339404896,54.12257070935333,287.12023761311923,0.7037037037037037,184,245,315,274,-41,29,90,34,-341.01365039095776,-22.719097294534162,254.4538896987826,0.623905723905724,22172,22008,Mahaska+Marion,Mahaska,19,123,Iowa,IA
19125,19CS023,229,292,370,329,-41,37,100,51,-331.0836801063048,-50.354932335559674,176.42210221851425,0.864406779661017,273,355,456,371,-85,16,98,45,-389.75945235950894,-86.87950898098201,158.9295845324514,0.6164383561643836,33363,33380,Mahaska+Marion,Marion,19,125,Iowa,IA
19127,19CS024,321,405,505,467,-38,62,146,60,-294.6540452512471,6.007218047935722,258.4605565124344,0.7058823529411765,380,487,634,531,-103,44,151,26,-323.571108438946,45.13196398218542,313.41641654295427,0.26,39952,39883,Marshall+Tama,Marshall,19,127,Iowa,IA
19129,19CS015,86,104,125,136,11,32,50,16,-41.059521142419,135.64831918994486,278.3738825353158,0.4936893729841177,102,123,149,156,7,33,54,15,-55.339386078685685,124.51361867704279,269.77950713359274,0.45454545454545453,14516,14456,Fremont+Harrison+Mills+Pottawattamie,Mills,19,129,Iowa,IA
19131,19CS025,101,121,141,129,-12,8,28,37,-560.5889081298906,-327.39240832235265,-103.52376850711592,2.1527224858374585,122,148,176,150,-26,2,28,6,-303.0607956529717,-37.88259945662146,208.35429701141805,0.245,10577,10559,Mitchell and Nearby Counties,Mitchell,19,131,Iowa,IA
19133,19CS032,99,120,140,154,14,34,55,17,-38.679178481415995,233.81045729943966,528.393847332797,0.4945858366284811,118,143,171,157,-14,14,39,22,-419.2591731115891,-93.03948363086585,198.2903994882823,1,8708,8598,West Central Iowa,Monona,19,133,Iowa,IA
19135,19CS020,67,83,100,101,1,18,34,16,-241.63667204893522,30.994277809315076,277.660375300113,0.8517454720513399,80,101,125,109,-16,8,29,17,-434.5301355304532,-118.32893251963932,157.77191002618576,1,7599,7606,Lucas and Nearby Counties,Monroe,19,135,Iowa,IA
19137,19CS031,113,134,155,169,14,35,56,30,-191.41751395710887,58.28436954039819,298.3823344418472,0.8574006664131663,138,165,195,159,-36,-6,21,15,-493.9995600820911,-203.41158356321398,58.117595303775424,-0.6,10273,10324,Taylor and Nearby Counties,Montgomery,19,137,Iowa,IA
19139,19CS019,281,354,444,431,-13,78,150,79,-256.80577464072053,-4.187050673490009,198.18706521186039,0.9186046511627907,328,425,547,486,-61,61,158,45,-247.9533372092287,37.426918824034516,264.3276141947438,0.47620380739081747,42990,42750,Louisa+Muscatine,Muscatine,19,139,Iowa,IA
19141,19CS021,132,171,220,220,0,49,88,50,-425.9151630234653,-8.518303260469306,323.6955238978336,0.9615384615384616,157,207,269,183,-86,-24,26,11,-691.4722284482694,-249.37174647799517,106.87360563342651,-0.24722222222222223,14087,14035,Lyon+O'Brien+Osceola+Sioux,O'Brien,19,141,Iowa,IA
19143,19CS021,48,61,75,71,-4,10,23,10,-269.45945196717435,3.1375170853222762,259.69937031120133,0.7435238219553189,56,73,94,91,-3,18,35,5,-129.79901433873485,210.92339830044415,486.74630377025574,0.25,6153,6163,Lyon+O'Brien+Osceola+Sioux,Osceola,19,143,Iowa,IA
19145,19CS031,141,165,189,189,-0,24,48,15,-119.36949704088224,69.17806666556422,257.72563037201087,0.5907358535097201,171,200,236,219,-17,19,48,18,-230.3461911297521,6.581319746564345,197.76865838425832,0.6428571428571429,15174,15195,Taylor and Nearby Counties,Page,19,145,Iowa,IA
19147,19CS026,95,114,135,119,-16,5,24,11,-360.0719535461905,-78.74145612030145,170.0429641523961,0.6613711039769621,113,139,170,139,-31,0,26,22,-594.5689491975422,-246.80220532728165,44.87312824132394,0.6470588235294118,8942,8914,Palo Alto and Nearby Counties,Palo Alto,19,147,Iowa,IA
19149,19CS032,163,211,270,262,-8,51,99,64,-337.63381024206655,-60.91935507490444,164.01364827858887,1.1428571428571428,199,257,333,250,-83,-7,51,19,-397.5907430220632,-101.3466599860161,124.73435075201984,-0.25675675675675674,25608,25655,West Central Iowa,Plymouth,19,149,Iowa,IA
19151,19CS027,68,85,102,95,-7,10,27,15,-375.6760609694119,-80.1364110831016,201.3299221419557,1.0115352800637232,83,104,128,112,-16,8,29,10,-367.5355387428989,-28.27196451868453,268.58366292750304,0.625,7010,7074,Pocahontas and Nearby Counties,Pocahontas,19,151,Iowa,IA
19153,19CS028,2532,3117,3861,3754,-107,637,1222,437,-132.44207660321757,48.68746497682844,191.12264376654005,0.6124740218668112,3056,3830,4878,4348,-530,518,1292,380,-183.33511265140487,27.808579408544595,183.84896683612794,0.48531289910600256,492940,496250,Polk,Polk,19,153,Iowa,IA
19155,19CS015,638,802,1004,994,-10,192,356,111,-155.40462714283004,103.9452914828178,314.4024248554366,0.5336538461538461,760,975,1238,1141,-97,166,381,117,-229.31962974602177,52.495500385681225,282.83290003713967,0.5318181818181819,93511,93341,Fremont+Harrison+Mills+Pottawattamie,Pottawattamie,19,155,Iowa,IA
19157,19CS016,142,184,237,194,-43,10,52,25,-438.47197531804,-96.72175926133235,174.42157253460238,0.6578947368421053,171,224,290,245,-45,21,74,25,-376.459199553627,-21.511954260207254,263.7903391157912,0.5208333333333334,18610,18594,Jasper+Poweshiek,Poweshiek,19,157,Iowa,IA
19159,19CS031,51,64,79,93,14,29,42,6,207.36411950934007,587.4594508376106,925.3219675738507,0.20781189456529425,61,78,99,87,-12,9,26,16,-603.578357404613,-150.89458935115326,215.5636990730761,1.0666666666666667,4672,4639,Taylor and Nearby Counties,Ringgold,19,159,Iowa,IA
19161,19CS027,99,118,139,128,-11,10,29,15,-318.649393462067,-66.19841051190555,176.1545331202492,0.8818503553015871,119,145,172,151,-21,6,32,12,-338.19488480236737,-61.48997905497589,204.96659684991963,0.5454545454545454,9770,9758,Pocahontas and Nearby Counties,Sac,19,161,Iowa,IA
19163,19CS029,1061,1306,1625,1594,-31,288,533,178,-143.89297529660354,75.388903325254,244.44593722037837,0.55625,1252,1583,2032,1826,-206,243,574,133,-194.61431223098288,63.139874193800665,253.19089551714063,0.39349112426035504,174296,174216,Scott,Scott,19,163,Iowa,IA
19165,19CS002,111,130,152,162,10,32,51,28,-186.0272358528435,37.92072207510021,236.51608099233326,0.8722679416431592,134,163,194,150,-44,-13,16,13,-484.7084751347741,-221.09509392112503,25.510972375514427,-0.52,11674,11760,Audubon and Nearby Counties,Shelby,19,165,Iowa,IA
19167,19CS021,169,215,269,279,10,64,110,63,-177.96442693507458,3.3578193761334827,157.8175106782737,0.9402985074626866,198,257,335,257,-78,0,59,13,-253.69537051226678,-36.22229342844007,128.3105086445895,0.12518518518518518,35737,35890,Lyon+O'Brien+Osceola+Sioux,Sioux,19,167,Iowa,IA
19169,19CS030,375,473,590,477,-113,4,102,35,-180.36585435472483,-37.753825016856645,81.6578699154915,0.29787773431841225,452,579,742,628,-114,49,176,26,-140.92017941319747,23.151172332168155,151.0362351496448,0.2222222222222222,98533,99347,Story,Story,19,169,Iowa,IA
19171,19CS024,136,177,225,222,-3,45,86,56,-415.8310441661416,-77.52782179368742,211.43951398278386,1.1428571428571428,160,212,280,216,-64,4,56,20,-497.4286450543801,-94.69194908828176,213.05688544863398,0.35714285714285715,17026,16897,Marshall+Tama,Tama,19,171,Iowa,IA
19173,19CS031,47,59,74,79,5,20,32,4,20.437735341030322,320.9487809145119,571.3746522257464,0.20196749368252498,55,71,90,105,15,34,50,11,68.17818653125721,392.02457255472893,664.7373186797578,0.3235294117647059,5909,5867,Taylor and Nearby Counties,Taylor,19,173,Iowa,IA
19175,19CS031,99,119,141,151,10,32,52,23,-124.76178515114442,87.1030553064004,282.67060034413424,0.7235392844594086,119,145,172,172,0,27,53,13,-108.0674798282697,116.38036289198274,332.51532254852214,0.4482758620689655,12107,12030,Taylor and Nearby Counties,Union,19,175,Iowa,IA
19177,19CS011,69,86,104,80,-24,-6,11,13,-611.1454957797195,-309.049599200877,-34.41696594738358,-0.8936364821666526,87,108,132,91,-41,-16,4,2,-594.1431988738914,-255.61974835272073,27.634567389483323,-0.09523809523809523,7185,7237,Davis+Jefferson+Van Buren+Wapello,Van Buren,19,177,Iowa,IA
19179,19CS011,279,356,452,456,4,100,177,95,-309.47950948092563,16.99503072382898,278.71850387079525,0.8878504672897196,335,432,564,469,-95,37,134,60,-439.4869580473074,-65.21419377476174,209.96134995743932,0.6857366771159874,35304,35268,Davis+Jefferson+Van Buren+Wapello,Wapello,19,179,Iowa,IA
19181,19CS022,301,380,479,423,-56,43,122,48,-237.75447754263217,-11.430503728011162,169.1714551745652,0.6575342465753424,364,468,594,534,-60,66,170,62,-228.9899027027534,7.507865662385358,202.71237288440466,0.62,52491,53277,Madison+Warren,Warren,19,181,Iowa,IA
19183,19CS003,164,209,269,263,-6,54,99,32,-203.2196876500031,117.65350337631759,358.5757909719131,0.5517241379310345,195,256,330,265,-65,9,70,34,-440.11899513572183,-111.14116038780854,160.0432709584443,0.5230769230769231,22439,22494,Benton+Iowa (county)+Keokuk+Washington,Washington,19,183,Iowa,IA
19185,19CS020,57,71,87,94,7,23,37,17,-188.25347048696142,116.30784100142876,374.53937692674697,0.7297684281330697,66,85,108,86,-22,1,20,2,-368.76862649692214,-15.365359437371756,276.57646987269163,0.09523809523809523,6495,6508,Lucas and Nearby Counties,Wayne,19,185,Iowa,IA
19187,19CS027,291,369,463,469,6,100,178,68,-201.99632003791956,104.25616518086171,358.38056780921215,0.6476190476190476,351,453,582,510,-72,57,159,47,-320.99589999466804,26.940486780920523,301.73345194630986,0.4895833333333333,36832,37119,Pocahontas and Nearby Counties,Webster,19,187,Iowa,IA
19189,19CS009,91,111,132,137,5,26,46,24,-219.07707363122088,22.734258006380504,246.40973977116138,0.8944597456034191,111,137,165,126,-39,-11,15,11,-469.25775155148347,-206.4734106826527,37.540620124118675,-0.4782608695652174,10608,10655,Cerro Gordo+Hancock+Winnebago,Winnebago,19,189,Iowa,IA
19191,19CS001,143,166,191,161,-30,-5,18,22,-310.26537193800925,-162.35840644187303,-24.311905312146006,-1.0224283199826631,173,205,240,202,-38,-3,29,16,-271.1895617128885,-95.4185494915719,65.2863759679176,-0.41025641025641024,20011,19912,Allamakee+Clayton+Winneshiek,Winneshiek,19,191,Iowa,IA
19193,19CS032,678,841,1047,1064,17,223,386,175,-180.2062254202387,54.642443589206934,240.36983258043824,0.7543103448275862,800,1020,1307,1084,-223,64,284,91,-297.28498488371406,-26.031960147435555,182.79169107162923,0.43855676328502413,105413,105639,West Central Iowa,Woodbury,19,193,Iowa,IA
19195,19CS025,51,65,81,59,-22,-6,8,3,-410.7659504612825,-144.7770483447774,81.31351845425208,-0.2478915331698659,60,78,97,99,2,21,39,5,-40.59082196414478,216.48438380877215,460.02931559364083,0.22727272727272727,7418,7391,Mitchell and Nearby Counties,Worth,19,195,Iowa,IA
19197,19CS014,127,150,174,161,-13,11,34,23,-331.7175279410965,-116.31908433129185,98.69540483357557,1.1740610986708784,157,186,218,189,-29,3,32,25,-422.13988997417755,-171.82382200614074,55.0617247792402,0.8333333333333334,12848,12804,Franklin+Hamilton+Hardin+Wright,Wright,19,197,Iowa,IA
20001,20CS001,109,130,151,129,-22,-1,20,6,-271.22957876455274,-66.18486115213918,130.97352116748945,-0.25530044971572596,127,153,182,199,17,46,72,27,-80.16259646649955,152.30893328634914,360.73168409924796,0.5869565217391305,12510,12475,Allen+Anderson+Franklin+Osage,Allen,20,1,Kansas,KS
20003,20CS001,71,88,104,90,-14,2,19,8,-342.63621317754814,-91.26677153014782,172.67114219962266,0.5268596798521147,86,106,130,103,-27,-3,17,21,-616.2932528728254,-308.1466264364127,-50.715798934326834,-0.84,7850,7788,Allen+Anderson+Franklin+Osage,Anderson,20,3,Kansas,KS
20005,20CS003,120,142,164,146,-18,4,26,6,-180.14330744683062,-16.458596685887567,147.2261140750556,0.2968683286351269,144,172,199,218,19,46,74,26,-43.38828670118239,123.08733815938272,295.40961158251855,0.5652173913043478,16274,16249,Brown and Nearby Counties,Atchison,20,5,Kansas,KS
20007,20CS023,39,51,64,66,2,15,27,5,-88.79830886470397,284.6633040066213,634.7835660734888,0.31548085458425235,46,62,79,66,-13,4,20,6,-460.84812224602825,-48.510328657476656,339.5723006023366,0.46153846153846156,4227,4123,South Central Kansas,Barber,20,7,Kansas,KS
20009,20CS005,189,242,308,306,-2,64,117,36,-179.00926615033572,131.90156453182632,381.57238310992614,0.5294117647058824,226,293,377,368,-9,75,142,50,-233.70405243817197,99.0271408636322,364.61793265989354,0.6097560975609756,25474,25246,Central Kansas,Barton,20,9,Kansas,KS
20011,20CS002,126,166,213,181,-32,15,55,17,-409.5800875349733,-16.717554593264218,318.0514761368513,0.4857142857142857,151,199,264,213,-51,14,62,34,-593.3906750400683,-139.6213353035455,195.4698694249637,0.7727272727272727,14356,14324,Bourbon+Linn+Miami,Bourbon,20,11,Kansas,KS
20013,20CS003,100,121,141,147,6,26,47,31,-322.12897973594175,-61.463079043504905,198.68253042998515,1.149594351630661,124,151,182,157,-25,6,33,11,-380.6452465603151,-52.86739535559932,232.616539564637,0.4583333333333333,9481,9458,Brown and Nearby Counties,Brown,20,13,Kansas,KS
20015,20CS004,444,554,697,638,-59,84,194,38,-172.8317882268918,82.8096666929466,277.90211800934014,0.3392857142857143,528,678,876,790,-86,112,262,101,-275.8124092237293,15.482653284411427,237.40068369430853,0.6711037527593819,67383,67818,Butler+Harvey,Butler,20,15,Kansas,KS
20017,20CS006,18,27,37,21,-16,-6,3,1,-795.3559642946584,-332.8850898231088,89.28749268204051,-0.12861296487080942,22,33,46,32,-14,-1,10,4,-696.0937123391127,-192.82374303022513,231.38849163627017,-0.2222222222222222,2571,2593,Chase+Coffey+Lyon+Marion,Chase,20,17,Kansas,KS
20019,20CS011,35,45,59,41,-18,-4,6,6,-864.0368796718799,-364.91124118765526,16.773070594399183,-0.6016045898405535,40,56,73,65,-8,9,25,10,-530.3965082229876,-29.466472679054863,441.99709018582297,0.7142857142857143,3360,3394,Elk and Nearby Counties,Chautauqua,20,19,Kansas,KS
20021,20CS007,177,229,289,271,-18,42,94,26,-272.75486285845886,99.18358649398506,421.53024259943646,0.5,218,280,361,312,-49,32,94,43,-480.6500916503038,-57.437816492703334,266.3026037388973,0.7227401129943503,19358,19151,Cherokee+Crawford,Cherokee,20,21,Kansas,KS
20023,20CS015,21,30,41,48,7,18,27,12,-233.75947200766913,255.40348808029958,706.9385281615012,0.6825770371532027,25,37,51,41,-10,4,16,6,-608.10971312741,-76.01371414092625,380.06857070463127,0.6,2622,2631,Northwest Kansas,Cheyenne,20,23,Kansas,KS
20025,20CS016,17,26,37,33,-4,7,16,5,-545.7469090361017,102.58783917042865,651.1787799605698,0.599845021270379,21,32,45,31,-14,-1,10,6,-1011.9323691866593,-354.1763292153308,202.3864738373319,-0.42857142857142855,1978,1976,Pawnee and Nearby Counties,Clark,20,25,Kansas,KS
20027,20CS008,67,83,101,90,-11,7,23,17,-417.002558286732,-148.82168522903098,82.78906877534727,1.2555384243930305,80,101,124,113,-11,12,33,10,-259.83332517058005,24.74603096862667,284.5793561392067,0.5555555555555556,8093,8082,Cloud and Nearby Counties,Clay,20,27,Kansas,KS
20029,20CS008,102,123,145,128,-17,5,26,21,-505.38271922200437,-207.79732364615796,68.29579336032143,1.3667081053662045,124,150,180,157,-23,6,33,17,-448.1494950625227,-117.49237698268385,179.03600302123255,0.7391304347826086,8951,8937,Cloud and Nearby Counties,Cloud,20,29,Kansas,KS
20031,20CS006,67,82,100,89,-11,7,22,1,-177.15214654507966,83.30251282196585,308.24062772986895,0.07483820985473659,81,100,122,111,-11,11,30,15,-311.65095093495285,-47.946300143838904,179.79862553939589,0.8333333333333334,8333,8343,Chase+Coffey+Lyon+Marion,Coffey,20,31,Kansas,KS
20033,20CS016,16,25,35,29,-6,4,13,6,-822.0243817324081,-118.66720917826451,467.4637679501887,0.7869793542958822,20,30,42,32,-10,2,12,1,-658.0505253187432,59.82277502897666,658.0505253187432,0.1111111111111111,1683,1672,Pawnee and Nearby Counties,Comanche,20,33,Kansas,KS
20035,20CS011,287,368,461,429,-32,61,142,63,-330.0568913852256,-6.948566134425802,274.4683623098192,0.7974683544303798,347,448,575,504,-71,56,157,64,-391.34641283906126,-24.640329697274225,269.5941955113533,0.6632302405498282,34540,34496,Elk and Nearby Counties,Cowley,20,35,Kansas,KS
20037,20CS007,287,364,455,484,29,120,197,53,-74.15178934656839,206.57671044574147,443.98576573413095,0.4291568318908996,343,443,569,518,-51,75,175,63,-291.6813253590047,30.70329740621102,286.6920395304953,0.6176470588235294,38920,39084,Cherokee+Crawford,Crawford,20,37,Kansas,KS
20039,20CS015,27,38,50,35,-15,-3,8,7,-963.4510319585975,-427.0675624599577,37.79811110552991,-0.6850471346945579,32,46,61,58,-3,12,26,10,-472.6055409970159,72.70854476877167,581.6683581501734,0.7142857142857143,2759,2751,Northwest Kansas,Decatur,20,39,Kansas,KS
20041,20CS009,150,196,254,203,-51,7,53,23,-483.44618734900814,-104.52890537275852,196.31835040321178,0.5111111111111111,182,240,312,285,-27,45,103,47,-401.4955551288278,-10.843904257361993,303.6293192061358,0.8245614035087719,18368,18444,Dickinson+Geary+Morris,Dickinson,20,41,Kansas,KS
20043,20CS003,63,78,95,92,-3,14,29,10,-214.31188729749869,62.4480526703971,299.67085835716495,0.6111663188652194,78,98,121,111,-10,13,33,17,-361.4115127414291,-53.54244633206356,214.83906590740443,0.9444444444444444,7486,7471,Brown and Nearby Counties,Doniphan,20,43,Kansas,KS
20045,20CS010,485,609,761,729,-32,120,244,53,-85.49525811683834,67.3507618321948,191.99993298431656,0.38686131386861317,582,743,953,849,-104,106,267,40,-120.72137307986735,55.330629328272536,190.471499748235,0.25316455696202533,119375,119283,Douglas,Douglas,20,45,Kansas,KS
20047,20CS016,30,41,53,69,16,28,39,11,190.38240416502612,705.2357353421336,1151.441955695627,0.39437156789871225,37,52,69,59,-10,7,22,6,-563.0581093564422,35.191131834777636,563.0581093564422,0.5,2874,2842,Pawnee and Nearby Counties,Edwards,20,47,Kansas,KS
20049,20CS011,25,35,46,36,-10,1,11,7,-827.8192560711586,-307.8585871262203,172.25835239764788,0.4786623213411927,30,43,58,50,-8,7,20,5,-531.4890210040372,81.76754169292882,613.2565626969661,0.45454545454545453,2476,2446,Elk and Nearby Counties,Elk,20,49,Kansas,KS
20051,20CS005,159,203,263,259,-4,56,100,57,-253.50100647172138,-4.155754204454449,178.6974307915413,0.95,187,245,321,235,-86,-10,48,18,-360.9787209118184,-97.18657870702803,104.12847718610146,-0.2571428571428571,28876,28811,Central Kansas,Ellis,20,51,Kansas,KS
20053,20CS005,53,67,83,92,9,25,39,17,-152.7484889145391,159.75413364500037,425.381362820609,0.6481631674330643,62,80,103,83,-20,3,21,6,-410.183596600209,-47.328876530793345,236.64438265396674,0.35294117647058826,6314,6339,Central Kansas,Ellsworth,20,53,Kansas,KS
20055,20CS020,156,201,257,275,18,74,119,59,-129.65404094130344,47.37662884578688,189.50651538314753,0.7866666666666666,187,244,320,325,5,81,138,45,-104.8913227560632,94.4021904804569,243.87232540784697,0.5357142857142857,37993,38135,Scott and Nearby Counties,Finney,20,55,Kansas,KS
20057,20CS016,165,213,269,253,-16,40,88,41,-200.7296257779098,-3.521572382068593,165.5139019572239,0.8541666666666666,199,258,332,276,-56,18,77,56,-327.8126735940672,-112.68560654796059,61.464876298887596,0.9655172413793104,34076,34166,Pawnee and Nearby Counties,Ford,20,57,Kansas,KS
20059,20CS001,181,233,297,269,-28,36,88,21,-226.6999608429675,69.32720515075458,309.6615163400371,0.42,216,282,369,338,-31,56,122,40,-273.15965893515823,61.5571062389089,315.6725354314046,0.5633802816901409,25964,25992,Allen+Anderson+Franklin+Osage,Franklin,20,59,Kansas,KS
20061,20CS009,149,194,245,214,-31,20,65,26,-190.33122387063815,-20.01730662969025,130.11249309298665,0.65,177,236,306,273,-33,37,96,40,-202.48213979242112,-8.3211838270858,155.32876477226827,0.7142857142857143,35969,36053,Dickinson+Geary+Morris,Geary,20,61,Kansas,KS
20063,20CS015,20,29,39,47,8,18,27,20,-518.1245536089316,-79.01410652175818,323.5038033081508,1.0974097010011212,24,36,51,44,-7,8,20,7,-509.81314437877904,36.415224598484215,473.39791978029484,0.5833333333333334,2696,2746,Northwest Kansas,Gove,20,63,Kansas,KS
20065,20CS015,21,30,40,28,-12,-2,7,1,-661.586660101581,-170.2880235039385,321.0106130937035,-0.11115099650656021,26,37,52,40,-12,3,14,8,-833.0802273614787,-208.27005684036968,249.92406820844363,0.8888888888888888,2410,2401,Northwest Kansas,Graham,20,65,Kansas,KS
20067,20CS024,39,53,67,60,-7,7,21,16,-384.9876194887113,-141.68229929196414,74.58909643847777,1.392136821688383,49,66,86,59,-27,-7,10,16,-587.0757993361265,-314.0172880169979,-81.91755339573858,-1,7299,7324,Southwest Kansas,Grant,20,67,Kansas,KS
20069,20CS024,33,44,58,55,-3,11,22,10,-282.16957205445544,12.742042285047724,255.61043056463873,0.8164480728833697,40,56,73,66,-7,10,26,11,-319.013421455868,-17.72296785865933,265.84451787988996,0.7333333333333333,5687,5642,Southwest Kansas,Gray,20,69,Kansas,KS
20071,20CS020,16,25,35,24,-11,-1,8,6,-1561.6893486474792,-629.6248667084699,224.7675750689557,-0.3880174568809669,22,33,47,27,-20,-6,5,7,-2076.8232296524207,-999.9519253882025,-153.83875775203114,-0.6363636363636364,1270,1300,Scott and Nearby Counties,Greeley,20,71,Kansas,KS
20073,20CS011,67,83,101,87,-14,4,20,6,-404.32361278307053,-40.9295216424967,272.91082979708995,0.3877744919696567,81,102,125,124,-1,22,43,13,-235.53905847467428,151.4179661622906,504.72655387430206,0.5416666666666666,5973,5944,Elk and Nearby Counties,Greenwood,20,73,Kansas,KS
20075,20CS020,12,18,25,20,-5,2,8,4,-456.0858125429669,-100.35060442417269,215.8584694591998,0.6640721062495406,13,21,31,27,-4,6,14,2,-241.4041675747263,160.9361117164842,482.8083351494526,0.25,2496,2485,Scott and Nearby Counties,Hamilton,20,75,Kansas,KS
20077,20CS023,62,76,95,94,-1,18,32,14,-320.62010335126615,78.02117758181342,404.1822256179696,0.7297630708129874,73,93,114,78,-36,-15,5,4,-748.6039610900395,-355.14295282673544,18.691734359301865,-0.21052631578947367,5445,5350,South Central Kansas,Harper,20,77,Kansas,KS
20079,20CS004,268,343,429,380,-49,37,112,40,-314.27659364581996,-10.587644929112408,254.1034782986978,0.5970149253731343,325,419,535,512,-23,93,187,61,-248.40972580969913,94.57598127198538,372.54070122917983,0.5570892410341952,34002,33835,Butler+Harvey,Harvey,20,79,Kansas,KS
20081,20CS024,17,25,35,25,-10,-0,8,2,-392.08786550739694,-78.9308412914905,182.03334555509832,-0.15601937293630438,20,31,45,35,-10,4,15,3,-353.18089200815035,27.167760923703874,326.01313108444646,0.3333333333333333,3781,3681,Southwest Kansas,Haskell,20,81,Kansas,KS
20083,20CS016,19,28,38,20,-18,-8,1,4,-1518.95701379198,-832.1341201222541,-199.68470553471712,-0.455826643407491,25,37,54,41,-13,4,16,2,-876.5949157494886,116.87932209993181,818.1552546995227,0.17424242424242425,1724,1711,Pawnee and Nearby Counties,Hodgman,20,83,Kansas,KS
20085,20CS003,99,118,140,125,-15,7,26,12,-242.8890963979752,-41.448744866679625,130.14859162294255,0.7283259291188462,119,146,173,157,-16,11,38,14,-226.3044328952352,-22.630443289523523,181.04354631618818,0.6086956521739131,13224,13256,Brown and Nearby Counties,Jackson,20,85,Kansas,KS
20087,20CS003,124,146,171,180,9,34,56,23,-91.16508994838219,69.36145607748051,213.8353475007569,0.6670655603923503,149,177,210,204,-6,27,55,27,-179.39840376193018,0,152.216827434365,0.9,18438,18395,Brown and Nearby Counties,Jefferson,20,87,Kansas,KS
20089,20CS008,22,32,44,31,-13,-1,9,3,-640.6342396853181,-167.16688958453227,238.66226764471253,-0.27448213262283494,27,39,54,59,5,20,32,11,-206.1050823639627,306.6026018637463,715.4060710154081,0.55,2917,2935,Cloud and Nearby Counties,Jewell,20,89,Kansas,KS
20091,20CS012,2887,3566,4439,3992,-447,426,1105,479,-182.30011200358695,-10.332799870648651,123.25554131416601,0.7363570837764386,3498,4418,5617,4825,-792,407,1327,420,-197.8125241898629,-2.1213139323309695,148.02691797800298,0.4861111111111111,609709,612828,Johnson,Johnson,20,91,Kansas,KS
20093,20CS020,18,25,35,29,-6,4,11,3,-284.93718668306246,15.639558262137289,241.0721169710372,0.44105078832537403,20,30,43,48,5,18,28,2,76.87051588657329,409.97608472839084,666.2111376836351,0.1111111111111111,3939,3903,Scott and Nearby Counties,Kearny,20,93,Kansas,KS
20095,20CS023,150,177,203,212,9,35,62,31,-358.7105660794085,68.87225296410085,497.12317016236466,0.8596830155812993,201,237,279,265,-14,28,64,35,-662.8490346120711,-94.59619250325174,392.5741988884941,0.9861111111111112,7384,7400,South Central Kansas,Kingman,20,95,Kansas,KS
20097,20CS016,18,27,38,29,-9,2,11,2,-530.2580313825042,-6.418869217538576,436.8296526143556,0.23679179389694655,22,34,48,37,-11,3,15,4,-624.8047485160887,-41.653649901072576,458.19014891179836,0.4444444444444444,2448,2401,Pawnee and Nearby Counties,Kiowa,20,97,Kansas,KS
20099,20CS013,177,227,290,241,-49,14,64,28,-461.14879618038367,-83.84523566916066,215.90148184808842,0.6363636363636364,209,276,355,303,-52,27,94,39,-456.8204967484134,-60.17394029616861,275.79722635743946,0.6724137931034483,20037,19942,Labette+Montgomery+Neosho,Labette,20,99,Kansas,KS
20101,20CS020,18,28,39,26,-13,-2,8,3,-1201.843213638194,-380.5920995276966,377.4858519589165,-0.32077089256260743,24,35,51,33,-18,-2,9,4,-1405.3579270970574,-383.2794346628338,319.39952888569485,-0.26666666666666666,1562,1565,Scott and Nearby Counties,Lane,20,101,Kansas,KS
20103,20CS014,434,541,683,669,-14,128,235,62,-111.49000525737883,96.69304003925102,253.45296858773372,0.4492753623188406,508,661,832,793,-39,132,285,88,-154.61744610329035,53.56824904365965,239.90053350120752,0.5552105724066555,81909,82138,Leavenworth,Leavenworth,20,103,Kansas,KS
20105,20CS008,20,28,39,39,0,11,19,1,-26.122676811901076,409.39517551699487,744.408908077684,0.09052325975222159,23,34,46,40,-6,6,17,7,-446.82496491278323,-34.37115114713717,343.71151147137175,0.7777777777777778,2945,2909,Cloud and Nearby Counties,Lincoln,20,105,Kansas,KS
20107,20CS002,75,92,111,122,11,30,47,4,87.45314826652549,323.3683115966474,538.7691128980631,0.1336936416127396,90,112,136,166,30,54,76,24,61.70974564014219,303.40624939736574,534.817795547899,0.44863731656184486,9618,9723,Bourbon+Linn+Miami,Linn,20,107,Kansas,KS
20109,20CS015,20,29,40,39,-1,10,19,1,-99.88424170247788,403.1752668532755,798.4363092899387,0.09052325975222159,24,35,49,50,1,15,26,2,-36.69640604573289,477.0532785945276,882.5485653998744,0.125,2746,2725,Northwest Kansas,Logan,20,109,Kansas,KS
20111,20CS006,188,237,300,323,23,86,135,68,-167.42477189020758,66.96990875608303,249.27688259208685,0.7816091954022989,219,286,373,320,-53,34,101,30,-259.2706840607099,12.494972725817346,221.94195304233048,0.47619047619047616,32253,32013,Chase+Coffey+Lyon+Marion,Lyon,20,111,Kansas,KS
20113,20CS005,258,325,410,356,-54,31,98,48,-409.17235263243623,-68.16197937042054,200.4764099130016,0.7741935483870968,306,393,508,422,-86,29,116,46,-437.83938426072444,-56.388405548729665,232.35340051108886,0.5443977591036415,29929,30148,Central Kansas,McPherson,20,113,Kansas,KS
20115,20CS006,124,144,167,133,-34,-11,9,10,-447.891368385161,-213.00829890656692,-11.67995363920055,-0.5236195884206131,149,179,209,222,13,43,73,29,-136.5406154994933,119.47303856205664,375.4866926236066,0.6744186046511628,11761,11718,Chase+Coffey+Lyon+Marion,Marion,20,115,Kansas,KS
20117,20CS003,102,121,142,123,-19,2,21,24,-520.6979078819054,-263.24081131890665,-35.4903028208694,1.2365370252806789,121,150,176,132,-44,-18,11,14,-580.9234261962245,-320.50947652205485,-30.047763423942644,-0.5833333333333334,9963,9984,Brown and Nearby Counties,Marshall,20,117,Kansas,KS
20119,20CS024,31,43,54,56,2,13,25,6,-127.83211199693488,215.3245686297743,557.2600511047873,0.4264293268808933,38,52,69,58,-11,6,20,5,-398.7226796813945,24.842534559588444,372.63801839382666,0.4166666666666667,4039,4025,Southwest Kansas,Meade,20,119,Kansas,KS
20121,20CS002,197,254,323,292,-31,38,95,23,-189.2821651581824,52.57837921060622,252.37622021090988,0.45098039215686275,237,311,399,419,20,108,182,61,-118.72629847839698,136.10087874352826,350.5321568490232,0.5495495495495496,34235,34533,Bourbon+Linn+Miami,Miami,20,121,Kansas,KS
20123,20CS008,56,69,86,76,-10,7,20,7,-358.9637705582848,-1.2563290039542536,272.1343584697118,0.5514235975762072,65,84,106,97,-9,13,32,12,-366.06573531969156,17.39029621471219,347.8059242942438,0.7058823529411765,5792,5750,Cloud and Nearby Counties,Mitchell,20,123,Kansas,KS
20125,20CS013,282,356,447,412,-35,56,130,41,-290.42427845064594,57.3205812731538,340.1021155540459,0.5466666666666666,331,426,559,544,-15,118,213,79,-301.5800485798802,123.45382105609133,429.8437587680269,0.6147953003875969,31402,31186,Labette+Montgomery+Neosho,Montgomery,20,125,Kansas,KS
20127,20CS009,49,63,78,77,-1,14,28,14,-335.7792080235283,-6.7933720020184385,303.9154731294074,0.9127230769716302,59,77,98,75,-23,-2,16,5,-522.7212619984754,-130.68031549961884,205.35478149940104,-0.22233201581027667,5398,5357,Dickinson+Geary+Morris,Morris,20,127,Kansas,KS
20129,20CS024,25,35,48,36,-12,1,11,1,-569.7799594755924,-15.832432733637383,427.3255886599263,0.08225282711638868,31,45,61,44,-17,-1,13,6,-854.2445274959957,-259.9874648900857,259.9874648900857,-0.3157894736842105,2672,2692,Southwest Kansas,Morton,20,129,Kansas,KS
20131,20CS003,95,113,133,158,25,45,63,42,-202.48554679059652,39.550952065028376,242.45580140507323,0.9258159594693457,113,139,167,123,-44,-16,10,5,-479.6260874175643,-205.55403746467042,48.941437491588196,-0.21739130434782608,10211,10216,Brown and Nearby Counties,Nemaha,20,131,Kansas,KS
20133,20CS013,132,172,223,192,-31,20,60,17,-362.38903081119406,22.64931442569963,324.6401734350281,0.5,160,209,270,241,-29,32,81,39,-430.6354456847465,-44.29754768248679,265.7852860949207,0.8125,15895,15802,Labette+Montgomery+Neosho,Neosho,20,133,Kansas,KS
20135,20CS016,30,41,53,55,2,14,25,14,-554.410563746735,-4.792024501177514,508.18527879467644,0.9514341950590404,38,52,69,53,-16,1,15,6,-823.0837581256138,-187.06449048309406,336.7160828695693,0.42857142857142855,2693,2673,Pawnee and Nearby Counties,Ness,20,135,Kansas,KS
20137,20CS015,47,61,77,76,-1,15,29,22,-515.8405916033624,-151.52826678537127,158.13720930992122,1.3764610412961467,58,76,97,56,-41,-20,-2,5,-858.9200480808505,-466.80437395698397,-130.7052247079555,-0.22727272727272727,5416,5356,Northwest Kansas,Norton,20,137,Kansas,KS
20139,20CS001,137,160,187,230,43,70,93,23,155.16358173023252,355.54648852454557,530.8815319695692,0.33007723423326574,167,198,232,232,0,34,65,23,-145.9244259512845,69.7899428462665,266.470690867563,0.6388888888888888,15755,15762,Allen+Anderson+Franklin+Osage,Osage,20,139,Kansas,KS
20141,20CS008,39,50,64,48,-16,-2,9,2,-623.9736828953424,-142.8874364366501,253.30123711756735,-0.15577375076756492,45,62,81,59,-22,-3,14,7,-830.6130715528126,-285.9253258357359,200.14772808501513,-0.3888888888888889,3486,3497,Cloud and Nearby Counties,Osborne,20,141,Kansas,KS
20143,20CS008,47,60,76,64,-12,4,17,11,-473.18083212650663,-146.67042741617703,129.14494077333745,0.9664067417056286,57,75,94,75,-19,0,18,10,-498.0518016809248,-171.74200057962926,137.39360046370342,0.47619047619047616,5741,5823,Cloud and Nearby Counties,Ottawa,20,143,Kansas,KS
20145,20CS016,61,76,94,82,-12,6,21,4,-301.32328098326025,29.509425094458784,328.83425440287124,0.27427951871024486,75,97,120,86,-34,-11,11,13,-755.4870154850754,-385.37063489143054,-31.311364084929465,-0.6842105263157895,6262,6228,Pawnee and Nearby Counties,Pawnee,20,145,Kansas,KS
20147,20CS015,46,59,73,65,-8,6,19,15,-558.1622910702808,-221.4890343136132,95.3799132220739,1.3968990679765776,54,69,90,77,-13,8,23,16,-599.7776686228381,-165.4559085856105,144.7739200124092,1.1428571428571428,4982,4835,Northwest Kansas,Phillips,20,147,Kansas,KS
20149,20CS017,133,155,182,180,-2,25,47,16,-83.93432658054739,40.8569355981639,146.14956306145157,0.6093412380990504,162,191,223,225,2,34,63,34,-124.35897643494552,0,112.70032239416938,0.9444444444444444,25299,25732,Pottawatomie+Riley+Wabaunsee,Pottawatomie,20,149,Kansas,KS
20151,20CS023,81,98,116,124,8,26,43,25,-221.9746206605173,15.268952707950907,230.9449284974673,0.9555078859161759,97,119,143,129,-14,10,32,6,-217.94505060411646,43.58901012082329,283.8734284118612,0.3157894736842105,9149,9177,South Central Kansas,Pratt,20,151,Kansas,KS
20153,20CS015,28,39,51,32,-19,-7,4,4,-1083.0799030081246,-501.67439579578866,2.2103771215689614,-0.43919736746944593,35,48,64,37,-27,-11,2,3,-1176.528261189274,-549.0465218883279,-39.21760870630913,-0.23076923076923078,2545,2550,Northwest Kansas,Rawlins,20,153,Kansas,KS
20155,20CS018,488,602,755,746,-9,144,258,94,-200.32509535894513,97.10377865193657,318.59749775700385,0.6103896103896104,572,728,948,825,-123,97,253,75,-322.507396725445,35.78896710194094,289.7279564025308,0.487012987012987,61790,61471,Reno,Reno,20,155,Kansas,KS
20157,20CS008,54,70,86,65,-21,-5,11,10,-806.4890191534495,-383.16041322833223,19.001762400529486,-0.7180584131816903,65,84,107,86,-21,2,21,7,-600.2626148940161,-107.18975265964573,300.13130744700806,0.4117647058823529,4661,4665,Cloud and Nearby Counties,Republic,20,157,Kansas,KS
20159,20CS005,85,102,121,107,-14,5,22,10,-304.6825765123319,-63.17708827941876,157.32792271584978,0.6527755382216676,100,124,150,145,-5,21,45,15,-213.04548521109257,63.91364556332777,319.56822781663885,0.6,9396,9388,Central Kansas,Rice,20,159,Kansas,KS
20161,20CS017,247,311,393,348,-45,37,101,22,-111.54891500564663,24.955014542650254,131.429743257958,0.36666666666666664,294,380,488,431,-57,51,137,32,-123.30783662866216,26.32414489825372,145.47553759561265,0.3902439024390244,72130,72177,Pottawatomie+Riley+Wabaunsee,Riley,20,161,Kansas,KS
20163,20CS015,46,60,75,59,-16,-1,13,10,-633.033836438189,-270.15054624836523,72.5725611531349,-0.6322834573439589,56,74,95,73,-22,-1,17,3,-516.5089162351666,-82.64142659762665,289.2449930916933,-0.12,4894,4840,Northwest Kansas,Rooks,20,163,Kansas,KS
20165,20CS016,41,55,69,58,-11,3,17,13,-977.9987988975586,-409.8901487786684,158.21850134022182,1.086995188164704,52,70,89,60,-29,-10,8,6,-1185.7623816884409,-542.062803057573,67.75785038219662,-0.375,2952,2952,Pawnee and Nearby Counties,Rush,20,165,Kansas,KS
20167,20CS005,60,75,92,120,28,45,60,19,158.91927046695318,461.34763048401084,733.6067380419458,0.42439645960157857,72,92,112,85,-27,-7,13,13,-597.1504725886161,-298.57523629430807,0,-0.7222222222222222,6704,6698,Central Kansas,Russell,20,167,Kansas,KS
20169,20CS019,380,476,599,545,-54,69,165,77,-290.2399748997605,-17.717816094605755,194.8959770406633,0.8191489361702128,451,583,750,736,-14,153,285,130,-267.065065244462,42.641419650278564,287.4587876858995,0.7784431137724551,54183,53938,Saline,Saline,20,169,Kansas,KS
20171,20CS020,31,42,56,55,-1,13,24,16,-398.2214958455791,-69.00762439709658,183.71243574423787,1.1517024408391279,37,52,68,72,4,20,35,12,-155.88844233345512,165.63146997929607,449.15357447326664,0.5714285714285714,5095,5132,Scott and Nearby Counties,Scott,20,171,Kansas,KS
20173,20CS021,3147,3870,4757,4833,76,963,1686,497,-96.69568511675277,106.90436361662348,272.86994700384713,0.4896556477038003,3728,4712,5979,5624,-355,912,1896,611,-184.44748350378,57.359483382889266,245.2905295214038,0.5529411764705883,523084,523889,Sedgwick,Sedgwick,20,173,Kansas,KS
20175,20CS024,90,109,129,141,12,32,51,38,-143.78921115723287,-30.45797225892923,69.273517971578,1.170089793857765,110,134,161,163,2,29,53,14,-55.1485900248073,68.93573753100912,179.2329175806237,0.45161290322580644,21763,21759,Southwest Kansas,Seward,20,175,Kansas,KS
20177,20CS022,1326,1646,2052,1914,-138,268,588,239,-253.73106250700337,19.854287384500267,234.88631515900312,0.7308868501529052,1584,2012,2577,2155,-422,142,571,238,-370.41364258775474,-53.557158012309735,186.77708351832206,0.6071468082752517,178299,178314,Shawnee,Shawnee,20,177,Kansas,KS
20179,20CS015,15,23,32,44,12,21,29,10,94.5728237730913,536.321560492826,937.9113211471306,0.47664925608475134,18,28,41,40,-1,12,22,8,-365.98928318673535,161.76321908805986,566.1712668082095,0.6153846153846154,2457,2473,Northwest Kansas,Sheridan,20,179,Kansas,KS
20181,20CS015,44,58,73,51,-22,-7,7,11,-675.7437069309551,-357.5268103837427,-89.55468697556391,-0.8939030544881394,51,69,90,62,-28,-7,11,6,-576.9455118800576,-220.59681336590435,84.84492821765552,-0.3875,5891,5893,Northwest Kansas,Sherman,20,181,Kansas,KS
20183,20CS008,36,48,61,43,-18,-5,7,4,-735.6296725122082,-292.5364399241768,95.17013859035086,-0.3831498538233697,43,58,76,55,-21,-3,12,0,-587.6557316838552,-83.9508188119793,335.8032752479172,-0,3563,3574,Cloud and Nearby Counties,Smith,20,183,Kansas,KS
20185,20CS023,37,50,63,59,-4,9,22,6,-304.347134597828,84.13213830266956,472.61141120316734,0.49433882736393486,46,61,78,81,3,20,35,16,-323.1497817810381,99.04974154208065,470.48627232488315,0.7619047619047619,4063,4038,South Central Kansas,Stafford,20,185,Kansas,KS
20187,20CS024,12,20,30,16,-14,-4,4,5,-1085.0894763831245,-509.45673968739146,-77.73218716559144,-0.8067037383503844,16,25,38,19,-19,-6,3,5,-1171.827318224356,-537.0875208528299,-97.65227651869634,-0.5555555555555556,2057,2048,Southwest Kansas,Stanton,20,187,Kansas,KS
20189,20CS024,28,38,49,46,-3,8,18,8,-258.1338193511662,4.12591827349066,228.91997909462498,0.7827829019009458,34,46,63,54,-9,8,20,10,-359.5293004553249,-37.84518952161315,189.22594760806575,0.8333333333333334,5267,5285,Southwest Kansas,Stevens,20,189,Kansas,KS
20191,20CS023,168,218,278,270,-8,52,102,42,-267.770725035726,56.23185225750245,321.32487004287117,0.711864406779661,202,265,343,322,-21,57,120,30,-228.13327139051995,120.6581454954758,402.4172593284292,0.444468832309043,22407,22377,South Central Kansas,Sumner,20,191,Kansas,KS
20193,20CS015,58,72,89,69,-20,-3,11,10,-453.6303053857113,-203.26158641097896,22.69618246371621,-0.7123929938983018,71,91,111,72,-39,-19,1,14,-672.359522053868,-418.6389476939178,-164.91837333396762,-0.6666666666666666,7881,7883,Northwest Kansas,Thomas,20,193,Kansas,KS
20195,20CS015,25,35,47,45,-2,10,20,4,-251.0552476979654,241.84627812662785,699.540552106607,0.35423837526675844,29,42,57,45,-12,3,16,6,-643.9639559063569,-107.32732598439281,357.75775328130936,0.5454545454545454,2802,2795,Northwest Kansas,Trego,20,195,Kansas,KS
20197,20CS017,39,50,65,57,-8,7,18,4,-207.99114842330573,49.584558814419104,249.92121999931624,0.3649776711530577,45,61,77,92,15,31,47,10,71.18013427161698,301.97632721292024,532.0535288989547,0.3225806451612903,6894,6954,Pottawatomie+Riley+Wabaunsee,Wabaunsee,20,197,Kansas,KS
20199,20CS015,7,12,19,15,-4,3,8,8,-943.972645962121,-422.64757464117724,33.5118627646486,1.5581801437550624,7,14,24,19,-5,5,12,4,-596.4708806229808,66.2745422914423,530.1963383315384,0.5714285714285714,1514,1509,Northwest Kansas,Wallace,20,199,Kansas,KS
20201,20CS008,45,58,72,66,-6,8,21,10,-355.8560965780014,-33.748736605325185,234.674063371905,0.8519288081151546,54,70,89,83,-6,13,29,10,-290.2132387117253,54.4149822584485,344.6282209701738,0.625,5513,5513,Cloud and Nearby Counties,Washington,20,201,Kansas,KS
20203,20CS020,11,18,27,31,4,13,20,6,-119.843373835028,388.7628825868414,804.8952742047344,0.4646591838891286,13,22,32,30,-2,8,17,2,-191.29221879047526,286.9383281857129,717.3458204642823,0.2222222222222222,2134,2091,Scott and Nearby Counties,Wichita,20,203,Kansas,KS
20205,20CS011,73,90,109,112,3,22,39,4,-7.3365639875178985,257.48700734361427,488.34407713444836,0.1786862944691907,86,107,130,155,25,48,69,26,-11.718606950598748,257.80935291317246,503.9000988757461,0.5416666666666666,8568,8533,Elk and Nearby Counties,Wilson,20,205,Kansas,KS
20207,20CS011,27,37,49,51,2,14,24,2,17.4868042788881,464.3602810966281,846.0315780228117,0.1349037932506209,32,44,59,55,-4,11,23,5,-290.12175711704936,193.41450474469957,580.2435142340987,0.38461538461538464,3102,3102,Elk and Nearby Counties,Woodson,20,207,Kansas,KS
20209,20CS025,972,1215,1504,1474,-30,259,502,213,-173.4406821778293,32.80539218824074,206.1391002611084,0.7332207607536438,1156,1465,1867,1653,-214,188,497,174,-231.9313529814542,8.36757877010787,193.0818801202391,0.5868482118482119,168265,167312,Wyandotte,Wyandotte,20,209,Kansas,KS
21001,21CS001,136,176,224,268,44,92,132,44,0,303.72938555439845,556.8372068497304,0.4782608695652174,165,213,275,270,-5,57,105,40,-238.0705976646534,89.83796138288808,343.7623169386391,0.6451612903225806,18964,18923,Adair and Nearby Counties,Adair,21,1,Kentucky,KY
21003,21CS003,159,203,259,231,-28,28,72,30,-335.87863006399266,-11.582021726344575,243.51200679639442,0.6976744186046512,189,248,324,290,-34,42,101,47,-390.0317201723041,-24.07603210940149,260.0211467815361,0.7899717514124294,20722,20768,Barren and Nearby Counties,Allen,21,3,Kentucky,KY
21005,21CS002,163,211,267,246,-21,35,83,13,-172.29011234592954,111.31813426168722,354.4470593195993,0.2708333333333333,195,256,332,291,-41,35,96,47,-366.5018680836221,-49.97752746594847,204.28314351706416,0.8392857142857143,23716,24011,Anderson+Franklin,Anderson,21,5,Kentucky,KY
21007,21CS044,72,88,108,96,-12,8,24,5,-259.12396978953365,53.386123210441546,302.11864621042173,0.32405970632041803,86,107,131,134,3,27,48,24,-273.4039933651366,38.96493967199097,311.71951737592775,0.8571428571428571,7735,7699,Southwest Kentucky,Ballard,21,7,Kentucky,KY
21009,21CS003,359,451,566,507,-59,56,148,45,-281.24116161320046,29.718086241548566,278.40443519923434,0.5056179775280899,428,550,706,653,-53,104,225,111,-368.2946581835382,-16.842743514491076,256.3465562905539,0.8538461538461538,44417,44530,Barren and Nearby Counties,Barren,21,9,Kentucky,KY
21011,21CS004,108,129,153,150,-3,21,42,10,-122.17840474955254,103.28795701208537,305.430212384588,0.4275545199161682,130,156,186,220,34,64,90,19,117.48311996005573,352.4493598801672,556.0867678109305,0.296875,12690,12768,Bath+Clark+Montgomery+Rowan,Bath,21,11,Kentucky,KY
21013,21CS005,249,314,393,362,-31,48,113,40,-351.52623725270416,39.60859011298075,361.42838478094933,0.6060606060606061,288,376,481,545,64,169,257,80,-67.23850818487446,372.8490485017962,741.5087818518867,0.47058823529411764,24237,23870,Bell+Harlan,Bell,21,13,Kentucky,KY
21015,21CS006,660,820,1022,911,-111,91,251,91,-178.09184942642707,0,141.1510153127275,0.6066666666666667,780,1006,1286,1168,-118,162,388,160,-202.60102390254363,1.4570372089359487,166.10224181869816,0.7207207207207207,136110,137265,Boone,Boone,21,15,Kentucky,KY
21017,21CS007,158,203,254,202,-52,-1,44,7,-350.4144570710326,-47.51382468759764,219.75143918013907,-0.06736374572036644,189,248,321,334,13,86,145,37,-118.59367665104634,242.12875649588628,533.9186150893979,0.4111111111111111,20205,20237,Bourbon+Fleming+Lewis+Nicholas,Bourbon,21,17,Kentucky,KY
21019,21CS008,448,562,711,641,-70,80,193,50,-300.42908012797676,73.82472189733706,357.86221123115934,0.44642857142857145,535,688,886,795,-91,106,260,78,-352.52950348618305,59.45024171216696,379.85575493984555,0.52,47951,47939,Boyd+Carter+Greenup,Boyd,21,19,Kentucky,KY
21021,21CS009,235,300,380,339,-41,39,104,45,-337.2156427866854,-23.526672752559445,231.34561540016787,0.7258064516129032,284,366,474,442,-32,76,158,55,-283.17883559443567,68.31425097625673,335.06513574068777,0.6043956043956044,30604,30740,Boyle+Lincoln+Mercer,Boyle,21,21,Kentucky,KY
21023,21CS010,67,84,101,90,-11,6,23,2,-187.79801970768395,59.24844453567772,306.2949087790396,0.1392548369951435,82,104,127,140,13,36,58,22,-106.73808894346588,166.03702724539136,426.95235577386353,0.6111111111111112,8386,8432,Bracken and Nearby Counties,Bracken,21,23,Kentucky,KY
21025,21CS045,133,173,222,183,-39,10,50,6,-400.14001693156274,35.52852536573255,390.81377902305803,0.17142857142857143,158,211,278,277,-1,66,119,47,-353.68560665371047,140.0005526337604,530.5284099805657,0.6667002012072434,13510,13571,Wolfe and Nearby Counties,Breathitt,21,25,Kentucky,KY
21027,21CS011,163,187,216,249,33,62,86,15,104.0052178794837,277.8339544785088,417.668444391733,0.24049311909657067,194,228,264,355,91,127,161,44,227.9444082387354,402.540125187554,567.4360800836605,0.3464566929133858,20460,20619,Breckinridge+Grayson+Hancock+Meade,Breckinridge,21,27,Kentucky,KY
21029,21CS012,450,567,705,699,-6,132,249,63,-100.76969253060756,100.62386084821884,271.2469292430247,0.44366197183098594,535,690,890,856,-34,166,321,103,-165.4656589084307,76.06228756826803,263.19966174416555,0.5567567567567567,82287,82827,Bullitt+Spencer,Bullitt,21,29,Kentucky,KY
21031,21CS013,118,139,161,170,9,31,52,20,-107.86707486553924,107.04495674833066,313.9972834876129,0.6439860525900017,142,168,200,189,-11,21,47,30,-333.40109778410243,-73.18560683065664,138.2394795690181,1.1111111111111112,12395,12298,Butler+McLean+Muhlenberg+Ohio,Butler,21,31,Kentucky,KY
21033,21CS036,119,139,162,145,-17,6,26,14,-293.8283288041296,-75.37885893708851,111.86354380608972,0.7791475510838232,141,167,199,210,11,43,69,30,-150.49306279785088,102.9689377037927,309.30284748716156,0.6976744186046512,12646,12625,Lyon and Nearby Counties,Caldwell,21,33,Kentucky,KY
21035,21CS014,258,324,406,404,-2,80,146,40,-134.50439035184527,128.09941938270978,339.6235856384092,0.46511627906976744,307,399,513,511,-2,112,204,40,-112.00068444862718,192.00117334050375,437.4693400904115,0.334733893557423,37471,37500,Calloway+Marshall,Calloway,21,35,Kentucky,KY
21037,21CS015,591,735,921,817,-104,82,226,58,-208.66518690173302,30.903822805563667,216.3911426031239,0.43609022556390975,707,892,1150,957,-193,64,250,84,-297.72635074324126,-20.95529268902077,178.44237697496914,0.4692737430167598,93192,93055,Campbell,Campbell,21,37,Kentucky,KY
21039,21CS044,49,63,80,69,-11,6,20,3,-344.01646326782793,67.41948462152156,417.14004032746845,0.2291166107271388,59,78,98,107,9,29,48,10,-20.859770194865018,396.33563370243536,792.6712674048707,0.3448275862068966,4796,4794,Southwest Kentucky,Carlisle,21,39,Kentucky,KY
21041,21CS040,100,118,140,122,-18,4,22,13,-341.5044349278505,-104.22727837072344,96.54570025453778,0.8597632865133789,119,145,172,154,-18,9,35,23,-377.58003430452754,-128.92976781130207,110.51122955254463,1.0952380952380953,10811,10859,Owen and Nearby Counties,Carroll,21,41,Kentucky,KY
21043,21CS008,227,287,359,304,-55,17,77,22,-347.7786606609713,-22.568375124008522,248.47781011533363,0.38596491228070173,271,349,452,436,-16,87,165,56,-272.35823934898815,117.26535305303656,412.50925001398815,0.5833333333333334,26586,26436,Boyd+Carter+Greenup,Carter,21,43,Kentucky,KY
21045,21CS001,129,166,210,210,0,44,81,25,-188.3204691272131,143.12355653668197,421.83785084495736,0.5208333333333334,152,202,263,242,-21,40,90,39,-378.0976437164898,6.30162739527483,321.3829971590163,0.78,15930,15869,Adair and Nearby Counties,Casey,21,45,Kentucky,KY
21047,21CS016,425,535,672,668,-4,133,243,72,-125.8802027656126,100.9689989309976,283.0442429049277,0.5052693785088151,510,652,837,835,-2,184,325,102,-143.70269218120282,112.55905250137462,308.052719759897,0.5284974093264249,72498,72406,Christian,Christian,21,47,Kentucky,KY
21049,21CS004,294,367,466,396,-70,29,102,17,-283.0740239250423,39.044692955178256,276.56657509917926,0.2463768115942029,346,446,582,523,-59,77,177,31,-244.10629896357605,124.69616604469184,395.91032719189644,0.29523809523809524,36881,36890,Bath+Clark+Montgomery+Rowan,Clark,21,49,Kentucky,KY
21051,21CS017,179,232,296,236,-60,4,57,21,-480.4953254280647,-100.8446979293469,213.55347796802877,0.38181818181818183,217,280,367,390,23,110,173,43,-98.91767576434512,331.37421381055617,643.212186657654,0.38392857142857145,20229,20219,Clay+Jackson+Leslie+Owsley,Clay,21,51,Kentucky,KY
21053,21CS018,82,99,119,145,26,46,63,21,61.35679473753028,324.73699948744314,535.4411632873733,0.45315318075660305,96,118,143,157,14,39,61,21,-75.61147404118574,194.4295046773348,432.6056479070694,0.5384615384615384,9365,9258,Clinton+Cumberland+McCreary+Wayne,Clinton,21,53,Kentucky,KY
21055,21CS036,91,110,132,112,-20,2,21,12,-422.69720795884007,-136.25549414661484,117.68610213691521,0.6024353714528595,112,136,161,157,-4,21,45,23,-302.1488311047607,-22.340024480943494,245.74026929037845,0.92,8955,8953,Lyon and Nearby Counties,Crittenden,21,55,Kentucky,KY
21057,21CS018,62,78,95,97,2,19,35,4,-31.097971375213834,299.37671688385893,613.3276707299782,0.20286179879871222,73,93,115,111,-4,18,38,11,-255.29108502256844,119.13583967719862,459.5239530406232,0.55,5971,5876,Clinton+Cumberland+McCreary+Wayne,Cumberland,21,57,Kentucky,KY
21059,21CS019,758,939,1178,1034,-144,95,276,92,-274.97211141842257,3.494667800276499,214.45611401030106,0.5154102065155985,889,1142,1446,1310,-136,168,421,191,-317.42182669107746,-22.309249851473744,223.2379936224643,0.7732793522267206,103014,103096,Daviess,Daviess,21,59,Kentucky,KY
21061,21CS020,106,125,147,140,-7,15,34,19,-258.3969213433014,-39.17559489921425,147.97446341694112,0.9924841151493062,128,156,185,187,2,31,59,29,-220.08813714751508,16.302824973890008,244.54237460835012,0.8787878787878788,12151,12268,Edmonson+Warren,Edmonson,21,61,Kentucky,KY
21063,21CS021,53,67,83,65,-18,-2,12,6,-391.8619971407941,-137.20580136688446,90.64447906240302,-0.418826742954427,65,85,105,115,10,30,50,15,-67.80446322879205,203.41338968637612,474.6312426015443,0.5,7361,7374,Elliott+Johnson+Lawrence+Magoffin,Elliott,21,63,Kentucky,KY
21065,21CS022,130,168,213,195,-18,27,65,11,-246.69276189212502,135.87208916605852,458.5683009354475,0.2972972972972973,157,204,268,273,5,69,116,27,-156.04912000709314,297.91195637717783,631.6442789378018,0.375,14131,14098,Estill+Madison+Rockcastle,Estill,21,65,Kentucky,KY
21067,21CS023,1632,2034,2529,2478,-51,444,846,142,-71.89338295013596,112.35084942272218,261.9225680002237,0.2915811088295688,1953,2454,3151,2837,-314,382,884,229,-168.78858411734012,47.68828945704345,203.5684147669558,0.4320754716981132,322561,321882,Fayette,Fayette,21,67,Kentucky,KY
21069,21CS007,127,150,173,179,6,29,52,17,-91.6100548437547,98.75499474183275,282.55573227274493,0.5630860442432465,150,182,213,208,-5,26,58,29,-223.61647582078345,-19.73086551359854,190.7316999647859,0.9354838709677419,15029,15205,Bourbon+Fleming+Lewis+Nicholas,Fleming,21,69,Kentucky,KY
21071,21CS024,369,454,569,541,-28,87,172,46,-248.94418905367448,137.9285371783872,423.87794352382406,0.44660194174757284,428,551,705,680,-25,129,252,110,-381.9570109741908,53.756912655626856,401.7621893210007,0.7534246575342466,35671,35344,Floyd+Martin,Floyd,21,71,Kentucky,KY
21073,21CS002,389,486,613,528,-85,42,139,40,-291.36786285314696,4.661885805650352,230.87989452483353,0.449438202247191,460,596,768,759,-9,163,299,79,-170.32635804423083,162.58425086040214,425.91267145037483,0.4475956599897278,51481,51666,Anderson+Franklin,Franklin,21,73,Kentucky,KY
21075,21CS044,72,89,109,111,2,22,39,19,-323.8472185160264,59.8881929668664,366.87652215318076,0.8250143878573465,87,111,136,125,-11,14,38,14,-384.76923126154003,0,368.64117965177485,0.6666666666666666,6427,6510,Southwest Kentucky,Fulton,21,75,Kentucky,KY
21077,21CS040,67,82,100,100,0,18,33,11,-145.0586789270861,93.5450351711486,308.9118079914081,0.5661565370124167,79,99,122,120,-2,21,41,23,-285.41256386106113,-22.83300510888489,205.49704597996404,1,8704,8759,Owen and Nearby Counties,Gallatin,21,77,Kentucky,KY
21079,21CS025,136,159,183,203,20,44,67,22,-16.717416758169374,156.76992238290472,312.6487295978466,0.4963343192154963,166,197,230,241,11,44,75,33,-127.16962091169538,63.58481045584769,242.7783671950548,0.7333333333333333,17089,17300,Garrard+Jessamine,Garrard,21,79,Kentucky,KY
21081,21CS040,164,211,272,227,-45,16,63,13,-277.8563277853001,14.371879023377591,239.77084837334925,0.31329849012775846,197,258,334,321,-13,63,124,36,-194.5688643538337,107.10212716724791,349.2719369287472,0.5070422535211268,25049,25210,Owen and Nearby Counties,Grant,21,81,Kentucky,KY
21083,21CS044,311,390,491,471,-20,81,160,66,-281.9871684368807,49.15522982630112,308.2032910109079,0.6875,365,478,606,578,-28,100,213,52,-218.85258359095153,131.14761563502714,439.89096077582013,0.4444444444444444,36619,36600,Southwest Kentucky,Graves,21,83,Kentucky,KY
21085,21CS011,218,280,357,314,-43,34,96,40,-377.1354238524154,-27.246388237381005,254.52667678420067,0.7017543859649122,268,342,442,447,5,105,179,65,-226.72935362328406,150.90140008205265,430.06899023385,0.5803571428571429,26426,26507,Breckinridge+Grayson+Hancock+Meade,Grayson,21,85,Kentucky,KY
21087,21CS001,111,132,157,141,-16,9,30,16,-346.06389393359973,-70.70294047954475,151.36234456404785,0.9051088488166661,139,166,197,164,-33,-2,25,28,-541.5052291872797,-266.31404714128513,-26.631404714128514,-0.8360071301247771,11107,11265,Adair and Nearby Counties,Green,21,87,Kentucky,KY
21089,21CS008,332,421,522,498,-24,77,166,37,-204.86687093492083,134.3389317606038,433.2430549279473,0.39361702127659576,394,512,660,577,-83,64,183,66,-417.6172344186204,-4.204200346496179,327.92762702670194,0.5892857142857143,35731,35679,Boyd+Carter+Greenup,Greenup,21,89,Kentucky,KY
21091,21CS011,61,77,94,102,8,25,41,3,70.06467449399719,288.4736282261658,506.8825819583342,0.12136974349309877,75,95,118,114,-4,19,39,4,-88.22150950678662,165.41533032522491,385.96910409219146,0.18181818181818182,9034,9068,Breckinridge+Grayson+Hancock+Meade,Hancock,21,91,Kentucky,KY
21093,21CS026,649,810,1015,1003,-12,193,354,84,-103.98012746045688,117.99931174585943,292.4001293812534,0.4097560975609756,777,990,1263,1396,133,406,619,223,-80.8234845596645,163.71016572851022,355.2286335807674,0.5419206056740604,110848,111478,Hardin+Larue,Hardin,21,93,Kentucky,KY
21095,21CS005,290,366,461,471,10,105,181,31,-94.99396863691194,334.74065138721346,678.7545235223157,0.28703703703703703,340,443,574,586,12,143,246,87,-286.0075884425115,213.4100593308547,606.1226774387933,0.5858652276437512,26528,26241,Bell+Harlan,Harlan,21,95,Kentucky,KY
21097,21CS010,149,193,247,209,-38,16,60,11,-313.9213952062009,32.00014222285432,313.60139378397236,0.2894736842105263,183,236,308,298,-10,62,115,43,-280.21170082113923,100.4532512377669,380.6649520589062,0.6323529411764706,18750,18914,Bracken and Nearby Counties,Harrison,21,97,Kentucky,KY
21099,21CS003,151,194,249,227,-22,33,76,31,-330.33455463050535,12.46545489171718,280.47273506363655,0.7209302325581395,176,236,308,269,-39,33,93,45,-432.524226567048,-61.75241783229716,247.00967132918865,0.8653846153846154,19253,19432,Barren and Nearby Counties,Hart,21,99,Kentucky,KY
21101,21CS027,339,429,539,543,4,114,204,60,-150.32176855499378,144.953133963744,386.54169056998404,0.4918032786885246,403,517,663,638,-25,121,235,71,-216.33762190117952,112.67584474019766,369.57677074784834,0.5220588235294118,44704,44375,Henderson+Union,Henderson,21,101,Kentucky,KY
21103,21CS028,129,153,177,164,-13,11,35,4,-127.93277687285702,54.03575094572169,236.0042787643006,0.2072375641947949,154,185,218,230,12,45,76,29,-108.88785110145169,102.18214766118636,300.1600587547349,0.6444444444444445,15723,15658,Henry+Shelby,Henry,21,103,Kentucky,KY
21105,21CS044,46,60,75,76,1,16,30,2,-21.809220175637346,384.8562662553547,747.5579163154285,0.11901101400578581,56,72,93,72,-21,-0,16,11,-721.0218231149457,-259.11721768193365,112.65965986171027,0.05215517241379308,4488,4438,Southwest Kentucky,Hickman,21,105,Kentucky,KY
21107,21CS029,401,499,627,613,-14,114,212,95,-289.12440214743395,50.39783156698389,310.47716762712963,0.7723577235772358,471,600,769,756,-13,156,285,103,-256.79968010729505,118.43778349776107,402.9098429269629,0.6005881952944376,45240,45171,Hopkins+Webster,Hopkins,21,107,Kentucky,KY
21109,21CS017,115,137,160,173,13,36,58,23,-95.19928990477811,117.16973808052127,321.9541579234886,0.6442419284217972,141,168,200,224,24,56,83,42,-138.6835655159462,107.8649954012915,315.8903436752108,0.75,13008,12979,Clay+Jackson+Leslie+Owsley,Jackson,21,109,Kentucky,KY
21111,21CS030,5491,6768,8330,8138,-192,1370,2647,753,-145.48426972498584,94.8961035660517,291.5149809222497,0.49215707298777095,6510,8146,10431,9578,-853,1432,3068,907,-226.0840546894851,67.5021566088034,277.55525193619775,0.49848863341166805,779589,778494,Jefferson,Jefferson,21,111,Kentucky,KY
21113,21CS025,320,406,514,454,-60,48,134,49,-245.9026024535427,-2.2559871784728687,191.75891017019387,0.6049382716049383,384,494,634,597,-37,103,213,51,-164.48528295718572,97.14065546591321,302.6305035668835,0.4146341463414634,53192,53531,Garrard+Jessamine,Jessamine,21,113,Kentucky,KY
21115,21CS021,210,269,341,302,-39,33,92,17,-297.8613378642928,85.10323938979795,399.18738226277077,0.3269230769230769,253,328,428,435,7,107,182,68,-270.52326644104596,172.81584588371487,505.5971285982526,0.6126126126126126,22561,22567,Elliott+Johnson+Lawrence+Magoffin,Johnson,21,115,Kentucky,KY
21117,21CS031,1036,1304,1608,1390,-218,86,354,109,-232.29947885131736,-16.691752799284384,174.09143025977025,0.4801762114537445,1237,1574,2010,1753,-257,180,516,197,-267.95593967524246,-10.327560718680196,188.2861855597095,0.6204739797234291,168946,169450,Kenton,Kenton,21,117,Kentucky,KY
21119,21CS032,137,160,185,197,12,37,60,11,8.556383524037285,216.24176197238438,410.0814485241749,0.29331133990212666,164,195,224,269,45,74,105,34,78.18828271579893,284.32102805745063,504.6698248019749,0.4594594594594595,14251,14069,Knott+Letcher+Perry,Knott,21,119,Kentucky,KY
21121,21CS033,266,337,425,411,-14,74,145,30,-174.48993502067523,174.48993502067523,456.2515232756517,0.35714285714285715,315,407,523,526,3,119,211,84,-270.6903773550773,116.89282180663425,424.3209431580822,0.6666666666666666,30260,29942,Knox+Whitley,Knox,21,121,Kentucky,KY
21123,21CS026,129,151,174,162,-12,11,33,3,-124.21228306718365,62.558175483030176,242.33722649393104,0.16552938322440747,156,185,217,225,8,40,69,34,-173.27605597038755,39.98678214701251,233.2562291909063,0.8292682926829268,14817,15005,Hardin+Larue,Larue,21,123,Kentucky,KY
21125,21CS034,466,580,731,687,-44,106,221,27,-136.66514055122488,152.91877091938605,373.16027117435084,0.2109375,555,713,924,940,16,227,385,142,-201.35602361804948,135.83541275820798,388.329474120524,0.5991561181434599,62386,62576,Laurel,Laurel,21,125,Kentucky,KY
21127,21CS021,145,188,239,182,-57,-6,37,14,-527.2936616712847,-148.5334258228971,170.81343969633167,-0.2916666666666667,176,232,299,276,-23,44,100,37,-368.6376623276967,42.971917340447575,387.05419833074535,0.6727272727272727,16158,16290,Elliott+Johnson+Lawrence+Magoffin,Lawrence,21,127,Kentucky,KY
21129,21CS045,81,99,119,124,5,25,43,16,-182.45789433015128,138.64871488506296,432.9964399990091,0.6313643128955881,101,124,154,150,-4,26,49,22,-349.5690608972833,53.77985552265897,363.014024777948,0.7586206896551724,7374,7438,Wolfe and Nearby Counties,Lee,21,129,Kentucky,KY
21131,21CS017,129,151,176,132,-44,-19,3,6,-578.8653048817486,-292.97473981554464,-35.67323125596117,-0.2659069362384312,155,189,223,206,-17,17,51,29,-446.4366951553127,-116.46174656225548,213.51320203080172,1.0740740740740742,10353,10304,Clay+Jackson+Leslie+Owsley,Leslie,21,131,Kentucky,KY
21133,21CS032,222,283,354,324,-30,41,102,24,-302.39365813300304,95.19800348631578,436.79083952544886,0.42857142857142855,263,343,442,427,-15,84,164,61,-357.6376412442516,108.09022008696172,484.29118173745223,0.6288659793814433,21429,21279,Knott+Letcher+Perry,Letcher,21,133,Kentucky,KY
21135,21CS007,140,161,186,174,-12,13,34,29,-374.09648246557634,-147.98004891957945,48.364387542861095,1.4920984693260517,168,201,234,231,-3,30,63,39,-323.1318140581573,-69.24253158389085,184.6467508903756,1.1470588235294117,13089,12998,Bourbon+Fleming+Lewis+Nicholas,Lewis,21,135,Kentucky,KY
21137,21CS009,202,257,327,309,-18,52,107,37,-271.8342634733005,74.13661731090014,345.9708807842007,0.5692307692307692,239,312,400,435,35,123,196,64,-119.8320083119276,243.37654011716793,544.5034456858673,0.512,24280,24242,Boyle+Lincoln+Mercer,Lincoln,21,137,Kentucky,KY
21139,21CS036,85,102,121,154,33,52,69,19,190.68127952442794,451.1517886405522,678.9249359740135,0.3621724384244269,101,124,150,174,24,50,73,27,-33.54813458393324,257.2023651434882,514.9638658633747,0.5347058823529411,8901,8942,Lyon and Nearby Counties,Livingston,21,139,Kentucky,KY
21141,21CS035,221,282,353,317,-36,35,96,40,-332.00760850769495,-21.842605822874667,244.6371852161963,0.7142857142857143,267,344,449,389,-60,45,122,41,-364.3930913762405,14.424268832310362,292.2717472146885,0.5857142857142857,27469,27731,Logan+Simpson+Todd,Logan,21,141,Kentucky,KY
21143,21CS036,86,106,127,112,-15,6,26,12,-370.5009993889212,-84.335861369167,190.3826711297973,0.7590902552488743,108,132,161,139,-22,7,31,13,-398.5093851332279,-68.31589459426765,204.94768378280293,0.65,8619,8783,Lyon and Nearby Counties,Lyon,21,143,Kentucky,KY
21145,21CS037,554,691,855,795,-60,104,241,76,-242.31795277146526,49.79745084477818,293.6271119454598,0.5671641791044776,653,831,1063,1006,-57,175,353,109,-245.89056018486232,97.7637167000055,361.503561524793,0.5190476190476191,67473,67510,McCracken,McCracken,21,145,Kentucky,KY
21147,21CS018,145,188,239,198,-41,10,53,11,-369.2598741741756,-7.094329955315573,297.9618581232541,0.28205128205128205,177,228,298,290,-8,62,113,57,-384.93379015433135,32.5713207053665,331.9313682792347,0.8260869565217391,16915,16886,Clinton+Cumberland+McCreary+Wayne,McCreary,21,147,Kentucky,KY
21149,21CS013,81,99,117,128,11,29,47,16,-62.442144750628216,164.74242444108944,402.74530645146024,0.5610138495558947,98,120,145,145,-0,25,47,21,-231.2667945378555,43.946184235221956,285.6501975289427,0.7777777777777778,9120,9102,Butler+McLean+Muhlenberg+Ohio,McLean,21,149,Kentucky,KY
21151,21CS022,556,693,854,833,-21,140,277,63,-108.23814808609029,99.21830241224943,275.74956774313483,0.39748029615476477,664,852,1086,1071,-15,220,407,142,-166.45240046551595,82.08756624929994,280.7394765726058,0.5941422594142259,93128,94411,Estill+Madison+Rockcastle,Madison,21,151,Kentucky,KY
21153,21CS021,123,146,168,152,-16,6,29,10,-264.460981097748,-36.20204896173285,200.5109176978385,0.4888558629170644,152,179,211,217,6,38,65,24,-156.37018469418226,121.62125476214176,356.1765318034152,0.6,11670,11511,Elliott+Johnson+Lawrence+Magoffin,Magoffin,21,153,Kentucky,KY
21155,21CS038,145,186,239,232,-7,46,87,27,-209.05513321764636,113.58355255584311,368.379089370302,0.54,175,227,297,256,-41,29,81,30,-360.3355942418203,-5.075149214673525,259.0863674090832,0.5882352941176471,19545,19704,Marion+Nelson+Washington,Marion,21,155,Kentucky,KY
21157,21CS014,299,375,471,385,-86,10,86,35,-459.5933585277925,-94.95730548094888,193.7129031811357,0.4242580076403174,358,459,591,510,-81,51,152,48,-406.4797813726964,9.453018171458057,327.8621802467368,0.49742268041237114,31593,31736,Calloway+Marshall,Marshall,21,157,Kentucky,KY
21159,21CS024,99,118,139,140,1,22,41,2,-10.08724148131367,209.6762423251043,420.6491867792654,0.08600435816678739,120,145,175,185,10,40,65,29,-170.3602970844479,98.62964568046984,322.78793131790127,0.725,11223,11153,Floyd+Martin,Martin,21,159,Kentucky,KY
21161,21CS010,155,200,254,197,-57,-3,42,21,-548.5325825521513,-168.7792561698927,148.03347259900977,-0.30658567774936063,184,240,315,272,-43,32,88,44,-513.169633531015,-70.78201841807105,259.82899260966883,0.8301886792452831,17064,16953,Bracken and Nearby Counties,Mason,21,161,Kentucky,KY
21163,21CS011,189,238,303,243,-60,5,54,13,-293.99241106918345,-32.21834641854065,165.32039006013648,0.23636363636363636,226,294,381,357,-24,63,131,63,-288.9489482009192,0,225.84515491566097,0.8289473684210527,29797,30109,Breckinridge+Grayson+Hancock+Meade,Meade,21,163,Kentucky,KY
21165,21CS045,56,72,88,80,-8,8,24,4,-232.54590519592057,86.89627798074396,390.3663519985754,0.3178724731890022,70,88,110,127,17,39,57,22,-80.87370559949319,274.9705990382768,566.1159391964524,0.5641025641025641,6177,6182,Wolfe and Nearby Counties,Menifee,21,165,Kentucky,KY
21167,21CS009,199,253,317,260,-57,7,61,25,-436.57619702127704,-95.83379934613399,191.93380369045144,0.45875420875420875,239,312,403,351,-52,39,112,51,-451.65920658313564,-52.59495855407693,267.35770598322443,0.7611940298507462,22539,22816,Boyle+Lincoln+Mercer,Mercer,21,167,Kentucky,KY
21169,21CS003,96,117,137,148,11,31,52,14,-39.09809872801801,201.9689536672218,442.5548343011937,0.44793355542480273,117,144,172,160,-12,16,43,34,-444.97648154194025,-174.12123190771575,87.06061595385788,1.4782608695652173,10252,10338,Barren and Nearby Counties,Metcalfe,21,169,Kentucky,KY
21171,21CS003,104,124,146,152,6,28,48,37,-327.0195285534914,-97.98295526491015,113.87587502702716,1.2902131607121152,121,148,178,185,7,37,64,37,-266.8346736834303,0,240.15120631508728,0.9736842105263158,11200,11243,Barren and Nearby Counties,Monroe,21,171,Kentucky,KY
21173,21CS004,210,267,340,306,-34,39,96,20,-230.4426745693647,81.08168179292461,324.32672717169845,0.36363636363636365,252,326,420,433,13,107,181,67,-191.48709826124988,141.84229500833322,404.2505407737497,0.5982142857142857,28120,28200,Bath+Clark+Montgomery+Rowan,Montgomery,21,173,Kentucky,KY
21175,21CS045,110,129,151,138,-13,9,28,6,-169.23365203728702,25.65744630008889,191.67578932822377,0.3339635285199565,131,160,189,183,-6,23,52,19,-181.45243438119195,28.974440619751213,239.03913511294752,0.7037037037037037,13668,13805,Wolfe and Nearby Counties,Morgan,21,175,Kentucky,KY
21177,21CS013,259,329,414,364,-50,35,105,42,-358.3123217166293,-27.248085301644817,245.4273968955292,0.6885245901639344,309,400,515,482,-33,82,173,61,-306.4739156057424,68.35849418715445,364.7413939843168,0.6288659793814433,30828,30720,Butler+McLean+Muhlenberg+Ohio,Muhlenberg,21,177,Kentucky,KY
21179,21CS038,305,385,483,441,-42,56,136,36,-200.62678029642504,51.376896362720885,257.01292405451113,0.47368421052631576,370,472,599,618,19,146,248,87,-144.63913280284814,125.4035097041593,342.4153459888144,0.5686274509803921,46714,47048,Marion+Nelson+Washington,Nelson,21,179,Kentucky,KY
21181,21CS007,65,81,99,77,-22,-4,12,4,-409.85488860927256,-134.0658557165736,128.59036608599672,-0.29769546564607746,77,99,122,116,-6,17,39,21,-351.27282189166925,-52.04041805802507,234.18188126111284,1,7512,7686,Bourbon+Fleming+Lewis+Nicholas,Nicholas,21,181,Kentucky,KY
21183,21CS013,190,239,304,260,-44,21,70,29,-368.55857379892836,-40.38998069029352,207.2510884170684,0.6237280296022202,226,291,380,372,-8,81,146,46,-228.12123556876432,147.71957899919985,422.05593999771384,0.5287356321839081,23768,23694,Butler+McLean+Muhlenberg+Ohio,Ohio,21,183,Kentucky,KY
21185,21CS039,294,373,465,424,-41,51,130,50,-161.5543780648703,1.7743479194384433,141.94783355507548,0.6756756756756757,353,458,589,486,-103,28,133,37,-204.35441738897288,-12.402802911861976,140.15167290404025,0.40217391304347827,67630,68533,Oldham,Oldham,21,185,Kentucky,KY
21187,21CS040,86,106,125,133,8,27,47,11,-31.6910880921121,170.29334965952307,381.0597194873165,0.396185927397042,103,128,153,160,7,32,57,18,-97.39684788383212,123.95962457942271,345.31609704267754,0.5454545454545454,11234,11294,Owen and Nearby Counties,Owen,21,187,Kentucky,KY
21189,21CS017,44,58,72,91,19,33,47,12,220.3946890733869,608.3508285574015,1020.5542267591668,0.36778996340391323,51,68,87,83,-4,15,32,7,-277.6039831965468,201.89380596112494,630.9181436285154,0.4117647058823529,4069,3962,Clay+Jackson+Leslie+Owsley,Owsley,21,189,Kentucky,KY
21191,21CS010,123,146,169,153,-16,7,30,6,-176.73606434615667,12.137777438714213,194.26612487412558,0.3302632520261117,149,178,208,209,1,31,60,23,-150.56311460333893,54.75022349212325,253.21978365107,0.6867201426024956,14626,14612,Bracken and Nearby Counties,Pendleton,21,191,Kentucky,KY
21193,21CS032,318,402,501,436,-65,34,118,33,-420.88444398074313,4.292549148197279,364.8666775967686,0.46156103286384975,372,489,621,594,-27,105,222,87,-407.2231503979579,64.29839216809862,482.2379412607396,0.7073170731707317,27955,27994,Knott+Letcher+Perry,Perry,21,193,Kentucky,KY
21195,21CS041,542,680,853,781,-72,101,239,47,-245.43733336767943,111.28141059491763,395.6672376708182,0.34814814814814815,645,823,1060,1076,16,253,431,160,-250.43747264098786,161.6286256461615,470.9823392484921,0.6015037593984962,58231,57539,Pike,Pike,21,195,Kentucky,KY
21197,21CS045,138,163,188,163,-25,0,25,6,-289.20364777820157,-53.50624406209786,174.5880175986477,0.213012769002838,169,202,234,218,-16,16,49,19,-266.64635075422825,-22.855401493219567,228.55401493219566,0.6785714285714286,12976,13126,Wolfe and Nearby Counties,Powell,21,197,Kentucky,KY
21199,21CS042,562,698,880,814,-66,116,252,66,-243.44192406074524,92.17793413886605,342.99409293072046,0.45517241379310347,668,848,1080,1042,-38,194,374,165,-310.5701914449769,43.60221899596966,319.7496059704442,0.7638888888888888,65092,65364,Pulaski,Pulaski,21,199,Kentucky,KY
21201,21CS010,16,24,32,39,7,15,23,3,213.7676520820578,667.2382433709022,1118.4527620662698,0.18773716742069071,18,28,40,39,-1,11,21,4,-222.58288894041272,311.6160445165778,756.7818223974032,0.3333333333333333,2186,2246,Bracken and Nearby Counties,Robertson,21,201,Kentucky,KY
21203,21CS022,130,170,215,192,-23,22,62,13,-267.34224216287305,70.54864723742483,363.88249627724383,0.37142857142857144,154,206,269,317,48,111,163,39,55.879940912136554,447.03952729709243,769.9014081227702,0.35135135135135137,16159,16106,Estill+Madison+Rockcastle,Rockcastle,21,203,Kentucky,KY
21205,21CS004,153,196,251,230,-21,34,77,11,-155.3751612169031,111.67589712464911,320.46127000986263,0.25,180,238,310,328,18,90,148,45,-108.6860808855903,181.1434681426505,414.6172715265111,0.4891304347826087,24714,24842,Bath+Clark+Montgomery+Rowan,Rowan,21,205,Kentucky,KY
21207,21CS001,168,216,273,272,-1,56,104,33,-226.80106729914024,156.75956122146457,473.94752445893835,0.55,203,262,339,310,-29,48,107,35,-353.2895666732933,68.94800286364038,397.1404964945686,0.5737704918032787,17989,18130,Adair and Nearby Counties,Russell,21,207,Kentucky,KY
21209,21CS043,296,371,466,389,-77,18,93,23,-208.80113478877598,-10.434839319778911,146.08775047690477,0.3333333333333333,354,457,586,559,-27,102,205,51,-134.24728318028173,87.72083846501434,264.8825318355335,0.4415667166416791,57500,58139,Scott+Woodford,Scott,21,209,Kentucky,KY
21211,21CS028,261,328,415,416,1,88,155,39,-94.47291546241371,121.66025907117668,288.0120418827856,0.417124227865477,310,399,517,508,-9,109,198,77,-177.71627869753897,66.08856383871293,250.10390877712905,0.6470588235294118,48331,48420,Henry+Shelby,Shelby,21,211,Kentucky,KY
21213,21CS035,151,195,249,222,-27,27,71,24,-314.3095589651409,18.488797586184756,289.6578288502279,0.5714285714285714,182,240,310,265,-45,25,83,55,-507.77243708354393,-152.2556033234015,142.10522976850805,1.0576923076923077,19471,19704,Logan+Simpson+Todd,Simpson,21,213,Kentucky,KY
21215,21CS012,109,130,154,157,3,27,48,12,-53.62598994499832,92.62779534712904,223.7518787124847,0.4297628127561797,130,160,191,213,22,53,83,26,-20.136255327717556,135.9197234620935,286.94163841997516,0.49056603773584906,19562,19865,Bullitt+Spencer,Spencer,21,215,Kentucky,KY
21217,21CS001,212,268,341,311,-30,43,99,28,-267.6837280856383,69.22855036697541,327.68180507035026,0.49122807017543857,253,331,428,447,19,116,194,66,-179.36435371986246,190.81314225517283,488.67245731549747,0.5454545454545454,26001,26204,Adair and Nearby Counties,Taylor,21,217,Kentucky,KY
21219,21CS035,97,117,137,121,-16,4,24,13,-286.16939752894297,-85.41741838033018,107.30448160233806,0.7467383576459049,118,143,172,184,12,41,66,20,-65.12393050055542,170.95031756395795,374.46260037819366,0.4878048780487805,12286,12284,Logan+Simpson+Todd,Todd,21,219,Kentucky,KY
21221,21CS036,120,140,163,196,33,56,76,3,255.90578897892652,450.8804610937462,618.0016086207346,0.053348106942916376,143,171,201,258,57,87,115,25,225.41405280826876,437.42320106768886,634.9691628401936,0.28735632183908044,14168,14174,Lyon and Nearby Counties,Trigg,21,221,Kentucky,KY
21223,21CS040,72,88,108,98,-10,10,26,11,-293.01422727693813,-13.730880226867944,207.36843618777093,0.7351563191582673,87,110,135,147,12,37,60,25,-152.58327892663533,140.84610362458645,410.8011355717105,0.6756756756756757,8478,8520,Owen and Nearby Counties,Trimble,21,223,Kentucky,KY
21225,21CS027,119,140,162,142,-20,2,23,13,-287.4844818685449,-93.88940173664518,85.3653020891879,0.5704710794677502,141,170,198,245,47,76,104,40,51.25793991020643,261.82113191544283,472.01556176305183,0.5298245614035088,13759,13559,Henderson+Union,Union,21,225,Kentucky,KY
21227,21CS020,740,910,1147,1081,-66,171,341,95,-143.35572236569942,67.62901862068998,218.90445500907543,0.46116504854368934,883,1125,1425,1336,-89,211,453,158,-180.45049612471297,38.720146941740026,215.62738433687858,0.5984848484848485,134853,136880,Edmonson+Warren,Warren,21,227,Kentucky,KY
21229,21CS038,98,117,138,150,12,33,52,27,-150.7130030467593,62.339638423196526,250.8092828004652,0.81191688315081,116,141,169,151,-18,10,35,18,-298.3837546622462,-66.3075010360547,140.90343970161626,0.9,12040,12065,Marion+Nelson+Washington,Washington,21,229,Kentucky,KY
21231,21CS018,153,195,250,258,8,63,105,26,-109.98733363461035,226.08507469336573,482.7221865074565,0.4,182,236,310,334,24,98,152,46,-112.59964428748737,266.1446137704247,542.5255588397118,0.46464646464646464,19639,19538,Clinton+Cumberland+McCreary+Wayne,Wayne,21,231,Kentucky,KY
21233,21CS029,111,131,154,174,20,43,63,23,-25.762315337055252,187.6984270184544,370.3386343814574,0.5314468937808438,128,155,184,205,21,50,77,28,-54.5227957212587,171.3573579810988,381.65957004881096,0.56,12964,12839,Hopkins+Webster,Webster,21,233,Kentucky,KY
21235,21CS033,336,425,534,474,-60,49,138,25,-278.35162256436365,78.54719507989098,369.8263768344867,0.30304143402879813,402,516,661,635,-26,119,233,108,-363.39247606853246,29.808480512705867,338.7327330989303,0.8120300751879699,36666,36902,Knox+Whitley,Whitley,21,235,Kentucky,KY
21237,21CS045,70,87,105,102,-3,15,32,5,-148.949604747437,178.1922560765672,490.46403231766226,0.29590292705030374,83,105,129,164,35,59,81,11,368.46195918132355,736.9239183626471,1074.6807142788605,0.1864406779661017,6635,6514,Wolfe and Nearby Counties,Wolfe,21,237,Kentucky,KY
21239,21CS043,171,219,277,237,-40,18,66,3,-191.99032606884148,66.9733695588982,281.2881521473724,0.07142857142857142,202,267,348,301,-47,34,99,31,-288.3728883271369,11.09126493565911,251.58685962386733,0.5344827586206896,26876,27048,Scott+Woodford,Woodford,21,239,Kentucky,KY
22001,22CS001,416,522,647,770,123,248,354,134,-22.810703914210414,235.33214897918444,454.1497611878998,0.5392375955434642,489,635,806,882,76,247,393,83,-12.301012761573725,286.15121885079316,540.9828378334659,0.32936507936507936,58131,57312,Acadia +Jefferson Davis,Acadia,22,1,Louisiana,LA
22003,22CS002,159,204,259,320,61,116,161,53,41.52529771962313,327.0117195420322,560.5915192149123,0.45689655172413796,189,246,317,339,22,93,150,39,-74.92796447532979,238.00647539222402,489.2355327506827,0.4083881578947368,23118,22688,Allen+Evangeline,Allen,22,3,Louisiana,LA
22005,22CS003,514,643,806,841,35,198,327,116,-76.4745269310613,77.41865689317318,199.30583500181524,0.5714285714285714,606,789,1010,1009,-1,220,403,115,-90.50690204529668,81.92435098927717,224.74580288058368,0.48832491886043994,127101,128167,Ascension,Ascension,22,5,Louisiana,LA
22007,22CS004,139,176,228,226,-2,50,87,24,-148.02221914721173,145.17563800976535,358.6692233182438,0.4528301886792453,162,213,276,325,49,112,163,31,86.83198914600136,390.7439511570061,636.7679204040099,0.2743362831858407,21078,20730,Assumption+St.James+St.John the Baptist,Assumption,22,7,Louisiana,LA
22009,22CS005,324,406,508,526,18,120,202,71,-160.3932492767908,146.77495452687458,396.4436916086716,0.5725806451612904,383,490,627,627,-0,138,244,75,-191.00863844308662,159.06782015580166,430.1193857012876,0.5172413793103449,39653,39291,Avoyelles+East Feliciana+Pointe Coupee+West Feliciana,Avoyelles,22,9,Louisiana,LA
22011,22CS006,251,317,395,423,28,106,172,54,-84.94173017728522,169.88346035457045,385.5047754199868,0.5,295,382,496,468,-28,86,173,75,-281.6928679835189,30.069107693534285,267.88841399694184,0.7425742574257426,36731,36582,Beauregard +Vernon,Beauregard,22,11,Louisiana,LA
22013,22CS007,130,153,178,223,45,70,93,44,13.131788023955131,241.9475670260018,455.50896076124525,0.6278537423654534,154,183,214,264,50,81,110,30,156.32404019481885,398.62630249678807,625.2961607792754,0.37037037037037035,12935,12794,Bienville+Natchitoches+Red River,Bienville,22,13,Louisiana,LA
22015,22CS008,736,920,1143,1132,-11,212,396,169,-168.20043262268868,39.69193995815808,212.09504857641636,0.7347826086956522,887,1128,1451,1379,-72,251,492,142,-165.80554425201797,84.45235665172878,271.21603161410695,0.49220251826220685,128490,129067,Bossier,Bossier,22,15,Louisiana,LA
22017,22CS009,1813,2248,2820,3042,222,794,1229,463,-121.95570864836026,167.75235442710135,387.7280662505129,0.5765877957658779,2136,2699,3452,3398,-54,699,1262,409,-197.97142766457407,124.10660186495133,365.1301817626774,0.536745406824147,237135,233670,Caddo,Caddo,22,17,Louisiana,LA
22019,22CS010,1451,1792,2235,2226,-9,434,775,269,-156.45739285308534,92.76130011052493,284.5523154602556,0.5809935205183585,1648,2094,2673,2454,-219,360,806,327,-263.6708307346925,15.707638161263876,231.50642089985834,0.7024712723245189,213451,206906,Calcasieu,Calcasieu,22,19,Louisiana,LA
22021,22CS012,86,103,123,125,2,22,39,23,-264.87148172965817,-9.550209464647379,195.21745089189073,0.9976860766520618,101,124,149,158,9,34,57,16,-73.0863767863746,187.93639745067756,428.0773497487655,0.45714285714285713,9660,9578,Catahoula and Nearby Parishes,Caldwell,22,21,Louisiana,LA
22023,22CS011,27,37,48,61,13,24,34,3,214.84636192429542,437.4549441241469,642.9397892317019,0.12498318165002584,29,42,56,52,-4,10,23,5,-174.46579945317893,96.92544414065496,348.93159890635786,0.38461538461538464,5761,5159,Cameron +Vermilion,Cameron,22,23,Louisiana,LA
22025,22CS012,73,90,109,140,31,50,67,22,127.18406244557004,369.9429869669761,601.6674149192276,0.4438754765192857,86,107,131,147,16,40,61,25,-102.1233139015361,170.20552316922684,408.4932556061444,0.625,8941,8813,Catahoula and Nearby Parishes,Catahoula,22,25,Louisiana,LA
22027,22CS013,123,146,169,202,33,56,79,40,-61.97521195225528,131.05702653984804,330.6268987776733,0.7186848466106794,147,176,207,202,-5,26,55,23,-199.31160382073227,21.35481469507846,227.7846900808369,0.7931034482758621,14336,14048,Claiborne+Webster,Claiborne,22,27,Louisiana,LA
22029,22CS012,154,199,253,258,5,59,104,43,-244.20885390981857,102.82478059360781,392.01947601312975,0.6935483870967742,180,237,306,295,-11,58,115,30,-222.74059209610442,152.11552630953474,461.77927629680187,0.46875,18673,18407,Catahoula and Nearby Parishes,Concordia,22,29,Louisiana,LA
22031,22CS014,198,254,321,310,-11,56,112,53,-285.23471512325085,13.359939818419242,262.96814875921854,0.828125,235,309,398,376,-22,67,141,57,-293.7621984783886,37.16156843496377,312.15717485369566,0.7402597402597403,26946,26910,De Soto+Sabine,De Soto,22,31,Louisiana,LA
22033,22CS015,2699,3347,4146,4176,30,829,1477,522,-130.21014739285795,81.232504063416755,252.74686606311298,0.5938566552901023,3211,4054,5187,5069,-118,1015,1858,538,-144.596046504932,105.14072283971426,290.97750151091566,0.4928997827714602,453513,453678,East Baton Rouge,East Baton Rouge,22,33,Louisiana,LA
22035,22CS024,65,81,97,82,-15,1,17,19,-560.9409452659695,-289.4197689615664,-31.440795964116596,1.0163463247534854,78,100,124,116,-8,16,38,19,-372.7340444807464,-41.41489383119404,262.29432759756224,0.9047619047619048,7285,7244,Northeast Louisiana,East Carroll,22,35,Louisiana,LA
22037,22CS005,168,215,274,278,4,63,110,67,-389.9222798762581,-24.75697015087353,266.1374291218905,1.0307692307692307,199,264,343,293,-50,29,94,38,-454.6751128883817,-46.50086381812995,289.33870820169744,0.6440677966101694,19388,19354,Avoyelles+East Feliciana+Pointe Coupee+West Feliciana,East Feliciana,22,37,Louisiana,LA
22039,22CS002,246,312,395,416,21,104,170,57,-133.10233846995214,173.77249744688197,417.97831566744685,0.5428571428571428,291,379,487,490,3,111,199,78,-232.86902604068354,102.39410871875492,375.44506530210134,0.6554621848739496,32456,32228,Allen+Evangeline,Evangeline,22,39,Louisiana,LA
22041,22CS024,170,222,285,286,1,64,116,55,-328.0085376707851,57.70520570134181,370.5281629244053,0.8208955223880597,204,267,347,314,-33,47,110,46,-401.5098974519157,5.0824037652141225,325.27384097370384,0.7301587301587301,19756,19676,Northeast Louisiana,Franklin,22,41,Louisiana,LA
22043,22CS016,145,186,235,235,-0,49,90,38,-205.92922216542888,59.5327580504525,281.42758351123,0.7307692307692307,175,227,294,282,-12,55,107,33,-202.51664433670643,99.00813723127871,333.25238918073563,0.5238095238095238,22173,22220,Grant+Jackson+Winn,Grant,22,43,Louisiana,LA
22045,22CS017,494,616,767,802,35,186,308,81,-79.35757130791538,181.80724805613622,391.18715932457746,0.421875,583,752,954,928,-26,176,345,100,-182.38566969738093,110.01040394445198,354.7111774551047,0.5025125628140703,69634,69084,Iberia,Iberia,22,45,Louisiana,LA
22047,22CS018,205,260,327,393,66,133,188,56,39.44170809986148,303.7011523689334,520.6305469181715,0.4194815396700707,238,312,407,435,28,123,197,54,-87.0627416810783,231.05112215363084,478.8450792459306,0.432,30425,29864,Iberville+West Baton Rouge,Iberville,22,47,Louisiana,LA
22049,22CS016,121,154,197,200,3,46,79,17,-111.73101057418702,230.6191677331975,493.0478758433877,0.3469387755102041,139,185,243,224,-19,39,85,16,-235.01795509198575,154.44037048901922,463.3211114670576,0.32653061224489793,15090,14892,Grant+Jackson+Winn,Jackson,22,49,Louisiana,LA
22051,22CS019,2969,3668,4534,4495,-39,827,1526,592,-172.76004427814473,64.32991666196168,255.70457512314212,0.6588761083212973,3547,4436,5638,5112,-526,676,1565,415,-216.57398664427814,60.05717224198534,264.67725046491813,0.45704845814977973,438365,434586,Jefferson,Jefferson,22,51,Louisiana,LA
22053,22CS001,265,338,429,365,-64,27,100,56,-449.0738786433901,-108.48098692759945,164.77887841933625,0.9491525423728814,321,417,537,515,-22,98,194,66,-272.7506547704612,99.01328363760365,396.0531345504146,0.5892857142857143,32079,32319,Acadia +Jefferson Davis,Jefferson Davis,22,53,Louisiana,LA
22055,22CS020,1220,1524,1890,1930,40,406,710,134,-46.56266917265796,134.51987270273995,284.8656127822728,0.3156659267480577,1472,1868,2386,2416,30,548,944,184,-63.32928228436448,149.45628612917358,311.7260398620142,0.3205574912891986,242641,243884,Lafayette,Lafayette,22,55,Louisiana,LA
22057,22CS021,610,765,954,953,-1,188,343,132,-163.79207574306733,68.9132700346489,259.71688644308307,0.6550908822225506,723,933,1194,1215,21,282,492,150,-132.35532610319075,135.380883732051,350.75956239667755,0.5050505050505051,97514,97503,Lafourche,Lafourche,22,57,Louisiana,LA
22059,22CS012,115,135,157,175,18,40,60,25,-56.89609000188265,122.74126388182427,282.4189117784525,0.6099126524170629,136,164,193,199,6,35,63,19,-87.6554690550909,107.88365422165035,297.01718552898086,0.5277777777777778,14829,14831,Catahoula and Nearby Parishes,La Salle,22,59,Louisiana,LA
22061,22CS022,265,337,429,437,8,100,172,68,-149.8672400013703,79.9291946673975,259.89477203570954,0.6476190476190476,318,411,529,490,-39,79,172,33,-149.47805946683565,95.49987132603388,288.57569813736325,0.34375,48043,48168,Lincoln+Union,Lincoln,22,61,Louisiana,LA
22063,22CS023,752,940,1167,1142,-25,202,390,119,-121.02511251837757,69.70912102030077,227.68846636871723,0.5384615384615384,910,1162,1475,1590,115,428,680,250,-92.86179413572037,122.78392780167472,295.81640420790035,0.5701261688561592,142879,145377,Livingston,Livingston,22,63,Louisiana,LA
22065,22CS024,82,100,119,118,-1,18,36,18,-228.95579456615195,-3.6033046637729345,211.95125089502432,0.8926757763995036,97,120,144,147,3,27,50,32,-295.8951549927002,-50.92859810545615,183.34295317964214,1.103448275862069,10069,9818,Northeast Louisiana,Madison,22,65,Louisiana,LA
22067,22CS024,247,314,400,405,5,91,158,44,-185.4426346133894,222.91058380637605,540.6767351899334,0.4583333333333333,292,380,489,505,16,125,213,62,-183.5827031606224,251.1554896659981,601.9758561835828,0.4732824427480916,25302,25084,Northeast Louisiana,Morehouse,22,67,Louisiana,LA
22069,22CS007,260,335,417,424,7,89,164,51,-141.19949002391277,121.80659752346617,362.37462763231173,0.5425531914893617,308,401,516,533,17,132,225,72,-148.3555295308987,161.84239585188948,412.96784674873777,0.5294117647058824,37436,37073,Bienville+Natchitoches+Red River,Natchitoches,22,69,Louisiana,LA
22071,22CS025,2241,2782,3474,3765,291,982,1524,548,-80.46897676813973,135.86077484265283,305.17863347854814,0.5499248750266865,2645,3358,4271,4069,-202,710,1424,261,-122.58814468554536,118.94953272779847,307.81334030917725,0.3208369851007888,383775,377891,Orleans,Orleans,22,71,Louisiana,LA
22073,22CS026,1121,1403,1742,1726,-16,323,605,274,-219.02748580676752,37.00171282376007,250.02585950912152,0.7795179357679358,1342,1704,2188,2054,-134,350,712,282,-261.7520996436337,42.46669084471884,270.59146270094186,0.6886457153080088,158912,158948,Ouachita,Ouachita,22,73,Louisiana,LA
22075,22CS027,125,160,205,209,4,50,84,20,-81.98274412683841,151.1556844838583,327.93097650735365,0.38461538461538464,147,194,255,223,-32,29,76,20,-223.13418506097696,38.58227983763291,240.28186498881362,0.4444444444444444,23420,23327,Plaquemines+St. Bernard,Plaquemines,22,75,Louisiana,LA
22077,22CS005,162,208,264,281,17,73,119,45,-161.4852477498901,161.4852477498901,426.78244048185235,0.6,191,247,323,327,4,80,136,27,-112.96493125005742,259.74582890468736,534.1942518983193,0.3253012048192771,20807,20405,Avoyelles+East Feliciana+Pointe Coupee+West Feliciana,Pointe Coupee,22,77,Louisiana,LA
22079,22CS028,1020,1257,1554,1626,72,369,606,211,-128.95269360707988,146.3687183183809,366.0144342252676,0.5611702127659575,1203,1529,1945,1973,28,444,770,241,-165.65343963657435,157.6172873036072,410.9307847558329,0.5210816900881696,129536,128793,Rapides,Rapides,22,79,Louisiana,LA
22081,22CS007,69,86,102,139,37,53,70,27,155.54498335687427,411.63379365955467,667.0839785001339,0.5047073045023952,83,103,126,135,9,32,52,19,-132.0651411308628,171.68468347012166,435.8149657318472,0.5757575757575758,7724,7572,Bienville+Natchitoches+Red River,Red River,22,81,Louisiana,LA
22083,22CS024,151,194,250,250,0,56,99,45,-270.01518835434496,66.00371270883987,324.31824290116293,0.7627118644067796,178,235,305,303,-2,68,125,42,-221.8524681087077,131.09464024605455,418.7465335551856,0.5675675675675675,19999,19833,Northeast Louisiana,Richland,22,83,Louisiana,LA
22085,22CS014,172,220,278,339,61,119,167,48,69.44035867092167,380.7154799718484,638.3687026851909,0.40336134453781514,203,268,345,374,29,106,171,51,-99.62715122260698,250.76221736302443,542.188578082215,0.4722222222222222,22379,22133,De Soto+Sabine,Sabine,22,85,Louisiana,LA
22087,22CS027,237,298,372,379,7,80,142,42,-94.65668639620021,104.12235503582022,270.4476754177149,0.5,286,362,468,489,21,128,203,47,-58.827854989337446,182.14008948621787,353.1933909167527,0.3560606060606061,44371,44197,Plaquemines+St. Bernard,St. Bernard,22,87,Louisiana,LA
22089,22CS029,287,364,459,463,4,99,176,57,-121.14623636218745,95.91219466940383,271.75121822997755,0.5377358490566038,335,440,569,502,-67,62,167,43,-210.3763188843651,35.36539663208318,237.13932174107663,0.45027412280701756,52548,52311,St. Charles,St. Charles,22,89,Louisiana,LA
22091,22CS030,88,109,128,136,8,27,48,5,30.08566514050267,250.1310265819628,478.86840853774265,0.17668911843708632,109,132,160,172,12,40,63,19,-64.62763671781745,192.50785405307332,403.34978944453457,0.4634146341463415,10783,10909,St. Helena +Tangipahoa +Washington,St. Helena,22,91,Louisiana,LA
22093,22CS004,126,165,212,210,-2,45,84,38,-237.67639916463787,41.541443049999124,272.9866257571371,0.76,148,196,254,254,0,58,106,21,-106.07053901301785,186.88618778484096,429.3331341003103,0.341485986250661,20221,19798,Assumption+St.James+St.John the Baptist,St. James,22,93,Louisiana,LA
22095,22CS004,274,348,436,440,4,92,166,91,-246.2200860136062,1.4142451810086512,212.27820166939844,0.9479166666666666,325,423,539,476,-63,53,151,43,-251.55590889404394,23.73168951830603,256.30224679770515,0.48863636363636365,42425,42138,Assumption+St.James+St.John the Baptist,St. John the Baptist,22,95,Louisiana,LA
22097,22CS031,688,856,1076,1109,33,254,421,168,-196.98268928488645,124.75570321376142,369.16015103019464,0.6363636363636364,820,1043,1335,1249,-86,206,429,122,-253.34815934340605,102.31367973483705,373.9321390308926,0.49493104242783315,82241,82100,St. Landry,St. Landry,22,97,Louisiana,LA
22099,22CS032,322,408,509,580,71,172,258,82,-25.56223626192456,208.19920937314126,407.26078677935004,0.47398843930635837,387,495,637,631,-6,136,244,62,-132.10646112461848,143.5518079768248,353.1568465159587,0.4189189189189189,51873,51549,St. Martin,St. Martin,22,99,Louisiana,LA
22101,22CS033,365,463,571,589,18,126,224,87,-168.7458444043073,95.37808596765196,335.1683764581204,0.6590909090909091,434,550,720,717,-3,166,283,112,-238.19164571749545,112.68615183683596,353.6691059025832,0.6363636363636364,49068,48364,St. Mary,St. Mary,22,101,Louisiana,LA
22103,22CS034,1635,2015,2487,2355,-132,340,720,259,-177.2130094200335,36.69756810180932,208.9043043425219,0.6379310344827587,1980,2500,3180,2956,-224,456,976,307,-197.47835545406272,55.25821704339235,248.996874980377,0.5472370766488414,264868,268738,St. Tammany,St. Tammany,22,103,Louisiana,LA
22105,22CS030,858,1079,1340,1323,-17,244,465,155,-154.1761645262645,79.75401710454832,277.7948910383144,0.5816155557432908,1035,1317,1681,1774,93,457,739,286,-142.99076672315914,126.69130108632234,335.65785939858677,0.609159370321644,133912,134974,St. Helena +Tangipahoa +Washington,Tangipahoa,22,105,Louisiana,LA
22107,22CS012,37,49,63,71,8,22,34,4,107.13625000455644,512.4496687374265,870.0791558546649,0.1845787010726579,44,60,78,85,7,25,41,2,123.34575356546317,567.3904664011307,962.0968778106128,0.08,4138,4054,Catahoula and Nearby Parishes,Tensas,22,107,Louisiana,LA
22109,22CS035,687,872,1093,1054,-39,182,367,116,-170.0042011455974,72.36554192589118,275.2631712196209,0.5686274509803921,828,1055,1358,1393,35,338,565,171,-125.0492842085066,153.49673254553917,362.1419917541463,0.48717948717948717,109444,108797,Terrebonne,Terrebonne,22,109,Louisiana,LA
22111,22CS022,175,224,284,351,67,128,176,52,84.67309228289045,426.1878978238819,700.2464731795037,0.40625,209,270,350,350,0,80,141,34,-161.1694263968264,220.4228919838949,507.2096654253066,0.3953488372093023,21258,21096,Lincoln+Union,Union,22,111,Louisiana,LA
22113,22CS011,373,479,599,639,40,160,266,65,-52.07137394297823,197.87122098331724,418.7579892494308,0.4012345679012346,446,576,745,778,33,202,332,84,-89.22267692062336,206.23459111916856,433.529579043303,0.40288001472212,57613,57216,Cameron +Vermilion,Vermilion,22,113,Louisiana,LA
22115,22CS006,275,348,439,463,24,115,188,63,-96.50127048837014,128.66836065116019,309.2989438729812,0.5338983050847458,329,421,546,490,-56,69,161,75,-272.40826942539366,-12.471954342253813,178.764678905638,0.8241758241758241,48497,48108,Beauregard +Vernon,Vernon,22,115,Louisiana,LA
22117,22CS030,400,509,642,630,-12,121,230,79,-240.34194724234692,110.86613711343844,398.85412661525095,0.5939849624060151,483,618,784,758,-26,140,275,110,-301.3224368704864,67.52633596289371,365.3064076681136,0.6896619496855345,45460,45168,St. Helena +Tangipahoa +Washington,Washington,22,117,Louisiana,LA
22119,22CS013,328,410,529,564,35,154,236,77,-136.19436070225214,249.6896612874623,515.5929369442404,0.4967741935483871,380,491,634,698,64,207,318,74,-27.560990174507005,366.5611693209431,672.4881602579709,0.3523809523809524,37006,36283,Claiborne+Webster,Webster,22,119,Louisiana,LA
22121,22CS018,142,185,237,249,12,64,107,40,-123.55723485527531,105.90620130452169,295.65481197512304,0.6153846153846154,172,229,294,285,-9,56,113,26,-126.30401376112302,108.26058322381972,313.9556913490772,0.40625,27194,27711,Iberville+West Baton Rouge,West Baton Rouge,22,121,Louisiana,LA
22123,22CS024,89,107,128,156,28,49,67,35,-88.29889158457541,171.84539873670803,391.9674905470248,0.7125343202746236,105,129,156,159,3,30,54,17,-146.22342870523744,135.29569915787098,385.0723745262482,0.5483870967741935,9860,9609,Northeast Louisiana,West Carroll,22,123,Louisiana,LA
22125,22CS005,99,120,139,149,10,29,50,26,-124.82959646279666,23.22266048464679,190.5860813817566,0.8976030439885706,124,149,176,168,-8,19,44,14,-142.30923689366966,32.34300838492492,194.05805030954954,0.6086956521739131,15327,15459,Avoyelles+East Feliciana+Pointe Coupee+West Feliciana,West Feliciana,22,125,Louisiana,LA
22127,22CS016,128,152,177,210,33,58,82,29,36.67312185687721,252.5727002802961,460.9283666456591,0.5008448219410815,156,187,220,211,-9,24,55,21,-221.8610133193643,22.18610133193643,251.4424817619462,0.75,13732,13522,Grant+Jackson+Winn,Winn,22,127,Louisiana,LA
23001,23CS001,841,1044,1303,1032,-271,-12,191,23,-319.06604675753675,-37.41597081283146,182.41641422371728,-0.07783440219880898,1013,1290,1660,1480,-180,190,467,150,-297.24934034340225,36.47507433391242,285.67638465967934,0.5607496226731511,110648,111035,Androscoggin,Androscoggin,23,1,Maine,ME
23003,23CS002,582,716,901,796,-105,80,214,21,-225.69108097930075,105.68074426808526,345.7909776432857,0.16030534351145037,686,867,1119,1107,-12,240,421,94,-158.4959334018031,218.30571959116273,489.01976433075174,0.3643410852713178,66994,66879,Aroostook,Aroostook,23,3,Maine,ME
23005,23CS003,1906,2356,2930,2469,-461,114,563,106,-224.9803017010004,2.975667512137383,181.3966915398948,0.2560386473429952,2289,2882,3680,3102,-578,220,813,171,-245.6295082784777,15.90418683867054,210.54192081996743,0.3114795435920066,302453,304951,Cumberland,Cumberland,23,5,Maine,ME
23007,23CS004,230,294,368,285,-83,-9,55,2,-345.3225231960671,-44.688797119491035,215.52188065354522,-0.02684684684684685,272,357,460,410,-50,53,138,40,-303.5641381132505,43.84815328302508,330.54761705665055,0.5063291139240507,29538,29648,Franklin+Oxford,Franklin,23,7,Maine,ME
23009,23CS005,420,531,666,575,-91,44,155,27,-255.31934067436012,36.76771530253386,276.83926816025496,0.2903225806451613,506,653,839,753,-86,100,247,44,-231.8791482609064,99.84799925114001,362.03814728471383,0.310957946259115,55483,56085,Hancock+Washington,Hancock,23,9,Maine,ME
23011,23CS006,906,1133,1409,1193,-216,60,287,34,-242.74812788448037,25.24075714855625,245.7090628576763,0.1654511011129529,1082,1379,1762,1629,-133,250,547,124,-206.74670413272307,101.30307105083845,340.1692806476964,0.3980748619012284,123610,124379,Kennebec,Kennebec,23,11,Maine,ME
23013,23CS007,336,429,543,390,-153,-39,54,1,-456.0015787136772,-118.40352579387917,156.8846716768899,-0.0125,401,523,673,539,-134,16,138,19,-373.03671902421235,-7.314445471062988,290.3834852012004,0.15966386554621848,40539,41015,Knox+Waldo,Knox,23,13,Maine,ME
23015,23CS008,282,354,447,384,-63,30,102,3,-225.1003199224086,92.08649451371262,337.8210104290085,0.047619047619047616,337,439,562,453,-109,14,116,18,-355.95105672969964,-11.193429456908794,274.23902169426543,0.17391710231516055,35184,35735,Lincoln+Sagadahoc,Lincoln,23,15,Maine,ME
23017,23CS004,459,580,719,608,-111,28,149,32,-296.5982421985966,-7.249258712954526,242.33236269019415,0.297680858428522,553,712,920,849,-71,136,296,91,-276.93635419826455,77.75750765826004,350.42147132585086,0.5260115606936416,57937,58515,Franklin+Oxford,Oxford,23,17,Maine,ME
23019,23CS009,1137,1418,1763,1529,-234,111,392,34,-211.5361376701332,60.76583697295378,282.52168358853834,0.13765182186234817,1361,1744,2227,1999,-228,256,638,211,-287.77410420647715,29.150802725217925,279.8149524511648,0.5672043010752689,152059,152654,Penobscot+Piscataquis,Penobscot,23,19,Maine,ME
23021,23CS009,161,209,269,203,-66,-6,42,3,-492.1047059741244,-64.187570344451,278.14613815928766,-0.04959016393442623,196,258,333,302,-31,44,106,36,-391.65015508907726,46.76419762257639,409.1867291975434,0.5950819672131147,16826,17107,Penobscot+Piscataquis,Piscataquis,23,21,Maine,ME
23023,23CS008,245,314,394,302,-92,-12,57,6,-321.16061101311215,-57.32086377082572,167.2131483143229,-0.07692307692307693,298,383,489,437,-52,54,139,21,-197.21656731731997,89.1526948146789,318.9235037234194,0.25,36636,37015,Lincoln+Sagadahoc,Sagadahoc,23,23,Maine,ME
23025,23CS010,413,516,645,559,-86,42,146,19,-249.7672961400673,55.87369309178087,302.07458328981954,0.2,496,629,797,774,-23,145,278,65,-174.1337398541469,158.21350583000287,421.44122615466995,0.3939393939393939,50471,50565,Somerset,Somerset,23,25,Maine,ME
23027,23CS007,284,361,455,388,-67,27,104,20,-263.09585998881715,21.168632412893334,254.02358895472003,0.3076923076923077,343,443,572,529,-43,86,186,32,-188.2291961123126,135.4347313799451,386.36519202001,0.2962962962962963,39681,39872,Knox+Waldo,Waldo,23,27,Maine,ME
23029,23CS005,282,357,452,429,-23,72,147,8,-119.80394402879342,246.9388862429237,536.3203935588499,0.09581181870338497,338,435,561,530,-31,95,192,38,-221.93726375138525,183.20672025820363,494.9795599958484,0.3486238532110092,31101,31112,Hancock+Washington,Washington,23,29,Maine,ME
23031,23CS011,1494,1851,2308,1901,-407,50,407,82,-277.2041139294993,-18.134583759059545,184.23603687719552,0.22282608695652173,1806,2273,2919,2367,-552,94,561,176,-340.0378922038571,-38.277310948886374,179.7166428697714,0.38054454334654797,211750,214226,York,York,23,31,Maine,ME
24001,24CS001,582,726,908,995,87,268,413,161,-130.1014572236799,188.87112291081147,442.83689795041875,0.5940959409594095,677,869,1111,1055,-56,186,378,140,-289.69555279940033,67.88586565854516,351.2355657985597,0.6466547192353644,68301,67761,Allegany+Garrett,Allegany,24,1,Maryland,MD
24003,24CS002,3148,3864,4798,4228,-570,364,1080,356,-189.17765749320844,1.7357621855486525,147.91756930613718,0.524310676916136,3770,4742,6083,4995,-1088,252,1225,412,-254.1909826525599,-27.028974488722202,137.81387776146283,0.4437327456211576,587638,590107,Anne Arundel,Anne Arundel,24,3,Maryland,MD
24005,24CS004,5868,7212,8943,8384,-559,1172,2516,889,-204.682961677322,39.924695625107695,229.96624680062018,0.6208148997760664,6980,8758,11166,9467,-1699,709,2486,863,-301.41296889524,-18.12054856724975,191.03058830473998,0.4998552403011002,849099,849864,Baltimore (county),Baltimore (county),24,5,Maryland,MD
24009,24CS005,488,609,762,711,-51,102,223,52,-132.98926366340947,64.55789498223761,220.917116629217,0.41602662570404503,588,750,956,860,-96,110,272,61,-167.5876746010428,52.25450878428953,225.0143133364304,0.37423312883435583,92940,93772,Calvert,Calvert,24,9,Maryland,MD
24011,24CS006,222,283,360,347,-13,64,125,15,-100.98422871457743,176.4073870593331,396.0165831944213,0.2054794520547945,265,344,442,436,-6,92,171,58,-191.7775380558552,101.88181709217308,338.60721562986936,0.5771287128712871,33332,33372,Caroline+Dorchester+Talbot,Caroline,24,11,Maryland,MD
24013,24CS007,1134,1408,1744,1557,-187,148,423,178,-254.10670415548464,-20.534578201853982,170.61102092455627,0.6966758578431372,1345,1727,2209,1887,-322,160,542,132,-261.3255773488093,16.11699595983846,236.02764976184858,0.3815028901734104,172392,173730,Carroll,Carroll,24,13,Maryland,MD
24015,24CS008,702,875,1085,1040,-45,165,338,93,-159.748897114017,83.3472506681828,283.61217241256645,0.4744897959183674,839,1076,1367,1248,-119,172,409,144,-253.22258956317177,26.472614381247762,255.14787060908066,0.6037762385288843,103663,103881,Cecil,Cecil,24,15,Maryland,MD
24017,24CS009,805,999,1234,1223,-11,224,418,153,-118.261269186537,51.18287176009831,191.07070647907116,0.6206922089463809,961,1236,1581,1476,-105,240,515,160,-157.38937317403386,47.50480986199853,210.8619747749459,0.5517241379310345,166462,168404,Charles,Charles,24,17,Maryland,MD
24019,24CS006,271,349,440,379,-61,30,108,27,-325.9893262612154,11.106961712477526,299.88796623689325,0.39705882352941174,327,427,546,493,-53,66,166,57,-338.70114548234966,27.69932130250929,335.46955799705694,0.5816326530612245,32412,32492,Caroline+Dorchester+Talbot,Dorchester,24,19,Maryland,MD
24021,24CS010,1356,1677,2088,1873,-215,196,517,189,-178.49327977291773,3.0915574870974245,144.8615508239936,0.63,1640,2076,2633,2209,-424,133,569,205,-225.71746131521758,-25.824975710623974,130.57753343684246,0.49219758808337943,271708,278800,Frederick,Frederick,24,21,Maryland,MD
24023,24CS001,224,285,360,376,16,91,152,49,-137.51502081028815,175.0191173949122,429.2135498018085,0.5268817204301075,265,344,444,396,-48,52,131,56,-362.23549806292533,-13.932134540881743,261.40167432329355,0.7088607594936709,28797,28711,Allegany+Garrett,Garrett,24,23,Maryland,MD
24025,24CS011,1535,1896,2330,2163,-167,267,628,158,-149.75294765417232,50.209385709950105,216.52221791708297,0.4388888888888889,1826,2309,2935,2606,-329,297,780,231,-213.20372522851272,25.123095634854202,209.11170586374467,0.5016292558709798,260509,262706,Harford,Harford,24,25,Maryland,MD
24027,24CS012,1214,1507,1864,1734,-130,227,520,178,-111.35119650691858,17.714963080646136,123.64321170573427,0.5993265993265994,1450,1853,2362,1994,-368,141,544,93,-137.92928936287728,14.359843594877148,134.9226971101999,0.26956521739130435,331923,334265,Howard,Howard,24,27,Maryland,MD
24029,24CS013,171,217,281,285,4,68,114,34,-187.53174365452483,212.5359761417948,500.08464974539953,0.4722222222222222,203,267,345,315,-30,48,112,23,-275.3056065380753,129.86113515946948,462.5653634380301,0.36507936507936506,19197,19251,Kent+Queen Anne's,Kent,24,29,Maryland,MD
24031,24CS014,4197,5236,6459,6588,129,1352,2391,1118,-112.1084247930229,26.56973633226931,144.26970265193395,0.7834618079887876,5009,6290,8009,7012,-997,722,2003,565,-147.92623847278807,14.870766409622364,136.24747733707824,0.4567513960912712,1059100,1055763,Montgomery,Montgomery,24,31,Maryland,MD
24033,24CS015,4518,5628,6951,7260,309,1632,2742,1249,-117.93053435280746,47.980034451894745,187.29774756038336,0.7342739564961788,5487,6896,8798,7624,-1174,728,2137,734,-199.44453726132127,-0.6270854810920337,146.67529402742665,0.5293906205946581,956648,956807,Prince George's,Prince George's,24,33,Maryland,MD
24035,24CS013,294,374,469,392,-77,18,98,27,-248.9448479796035,-21.532951771421732,170.1103189942315,0.36,354,458,600,523,-77,65,169,48,-246.94575637003877,33.544369622777936,238.75698378565474,0.4776237623762376,50156,50679,Kent+Queen Anne's,Queen Anne's,24,35,Maryland,MD
24037,24CS016,574,720,890,855,-35,135,281,88,-129.5500855785674,49.48276328478397,203.24781813037328,0.5448968637374434,693,879,1129,1051,-78,172,358,89,-146.07550476164116,72.55695329273617,235.19817208928512,0.4248234221918432,113979,114393,St. Mary's,St. Mary's,24,37,Maryland,MD
24039,24CS017,175,220,281,300,19,80,125,17,9.465740206220332,305.81622204711795,524.2563806522022,0.20987654320987653,204,268,347,312,-35,44,108,31,-268.6977768699896,52.88525509931665,313.2434340497986,0.49206349206349204,24721,24582,Somerset+Worcester,Somerset,24,39,Maryland,MD
24041,24CS006,303,394,495,458,-37,64,155,5,-134.63576217910472,189.13118972778997,480.84200778251693,0.058823529411764705,371,483,618,556,-62,73,185,52,-303.31472060405855,55.84926902836677,353.8450116297236,0.49290206648697216,37434,37601,Caroline+Dorchester+Talbot,Talbot,24,41,Maryland,MD
24043,24CS018,1153,1424,1768,1660,-108,236,507,143,-195.48472315969613,72.41616910516527,283.4353285406468,0.49310344827586206,1377,1755,2236,2025,-211,270,648,272,-311.8749175299707,-1.291273853762429,242.75948450733665,0.7272727272727273,154109,154886,Washington,Washington,24,43,Maryland,MD
24045,24CS019,693,863,1083,1033,-50,170,340,83,-154.1648309066446,100.76889773762643,297.6736404433333,0.41919191919191917,835,1059,1344,1255,-89,196,420,151,-231.21846234910495,43.30834882709563,258.98392598603175,0.6213991769547325,103603,103906,Wicomico,Wicomico,24,45,Maryland,MD
24047,24CS017,431,535,674,614,-60,79,183,53,-258.3362538782389,59.440200007382394,297.31530811384914,0.4732142857142857,507,657,851,744,-107,87,237,70,-333.85621130712815,32.056230399441844,314.90532215922286,0.5072463768115942,52490,53032,Somerset+Worcester,Worcester,24,47,Maryland,MD
24510,24CS003,4397,5408,6721,6749,28,1340,2352,684,-134.76832360889892,134.87104336774718,342.7347473730579,0.48822269807280516,5218,6587,8306,7538,-768,951,2320,604,-237.6159439839511,60.090174224706516,297.13465545666463,0.4429805499376049,584114,577465,Baltimore (city),Baltimore (city),24,510,Maryland,MD
25001,25CS001,2155,2670,3288,2625,-663,-44,470,197,-454.8620518751033,-127.67222864695194,144.37799438295056,-0.27746533914965116,2596,3261,4173,3312,-861,51,716,199,-457.1188740125663,-63.81812409570779,222.95379097084938,0.271121695341227,226988,231909,Barnstable+Dukes+Nantucket,Barnstable,25,1,Massachusetts,MA
25003,25CS002,1071,1344,1661,1386,-275,42,315,121,-370.7681379904638,-73.46112779467798,181.59403628735356,0.4662830412830413,1284,1634,2070,1760,-310,126,476,128,-340.7508415714861,-1.9429287351550126,270.45567993357776,0.3902439024390244,128231,128672,Berkshire,Berkshire,25,3,Massachusetts,MA
25005,25CS003,3809,4678,5802,5477,-325,800,1668,777,-229.09706553119094,4.677571664656802,185.25262712780784,0.805181347150259,4489,5688,7197,6249,-948,562,1760,669,-278.71484743611995,-18.533864963121918,188.0971783699164,0.6032481296910179,577223,580019,Bristol,Bristol,25,5,Massachusetts,MA
25007,25CS001,118,143,168,143,-25,-0,25,8,-194.56351642609053,-47.8946213514605,98.77427372316954,-0.18336783539764714,147,180,220,171,-49,-9,24,4,-252.1198282730981,-61.84071259528821,95.377406733502,-0.11428571428571428,20180,21022,Barnstable+Dukes+Nantucket,Dukes,25,7,Massachusetts,MA
25009,25CS004,4874,6028,7412,7072,-340,1044,2198,1242,-235.4965499292123,-29.47335222400306,142.3726653265036,0.9861057528650856,5800,7306,9332,7483,-1849,176,1683,631,-307.1700465700037,-56.29273045546125,130.29692505862525,0.4102732553690789,806152,807387,Essex,Essex,25,9,Massachusetts,MA
25011,25CS005,474,598,743,705,-38,107,231,70,-182.9955254476389,62.63491620316965,272.71581081974665,0.5426356589147286,570,728,918,717,-201,-10,147,26,-319.7389139192221,-51.40044200859549,170.4663974011091,-0.11555555555555555,70887,71011,Franklin,Franklin,25,11,Massachusetts,MA
25013,25CS006,3146,3887,4795,4817,22,930,1671,751,-188.15732720898808,46.213174492877144,237.53313515179653,0.757447663418306,3745,4702,5984,5148,-836,446,1403,448,-277.3318244558552,-0.4319305757985519,206.25764820820348,0.48748639825897716,464803,463037,Hampden,Hampden,25,13,Massachusetts,MA
25015,25CS007,895,1110,1380,1246,-134,136,351,149,-209.73852153052434,-10.003427100025009,149.71795893037424,0.7268292682926829,1073,1361,1738,1404,-334,43,331,93,-264.25395352433975,-30.93221977342149,147.2682983412597,0.31579038395019027,161944,161644,Hampshire,Hampshire,25,15,Massachusetts,MA
25017,25CS008,7848,9637,11952,11522,-430,1885,3674,2117,-188.06153324891102,-17.129728789677216,114.93900347797636,1.009297298059054,9204,11586,14625,12202,-2424,616,2998,823,-200.78758541254842,-12.833335583891515,134.53355772944585,0.3558192154813964,1625245,1616883,Middlesex,Middlesex,25,17,Massachusetts,MA
25019,25CS001,55,71,86,64,-22,-7,9,3,-219.51217253237974,-84.11787396956368,51.27642459325233,-0.24077061529729138,69,90,113,91,-22,2,22,2,-166.0327539962441,-3.4590157082550856,138.3606283302034,0.09523809523809523,13845,14455,Barnstable+Dukes+Nantucket,Nantucket,25,19,Massachusetts,MA
25021,25CS009,3976,4924,6083,5757,-326,833,1781,926,-207.82554714804473,-15.433206280008113,141.92741581695628,0.9278557114228457,4702,5910,7538,6186,-1352,276,1484,374,-238.17255241056398,-13.591330984555096,153.1059985833739,0.31587860370723075,723116,724727,Norfolk,Norfolk,25,21,Massachusetts,MA
25023,25CS010,3250,4047,5039,4799,-240,752,1549,740,-221.96923652307896,2.717713333615904,183.24182151905228,0.8491132440652526,3884,4935,6310,5438,-872,503,1554,412,-240.94821207497412,17.082534610122433,214.376423349009,0.4280520635660823,529857,532708,Plymouth,Plymouth,25,23,Massachusetts,MA
25025,25CS011,3079,3826,4750,5128,378,1302,2049,1089,-107.42654172829064,32.17358462897344,145.0228103393305,0.826252372457218,3542,4460,5656,5141,-515,681,1599,393,-117.22801720570419,37.17222015440992,155.65867189659153,0.41875344863995856,794441,774772,Suffolk,Suffolk,25,25,Massachusetts,MA
25027,25CS012,5081,6236,7738,6985,-753,749,1904,1135,-264.3802778786146,-54.059482061260894,107.712817754704,0.9912671316467128,6004,7559,9519,7793,-1726,234,1789,665,-277.34910745586,-50.00312277816268,130.44898202265915,0.41784484174486514,856834,861946,Worcester,Worcester,25,27,Massachusetts,MA
26001,26CS001,123,146,169,176,7,30,53,20,-147.4086622670729,123.17751188640506,384.09989410583046,0.6561815505570843,146,175,209,227,18,52,81,35,-166.27915743742625,166.27915743742625,449.93183777185925,0.6730769230769231,10209,10224,Alcona+Alpena+Presque Isle,Alcona,26,1,Michigan,MI
26003,26CS002,79,96,115,78,-37,-18,-1,8,-610.2827892773296,-354.41036975053714,-120.78772583477037,-0.4207480630355045,92,117,145,114,-31,-3,22,6,-419.36344595855,-102.00732469262027,181.34635500910272,-0.20689655172413793,8868,8823,Alger+Delta+Schoolcraft,Alger,26,3,Michigan,MI
26005,26CS003,709,889,1105,1042,-63,153,333,73,-135.9045727161495,79.82647442945638,259.4360418957332,0.3924731182795699,847,1081,1381,1279,-102,198,432,168,-223.4107778537139,24.814229306225165,218.36521789478147,0.6746987951807228,120261,120898,Allegan,Allegan,26,5,Michigan,MI
26007,26CS001,257,327,414,343,-71,16,86,20,-379.0641131522577,-16.66215881987946,275.1338975132594,0.3225806451612903,304,398,510,477,-33,78,173,72,-363.4391729739708,22.49861546981724,349.7669374192355,0.7422680412371134,28808,28891,Alcona+Alpena+Presque Isle,Alpena,26,7,Michigan,MI
26009,26CS004,178,228,289,259,-30,31,81,8,-194.43314317591899,117.68321823805623,373.7721344473914,0.17391304347826086,212,282,363,333,-30,51,121,36,-277.82649875469184,63.142386080611786,358.22780369733715,0.5454545454545454,23453,23756,Antrim+Charlevoix+Kalkaska+Otsego,Antrim,26,9,Michigan,MI
26011,26CS005,132,172,218,204,-14,32,72,15,-232.28293351763188,132.16097941520434,456.5561107070696,0.36585365853658536,157,208,273,254,-19,46,97,20,-260.72985999540964,173.59734596365305,514.1152168923571,0.36363636363636365,14982,14977,Arenac+Iosco+Ogemaw,Arenac,26,11,Michigan,MI
26013,26CS041,77,94,114,105,-9,11,28,27,-533.8978219332129,-231.41884806188352,11.169288982922266,1.6658696263533157,95,118,146,114,-32,-4,19,18,-609.5841873861792,-268.21704244991884,12.191683747723584,-0.6547619047619048,8154,8202,Northwest Upper Peninsula,Baraga,26,13,Michigan,MI
26015,26CS006,388,489,613,534,-79,45,146,39,-226.87871927608933,11.531319912380653,205.64187177078827,0.42857142857142855,463,598,771,769,-2,172,306,78,-127.2103897754947,148.58427787643666,362.3231588858563,0.42276733254994125,62439,62927,Barry,Barry,26,15,Michigan,MI
26017,26CS007,880,1090,1354,1312,-42,222,432,148,-220.42043021862585,85.84795703251746,329.47053780047236,0.5861409122278687,1042,1318,1708,1559,-149,240,517,219,-357.1227172760297,20.858838417372016,289.2102201031905,0.7448979591836735,103439,103074,Bay,Bay,26,17,Michigan,MI
26019,26CS008,150,177,203,226,23,49,76,24,-7.427614038756776,168.53424670685112,344.22159596923643,0.48743185070026895,183,217,257,241,-16,24,58,24,-219.941097024953,0,186.94993247121005,0.75,17970,18187,Benzie+Manistee+Mason,Benzie,26,19,Michigan,MI
26021,26CS009,1168,1440,1796,1652,-144,212,484,170,-244.90018058891835,32.75213368805786,244.90018058891832,0.6159420289855072,1376,1737,2200,2006,-194,269,630,204,-259.71321157735804,42.4154742525836,278.0171200817422,0.5543478260869565,153883,153246,Berrien,Berrien,26,21,Michigan,MI
26023,26CS010,324,410,514,468,-46,58,144,71,-314.7279446809881,-34.954833668114865,196.28483521326038,0.8765432098765432,392,502,645,565,-80,63,173,75,-344.86609470101547,-26.69070065406118,218.0852665942248,0.7177197802197802,44629,44959,Branch+Hillsdale,Branch,26,23,Michigan,MI
26025,26CS011,1049,1318,1640,1625,-15,306,576,158,-154.92667247453102,132.9477657467082,374.2233406203639,0.4759036144578313,1261,1594,2041,1847,-194,254,586,229,-316.2214782961915,18.302447952413637,266.76751689007784,0.6695906432748538,134038,133862,Calhoun,Calhoun,26,25,Michigan,MI
26027,26CS012,351,448,563,560,-3,112,209,66,-160.59358510739668,106.98486480724473,332.58338407469563,0.5523109243697479,423,538,693,634,-59,96,211,65,-240.80163641542165,60.200409103855414,283.81579969446653,0.5462184873949579,51596,51495,Cass,Cass,26,27,Michigan,MI
26029,26CS004,191,246,310,242,-68,-4,51,12,-368.5586222562058,-76.01521584034245,179.67232834990034,-0.16901408450704225,231,300,389,376,-13,76,145,36,-187.917961665375,153.4024176860204,418.02158819440564,0.4235294117647059,26047,26075,Antrim+Charlevoix+Kalkaska+Otsego,Charlevoix,26,29,Michigan,MI
26031,26CS013,221,280,358,343,-15,63,122,39,-253.5985683110942,112.60620979586051,389.4298088773509,0.5611801242236025,262,346,448,443,-5,97,181,52,-221.53397704499912,174.89524503552562,501.5606971518793,0.49290206648697216,25576,25730,Cheboygan+Emmet,Cheboygan,26,31,Michigan,MI
26033,26CS014,238,303,385,308,-77,5,70,22,-322.72001439017396,-55.38859409018634,156.39132448993792,0.3120724346076459,288,372,483,452,-31,80,164,50,-220.07580388800585,81.50955699555773,309.87216584477846,0.5263157894736842,36831,36806,Chippewa+Luce+Mackinac,Chippewa,26,33,Michigan,MI
26035,26CS015,307,389,488,434,-54,45,127,42,-373.5373251727595,11.66696486744694,330.75845399212056,0.5675675675675675,371,474,614,557,-57,83,186,65,-393.4957188004181,58.009196874754515,390.111848982724,0.5855855855855856,30856,31030,Clare+Gladwin,Clare,26,35,Michigan,MI
26037,26CS016,414,519,650,638,-12,119,224,48,-91.0260546620167,107.53493978374685,266.5654845343584,0.3622693096377307,493,630,810,771,-39,142,278,90,-162.6302172864415,64.87572571844879,236.8278919430752,0.5389221556886228,79230,79383,Clinton,Clinton,26,37,Michigan,MI
26039,26CS017,135,159,183,155,-28,-4,20,1,-267.8884407308176,-42.68601588672213,175.00966146257045,-0.04427815905213502,167,198,234,219,-15,21,52,12,-205.0246868073891,68.3415622691297,303.74027675168753,0.41379310344827586,13143,13169,Crawford+Montmorency+Oscoda+Roscommon,Crawford,26,39,Michigan,MI
26041,26CS002,312,398,500,502,2,104,190,63,-199.72623746911648,134.13228069178996,415.48291824042246,0.5675675675675675,375,489,631,555,-76,66,180,51,-344.8431913834457,40.72951079332036,350.2737928225551,0.49038461538461536,36680,36828,Alger+Delta+Schoolcraft,Delta,26,41,Michigan,MI
26043,26CS018,206,264,339,339,0,75,133,68,-316.33449982756986,32.563845570485135,302.37856601164765,0.8607594936708861,242,321,414,360,-54,39,118,30,-325.75704357557595,34.88177742034722,341.0662681100617,0.43478260869565216,25795,25801,Dickinson+Iron+Menominee,Dickinson,26,43,Michigan,MI
26045,26CS019,712,886,1105,1071,-34,184,359,80,-125.39723982805711,114.7964219188083,306.4899685679188,0.3864734299516908,852,1087,1391,1330,-61,243,478,183,-224.05737483954525,55.06222605108628,270.7226114178409,0.6570936798947938,109237,108968,Eaton,Eaton,26,45,Michigan,MI
26047,26CS013,252,320,402,374,-28,54,122,32,-211.80052508880178,77.66019253256066,317.7007876332027,0.4507042253521127,303,394,511,387,-124,-7,84,28,-444.37541683035346,-102.32328677014718,163.8634349561927,-0.22134733158355205,33994,34205,Cheboygan+Emmet,Emmet,26,47,Michigan,MI
26049,26CS020,3178,3956,4908,4701,-206,745,1523,497,-208.18440669940972,73.38981216979903,303.5319771877532,0.5654159763926279,3831,4834,6101,5638,-463,804,1807,670,-280.19277084600583,33.25766904539363,281.1818465053484,0.6429948340475776,405506,404418,Genesee,Genesee,26,49,Michigan,MI
26051,26CS015,246,310,397,390,-7,80,144,36,-203.22978471657535,207.95605877975154,510.43759882302646,0.4186046511627907,290,379,489,481,-8,102,191,59,-263.2706950202377,168.8387753299064,518.2957754313406,0.5221238938053098,25390,25468,Clare+Gladwin,Gladwin,26,51,Michigan,MI
26053,26CS041,133,158,182,207,25,49,74,38,-106.76034214746468,93.74132351435338,301.15683971623434,0.7731888579172723,164,194,229,211,-18,17,47,20,-264.7291895861575,-20.899672862065064,188.09705575858555,0.7692307692307693,14270,14354,Northwest Upper Peninsula,Gogebic,26,53,Michigan,MI
26055,26CS021,625,775,966,899,-67,124,274,37,-131.31474327161,109.84983331375071,299.2460976478036,0.23053183229813665,749,951,1218,1122,-96,171,373,113,-218.36381571148448,60.55511026185083,271.5061452343846,0.518348623853211,95039,95781,Grand Traverse+Leelanau,Grand Traverse,26,55,Michigan,MI
26057,26CS022,322,407,512,484,-28,77,162,54,-237.2150243008273,66.49537548956768,312.23915447275255,0.5806451612903226,391,496,640,528,-112,32,137,48,-384.974370130801,-38.4974370130801,214.26229787592385,0.47291788002329643,41507,41561,Gratiot+Isabella,Gratiot,26,57,Michigan,MI
26059,26CS010,341,426,540,545,5,119,204,63,-152.48263529136835,147.22461338476944,370.8219949628879,0.5121951219512195,408,528,671,651,-20,124,243,108,-281.4653940675544,34.01726010173172,296.3890952734754,0.7686930091185411,45645,45565,Branch+Hillsdale,Hillsdale,26,59,Michigan,MI
26061,26CS041,242,309,390,333,-57,24,91,27,-272.6953008756188,-9.739117888414956,207.76784828618574,0.4576271186440678,299,380,491,381,-110,1,82,46,-418.33500656162477,-120.67355958508406,96.67292940093944,0.35116550116550116,36964,37291,Northwest Upper Peninsula,Houghton,26,61,Michigan,MI
26063,26CS023,299,377,483,424,-59,47,125,46,-403.0631005099839,3.836869114802321,303.11266006938337,0.601332877648667,356,458,589,529,-60,71,173,71,-419.29944849009416,0,326.7081515123041,0.696078431372549,31276,31266,Huron+Sanilac,Huron,26,63,Michigan,MI
26065,26CS024,1483,1834,2274,2244,-30,410,761,157,-78.71050681930036,106.3485085462376,253.91231852709413,0.35600907029478457,1765,2226,2813,2850,37,624,1085,345,-108.46346793591626,98.20317233204815,260.4671954326725,0.5267175572519084,285476,284105,Ingham,Ingham,26,65,Michigan,MI
26067,26CS025,372,466,587,520,-67,54,148,31,-176.64515034771694,41.45753528568867,210.89267949676412,0.3522727272727273,445,572,730,628,-102,56,183,82,-274.0215643057128,-39.46506225055102,150.4884732233275,0.7068965517241379,66574,67148,Ionia,Ionia,26,67,Michigan,MI
26069,26CS005,275,349,437,405,-32,56,130,43,-357.13618890492535,61.86236450052006,414.0019778111727,0.5733333333333334,328,428,543,499,-44,71,171,56,-394.58562754733794,59.18784413210069,453.9707644932122,0.5656565656565656,25217,25343,Arenac+Iosco+Ogemaw,Iosco,26,69,Michigan,MI
26071,26CS018,151,175,202,204,2,29,53,28,-273.1056723932957,9.161861537742196,256.8398792079422,0.9172432314772412,183,218,253,197,-56,-21,14,25,-696.1578817319433,-395.34892048974564,-94.53995924754787,-0.8333333333333334,11552,11635,Dickinson+Iron+Menominee,Iron,26,71,Michigan,MI
26073,26CS022,309,386,489,512,23,126,203,33,-18.384476862689024,170.97563482300788,312.53610666571336,0.2558139534883721,360,470,604,685,81,215,325,101,-30.880588944298815,176.01935698250324,345.9397976485074,0.46543778801843316,65272,64766,Gratiot+Isabella,Isabella,26,73,Michigan,MI
26075,26CS026,1199,1482,1823,1706,-117,224,507,175,-219.26565692398424,36.769394898272516,249.13141033115252,0.5952380952380952,1410,1792,2273,2162,-111,370,752,229,-212.59199968764028,88.39779005524862,326.9468793315501,0.5407327490075382,159916,160072,Jackson,Jackson,26,75,Michigan,MI
26077,26CS027,1464,1816,2252,2161,-91,345,697,185,-126.20555466501719,73.24225152848298,234.3752048911455,0.4642416342363446,1730,2188,2771,2662,-109,474,932,249,-137.16384946084065,85.95473608920787,261.57806546167836,0.46455223880597013,262144,261184,Kalamazoo,Kalamazoo,26,77,Michigan,MI
26079,26CS004,138,180,230,209,-21,29,71,13,-227.43452141082795,107.02801007568375,387.9765365243536,0.325,167,220,289,251,-38,32,84,26,-356.4050664607808,30.60465051575792,323.0181749890447,0.5474290780141844,17939,17971,Antrim+Charlevoix+Kalkaska+Otsego,Kalkaska,26,79,Michigan,MI
26081,26CS028,3307,4091,5061,4822,-239,731,1515,442,-124.16627529865629,52.71640011945301,195.64351193120865,0.5151522149306608,3942,4949,6307,5811,-496,862,1869,542,-157.75513875283247,48.62888392342394,201.6655012830617,0.49862047719640346,657860,658045,Kent,Kent,26,81,Michigan,MI
26083,26CS041,15,24,34,26,-8,2,11,5,-738.5637300078353,-165.1903125995064,360.40198669146184,0.631896358407867,20,31,45,35,-10,4,15,4,-666.8519033064741,0,523.9550668836582,0.4,2065,2099,Northwest Upper Peninsula,Keweenaw,26,83,Michigan,MI
26085,26CS029,124,146,169,175,6,29,51,4,16.27490123376785,245.13881029523728,465.82900831879715,0.13568811189416052,151,181,216,194,-22,13,43,20,-342.0886070579531,-57.014767842992185,187.74148554013817,0.7692307692307693,12070,12278,Lake+Missaukee+Wexford,Lake,26,85,Michigan,MI
26087,26CS030,616,771,969,874,-95,103,258,96,-259.281014290228,9.499958649733555,219.92404274133176,0.6666666666666666,739,949,1195,1207,12,258,468,210,-223.74691348871627,54.2279820624003,291.5318910667166,0.7608795536593371,88421,88515,Lapeer,Lapeer,26,87,Michigan,MI
26089,26CS021,164,210,269,243,-26,33,79,10,-194.18803162672742,124.0645757615203,372.1937272845609,0.21739130434782608,200,262,334,316,-18,54,116,28,-203.97598132988577,112.95086914032763,390.01270697277806,0.42424242424242425,22246,22576,Grand Traverse+Leelanau,Leelanau,26,89,Michigan,MI
26091,26CS031,726,896,1117,1037,-80,141,311,75,-187.89781664328277,79.93075023175417,285.873539275842,0.4166666666666667,849,1082,1385,1308,-77,226,459,188,-267.6940055483371,37.88122720023638,273.7550019003749,0.7315175097276264,99086,98994,Lenawee,Lenawee,26,91,Michigan,MI
26093,26CS032,1014,1265,1577,1499,-78,234,485,80,-97.86268299374018,95.35497109165446,250.80214961477037,0.2867383512544803,1220,1548,1977,1913,-64,365,693,226,-148.90010407996675,71.33246412929651,239.73352962590545,0.5587153159760421,193802,194862,Livingston,Livingston,26,93,Michigan,MI
26095,26CS014,44,58,74,65,-9,7,21,5,-307.5186679296855,35.761540975917285,342.90699104935135,0.44907536262019965,53,71,92,83,-9,12,30,7,-301.2426258315552,94.138320572361,433.03627463286057,0.4375,5461,5311,Chippewa+Luce+Mackinac,Luce,26,95,Michigan,MI
26097,26CS014,118,141,166,140,-26,-1,22,5,-344.1695972102163,-61.88780780755178,193.07638907227417,-0.16125237891405178,146,179,218,195,-23,16,49,14,-340.0668507484377,18.357184925691644,321.2507361996038,0.4827586206896552,10835,10895,Chippewa+Luce+Mackinac,Mackinac,26,97,Michigan,MI
26099,26CS033,5957,7414,9168,9309,141,1896,3352,1407,-172.86862720643578,66.70325781227794,265.58410735901845,0.7049098196392786,7162,8957,11450,10658,-792,1701,3496,1448,-255.37702042332734,28.838129021893735,233.46346190767883,0.7115480833685885,878818,877311,Macomb,Macomb,26,99,Michigan,MI
26101,26CS008,217,275,347,343,-4,68,126,21,-119.86505192903657,225.34629762658875,503.43321810195357,0.28378378378378377,262,339,433,373,-60,34,111,43,-407.37871782059625,-35.56167274864565,269.0833237980851,0.6056338028169014,25028,25308,Benzie+Manistee+Mason,Manistee,26,101,Michigan,MI
26103,26CS034,464,580,723,600,-123,20,136,44,-303.36306875056374,-43.59708772463191,167.2129968771819,0.3911188369152971,553,698,902,794,-108,96,241,41,-225.56703891239508,83.23506970937088,302.67298076134864,0.26973684210526316,66059,66078,Marquette,Marquette,26,103,Michigan,MI
26105,26CS008,231,293,367,349,-18,56,118,21,-160.76753904144928,144.27856067822373,400.06383753776015,0.31343283582089554,281,357,463,441,-22,84,160,46,-231.96375956839856,129.53156302129528,388.76512533101896,0.4791666666666667,29110,29336,Benzie+Manistee+Mason,Mason,26,105,Michigan,MI
26107,26CS035,252,318,402,412,10,94,160,13,-8.91939100380313,240.82355710268448,437.19881570308326,0.13402061855670103,297,386,500,474,-26,88,177,59,-212.52900135330967,72.50989457936447,295.1652777618611,0.5619047619047619,40362,39995,Mecosta+Osceola,Mecosta,26,107,Michigan,MI
26109,26CS018,194,249,319,248,-71,-1,54,22,-478.6588117345038,-118.3779856977805,164.69980618821637,-0.19649122807017544,232,305,399,326,-73,21,94,33,-454.816747377638,-51.46441271599864,261.82519969264285,0.5238095238095238,23315,23317,Dickinson+Iron+Menominee,Menominee,26,109,Michigan,MI
26111,26CS036,513,640,799,767,-32,127,254,37,-99.27551696638173,129.39603949274954,312.0601152433475,0.2534246575342466,610,776,994,938,-56,162,328,103,-190.57085636817538,70.69274143805312,269.59096311121954,0.5364583333333334,83465,83460,Midland,Midland,26,111,Michigan,MI
26113,26CS029,122,143,166,167,1,24,45,4,-24.472262951359355,162.04158567454144,328.9223976029792,0.1563103146241747,146,175,209,204,-5,29,58,30,-231.46904308217566,-6.613401230919304,185.17523446574052,0.9375,15075,15121,Lake+Missaukee+Wexford,Missaukee,26,113,Michigan,MI
26115,26CS037,1067,1328,1646,1530,-116,202,463,123,-186.2567904770525,61.476024431531854,264.5803583129219,0.4659090909090909,1285,1632,2085,1933,-152,300,648,207,-231.3724679541991,60.243179486821546,284.1416273121743,0.5602175346077785,154206,155204,Monroe,Monroe,26,115,Michigan,MI
26117,26CS038,457,571,713,620,-93,49,163,70,-295.56166412096474,-38.07849660454146,168.6333421058265,0.693069306930693,552,707,911,820,-91,113,268,90,-269.75206611570246,34.268420439995346,265.2077755790944,0.5750857422831945,66179,67117,Montcalm,Montcalm,26,117,Michigan,MI
26119,26CS017,112,135,158,159,1,24,47,16,-193.91203031197625,106.62860669977495,407.16924371152584,0.6198757004776017,136,165,196,200,4,35,64,26,-237.16373730522704,97.02152889759287,409.64645534539216,0.7124624624624625,9192,9276,Crawford+Montmorency+Oscoda+Roscommon,Montmorency,26,119,Michigan,MI
26121,26CS039,1212,1511,1858,1878,20,367,666,247,-155.1495452615621,82.01738075501082,286.4457022868752,0.6309077979017694,1450,1837,2331,2152,-179,315,702,230,-232.10162890145696,48.18326647117802,267.61553060050755,0.5630363392300686,175573,176410,Muskegon,Muskegon,26,121,Michigan,MI
26123,26CS040,349,443,557,488,-69,45,139,30,-238.21906608891396,36.05737630003743,262.2573169556054,0.37037037037037035,420,535,690,641,-49,106,221,82,-260.749534701525,47.75268090680351,276.56761025190366,0.656,49920,50259,Newaygo+Oceana,Newaygo,26,123,Michigan,MI
26125,26CS042,7229,8935,11004,10946,-58,2011,3717,1401,-137.89412894553396,57.63698688281192,218.85047379994913,0.6425132188332092,8606,10790,13689,12423,-1266,1633,3817,1189,-193.26718472943642,34.95056615341714,206.89318247978892,0.5269222505554036,1270018,1270366,Oakland,Oakland,26,125,Michigan,MI
26127,26CS040,180,227,289,284,-5,57,104,41,-206.87442076177192,71.95632026496415,283.32801104329633,0.6721311475409836,213,277,357,330,-27,53,117,37,-238.83734725721894,59.709336814304734,298.54668407152366,0.5522388059701493,26683,26796,Newaygo+Oceana,Oceana,26,127,Michigan,MI
26129,26CS005,219,277,349,294,-55,17,75,28,-479.90321036997346,-63.563339121850795,271.5888126115443,0.5283018867924528,259,335,435,385,-50,50,126,52,-492.56944597998273,-9.64876485759026,357.00429973083965,0.6842105263157895,20767,20728,Arenac+Iosco+Ogemaw,Ogemaw,26,129,Michigan,MI
26131,26CS041,71,87,105,115,10,28,44,20,-211.8590851721778,162.52921979756678,502.88222431551674,0.6974910684457979,88,109,133,101,-32,-8,13,13,-768.0928538916704,-358.44333181611285,0,-0.65,5797,5859,Northwest Upper Peninsula,Ontonagon,26,131,Michigan,MI
26133,26CS035,163,208,269,223,-46,15,60,17,-328.9295377600921,-10.44220754793943,224.50746228069778,0.3953488372093023,193,255,330,285,-45,30,92,47,-398.94755280745886,-73.67852686286585,195.03139463699785,0.8103448275862069,22984,23073,Mecosta+Osceola,Osceola,26,133,Michigan,MI
26135,26CS017,85,103,123,148,25,45,63,13,181.71803517085374,468.5747855871256,731.5268068020413,0.2874122718352693,100,125,150,172,22,47,72,33,-132.533779798137,168.6793561067198,469.8924920115766,0.7021276595744681,8254,8300,Crawford+Montmorency+Oscoda+Roscommon,Oscoda,26,135,Michigan,MI
26137,26CS004,184,234,295,276,-19,42,92,18,-177.43116901472857,114.9351702119699,354.3834414869072,0.3333333333333333,219,287,372,366,-6,79,147,59,-257.30621831607925,79.17114409725515,348.35303402792266,0.686046511627907,25058,25262,Antrim+Charlevoix+Kalkaska+Otsego,Otsego,26,137,Michigan,MI
26139,26CS043,1422,1763,2182,2147,-35,384,725,221,-103.69374509197637,66.02375175778182,204.268576757358,0.513953488372093,1719,2162,2748,2544,-204,382,825,290,-165.47228163586473,30.788653879056643,179.1263803126637,0.597322981629969,296257,298811,Ottawa,Ottawa,26,139,Michigan,MI
26141,26CS001,142,168,196,170,-26,2,28,11,-340.5678225551266,-80.87906195900494,155.9296316242424,0.40218320826465853,173,206,247,211,-36,5,38,33,-527.669174369808,-214.12662148340038,38.61926566039865,0.9705882352941176,12936,13076,Alcona+Alpena+Presque Isle,Presque Isle,26,141,Michigan,MI
26143,26CS017,265,335,425,389,-36,54,124,29,-331.43918436216103,127.47660937006192,484.4111156062354,0.4142857142857143,314,407,521,468,-53,61,154,61,-483.39904517037854,0,394.0062331362419,0.6853932584269663,23534,23604,Crawford+Montmorency+Oscoda+Roscommon,Roscommon,26,143,Michigan,MI
26145,26CS044,1441,1804,2235,2310,75,506,869,328,-159.96736900180235,112.79547843895605,341.95671236549606,0.6253580516175936,1726,2184,2780,2583,-197,398,857,337,-281.6333203252719,32.43226139875333,274.2503665109215,0.6780711555901023,189901,189626,Saginaw,Saginaw,26,145,Michigan,MI
26147,26CS045,1222,1517,1888,1776,-112,259,554,154,-199.44053345283606,78.6969410467786,299.8728201220582,0.4782608695652174,1457,1830,2322,2357,35,526,900,411,-234.59570943781048,72.14965900696873,305.46479008145207,0.7378815080789947,160108,160084,St. Clair,St. Clair,26,147,Michigan,MI
26149,26CS046,452,564,708,639,-69,76,187,59,-252.41509025873668,32.525177581172635,252.31652911455132,0.5462962962962963,539,684,883,792,-91,108,253,89,-296.2371871863637,30.438144753944616,269.9123052370061,0.5933333333333334,60876,60779,St. Joseph,St. Joseph,26,149,Michigan,MI
26151,26CS023,327,415,523,492,-31,77,165,64,-281.0136634644685,38.414065457813784,298.44773932609166,0.6736842105263158,390,503,646,644,-2,141,254,99,-249.4692144373673,103.68834246778256,382.65935910729274,0.6644295302013423,40610,40506,Huron+Sanilac,Sanilac,26,151,Michigan,MI
26153,26CS002,81,99,119,110,-9,11,29,4,-197.05188703235274,97.24158488111802,379.2728287981938,0.2457780218700107,99,124,153,131,-22,7,32,5,-336.17194572483186,24.901625609246803,336.7944863650625,0.22727272727272727,8046,8032,Alger+Delta+Schoolcraft,Schoolcraft,26,153,Michigan,MI
26155,26CS047,506,634,789,728,-61,94,222,49,-194.16357055038753,78.54798990447496,305.3663427747004,0.3888888888888889,609,774,989,880,-109,106,271,118,-334.425951827001,-16.938552944331693,225.35640004197816,0.7283950617283951,67984,67892,Shiawassee,Shiawassee,26,155,Michigan,MI
26157,26CS048,428,535,671,647,-24,112,219,90,-257.613574929755,49.71490042504043,291.6230863568848,0.7003997093023255,501,656,836,794,-42,138,293,118,-302.15750939522485,36.81394210063658,330.38153167237954,0.7283950617283951,53103,52969,Tuscola,Tuscola,26,157,Michigan,MI
26159,26CS049,520,650,812,767,-45,117,247,90,-214.60281893907143,42.87292720203425,249.3775265584992,0.6405775075987843,618,792,1005,980,-25,188,362,117,-187.78970329425178,93.86180171694387,323.8893157838204,0.5505912835503588,75572,75643,Van Buren,Van Buren,26,159,Michigan,MI
26161,26CS050,1619,2022,2487,2311,-176,290,692,179,-114.89744589216289,35.748747771600726,165.9971265303921,0.46614899460852466,1972,2483,3168,2640,-528,157,668,172,-189.19699579333079,-4.057119280771926,134.18245834606344,0.3531842407070094,370922,369720,Washtenaw,Washtenaw,26,161,Michigan,MI
26163,26CS051,12441,15326,18972,19800,828,4474,7359,3079,-151.50378745796078,93.93261746827098,288.10153540438546,0.6697849274100434,14825,18442,23356,21711,-1645,3269,6886,2477,-231.96699620186774,44.56791543153638,248.08910197350298,0.612891337674455,1782767,1777063,Wayne,Wayne,26,163,Michigan,MI
26165,26CS029,237,302,377,329,-48,26,92,12,-214.02988341301787,51.63782544906422,284.8983473051819,0.21428571428571427,284,370,472,507,35,137,223,66,-91.53132271988278,209.636255261667,463.5618602265031,0.4748201438848921,33696,33868,Lake+Missaukee+Wexford,Wexford,26,165,Michigan,MI
27001,27CS001,150,191,244,225,-19,34,75,29,-366.06776384604177,38.13205873396269,351.19626093979605,0.6904761904761905,179,235,306,248,-58,13,69,20,-491.8433352863437,-44.13978650005648,309.2937896896812,0.4,15735,15859,Aitkin+Itasca,Aitkin,27,1,Minnesota,MN
27003,27CS002,1556,1946,2412,2359,-53,413,803,331,-126.75048216256354,27.062985385575345,155.79368599098584,0.7187847778930492,1909,2398,3055,2764,-291,366,855,307,-163.12464871381022,16.092892357018314,149.47296629908536,0.601371781589348,363596,366621,Anoka,Anoka,27,3,Minnesota,MN
27005,27CS003,252,320,404,386,-18,66,134,40,-198.8905357972773,89.00437058053718,321.95619434998144,0.5194805194805194,298,390,498,412,-86,22,114,43,-366.3887981595354,-59.6446880724825,201.797861311899,0.5119047619047619,35054,35208,Becker+Hubbard+Mahnomen+Norman,Becker,27,5,Minnesota,MN
27007,27CS004,270,337,427,461,34,124,191,40,-15.521318234180585,217.29845527852817,390.61984222687806,0.32,319,409,522,511,-11,102,192,56,-144.6348401709517,99.22748169819207,293.3682067598722,0.5,46388,46358,Beltrami+Clearwater,Beltrami,27,7,Minnesota,MN
27009,27CS005,257,323,407,397,-10,74,140,72,-238.30125593520577,5.812225754517214,197.76098129744807,0.8888888888888888,307,394,508,407,-101,13,100,51,-367.265990845497,-91.69584528336982,118.2393794443453,0.5896150761828388,41292,41441,Benton+Stearns,Benton,27,9,Minnesota,MN
27011,27CS031,54,69,86,67,-19,-2,13,6,-593.5105935416193,-188.9012221826155,157.90681041081615,-0.355885683850525,68,86,110,76,-34,-10,8,7,-796.8450120255574,-330.3991513276701,19.4352441957453,-0.4117647058823529,5121,5145,Stevens and Nearby Counties,Big Stone,27,11,Minnesota,MN
27013,27CS006,338,428,542,456,-86,28,118,27,-196.62377489094877,1.7392638203533723,158.2730076521569,0.32926829268292684,410,520,670,594,-76,74,184,41,-168.91795357824233,48.36539696471041,206.52746375527823,0.3565217391304348,68995,69264,Blue Earth+Faribault+Martin+Watonwan,Blue Earth,27,13,Minnesota,MN
27015,27CS007,196,254,320,268,-52,14,72,30,-382.2256030945772,-72.24996156056032,195.77408938990538,0.6,237,308,401,342,-59,34,105,30,-344.7725149906354,15.486693542532752,290.5690875917706,0.46153846153846156,25744,25829,Brown+Le Sueur+Nicollet,Brown,27,15,Minnesota,MN
27017,27CS027,253,321,402,367,-35,46,114,41,-252.80164513801316,16.59892614169489,242.3443216687454,0.640625,299,388,497,472,-25,84,173,34,-162.34969450603458,137.46798857411903,382.1610082360509,0.3434343434343434,36147,36372,St. Louis and Nearby Counties,Carlton,27,17,Minnesota,MN
27019,27CS008,374,464,584,510,-74,46,136,36,-123.29280290166614,11.203344198243174,112.03344198243174,0.4090909090909091,454,572,734,674,-60,102,220,53,-104.21414007579351,45.19020233375117,154.1078124483636,0.4015151515151515,107111,108431,Carver,Carver,27,19,Minnesota,MN
27021,27CS009,223,288,365,310,-55,22,87,24,-315.0951974638922,-7.972048006676589,251.31881341047927,0.42105263157894735,276,353,457,429,-28,76,153,40,-222.64725569398678,117.78546958094819,369.7155017401985,0.43956043956043955,30105,30564,Cass+Crow Wing,Cass,27,21,Minnesota,MN
27023,27CS031,123,146,172,155,-17,9,32,28,-432.21760534264433,-186.49105370024517,43.382172029741156,1.388384394402617,150,182,215,172,-43,-10,22,5,-387.3649098502324,-121.05153432819762,137.19173890529063,-0.16954022988505746,12446,12391,Stevens and Nearby Counties,Chippewa,27,23,Minnesota,MN
27025,27CS010,305,383,482,412,-70,29,107,27,-205.271170719276,4.230214749495642,169.31434534856294,0.38028169014084506,365,470,607,544,-63,74,179,64,-221.69922180783382,16.564235998225886,200.6016159574618,0.5981308411214953,56735,57352,Chisago+Isanti,Chisago,27,25,Minnesota,MN
27027,27CS011,328,415,516,489,-27,74,161,83,-202.69300640281156,-16.55387529605539,143.46691923248008,0.9021739130434783,394,504,654,543,-111,39,149,32,-218.182442352823,10.680259415872454,178.74177008135095,0.3106796116504854,65242,65541,Clay,Clay,27,27,Minnesota,MN
27029,27CS004,69,84,100,92,-8,8,23,10,-254.8501483741954,-25.890366494268523,180.74583665236517,0.6794467290506844,83,103,128,125,-3,22,42,15,-209.87378423809014,81.61758275925727,314.8106763571352,0.625,8618,8577,Beltrami+Clearwater,Clearwater,27,29,Minnesota,MN
27031,27CS027,37,49,63,48,-15,-1,11,7,-480.64288699256286,-161.75890216972036,86.26197491471281,-0.3605211379332236,43,61,81,49,-32,-12,6,5,-659.1424467694226,-302.84923229946446,17.81466072349791,-0.3125,5569,5613,St. Louis and Nearby Counties,Cook,27,31,Minnesota,MN
27033,27CS030,101,122,143,150,7,28,49,16,-94.80936401245377,129.02502166345153,344.25039250566806,0.5490002783150707,124,151,179,166,-13,15,42,16,-250.92293493308722,-8.652514997692663,224.96538994000923,0.6956521739130435,11460,11557,Southwest Minnesota,Cottonwood,27,33,Minnesota,MN
27035,27CS009,486,608,751,619,-132,11,133,68,-362.5853468308247,-103.33682384678502,117.84023772001801,0.5151515151515151,578,744,952,815,-137,72,237,67,-304.0858273929284,6.704489089995972,253.35519327862548,0.4589041095890411,66191,67119,Cass+Crow Wing,Crow Wing,27,35,Minnesota,MN
27037,27CS012,1893,2344,2895,2746,-149,402,853,285,-118.78009127970003,31.85149184966062,155.3614613181943,0.5804480651731161,2278,2890,3711,3241,-470,352,963,333,-181.79574367871547,4.187538141139559,142.61396788243127,0.5791304347826087,438912,441787,Dakota,Dakota,27,37,Minnesota,MN
27039,27CS013,122,144,168,133,-35,-11,11,2,-210.97160785431186,-73.9824797601943,49.07154737262479,-0.10943503101080704,150,179,211,163,-48,-16,13,11,-281.97004665648444,-129.03713999534034,9.558306666321506,-0.4230769230769231,20885,20924,Dodge+Steele+Waseca,Dodge,27,39,Minnesota,MN
27041,27CS014,307,386,484,433,-51,47,126,52,-317.65091007122675,-15.404990789099259,228.14791358655987,0.7027027027027027,366,472,609,448,-161,-24,82,46,-527.9892642607944,-178.50397729174404,91.92954830524806,-0.39655172413793105,38948,39215,Douglas+Morrison+Todd,Douglas,27,41,Minnesota,MN
27043,27CS006,125,146,170,159,-11,13,34,11,-192.09938160671965,14.349727519326272,199.4420322530228,0.5718913496634375,151,179,209,184,-25,5,33,17,-302.0292590844738,-86.29407402413537,115.05876536551382,0.68,13859,13906,Blue Earth+Faribault+Martin+Watonwan,Faribault,27,43,Minnesota,MN
27045,27CS015,155,200,253,206,-47,6,51,4,-288.3454491557532,11.307664672774637,265.7301198102039,0.09302325581395349,185,242,313,248,-65,6,63,14,-371.46134578329657,-37.61633881349839,230.4000752326776,0.22580645161290322,21225,21267,Fillmore+Houston+Winona,Fillmore,27,45,Minnesota,MN
27047,27CS016,243,306,389,326,-63,20,83,17,-311.7245783465067,11.689671687994002,257.36760499733447,0.29310344827586204,285,374,481,391,-90,17,106,24,-370.5082978420871,-22.750509516619385,266.6684722626599,0.2823529411764706,30796,30769,Freeborn+Mower,Freeborn,27,47,Minnesota,MN
27049,27CS017,337,425,539,482,-57,57,145,42,-250.68534140525412,37.96345402401627,260.6823842982451,0.49411764705882355,405,525,676,567,-109,42,162,43,-317.2946456528546,-2.0874647740319383,248.40830810980066,0.3927022518765638,47414,47905,Goodhue+Wabasha,Goodhue,27,49,Minnesota,MN
27051,27CS031,42,55,68,73,5,18,31,4,15.048204433983502,274.99175490600254,534.9353053780213,0.2134691564370985,50,66,85,78,-7,12,28,7,-227.92563926019133,81.40201402149691,341.88845889028704,0.4375,6073,6142,Stevens and Nearby Counties,Grant,27,51,Minnesota,MN
27053,27CS018,6029,7442,9163,9067,-96,1624,3038,1286,-129.83266715651095,31.797097154779838,164.58872608492612,0.7198437764367491,7094,8932,11380,9922,-1458,990,2828,683,-168.66940164123088,24.183969504172005,169.00025725008277,0.3989487342469642,1277475,1269436,Hennepin,Hennepin,27,53,Minnesota,MN
27055,27CS015,139,163,188,179,-9,16,40,12,-135.84078084101537,26.91093296493108,179.16253620275185,0.5462176802311326,169,200,235,202,-33,2,33,2,-186.33044373264244,0,165.0355358774833,0.06060606060606061,18792,18784,Fillmore+Houston+Winona,Houston,27,55,Minnesota,MN
27057,27CS003,145,186,241,229,-12,44,84,37,-274.1570283336393,36.36776906466644,262.9669455445112,0.7551020408163265,176,230,297,239,-58,9,63,15,-337.3927257866775,-27.692973388783383,221.54378711026706,0.2777777777777778,21448,21666,Becker+Hubbard+Mahnomen+Norman,Hubbard,27,57,Minnesota,MN
27059,27CS010,231,289,371,314,-57,25,83,31,-255.82928572617578,-17.433000730914877,151.23128134068642,0.5849056603773585,276,357,463,435,-28,78,159,57,-203.20475817886702,50.2035284912495,243.84570981464043,0.6195652173913043,41301,41830,Chisago+Isanti,Isanti,27,59,Minnesota,MN
27061,27CS001,343,432,546,469,-77,37,126,36,-301.27850708053165,2.665002274042739,239.9834547775485,0.45,409,519,675,684,9,165,275,64,-122.17733098201462,224.15822759643012,468.290950721255,0.3764705882352941,45028,45057,Aitkin+Itasca,Itasca,27,61,Minnesota,MN
27063,27CS030,71,86,107,96,-11,10,25,11,-263.9696962247862,-15.995313931177828,172.4652166119646,0.7530581850186381,85,107,131,106,-25,-1,21,1,-260.34006921541265,-20.026159170416356,200.26159170416358,-0.0339080459770115,9946,9987,Southwest Minnesota,Jackson,27,63,Minnesota,MN
27065,27CS019,108,130,153,181,28,51,73,19,67.68291457375766,239.2767945701412,404.742321709511,0.37181830023110607,134,158,191,213,22,55,79,29,-43.366085913895084,161.07403339446745,309.75775652782204,0.5272727272727272,16099,16142,Kanabec+Mille Lacs+Pine,Kanabec,27,65,Minnesota,MN
27067,27CS020,265,334,423,406,-17,72,141,69,-236.62330292425818,8.254301264799704,198.1032303551929,0.8414634146341463,315,411,527,439,-88,28,124,48,-311.04986949123,-45.7090182940823,173.69426951751274,0.5517241379310345,43614,43755,Kandiyohi+Renville,Kandiyohi,27,67,Minnesota,MN
27069,27CS022,39,53,67,74,7,21,35,19,-331.90125810359973,44.66368765403895,444.76394252152977,0.8885824712927053,48,64,84,62,-22,-2,14,4,-627.5659235317146,-144.54493440269817,240.908224004497,-0.2,4192,4151,Northwest Minnesota,Kittson,27,69,Minnesota,MN
27071,27CS027,104,124,146,147,1,23,43,5,-43.259950983370025,177.86266983431452,374.41611056114533,0.20408511198480522,127,154,183,186,3,32,59,22,-158.94095134524693,83.65313228697207,309.93485512323116,0.6568627450980392,12047,11954,St. Louis and Nearby Counties,Koochiching,27,71,Minnesota,MN
27073,27CS034,54,69,84,94,10,25,40,16,-105.12264335492573,160.3812597480273,425.8851628509801,0.6415561112572077,64,83,106,102,-4,19,38,7,-164.51109359372612,179.46664755679214,463.62217285504636,0.3333333333333333,6689,6686,Yellow Medicine and Nearby Counties,Lac Qui Parle,27,73,Minnesota,MN
27075,27CS027,95,116,138,135,-3,19,40,12,-167.12279525822467,78.21378461285981,305.3772844934938,0.5570193479805742,115,142,174,169,-5,27,54,1,-54.688286262796204,236.98257380545022,483.0798619880331,0.03333333333333333,10858,10971,St. Louis and Nearby Counties,Lake,27,75,Minnesota,MN
27077,27CS022,28,38,50,45,-5,7,17,1,-196.15441552652166,197.10793865737315,511.7178220044889,0.1036534689884112,33,47,63,50,-13,3,17,1,-367.0867406302748,52.440962947182115,419.5277035774569,0.08333333333333333,3763,3814,Northwest Minnesota,Lake of the Woods,27,77,Minnesota,MN
27079,27CS007,158,203,254,216,-38,13,58,19,-238.47137755135395,-25.102250268563573,163.1646267456632,0.48108974358974355,191,249,323,284,-39,35,93,32,-246.61754177905368,10.413126324238721,211.9071206982578,0.5714285714285714,28683,28810,Brown+Le Sueur+Nicollet,Le Sueur,27,79,Minnesota,MN
27081,27CS034,55,71,86,65,-21,-6,10,5,-562.08333856318,-228.56165496041004,104.96002864235975,-0.3815543456261024,66,85,108,101,-7,16,35,3,-179.3433790534406,233.14639276947278,573.8988129710099,0.15789473684210525,5620,5576,Yellow Medicine and Nearby Counties,Lincoln,27,81,Minnesota,MN
27083,27CS034,143,184,236,226,-10,42,83,25,-166.40912872934743,80.82729109711161,275.76369903720433,0.5319148936170213,172,226,291,247,-44,21,75,37,-321.1394503460426,-63.43495315477385,150.65801374258788,0.7872340425531915,25239,25223,Yellow Medicine and Nearby Counties,Lyon,27,83,Minnesota,MN
27085,27CS021,229,294,374,376,2,82,147,39,-121.38796475237982,141.07249957709007,354.48566463499014,0.4482758620689655,274,356,463,417,-46,61,143,43,-242.44459292518275,49.00620631839741,272.2567017688745,0.524390243902439,36577,36730,McLeod+Meeker+Sibley,McLeod,27,85,Minnesota,MN
27087,27CS003,45,59,74,68,-6,9,23,5,-244.19350862292842,84.52209909207805,394.97572860069533,0.3871191652544108,57,75,95,89,-6,14,32,10,-295.84887053530156,73.96221763382539,406.79219698603964,0.5555555555555556,5402,5408,Becker+Hubbard+Mahnomen+Norman,Mahnomen,27,87,Minnesota,MN
27089,27CS022,57,72,89,87,-2,15,30,15,-222.03862262331495,6.253146367293961,201.93180550210158,0.8763109633360379,70,90,111,99,-12,9,29,12,-267.37509640928954,-33.352402878497664,188.9969496448201,0.7058823529411765,9075,8995,Northwest Minnesota,Marshall,27,89,Minnesota,MN
27091,27CS006,166,213,272,215,-57,2,49,23,-482.01744384308483,-126.52957900880978,156.65566924900259,0.41818181818181815,196,256,334,302,-32,46,106,25,-286.10119156545244,105.405702155693,406.56485117195876,0.4166666666666667,19916,19923,Blue Earth+Faribault+Martin+Watonwan,Martin,27,91,Minnesota,MN
27093,27CS021,151,196,249,226,-23,30,75,29,-266.8448483228652,5.131631698516638,236.05505813176535,0.6904761904761905,181,239,313,244,-69,5,63,27,-410.7582598903076,-94.08309961048171,153.95416299897008,0.4426229508196721,23384,23384,McLeod+Meeker+Sibley,Meeker,27,93,Minnesota,MN
27095,27CS019,204,258,328,306,-22,48,102,42,-290.6666393325643,27.249997437427904,272.72705768625735,0.711864406779661,245,319,416,377,-39,58,132,47,-320.8912817538947,41.04423371270747,317.1599877800122,0.6144053315105946,26422,26800,Kanabec+Mille Lacs+Pine,Mille Lacs,27,95,Minnesota,MN
27097,27CS014,220,282,352,323,-29,41,103,43,-254.97020367736974,-7.082505657704714,212.47516973114145,0.7543859649122807,265,342,449,415,-34,73,150,34,-200.20447039959987,114.73878538698598,341.42143702973635,0.38202247191011235,33886,33990,Douglas+Morrison+Todd,Morrison,27,97,Minnesota,MN
27099,27CS016,278,353,447,354,-93,1,76,30,-368.60592230010496,-86.87177364244651,137.79660646732896,0.30303030303030304,334,431,550,447,-103,16,113,21,-308.9025913668161,-12.455749651887748,229.3103510912533,0.23863636363636365,40059,40142,Freeborn+Mower,Mower,27,99,Minnesota,MN
27101,27CS030,64,79,95,58,-37,-21,-6,7,-652.3187143030008,-410.1939201236166,-192.8250275934958,-0.3345049990524977,76,95,118,109,-9,14,33,5,-171.8318502608162,110.46333231052469,343.6637005216324,0.2777777777777778,8170,8148,Southwest Minnesota,Murray,27,101,Minnesota,MN
27103,27CS007,171,219,279,238,-41,19,67,30,-247.33334663862877,-38.31925088767488,128.89202571308823,0.6976744186046512,205,270,348,298,-50,28,93,20,-203.90020387594737,23.286247409101772,212.6325466543604,0.35714285714285715,34447,34355,Brown+Le Sueur+Nicollet,Nicollet,27,103,Minnesota,MN
27105,27CS030,136,160,184,201,17,41,65,43,-142.153921880693,-12.602508767696204,116.94890434530043,1.0465438369717348,164,195,229,184,-45,-11,20,18,-286.3436123348018,-131.7044370770698,9.537217857304643,-0.6428571428571429,22085,22019,Southwest Minnesota,Nobles,27,105,Minnesota,MN
27107,27CS003,67,84,102,66,-36,-18,-1,6,-784.4875139935364,-446.2181477667493,-138.70054210603362,-0.32117340850217285,85,105,130,85,-45,-20,0,2,-732.4437518262395,-342.84601149313335,-30.388623745982983,-0.09523809523809523,6416,6417,Becker+Hubbard+Mahnomen+Norman,Norman,27,107,Minnesota,MN
27109,27CS023,764,955,1183,1055,-128,100,291,57,-136.9004688294868,31.78574600252664,173.12143520445892,0.3333333333333333,918,1162,1507,1266,-241,104,348,51,-178.9484140976073,32.44147750016482,181.91711534054681,0.22870415057915058,162337,163371,Olmsted,Olmsted,27,109,Minnesota,MN
27111,27CS024,455,573,719,675,-44,102,220,53,-194.5483832553009,98.27701834546127,335.04440642059797,0.4274193548387097,548,696,896,783,-113,87,235,82,-324.8516509406139,8.327394281994717,254.9015389718582,0.5616438356164384,59831,60043,Otter Tail+Wadena+Wilkin,Otter Tail,27,111,Minnesota,MN
27113,27CS022,96,114,135,121,-14,7,25,13,-230.96115902476612,-54.045490586361765,101.64029763943425,0.8699963515727333,115,140,167,156,-11,16,41,13,-173.8728826222204,21.73411032777755,202.85169639259047,0.5909090909090909,13941,13803,Northwest Minnesota,Pennington,27,113,Minnesota,MN
27115,27CS019,197,250,313,302,-11,52,105,18,-120.27048784414745,140.76408215838256,360.19044552292013,0.30254237288135594,239,306,391,394,3,88,155,38,-120.05472580093488,171.01812792155968,400.18241933644964,0.40425531914893614,28985,29237,Kanabec+Mille Lacs+Pine,Pine,27,115,Minnesota,MN
27117,27CS030,88,105,127,106,-21,1,18,17,-482.27070018229813,-208.17723359569325,13.205950955026097,0.7147375433502702,106,131,159,128,-31,-3,22,11,-450.8698410429157,-150.11124315340834,118.48065977465396,-0.36666666666666664,9359,9326,Southwest Minnesota,Pipestone,27,117,Minnesota,MN
27119,27CS022,233,294,375,349,-26,55,116,60,-332.24877610030245,-19.316789308157116,216.34804025135975,0.8955223880597015,277,353,457,380,-77,27,103,35,-363.8001777604617,-25.974131388520245,220.9424551236002,0.45753588516746413,31061,30800,Northwest Minnesota,Polk,27,119,Minnesota,MN
27121,27CS031,90,108,127,109,-18,1,19,8,-280.5779876473122,-71.13567795161659,112.12634303211715,0.35282387859455017,108,134,158,148,-10,14,40,6,-140.48283658260866,70.24141829130433,298.5260277380434,0.2857142857142857,11305,11389,Stevens and Nearby Counties,Pope,27,121,Minnesota,MN
27123,27CS025,2918,3598,4461,4354,-107,756,1436,630,-160.64207771748704,27.582250195130115,175.80686428722055,0.7590361445783133,3441,4334,5472,4976,-496,642,1535,357,-156.70682409133244,52.25397498122841,216.4177810909716,0.40134919932761215,550354,544456,Ramsey,Ramsey,27,123,Minnesota,MN
27125,27CS022,18,27,37,27,-10,0,9,2,-364.48768493036386,-52.253949626171675,210.02238802934983,0.01421228521984532,21,32,46,43,-3,11,22,6,-228.8074998013824,127.11527766743467,406.7688885357909,0.46153846153846156,3950,3933,Northwest Minnesota,Red Lake,27,125,Minnesota,MN
27127,27CS034,121,157,202,178,-24,21,57,21,-351.6903388275904,0,281.3522710620723,0.6363636363636364,143,189,249,187,-62,-2,44,18,-520.5064636329995,-130.12661590824987,169.16460068072485,-0.23376623376623376,15354,15370,Yellow Medicine and Nearby Counties,Redwood,27,127,Minnesota,MN
27129,27CS020,122,143,167,174,7,31,52,34,-220.21245019290038,-25.005751484920108,150.0071508049934,1.070260343675728,143,171,202,203,1,32,60,10,-61.56336751620313,150.48823170627432,342.0187084233507,0.30303030303030304,14657,14619,Kandiyohi+Renville,Renville,27,129,Minnesota,MN
27131,27CS026,350,443,551,508,-43,65,158,52,-170.10646567875366,23.26548189188635,189.70316004153486,0.5777777777777777,421,541,681,615,-66,74,194,73,-207.13044383678468,1.4874717690253838,180.05845764052265,0.6517857142857143,67052,67228,Rice,Rice,27,131,Minnesota,MN
27133,27CS030,81,99,119,119,-0,20,38,13,-164.3211004726342,91.31496941730876,316.27471092045846,0.6027632833519181,97,120,146,122,-24,2,25,16,-413.0675645149145,-144.5736475802201,92.94020201585577,0.6956521739130435,9648,9684,Southwest Minnesota,Rock,27,133,Minnesota,MN
27135,27CS022,99,119,139,174,35,55,75,17,141.54717389000362,296.9010492225061,451.9319435252113,0.31028588134126467,120,148,176,171,-5,23,51,15,-131.03369203806528,52.41347681522611,235.86064566851752,0.5769230769230769,15273,15263,Northwest Minnesota,Roseau,27,135,Minnesota,MN
27137,27CS027,1396,1729,2128,2079,-49,350,683,220,-161.79495185433848,78.08926579195844,278.11792355135964,0.5513784461152882,1645,2078,2667,2371,-296,292,726,185,-241.34985317047654,53.939935999638735,271.4558639609726,0.4337637848951633,199771,199296,St. Louis and Nearby Counties,St. Louis,27,137,Minnesota,MN
27139,27CS028,488,611,767,740,-27,129,252,64,-72.32841546715684,51.60644352760917,149.3014108517985,0.43243243243243246,590,746,960,911,-49,166,321,109,-103.31693051315409,36.933923277400865,138.61660939774958,0.5662375863557858,151144,152976,Scott,Scott,27,139,Minnesota,MN
27141,27CS029,380,478,597,595,-2,117,215,57,-72.57485305922312,73.7424417197864,194.24988189687062,0.456,450,586,752,727,-25,140,277,87,-113.31284737100917,54.12711905668741,192.22715179010484,0.5489013613565799,97637,98841,Sherburne,Sherburne,27,141,Minnesota,MN
27143,27CS021,98,117,139,93,-46,-24,-5,2,-388.4442710853818,-208.4138045021812,-55.337991880605884,-0.08140831513376426,117,141,170,170,-0,29,53,12,-80.87123939648578,114.09220495769782,275.1635531332712,0.3870967741935484,14824,14900,McLeod+Meeker+Sibley,Sibley,27,143,Minnesota,MN
27145,27CS005,726,908,1140,1187,47,279,461,185,-104.3140009269522,71.02872935265127,208.59022061488704,0.6457262249945177,871,1110,1421,1279,-142,170,408,121,-165.61774206028113,30.53006647633461,180.7254038217663,0.5094759422756444,158809,158860,Benton+Stearns,Stearns,27,145,Minnesota,MN
27147,27CS013,215,268,342,299,-43,31,84,6,-157.83239926049615,80.52673431657966,251.4044645363616,0.12,254,330,426,383,-43,53,129,33,-203.48365353561215,53.548329877792675,257.1658542380992,0.4490003702332469,37255,37349,Dodge+Steele+Waseca,Steele,27,147,Minnesota,MN
27149,27CS031,56,70,86,80,-6,10,24,2,-93.04645352653088,100.65474927991215,274.47609179832506,0.1589362365945011,66,85,106,74,-32,-11,8,7,-402.38853708552045,-185.7177863471633,10.317654797064627,-0.4117647058823529,9677,9692,Stevens and Nearby Counties,Stevens,27,149,Minnesota,MN
27151,27CS031,86,104,124,123,-1,19,37,17,-224.14386903196396,19.603069600655136,243.5455694693733,0.8402865722544147,107,132,160,94,-66,-38,-13,15,-830.332773798388,-543.3041606335131,-287.02861316487486,-0.39473684210526316,9714,9755,Stevens and Nearby Counties,Swift,27,151,Minnesota,MN
27153,27CS014,143,186,235,214,-21,28,71,31,-248.13202456424938,-14.3015576117723,190.68743482363067,0.775,169,224,293,252,-41,28,83,28,-273.7837679441536,0,217.91761558507167,0.56,25172,25239,Douglas+Morrison+Todd,Todd,27,153,Minnesota,MN
27155,27CS031,37,49,62,56,-6,7,19,3,-342.03212692374336,132.39830064808206,577.1768264966687,0.27824861010906593,45,61,78,62,-16,1,17,1,-515.9723803019956,0,485.62106381364293,0.0625,3327,3295,Stevens and Nearby Counties,Traverse,27,155,Minnesota,MN
27157,27CS017,127,165,209,194,-15,29,67,6,-117.50614196910217,128.69720310901667,341.32736476739206,0.16216216216216217,151,200,264,219,-45,19,68,10,-255.86651521436576,41.869066125987125,269.8228705896948,0.23255813953488372,21446,21496,Goodhue+Wabasha,Wabasha,27,157,Minnesota,MN
27159,27CS024,139,180,230,170,-60,-10,31,11,-606.43177123571445,-179.36714360492962,170.82585105231394,-0.2558139534883721,164,219,285,222,-63,3,58,29,-649.4060346526354,-183.52779240183173,204.70407614050464,0.46774193548387094,14049,14167,Otter Tail+Wadena+Wilkin,Wadena,27,159,Minnesota,MN
27161,27CS013,133,155,179,162,-17,7,29,18,-223.6625874029582,-72.29084655783615,68.64146388417413,0.9931762993464447,161,193,226,188,-38,-5,27,14,-273.78087438766755,-100.03531948780162,68.44521859691689,-0.45161290322580644,18901,18993,Dodge+Steele+Waseca,Waseca,27,161,Minnesota,MN
27163,27CS032,1189,1479,1833,1715,-118,236,526,172,-129.97474782640626,28.679137600034476,158.65388542644072,0.566723119680389,1439,1821,2328,2018,-310,197,579,182,-181.12501900906244,5.521543105651736,146.13684086291596,0.49056603773584906,267790,271663,Washington,Washington,27,163,Minnesota,MN
27165,27CS006,84,101,121,134,13,33,50,10,33.37109124075636,246.03138467485078,432.1644065787042,0.30417793758926664,99,123,152,128,-24,5,29,15,-349.85291973940446,-89.70587685625755,126.03675698304146,0.7142857142857143,11157,11148,Blue Earth+Faribault+Martin+Watonwan,Watonwan,27,165,Minnesota,MN
27167,27CS024,58,73,90,76,-14,3,18,12,-493.8006137506285,-171.04376490498515,120.28070673716334,0.7711542127492358,71,92,115,89,-26,-3,18,11,-578.2248782359327,-218.4925315871271,109.24626579356355,-0.43153846153846154,6434,6408,Otter Tail+Wadena+Wilkin,Wilkin,27,167,Minnesota,MN
27169,27CS015,279,352,446,389,-57,37,110,41,-236.32460973658397,-9.645902438227916,166.3918170594316,0.5942028985507246,330,425,548,431,-117,6,101,20,-276.16293714043906,-28.210734184357147,163.3200004030104,0.17543859649122806,49762,49626,Fillmore+Houston+Winona,Winona,27,169,Minnesota,MN
27171,27CS033,602,747,934,824,-110,77,222,92,-171.1727655938504,-12.710848930236416,110.16069072871561,0.6595066803699897,734,930,1190,1097,-93,167,363,146,-165.55287162323017,14.543444066462385,150.3168826012219,0.6886792452830188,141611,144395,Wright,Wright,27,171,Minnesota,MN
27173,27CS034,67,85,102,91,-11,6,24,14,-314.481867595441,-96.83427809085896,120.81331141372301,0.9628605595119201,81,100,123,109,-14,9,28,16,-318.906908102013,-74.28779889231586,127.35051238682719,0.9411764705882353,9519,9423,Yellow Medicine and Nearby Counties,Yellow Medicine,27,173,Minnesota,MN
28001,28CS001,261,333,417,414,-3,81,153,61,-260.07413354479405,81.27316673274815,373.85656697064144,0.6931818181818182,308,397,506,467,-39,70,159,60,-343.28885459853194,34.67564187863959,343.462232807925,0.6451612903225806,29530,28839,Adams+Amite+Wilkinson,Adams,28,1,Mississippi,MS
28003,28CS002,299,375,470,463,-7,88,164,41,-164.6178743288285,161.1883352803112,421.833302967623,0.4270833333333333,347,451,584,541,-43,90,194,67,-319.79281301992825,66.86576999507591,369.360699038017,0.6090909090909091,34990,34397,Alcorn+Prentiss+Tishomingo,Alcorn,28,3,Mississippi,MS
28005,28CS001,128,149,175,167,-8,18,39,23,-295.6218291453713,-45.687765611446,149.96374349870476,1.0313198360703282,156,186,220,224,4,38,68,31,-213.50800572649558,55.35392741057292,292.58504488445686,0.7948717948717948,12632,12646,Adams+Amite+Wilkinson,Amite,28,5,Mississippi,MS
28007,28CS003,170,215,272,272,0,57,102,33,-221.60845675032553,161.1697867275095,463.6989072306051,0.5409836065573771,199,260,333,305,-28,44,106,33,-343.85568011940603,64.77215923625175,411.1624021083807,0.55,17869,17755,Attala+Choctaw+Leake+Webster,Attala,28,7,Mississippi,MS
28009,28CS004,76,92,111,119,8,27,43,18,-154.70033562356622,138.113349766913,392.7339457586342,0.6488520824654638,90,112,137,132,-5,20,42,24,-379.1748044879914,-52.2999730328264,235.3498786477188,1.0434782608695652,7749,7648,Benton+Marshall+Tippah,Benton,28,9,Mississippi,MS
28011,28CS005,265,329,417,473,56,144,208,87,-120.8853552429013,222.27307254339917,472.03781458558694,0.6041666666666666,312,397,509,492,-17,95,180,50,-220.48978075115988,148.09015125077903,427.8159925022505,0.4672897196261682,30773,30387,Bolivar+Sunflower,Bolivar,28,11,Mississippi,MS
28013,28CS006,109,140,180,209,29,69,100,19,89.67981503538148,448.39907517690744,726.40650178659,0.2753623188405797,124,166,218,231,13,64,107,32,-145.97281687307833,249.03498941601293,574.6961294215683,0.48484848484848486,13381,13050,Calhoun+Chickasaw+Grenada,Calhoun,28,13,Mississippi,MS
28015,28CS007,82,99,117,141,24,42,59,20,51.40183872027532,259.9886724332716,469.0721414646315,0.48169794634369445,98,122,149,156,7,34,58,24,-171.92484187549778,101.1322599267634,343.84968375099555,0.6857142857142857,9933,9888,Carroll+Leflore+Montgomery,Carroll,28,15,Mississippi,MS
28017,28CS006,129,170,219,210,-9,40,81,34,-302.5472455228065,42.21589472411254,330.69117533888146,0.7391304347826086,156,206,267,248,-19,42,92,33,-306.1254468001762,52.88155510943543,346.9617588013511,0.6226415094339622,17055,17019,Calhoun+Chickasaw+Grenada,Chickasaw,28,17,Mississippi,MS
28019,28CS003,82,100,120,108,-12,8,26,10,-322.8206468469652,-33.73191442013413,231.266090304461,0.6623833134295425,103,127,154,115,-39,-12,12,13,-640.3940886699507,-307.8817733990148,-12.315270935960593,-0.5909090909090909,8191,8120,Attala+Choctaw+Leake+Webster,Choctaw,28,19,Mississippi,MS
28021,28CS008,82,100,119,113,-6,13,31,20,-347.1811591603209,-96.72127380946677,142.84905130874145,1.2204784488001965,100,122,147,130,-17,8,30,20,-414.1028122151003,-134.30361477246495,111.91967897705413,1,9060,8935,Claiborne+Jefferson+Warren,Claiborne,28,21,Mississippi,MS
28023,28CS009,139,182,234,237,3,55,98,45,-324.7967670692166,77.33256358790872,409.8625870159163,0.7758620689655172,166,220,286,254,-32,34,88,35,-434.0127828640525,-6.477802729314217,343.32354465365347,0.6862745098039216,15517,15437,Clarke+Jasper+Wayne,Clarke,28,23,Mississippi,MS
28025,28CS010,140,183,235,241,6,58,101,29,-147.30835347778034,185.73661960241867,461.13919349566015,0.48333333333333334,166,220,286,287,1,67,121,41,-215.62131506541635,140.15385479252063,431.2426301308327,0.5774647887323944,18736,18551,Clay+Oktibbeha,Clay,28,25,Mississippi,MS
28027,28CS011,178,231,288,333,45,102,155,58,-73.19168734794496,247.7257110238137,546.1225902115892,0.5631067961165048,214,277,361,390,29,113,176,53,-114.98910997231077,287.47277493077695,589.3191886080928,0.45689655172413796,21314,20872,Coahoma+Quitman+Tallahatchie+Tunica,Coahoma,28,27,Mississippi,MS
28029,28CS012,213,272,343,364,21,92,151,42,-89.68016906530026,212.5122489699059,463.2767027543948,0.44680851063829785,250,328,425,399,-26,72,149,46,-256.7901528109457,90.94651245387661,367.3525797156584,0.5542168674698795,28234,28038,Copiah+Franklin+Lincoln,Copiah,28,29,Mississippi,MS
28031,28CS013,171,220,279,298,19,78,127,50,-202.77152886053437,183.14847768048267,503.6583136213273,0.625,202,264,344,302,-42,38,100,30,-394.0612786709661,43.754201656734615,383.12272825678224,0.5172413793103449,18346,18284,Covington+Simpson+Smith,Covington,28,31,Mississippi,MS
28033,28CS014,991,1234,1542,1497,-45,264,506,152,-127.0853921022973,71.89254804366387,228.25078033593735,0.5223367697594502,1182,1508,1927,2083,156,575,901,275,-63.40487779719182,159.37547833395516,332.56349812351976,0.4708904109589041,186111,188235,De Soto,De Soto,28,33,Mississippi,MS
28035,28CS015,544,680,853,780,-73,100,236,92,-254.96872448032417,12.362119974803596,222.5954227963072,0.6764705882352942,652,828,1065,1029,-36,201,377,141,-227.24045791422975,77.00890977042522,302.96588585514775,0.6394590703414232,77657,77913,Forrest,Forrest,28,35,Mississippi,MS
28037,28CS012,70,86,103,103,0,17,33,14,-215.6606110643022,54.76331998822867,299.43259094051876,0.7642545812605853,83,105,128,143,15,38,60,16,-13.033313692853671,286.73290124278077,573.4658024855615,0.41025641025641024,7661,7673,Copiah+Franklin+Lincoln,Franklin,28,37,Mississippi,MS
28039,28CS016,192,247,314,269,-45,22,77,37,-403.3768463124992,-73.78844749618888,196.76919332317033,0.8043478260869565,235,302,393,382,-11,80,147,42,-214.57725160616639,153.8478407742325,425.30830719297677,0.4827586206896552,24394,24700,George+Greene+Perry+Stone,George,28,39,Mississippi,MS
28041,28CS016,100,119,141,141,0,22,41,22,-191.5453625182157,-1.8794172375535516,166.26673809780246,0.973006388630703,123,150,179,143,-36,-7,20,17,-389.38556977486354,-176.32554103012689,22.408037505911622,-0.68,13524,13611,George+Greene+Perry+Stone,Greene,28,41,Mississippi,MS
28043,28CS006,208,262,331,329,-2,67,121,48,-279.9201061363736,106.36964033182196,408.68335495910543,0.6666666666666666,246,321,418,350,-68,29,104,39,-500.3154721566611,-46.736615801649805,304.0216857897318,0.5492957746478874,21435,21396,Calhoun+Chickasaw+Grenada,Grenada,28,43,Mississippi,MS
28045,28CS017,332,418,529,522,-7,104,190,54,-158.0790089108403,129.57295812363958,352.4384460962997,0.4778761061946903,393,503,646,658,12,155,265,78,-143.29784058115237,167.1808140113444,406.010548313265,0.48148148148148145,46306,46058,Hancock+Harrison,Hancock,28,45,Mississippi,MS
28047,28CS017,1467,1834,2286,2084,-202,250,617,145,-199.65999008595728,60.40714294489416,271.5732554965456,0.41018469614762887,1781,2254,2868,2856,-12,602,1075,348,-172.11242376831,121.36745040852512,347.59351102236826,0.5403726708074534,208585,209282,Hancock+Harrison,Harrison,28,47,Mississippi,MS
28049,28CS018,1481,1826,2282,2460,178,634,979,268,-47.604730075761836,193.74940114121833,375.8949841240472,0.4177711033674992,1749,2217,2849,2878,29,661,1129,329,-134.48682944500106,148.70816777931842,358.4001218331976,0.4720229555236729,226994,223256,Hinds,Hinds,28,49,Mississippi,MS
28051,28CS036,137,179,231,260,29,81,123,62,-234.50338282973334,135.01709920499798,433.47595007920404,0.760764829870521,160,214,277,299,22,86,139,27,-30.199315482182403,353.3319911415341,676.4646668008859,0.3103448275862069,16887,16557,Yazoo and Nearby Counties,Holmes,28,51,Mississippi,MS
28053,28CS036,70,86,104,117,13,31,47,25,-179.52742013854893,100.6192522792976,342.5641057310742,0.7937426975742904,85,105,129,144,15,39,59,14,12.541392094522529,330.03663406638134,594.0659413194865,0.358974358974359,7748,7575,Yazoo and Nearby Counties,Humphreys,28,53,Mississippi,MS
28055,28CS036,8,16,27,13,-14,-3,5,6,-1816.9200681345023,-817.614030660526,-90.84600340672512,-0.6666666666666666,10,19,32,13,-19,-6,3,6,-1942.9422622324407,-932.6122858715715,-233.1530714678929,-0.6666666666666666,1321,1287,Yazoo and Nearby Counties,Issaquena,28,55,Mississippi,MS
28057,28CS019,200,256,325,301,-24,45,101,43,-338.68655130047847,10.102507123056778,292.9727065686466,0.7413793103448276,240,312,407,358,-49,46,118,56,-440.510922748019,-41.95342121409705,260.53074573954234,0.8115942028985508,23756,23836,Itawamba+Monroe,Itawamba,28,57,Mississippi,MS
28059,28CS020,991,1221,1524,1424,-100,203,433,142,-202.5422398911963,51.05403567505362,243.55285871214102,0.5612648221343873,1193,1504,1918,1824,-94,320,631,207,-209.29836571440484,78.1871696592082,294.7830045418057,0.5625,143378,143886,Jackson,Jackson,28,59,Mississippi,MS
28061,28CS009,132,167,212,209,-3,42,77,22,-183.90968684318193,146.83408131192175,403.7937236077848,0.4782608695652174,154,204,267,317,50,112,163,37,79.75796525160187,463.2097212689186,773.0387401309105,0.32456140350877194,16345,16299,Clarke+Jasper+Wayne,Jasper,28,61,Mississippi,MS
28063,28CS008,59,74,90,97,7,23,38,17,-159.90546747015625,99.89866253455281,346.0288909600666,0.7389229222409338,72,91,114,104,-10,13,32,20,-415.96496650615427,-97.05849218476934,166.3859866024617,1.1111111111111112,7215,7212,Claiborne+Jefferson+Warren,Jefferson,28,63,Mississippi,MS
28065,28CS021,119,139,161,145,-16,6,26,21,-397.2196881358203,-159.81651452124083,51.2085286917188,1.1954450410021908,143,170,202,197,-5,27,54,17,-197.27255744442368,89.66934429291986,331.77657388380345,0.5666666666666667,11220,11152,Jefferson Davis+Lawrence+Marion,Jefferson Davis,28,65,Mississippi,MS
28067,28CS022,522,651,815,763,-52,112,241,86,-246.27308051335382,46.382470795705906,276.5108835897852,0.6209467208841623,619,781,997,1048,51,267,429,138,-130.31038846741836,193.1078703308095,435.7651244441754,0.500909090909091,67267,66802,Jones,Jones,28,67,Mississippi,MS
28069,28CS023,66,81,99,106,7,25,40,20,-167.22835915575436,60.86548397669066,267.2361039536647,0.7864956964523984,78,97,119,133,14,36,55,19,-56.48786687692706,192.058747381552,407.27752018264357,0.5277777777777778,9083,8851,Kemper+Neshoba+Noxubee+Winston,Kemper,28,69,Mississippi,MS
28071,28CS024,263,335,422,409,-13,74,146,56,-148.48283671557934,38.73465305623809,193.67326528119045,0.6829268292682927,316,414,532,523,-9,110,207,46,-96.93128049526011,111.91156929907302,283.83241315930246,0.37398373983739835,55764,56741,Lafayette+Yalobusha,Lafayette,28,71,Mississippi,MS
28073,28CS025,298,379,478,484,6,105,186,53,-87.66436258436302,96.99035860397612,248.16475408190416,0.4732142857142857,360,460,596,577,-19,118,217,86,-161.17319569118567,48.305953037795895,200.8914237444845,0.6564885496183206,64336,65209,Lamar,Lamar,28,73,Mississippi,MS
28075,28CS026,560,701,870,1032,162,331,472,151,18.019598370259438,296.21257594947014,528.2457604432217,0.4561933534743202,656,847,1086,1071,-15,224,415,140,-214.74650387496212,116.37875048707623,381.14040784517454,0.5785123966942148,72921,72178,Lauderdale+Newton,Lauderdale,28,75,Mississippi,MS
28077,28CS021,113,134,156,176,20,42,63,17,27.782315582127794,248.7146602877413,461.4643255598135,0.4048633523984897,136,162,192,202,10,40,66,27,-144.03886092435494,109.82435143792459,329.4730543137738,0.6585365853658537,12057,11837,Jefferson Davis+Lawrence+Marion,Lawrence,28,77,Mississippi,MS
28079,28CS003,146,187,242,270,28,83,124,62,-190.01010981078548,117.3591854713675,346.7684504046833,0.7380952380952381,176,228,297,317,20,89,141,38,-85.12770629762272,240.52703718441882,485.7702907842184,0.4175824175824176,21473,21203,Attala+Choctaw+Leake+Webster,Leake,28,79,Mississippi,MS
28081,28CS027,601,749,932,969,37,220,368,116,-113.68210334233423,149.3738313026249,362.016097882948,0.5110132158590308,710,900,1165,1168,3,268,458,141,-166.51933443512218,153.73798074205706,382.2951121119151,0.493006993006993,83549,82933,Lee,Lee,28,81,Mississippi,MS
28083,28CS007,240,302,384,477,93,175,237,91,8.318428741237778,358.3323150071653,623.0289834142437,0.52,278,362,463,442,-21,80,164,39,-216.9967201849897,150.0893981279512,452.2573309855492,0.42391304347826086,28130,27650,Carroll+Leflore+Montgomery,Leflore,28,83,Mississippi,MS
28085,28CS012,286,364,456,474,18,110,188,74,-193.68958599306944,124.40365915701163,393.9449206638701,0.6548672566371682,346,442,571,536,-35,94,190,54,-254.97981350157005,113.10165786987105,389.41330304563195,0.4886977886977887,34726,34924,Copiah+Franklin+Lincoln,Lincoln,28,85,Mississippi,MS
28087,28CS028,439,554,690,694,4,140,255,88,-171.86499305741302,106.3926147498271,341.68397429271397,0.5986394557823129,522,672,855,753,-102,81,231,87,-324.7243878146787,-10.30325926434729,247.36408283820444,0.6397058823529411,58651,58234,Lowndes,Lowndes,28,87,Mississippi,MS
28089,28CS029,715,890,1095,1018,-77,128,303,121,-218.3122998357062,8.267317590344845,200.62024019236821,0.7055453556371549,854,1097,1393,1176,-217,79,322,131,-317.1512887973484,-47.3904224639716,174.20537026900317,0.5927723177723178,108862,109727,Madison,Madison,28,89,Mississippi,MS
28091,28CS021,213,268,344,397,53,129,184,66,-64.14845082105714,309.6821763775173,580.0396319451911,0.5116279069767442,251,327,416,408,-8,81,157,39,-192.77256682312347,172.2648469483231,483.98218904528875,0.43333333333333335,24412,24381,Jefferson Davis+Lawrence+Marion,Marion,28,91,Mississippi,MS
28093,28CS004,265,339,423,437,14,98,172,46,-113.19512190635379,183.65511198534784,445.0104636568043,0.45544554455445546,316,408,533,580,47,172,264,72,-74.41616846911337,296.47875884108925,569.2392169748914,0.4090909090909091,33977,33729,Benton+Marshall+Tippah,Marshall,28,93,Mississippi,MS
28095,28CS019,288,365,454,495,41,130,207,76,-122.6426572575739,189.2200997688283,459.0339457354909,0.5779551237566505,339,438,562,554,-8,116,215,84,-271.27739957023175,94.35735637225453,386.42286101824845,0.6774193548387096,34246,33914,Itawamba+Monroe,Monroe,28,95,Mississippi,MS
28097,28CS007,100,119,141,184,43,65,84,35,103.1927858491815,365.4096763772393,597.3707718443674,0.5402219628433373,120,144,174,169,-5,25,49,26,-318.32962519253806,-10.268697586856067,236.69347937703188,0.9285714285714286,9782,9738,Carroll+Leflore+Montgomery,Montgomery,28,97,Mississippi,MS
28099,28CS023,260,331,412,497,85,166,237,121,-149.0967942982941,186.11250328497184,479.9634668049105,0.7289156626506024,313,400,512,470,-42,70,157,65,-369.0564557214888,17.245628772032187,317.4920256931124,0.7222222222222222,29015,28993,Kemper+Neshoba+Noxubee+Winston,Neshoba,28,99,Mississippi,MS
28101,28CS026,174,221,280,276,-4,55,102,39,-243.83811386546066,90.62508296974148,356.8362641933571,0.6610169491525424,207,268,354,324,-30,56,117,45,-355.7322798387743,52.174067709686895,341.74014349844896,0.6569693094629157,21186,21083,Lauderdale+Newton,Newton,28,101,Mississippi,MS
28103,28CS023,86,105,125,143,18,38,57,18,-0.09340210486817559,231.43631725108503,462.48468583914644,0.47663506002581957,106,129,154,151,-3,22,45,19,-216.98927382566885,29.589446430773023,256.44186906669955,0.7916666666666666,10248,10139,Kemper+Neshoba+Noxubee+Winston,Noxubee,28,103,Mississippi,MS
28105,28CS010,226,286,362,397,35,111,171,73,-88.70261483864093,88.70261483864093,228.7593751101792,0.6517857142857143,273,349,447,428,-19,79,155,61,-154.46883849274693,34.73378004833785,181.48400075256515,0.6777777777777778,51408,51823,Clay+Oktibbeha,Oktibbeha,28,105,Mississippi,MS
28107,28CS030,256,325,411,403,-8,78,147,67,-270.83399944704723,39.72231991890026,289.0701554098149,0.788235294117647,302,390,505,499,-6,109,197,61,-203.71333429193467,145.9438812837741,413.50766363735994,0.5213675213675214,33231,32889,Panola+Tate,Panola,28,107,Mississippi,MS
28109,28CS031,469,591,738,712,-26,121,243,84,-235.3120235620879,79.11444681324173,339.9782984677144,0.6,565,720,937,932,-5,212,367,154,-281.66487858184394,102.74567897954054,377.5017963886221,0.6844444444444444,56121,56450,Pearl River,Pearl River,28,109,Mississippi,MS
28111,28CS016,94,112,134,177,43,65,83,25,186.7820223344925,417.2611631690389,605.0589816268174,0.38350888349323586,113,137,165,195,30,58,82,26,34.61324208898127,276.9059367118502,484.5853892457378,0.4482758620689655,11558,11556,George+Greene+Perry+Stone,Perry,28,111,Mississippi,MS
28113,28CS032,354,448,556,543,-13,94,189,59,-215.88273267938595,106.36831381149482,389.66758341365903,0.5488490827275874,424,541,691,640,-51,99,216,78,-322.5651910374952,52.49026742958077,345.5609272447395,0.6190476190476191,40050,40007,Pike+Walthall,Pike,28,113,Mississippi,MS
28115,28CS033,197,254,324,386,62,132,189,38,91.56505272464308,359.3784950361774,577.2994973453489,0.2857142857142857,235,311,402,458,56,147,223,63,-22.28579274080098,267.4295128896117,509.5487325950279,0.42424723381099216,31388,31410,Pontotoc+Union,Pontotoc,28,115,Mississippi,MS
28117,28CS002,208,269,335,342,7,73,134,45,-182.92078340252286,134.60662116348593,428.09712909315783,0.5844155844155844,251,324,422,367,-55,42,116,40,-380.39622105069196,10.00516099554687,304.15689426462484,0.5882352941176471,24962,24987,Alcorn+Prentiss+Tishomingo,Prentiss,28,117,Mississippi,MS
28119,28CS011,57,72,90,123,33,51,66,13,392.92414574179764,725.703063315622,1026.78875064432,0.2566595248293011,68,85,105,130,25,45,62,19,100.55655258618883,435.74506120681826,721.4932648059041,0.4222222222222222,6226,5967,Coahoma+Quitman+Tallahatchie+Tunica,Quitman,28,119,Mississippi,MS
28121,28CS034,834,1036,1292,1391,99,355,557,140,-31.431755664622777,164.4240259828199,318.90613411551584,0.3872759829203716,995,1261,1620,1608,-12,347,613,209,-140.04985952277315,87.3728780024534,255.8505797158798,0.5671652232826676,156911,157944,Rankin+Scott,Rankin,28,121,Mississippi,MS
28123,28CS034,198,256,322,302,-20,46,104,43,-270.63735795316927,12.877273177787597,261.8378879483478,0.7678571428571429,238,307,398,398,-0,91,160,51,-184.80678468743784,144.6628451565071,394.2062530514819,0.53125,27956,27650,Rankin+Scott,Scott,28,123,Mississippi,MS
28125,28CS036,36,48,61,75,14,27,39,14,5.032781152347694,416.57465461882146,776.6737939019861,0.5125337632810217,41,57,74,76,2,19,35,4,-54.37491503919526,407.8118627939644,842.8111831075264,0.2,3836,3678,Yazoo and Nearby Counties,Sharkey,28,125,Mississippi,MS
28127,28CS013,198,253,323,350,27,97,152,58,-143.01744707129006,179.92517534775197,433.6658072484279,0.5979381443298969,231,307,397,400,3,93,169,58,-213.41939093016092,135.81233968282967,430.91315205080656,0.5858585858585859,26011,25771,Covington+Simpson+Smith,Simpson,28,127,Mississippi,MS
28129,28CS013,117,137,162,164,2,27,47,16,-116.03144854718597,88.91936285700939,260.0532903795122,0.5813314574954999,140,166,196,221,25,55,81,32,-49.32044934452242,162.0529049891451,345.24314541165694,0.5818181818181818,14441,14193,Covington+Simpson+Smith,Smith,28,129,Mississippi,MS
28131,28CS016,139,161,185,217,32,56,78,14,117.7591474453177,276.28716698848274,418.69369301878345,0.2488155354330947,169,200,235,282,47,82,113,47,0,188.18574380975318,354.86454546982026,0.573170731707317,18359,18599,George+Greene+Perry+Stone,Stone,28,131,Mississippi,MS
28133,28CS005,206,265,335,367,32,102,161,55,-107.47463013005175,219.62207026575794,495.31786059936894,0.5339805825242718,244,320,411,397,-14,77,153,43,-223.84689396071556,133.52270867832155,432.18159088380236,0.5,25680,25464,Bolivar+Sunflower,Sunflower,28,133,Mississippi,MS
28135,28CS011,98,118,138,181,43,63,83,31,111.16997078518804,303.5274252308212,488.1905814986293,0.4887085848985584,117,141,168,192,24,51,75,24,0,217.560634954742,410.9478660256238,0.47058823529411764,12822,12410,Coahoma+Quitman+Tallahatchie+Tunica,Tallahatchie,28,135,Mississippi,MS
28137,28CS030,199,253,321,377,56,124,178,55,4.261105135371464,294.016254340631,524.1159316506901,0.4417741935483871,238,307,397,413,16,106,175,62,-163.19394711701028,155.92906999236598,400.45420248039443,0.5688073394495413,28162,28218,Panola+Tate,Tate,28,137,Mississippi,MS
28139,28CS004,178,227,285,285,-0,58,107,43,-237.36400063560495,82.70522670230137,353.1513180188267,0.6935483870967742,210,274,356,334,-22,60,124,45,-309.4810322578162,69.28679826667526,364.9104708711564,0.6338028169014085,21764,21649,Benton+Marshall+Tippah,Tippah,28,139,Mississippi,MS
28141,28CS002,186,238,306,308,2,70,122,44,-267.0671438873194,165.13069538811666,495.70964519394215,0.5945945945945946,219,285,380,394,14,109,175,39,-133.25870845659765,373.1243836784734,724.9273740038911,0.34513274336283184,18894,18760,Alcorn+Prentiss+Tishomingo,Tishomingo,28,141,Mississippi,MS
28143,28CS011,76,94,113,117,4,23,41,15,-131.55825743167608,102.3661782211766,316.4578899817218,0.6224841610850699,95,115,141,163,22,48,68,21,10.309809784009484,278.3648641682561,484.5610598484458,0.4375,9700,9700,Coahoma+Quitman+Tallahatchie+Tunica,Tunica,28,143,Mississippi,MS
28145,28CS033,205,260,326,294,-32,34,89,40,-309.3028008191989,-25.77523340159991,210.71253305807906,0.7547169811320755,244,315,406,379,-27,64,135,46,-261.74663361513666,64.45197544558769,318.6792119254058,0.575,27934,27928,Pontotoc+Union,Union,28,145,Mississippi,MS
28147,28CS032,128,152,177,200,23,48,72,33,-84.12039998129872,128.4092928923939,333.85466267029705,0.6889041307210433,155,186,218,229,11,43,74,30,-137.2838569538338,93.93106002104417,317.9205108404572,0.6818181818181818,13926,13840,Pike+Walthall,Walthall,28,147,Mississippi,MS
28149,28CS008,327,412,520,581,61,169,254,87,-69.98255109202874,220.71419959793678,449.5033089372615,0.5117647058823529,373,484,624,653,29,169,280,98,-158.05010542868374,162.3959115113827,416.3968407133411,0.5632183908045977,44583,43720,Claiborne+Jefferson+Warren,Warren,28,149,Mississippi,MS
28151,28CS035,390,494,616,687,71,194,297,97,-70.23355847215747,260.6745535601229,540.258142093519,0.49743589743589745,467,600,763,713,-50,112,246,45,-217.0140787218,154.03207480253946,458.7873872451933,0.3191489361702128,44423,43822,Washington,Washington,28,151,Mississippi,MS
28153,28CS009,146,186,235,224,-11,38,78,29,-242.05367414154466,57.48774760861686,296.81831791606885,0.6444444444444445,169,224,288,301,13,77,132,39,-131.85211010919002,192.70693015958543,471.62485539056433,0.4875,19830,19719,Clarke+Jasper+Wayne,Wayne,28,153,Mississippi,MS
28155,28CS003,98,117,136,152,16,35,54,20,-54.2909320452846,184.98836898249314,414.2976991341134,0.5543731093199123,117,142,170,203,33,60,86,23,100.26109660574411,375.97911227154043,631.644908616188,0.38019125683060107,9896,9974,Attala+Choctaw+Leake+Webster,Webster,28,155,Mississippi,MS
28157,28CS001,90,107,127,119,-8,12,29,19,-374.88679548852804,-102.70734160118194,146.88700866572447,1.1141510056610828,107,131,157,123,-34,-8,16,15,-587.1339773833596,-275.59349958810753,12.581442372500018,-0.6818181818181818,8518,8346,Adams+Amite+Wilkinson,Wilkinson,28,157,Mississippi,MS
28159,28CS023,148,191,247,258,11,67,110,49,-257.4577226142404,121.95365808042968,413.2873968281228,0.7101449275362319,174,233,299,299,0,66,125,39,-221.49992841482012,153.34610428718315,488.4357395813982,0.5416666666666666,17712,17607,Kemper+Neshoba+Noxubee+Winston,Winston,28,159,Mississippi,MS
28161,28CS024,140,165,192,212,20,47,72,25,-52.125408352432764,210.58282729363373,457.3693516884236,0.5301636542353891,174,207,243,196,-47,-11,22,16,-507.2659472570902,-217.3996916816101,48.31104259591336,-0.5333333333333333,12393,12420,Lafayette+Yalobusha,Yalobusha,28,161,Mississippi,MS
28163,28CS036,185,235,294,307,13,72,122,38,-110.93999302002544,150.8783905072346,372.7583765472855,0.5135135135135135,212,282,365,361,-4,79,149,33,-140.10518933528135,174.18482998440382,439.24870169980096,0.3859781121751026,27042,26409,Yazoo and Nearby Counties,Yazoo,28,163,Mississippi,MS
29001,29CS044,148,190,242,196,-46,6,48,11,-270.5879056304899,-26.109359315222708,175.64478084786185,0.2619047619047619,176,230,302,291,-11,61,115,35,-183.17929194158307,103.19960109384964,317.73569490625613,0.5147058823529411,25278,25194,Scotland and Nearby Counties,Adair,29,1,Missouri,MO
29003,29CS001,119,142,165,175,10,33,56,18,-54.95826634678395,98.35171752994205,251.66170140666813,0.5493168855142855,143,172,204,191,-13,19,48,16,-160.9875755062955,16.653887121340915,177.64146262763643,0.6153846153846154,18019,18014,Andrew+Atchison+Holt+Nodaway,Andrew,29,3,Missouri,MO
29005,29CS001,47,61,76,87,11,26,40,11,-10.47466226346407,345.2339814379179,663.4996100128384,0.4204753710606432,55,74,95,95,-0,21,40,3,-58.15616359996181,343.2167032128897,705.5010010487177,0.13636363636363635,5270,5244,Andrew+Atchison+Holt+Nodaway,Atchison,29,5,Missouri,MO
29007,29CS002,199,256,322,325,3,69,126,42,-187.6779531874507,129.93089066823512,404.2294376345092,0.5753424657534246,239,312,403,330,-73,18,91,38,-444.467802361986,-80.08428871387135,212.2233650917591,0.6129032258064516,24936,24974,Audrain+Callaway,Audrain,29,7,Missouri,MO
29009,29CS003,278,355,446,437,-9,82,159,52,-210.71228741213574,103.62899380924708,369.6100779196479,0.5652173913043478,329,430,548,501,-47,71,172,51,-282.8167559077818,57.65886970596979,348.98030889538205,0.53125,34739,34687,Barry+Lawrence+McDonald,Barry,29,9,Missouri,MO
29011,29CS046,99,118,139,132,-7,14,33,16,-236.78233049471785,-24.66198932510412,178.97353819772488,0.9028791591592595,121,146,172,168,-4,22,47,26,-257.90809073987646,-34.330527885507685,180.6644029974838,1,11628,11651,Vernon and Nearby Counties,Barton,29,11,Missouri,MO
29013,29CS046,136,175,224,191,-33,16,55,16,-365.7853810264386,0,291.1353032659409,0.45714285714285713,162,213,278,244,-34,31,82,42,-472.47457653443576,-68.33951797342266,248.5073380851733,0.875,16075,16096,Vernon and Nearby Counties,Bates,29,13,Missouri,MO
29015,29CS004,206,266,336,308,-28,42,102,24,-321.0946252044985,110.93480333360796,480.71748111230113,0.42857142857142855,254,326,421,365,-56,38,111,42,-494.0704197392896,-17.645372133546058,348.117984520387,0.6,19471,19835,Benton+Henry+St. Clair,Benton,29,15,Missouri,MO
29017,29CS005,81,99,118,166,48,67,85,15,372.7129947017614,583.5199874710266,775.9959373907906,0.2227437875675605,95,116,140,163,23,47,68,15,75.8187536897473,303.2750147589892,502.2992431945758,0.3191489361702128,10764,10551,Bollinger+Madison+Stoddard+Wayne,Bollinger,29,17,Missouri,MO
29019,29CS006,806,1006,1247,1164,-83,158,358,83,-108.60871510083052,48.66977007525939,179.65351370062191,0.4029126213592233,973,1240,1590,1381,-209,140,408,94,-163.4275687802595,25.059792080072768,169.24790758595384,0.38289364526298325,183687,185556,Boone,Boone,29,19,Missouri,MO
29021,29CS007,606,756,940,954,14,198,348,105,-128.81214380470124,131.42654277385864,343.5461564336024,0.5036000184026499,713,908,1165,1119,-46,210,406,89,-161.0211504020318,144.70465809058334,377.7208420858311,0.37872340425531914,84914,83964,Buchanan,Buchanan,29,21,Missouri,MO
29023,29CS008,374,477,593,575,-18,98,201,53,-202.5203201741906,128.2676200962502,421.8579505387785,0.4732142857142857,453,574,735,707,-28,133,254,76,-247.10547027754816,135.43280582519466,423.16811785030103,0.5049889624724062,42099,42087,Butler+Carter+Ripley,Butler,29,23,Missouri,MO
29025,29CS018,69,86,104,92,-12,6,23,5,-225.5333260131154,20.290770791976776,243.26047310952097,0.3397233645253422,82,104,127,136,9,32,54,17,-90.0522725300702,168.84801099388162,416.49176045157463,0.53125,8849,8884,DeKalb and Nearby Counties,Caldwell,29,25,Missouri,MO
29027,29CS002,275,348,442,452,10,104,177,38,-75.8217685363688,178.40416126204425,375.729975991275,0.35185185185185186,330,427,558,503,-55,76,173,57,-251.19452904296566,42.6133576055031,260.27790263782276,0.5876288659793815,44394,44587,Audrain+Callaway,Callaway,29,27,Missouri,MO
29029,29CS009,319,401,506,549,43,148,230,73,-83.04175010488346,207.6043752622086,434.7235617990647,0.48344370860927155,380,488,628,664,36,176,284,74,-87.79232865017853,235.34343028431564,484.5305917618264,0.4134078212290503,43352,43341,Camden+Miller+Moniteau+Morgan,Camden,29,29,Missouri,MO
29031,29CS010,564,708,883,943,60,235,379,113,-78.12208110591058,179.82818669662439,392.0844070598531,0.46985650069156293,673,860,1106,926,-180,66,253,70,-304.75617957076514,-4.874149213446864,223.05325338036204,0.4,81411,82066,Cape Girardeau+Perry,Cape Girardeau,29,31,Missouri,MO
29033,29CS011,72,90,106,123,17,33,51,30,-184.62859457411204,47.871570714335334,291.996744267205,0.89859099626333,83,106,130,110,-20,4,27,10,-357.6369140901493,-71.52738281802986,202.66091798441795,0.5,8487,8388,Carroll+Lafayette+Ray,Carroll,29,33,Missouri,MO
29035,29CS008,50,64,80,79,-1,15,29,4,-106.87718305920022,244.70337842947728,559.2754597614518,0.25486773445523203,61,78,101,102,1,24,41,13,-226.26478479312092,207.40938606036084,527.9511645172821,0.52,5332,5304,Butler+Carter+Ripley,Carter,29,35,Missouri,MO
29037,29CS012,689,868,1073,956,-117,88,267,69,-206.97806625968195,20.569939434886468,220.20954081509535,0.44089906908378246,839,1074,1363,1255,-108,181,416,151,-236.71212344217355,27.41839267669964,242.28719661976908,0.6357922916001844,107924,109416,Cass,Cass,29,37,Missouri,MO
29039,29CS046,142,182,235,157,-78,-25,15,13,-766.5948568996608,-320.1165336504078,16.848238613179358,-0.3611111111111111,168,224,295,236,-59,12,68,34,-643.4789377408181,-152.2208239816989,235.59632075349276,0.6415094339622641,14245,14453,Vernon and Nearby Counties,Cedar,29,39,Missouri,MO
29041,29CS039,65,80,99,115,16,35,50,17,-10.686166640056863,296.3851192657267,536.7017778006876,0.48225026914072655,78,97,121,117,-4,20,39,12,-217.4060737821863,108.70303689109315,367.5521434880081,0.5454545454545454,7390,7360,Randolph and Nearby Counties,Chariton,29,41,Missouri,MO
29043,29CS013,470,598,751,708,-43,110,238,82,-167.82301750952362,38.248348652710305,209.35938209904586,0.6212121212121212,577,739,944,952,8,213,375,135,-139.30444213438352,85.5570589486765,263.30733334140757,0.6053811659192825,89416,91167,Christian,Christian,29,43,Missouri,MO
29045,29CS044,50,64,79,82,3,18,32,17,-250.62899204747822,15.697818859880641,267.96849252490574,0.9093625010952238,60,78,99,102,3,24,42,12,-133.9119652820831,185.98884066955986,446.3732176069436,0.48,6668,6721,Scotland and Nearby Counties,Clark,29,45,Missouri,MO
29047,29CS014,1276,1576,1957,1878,-79,302,602,209,-136.32859455334957,44.007494944330126,186.01447594210936,0.5954415954415955,1527,1913,2445,2220,-225,307,693,265,-192.07914279598347,16.452174971818714,167.69466917703784,0.6227975697321182,253593,255285,Clay,Clay,29,47,Missouri,MO
29049,29CS018,168,215,278,270,-8,55,102,43,-290.0425249576182,68.2452999900278,335.82374703426154,0.7166666666666667,200,263,344,246,-98,-17,46,26,-583.081585789198,-202.11614823809361,94.00751080841563,-0.40625,21100,21275,DeKalb and Nearby Counties,Clinton,29,49,Missouri,MO
29051,29CS015,458,576,718,751,33,175,293,125,-143.3555224194215,77.78378861607246,261.3535297500034,0.6925260896255372,547,706,891,775,-116,69,228,88,-264.2998485343615,-24.610130468771715,181.40256695534092,0.624113475177305,77137,77204,Cole,Cole,29,51,Missouri,MO
29053,29CS039,125,163,208,173,-35,10,48,18,-370.9610061671441,-55.94133929005001,209.78002233768757,0.5,150,196,257,227,-30,31,77,36,-385.7120941682961,-29.22061319456789,239.9012343274021,0.8,17161,17111,Randolph and Nearby Counties,Cooper,29,53,Missouri,MO
29055,29CS016,199,254,320,306,-14,52,107,27,-212.76384888505288,129.73405419820298,415.14897343424957,0.4426229508196721,235,308,401,382,-19,74,147,55,-324.0080673630286,83.19126053915599,402.8208405053869,0.6547619047619048,23124,22839,Crawford+Iron+Reynolds+Washington,Crawford,29,55,Missouri,MO
29057,29CS046,76,93,113,111,-2,18,35,28,-469.04640161516926,-156.74128291139098,103.51298267509074,1.4183463399971221,93,115,141,119,-22,4,26,10,-421.21312671220664,-78.97746125853875,210.60656335610332,0.513157894736842,7582,7597,Vernon and Nearby Counties,Dade,29,57,Missouri,MO
29059,29CS017,141,185,237,265,28,80,124,27,7.014492965413434,371.76812716691205,680.4058176451032,0.3313008130081301,172,226,291,302,11,76,130,31,-115.56880316465906,260.02980712048287,572.0655756650624,0.3924050632911392,17107,17306,Dallas+Hickory+Polk,Dallas,29,59,Missouri,MO
29061,29CS018,57,72,88,99,11,27,42,14,-42.42177350969724,180.69018825271198,403.8021500151211,0.5095928955571548,67,87,108,107,-1,20,40,11,-142.80472445630073,107.10354334222555,345.11141743606015,0.5,8402,8403,DeKalb and Nearby Counties,Daviess,29,61,Missouri,MO
29063,29CS018,77,95,113,139,26,44,62,22,47.65779427947941,236.1449266748261,433.60763680328466,0.5042338764750485,96,117,143,130,-13,13,34,12,-225.51473738808832,9.020589495523533,198.9039983762935,0.6,10992,11086,DeKalb and Nearby Counties,DeKalb,29,63,Missouri,MO
29065,29CS019,132,156,178,232,54,76,100,28,210.58348360285598,393.2303438695161,589.4066011929657,0.36943498791571894,157,186,220,269,49,83,112,45,27.72010776191892,263.34102373822975,464.311805012142,0.54216867469879515,14584,14430,Dent+Phelps,Dent,29,65,Missouri,MO
29067,29CS020,123,144,168,177,9,33,54,24,-149.4905102787402,92.40654622928803,308.90649353423566,0.724557382563294,148,178,209,229,20,51,81,40,-171.19803043994904,93.92410647578252,350.5076882573517,0.7692307692307693,11848,11712,Douglas+Ozark+Texas+Wright,Douglas,29,67,Missouri,MO
29069,29CS021,281,353,442,455,13,102,174,55,-178.88541442553952,199.4689081376123,505.2505002932497,0.5188679245283019,328,429,544,519,-25,90,191,47,-259.67968939213864,154.76405604798285,518.2796295560356,0.44339622641509435,28275,27784,Dunklin+Pemiscot,Dunklin,29,69,Missouri,MO
29071,29CS022,738,918,1147,1087,-60,169,349,134,-222.43967442668537,40.12052875513522,246.5119916797665,0.6666666666666666,880,1128,1432,1329,-103,202,449,144,-234.91963119377064,54.676700237368195,290.0717809984203,0.5517241379310345,104685,105164,Franklin,Franklin,29,71,Missouri,MO
29073,29CS023,140,182,234,240,6,58,100,37,-252.3916140850804,170.97496438021577,513.3319763891712,0.6166666666666667,168,222,294,247,-47,26,79,42,-602.3284849065591,-111.60494105511762,250.60382218740017,0.8936170212765957,14739,14784,Gasconade+Montgomery+Warren,Gasconade,29,73,Missouri,MO
29075,29CS018,58,74,90,92,2,18,34,13,-205.88760245111828,97.11033229148698,400.1082670340921,0.6904386620724815,71,90,111,105,-6,15,34,5,-178.43986779227976,162.21806162934524,470.4323787251012,0.2631578947368421,6187,6165,DeKalb and Nearby Counties,Gentry,29,75,Missouri,MO
29077,29CS024,2039,2512,3148,2927,-221,415,888,359,-233.21501785203438,22.517312068472286,212.70818007538998,0.6977654792036568,2435,3073,3910,3571,-339,498,1136,388,-241.8981092440615,36.593264136487335,248.90072933563468,0.5928192917337816,298437,300602,Greene,Greene,29,77,Missouri,MO
29079,29CS025,83,101,122,137,15,36,54,31,-193.25068747222412,60.09545425840644,283.04005898136126,0.864099596578992,98,123,148,152,4,29,54,26,-226.30689014472068,30.860030474280094,288.0269510932809,0.8666666666666667,9736,9721,Grundy and Nearby Counties,Grundy,29,79,Missouri,MO
29081,29CS018,76,93,112,105,-7,12,29,15,-319.83895978122604,-42.56708554284998,210.59419093566729,0.9749375733073457,93,114,139,111,-28,-3,18,2,-367.52601395067495,-61.254335658445825,196.01387410702662,-0.0754985754985755,8184,8163,DeKalb and Nearby Counties,Harrison,29,81,Missouri,MO
29083,29CS004,199,255,325,301,-24,46,102,33,-311.20644631091636,70.97690880775286,376.72359290268827,0.5789473684210527,236,311,405,340,-65,29,104,34,-446.57918651541365,-22.554504369465338,315.9886062162092,0.5396825396825397,21979,22169,Benton+Henry+St. Clair,Henry,29,83,Missouri,MO
29085,29CS017,94,113,132,149,17,36,55,27,-146.19797332240842,132.0828900118937,399.3484691725458,0.7424642403034913,111,136,164,197,33,61,86,12,245.25070071628778,572.2516350046715,864.2167549050141,0.19672131147540983,8509,8563,Dallas+Hickory+Polk,Hickory,29,85,Missouri,MO
29087,29CS001,33,44,57,64,7,20,31,18,-305.11011206064137,68.99503453518626,372.9554661442964,0.8812286867440456,38,52,69,83,14,31,45,8,142.17447968089726,545.0021721101061,876.7426246988664,0.25806451612903225,4219,4220,Andrew+Atchison+Holt+Nodaway,Holt,29,87,Missouri,MO
29089,29CS039,76,94,112,92,-20,-2,16,5,-294.13535322059516,-79.72223448897726,135.17818678521223,-0.25236641742157273,92,114,139,145,6,32,53,14,-78.70529785036155,172.1678390476659,383.6883270205126,0.4375,10123,10164,Randolph and Nearby Counties,Howard,29,89,Missouri,MO
29091,29CS026,346,437,549,539,-10,102,193,80,-271.2058773829261,66.29477002693748,340.5140460474516,0.7079646017699115,412,529,677,638,-39,109,226,83,-305.8170011344521,65.09408128936353,358.01744709149943,0.6484375,39822,39942,Howell+Oregon+Shannon,Howell,29,91,Missouri,MO
29093,29CS016,104,125,146,155,9,30,51,12,-42.31292948068256,225.4904748027398,493.2938790861616,0.39955874130364644,124,152,179,190,11,38,66,19,-84.89320920649169,201.62137186541776,498.74760408813864,0.48717948717948717,9597,9424,Crawford+Iron+Reynolds+Washington,Iron,29,93,Missouri,MO
29095,29CS027,4385,5396,6660,6353,-307,956,1968,518,-138.39900082445263,73.56116589275452,243.255116539997,0.4547848990342406,5169,6519,8289,7829,-460,1310,2660,862,-184.42148290934077,62.4897510444236,250.82381769661276,0.5626631853785901,715323,716918,Jackson,Jackson,29,95,Missouri,MO
29097,29CS028,848,1055,1315,1291,-24,236,443,175,-194.8080089776471,59.71501782731896,262.4034512887352,0.6809338521400778,1019,1300,1658,1536,-122,236,517,214,-273.1151280387942,18.278079657563563,246.26665991957293,0.7316260694749638,122582,123098,Jasper,Jasper,29,97,Missouri,MO
29099,29CS029,1481,1824,2262,2088,-174,264,607,200,-197.91527058372438,34.12788384614416,215.3760483654725,0.5813953488372093,1768,2232,2843,2501,-342,270,733,265,-266.7053716104728,1.9767342044752163,205.75606697248682,0.6177156177156177,226794,227648,Jefferson,Jefferson,29,99,Missouri,MO
29101,29CS030,274,348,438,420,-18,72,146,46,-142.10539097678566,57.73031508431917,222.15069323792812,0.5542168674698795,328,422,542,565,23,144,237,57,-62.81358682515807,159.80515471694628,332.6348914079326,0.3877551020408163,54044,54128,Johnson,Johnson,29,101,Missouri,MO
29103,29CS044,25,34,45,45,-0,11,20,7,-229.59320956667807,136.51119447638732,424.16465479593853,0.5778446838340832,29,41,56,67,11,26,38,5,158.0229572240634,553.0803502842218,869.1262647323487,0.19230769230769232,3773,3797,Scotland and Nearby Counties,Knox,29,103,Missouri,MO
29105,29CS031,299,380,478,408,-70,28,109,52,-406.52268988066726,-81.63775329570775,189.93273215736096,0.7428571428571429,357,463,593,567,-26,104,210,74,-276.8771259692863,83.06313779078589,376.55289131822934,0.6218487394957983,36013,36117,Laclede+Webster,Laclede,29,105,Missouri,MO
29107,29CS011,267,335,418,383,-35,48,116,42,-280.61780329160393,21.852132637892588,269.5096358673419,0.6176470588235294,312,405,520,470,-50,65,158,40,-274.17627865200467,76.11778974236665,359.5804387429398,0.449438202247191,32949,32844,Carroll+Lafayette+Ray,Lafayette,29,107,Missouri,MO
29109,29CS003,326,410,520,453,-67,42,127,56,-388.0919175442659,-42.57814617511248,223.9295095135545,0.7368421052631579,396,506,656,581,-75,75,185,59,-350.2854262230647,41.80952495016066,329.25000898251517,0.5514018691588785,38048,38269,Barry+Lawrence+McDonald,Lawrence,29,109,Missouri,MO
29111,29CS044,84,102,123,109,-14,7,25,8,-258.2067362525554,-16.305517369084367,205.8486632381848,0.47283701695507047,101,125,152,155,3,30,54,14,-109.95029330490173,159.92769935258434,399.81924838146085,0.45161290322580644,9992,10005,Scotland and Nearby Counties,Lewis,29,111,Missouri,MO
29113,29CS032,353,440,557,480,-77,40,127,51,-256.54057280315425,-23.039567256823695,152.3616599896905,0.6071428571428571,425,542,704,606,-98,64,181,54,-247.92200905691195,16.305294906735412,207.15877179007333,0.463527851458886,59897,61330,Lincoln+Pike,Lincoln,29,113,Missouri,MO
29115,29CS025,116,136,159,162,3,26,46,14,-116.36155338259336,116.62304086911305,324.64500002242244,0.5314066039074549,136,164,193,186,-7,22,50,38,-380.36537872951214,-139.31251385209657,101.31819189243386,1.52,11857,11844,Grundy and Nearby Counties,Linn,29,115,Missouri,MO
29117,29CS025,119,141,166,169,3,28,50,30,-221.87041128661593,-19.748574875688995,162.16107789414508,1.0558817564048433,142,169,200,220,20,51,78,40,-135.80632885785462,74.69348087182004,258.0320248299238,0.7843137254901961,14643,14727,Grundy and Nearby Counties,Livingston,29,117,Missouri,MO
29119,29CS003,161,207,261,260,-1,53,99,29,-154.89992012972868,123.91993610378294,361.6913135029163,0.5087719298245614,195,253,325,304,-21,51,109,39,-256.753600345191,51.35072006903819,299.54586706938943,0.6290322580645161,23241,23369,Barry+Lawrence+McDonald,McDonald,29,119,Missouri,MO
29121,29CS039,145,168,192,235,43,67,90,15,224.61089826852154,413.5157038179906,595.5926248295274,0.22294453832174757,172,204,239,226,-13,22,54,17,-197.92062592535166,32.93188451336966,243.6959453989355,0.5666666666666667,15172,15183,Randolph and Nearby Counties,Macon,29,121,Missouri,MO
29123,29CS005,118,138,161,174,13,36,56,22,-87.51238495806491,132.86240399352374,329.62560841458475,0.6131767728108585,140,168,199,215,16,47,75,26,-79.48172118128552,166.08120843850713,387.9182511385127,0.5416666666666666,12535,12644,Bollinger+Madison+Stoddard+Wayne,Madison,29,123,Missouri,MO
29125,29CS033,68,83,101,125,24,42,57,13,154.0426897148972,410.23499227172164,619.8468761818508,0.30979817181203806,81,101,125,133,8,32,52,11,-35.6757962020142,249.73057341409935,487.5692147608607,0.34375,8472,8409,Maries+Osage+Pulaski,Maries,29,125,Missouri,MO
29127,29CS034,231,290,366,310,-56,20,79,39,-400.2015635067662,-80.04031270135324,168.50592147653313,0.6964285714285714,272,353,461,396,-65,43,124,50,-403.35309178913406,-24.551927326295118,259.5489460208341,0.6666666666666666,28486,28511,Marion+Monroe+Ralls+Shelby,Marion,29,127,Missouri,MO
29129,29CS025,25,35,47,59,12,24,34,10,72.71481134429997,492.2561297851425,827.8891845378164,0.4086689986875079,29,41,56,52,-4,11,23,7,-315.01136546687906,114.54958744250146,458.19834977000585,0.5608974358974359,3527,3492,Grundy and Nearby Counties,Mercer,29,129,Missouri,MO
29131,29CS009,188,237,300,298,-2,61,110,38,-192.93541520471751,110.93786374271257,347.2837473684915,0.5846153846153846,225,287,374,365,-9,78,140,36,-180.8439383791025,168.78767582049565,418.1513730743468,0.42857142857142855,24879,24883,Camden+Miller+Moniteau+Morgan,Miller,29,131,Missouri,MO
29133,29CS035,115,137,159,185,26,48,70,24,14.272894280328511,225.09808274308202,435.9232712058355,0.5031354337732953,141,167,198,221,23,54,80,26,-23.927539434745118,223.32370139095443,430.6957098254121,0.48148148148148145,12635,12538,Mississippi+New Madrid+Scott,Mississippi,29,133,Missouri,MO
29135,29CS009,105,126,148,165,17,39,60,21,-30.83308404815574,140.8299916470493,300.0951785420449,0.5355642662903152,124,151,180,172,-8,21,48,14,-142.10891787288787,45.21647386864614,219.62287307628125,0.5185185185185185,15517,15481,Camden+Miller+Moniteau+Morgan,Moniteau,29,135,Missouri,MO
29137,29CS034,76,94,113,114,1,20,38,16,-214.05530586621148,59.20087926014286,298.300041245703,0.7299553423061154,94,117,142,122,-20,5,28,17,-425.0288378237375,-137.8471906455365,126.35992475840845,0.85,8665,8705,Marion+Monroe+Ralls+Shelby,Monroe,29,137,Missouri,MO
29139,29CS023,127,150,172,162,-10,12,35,15,-263.4758744237484,-27.922728580141996,207.6304172634644,0.7436539374988438,157,188,220,185,-35,-3,28,17,-456.43312870646196,-175.5512033486392,96.55316184175156,-0.4857142857142857,11309,11393,Gasconade+Montgomery+Warren,Montgomery,29,139,Missouri,MO
29141,29CS009,199,256,322,305,-17,48,106,31,-274.6185605267571,100.0171656445005,428.64499561928784,0.5166666666666667,242,314,397,325,-72,10,83,36,-506.4884056753276,-119.5875402288968,220.41625061796663,0.5142857142857142,20996,21323,Camden+Miller+Moniteau+Morgan,Morgan,29,141,Missouri,MO
29143,29CS035,153,196,248,289,41,93,136,37,28.529953021591815,409.6608638997793,724.5876530227345,0.3978494623655914,182,237,307,296,-11,59,114,24,-217.69045971560297,217.69045971560297,559.7754678401219,0.3582089552238806,16404,16078,Mississippi+New Madrid+Scott,New Madrid,29,143,Missouri,MO
29145,29CS036,448,558,704,642,-62,84,194,80,-290.6289593901327,8.183849613238513,233.2397139772976,0.7017543859649122,545,689,877,818,-59,129,273,115,-293.55559015674925,23.61941529996833,266.56197267107115,0.71875,58652,59273,Newton,Newton,29,145,Missouri,MO
29147,29CS001,131,155,178,156,-22,1,25,20,-233.85091366260554,-104.39647702901391,29.68133234149154,0.6805306632292168,157,187,218,168,-50,-19,11,15,-307.06062282129665,-160.61632578344748,-18.89603832746441,-0.5769230769230769,21339,21168,Andrew+Atchison+Holt+Nodaway,Nodaway,29,147,Missouri,MO
29149,29CS026,86,104,123,140,17,36,54,10,101.168642824046,345.1647119351077,589.1607810461691,0.2810023396714308,101,125,147,179,32,54,78,14,208.59991791206934,463.55537313793184,741.688597020691,0.25925925925925924,8896,8629,Howell+Oregon+Shannon,Oregon,29,149,Missouri,MO
29151,29CS033,95,113,134,119,-15,6,24,10,-225.3743214358041,-40.16068856112741,130.23585368357516,0.586395266137412,115,141,168,165,-3,24,50,21,-180.01440863769758,22.45501978848619,217.06519128869982,0.8076923076923077,13317,13360,Maries+Osage+Pulaski,Osage,29,151,Missouri,MO
29153,29CS020,83,101,121,140,19,39,57,11,113.16979620720761,387.3660639875376,638.7126427861732,0.2829546028351261,101,124,149,188,39,64,87,39,0,291.6646809321833,549.587761521231,0.6046875,8635,8743,Douglas+Ozark+Texas+Wright,Ozark,29,153,Missouri,MO
29155,29CS021,144,186,235,261,26,75,117,32,-46.185425932261374,330.99555251453984,654.2935340403695,0.42105263157894735,167,222,287,292,5,70,125,27,-143.91410944286432,284.5574436711181,641.0719420636684,0.36486486486486486,15589,15287,Dunklin+Pemiscot,Pemiscot,29,155,Missouri,MO
29157,29CS010,132,172,220,213,-7,41,81,22,-183.61098979719478,120.08980399816528,372.91044399430274,0.4888888888888889,160,208,274,225,-49,17,65,11,-316.9983775846925,31.69983775846925,285.29853982622325,0.25,18986,18928,Cape Girardeau+Perry,Perry,29,157,Missouri,MO
29159,29CS037,308,392,491,492,1,100,184,51,-140.0071390586641,137.06992635113969,372.0469429530935,0.4811320754716981,373,479,615,514,-101,35,141,47,-343.0781151559479,-27.80774996198159,217.94324032703062,0.46078431372549017,42898,43153,Pettis+Saline,Pettis,29,159,Missouri,MO
29161,29CS019,308,390,489,509,20,118,201,73,-142.69101188717835,122.49888756352104,344.61225512375154,0.5983606557377049,369,476,608,602,-6,126,233,80,-191.75166988852553,101.39106310200944,340.94137702433943,0.5860884499785315,44572,44876,Dent+Phelps,Phelps,29,161,Missouri,MO
29163,29CS032,129,168,215,204,-11,36,75,23,-231.3201097542106,88.4459243177864,354.1238739031368,0.5476190476190477,155,204,265,212,-53,8,57,27,-450.9731154256293,-109.92469688499715,169.11491828461098,0.5684840425531915,17638,17739,Lincoln+Pike,Pike,29,163,Missouri,MO
29165,29CS038,508,640,806,740,-66,100,232,67,-149.3450195234284,37.04160574425507,185.20802872127535,0.5075757575757576,613,783,1001,902,-99,119,289,96,-180.01053253115873,21.226568819362477,178.118599223346,0.5647058823529412,106907,108355,Platte,Platte,29,165,Missouri,MO
29167,29CS017,242,310,391,364,-27,54,122,41,-257.2470597661999,49.17958495530293,306.42664472150284,0.6119402985074627,292,382,497,429,-68,47,137,44,-350.4295668105722,9.38231771915856,290.8518492939154,0.5432098765432098,31720,31975,Dallas+Hickory+Polk,Polk,29,167,Missouri,MO
29169,29CS033,226,288,365,342,-23,54,116,39,-138.4066952378516,33.485490783351196,172.00380432381388,0.6,272,350,454,459,5,109,187,50,-83.86334824959637,109.5888714668037,254.46907442291706,0.43478260869565216,53755,53838,Maries+Osage+Pulaski,Pulaski,29,169,Missouri,MO
29171,29CS025,51,66,81,59,-22,-7,8,4,-676.5240621086133,-276.11756082866,103.21491406813766,-0.31930800790230346,64,84,105,88,-17,4,24,8,-532.2143729749827,-84.9843310139693,339.9373240558772,0.4444444444444444,4682,4707,Grundy and Nearby Counties,Putnam,29,171,Missouri,MO
29173,29CS034,67,85,102,128,26,43,61,14,139.3606658999328,340.14034359346766,540.4431099385619,0.3231875287140954,82,103,127,136,9,33,54,12,-28.958810114668847,202.7116708026819,405.4233416053638,0.36363636363636365,10343,10360,Marion+Monroe+Ralls+Shelby,Ralls,29,173,Missouri,MO
29175,29CS039,189,242,306,280,-26,38,91,41,-325.78937993481173,-14.5875841761856,243.12640293642667,0.803921568627451,226,296,378,355,-23,59,129,38,-246.74725415371347,84.87620535999972,367.79688989333215,0.5277777777777778,24679,24742,Randolph and Nearby Counties,Randolph,29,175,Missouri,MO
29177,29CS011,175,223,288,284,-4,61,109,23,-140.3853375314134,197.57936393310032,447.1532973222796,0.35384615384615387,209,270,351,353,2,83,144,53,-222.18441523653692,130.3134400214293,395.28410139833557,0.5955056179775281,23079,23021,Carroll+Lafayette+Ray,Ray,29,177,Missouri,MO
29179,29CS016,61,76,92,79,-13,3,18,2,-296.20813363102866,10.6064763745325,317.42108638009364,0.14234759831797525,74,94,116,112,-4,18,38,13,-279.3439525115281,82.15998603280238,410.79993016401187,0.6190476190476191,6110,6086,Crawford+Iron+Reynolds+Washington,Reynolds,29,179,Missouri,MO
29181,29CS008,102,132,172,185,13,53,83,18,-54.24076117868187,379.6853282507731,705.1298953228643,0.33962264150943394,118,157,203,236,33,79,118,38,-47.52410024761936,385.8392297331475,752.8570336256536,0.4810126582278481,11062,10626,Butler+Carter+Ripley,Ripley,29,181,Missouri,MO
29183,29CS040,2131,2644,3289,3221,-68,577,1090,396,-137.18249411594692,53.50146829344191,205.1973441398197,0.6305732484076433,2569,3272,4134,3655,-479,382,1086,298,-189.8211405296497,20.638042170297734,192.471113991753,0.4515161880536916,405970,409438,St. Charles,St. Charles,29,183,Missouri,MO
29185,29CS004,95,113,135,140,5,27,45,16,-138.8835335640176,140.44303028446544,377.6070939294041,0.5846801857010904,112,137,164,153,-11,16,41,12,-245.4446015527039,42.68601766133981,309.4736280447136,0.5454545454545454,9360,9371,Benton+Henry+St. Clair,St. Clair,29,185,Missouri,MO
29186,29CS040,133,171,214,176,-38,5,43,10,-313.1656813102883,-32.58747984498317,215.0773669768889,0.2777777777777778,161,208,272,246,-26,38,85,26,-280.26563762003053,64.61455622363816,317.9574620838192,0.5,18412,18572,St. Charles,Ste. Genevieve,29,186,Missouri,MO
29187,29CS040,522,656,825,827,2,171,305,103,-181.14790840448828,121.84033404060537,362.02705136623985,0.5659340659340659,633,810,1027,1027,-0,218,394,123,-182.58639973485558,140.10893036901223,402.23865406468764,0.5222953479985575,66973,67448,St. Charles,St. Francois,29,187,Missouri,MO
29189,29CS043,7135,8824,10939,10649,-290,1825,3514,1364,-198.2831329839048,55.255107480856026,257.7273207390687,0.667156142927068,8541,10728,13615,11421,-2194,692,2880,933,-313.3231671416148,-24.097928269126434,195.12808944406157,0.44439215189838954,1001174,998011,St. Louis (county),St. Louis (county),29,189,Missouri,MO
29195,29CS037,167,218,274,255,-19,37,88,42,-315.17641554586373,-25.812974246180485,237.737492807322,0.8571428571428571,204,264,343,325,-18,61,121,36,-231.8255727218576,107.32665403789704,365.1252770369255,0.5142857142857142,23244,23293,Pettis+Saline,Saline,29,195,Missouri,MO
29197,29CS044,28,38,50,51,1,13,23,7,-180.03355477517405,180.9087130444731,469.6625273001906,0.5310642584770197,33,45,59,64,5,19,31,23,-448.739861400292,-99.44373659840268,200.13051990428426,1.2105263157894737,4100,4022,Scotland and Nearby Counties,Schuyler,29,197,Missouri,MO
29199,29CS044,29,39,51,51,0,12,22,7,-176.8314082630947,135.8930595842027,386.07263386204045,0.5663921363011276,33,45,59,69,10,24,36,11,-21.305021327214057,276.96527725378274,532.6255331803513,0.4583333333333333,4732,4694,Scotland and Nearby Counties,Scotland,29,199,Missouri,MO
29201,29CS035,296,370,473,469,-4,99,173,60,-201.99339040623377,122.99363350262477,356.52385301209557,0.5607476635514018,350,456,580,585,5,129,235,49,-116.2033845336156,211.2788809702102,491.22339825573874,0.35251798561151076,38051,37865,Mississippi+New Madrid+Scott,Scott,29,201,Missouri,MO
29203,29CS026,63,78,95,121,26,43,58,13,210.1169763406018,497.33359737150215,743.5192725408453,0.3030606313879726,76,95,117,120,3,25,44,15,-169.09694597998433,140.91412164998692,408.6509527849621,0.5769230769230769,7213,7097,Howell+Oregon+Shannon,Shannon,29,203,Missouri,MO
29205,29CS034,53,67,82,84,2,17,31,1,15.538473277398667,324.75929044033893,601.4305479019171,0.054860763316898715,61,79,99,88,-11,9,27,2,-216.87525849514984,116.77898534354222,417.0678047983651,0.13333333333333333,6062,5994,Marion+Monroe+Ralls+Shelby,Shelby,29,205,Missouri,MO
29207,29CS005,256,324,406,380,-26,56,124,49,-313.8118049652315,27.17890382776821,313.6027364742486,0.7205882352941176,302,391,506,450,-56,59,148,65,-424.4984114199428,-21.049508004294683,291.18486072607647,0.7647058823529411,28699,28504,Bollinger+Madison+Stoddard+Wayne,Stoddard,29,207,Missouri,MO
29209,29CS045,272,343,432,386,-46,43,114,47,-356.34890768549536,-15.31859893328298,256.7780146191558,0.6811594202898551,332,422,552,499,-53,77,167,66,-378.0132606289769,34.927726727582915,320.8587987111138,0.6666666666666666,31334,31494,Stone+Taney,Stone,29,209,Missouri,MO
29211,29CS025,44,57,71,72,1,15,28,12,-215.49483645482982,65.60709756120639,329.3977687786011,0.7456301826125176,52,68,89,86,-3,18,34,11,-235.6852759832495,117.84263799162476,387.19723911533845,0.55,5984,5940,Grundy and Nearby Counties,Sullivan,29,211,Missouri,MO
29213,29CS045,406,510,638,622,-16,112,216,72,-188.3574242657338,85.617011029879,308.32826097135165,0.5806451612903226,488,622,802,795,-7,173,307,103,-195.35452386033023,124.26003335050538,362.2179972167231,0.544973544973545,56064,56333,Stone+Taney,Taney,29,213,Missouri,MO
29215,29CS020,199,257,326,346,20,89,147,19,4.875224717389317,341.26573021725216,624.0287638258326,0.2087912087912088,245,317,414,441,27,124,196,47,-80.51144510682153,309.19607347756903,598.314479846205,0.3700787401574803,24614,24903,Douglas+Ozark+Texas+Wright,Texas,29,215,Missouri,MO
29217,29CS046,153,198,250,251,1,53,98,37,-218.65394639162224,97.04474735827895,369.98309930343856,0.6607142857142857,184,238,307,340,33,102,156,44,-56.117140279033976,295.8903760167246,571.3745192047095,0.4230769230769231,19785,19602,Vernon and Nearby Counties,Vernon,29,217,Missouri,MO
29219,29CS023,212,265,337,315,-22,50,103,18,-134.10521438790633,107.28417151032507,284.9735805743009,0.29508196721311475,257,328,424,463,39,135,206,65,-71.42910289511083,192.30912317914454,387.5028832059761,0.4744525547445255,35793,36400,Gasconade+Montgomery+Warren,Warren,29,219,Missouri,MO
29221,29CS016,183,235,299,322,23,87,139,44,-106.41564211406073,217.89869575736247,481.6574658543557,0.5,218,285,369,401,32,116,183,55,-97.86583338873744,259.5572102918689,544.6446379894953,0.4700854700854701,23681,23502,Crawford+Iron+Reynolds+Washington,Washington,29,221,Missouri,MO
29223,29CS005,112,133,155,188,33,55,76,21,133.19867019673032,362.1555994780573,591.1125287593845,0.383130393609563,130,156,185,242,57,86,112,17,366.50663816059483,632.2239508270261,870.4532656314127,0.19767441860465115,11203,10914,Bollinger+Madison+Stoddard+Wayne,Wayne,29,223,Missouri,MO
29225,29CS031,240,310,389,362,-27,52,122,50,-235.13556929135402,6.107417384191013,219.86702583087651,0.7246376811594203,288,378,489,508,19,130,220,63,-110.9645244523885,168.9687076888643,395.94159861420445,0.468407960199005,39296,39652,Laclede+Webster,Webster,29,225,Missouri,MO
29227,29CS018,16,25,34,25,-9,0,9,4,-774.8391159212081,-223.43176138825766,277.8476518235158,0.4674540431265186,19,29,43,32,-11,3,13,3,-707.0930269263549,0,505.0664478045393,0.3,1968,1980,DeKalb and Nearby Counties,Worth,29,227,Missouri,MO
29229,29CS020,167,215,271,204,-67,-11,37,27,-618.5288747969076,-249.91065648359904,65.76596223252606,-0.574468085106383,201,268,352,290,-62,22,89,43,-566.3899715816549,-113.22407808866971,248.01464724184797,0.7962962962962963,18247,18547,Douglas+Ozark+Texas+Wright,Wright,29,229,Missouri,MO
29510,29CS042,2025,2524,3105,3132,27,608,1107,330,-121.40941414629626,111.06349901301208,310.97779723643384,0.5061361599424139,2388,3017,3818,3392,-426,375,1004,265,-234.74447545777934,37.36887453018195,251.08486513870432,0.42536115569823435,299828,294363,St. Louis (city),St. Louis (city),29,510,Missouri,MO
30001,30CS001,60,75,93,94,1,19,34,4,-37.048916927998164,193.78640437892952,382.65166726641587,0.19993542969891753,74,93,117,122,5,29,48,18,-136.8157022329024,115.76713265860973,316.254757853747,0.6206896551724138,9403,9502,Beaverhead+Gallatin+Madison,Beaverhead,30,1,Montana,MT
30003,30CS004,112,133,155,197,42,64,85,61,-177.99414135746767,25.81459696618828,222.07486350007926,0.9559386499596492,142,168,201,165,-36,-3,23,24,-462.58075085850487,-208.1613378863272,-7.324195221926678,-0.6666666666666666,13070,12971,Eastern Montana,Big Horn,30,3,Montana,MT
30005,30CS009,44,57,72,89,17,32,45,24,-112.59669255828463,142.6909956687571,369.6133852039052,0.7436875186349758,52,69,88,76,-12,7,24,7,-272.797245774089,0,243.44111171441014,0.5,6956,6983,North Central Montana,Blaine,30,5,Montana,MT
30007,30CS010,42,54,68,43,-25,-11,1,8,-586.7107419434622,-340.0028705104764,-122.31945454019497,-0.6198556393296224,54,71,91,92,1,21,38,20,-263.0288697257232,13.843624722406485,249.8774262394364,0.9090909090909091,6798,7224,South Central Montana,Broadwater,30,7,Montana,MT
30009,30CS010,72,88,105,104,-1,16,32,4,-59.87506847505921,136.51274660267052,323.10449489505027,0.2162588512907701,90,111,137,109,-28,-2,19,18,-425.9990623390204,-185.21698362566104,9.260849181283051,-0.5539772727272727,10575,10798,South Central Montana,Carbon,30,9,Montana,MT
30011,30CS004,7,15,26,17,-9,2,10,6,-1294.905804595117,-345.3082145586979,345.3082145586979,0.8571428571428571,10,19,33,12,-21,-7,2,6,-1893.6571253232805,-911.7608381186166,-277.03502388989057,-0.6,1390,1426,Eastern Montana,Carter,30,11,Montana,MT
30013,30CS002,620,774,952,908,-44,134,288,137,-258.8923749427151,-4.289848797725188,215.99388696546313,0.8616352201257862,738,948,1197,1029,-168,80,291,114,-334.0265093593559,-39.65233190481369,209.62471583111943,0.5906735751295337,83919,84484,Cascade,Cascade,30,13,Montana,MT
30015,30CS009,40,52,67,64,-3,12,24,5,-155.27443353486908,147.3071451007157,382.64837292839263,0.3610415308630901,48,65,84,72,-12,7,24,4,-270.5663926947074,50.731198630257644,338.2079908683843,0.3076923076923077,5869,5914,North Central Montana,Chouteau,30,15,Montana,MT
30017,30CS004,97,116,139,119,-20,3,22,12,-325.0601790491411,-94.98685805290647,101.62125261660302,0.5899140771720569,121,145,175,158,-17,13,37,28,-377.9071293229689,-125.96904310765629,76.00132267495225,1.2727272727272727,11792,11908,Eastern Montana,Custer,30,17,Montana,MT
30019,30CS004,11,17,25,25,-0,8,14,7,-541.476457997995,53.14767768904967,528.8469862386852,0.8180445754714075,12,21,31,20,-11,-1,8,5,-951.2956448496259,-356.73586681860974,178.36793340930487,-0.35714285714285715,1659,1682,Eastern Montana,Daniels,30,19,Montana,MT
30021,30CS004,55,69,86,115,29,46,60,20,128.34776049535907,350.58291184581014,539.4827904936933,0.4353565047156432,64,83,103,141,38,58,77,22,179.6415589519038,404.1935076417835,617.5178588971693,0.3793103448275862,8879,8907,Eastern Montana,Dawson,30,21,Montana,MT
30023,30CS003,85,101,122,133,11,32,48,6,68.00151904173234,330.6390950564151,540.7491558681612,0.18823237615004476,101,125,152,125,-27,0,24,14,-433.03400714690713,-147.6851668710524,105.48940490789457,0.44455645161290325,9391,9480,Deer Lodge and Nearby Counties,Deer Lodge,30,23,Montana,MT
30025,30CS004,16,25,37,29,-8,4,13,7,-598.1304243037483,-139.06193170538728,221.634741050468,0.9181425800118626,21,32,45,34,-11,2,13,8,-629.2779863104438,-198.71936409803487,165.59947008169573,0.8,3009,3019,Eastern Montana,Fallon,30,25,Montana,MT
30027,30CS009,110,132,154,150,-4,18,40,15,-197.08357715568195,27.695572933320484,261.1200749488234,0.7462601833259765,138,164,194,172,-22,8,34,23,-388.14295161151205,-133.69368333285416,94.87938817170294,0.92,11412,11594,North Central Montana,Fergus,30,27,Montana,MT
30029,30CS005,641,799,992,941,-51,142,300,62,-129.28201651254506,91.40575626163151,271.93212487835376,0.36046511627906974,776,992,1253,1249,-4,257,473,150,-142.79467763186472,99.15010062692748,299.34990661241983,0.5415162454873647,105026,107917,Flathead,Flathead,30,29,Montana,MT
30031,30CS001,537,671,829,705,-124,34,168,40,-144.53865089552198,-5.284776998008116,112.78594909915651,0.3225806451612903,643,830,1065,876,-189,46,233,80,-192.58732691266198,-24.341892620931254,109.57431369510374,0.44692737430167595,136240,139677,Beaverhead+Gallatin+Madison,Gallatin,30,31,Montana,MT
30033,30CS004,8,16,27,12,-15,-4,4,5,-2016.065522129469,-907.2294849582611,-100.80327610647346,-0.625,10,19,34,19,-15,0,9,6,-1744.7596628182714,-498.5027608052204,249.2513804026102,0.41428571428571426,1190,1204,Eastern Montana,Garfield,30,33,Montana,MT
30035,30CS009,95,115,135,160,25,45,65,42,-146.96479910433177,25.31039294367455,197.58558499168086,0.9354341854368614,113,139,167,183,16,44,70,21,-36.2858965791471,166.91512426407667,355.6017864756416,0.4772727272727273,13744,13779,North Central Montana,Glacier,30,35,Montana,MT
30037,30CS010,4,10,18,12,-6,2,8,7,-1897.4255017230894,-729.7790391242651,145.95580782485303,1.4,5,12,22,17,-5,5,12,3,-964.5575343498027,241.13938358745068,1085.127226143528,0.42857142857142855,822,829,South Central Montana,Golden Valley,30,37,Montana,MT
30039,30CS003,16,25,35,25,-10,0,9,6,-562.0669286641669,-205.00775039332402,92.54156483237851,0.38841396259249916,19,30,43,39,-4,9,20,5,-269.5619618120554,119.80531636091351,449.2699363534257,0.45454545454545453,3316,3339,Deer Lodge and Nearby Counties,Granite,30,39,Montana,MT
30041,30CS009,104,123,144,158,14,35,54,34,-146.5248842802601,4.993911213313994,150.45195488714506,0.9804647627360247,121,150,183,205,22,55,84,29,-43.238290594770994,160.59936506629228,340.0382710345916,0.5272727272727272,16278,16189,North Central Montana,Hill,30,41,Montana,MT
30043,30CS006,69,86,103,136,33,50,67,2,307.30462542479506,477.8170109771237,639.8240281289801,0.03960682090603608,84,107,130,177,47,70,93,18,233.47830681263534,418.6507570433462,603.8232072740569,0.2571428571428571,12179,12421,Jefferson+Lewis and Clark,Jefferson,30,43,Montana,MT
30045,30CS009,9,16,25,16,-9,-0,7,1,-574.4731635915533,-85.77462108349117,354.05406717376474,-0.10541113201732114,12,20,30,24,-6,4,12,6,-588.217272755124,-98.036212125854,294.108636377562,0.8571428571428571,2019,2040,North Central Montana,Judith Basin,30,45,Montana,MT
30047,30CS007,218,275,349,319,-30,44,101,23,-203.5755082552509,80.6619938369862,299.60169139452023,0.3865819209039548,262,342,446,397,-49,54,135,62,-347.7429991267265,-23.49614858964368,228.85248726312932,0.7654320987654321,31241,31920,Lake+Lincoln+Mineral+Sanders,Lake,30,47,Montana,MT
30049,30CS006,439,556,694,604,-90,48,165,49,-234.9634292968852,-1.6903843834308288,196.08458847797613,0.4537037037037037,534,689,870,782,-88,93,248,99,-259.5818079943472,-8.326601699898866,206.77727554748853,0.6923076923076923,70990,72058,Jefferson+Lewis and Clark,Lewis and Clark,30,49,Montana,MT
30051,30CS009,6,10,16,18,2,8,12,2,22.515818669366137,364.2873700991887,610.8511322021301,0.24587560428011876,5,11,18,15,-3,4,10,2,-256.66802130344576,102.66720852137831,410.66883408551325,0.4,2021,1948,North Central Montana,Liberty,30,51,Montana,MT
30053,30CS007,164,210,266,239,-27,29,75,12,-235.56207098320738,102.68090273626987,380.52334543441197,0.2608695652173913,201,262,338,331,-7,69,130,50,-279.2856982448691,93.09523274828969,392.2249148158202,0.6536226930963773,19867,20409,Lake+Lincoln+Mineral+Sanders,Lincoln,30,53,Montana,MT
30055,30CS004,10,17,25,13,-12,-4,3,1,-941.3747423681284,-367.51031796565826,148.96766399656468,-0.16922018664018762,12,21,33,25,-8,4,13,4,-697.5983722704648,0,523.1987792028485,0.5,1719,1720,Eastern Montana,McCone,30,55,Montana,MT
30057,30CS001,61,76,94,91,-3,15,30,4,-93.35454063561282,145.4212049801644,360.9432556547377,0.2352047520796167,76,97,119,105,-14,8,29,14,-315.34786811701656,-67.57454316793212,168.9363579198303,0.875,8698,8879,Beaverhead+Gallatin+Madison,Madison,30,57,Montana,MT
30059,30CS010,12,19,28,18,-10,-1,6,3,-810.9159625332331,-270.4825229642652,167.0112138296613,-0.40071251587594836,15,24,36,19,-17,-5,4,7,-1225.5449526058787,-612.7724763029394,-153.19311907573484,-0.7777777777777778,1917,1958,South Central Montana,Meagher,30,59,Montana,MT
30061,30CS007,35,47,62,54,-8,7,19,3,-301.21306985839027,108.52556469273961,410.438242783046,0.266709900274842,45,61,79,84,5,23,39,13,-167.11718530372158,207.5989879549337,539.7573686828276,0.5416666666666666,4575,4817,Lake+Lincoln+Mineral+Sanders,Mineral,30,61,Montana,MT
30063,30CS008,603,748,939,835,-104,88,232,56,-161.9359772560251,31.86123225212237,178.01831353566786,0.4,724,910,1176,1090,-86,180,366,94,-150.82432300564946,72.47946633327044,228.12178854604463,0.4253393665158371,118639,119344,Missoula,Missoula,30,63,Montana,MT
30065,30CS010,39,52,66,60,-6,8,21,4,-247.13914718920347,106.33421653831647,418.22247865083403,0.34803420542209573,50,66,85,92,7,26,42,17,-206.1846857435941,174.3850575940846,513.9230226743308,0.6538461538461539,4745,4874,South Central Montana,Musselshell,30,65,Montana,MT
30069,30CS009,3,7,14,6,-8,-1,3,6,-3359.720023331389,-1679.8600116656944,-719.9400049995833,-0.8571428571428571,4,9,17,5,-12,-4,1,5,-3294.9727437916413,-1744.3973349485161,-775.2877044215627,-0.8333333333333334,500,516,North Central Montana,Petroleum,30,69,Montana,MT
30071,30CS004,41,53,67,46,-21,-7,5,12,-942.3229579987069,-561.311026291478,-205.2251088080867,-1.118528472683947,49,67,86,67,-19,0,18,13,-763.4118945139711,-310.1360821463008,119.28310851780799,0.5652173913043478,4156,4192,Eastern Montana,Phillips,30,71,Montana,MT
30073,30CS009,52,66,82,67,-15,1,15,4,-391.4669281470613,-56.474524380074996,228.26901882186314,0.24958394613433035,65,84,106,69,-37,-15,4,4,-685.8863547649584,-317.84977415937095,0,-0.2222222222222222,5890,5978,North Central Montana,Pondera,30,73,Montana,MT
30075,30CS004,9,16,23,15,-8,-1,6,6,-993.6317305057639,-469.22934413983364,-3.093889592340142,-0.7481098332101896,11,19,30,22,-8,3,11,0,-470.39800080849653,176.3992503031862,646.7972511116827,0,1693,1701,Eastern Montana,Powder River,30,75,Montana,MT
30077,30CS003,54,69,86,81,-5,12,27,1,-95.31357206351488,189.4506691420057,445.738486226974,0.06566866210396832,66,86,108,82,-26,-4,16,14,-572.2852961427375,-257.5283832642319,29.329621427314645,-0.7,6929,6990,Deer Lodge and Nearby Counties,Powell,30,77,Montana,MT
30079,30CS004,11,17,26,18,-8,1,7,2,-1154.4675741668607,-141.12045060601645,592.5245257276262,0.1886677488040569,14,23,34,12,-22,-11,-2,7,-2663.4521554445782,-1653.1771999311177,-826.5885999655588,-0.6363636363636364,1076,1089,Eastern Montana,Prairie,30,79,Montana,MT
30081,30CS003,329,417,522,478,-44,61,149,35,-213.08618133491674,70.12962930009918,307.49145154658873,0.4268292682926829,408,519,669,665,-4,146,257,106,-240.57124736191756,87.48045358615184,330.4574134216884,0.6773232075779847,44489,45724,Deer Lodge and Nearby Counties,Ravalli,30,81,Montana,MT
30083,30CS004,60,75,92,95,3,20,35,15,-127.20125520151984,54.58643399227545,210.40445330124288,0.7140660840347147,71,91,113,128,15,37,57,16,-8.83798862108965,185.59776104288267,362.35753346467567,0.43243243243243246,11397,11315,Eastern Montana,Richland,30,83,Montana,MT
30085,30CS004,94,113,135,167,32,54,73,45,-142.317877144998,94.74684313730761,313.57581570558966,0.8404422717134502,115,142,172,193,21,51,78,22,-9.246399201727534,268.1455768500985,518.2606752568279,0.43137254901960786,10820,10815,Eastern Montana,Roosevelt,30,85,Montana,MT
30087,30CS004,62,79,96,123,27,44,61,35,-117.36258999524891,129.9984946640801,377.3595793234095,0.7941269746975789,76,96,121,126,5,30,50,21,-196.33407469897998,110.43791701817624,355.8555103919012,0.6774193548387096,8376,8149,Eastern Montana,Rosebud,30,87,Montana,MT
30089,30CS007,120,144,169,163,-6,19,43,14,-196.5813345813972,49.46315880916702,279.633813916469,0.6246577678746834,154,184,219,233,14,49,79,39,-194.02531383594516,77.61012553437806,310.82855276518376,0.78,12430,12885,Lake+Lincoln+Mineral+Sanders,Sanders,30,89,Montana,MT
30091,30CS004,27,38,50,29,-21,-9,2,3,-830.4675188396386,-406.4079205543263,-38.889602040389285,-0.2867185706164266,33,46,62,61,-1,15,28,6,-198.54283738987078,255.2693623584053,625.4099377780917,0.36397058823529416,3490,3526,Eastern Montana,Sheridan,30,91,Montana,MT
30093,30CS003,282,360,452,402,-50,42,120,54,-355.176276068057,-40.96218464984799,225.29201557416394,0.7714285714285715,338,437,555,536,-19,99,198,51,-197.8767122077564,135.68688837103295,415.6824361450081,0.45132743362831856,35154,35376,Deer Lodge and Nearby Counties,Silver Bow,30,93,Montana,MT
30095,30CS010,53,67,81,95,14,28,42,6,100.20404676086164,295.1389715316801,479.24417825967544,0.21122437005874653,60,79,98,133,35,54,73,20,165.94679561347303,376.1460700572055,586.345344500938,0.37037037037037035,9110,9039,South Central Montana,Stillwater,30,95,Montana,MT
30097,30CS010,20,28,39,46,7,18,26,4,109.43734950649765,457.6619437479767,725.5270162414222,0.2216449042975209,23,34,47,42,-5,8,19,2,-188.40417180666145,161.48929011999553,457.55298867332067,0.18181818181818182,3683,3715,South Central Montana,Sweet Grass,30,97,Montana,MT
30099,30CS009,44,56,70,65,-5,9,21,7,-228.83069407264958,40.32038725409174,262.76583976236833,0.6055247836141561,54,69,88,92,4,23,38,14,-159.6153270617811,143.653794355603,383.0767849482746,0.5833333333333334,6231,6265,North Central Montana,Teton,30,99,Montana,MT
30101,30CS009,35,46,60,48,-12,2,13,3,-365.3983280499848,-25.315984700411946,254.75182746982466,0.2726472245500596,42,58,77,75,-2,17,33,3,-99.91715202811004,279.7680256787081,600.5020836889403,0.16666666666666666,4932,5004,North Central Montana,Toole,30,101,Montana,MT
30103,30CS004,3,8,16,8,-8,0,5,8,-2551.848262494808,-1275.924131247404,-478.47154921777644,1.6,4,10,20,2,-18,-8,-2,2,-2607.6327583865277,-1303.8163791932639,-515.0074697813452,-0.25,752,767,Eastern Montana,Treasure,30,103,Montana,MT
30105,30CS004,65,82,100,91,-9,9,26,17,-419.380340058901,-130.98555204321198,144.30038197176404,1.239260595169066,82,103,131,102,-29,-1,20,13,-557.099985077679,-185.69999502589297,92.84999751294649,-0.38235294117647056,7526,7539,Eastern Montana,Valley,30,105,Montana,MT
30107,30CS010,17,26,36,32,-4,6,15,6,-583.9733265333899,-17.724441061131227,501.33703728843943,0.668167275312044,21,33,48,31,-17,-2,10,2,-920.5612193398606,-193.80236196628644,387.6047239325729,-0.14835164835164835,2091,2064,South Central Montana,Wheatland,30,107,Montana,MT
30109,30CS004,7,13,21,19,-2,6,12,3,-591.3496457708723,366.2216045717675,1106.8844501406604,0.449927346683166,9,17,27,20,-7,3,11,8,-1607.501674480911,-535.833891493637,321.5003348961822,1.1428571428571428,932,933,Eastern Montana,Wibaux,30,109,Montana,MT
30111,30CS011,1107,1361,1701,1579,-122,218,472,173,-214.90381751488877,32.78193826498303,217.8541919587372,0.6134751773049646,1309,1684,2141,1942,-199,258,633,238,-262.04809234817725,11.687872371430595,236.78430668377723,0.6538461538461539,164725,166840,Yellowstone,Yellowstone,30,111,Montana,MT
31001,31CS015,206,264,331,337,6,73,131,47,-157.90423846107555,100.13439512165768,323.5111227007402,0.618421052631579,248,318,412,364,-48,46,116,32,-257.6945996875453,43.48596369727326,270.57932967192255,0.463768115942029,31158,31044,South Central Nebraska,Adams,31,1,Nebraska,NE
31003,31CS017,43,55,70,75,5,20,32,10,-93.26765847119215,189.40705251872404,424.9693116769874,0.5021108851140925,51,66,85,83,-2,17,32,7,-144.1412743761012,159.27212638243228,398.18031595608073,0.3684210526315789,6282,6279,Wheeler and Nearby Counties,Antelope,31,3,Nebraska,NE
31005,31CS012,2,6,12,6,-6,0,4,6,-3293.4673845714015,-1646.7336922857007,-548.9112307619002,1.5,3,7,15,5,-10,-2,2,5,-3425.961172440046,-1598.7818804720214,-685.1922344880091,-1,437,438,Northwest Nebraska,Arthur,31,5,Nebraska,NE
31007,31CS001,3,7,15,4,-11,-3,1,4,-2590.9377155366296,-1209.1042672504273,-518.187543107326,-0.8,4,9,17,2,-15,-7,-2,2,-2461.315718034567,-1303.049497783006,-579.1331101257805,-0.2857142857142857,695,691,Banner and Nearby Counties,Banner,31,7,Nebraska,NE
31009,31CS012,2,6,12,6,-6,0,4,6,-3290.4884318766067,-1645.2442159383033,-548.4147386461011,1.5,2,7,14,3,-11,-4,1,3,-3065.9731727347385,-1532.9865863673692,-437.9961675335341,-0.6,438,457,Northwest Nebraska,Blaine,31,9,Nebraska,NE
31011,31CS017,44,55,70,62,-8,7,18,7,-336.0528297438547,-1.8933037513145492,257.2886000656141,0.6348243699180669,51,68,87,82,-5,14,31,1,-112.43480987908606,241.59545924431728,557.5279828715014,0.058823529411764705,5329,5381,Wheeler and Nearby Counties,Boone,31,11,Nebraska,NE
31013,31CS012,82,101,120,112,-8,11,30,6,-156.45429509119805,54.194528908095485,264.3864140266963,0.37954512762443715,99,123,151,130,-21,7,31,15,-338.4704582670626,-75.21565739268057,150.43131478536114,0.7142857142857143,10796,10636,Northwest Nebraska,Box Butte,31,13,Nebraska,NE
31015,31CS017,20,28,39,33,-6,5,13,3,-570.6620229622706,108.02992154116647,678.1311549240536,0.39929001350729043,23,35,49,38,-11,3,15,2,-725.6573362328614,55.8197950948355,725.6573362328614,0.2,1817,1791,Wheeler and Nearby Counties,Boyd,31,15,Nebraska,NE
31017,31CS012,21,31,43,40,-3,9,19,8,-442.96190589946656,31.240315919879272,437.69936319360403,0.7127117603328468,25,37,52,50,-2,13,25,0,-68.79304043740908,447.154762843159,859.9130054676134,0,2913,2907,Northwest Nebraska,Brown,31,17,Nebraska,NE
31019,31CS002,249,314,397,385,-12,71,136,58,-167.6437570163403,31.13384058874891,186.80304353249346,0.7295886075949367,302,382,496,424,-72,42,122,35,-212.78763227792587,13.914184268523877,173.231594143122,0.4375,50106,50308,Buffalo+Kearney+Sherman,Buffalo,31,19,Nebraska,NE
31021,31CS003,64,81,98,94,-4,13,30,11,-266.2483599985766,43.595947058848246,338.6857633040151,0.6920107490594107,78,99,122,72,-50,-27,-6,4,-804.6790597176173,-461.9453861341877,-149.01464068844763,-0.14285714285714285,6687,6711,Burt+Dakota+Thurston+Washington,Burt,31,21,Nebraska,NE
31023,31CS018,81,99,120,90,-30,-9,9,11,-593.388808409355,-295.8661612333813,-34.56882638821488,-0.685042043407891,101,126,153,109,-44,-17,8,5,-581.8404683588411,-260.96820191426104,35.586572988308326,-0.21739130434782608,8307,8430,York and Nearby Counties,Butler,31,23,Nebraska,NE
31025,31CS016,154,199,255,266,11,67,112,17,-27.316017825018506,225.75221342990514,428.9292055168197,0.2463768115942029,187,243,314,267,-47,24,80,22,-255.98060977796462,7.419727819651149,215.3575999653744,0.41509433962264153,26578,26955,Southeast Nebraska,Cass,31,25,Nebraska,NE
31027,31CS004,69,85,103,95,-8,10,26,20,-397.8635958500686,-138.71374294433878,85.09749365606432,1.3113545127930193,82,103,128,87,-41,-16,5,12,-635.7758889991278,-335.88160173538824,-83.97040043384706,-0.5714285714285714,8375,8336,Cuming and Nearby Counties,Cedar,31,27,Nebraska,NE
31029,31CS007,35,45,60,46,-14,1,11,2,-495.6021284247285,-37.69621716351224,293.0136076362553,0.1251490730139686,40,56,72,60,-12,4,20,2,-365.15190210451385,52.16455744350198,469.48101699151783,0.15384615384615385,3878,3834,Frontier and Nearby Counties,Chase,31,29,Nebraska,NE
31031,31CS012,40,53,68,70,2,17,30,10,-179.59847695211488,143.01236434743825,429.77755661370753,0.6038566948277148,51,67,85,79,-6,12,28,10,-294.03233439689785,36.63954322702777,329.7558890432499,0.625,5505,5459,Northwest Nebraska,Cherry,31,31,Nebraska,NE
31033,31CS001,70,86,104,107,3,21,37,13,-122.20104162828328,97.7791362825103,307.28406762612315,0.6288029792158282,88,109,134,136,2,27,48,15,-137.04894073683494,126.02201447065283,346.56053979429527,0.5357142857142857,9418,9522,Banner and Nearby Counties,Cheyenne,31,33,Nebraska,NE
31035,31CS015,43,56,70,74,4,18,31,12,-155.4768947394512,119.56748071225755,377.6736394939197,0.6632117347919083,51,68,87,83,-4,15,32,11,-246.65559000359704,65.77482400095921,345.31782600503584,0.6111111111111112,6116,6081,South Central Nebraska,Clay,31,35,Nebraska,NE
31037,31CS004,49,62,77,65,-12,3,16,21,-378.6695627061821,-200.69443018805399,-51.214003926109044,1.6959595318690899,56,73,93,65,-28,-8,9,5,-314.13612565445027,-123.75059495478344,38.07710613993336,-0.3125,10560,10505,Cuming and Nearby Counties,Colfax,31,37,Nebraska,NE
31039,31CS004,67,81,99,104,5,23,37,12,-99.97443119012087,141.76607410132794,339.5537602488769,0.5121801676369087,80,100,122,121,-1,21,41,4,-56.188239875569906,189.14853027419582,411.6762129497203,0.16666666666666666,8979,8988,Cuming and Nearby Counties,Cuming,31,39,Nebraska,NE
31041,31CS012,73,91,109,126,17,35,53,15,18.839491213335513,224.85996526761312,430.8804393218906,0.431762777535415,87,109,131,144,13,35,57,14,-9.555566615239139,200.6668989200219,410.88936445528293,0.3888888888888889,10535,10465,Northwest Nebraska,Custer,31,41,Nebraska,NE
31043,31CS003,122,143,169,210,41,67,88,68,-149.9661948664988,-5.947314474686973,114.88011979928062,1.0157467490638548,146,176,208,157,-51,-19,11,11,-291.36621972890015,-140.98365470753234,0,-0.4230769230769231,21270,21279,Burt+Dakota+Thurston+Washington,Dakota,31,43,Nebraska,NE
31045,31CS012,56,72,89,90,1,18,34,16,-216.2110121018977,24.12834546260782,264.46770302711315,0.8292277519072896,69,90,112,107,-5,17,38,4,-111.06423777564714,159.5397890699904,417.25790987535953,0.2,8210,8148,Northwest Nebraska,Dawes,31,45,Nebraska,NE
31047,31CS007,156,182,209,228,19,46,72,36,-84.28538063116612,51.61824705892231,179.49120584005084,0.7774580427829069,187,222,258,241,-17,20,54,29,-192.52829261791965,-39.71810596895193,104.52133149724193,1,23956,23919,Frontier and Nearby Counties,Dawson,31,47,Nebraska,NE
31049,31CS011,12,19,28,18,-10,-1,6,8,-1176.7042360100043,-583.9543494278322,-150.16920515633623,-1.1344771905650417,15,24,36,35,-1,11,20,2,-161.31200430165345,483.93601290496036,967.8720258099207,0.16666666666666666,1831,1860,Lincoln and Nearby Counties,Deuel,31,49,Nebraska,NE
31051,31CS004,35,47,61,64,3,17,29,14,-232.9109466615687,67.41686601408455,314.7456529234462,0.7795284878640513,41,55,73,64,-9,9,23,2,-198.19447833186314,126.12375893845837,379.2721608077918,0.15384615384615385,5585,5550,Cuming and Nearby Counties,Dixon,31,51,Nebraska,NE
31053,31CS005,302,378,478,451,-27,73,149,57,-272.38718793894026,51.88327389313148,298.49096011642195,0.6551724137931034,358,461,590,488,-102,27,130,41,-385.5498538129086,-37.73294619630004,239.87372939076454,0.43157894736842106,37006,37103,Dodge+Saunders,Dodge,31,53,Nebraska,NE
31055,31CS006,2855,3534,4385,4168,-217,634,1313,488,-145.04253179431208,30.157154283092137,169.83727058884074,0.648074369189907,3372,4266,5413,4695,-718,429,1323,384,-188.38194529863856,7.692198664705536,160.5361861324045,0.4668694734414772,582946,585008,Douglas,Douglas,31,55,Nebraska,NE
31057,31CS007,15,23,31,20,-11,-3,5,6,-1252.85157414931,-655.4444393788928,-58.03730460847515,-0.8414008493337388,17,28,40,25,-15,-3,8,8,-1405.2237666106614,-672.063540552925,0,-0.7272727272727273,1651,1637,Frontier and Nearby Counties,Dundy,31,57,Nebraska,NE
31059,31CS013,52,66,81,71,-10,5,19,13,-505.5456235491341,-167.96206554207726,134.0863810958156,1.1012126874660293,61,79,100,82,-18,3,21,3,-378.4423044433181,0,324.37911809427266,0.1875,5553,5549,Saline and Nearby Counties,Fillmore,31,59,Nebraska,NE
31061,31CS015,22,32,42,40,-2,8,18,5,-287.17833978842225,138.71440578784453,530.5357317180096,0.5012734464274569,27,39,52,65,13,26,38,5,275.82640175839333,724.0443046157825,1137.7839072533725,0.19230769230769232,2896,2900,South Central Nebraska,Franklin,31,61,Nebraska,NE
31063,31CS007,12,18,27,19,-8,1,7,3,-529.412413444568,-98.91162272488896,212.76315788664328,0.449927346683166,15,23,35,32,-3,9,17,7,-392.3973022685469,78.47946045370938,392.3973022685469,0.7,2532,2548,Frontier and Nearby Counties,Frontier,31,63,Nebraska,NE
31065,31CS015,39,52,67,57,-10,5,18,7,-430.5712687307604,-46.587489736169516,273.39899275932277,0.6387109245178509,47,62,82,79,-3,17,32,10,-282.2648132483523,151.9887455952666,477.6789147279808,0.5555555555555556,4625,4606,South Central Nebraska,Furnas,31,65,Nebraska,NE
31067,31CS013,179,230,292,252,-40,22,73,25,-360.43598891736355,-19.408091710934958,266.1681148928223,0.5434782608695652,215,281,364,330,-34,49,115,30,-295.9831274201582,87.86999095285948,393.10259110489767,0.46153846153846156,21640,21623,Saline and Nearby Counties,Gage,31,67,Nebraska,NE
31069,31CS012,17,25,35,24,-11,-1,7,7,-1177.4755729674614,-544.4956404754038,-17.012363398688787,-0.6928947320845191,21,31,44,36,-8,5,15,3,-593.8723174517479,107.97678499122688,647.8607099473613,0.3,1870,1852,Northwest Nebraska,Garden,31,69,Nebraska,NE
31071,31CS017,21,31,42,23,-19,-8,2,1,-1304.4728747081601,-604.9055287012837,40.84894453583238,-0.11032817680734759,26,39,53,40,-13,1,14,2,-817.8007973557774,-54.52005315705183,654.240637884622,0.18181818181818182,1833,1834,Wheeler and Nearby Counties,Garfield,31,71,Nebraska,NE
31073,31CS007,12,18,27,29,2,11,17,8,-387.89084541402394,184.27862343252886,600.401873502749,0.7330914738349069,13,22,33,22,-11,0,9,3,-763.4541757080698,-163.59732336601496,327.1946467320299,0.3333333333333333,1897,1834,Frontier and Nearby Counties,Gosper,31,73,Nebraska,NE
31075,31CS012,3,8,17,14,-3,6,11,7,-1965.3336972840177,-196.53336972840177,786.1334789136071,1,4,10,19,5,-14,-5,1,5,-3255.2826956025133,-1713.3066818960594,-685.3226727584238,-0.8333333333333334,611,584,Northwest Nebraska,Grant,31,75,Nebraska,NE
31077,31CS017,14,21,30,27,-3,6,13,1,-242.61795587823178,251.50610445697194,653.9600902503507,0.13758206757954367,16,26,38,28,-10,2,12,3,-598.9115933543849,-46.07012256572191,414.6311030914972,0.375,2206,2171,Wheeler and Nearby Counties,Greeley,31,77,Nebraska,NE
31079,31CS008,382,480,605,549,-56,69,167,111,-320.9121807872521,-80.68429567832739,107.67511363738683,1.1935483870967742,450,575,739,625,-114,50,175,53,-269.05134436753434,-4.831811033239169,196.57417886894677,0.47964782964782965,62466,62089,Hall,Hall,31,79,Nebraska,NE
31081,31CS018,55,70,86,101,15,31,46,20,-68.10467870742248,142.16351285987483,331.40488527044255,0.6427311159533768,67,86,106,112,6,26,45,6,0,213.02704777797257,415.40274316704654,0.2222222222222222,9384,9388,York and Nearby Counties,Hamilton,31,81,Nebraska,NE
31083,31CS015,19,28,38,37,-1,9,18,9,-379.56943393176414,1.8124134091582682,351.4124401383373,0.911943264138413,22,32,44,62,18,30,40,5,421.31133151935404,810.2140990756808,1134.2997387059531,0.16666666666666666,3104,3086,South Central Nebraska,Harlan,31,83,Nebraska,NE
31085,31CS007,4,11,20,3,-17,-8,-1,3,-2784.491926907087,-1531.470559798898,-556.8983853814175,-0.3333333333333333,6,14,24,3,-21,-11,-3,3,-2841.077241787511,-1657.2950577093814,-710.2693104468777,-0.2727272727272727,862,845,Frontier and Nearby Counties,Hayes,31,85,Nebraska,NE
31087,31CS007,21,30,42,44,2,14,23,6,-179.35324395769362,345.9766818963887,758.7359093531675,0.44181212154386124,26,37,50,45,-5,8,19,5,-386.17493724657265,115.8524811739718,540.6449121452017,0.45454545454545453,2629,2590,Frontier and Nearby Counties,Hitchcock,31,87,Nebraska,NE
31089,31CS017,85,103,122,112,-10,9,27,17,-317.61089175236344,-92.48942703283421,122.84414791628063,1.075377861602572,102,124,150,125,-25,1,23,3,-278.49727511966677,-19.892662508547627,198.92662508547627,0.11538461538461539,10080,10054,Wheeler and Nearby Counties,Holt,31,89,Nebraska,NE
31091,31CS012,7,13,21,10,-11,-3,3,4,-2620.4287837121196,-1219.2847466058931,-238.48392063153466,-0.711635047679059,9,17,28,15,-13,-2,6,2,-2054.618611420255,-547.8982963787347,547.8982963787347,-0.2222222222222222,704,730,Northwest Nebraska,Hooker,31,91,Nebraska,NE
31093,31CS009,52,67,84,70,-14,3,18,14,-515.1982678840653,-195.9165380693658,77.75351605751955,1.0548826306535575,65,85,106,93,-13,8,28,7,-306.47133375685974,15.323566687842986,321.7949004447027,0.4117647058823529,6489,6526,Howard+Merrick+Nance+Platte,Howard,31,93,Nebraska,NE
31095,31CS013,74,91,110,96,-14,5,22,4,-302.12081132270197,12.327171188029993,299.4318508717418,0.2461325509846546,89,111,136,123,-13,12,34,10,-319.96661217959866,27.823183667791188,333.8782040134942,0.5,7216,7188,Saline and Nearby Counties,Jefferson,31,95,Nebraska,NE
31097,31CS016,49,63,79,51,-28,-12,2,7,-797.375782585339,-440.74931025650216,-102.8926522607622,-0.4738683170023749,62,80,102,67,-35,-13,5,1,-677.7214752992485,-263.5583515052633,76.24366597116462,-0.058823529411764705,5256,5312,Southeast Nebraska,Johnson,31,97,Nebraska,NE
31099,31CS002,47,60,76,61,-15,1,14,5,-352.7767013004323,-72.16159922108194,164.88431595647387,0.3168221468343815,56,73,92,63,-29,-10,7,3,-479.252665374931,-194.6963953085657,59.90658317186637,-0.1875,6680,6677,Buffalo+Kearney+Sherman,Kearney,31,99,Nebraska,NE
31101,31CS011,65,81,99,78,-21,-3,13,7,-413.0746312579794,-138.81331849687794,88.34659489872965,-0.445146736563786,79,100,122,132,10,32,53,15,-60.34805742117663,211.2182009741182,458.6452364009424,0.45454545454545453,8274,8285,Lincoln and Nearby Counties,Keith,31,101,Nebraska,NE
31103,31CS012,5,11,20,6,-14,-5,1,6,-3122.71285679434,-1717.4920712368869,-780.678214198585,-1,6,14,24,4,-20,-10,-2,4,-3063.178047223995,-1786.8538608806637,-765.7945118059987,-0.4,769,784,Northwest Nebraska,Keya Paha,31,103,Nebraska,NE
31105,31CS001,35,48,61,56,-5,8,21,7,-414.10906105517,46.00562463352568,477.36314246667814,0.6492467569211539,43,58,77,50,-27,-8,7,7,-996.9517223684933,-439.8316422213941,0,-0.4666666666666667,3431,3410,Banner and Nearby Counties,Kimball,31,105,Nebraska,NE
31107,31CS017,68,86,104,104,0,18,36,12,-166.01661484479635,93.04688742662263,340.33477595843175,0.6211661364040223,83,103,129,122,-7,19,39,12,-226.2342417431944,83.34945748433478,322.0861178501788,0.5454545454545454,8378,8398,Wheeler and Nearby Counties,Knox,31,107,Nebraska,NE
31109,31CS010,1568,1952,2404,2179,-225,227,611,148,-138.88104348426168,29.402659614784064,172.32191647651925,0.41456582633053224,1877,2375,3038,2552,-486,177,675,179,-205.1158964691274,-0.6167507974716301,152.96961654290106,0.3853610493140527,322420,324280,Lancaster,Lancaster,31,109,Nebraska,NE
31111,31CS011,248,314,398,406,8,92,158,55,-163.57982819342618,130.2387167145113,357.722341909191,0.5789473684210527,292,378,488,501,13,122,209,60,-137.45118228731926,182.78082750973306,435.74949278320366,0.47244094488188976,34552,34194,Lincoln and Nearby Counties,Lincoln,31,111,Nebraska,NE
31113,31CS011,3,9,17,12,-5,3,9,6,-1842.4496205181888,-502.48626014132424,502.48626014132424,1.2,4,10,20,6,-14,-4,2,6,-2894.6178199909546,-1447.3089099954773,-578.9235639981908,-0.8571428571428571,716,691,Lincoln and Nearby Counties,Logan,31,113,Nebraska,NE
31115,31CS012,3,8,15,3,-12,-5,0,3,-2933.88570070291,-1564.7390403748852,-586.777140140582,-0.5,4,10,18,4,-14,-6,0,4,-2978.694063297249,-1654.8300351651385,-661.9320140660553,-0.6666666666666666,614,604,Northwest Nebraska,Loup,31,115,Nebraska,NE
31117,31CS011,2,5,10,2,-8,-3,0,2,-2938.475665748393,-1469.2378328741966,-587.6951331496787,-0.5,2,6,12,5,-7,-1,3,5,-3145.650155644148,-1572.825077822074,-524.2750259406913,-0.625,408,381,Lincoln and Nearby Counties,McPherson,31,117,Nebraska,NE
31119,31CS017,252,317,395,327,-68,10,75,41,-369.50761744567495,-105.08932239280662,115.42875572500198,0.6212121212121212,296,381,493,357,-136,-24,61,24,-452.52921406045976,-135.7587642181379,104.64738075148131,-0.2857142857142857,35398,35357,Wheeler and Nearby Counties,Madison,31,119,Nebraska,NE
31121,31CS009,58,72,91,90,-1,18,32,17,-285.18775525426116,10.164403059256125,241.3095704350522,0.8810544864014952,69,89,112,95,-17,6,26,6,-300.75187969924815,0,260.9560778301502,0.35294117647058826,7683,7664,Howard+Merrick+Nance+Platte,Merrick,31,121,Nebraska,NE
31123,31CS001,38,50,64,69,5,19,31,12,-187.7761642123041,180.42835496698243,505.31469541929425,0.6366445508256714,47,63,81,73,-8,10,26,14,-482.6111341635242,-87.54850506367787,262.6455151910336,0.9333333333333333,4555,4569,Banner and Nearby Counties,Morrill,31,123,Nebraska,NE
31125,31CS009,34,46,58,52,-6,6,18,2,-295.731130144382,139.8559534802735,575.4430371049293,0.19860328600536545,42,57,74,49,-25,-8,7,4,-857.2271676584861,-354.1041656420597,88.52604141051492,-0.2857142857142857,3397,3389,Howard+Merrick+Nance+Platte,Nance,31,125,Nebraska,NE
31127,31CS016,53,68,85,81,-4,13,28,14,-300.35011902773954,-21.037807710556084,230.34327247490916,0.9193612694555565,65,82,105,90,-15,8,25,10,-353.73187124159887,-28.298549699327907,212.94658648744186,0.625,7064,7068,Southeast Nebraska,Nemaha,31,127,Nebraska,NE
31129,31CS013,41,53,67,70,3,17,29,12,-276.33025556426065,133.82346607012678,495.72380868870397,0.690354615645654,48,65,83,62,-21,-3,14,5,-639.9113968835085,-196.8958144256949,221.5077912289068,-0.2777777777777778,4089,4063,Saline and Nearby Counties,Nuckolls,31,129,Nebraska,NE
31131,31CS016,119,141,164,148,-16,7,29,2,-139.00159264321115,34.61915921661782,202.03916993859548,0.10569495695604238,141,169,200,193,-7,24,52,14,-131.8726173313064,62.796484443479244,238.94062330743822,0.5,15911,15924,Southeast Nebraska,Otoe,31,131,Nebraska,NE
31133,31CS016,20,30,40,43,3,13,23,5,-107.4512420635999,395.0638875672935,858.9240072265794,0.35150041924803027,24,36,50,41,-9,5,17,2,-432.00785468826706,117.82032400589102,589.1016200294551,0.2,2552,2546,Southeast Nebraska,Pawnee,31,133,Nebraska,NE
31135,31CS011,21,30,40,28,-12,-2,7,11,-979.119781974315,-564.2754249739389,-184.00143105692788,-1.2226609615721624,25,38,53,36,-17,-2,11,3,-705.5244030602121,-176.38110076505302,282.2097612240848,-0.2,2854,2835,Lincoln and Nearby Counties,Perkins,31,135,Nebraska,NE
31137,31CS015,73,91,109,98,-11,7,25,12,-301.93558836519344,-70.3652157964322,171.65607619942276,0.8486170643162457,88,110,136,141,5,31,53,11,-67.66186773782421,223.67559582751812,469.71875123778807,0.34375,8968,8942,South Central Nebraska,Phelps,31,137,Nebraska,NE
31139,31CS017,49,62,77,64,-13,2,15,17,-485.05340662445303,-254.5767012416566,-24.775880625378665,1.1587507043377536,59,76,97,82,-15,6,23,6,-287.0739813572789,0,232.3932230035115,0.42857142857142855,7298,7315,Wheeler and Nearby Counties,Pierce,31,139,Nebraska,NE
31141,31CS009,203,259,326,305,-21,46,102,51,-253.18086648413595,-17.569803364617343,179.2119943190969,0.8793103448275862,243,314,409,344,-65,30,101,32,-283.23907239203794,-4.379985655546978,201.479340155161,0.49230769230769234,34150,34247,Howard+Merrick+Nance+Platte,Platte,31,141,Nebraska,NE
31143,31CS018,36,47,61,90,29,43,54,10,441.3816162126467,763.339690192033,1009.5429232350932,0.23181727252243056,42,56,73,63,-10,7,21,5,-289.4949519317757,38.599326924236756,308.79461539389405,0.4166666666666667,5209,5181,York and Nearby Counties,Polk,31,143,Nebraska,NE
31145,31CS007,99,118,140,119,-21,1,20,7,-312.17312301312285,-71.84009867458191,150.00576994560956,0.19919948179955127,121,147,177,171,-6,24,50,12,-169.33207902163687,112.88805268109124,357.47883349012227,0.42857142857142855,10673,10630,Frontier and Nearby Counties,Red Willow,31,145,Nebraska,NE
31147,31CS016,80,99,118,129,11,30,49,18,-100.64380455813635,189.13399617048807,478.9117968991125,0.5932381629107841,96,119,146,131,-15,12,35,12,-347.4800989889294,0,296.0015658053843,0.6,7831,7770,Southeast Nebraska,Richardson,31,147,Nebraska,NE
31149,31CS012,12,19,28,15,-13,-4,3,3,-1493.6111466596533,-646.898543318932,45.86631395983991,-0.4705209370650293,14,23,34,24,-10,1,10,6,-1265.3848054965154,-395.43275171766106,316.34620137412884,0.75,1282,1264,Northwest Nebraska,Rock,31,149,Nebraska,NE
31151,31CS013,93,112,133,102,-31,-10,9,5,-305.06442711952457,-124.86759472542926,34.53729546934733,-0.290498111174996,111,136,163,133,-30,-3,22,1,-218.30505490636207,-28.168394181466077,147.8840694526969,-0.03125,14235,14200,Saline and Nearby Counties,Saline,31,151,Nebraska,NE
31153,31CS014,733,907,1142,1136,-6,229,403,116,-76.81723826640867,71.09212059053382,180.59286031427197,0.4773662551440329,887,1122,1435,1298,-137,176,411,105,-125.49072414828932,36.51298412073626,158.48188852404678,0.4242441556745462,190738,193082,Sarpy,Sarpy,31,153,Nebraska,NE
31155,31CS005,154,194,250,234,-16,40,80,18,-183.05113261953608,118.44485051852335,334.0683170306531,0.3829787234042553,184,241,313,252,-61,11,68,23,-369.63899691417447,-52.80557098773921,198.02089120402204,0.41818181818181815,22289,22725,Dodge+Saunders,Saunders,31,155,Nebraska,NE
31157,31CS001,283,358,457,460,3,102,177,96,-310.74250915526744,18.37724516509646,270.6467015223297,0.9014283195203667,337,441,560,465,-95,24,128,48,-399.77665978286626,-67.07193173567838,223.57310578559458,0.5161290322580645,35914,35782,Banner and Nearby Counties,Scotts Bluff,31,157,Nebraska,NE
31159,31CS018,123,145,167,155,-12,10,32,23,-238.43306770787376,-86.76325325661595,59.28916065941006,1.270534358739067,147,177,208,177,-31,0,30,19,-284.03778649352984,-107.93435886754133,62.48831302857656,0.4368393234672304,17563,17603,York and Nearby Counties,Seward,31,159,Nebraska,NE
31161,31CS012,56,70,87,86,-1,16,30,16,-402.2159928363892,2.7492673698416055,330.5782875367904,0.9008241941304639,68,88,110,71,-39,-17,3,13,-1020.5500175815909,-588.7788562970717,-196.25961876569053,-0.6842105263157895,5116,5095,Northwest Nebraska,Sheridan,31,161,Nebraska,NE
31163,31CS002,23,32,44,43,-1,11,20,4,-185.37397399746737,281.1074973413829,647.6286533933364,0.34018573028510773,27,40,55,39,-16,-1,12,9,-843.7869156775608,-337.5147662710243,101.2544298813073,-0.45,2961,2963,Buffalo+Kearney+Sherman,Sherman,31,163,Nebraska,NE
31165,31CS012,6,14,24,10,-14,-4,4,1,-1570.766293973275,-523.5887646577584,314.153258794655,-0.125,8,16,29,13,-16,-3,5,5,-1837.0359570629294,-699.8232217382588,0,-0.5,1146,1143,Northwest Nebraska,Sioux,31,165,Nebraska,NE
31167,31CS004,26,35,48,55,7,20,29,1,129.78997329886334,383.2395260454287,569.1025313929098,0.050896981771672914,29,43,58,43,-15,0,14,5,-343.8099876801421,-85.95249692003553,154.71449445606393,0.2777777777777778,5839,5817,Cuming and Nearby Counties,Stanton,31,167,Nebraska,NE
31169,31CS013,55,69,86,65,-21,-4,10,8,-704.2152658546283,-289.6182260662303,46.00794900056799,-0.5744467305453522,65,83,106,95,-11,12,30,6,-344.9967022374051,121.76354196614298,487.0541678645719,0.35294117647058826,4997,4928,Saline and Nearby Counties,Thayer,31,169,Nebraska,NE
31171,31CS012,3,9,17,5,-12,-4,2,5,-3005.3403719845314,-1591.0625498741638,-530.3541832913879,-0.8333333333333334,4,11,21,2,-19,-9,-2,2,-3121.709507587488,-1635.1811706410651,-594.6113347785691,-0.2222222222222222,679,673,Northwest Nebraska,Thomas,31,171,Nebraska,NE
31173,31CS003,58,72,90,84,-6,12,26,10,-274.6881431628508,29.040130895838328,289.3786515175717,0.6693726349476213,69,89,109,104,-5,15,35,18,-346.2953610850588,-45.1689601415294,255.95744080199998,0.9473684210526315,6821,6642,Burt+Dakota+Thurston+Washington,Thurston,31,173,Nebraska,NE
31175,31CS017,33,44,58,41,-17,-3,8,1,-518.7429155970875,-129.93671545142666,210.2687096760268,-0.10026743164009226,40,55,71,73,2,18,33,9,-172.27058787338112,221.4907558372043,590.6420155658781,0.47368421052631576,4060,4063,Wheeler and Nearby Counties,Valley,31,175,Nebraska,NE
31177,31CS003,139,162,188,177,-11,15,38,19,-173.99177305652907,-22.781128423810163,109.7644522620573,0.8790775956613176,167,200,234,201,-33,1,34,17,-238.5550719293241,-76.33762301738372,81.3472795278993,0.425,20879,20960,Burt+Dakota+Thurston+Washington,Washington,31,177,Nebraska,NE
31179,31CS004,45,59,76,67,-9,8,22,2,-132.18615905810097,72.13519264440004,245.8083415915259,0.15700965665717892,57,74,96,72,-24,-2,15,6,-307.0670195094178,-81.88453853584474,92.12010585282533,-0.23076923076923078,9657,9770,Cuming and Nearby Counties,Wayne,31,179,Nebraska,NE
31181,31CS015,39,51,66,54,-12,3,15,6,-627.0869588030645,-104.91399413092616,330.23014309585596,0.4970867884083452,47,64,81,63,-18,-1,16,5,-674.9816581071167,-176.08217168011737,322.8173147468819,-0.22727272727272727,3401,3408,South Central Nebraska,Webster,31,181,Nebraska,NE
31183,31CS017,5,11,20,8,-12,-3,3,8,-3091.5385234683195,-1700.3461879075758,-772.8846308670799,-1.1428571428571428,6,14,24,4,-20,-10,-2,4,-3037.415144977108,-1768.141872335947,-757.7750881439772,-0.4,776,792,Wheeler and Nearby Counties,Wheeler,31,183,Nebraska,NE
31185,31CS018,116,137,161,137,-24,-0,21,10,-292.3289843728973,-88.07794920796327,94.72848501882784,-0.246399498885231,142,170,203,179,-24,9,37,11,-246.12066944822092,-14.064038254184053,182.8324973043927,0.44,14032,14221,York and Nearby Counties,York,31,185,Nebraska,NE
32001,32CS003,195,250,316,325,9,75,130,46,-174.44486678028863,136.54254079968612,395.5025319715046,0.5974025974025974,234,304,395,388,-7,84,154,50,-221.82296970365226,132.31545561270485,404.92421048535095,0.5494505494505495,25487,25696,Lyon and Nearby Counties,Churchill,32,1,Nevada,NV
32003,32CS002,11747,14535,17946,18083,137,3548,6336,2428,-120.82054231032512,59.05774337169474,206.06143074560458,0.6503281220160209,14241,17755,22530,22834,304,5079,8593,3895,-156.84423645836358,51.71001071122939,205.16077771666855,0.737689499783273,2275739,2289692,Clark+Nye,Clark,32,3,Nevada,NV
32005,32CS001,361,452,568,522,-46,70,161,43,-216.13494781694126,65.53221326285698,286.52139909926905,0.4574468085106383,430,558,709,660,-49,102,230,53,-204.87288295093236,98.3711049935883,355.3405221196965,0.4015151515151515,49441,49811,Carson City (city)+Douglas,Douglas,32,5,Nevada,NV
32007,32CS004,215,276,348,340,-8,64,125,42,-111.96802777761594,48.09815379058427,185.68124486597648,0.6,261,337,429,505,76,168,244,101,-46.482769018445815,124.32517062817843,265.5362972670496,0.6011904761904762,53640,53891,"Northern Nevada, excluding Washoe",Elko,32,7,Nevada,NV
32009,32CS003,3,8,16,6,-10,-2,3,6,-2553.969793543023,-1276.9848967715116,-478.86933628931683,-1,4,10,19,12,-7,2,8,4,-1484.2717791583505,-269.8675962106092,539.7351924212184,0.8,752,741,Lyon and Nearby Counties,Esmeralda,32,9,Nevada,NV
32011,32CS004,8,17,30,11,-19,-6,3,5,-1526.619769637671,-699.7007277505992,-127.21831413647257,-0.5555555555555556,11,21,39,28,-11,7,17,2,-686.076172046794,263.8754507872285,791.6263523616853,0.18181818181818182,1887,1895,"Northern Nevada, excluding Washoe",Eureka,32,11,Nevada,NV
32013,32CS004,90,109,130,124,-6,15,34,10,-110.52488176023215,32.35151142465757,163.79779315475614,0.5329143389394013,111,136,163,207,44,71,96,36,45.468054547456696,198.92273864512305,341.0104091059252,0.5070422535211268,17263,17595,"Northern Nevada, excluding Washoe",Humboldt,32,13,Nevada,NV
32015,32CS004,35,48,62,55,-7,7,20,4,-224.36444105586267,69.76922432618628,329.29892907505314,0.35007797345878205,47,62,81,70,-11,8,23,12,-397.4182214814628,-69.11621243155875,190.06958418678656,0.8571428571428571,5702,5787,"Northern Nevada, excluding Washoe",Lander,32,15,Nevada,NV
32017,32CS004,29,40,52,51,-1,11,22,3,-100.01690960562497,201.11453173129863,501.1743309282334,0.24273948698619754,35,49,66,63,-3,14,28,7,-221.158409318141,154.8108865226987,464.43265956809614,0.4375,4603,4522,"Northern Nevada, excluding Washoe",Lincoln,32,17,Nevada,NV
32019,32CS003,456,566,711,699,-12,133,243,61,-147.7170050208605,145.6934844041364,368.2807522437892,0.41216216216216217,543,697,903,893,-10,196,350,108,-194.5184412160492,145.00315821272622,398.84107324307246,0.5142857142857142,59303,60688,Lyon and Nearby Counties,Lyon,32,19,Nevada,NV
32021,32CS003,47,60,75,78,3,18,31,3,4.8597751812417975,395.06604251476995,741.9160579223504,0.15953062014075556,56,74,92,87,-5,13,31,14,-414.7396280986098,-21.8284014788742,371.08282514086136,0.8235294117647058,4551,4581,Lyon and Nearby Counties,Mineral,32,21,Nevada,NV
32023,32CS002,610,761,957,783,-174,22,173,66,-560.9313495103229,-102.77318083886824,250.159265178245,0.4520547945205479,749,959,1217,1088,-129,129,339,187,-593.79483458606,-108.95318065799269,285.5324734485325,0.9033816425120773,51375,53234,Clark+Nye,Nye,32,23,Nevada,NV
32027,32CS004,36,49,62,54,-8,5,18,11,-336.8452272633514,-99.40179683830019,123.2014191851854,1.0164941743537341,44,60,79,86,7,26,42,19,-178.40881636900892,96.6381088665465,342.6936014421373,0.7307692307692307,6648,6726,"Northern Nevada, excluding Washoe",Pershing,32,27,Nevada,NV
32029,32CS003,25,35,47,36,-11,1,11,7,-521.1450080234337,-160.97794593590206,126.19844908405665,0.6658210157938954,30,44,60,48,-12,4,18,6,-435.0343646937388,-48.33715163263764,290.02290979582585,0.5,4123,4138,Lyon and Nearby Counties,Storey,32,29,Nevada,NV
32031,32CS005,2733,3357,4166,3998,-168,641,1265,441,-150.46161822278646,49.400514888873495,203.56717172832543,0.6032831737346102,3214,4092,5201,4849,-352,756,1635,522,-177.45601373355237,47.61262611043253,226.04322664709815,0.5698689956331878,485825,492516,Washoe,Washoe,32,31,Nevada,NV
32033,32CS004,55,69,85,79,-6,10,24,5,-140.1171066066891,64.79326851428755,248.13413046463504,0.3779871285714583,65,83,104,105,1,22,40,18,-185.993659307069,43.634876083769875,240.5372544117809,0.782608695652174,9148,9167,"Northern Nevada, excluding Washoe",White Pine,32,33,Nevada,NV
32510,32CS001,556,690,868,786,-82,96,230,68,-309.0350693830297,57.628917367464744,333.73317682622854,0.5093704410279429,661,845,1082,985,-97,140,324,110,-350.40000678576627,50.89324717295081,363.123318579004,0.5898165717900063,58304,58947,Carson City (city)+Douglas,Carson City (city),32,510,Nevada,NV
33001,33CS001,530,660,822,697,-125,37,167,44,-319.58682356833356,-13.233408843409256,232.71894694623973,0.37131462754593364,647,824,1048,823,-225,-1,176,80,-474.0081209144138,-125.86349055586794,149.2492378751989,-0.21714470912331874,63476,64355,Belknap+Carroll,Belknap,33,1,New Hampshire,NH
33003,33CS001,392,492,615,489,-126,-3,97,5,-313.9297865187356,-19.149357927181743,220.33729964963476,-0.028169237605535455,481,616,790,611,-179,-5,130,36,-419.10138271300184,-79.90307691807988,183.28986302793678,-0.1632661456190868,50132,51312,Belknap+Carroll,Carroll,33,3,New Hampshire,NH
33005,33CS002,515,641,795,631,-164,-10,116,5,-265.10951863111717,-23.53043064773229,174.20362156204467,-0.03135073512068559,615,790,1003,900,-103,110,285,76,-231.90526919079244,43.389145590011424,270.7612204654295,0.44838148277062306,76497,77208,Cheshire,Cheshire,33,5,New Hampshire,NH
33007,33CS003,304,376,476,402,-74,26,98,20,-361.292388997878,23.061216319013493,299.7958121471754,0.30303030303030304,355,459,589,573,-16,114,218,62,-249.90340159620533,166.28249370444885,499.00736812652383,0.484375,31221,31272,Coos+Grafton,Coos,33,7,New Hampshire,NH
33009,33CS003,591,743,930,734,-196,-9,143,11,-272.5915954582699,-26.337352218190333,173.95821140114703,-0.05081075314700235,718,917,1170,935,-235,18,217,44,-303.22523110602697,-28.247423893789684,188.06265676980735,0.2115433511314518,91125,92044,Coos+Grafton,Grafton,33,9,New Hampshire,NH
33011,33CS004,2388,2958,3644,3420,-224,462,1032,412,-180.8284803514135,14.355979024911779,176.25162367218425,0.7048764781641494,2828,3596,4544,3963,-581,366,1135,297,-207.05219566096306,16.396203040434038,197.7098986767733,0.42277601488127803,422124,423879,Hillsborough,Hillsborough,33,11,New Hampshire,NH
33013,33CS005,974,1218,1495,1280,-215,62,306,58,-213.11290560408008,2.732216738513847,193.5970717575526,0.2516280820628647,1172,1476,1893,1560,-333,84,388,101,-280.14251676786415,-10.641997298652605,185.1385045198927,0.33114754098360655,153721,155046,Merrimack+Sullivan,Merrimack,33,13,New Hampshire,NH
33015,33CS006,1772,2196,2716,2461,-255,265,689,183,-167.50602982640888,31.338111899989805,193.37908074871757,0.4575,2126,2682,3441,2970,-471,288,844,256,-229.67342963734077,10.265969554687905,185.73507994327656,0.4771672364434809,313995,316580,Rockingham,Rockingham,33,15,New Hampshire,NH
33017,33CS007,805,1000,1238,1019,-219,19,214,26,-224.28395368540674,-6.4068054511236365,172.16001505090796,0.12149532710280374,960,1232,1567,1338,-229,106,378,114,-259.5106473300602,-6.050962339377678,199.7952127433266,0.4720517129042214,131111,132210,Strafford,Strafford,33,17,New Hampshire,NH
33019,33CS005,303,388,487,405,-82,17,102,1,-230.99066818573178,44.52832157797239,281.08502996095075,0.012987012987012988,370,473,617,518,-99,45,148,45,-331.3385271158783,0,237.11413346730032,0.46875,43119,43460,Merrimack+Sullivan,Sullivan,33,19,New Hampshire,NH
34001,34CS001,1945,2417,2992,2830,-162,413,885,286,-197.11446026235635,55.87842958330191,263.5525930739988,0.5635473450434081,2350,2977,3794,3403,-391,426,1053,413,-292.3744914231798,4.729801379419285,232.9245263926327,0.6820851107935019,272735,274853,Atlantic,Atlantic,34,1,New Jersey,NJ
34003,34CS002,5022,6206,7636,8114,478,1908,3092,1962,-187.18493899423672,-6.811082312380838,142.5912695212321,1.010038676958614,6010,7564,9576,7617,-1960,53,1607,626,-271.02862662340857,-60.06552042359819,102.84516943733364,0.3108279852776539,951391,953958,Bergen,Bergen,34,3,New Jersey,NJ
34005,34CS003,2862,3540,4387,4075,-312,535,1213,523,-217.7925674910043,3.1316407763370107,180.1084901490823,0.7444873800414992,3435,4312,5483,4560,-923,248,1125,341,-272.5158447773387,-20.154424747226557,169.00616816110139,0.40595238095238095,459823,463918,Burlington,Burlington,34,5,New Jersey,NJ
34007,34CS004,3475,4291,5320,5018,-301,727,1543,700,-230.74818437966502,6.220869673740345,194.2639357560804,0.7977231287110197,4178,5283,6664,5644,-1020,361,1466,516,-293.35197355583523,-29.597758113037894,181.4056142412,0.497829348841885,520828,523688,Camden,Camden,34,7,New Jersey,NJ
34009,34CS005,906,1124,1399,1224,-175,100,318,112,-364.0850302388093,-15.835291851026852,260.9656097049225,0.5758392809939201,1079,1380,1776,1434,-342,54,355,97,-459.3734469138817,-44.990452607440865,269.9427156446452,0.3339080459770115,94725,95576,Cape May,Cape May,34,9,New Jersey,NJ
34011,34CS006,1108,1366,1700,1630,-70,264,522,180,-195.96746937396014,65.44004676155038,268.1474490953826,0.5911345987920621,1320,1670,2131,1922,-209,252,602,239,-291.7169391197486,8.785674686261252,236.3671885963026,0.6760975336502297,153117,153659,Cumberland,Cumberland,34,11,New Jersey,NJ
34013,34CS007,4287,5284,6570,7733,1163,2450,3446,2055,-125.6076094954335,55.52689595018882,195.73758644646398,0.8386044013688707,5091,6387,8115,6771,-1344,384,1680,721,-241.2627947729218,-39.3712468347657,112.06785912833529,0.5864173397633081,852560,855955,Essex,Essex,34,13,New Jersey,NJ
34015,34CS008,1951,2409,2988,2802,-186,393,851,343,-210.73465618369457,19.91820946915828,202.44868104452465,0.6978644048151276,2368,2970,3777,3186,-591,216,818,321,-299.79853177065905,-34.51627832885877,163.3934870796119,0.5572916666666666,301232,304204,Gloucester,Gloucester,34,15,New Jersey,NJ
34017,34CS009,2668,3297,4088,5136,1048,1839,2468,1511,-77.91601409853762,55.16773367365427,160.97036436698423,0.8216424397975115,3116,3931,4994,4532,-462,601,1416,635,-155.5767043454305,-4.819907920857112,110.71612018204131,0.7461819939243304,713461,705408,Hudson,Hudson,34,17,New Jersey,NJ
34019,34CS010,623,779,966,925,-41,146,302,144,-173.0551629229988,1.8688462518682378,147.6388538975908,0.8323699421965318,745,950,1225,996,-229,46,251,66,-227.3712074495762,-15.412384846607436,142.5645598311188,0.35294117647058826,128421,129766,Hunterdon,Hunterdon,34,19,New Jersey,NJ
34021,34CS011,2058,2544,3147,3247,100,704,1189,607,-158.47768938577337,30.16092500882976,181.98133250146242,0.8407202216066482,2453,3108,3956,3441,-515,333,988,296,-210.09080242349197,9.584907138926267,179.31547896120975,0.47665550764060505,383940,386024,Mercer,Mercer,34,21,New Jersey,NJ
34023,34CS012,4221,5203,6441,6749,308,1546,2528,1445,-159.34650401020778,14.15354577876263,151.80728853597566,0.9180432020330368,5032,6344,8024,6782,-1242,438,1750,741,-230.2699992835096,-35.13488930078013,117.20534477162721,0.5942265248796148,856323,860968,Middlesex,Middlesex,34,23,New Jersey,NJ
34025,34CS013,4013,4946,6095,5879,-216,933,1866,937,-216.21718051046,-0.7500379169558928,174.19630621300612,0.8671913009216432,4838,6062,7706,6325,-1381,263,1487,647,-314.3785433950479,-59.531701389993536,130.20234221975528,0.5232580423202905,639968,645034,Monmouth,Monmouth,34,25,New Jersey,NJ
34027,34CS014,2743,3382,4212,4288,76,906,1545,829,-178.389620386201,18.118435952661144,169.6027710549104,0.8800434545952445,3277,4138,5276,4198,-1078,60,921,314,-272.58099178125383,-49.834318026169385,118.87785647814314,0.32472429694651916,506666,510692,Morris,Morris,34,27,New Jersey,NJ
34029,34CS015,5133,6342,7820,7343,-477,1000,2210,1136,-304.68645167721803,-25.593586387863773,202.90708617832215,0.9084367705835332,6195,7716,9822,8288,-1534,572,2093,891,-374.5245519999141,-49.342540251524696,185.66385568194988,0.6159696553464458,635315,647514,Ocean,Ocean,34,29,New Jersey,NJ
34031,34CS016,2634,3239,4002,4800,798,1561,2166,1352,-127.98562152529786,48.279026980935384,188.0572050965526,0.8655573329923278,3113,3938,5019,4216,-803,278,1103,514,-253.84331191270397,-45.38939292771101,113.56985045712824,0.6754270696452037,519480,518844,Passaic,Passaic,34,31,New Jersey,NJ
34033,34CS017,510,648,812,789,-23,142,279,94,-217.63638847346118,88.3566534400804,344.21892040182894,0.6143790849673203,620,792,1007,913,-94,120,293,98,-295.37642839451064,34.6054133760817,299.91358259270805,0.5850798403193613,64511,65019,Salem,Salem,34,33,New Jersey,NJ
34035,34CS018,1696,2126,2630,2624,-6,498,928,525,-185.86713126320535,-9.449091591238082,141.1239327469168,0.9877713351174546,2036,2588,3300,2637,-663,50,601,218,-254.96687843367775,-48.762180371232844,110.8507607786394,0.37946068777457964,342890,345555,Somerset,Somerset,34,35,New Jersey,NJ
34037,34CS019,872,1087,1361,1321,-40,234,449,217,-214.717382957973,14.19205097311641,193.721495783039,0.8509803921568627,1060,1346,1724,1478,-246,132,418,122,-253.28573474408876,7.224939458877838,203.74329274035497,0.46923076923076923,143742,145330,Sussex,Sussex,34,37,New Jersey,NJ
34039,34CS020,2758,3400,4226,5073,847,1672,2315,1389,-113.85087189218022,59.52369235856727,194.46505771606698,0.8304939415583998,3268,4124,5247,4420,-827,296,1152,480,-228.3820387706614,-32.23045561876088,117.40969767679775,0.5922380643570235,571537,572440,Union,Union,34,39,New Jersey,NJ
34041,34CS021,712,883,1112,1062,-50,179,350,150,-220.07232789664826,31.894540274876555,219.9623467232866,0.7335007173601148,857,1090,1393,1190,-203,100,333,106,-279.5632145096715,-5.426655732960301,205.35369736143932,0.48847926267281105,109110,110565,Warren,Warren,34,41,New Jersey,NJ
35001,35CS001,4036,4970,6146,6092,-54,1122,2056,602,-116.36191337896031,92.11430704818271,257.8580000477761,0.49711016556201076,4834,6118,7759,7401,-358,1282,2567,797,-171.19153910711296,71.95661853296684,262.34152962776096,0.5341823056300268,676768,674712,Bernalillo,Bernalillo,35,1,New Mexico,NM
35003,35CS002,28,39,51,38,-13,-1,10,3,-531.1042175409306,-148.39962592854798,234.30496568383478,-0.2243531108319904,36,51,68,73,5,22,37,10,-134.6385795629856,323.1325909511654,727.0483296401222,0.43478260869565216,3609,3714,Catron+Cibola+Sierra+Socorro,Catron,35,3,New Mexico,NM
35005,35CS003,453,569,709,734,25,165,281,106,-149.5686886372483,108.87788562119249,323.03515047440237,0.6217062263501891,547,690,880,846,-34,156,299,142,-271.9927623138059,22.40849462244423,242.70717796240453,0.8022598870056498,65027,64708,Chaves,Chaves,35,5,New Mexico,NM
35006,35CS002,172,219,279,321,42,102,149,69,-119.8683852529206,146.50580419801406,355.3875644257884,0.6764705882352942,203,268,349,396,47,128,193,85,-139.86914873059547,158.27298408988435,397.7068821142325,0.6589147286821705,27030,27168,Catron+Cibola+Sierra+Socorro,Cibola,35,6,New Mexico,NM
35007,35CS012,102,123,146,150,4,27,48,30,-257.05803544608847,-32.422273239235864,176.16807738141287,1.0909256605487212,123,152,181,178,-3,26,55,32,-283.0889725049836,-48.52953814371147,186.02989621756063,1.0666666666666667,12297,12364,Northeast New Mexico,Colfax,35,7,New Mexico,NM
35009,35CS004,267,340,426,400,-26,60,133,57,-205.90235512268018,7.437773213341849,188.42358807132686,0.7916666666666666,318,409,525,560,35,151,242,102,-139.4481219165098,101.98444737177581,291.48820111055505,0.6623376623376623,48402,48047,Curry+Roosevelt,Curry,35,9,New Mexico,NM
35011,35CS008,13,21,30,28,-2,7,15,4,-398.0630680661576,186.61334610899175,771.2897602841414,0.53718396517741,17,26,37,38,1,12,21,5,-238.1365812517054,416.73901719048445,952.5463250068216,0.38461538461538464,1687,1680,Guadalupe and Nearby Counties,De Baca,35,11,New Mexico,NM
35013,35CS005,1119,1389,1735,1984,249,595,865,329,-43.73494688115292,145.1465486012062,292.47575206859597,0.5501687625663096,1330,1706,2178,2317,139,611,987,323,-83.15506432889711,130.15575286262157,300.10391558480507,0.5192926045016077,219916,221273,Do�a Ana,Do�a Ana,35,13,New Mexico,NM
35015,35CS006,425,524,663,534,-129,10,109,77,-401.7972188799366,-130.61821283336127,62.48229434789884,0.7032110091743119,497,640,820,787,-33,147,290,149,-297.91861991374464,-3.272931830966708,230.74169408315294,0.8922155688622755,61553,61107,Eddy,Eddy,35,15,New Mexico,NM
35017,35CS007,237,300,380,374,-6,74,137,23,-124.5411430561882,218.64365906594145,488.9472414994237,0.2839506172839506,284,368,475,426,-49,58,142,58,-383.2018805111744,0,300.69087307742785,0.694635685599541,27991,27936,Grant+Hidalgo+Luna,Grant,35,17,New Mexico,NM
35019,35CS008,35,48,62,55,-7,7,20,4,-289.2789165683156,89.95527779674228,424.5736845894406,0.35007797345878205,46,63,82,59,-23,-4,13,3,-584.4393035431633,-157.3490432616209,224.7843475166013,-0.1875,4423,4449,Guadalupe and Nearby Counties,Guadalupe,35,19,New Mexico,NM
35021,35CS012,2,7,13,12,-1,5,10,6,-1283.7902378450665,-183.39860540643804,733.5944216257521,1,3,8,15,14,-1,6,11,5,-934.4884649080112,155.74807748466856,934.4884649080112,0.7142857142857143,654,642,Northeast New Mexico,Harding,35,21,New Mexico,NM
35023,35CS007,40,53,67,47,-20,-6,7,3,-653.4735052875473,-249.24075952471134,107.43519261896732,-0.26379001304730765,50,67,87,61,-26,-6,11,6,-783.3657185697456,-293.7621444636546,122.40089352652274,-0.375,4149,4085,Grant+Hidalgo+Luna,Hidalgo,35,23,New Mexico,NM
35025,35CS009,398,499,630,604,-26,105,206,134,-259.83482981992273,-47.08035029539368,116.97031857872803,1.1452991452991452,472,602,773,742,-31,140,270,163,-265.0382645296259,-32.088610079578615,146.1055863197835,1.0316455696202531,73916,73235,Lea,Lea,35,25,New Mexico,NM
35027,35CS008,158,202,259,208,-51,6,50,18,-409.33275382977007,-71.18830501387306,190.1320979745524,0.4,190,249,324,319,-5,70,129,40,-220.66476996738604,146.9465726752848,435.94149893667833,0.5333333333333333,20228,20416,Guadalupe and Nearby Counties,Lincoln,35,27,New Mexico,NM
35028,35CS010,94,114,134,116,-18,2,22,3,-129.9069000023557,-7.907448740080902,119.17531299145541,0.15145092370200713,113,138,167,140,-27,2,27,10,-191.2766640315865,-41.357116547370055,88.14235464158219,0.4166666666666667,19408,19344,Los Alamos+Santa Fe,Los Alamos,35,28,New Mexico,NM
35029,35CS007,213,267,338,337,-1,70,124,59,-285.80761740151587,52.39806319027791,309.86309186614324,0.7763157894736842,251,326,422,423,1,97,172,57,-219.4730035141808,156.76643108155773,450.8994473983302,0.5533980582524272,25192,25516,Grant+Hidalgo+Luna,Luna,35,29,New Mexico,NM
35031,35CS011,459,574,713,1056,343,482,597,374,-51.56586524871283,178.24213872143505,369.74880869655834,0.7767401937526419,545,696,905,1029,124,333,484,179,-76.49092104920047,214.1745789377613,424.1769258182935,0.5359281437125748,72373,71904,McKinley,McKinley,35,31,New Mexico,NM
35033,35CS012,28,38,49,43,-6,5,15,7,-378.1396071431257,-51.60211769523653,228.28715897438263,0.8264774158166865,32,46,62,56,-6,10,24,5,-262.2638135542707,119.21082434285033,453.00113250283124,0.35714285714285715,4230,4194,Northeast New Mexico,Mora,35,33,New Mexico,NM
35035,35CS013,423,530,670,640,-30,110,217,45,-132.5688122662976,114.89297063079125,304.0244761307092,0.36,507,653,825,855,30,202,348,122,-134.5735399586733,116.89341147333187,330.2969457943333,0.583732057416268,67889,68438,Otero,Otero,35,35,New Mexico,NM
35037,35CS008,85,103,123,140,17,37,55,10,92.1229684926289,378.0132235099475,629.094485401405,0.26859198258870487,102,126,152,175,23,49,73,39,-184.64068393986676,115.40042746241673,392.9384555095284,0.7959183673469388,8645,8665,Guadalupe and Nearby Counties,Quay,35,37,New Mexico,NM
35039,35CS014,290,367,460,438,-22,71,148,45,-200.8800674094186,77.89532815279468,308.7351371594419,0.54216867469879515,351,447,577,604,27,157,253,70,-106.98807321426071,216.46424115443446,455.44573957838185,0.43209876543209874,40054,40191,Rio Arriba+Taos,Rio Arriba,35,39,New Mexico,NM
35041,35CS004,113,136,159,162,3,26,49,40,-231.4161329967063,-91.34839059815906,53.90704596329735,1.4723569311635307,139,168,199,220,21,52,81,47,-136.60170423760815,26.269558507232336,178.6329978491799,0.9038461538461539,19018,19033,Curry+Roosevelt,Roosevelt,35,41,New Mexico,NM
35043,35CS015,830,1037,1289,1237,-52,200,407,153,-165.08279957217147,37.82057801555964,204.4322945713388,0.652454991816694,1019,1290,1639,1557,-82,267,538,177,-171.5927733425463,59.58082407727302,239.0184059233269,0.5645947375918277,149125,151055,Sandoval,Sandoval,35,43,New Mexico,NM
35045,35CS016,741,918,1151,1336,185,418,595,327,-140.1417171891035,90.1755775161953,264.1208172059054,0.7804295942720764,902,1131,1440,1705,265,574,803,369,-86.03414794321387,169.3422979199121,358.5513385957944,0.6417391304347826,121762,121057,San Juan,San Juan,35,45,New Mexico,NM
35047,35CS012,187,242,305,264,-41,22,77,10,-225.62687560090205,55.246541528134685,296.1214625908019,0.2127659574468085,227,291,381,391,10,100,164,45,-128.93768395685194,202.61636050362446,438.38812545329654,0.4411764705882353,27151,27145,Northeast New Mexico,San Miguel,35,47,New Mexico,NM
35049,35CS010,853,1067,1334,1215,-119,148,362,87,-160.16764541677537,47.40527108405288,213.790001233163,0.4393939393939394,1028,1304,1674,1591,-83,286,563,133,-139.3325528189815,98.92482357869409,277.2150675073306,0.40425531914893614,154413,155168,Los Alamos+Santa Fe,Santa Fe,35,49,New Mexico,NM
35051,35CS002,170,217,273,264,-9,47,94,42,-535.4252635569618,52.49267289774136,546.4487248654871,0.7777777777777778,204,266,344,278,-66,12,74,29,-826.1266350875667,-147.75542132023813,391.55186649863066,0.5,11430,11506,Catron+Cibola+Sierra+Socorro,Sierra,35,51,New Mexico,NM
35053,35CS002,119,141,164,194,30,53,75,48,-133.66808697499667,39.25363650254779,194.5850467297899,0.898669873339531,141,170,202,224,22,54,83,30,-48.935524897222656,146.80657469166798,324.1978524441001,0.5555555555555556,16546,16348,Catron+Cibola+Sierra+Socorro,Socorro,35,53,New Mexico,NM
35055,35CS014,216,278,352,344,-8,66,128,44,-182.57948382526936,77.24516623376782,294.93608925620435,0.6111111111111112,262,339,436,425,-11,86,163,36,-136.02467525192932,144.55332120290046,367.3099891765699,0.3829787234042553,34177,34589,Rio Arriba+Taos,Taos,35,55,New Mexico,NM
35057,35CS008,114,136,160,151,-9,15,37,10,-153.1792863238649,35.86218419672041,211.8663119227827,0.4931433892856554,141,170,200,235,35,65,94,45,-65.48931432687901,130.97862865375802,320.89764020170713,0.6923076923076923,15135,15270,Guadalupe and Nearby Counties,Torrance,35,57,New Mexico,NM
35059,35CS012,26,36,47,48,1,12,22,5,-113.94962891738987,201.35514253200333,492.40570079298146,0.3953340941408007,32,45,61,55,-6,10,23,7,-316.98297232494815,73.14991669037265,391.3520542934926,0.5384615384615384,4068,4101,Northeast New Mexico,Union,35,59,New Mexico,NM
35061,35CS017,477,598,747,740,-7,142,263,73,-125.63114965016683,109.00580400357796,298.0799000126617,0.46794871794871795,578,735,941,961,20,226,383,142,-158.30907738734874,108.99969262735486,312.85507014827675,0.5941422594142259,76510,77064,Valencia,Valencia,35,61,New Mexico,NM
36001,36CS001,1900,2354,2909,2634,-275,280,734,209,-185.75230269840117,27.229097742513645,201.3419199270375,0.5042226878528607,2268,2852,3625,3188,-437,336,920,256,-220.86506812681515,25.491171391683203,211.6404504794497,0.44991212653778556,312901,313834,Albany+Greene,Albany,36,1,New York,NY
36003,36CS002,325,410,521,474,-47,64,149,69,-300.7882997961162,-12.965012922246386,207.56985688516448,0.8214285714285714,389,500,640,562,-78,62,173,81,-344.6748627625728,-41.17461422501656,199.48017049540906,0.7641509433962265,46278,46145,Allegany+Steuben,Allegany,36,3,New York,NY
36005,36CS003,6628,8226,10132,14136,4004,5910,7508,4277,-22.538974351874266,134.71428687810692,266.49677522635966,0.7236274478652751,7883,9828,12512,11765,-747,1936,3882,1456,-153.9239773902648,33.57794980410971,169.54593509829544,0.6362246316374757,1455080,1430999,Bronx,Bronx,36,5,New York,NY
36007,36CS004,1479,1824,2276,2054,-222,230,575,211,-263.83312344293984,11.268412290648476,221.80499111565624,0.6298507462686567,1774,2221,2823,2511,-312,290,737,298,-309.1500916221926,-4.053098546341429,222.59110579188822,0.6689121781629466,197011,197380,Broome,Broome,36,7,New York,NY
36009,36CS005,571,718,894,789,-105,72,218,53,-247.16588245767545,28.922003956147982,258.1875109923155,0.41897887764029496,683,868,1116,1157,41,289,474,161,-157.06673675008133,167.3286916688341,409.2363041166289,0.5375641025641025,76758,76496,Cattaraugus+Wyoming,Cattaraugus,36,9,New York,NY
36011,36CS006,505,634,792,759,-33,126,254,29,-97.81361094918677,152.11947552935573,354.7615333459223,0.1952884092145837,604,764,975,940,-35,176,336,111,-192.32959496342363,84.96752654206043,296.4642147021814,0.5495049504950495,76124,75911,Cayuga,Cayuga,36,11,New York,NY
36013,36CS007,1013,1257,1566,1291,-275,34,278,41,-298.0553725913188,-6.601447897925112,223.50616454403593,0.17012448132780084,1221,1530,1955,1880,-75,350,659,286,-284.4827373911416,50.434612723083276,294.0968354414792,0.7352233676975946,127245,126897,Chautauqua,Chautauqua,36,13,New York,NY
36015,36CS008,693,871,1081,942,-139,71,249,100,-342.6212518397882,-41.56459445034033,213.62768285597323,0.6578947368421053,832,1059,1346,1138,-208,79,306,123,-397.99409772348275,-52.90555981822732,220.21939274337106,0.5603673723536737,83725,83167,Chemung,Chemung,36,15,New York,NY
36017,36CS009,382,483,608,519,-89,36,137,29,-301.0162753753292,17.856897691756817,275.5064215299623,0.3169493549928333,451,579,740,697,-43,118,246,83,-270.2982934738694,75.08285929829705,349.77886310249517,0.5865797622615123,47041,46615,Chenango+Cortland,Chenango,36,17,New York,NY
36019,36CS010,497,617,770,676,-94,59,179,10,-156.56684004987542,73.73162097495334,254.2988560156554,0.09216785592932382,581,760,974,866,-108,106,285,57,-207.314465930522,60.91942803774806,286.44691884553487,0.33628611207796727,79749,79613,Clinton,Clinton,36,19,New York,NY
36021,36CS011,464,576,734,579,-155,3,115,44,-389.6437647615512,-80.27836359408845,139.01862963854342,0.3165631469979296,558,706,907,763,-144,57,205,65,-338.73325262471707,-12.95656715753161,226.9018823462722,0.4676258992805755,61287,61745,Columbia,Columbia,36,21,New York,NY
36023,36CS009,292,370,466,425,-41,54,133,28,-177.12595186806402,67.97737472127004,269.34431493333415,0.3684210526315789,346,448,572,556,-16,108,210,54,-151.1717970789986,116.45188362718864,336.52437851894035,0.451890756302521,46780,46371,Chenango+Cortland,Cortland,36,23,New York,NY
36025,36CS012,355,452,566,476,-90,24,121,23,-306.70940964015455,2.713042102080093,266.01377810895303,0.2804878048780488,432,552,710,673,-37,121,241,70,-241.37542277339347,114.99436302142051,385.5693348365276,0.5,44231,44350,Delaware+Schoharie,Delaware,36,25,New York,NY
36027,36CS013,1792,2206,2712,2497,-215,291,705,264,-194.45841769551527,10.95997761774118,179.17533779522051,0.6330935251798561,2157,2712,3418,3137,-281,425,980,335,-207.41821411014732,30.31199037089106,217.23593099138594,0.5795847750865052,295621,296912,Dutchess,Dutchess,36,27,New York,NY
36029,36CS014,6649,8197,10179,9465,-714,1268,2816,1189,-240.85103483893653,10.000384596366114,205.90032361037086,0.7307928703134604,7880,9850,12561,10895,-1666,1044,3015,1200,-301.32759393535895,-16.350213154075064,190.88742424801006,0.6086745775322977,947964,951058,Erie,Erie,36,29,New York,NY
36031,36CS015,289,365,465,403,-62,38,114,4,-212.45763114435726,109.44787058951738,354.41795740899573,0.056338028169014086,343,448,568,490,-78,42,147,33,-297.8975488168822,24.14298009321873,305.81108118077054,0.3626373626373626,37278,37278,Essex+Franklin,Essex,36,31,New York,NY
36033,36CS015,296,373,467,413,-54,40,117,11,-162.98109671913372,72.65875180407191,265.5802652148835,0.15492957746478872,350,446,572,547,-25,101,197,37,-130.7241752381621,134.8323483520125,337.0808708800313,0.3274336283185841,47895,47466,Essex+Franklin,Franklin,36,33,New York,NY
36035,36CS016,403,504,635,565,-70,61,162,48,-266.48573349232885,29.333738657072608,257.2343236081752,0.5217391304347826,479,613,790,803,13,190,324,117,-195.86834810790802,137.41844701467838,389.76012951218013,0.5879396984924623,53181,53122,Fulton+Hamilton,Fulton,36,35,New York,NY
36037,36CS017,429,540,674,607,-67,67,178,57,-256.34877571813166,20.656629791952593,250.1517867805457,0.5757575757575758,519,659,847,734,-113,75,215,121,-404.4062495615658,-79.43077489253642,162.40139953571838,0.8832116788321168,58093,57912,Genesee+Orleans,Genesee,36,37,New York,NY
36039,36CS001,349,446,553,461,-92,15,112,28,-300.91266393035824,-32.598871925788806,210.63886475125074,0.3181818181818182,424,540,700,653,-47,113,229,67,-235.4876233437435,95.02132170010702,334.64030685689863,0.5114503816793893,47854,48410,Albany+Greene,Greene,36,39,New York,NY
36041,36CS016,47,61,77,64,-13,3,17,4,-415.6911414900991,-20.183863586769533,315.9973226310606,0.30706231419964575,59,77,97,79,-18,2,20,4,-430.2740144647041,-39.11581949679128,312.92655597433026,0.2222222222222222,4989,5113,Fulton+Hamilton,Hamilton,36,41,New York,NY
36043,36CS018,433,544,686,609,-77,65,176,35,-223.3687001826312,59.80420352948627,281.17943026113454,0.3431372549019608,517,656,838,834,-4,178,317,139,-238.62662495403941,65.89130853327198,297.011328717698,0.7128205128205128,60196,59947,Herkimer,Herkimer,36,43,New York,NY
36045,36CS019,647,803,995,793,-202,-10,146,13,-223.80857716010337,-23.94231290549943,138.60517232031503,-0.05803571428571429,779,997,1272,1081,-191,84,302,119,-266.6173090178826,-30.101954243954484,157.56222907121304,0.5964949748743719,115277,116272,Jefferson+Lewis,Jefferson,36,45,New York,NY
36047,36CS020,11076,13746,16986,22012,5026,8266,10936,6645,-72.11150594013064,72.19612817549982,191.11709168037467,0.8038954872070245,13030,16284,20567,18747,-1820,2463,5717,2754,-172.38375009930334,-10.96605521514002,111.64838518438509,0.8069150148537609,2694327,2653643,Kings,Kings,36,47,New York,NY
36049,36CS019,171,218,277,205,-72,-13,34,4,-344.23230462635235,-76.94870714856003,136.01815587142502,-0.08163265306122448,206,268,348,304,-44,36,98,40,-316.1710679948152,-13.173794499783966,218.49679163213105,0.6666666666666666,26511,26568,Jefferson+Lewis,Lewis,36,49,New York,NY
36051,36CS021,379,480,600,482,-118,2,103,33,-292.91702940587106,-60.135284182662275,135.88634377404804,0.25,456,588,753,678,-75,90,222,74,-242.06256462256698,25.164116375920784,240.35789867452067,0.5481481481481482,61861,61596,Livingston,Livingston,36,51,New York,NY
36053,36CS022,379,477,602,612,10,135,233,70,-105.41550821957294,114.20013390453735,286.4666435866894,0.49822695035460995,451,575,742,716,-26,141,265,71,-143.29645870624472,103.40981556120754,286.59291741248944,0.44654088050314467,68301,67692,Madison,Madison,36,53,New York,NY
36055,36CS023,4676,5778,7131,6541,-590,764,1865,654,-197.5327751554015,17.383836752675478,192.27793500459268,0.6166914742081593,5562,7004,8945,8105,-840,1101,2543,896,-229.7874156519518,27.128783810556392,217.96985275301185,0.6029609690444145,755875,755655,Monroe,Monroe,36,55,New York,NY
36057,36CS024,384,481,609,560,-49,79,176,33,-199.05068265635225,111.66257807551469,347.12497097388257,0.336734693877551,456,585,758,737,-21,152,281,116,-276.9492020089919,72.66888682451683,333.0657312790355,0.703030303030303,49435,49540,Montgomery,Montgomery,36,57,New York,NY
36059,36CS025,7429,9112,11342,12307,965,3194,4878,2755,-154.7405177233753,37.99355169800193,183.4928619662773,0.8504399029573981,8794,11002,14062,12165,-1897,1162,3371,1300,-229.7760338008667,-9.882453752774218,148.85850247315145,0.6069094304388422,1388130,1391355,Nassau,Nassau,36,59,New York,NY
36061,36CS026,6789,8395,10364,12306,1942,3911,5517,2787,-60.817143064240405,80.85453758851052,196.38157261266346,0.7106977260472582,7690,9633,12290,11301,-989,1668,3611,1124,-132.64117370537267,34.14817372789226,156.1243203811162,0.5289412936063764,1668181,1593057,New York (county),New York (county),36,61,New York,NY
36063,36CS027,1625,2013,2505,2390,-115,377,765,234,-197.82107079896883,81.02080230345855,301.02344240438816,0.5318181818181819,1923,2410,3095,2968,-127,558,1045,372,-235.80767207321628,87.84343481998442,317.98378851771764,0.6024295447750625,211797,211740,Niagara,Niagara,36,63,New York,NY
36065,36CS028,1762,2186,2694,2455,-239,268,693,246,-252.03087086014784,11.686130024427257,232.19041899645356,0.6022040845678125,2091,2652,3351,3040,-311,388,949,471,-339.33349055269235,-36.22854681134102,207.500628892501,0.8263183327741852,231043,230481,Oneida,Oneida,36,65,New York,NY
36067,36CS029,2998,3678,4527,4339,-188,661,1341,474,-167.88753614338012,47.4172621338349,219.85634830556975,0.6208254135988417,3545,4445,5680,5173,-507,728,1628,514,-215.68303388573946,45.18691003137525,235.28866284094127,0.5416233622029758,473245,473588,Onondaga,Onondaga,36,67,New York,NY
36069,36CS030,749,931,1162,935,-227,4,186,74,-322.22223873962935,-74.92295868385335,119.93025029322521,0.3115913764981207,891,1126,1443,1194,-249,68,303,103,-312.9244671400977,-31.554661506812863,177.77274088345277,0.46085241832158874,112115,112503,Ontario,Ontario,36,69,New York,NY
36071,36CS031,1927,2370,2924,3006,82,636,1079,594,-154.00179922980936,12.773373277257807,145.79678533641788,0.9020506339622989,2303,2898,3684,3163,-521,266,860,393,-226.24233047460865,-31.55488392004879,115.63936871876697,0.7408164788151854,399268,404058,Orange,Orange,36,71,New York,NY
36073,36CS017,275,351,441,418,-23,67,143,49,-214.66860740780618,53.667151851951544,280.5599438482575,0.5975609756097561,329,424,550,488,-62,64,159,52,-283.72367105592537,29.85255635836128,266.3096798468812,0.5714285714285714,40248,40198,Genesee+Orleans,Orleans,36,73,New York,NY
36075,36CS032,746,934,1167,981,-186,47,235,48,-239.55202288268313,-1.0230707789138718,191.36538919583967,0.2798857609139127,899,1140,1455,1329,-126,190,430,138,-224.94978989493683,43.87394122169758,248.80358318051992,0.5542168674698795,117294,117382,Oswego,Oswego,36,75,New York,NY
36077,36CS033,407,516,641,571,-70,55,164,19,-182.75257599726368,73.8808841763222,297.5757834879644,0.20212765957446807,488,623,801,735,-66,112,247,85,-259.81730252552387,46.426652337452985,278.64588930682424,0.5902777777777778,58472,58156,Otsego,Otsego,36,77,New York,NY
36079,36CS034,465,586,727,777,50,190,312,116,-80.9709528208311,91.39903007805935,240.5205348564232,0.5979381443298969,556,707,906,753,-153,46,197,53,-210.5300791913847,-7.1504636309543566,147.1463265769964,0.3706293706293706,97813,97896,Putnam,Putnam,36,79,New York,NY
36081,36CS035,10119,12522,15535,20419,4884,7896,10300,6559,-84.87101077802393,67.76811254327154,189.5556442925311,0.8306214310223841,11889,14972,18958,17202,-1756,2230,5313,2511,-182.31236325896282,-11.9842559774414,119.72293083774079,0.8115729016273276,2368371,2340571,Queens,Queens,36,81,New York,NY
36083,36CS036,1000,1245,1542,1393,-149,148,393,78,-169.68531597825682,52.31434537977528,235.48928898810266,0.3482142857142857,1176,1498,1919,1786,-133,288,610,167,-187.23558411652428,75.15618882758554,276.3315307888943,0.48830409356725146,160568,160333,Rensselaer,Rensselaer,36,83,New York,NY
36085,36CS037,2590,3220,3993,4420,427,1200,1830,1125,-170.1373846521097,18.152860947486104,171.78210695272085,0.9297520661157025,3093,3883,4980,4367,-613,484,1274,594,-244.45626909023528,-22.27668759831487,137.73068396012675,0.7576530612244898,492484,493790,Richmond,Richmond,36,85,New York,NY
36087,36CS038,1581,1951,2420,2791,371,840,1210,819,-159.89544947039101,7.488413110789946,139.4449498559242,0.9709546980148758,1880,2380,3048,2477,-571,97,597,273,-249.02252845042204,-51.90734293512676,95.55669949421063,0.5492957746478874,336520,339066,Rockland,Rockland,36,87,New York,NY
36089,36CS039,689,860,1083,939,-144,80,250,47,-211.87670792152124,36.042884100756034,225.1293991524146,0.2974683544303797,841,1054,1346,1261,-85,208,420,139,-207.2830470592498,63.37375016094003,260.0174085070393,0.5548924302788845,108204,108089,St. Lawrence,St. Lawrence,36,89,New York,NY
36091,36CS040,1330,1648,2048,1689,-359,41,359,64,-216.04384201356072,-11.745676317957443,150.8553384488967,0.1907604832977967,1591,2022,2573,2364,-209,342,773,252,-194.46222664732073,38.16706031572875,219.7452682597841,0.5656572781780622,234980,237115,Saratoga,Saratoga,36,91,New York,NY
36093,36CS041,1055,1308,1630,1453,-177,144,398,88,-201.84396842379616,43.03465741865842,236.15744305584147,0.3705279580186505,1252,1587,2017,1851,-166,264,599,188,-224.06650817828518,48.08429936905174,260.0664638901147,0.5325779036827195,157547,158056,Schenectady,Schenectady,36,93,New York,NY
36095,36CS012,189,239,303,258,-45,19,69,3,-192.45454020224153,64.15151340074719,264.8254662574593,0.06666666666666667,225,292,385,357,-28,65,132,33,-204.40889318308908,107.23089478457132,331.7455807397675,0.42857142857142855,29929,29842,Delaware+Schoharie,Schoharie,36,95,New York,NY
36097,36CS042,135,172,221,192,-29,20,57,11,-269.06583704700245,63.90313629866308,309.4257126040528,0.3142857142857143,157,209,271,259,-12,50,102,17,-163.22108366135848,185.73433658016654,478.4066245246714,0.29310344827586204,17840,17767,Schuyler+Seneca+Yates,Schuyler,36,97,New York,NY
36099,36CS042,237,301,380,324,-56,23,87,30,-305.67195990386693,-24.86581893465507,202.4788113250484,0.5172413793103449,286,366,475,410,-65,44,124,52,-347.26408951696527,-23.744553129365148,213.7009781642863,0.6753246753246753,33781,33692,Schuyler+Seneca+Yates,Seneca,36,99,New York,NY
36101,36CS002,685,852,1061,972,-89,120,287,123,-271.9046788144677,-3.2049113485910854,210.30628269454695,0.727810650887574,817,1040,1340,1267,-73,226,450,145,-234.38712716509622,87.6263801098869,327.9269439695153,0.5523829564914522,93606,93009,Allegany+Steuben,Steuben,36,101,New York,NY
36103,36CS043,8705,10745,13345,13547,202,2802,4842,2804,-205.74998264526613,-0.158138449086537,161.15098654163552,0.9632428718653384,10508,13180,16730,14328,-2402,1148,3820,1770,-273.3849676739401,-40.72694873063922,134.33012422033354,0.7000200209281264,1517657,1526017,Suffolk,Suffolk,36,103,New York,NY
36105,36CS044,510,640,807,739,-68,100,229,63,-200.80898422068427,55.929247798969676,254.4397697813401,0.4883720930232558,623,792,1019,876,-143,84,253,81,-281.40399581744845,3.767121764624477,216.0444332012137,0.5159235668789809,78313,79636,Sullivan,Sullivan,36,105,New York,NY
36107,36CS045,318,398,500,492,-8,94,174,57,-161.75120037856516,91.93232586800171,290.70492233935676,0.5480769230769231,377,482,622,559,-63,77,182,59,-253.98312417458737,37.472919960185024,256.0649530612643,0.5462962962962963,48296,48035,Tioga,Tioga,36,107,New York,NY
36109,36CS046,473,600,748,584,-164,-16,111,22,-212.87561696103276,-44.051122026335726,101.83246390503582,-0.15492957746478872,570,728,927,759,-168,30,189,54,-211.0320489081032,-22.338978150182097,128.37782975242942,0.3612080536912752,104878,105197,Tompkins,Tompkins,36,109,New York,NY
36111,36CS047,1183,1469,1821,1664,-157,195,481,149,-202.86729667723932,30.45160922549522,219.8142792027323,0.5418181818181819,1415,1802,2287,2042,-245,240,627,209,-248.43151559365313,16.961517417472187,228.76162684661676,0.5671652232826676,181271,182767,Ulster,Ulster,36,111,New York,NY
36113,36CS048,501,624,790,671,-119,46,170,37,-286.4477504668806,17.432758676715988,244.15037283548014,0.32456140350877194,603,766,980,883,-97,117,280,71,-256.0921250973076,70.09959984811752,318.49600800557744,0.42011834319526625,65394,65621,Warren,Warren,36,113,New York,NY
36115,36CS049,442,555,687,627,-60,72,185,16,-149.19716547198053,109.93475350566987,331.86553714524075,0.1523809523809524,529,680,867,781,-86,101,252,91,-290.571492113445,16.397939735521728,264.17080913925486,0.6066666666666667,61127,60983,Washington,Washington,36,115,New York,NY
36117,36CS050,613,762,956,832,-124,70,219,50,-229.77766623462793,26.403638751465433,223.1767565467615,0.36764705882352944,725,929,1190,1040,-150,111,315,106,-281.47565812802196,5.497571447812929,229.7984865185804,0.5683686964521879,90897,90949,Wayne,Wayne,36,117,New York,NY
36119,36CS051,5017,6160,7648,8319,671,2158,3302,1925,-150.84562854892968,28.086961657170832,165.5807583262462,0.8868924681654062,5966,7464,9500,8016,-1484,552,2050,930,-241.74025547595238,-37.90020988221688,112.19863982304885,0.6524027459954234,997616,998675,Westchester,Westchester,36,119,New York,NY
36121,36CS005,252,322,404,373,-31,51,121,28,-175.5465295932583,68.43339289228713,276.70893647750887,0.4,302,392,505,428,-77,36,126,54,-323.63358995500624,-44.468737551069566,177.99847447525335,0.6626016260162602,40331,40478,Cattaraugus+Wyoming,Wyoming,36,121,New York,NY
36123,36CS042,181,233,293,256,-37,23,75,16,-257.20720227347977,33.97076256442186,286.32499875726995,0.36363636363636365,215,282,367,279,-88,-3,64,25,-459.0490112478175,-113.69634953506315,158.3627725666951,-0.22624897624897625,24727,24627,Schuyler+Seneca+Yates,Yates,36,123,New York,NY
37001,37CS001,1202,1495,1856,1726,-130,231,524,149,-195.1361592872153,57.32102834157857,262.2786565092715,0.5033783783783784,1445,1824,2325,1995,-330,171,550,173,-289.98118185262797,-1.152204954217256,217.2194389938082,0.48055555555555557,171665,173580,Alamance,Alamance,37,1,North Carolina,NC
37003,37CS002,261,336,422,440,18,104,179,44,-85.41863659678053,196.74158141293015,442.6685581790929,0.4074074074074074,317,407,524,614,90,207,297,97,-19.255565279438986,300.4414440763531,546.2571710479148,0.46859903381642515,36596,36613,Alexander+Catawba,Alexander,37,3,North Carolina,NC
37005,37CS003,105,127,150,129,-21,2,24,5,-280.9201921489713,-28.618446986073476,206.1122837815506,0.23476062561393815,131,159,189,170,-19,11,39,14,-299.2620469977442,-27.205640636158563,226.71367196798803,0.6086956521739131,10949,11027,Alleghany+Ashe+Avery+Watauga,Alleghany,37,5,North Carolina,NC
37007,37CS004,187,239,297,286,-11,47,99,34,-242.66345611929455,70.10277621224064,350.5138810612032,0.5964912280701754,219,289,373,417,44,128,198,73,-131.71243163592052,249.3694919096602,566.7488452492278,0.5615384615384615,22253,22056,Anson+Richmond,Anson,37,7,North Carolina,NC
37009,37CS003,222,282,358,343,-15,61,121,34,-220.6312317265162,121.44838443661442,391.3336831846465,0.4788732394366197,265,346,453,440,-13,94,175,57,-262.4549812900134,138.6271849783083,442.29565369430503,0.5588235294117647,26678,26690,Alleghany+Ashe+Avery+Watauga,Ashe,37,9,North Carolina,NC
37011,37CS003,145,186,234,187,-47,0,42,19,-446.26284427344814,-124.9941350349552,155.39811382724162,0.3619375907111756,174,227,297,247,-50,20,73,32,-459.27118703399026,-67.21041761473029,229.63559351699513,0.6274509803921569,17761,17854,Alleghany+Ashe+Avery+Watauga,Avery,37,11,North Carolina,NC
37013,37CS005,379,481,604,571,-33,90,192,65,-261.67746240026685,66.72041366656472,338.9397014261488,0.5963302752293578,452,576,745,685,-60,109,233,80,-314.90310997727005,65.18337037359623,343.89847128138706,0.5925925925925926,44964,44490,Beaufort+Martin+Pamlico,Beaufort,37,13,North Carolina,NC
37015,37CS029,151,194,245,261,16,67,110,38,-146.8544840333992,193.5809107712989,480.6146750183973,0.5588235294117647,177,230,306,313,7,83,136,28,-119.62091562215932,313.2928742485125,615.1932803425336,0.32941176470588235,17977,17555,Gates and Nearby Counties,Bertie,37,15,North Carolina,NC
37017,37CS006,249,315,400,421,21,106,172,27,-24.145722428125094,315.2912515408072,578.6991325748994,0.25,294,379,485,575,90,196,281,87,9.987881934206955,369.0437731622227,656.999487909443,0.4416243654822335,30067,29536,Bladen+Columbus,Bladen,37,17,North Carolina,NC
37019,37CS007,1049,1308,1631,1530,-101,222,481,84,-159.38304570979145,118.76274464336514,341.65804074939103,0.3116893845518381,1297,1635,2101,2039,-62,404,742,203,-185.00442552936644,140.24472763116216,376.07914523978314,0.4496129544963994,139438,143321,Brunswick,Brunswick,37,19,North Carolina,NC
37021,37CS008,1816,2274,2798,2542,-256,268,726,158,-184.9461742023352,48.89920578330485,253.69533155703635,0.38678148521022104,2162,2744,3476,3154,-322,410,992,264,-216.143464625578,53.82388851327714,268.4005618636399,0.46073438756365587,268716,271255,Buncombe+Madison,Buncombe,37,21,North Carolina,NC
37023,37CS009,683,850,1054,1016,-38,166,333,85,-167.84794676554858,111.17113093370345,338.3558162957686,0.4473684210526316,812,1027,1306,1317,11,290,505,178,-190.7501130236276,127.8516616316355,373.33826729130703,0.577922077922078,87972,87602,Burke,Burke,37,23,North Carolina,NC
37025,37CS010,1129,1399,1727,1580,-147,181,451,127,-145.6051621422005,28.68020702417956,172.107797892322,0.48197516995045514,1328,1698,2159,1971,-188,272,643,272,-199.22952373012896,0.21676588372334785,160.86196231109642,0.7351351351351352,225940,230664,Cabarrus,Cabarrus,37,25,North Carolina,NC
37027,37CS011,665,822,1017,976,-41,154,311,108,-221.3857659353177,68.34728344311822,301.61953345549995,0.6,789,994,1281,1322,41,328,533,173,-164.4087986046585,192.61801801755155,447.37088055689395,0.5110794016512192,80764,80470,Caldwell,Caldwell,37,27,North Carolina,NC
37029,37CS012,62,78,95,95,0,17,33,4,-40.549205705053765,147.41080233679725,335.37081037864834,0.2157496400956841,78,98,123,105,-18,7,27,10,-259.95075635225646,-27.85186675202748,157.82724492815572,0.5882352941176471,10498,10771,Camden+Currituck+Pasquotank,Camden,37,29,North Carolina,NC
37031,37CS013,569,713,897,754,-143,41,185,31,-307.23768358840914,17.642129405019187,271.68879283729547,0.2246376811594203,699,888,1134,1064,-70,176,365,79,-217.87133276264834,141.7881199461717,418.12878052167423,0.3700254486420078,68019,68412,Carteret,Carteret,37,31,North Carolina,NC
37033,37CS014,185,235,300,279,-21,44,94,16,-195.7592836856241,148.14216062695877,412.68173317509945,0.2962962962962963,221,287,375,362,-13,75,141,44,-250.9787805513461,136.49723152792507,427.3243974124233,0.5301204819277109,22681,22711,Caswell+Person,Caswell,37,33,North Carolina,NC
37035,37CS002,1137,1415,1754,1706,-48,291,569,174,-165.90429731470996,87.39668071058563,295.0945189292039,0.5248880719251628,1339,1708,2164,2319,155,612,980,320,-102.27089874613712,180.40524650226308,408.4647090617277,0.5091490891415957,160647,161581,Alexander+Catawba,Catawba,37,35,North Carolina,NC
37037,37CS015,514,643,810,727,-83,84,213,51,-210.5608642957343,51.815872645482706,254.3688293505515,0.4180327868852459,627,793,1020,833,-187,40,206,55,-311.57248548552894,-19.304367130454086,194.3306291132378,0.3313253012048193,76424,77703,Chatham,Chatham,37,37,North Carolina,NC
37039,37CS016,265,338,422,351,-71,13,86,28,-411.99931541422853,-62.39262727121079,241.25149211534836,0.4057971014492754,322,413,537,545,8,132,223,94,-295.5187103181133,130.50216144204887,443.02049542169226,0.6861313868613139,28850,29118,Cherokee+Clay+Graham+Swain,Cherokee,37,39,North Carolina,NC
37041,37CS029,126,164,208,194,-14,30,68,22,-315.57207012104766,70.02986299496203,402.6717122210317,0.5945945945945946,148,199,258,237,-21,38,89,21,-306.2601023297643,123.96242237157128,495.8496894862851,0.40384615384615385,13708,13714,Gates and Nearby Counties,Chowan,37,41,North Carolina,NC
37043,37CS016,114,134,157,111,-46,-23,-3,5,-548.6643392084475,-301.15919621694167,-89.01193079565093,-0.20979600924953498,139,166,198,191,-7,25,52,42,-434.3530411176465,-150.6939122244896,89.0866951680067,1.4482758620689655,11161,11281,Cherokee+Clay+Graham+Swain,Clay,37,43,North Carolina,NC
37045,37CS017,846,1060,1316,1263,-53,203,417,162,-259.32787359792263,49.430231601649595,307.49220902440794,0.675,1029,1289,1643,1480,-163,191,451,218,-380.3362454324868,-26.928225060121004,232.48034301904457,0.7927272727272727,99534,100267,Cleveland,Cleveland,37,45,North Carolina,NC
37047,37CS006,440,549,693,753,60,204,313,85,-58.72995973630782,278.99661511459607,534.5481365220833,0.4116246892734862,521,666,837,908,71,242,387,154,-165.5958296968355,175.46577981121646,464.685227102318,0.6184738955823293,51183,50152,Bladen+Columbus,Columbus,37,47,North Carolina,NC
37049,37CS018,745,924,1148,1121,-27,197,376,102,-153.60130184049103,113.1172377895089,326.31346332857794,0.46788990825688076,867,1114,1426,1292,-134,178,425,108,-240.47200267908627,70.04038912983096,314.93338091002005,0.4426229508196721,100780,100656,Craven,Craven,37,49,North Carolina,NC
37051,37CS019,1792,2227,2760,2594,-166,367,802,148,-112.70519549824373,78.49399845481118,234.46049812426816,0.32456140350877194,2143,2726,3445,3572,127,846,1429,444,-94.5452584543965,119.8776025821397,293.74485677496693,0.5051253378063554,334803,335342,Cumberland,Cumberland,37,51,North Carolina,NC
37053,37CS012,156,205,261,262,1,57,106,13,-51.03926147735285,185.59731446310136,392.2852328424642,0.20967741935483872,191,254,332,317,-15,63,126,27,-142.696759488373,122.16607233249533,335.95669891436216,0.375,28449,29468,Camden+Currituck+Pasquotank,Currituck,37,53,North Carolina,NC
37055,37CS020,241,308,394,324,-70,16,83,2,-233.06375209683134,45.28650283630311,262.0147664100394,0.031746031746031744,291,380,493,414,-79,34,123,26,-278.4725779101627,21.21695831696478,257.255619593198,0.3333333333333333,37097,37706,Dare+Hyde+Tyrrell+Washington,Dare,37,55,North Carolina,NC
37057,37CS021,1255,1556,1935,1849,-86,293,594,137,-158.30203753476016,110.66599980023562,324.2300974916519,0.39653424703438106,1500,1904,2422,2384,-38,480,884,349,-227.06018092345332,76.8700961389647,313.99380491572526,0.6635004969729827,169158,170417,Davidson,Davidson,37,57,North Carolina,NC
37059,37CS022,322,402,507,438,-69,36,116,34,-288.3395688320323,5.598826579262763,229.55188974977327,0.4533333333333333,385,492,635,579,-56,87,194,84,-322.4953765780201,6.9081480166659075,253.29876061108328,0.7272863568215893,42866,43427,Davie+Yadkin,Davie,37,59,North Carolina,NC
37061,37CS023,310,383,482,596,114,213,286,74,95.74113989301426,332.70046112822456,507.42804143297553,0.3474178403755869,356,455,587,752,165,297,396,107,119.39017271572297,391.4431892318786,595.508704460392,0.359664881476962,50135,48538,Duplin,Duplin,37,61,North Carolina,NC
37063,37CS024,1444,1791,2225,2037,-188,246,593,138,-120.32369003307159,39.84350306169472,167.87764877985353,0.39712312431680413,1713,2174,2740,2269,-472,94,556,133,-185.40124904315422,-11.80801999695854,129.8728848756387,0.3061026124541814,325273,326050,Durham,Durham,37,63,North Carolina,NC
37065,37CS025,440,551,682,680,-2,129,240,85,-212.9220473143119,107.62286136507437,379.24828760579027,0.6071428571428571,526,672,859,703,-156,31,177,61,-448.4768879986986,-61.97285416840607,239.73165754145072,0.4420289855072464,49060,48408,Edgecombe,Edgecombe,37,65,North Carolina,NC
37067,37CS026,2348,2924,3611,3325,-286,401,977,244,-166.11742593329166,49.19908672236709,229.70019469742087,0.4376685134778608,2836,3549,4495,4133,-362,584,1297,409,-200.08250758131715,45.440839435118434,230.683667166624,0.5284237726098191,382934,385116,Forsyth+Stokes,Forsyth,37,67,North Carolina,NC
37069,37CS027,434,544,679,593,-86,49,159,43,-222.92760493234528,10.368725810806756,200.46203234226394,0.43434343434343436,541,685,884,758,-126,73,217,73,-279.10376213432704,0,202.12412615756446,0.5289855072463768,69440,71318,Franklin+Warren,Franklin,37,69,North Carolina,NC
37071,37CS028,1648,2066,2574,2346,-228,280,698,226,-238.9358408146975,28.419681506593975,248.48801154330266,0.5750636132315522,1986,2530,3235,3062,-173,532,1076,452,-271.1746989667069,34.49342170856512,270.7842074001948,0.7308008009578033,228011,230479,Gaston,Gaston,37,71,North Carolina,NC
37073,37CS029,90,111,131,126,-5,15,36,18,-257.2020108739405,-33.848988595096394,208.11678554031818,0.9836984503871926,109,135,162,164,2,29,55,19,-163.79950619266518,96.35265070156774,346.8695425256439,0.6129032258064516,10601,10379,Gates and Nearby Counties,Gates,37,73,North Carolina,NC
37075,37CS016,72,87,104,113,9,26,41,10,-21.58384368342355,235.28031168536438,455.53674894933675,0.38681649174900484,84,106,132,130,-2,24,46,15,-212.08940719144798,111.95335276967931,385.617103984451,0.5769230769230769,8085,8039,Cherokee+Clay+Graham+Swain,Graham,37,75,North Carolina,NC
37077,37CS030,384,479,604,594,-10,115,210,48,-114.12219889198035,131.71726659367243,318.4805550473871,0.37945256842894637,456,593,753,706,-47,113,250,67,-184.56482657636494,74.37566379774671,295.8857929345141,0.47018122722348077,61040,61848,Granville+Vance,Granville,37,77,North Carolina,NC
37079,37CS031,130,169,217,206,-11,37,76,26,-216.77362733805055,64.35924158484633,292.8345492110505,0.6046511627906976,157,206,267,266,-1,60,109,21,-107.73256614687745,190.98045816946455,430.9302645875098,0.3230769230769231,20510,20421,Greene+Jones+Lenoir,Greene,37,79,North Carolina,NC
37081,37CS032,3173,3923,4837,4378,-459,455,1205,346,-178.60768801977812,24.17964105341342,190.57550118337124,0.48223019933722605,3811,4806,6132,5761,-371,956,1950,547,-169.21928525398894,75.33356367290158,258.78047300856576,0.4857904085257549,540951,542255,Guilford,Guilford,37,81,North Carolina,NC
37083,37CS033,434,549,690,696,6,147,262,53,-116.0526295526625,231.61246662314807,514.9681438748718,0.34083953680727874,519,671,854,863,9,192,344,92,-172.13709724374482,207.01996060582664,521.7938107069859,0.44552319309600863,48702,48305,Halifax+Northampton,Halifax,37,83,North Carolina,NC
37085,37CS034,685,860,1069,1068,-1,208,383,97,-87.58224870239735,99.14971551214792,255.5561586308605,0.4320734126984127,833,1051,1351,1426,75,375,593,187,-82.71625587300622,138.59764798685535,299.3856640822444,0.49081364829396323,134342,135644,Harnett,Harnett,37,85,North Carolina,NC
37087,37CS035,551,690,857,806,-51,116,255,72,-237.31076725686762,85.82144772800173,353.02507880024064,0.4948512045347189,665,841,1075,959,-116,118,294,107,-357.38493068258157,17.620951311108907,299.63626752208364,0.5977653631284916,62222,62426,Haywood,Haywood,37,87,North Carolina,NC
37089,37CS036,953,1187,1477,1298,-179,111,345,98,-285.0516544681659,13.373047665413775,254.1393404415748,0.47572815533980584,1125,1436,1829,1646,-183,210,521,149,-284.4237026888166,52.2349717417366,318.5905120739852,0.49174917491749176,116653,116780,Henderson,Henderson,37,89,North Carolina,NC
37091,37CS029,164,208,264,315,51,107,151,47,21.790598781749235,330.9964371911275,574.00298816228,0.4351851851851852,195,252,326,304,-22,52,109,30,-244.32915588892527,103.2707287138589,371.0705047650246,0.4724702380952381,21752,21303,Gates and Nearby Counties,Hertford,37,91,North Carolina,NC
37093,37CS037,231,292,370,410,40,118,179,40,0,177.45757891743293,316.23850601952796,0.3389830508474576,274,359,466,499,33,140,225,77,-83.1382078337236,118.90367976219265,279.32927944134144,0.5422535211267606,52745,52984,Hoke+Scotland,Hoke,37,93,North Carolina,NC
37095,37CS020,41,54,68,49,-19,-5,8,6,-659.3840840364234,-293.75222660336163,50.43494710928498,-0.5067938410454719,49,68,86,51,-35,-17,2,3,-842.9369874140978,-443.0680617156887,-22.153403085784436,-0.15789473684210525,4601,4514,Dare+Hyde+Tyrrell+Washington,Hyde,37,95,North Carolina,NC
37097,37CS038,1110,1383,1725,1614,-111,231,504,134,-157.08073650955285,62.165774954820996,237.1592270312526,0.4677152116176506,1339,1700,2161,2032,-129,332,693,302,-225.3373167403048,15.417953946048922,204.45774859980799,0.7531172069825436,187241,191335,Iredell,Iredell,37,97,North Carolina,NC
37099,37CS039,262,332,421,381,-40,49,119,31,-196.9917525117701,49.94157105932199,244.29751843184997,0.47692307692307695,316,408,523,464,-59,56,148,50,-251.44253771349844,13.834527522063189,225.96394952703207,0.5494505494505495,43251,43370,Jackson+Macon+Transylvania,Jackson,37,99,North Carolina,NC
37101,37CS040,1107,1376,1726,1536,-190,160,429,121,-171.722733777899,21.803432929048572,170.0667768465788,0.484,1349,1714,2188,2110,-78,396,761,249,-145.24399192299538,65.2732094548466,227.390548039639,0.5576714719956661,217397,225207,Johnston,Johnston,37,101,North Carolina,NC
37103,37CS031,78,95,113,135,22,40,57,17,70.03660739196394,306.13768422002096,520.7750267909818,0.4202439130620556,92,115,141,169,28,54,77,16,129.86222429641052,411.2303769386333,660.1329735067535,0.2962962962962963,9193,9241,Greene+Jones+Lenoir,Jones,37,103,North Carolina,NC
37105,37CS041,413,524,656,646,-10,122,233,46,-106.3740475369898,145.18491769098517,354.8964654668527,0.34328358208955223,500,638,821,784,-37,146,284,85,-190.618302337469,95.27010604330691,310.95537890528516,0.5151515151515151,63230,64028,Lee,Lee,37,105,North Carolina,NC
37107,37CS031,482,598,752,733,-19,135,251,78,-211.16699699304726,124.08782297529582,376.61742762677505,0.5165562913907285,564,725,925,944,19,219,380,111,-168.04222060792773,197.26695462669775,491.4321679843798,0.4847161572052402,55122,54748,Greene+Jones+Lenoir,Lenoir,37,107,North Carolina,NC
37109,37CS042,577,717,889,850,-39,133,273,74,-155.20871313024028,81.03817765207236,273.3321585213966,0.4713375796178344,683,882,1124,1057,-67,175,374,174,-269.9076234020715,1.119716338527573,224.05523933936726,0.8149927603001185,87366,89308,Lincoln,Lincoln,37,109,North Carolina,NC
37111,37CS043,348,438,549,541,-8,103,193,64,-193.12935969551577,104.61173650173771,346.15755373203194,0.5765765765765766,414,533,687,685,-2,152,271,110,-250.61196215274558,93.97948580727959,360.2546955945718,0.6832298136645962,44737,44691,McDowell+Mitchell+Yancey,McDowell,37,111,North Carolina,NC
37113,37CS039,336,420,523,463,-60,43,127,16,-247.0865339080774,87.78074230944856,360.8763850499552,0.20512820512820512,397,516,663,630,-33,114,233,90,-328.76401734513604,65.35268498949966,381.44628381626336,0.6766917293233082,36910,37489,Jackson+Macon+Transylvania,Macon,37,113,North Carolina,NC
37115,37CS008,173,222,279,239,-40,17,66,14,-304.47726161369195,16.899755501222494,292.9290953545232,0.3111111111111111,203,273,354,296,-58,23,93,40,-456.6790771276983,-79.21983990990685,246.97950089559194,0.6666666666666666,21302,21459,Buncombe+Madison,Madison,37,115,North Carolina,NC
37117,37CS005,199,254,322,341,19,88,142,30,-59.99482999097616,313.60933858919356,610.8564508172118,0.33707865168539325,232,306,395,384,-11,78,152,54,-298.4055388658868,112.47593388021889,449.9037355208755,0.6206896551724138,22002,21782,Beaufort+Martin+Pamlico,Martin,37,117,North Carolina,NC
37119,37CS044,4302,5354,6604,6552,-52,1198,2250,611,-71.1941937293077,63.004661117297786,175.92468450478182,0.47,5137,6459,8184,7967,-217,1508,2830,847,-94.8870555637772,58.9283071617952,176.79829402105014,0.5139564999191797,1118013,1121702,Mecklenburg,Mecklenburg,37,119,North Carolina,NC
37121,37CS043,173,199,227,214,-13,15,41,26,-313.4733460202314,-88.29311511315346,117.34941928875119,1.1177461954123726,210,249,287,271,-16,22,61,36,-347.80185327109314,-93.63896049606353,167.21242945725632,1.1612903225806452,14896,14951,McDowell+Mitchell+Yancey,Mitchell,37,121,North Carolina,NC
37123,37CS045,199,253,317,314,-3,61,115,38,-189.86119018157606,106.37776794582828,356.3655226185245,0.5671641791044776,240,308,397,403,6,95,163,65,-228.99468232077672,116.33938136533958,380.235878095718,0.65,25945,25787,Montgomery+Moore,Montgomery,37,123,North Carolina,NC
37125,37CS045,773,961,1190,1118,-72,157,345,97,-201.80147936053444,71.581961345740865,295.9914101646384,0.49489795918367346,928,1183,1496,1386,-110,203,458,149,-253.11433059061025,52.74232626622788,301.85214689958747,0.5752981514609421,100584,102385,Montgomery+Moore,Moore,37,125,North Carolina,NC
37127,37CS046,749,933,1164,1058,-106,125,309,115,-279.36263814400814,12.640843354932496,245.295565302465,0.6336136239451157,892,1144,1456,1240,-216,96,348,133,-366.8253636364631,-38.35876170385591,226.0539628082028,0.584618208516887,94930,95154,Nash,Nash,37,127,North Carolina,NC
37129,37CS047,1342,1657,2054,1952,-102,295,610,88,-100.2170156570777,109.15507624843508,275.313358982164,0.24823744728256547,1586,2004,2550,2373,-177,370,787,205,-167.13576308325125,71.96396552072983,254.69556672443093,0.4606741573033708,227566,228587,New Hanover,New Hanover,37,129,North Carolina,NC
37131,37CS033,153,196,256,305,49,109,152,43,40.66365532845667,447.3002086130234,738.7230718002962,0.3944954128440367,178,236,307,323,16,87,145,45,-168.85928999035607,244.5548337791364,582.5645504667283,0.5,17706,17174,Halifax+Northampton,Northampton,37,131,North Carolina,NC
37133,37CS048,867,1070,1331,1205,-126,135,338,79,-120.23429803504288,32.8444911705483,151.90577166378588,0.3910891089108911,1049,1326,1689,1649,-40,323,600,220,-126.24289314722621,50.01160766986269,184.53312131001275,0.6145251396648045,204601,205952,Onslow,Onslow,37,133,North Carolina,NC
37135,37CS049,552,698,880,754,-126,56,202,52,-143.67166525923065,3.22767009849437,121.03762869353889,0.4094488188976378,663,848,1085,929,-156,81,266,51,-139.1477049137198,20.151731341595916,144.4207412814374,0.30088757396449706,148714,148871,Orange,Orange,37,135,North Carolina,NC
37137,37CS005,131,154,178,152,-26,-2,21,7,-324.84560784117883,-85.00835199860475,138.83975345446424,-0.27360317823567815,162,194,230,207,-23,13,45,21,-357.1235542103557,-64.85785320505892,194.57355961517675,0.8076923076923077,12341,12335,Beaufort+Martin+Pamlico,Pamlico,37,137,North Carolina,NC
37139,37CS012,294,371,466,442,-24,71,148,41,-192.58030470722065,88.74668419687588,316.5298403021906,0.4939759036144578,355,454,582,537,-45,84,182,56,-247.82246335365156,67.40967104080532,308.85885640514437,0.5384615384615384,40565,40795,Camden+Currituck+Pasquotank,Pasquotank,37,139,North Carolina,NC
37141,37CS050,403,501,630,579,-51,78,176,31,-160.89029231877612,92.21760657295705,284.5011266612505,0.3069306930693069,485,626,808,770,-38,144,285,88,-201.72330326910176,88.8190664929405,315.34769463844896,0.5269461077844312,61160,62487,Pender,Pender,37,141,North Carolina,NC
37143,37CS029,120,142,164,182,18,40,62,15,23.172407597416267,226.95870001684585,430.36830797708996,0.37718795975415553,147,175,209,196,-13,21,49,26,-297.4691288381383,-38.137067799761326,175.43051187890208,0.9285714285714286,13096,13111,Gates and Nearby Counties,Perquimans,37,143,North Carolina,NC
37145,37CS014,302,379,474,449,-25,70,147,26,-156.22253933880836,134.64822195705324,370.28261038189646,0.3058823529411765,358,462,594,537,-57,75,179,76,-339.8946560829377,-2.5555989179168246,263.2266885454329,0.7307692307692307,39213,39130,Caswell+Person,Person,37,145,North Carolina,NC
37147,37CS051,851,1062,1314,1393,79,331,542,126,-32.76936225206658,142.77830524279807,289.7703116891031,0.37058823529411766,1014,1290,1664,1667,3,377,653,180,-102.97447484944416,114.57764216515392,275.1026636757249,0.45,172295,171936,Pitt,Pitt,37,147,North Carolina,NC
37149,37CS052,188,245,308,275,-33,30,87,17,-306.14425134443036,79.5975053495519,428.60195188220246,0.3469387755102041,225,298,387,358,-29,60,133,53,-418.56611789697297,35.687732342007436,407.8597981943707,0.7114414414414414,19599,19615,Polk+Rutherford,Polk,37,149,North Carolina,NC
37151,37CS053,1078,1342,1675,1564,-111,222,486,137,-206.32168549404597,71.10239463821415,290.27240758442866,0.4910394265232975,1313,1651,2106,2047,-59,396,734,294,-243.4336485028848,70.32068011128364,303.5854067353307,0.6727688787185355,144299,145050,Randolph,Randolph,37,151,North Carolina,NC
37153,37CS004,368,458,572,575,3,117,207,57,-150.49463636837802,166.90717526992017,417.4070274875253,0.4523809523809524,433,547,711,726,15,179,293,104,-208.32064145446253,175.4525335102155,442.14038444574305,0.5591397849462365,43138,42747,Anson+Richmond,Richmond,37,153,North Carolina,NC
37155,37CS054,877,1096,1364,1529,165,433,652,194,-29.743921054465048,242.20773873993699,464.14704745979566,0.44495412844036697,1035,1331,1695,1932,237,601,897,300,-54.15497024968772,258.74041341517466,513.2257934535882,0.4983388704318937,118411,116333,Robeson,Robeson,37,155,North Carolina,NC
37157,37CS055,802,992,1234,1204,-30,212,402,104,-176.5656628484193,141.5949925863862,392.5803492127665,0.44161557879552826,951,1222,1547,1518,-29,296,567,167,-215.3139218343058,141.3871006191166,438.51921672642277,0.5030166117779411,91105,91239,Rockingham,Rockingham,37,157,North Carolina,NC
37159,37CS056,1149,1417,1759,1687,-72,270,538,157,-187.8889589732963,92.63286371720106,312.41048108517975,0.5007987220447284,1370,1735,2194,2150,-44,415,780,349,-265.7679719354517,44.598744336994194,291.2771022191113,0.7670329670329671,146384,147986,Rowan,Rowan,37,159,North Carolina,NC
37161,37CS052,560,699,871,889,18,190,329,115,-179.67006106444788,138.84857887515292,396.3664098289364,0.5778894472361809,663,846,1074,1122,48,276,459,210,-250.92183765395828,101.45296522428559,385.6761578755284,0.7291754578445439,64819,64562,Polk+Rutherford,Rutherford,37,161,North Carolina,NC
37163,37CS057,436,550,692,647,-45,97,211,57,-205.1890993290981,80.46631346239143,309.89588972203484,0.4672131147540984,516,663,843,889,46,226,373,118,-122.04523230794386,183.0678484619158,432.41303835772874,0.5086206896551724,59652,58995,Sampson,Sampson,37,163,North Carolina,NC
37165,37CS037,264,332,417,484,67,152,220,56,38.57470836095845,336.6520002410919,575.2891733286574,0.3660130718954248,309,404,528,550,22,146,241,78,-163.84128149897964,198.77265195237496,476.46973923878113,0.5234899328859061,34219,34210,Hoke+Scotland,Scotland,37,165,North Carolina,NC
37167,37CS058,493,612,768,718,-50,106,225,74,-237.4191078840656,61.244751731480044,288.9986722329215,0.5670581327069877,585,746,960,922,-38,176,337,138,-278.01472214324076,59.23609136574733,314.50415442454096,0.7040816326530612,62699,63306,Stanly,Stanly,37,167,North Carolina,NC
37169,37CS026,372,466,588,554,-34,88,182,35,-185.43697241953268,140.99118105757373,394.7753069612064,0.33653846153846156,438,567,723,671,-52,104,233,76,-287.3321323748113,62.85390395698997,352.4308186159795,0.5757575757575758,44684,44548,Forsyth+Stokes,Stokes,37,169,North Carolina,NC
37171,37CS059,649,808,1019,919,-100,111,270,85,-311.3008701291683,43.75039255869391,311.3850054994734,0.5592105263157895,777,986,1260,1087,-173,102,310,169,-480.70215395009893,-94.84769187849074,198.26680480081532,0.8622448979591837,71314,71167,Surry,Surry,37,171,North Carolina,NC
37173,37CS016,131,168,219,211,-8,43,80,10,-152.9537421147979,280.41519387712947,594.8201082242141,0.20833333333333334,156,207,265,249,-16,42,93,30,-325.588322468101,84.93608412211331,446.2683419916034,0.5825791855203619,14122,14128,Cherokee+Clay+Graham+Swain,Swain,37,173,North Carolina,NC
37175,37CS039,276,351,444,369,-75,18,93,14,-321.7788272432481,14.453849623503562,285.46353006419537,0.20439045183290708,333,430,551,513,-38,83,180,47,-256.6210803430666,108.62267951029276,401.45131969012346,0.44761904761904764,33209,33142,Jackson+Macon+Transylvania,Transylvania,37,175,North Carolina,NC
37177,37CS020,21,29,39,39,-0,10,18,6,-233.67934567397475,152.74628196439204,449.9967647631355,0.5431395585133295,23,34,47,49,2,15,26,3,-30.761737525474565,369.1408503056948,707.519963085915,0.2,3319,3251,Dare+Hyde+Tyrrell+Washington,Tyrrell,37,177,North Carolina,NC
37179,37CS060,1011,1273,1592,1448,-144,175,437,117,-130.58197646300175,29.018216991778168,160.10050754084506,0.4717741935483871,1236,1571,2007,1997,-10,426,761,292,-124.2942628781138,55.1413051669169,193.0357183119456,0.6313520892354586,239849,243012,Union,Union,37,179,North Carolina,NC
37181,37CS030,338,426,536,566,30,140,228,71,-115.07894984033845,193.43355758790142,440.271597379419,0.4965034965034965,393,512,660,629,-31,117,236,60,-215.69702972641284,134.95862452695425,416.83273417491733,0.45112781954887216,42805,42235,Granville+Vance,Vance,37,181,North Carolina,NC
37183,37CS061,4121,5071,6275,5693,-582,622,1572,449,-109.30525709332915,18.33500700746201,119.05036630914492,0.49476599041230956,4940,6234,7958,6958,-1000,724,2018,525,-132.9005276237636,17.294319347919938,130.0907452611922,0.4270029173033797,1132260,1147776,Wake,Wake,37,183,North Carolina,NC
37185,37CS027,156,204,258,262,4,58,106,14,-63.91605691192233,284.42645325805444,588.0277235896855,0.22580645161290322,192,248,320,302,-18,54,110,29,-250.82608057565474,133.4181279657738,432.54157086503847,0.44963942307692306,18775,18738,Franklin+Warren,Warren,37,185,North Carolina,NC
37187,37CS020,112,133,156,167,11,34,55,12,-13.127765552878987,236.91970941836365,469.1066504630892,0.34648256953869105,137,163,193,215,22,52,78,33,-100.90643794540733,174.29293826933994,412.7990643221209,0.6346153846153846,11048,10901,Dare+Hyde+Tyrrell+Washington,Washington,37,187,North Carolina,NC
37189,37CS003,233,298,374,361,-13,63,128,24,-81.60330272826583,86.01429206492885,229.4817202398934,0.3380281690140845,283,362,470,457,-13,95,174,39,-95.92259784220272,103.30125921467985,249.0298213211032,0.37142857142857144,54410,54210,Alleghany+Ashe+Avery+Watauga,Watauga,37,189,North Carolina,NC
37191,37CS062,852,1065,1316,1316,-0,251,464,149,-151.5752324857065,103.58910360832203,319.90752584922984,0.5591014051983892,1028,1304,1674,1508,-166,204,480,191,-305.58116580882967,11.121375015438929,247.23672149706542,0.7048066448801742,118159,116892,Wayne,Wayne,37,191,North Carolina,NC
37193,37CS063,548,686,862,827,-35,140,279,77,-202.9663440574014,115.07466828254455,366.06429910352756,0.4782608695652174,641,830,1055,1055,0,225,414,157,-238.54570685784088,103.31915965817312,390.56161750196173,0.6555352161785216,66218,65815,Wilkes,Wilkes,37,193,North Carolina,NC
37195,37CS064,599,749,927,942,15,193,343,110,-143.94446773955102,125.76200865666037,353.11850743897224,0.5379005260640841,710,910,1161,1183,22,273,473,136,-145.6648762246979,174.67035486025046,429.7273219390322,0.47058823529411764,79197,78433,Wilson,Wilson,37,195,North Carolina,NC
37197,37CS022,297,370,466,433,-33,63,136,40,-235.51219326658952,74.10096368169027,309.4520678967977,0.49382716049382713,352,454,580,507,-73,53,155,66,-373.7509424999412,-34.95512411869954,239.3081574280199,0.7333333333333333,37246,37191,Davie+Yadkin,Yadkin,37,197,North Carolina,NC
37199,37CS043,159,205,260,234,-26,29,75,19,-293.10808337983366,65.06283759818727,364.6772047378394,0.4418604651162791,194,251,327,306,-21,55,112,50,-379.3570965824467,26.715288491721598,331.5367301822648,0.7575757575757576,18444,18716,McDowell+Mitchell+Yancey,Yancey,37,199,North Carolina,NC
38001,38CS008,18,27,39,24,-15,-3,6,7,-1185.0004846447093,-554.7414095005663,-59.5378504587393,-0.8680697955342545,22,34,48,40,-8,6,18,5,-599.0610869502606,46.08162207309697,599.0610869502606,0.5,2192,2170,Southwest North Dakota,Adams,38,1,North Dakota,ND
38003,38CS003,99,118,141,151,10,33,52,26,-173.65791808617698,73.64363590070529,284.3079226302717,0.7776867310247506,122,148,179,158,-21,10,36,12,-305.2623058867061,-18.500745811315518,222.00894973578622,0.5217391304347826,10771,10810,LaMoure and Nearby Counties,Barnes,38,3,North Dakota,ND
38005,38CS001,36,49,61,91,30,42,55,15,299.0598294023231,543.7976100569832,787.7223083838873,0.35299829410375444,42,56,74,101,27,45,59,7,343.0531732418525,651.8010291595198,891.9382504288166,0.15555555555555556,6067,5830,Benson and Nearby Counties,Benson,38,5,North Dakota,ND
38007,38CS006,3,8,16,6,-10,-2,3,6,-2054.849498327759,-1027.4247491638796,-385.2842809364548,-1,4,10,20,6,-14,-4,2,6,-2101.9442984760904,-1050.9721492380452,-420.3888596952181,-1,934,952,Northwest North Dakota,Billings,38,7,North Dakota,ND
38009,38CS004,56,72,89,68,-21,-4,12,21,-787.7949594982929,-462.3421311442087,-167.8848102524181,-1.4773079767787063,69,90,113,64,-49,-26,-5,6,-860.9753154463538,-500.9310926233331,-172.19506308927075,-0.2222222222222222,6366,6388,McHenry and Nearby Counties,Bottineau,38,9,North Dakota,ND
38011,38CS008,17,26,36,41,5,15,24,4,33.22679052779568,430.38815420719476,794.4527375799773,0.27227210561059845,20,31,43,36,-7,5,16,6,-446.06476517263565,-34.3126742440489,343.12674244048895,0.6666666666666666,2981,2914,Southwest North Dakota,Bowman,38,11,North Dakota,ND
38013,38CS006,8,15,23,19,-4,4,11,2,-331.79689472998496,121.32159199501278,483.8163813750109,0.3421381016122922,10,17,27,21,-6,4,11,4,-462.4232907197425,0,323.69630350381976,0.5714285714285714,2177,2163,Northwest North Dakota,Burke,38,13,North Dakota,ND
38015,38CS007,514,640,803,871,68,231,357,161,-113.85020855851008,85.60166057030833,239.6846495968633,0.688034188034188,612,778,1001,888,-113,110,276,87,-202.5994189891017,23.264037128054614,191.32141838137076,0.5209580838323353,98129,98865,South Central North Dakota,Burleigh,38,15,North Dakota,ND
38017,38CS002,810,1003,1248,1197,-51,194,387,153,-132.69727261363283,26.643428879328823,152.06249653080354,0.6907484407484408,966,1238,1558,1289,-269,50,323,104,-200.22546946154574,-28.714817360119817,117.59656978695793,0.4219084296106119,184661,186315,Cass,Cass,38,17,North Dakota,ND
38019,38CS005,30,40,53,40,-13,-0,10,3,-533.7951818516513,-106.67514607978514,240.35988298485628,-0.18860533464163326,35,49,65,57,-8,8,22,6,-381.83336837260566,54.547624053229384,436.3809924258351,0.5,3696,3667,Northeast North Dakota,Cavalier,38,19,North Dakota,ND
38021,38CS003,44,57,72,82,10,25,38,35,-616.1711902206342,-236.47053394243054,83.27738713395148,1.3849528388968182,53,69,87,66,-21,-3,13,2,-468.80971591150364,-101.91515563293558,224.21334239245826,-0.1111111111111111,4937,4906,LaMoure and Nearby Counties,Dickey,38,21,North Dakota,ND
38023,38CS006,17,25,35,18,-17,-7,1,2,-1053.8328591958457,-516.5934154719438,-68.89387903535852,-0.26714167725063226,21,32,47,30,-17,-2,9,5,-1004.8147372828134,-319.7137800445315,182.69358859687517,-0.34523809523809523,2204,2189,Northwest North Dakota,Divide,38,23,North Dakota,ND
38025,38CS006,16,24,34,34,0,10,18,6,-165.41504012777042,120.48271653877615,358.7308470942317,0.5464586741796318,18,27,40,42,2,15,24,4,-49.4447763653969,271.9462700096829,494.44776365396893,0.26666666666666666,4141,4045,Northwest North Dakota,Dunn,38,25,North Dakota,ND
38027,38CS001,27,38,49,32,-17,-6,5,6,-1206.6738236054005,-611.3234946491978,-58.49818918986682,-0.658796051204169,34,47,63,49,-14,2,15,6,-856.0116988265507,-171.20233976531014,385.2052644719478,0.5,2320,2336,Benson and Nearby Counties,Eddy,38,27,North Dakota,ND
38029,38CS007,26,37,49,52,3,15,26,11,-305.27894647664306,146.7280228853401,538.4673963323919,0.6950859942486537,32,45,60,45,-15,0,13,4,-580.5773944043035,-122.2268198745902,276.53817996625895,0.26666666666666666,3274,3273,South Central North Dakota,Emmons,38,29,North Dakota,ND
38031,38CS001,26,38,50,52,2,14,26,21,-683.7035608195523,-243.437796273372,167.47691730306275,1.3996986394967177,32,46,63,45,-18,-1,13,3,-625.0657296454619,-118.77733579961274,296.9433394990318,-0.15,3361,3368,Benson and Nearby Counties,Foster,38,31,North Dakota,ND
38033,38CS006,4,8,14,12,-2,4,8,7,-619.4883121153742,-222.32179342131016,61.368577074449874,1.5215254845922819,4,10,18,19,1,9,15,4,-170.05196032120926,283.4199338686821,623.5238545111006,0.4444444444444444,1739,1764,Northwest North Dakota,Golden Valley,38,33,North Dakota,ND
38035,38CS005,357,450,565,486,-79,36,129,66,-239.9829725973137,-49.63453414629032,104.23252170720968,0.825,429,550,707,536,-171,-14,107,37,-285.88289968413716,-70.0962879033221,96.27931309073941,-0.24584988962472407,72530,72757,Northeast North Dakota,Grand Forks,38,35,North Dakota,ND
38037,38CS008,18,27,36,37,1,10,19,5,-221.48575237599283,255.80920008953737,730.9444468878031,0.4676749848908975,23,35,49,46,-3,11,23,3,-258.96951712975454,345.2926895063394,863.2317237658484,0.23076923076923078,2284,2317,Southwest North Dakota,Grant,38,37,North Dakota,ND
38039,38CS001,25,35,48,30,-18,-5,5,4,-1139.7704450662409,-491.57495427650895,26.981438355276406,-0.42268902519495116,31,45,60,24,-36,-21,-7,7,-1883.3319646327775,-1226.3556979004134,-613.1778489502067,-0.3333333333333333,2283,2283,Benson and Nearby Counties,Griggs,38,39,North Dakota,ND
38041,38CS008,15,22,32,38,6,16,23,2,190.7448360029505,668.8414311800015,1027.41387756279,0.1265667561527351,16,26,37,24,-13,-2,8,6,-779.8337722748572,-328.3510620104662,82.08776550261655,-0.5,2476,2436,Southwest North Dakota,Hettinger,38,41,North Dakota,ND
38043,38CS007,12,19,27,24,-3,5,12,7,-507.2704053355781,-95.60913263732506,274.8860127911025,0.9262946163570106,14,24,36,35,-1,11,21,7,-337.38369487862093,168.69184743931046,590.4214660375867,0.5833333333333334,2397,2371,South Central North Dakota,Kidder,38,43,North Dakota,ND
38045,38CS003,25,35,48,50,2,15,25,14,-343.9828262324845,43.265454547977534,333.70166513332396,0.9049960417354929,29,43,57,36,-21,-7,7,6,-663.6386446614471,-319.52971779995596,24.579209061535074,-0.5,4076,4068,LaMoure and Nearby Counties,LaMoure,38,45,North Dakota,ND
38047,38CS007,15,23,32,25,-7,2,10,4,-706.2669346557019,-128.96118079091073,395.86223181344513,0.5171405952774245,19,29,41,25,-16,-4,6,4,-1064.6253235691051,-424.788159030067,108.85196575145224,-0.4,1880,1883,South Central North Dakota,Logan,38,47,North Dakota,ND
38049,38CS004,41,53,69,80,11,27,39,11,-1.3532156902394885,347.245610055653,622.455209328726,0.41415318865619644,50,66,85,75,-10,9,25,2,-228.15224409121336,133.0888090532078,437.29180117482565,0.13333333333333333,5377,5260,McHenry and Nearby Counties,McHenry,38,49,North Dakota,ND
38051,38CS007,31,42,56,51,-5,9,20,5,-474.2817595637063,194.87550747088466,706.5840057914546,0.4333965614601972,38,53,70,43,-27,-10,5,7,-1353.0431033768045,-676.5215516884023,-79.59077078687085,-0.5,2506,2513,South Central North Dakota,McIntosh,38,51,North Dakota,ND
38053,38CS006,41,53,67,90,23,37,49,11,94.62152810818613,208.78949708250713,309.52594029514324,0.30087345912874963,44,58,77,94,17,36,50,17,0,136.1626905269884,236.85141694299793,0.4722222222222222,14691,13954,Northwest North Dakota,McKenzie,38,53,North Dakota,ND
38055,38CS004,80,97,117,114,-3,17,34,22,-305.8496977813385,-61.96938518224718,151.42588834195777,1.1309485333595357,99,122,147,113,-34,-9,14,10,-449.47741865458977,-194.09252169175468,40.86158351405362,-0.47619047619047616,9709,9789,McHenry and Nearby Counties,McLean,38,55,North Dakota,ND
38057,38CS008,54,69,84,60,-24,-9,6,5,-416.52113150731435,-202.934357816579,11.245712467741013,-0.3796106437255068,67,86,108,91,-17,5,24,10,-324.9631463160081,-60.067125012201124,168.18795003416315,0.5555555555555556,8314,8324,Southwest North Dakota,Mercer,38,57,North Dakota,ND
38059,38CS008,220,278,346,326,-20,48,106,61,-293.96087326339665,-45.36433229373405,163.3115962574426,1.0166666666666666,260,343,440,369,-71,26,109,32,-306.8173778781195,-17.872856963773952,229.36833103509903,0.4383561643835616,33066,33570,Southwest North Dakota,Morton,38,59,North Dakota,ND
38061,38CS006,64,80,98,108,10,28,44,18,-95.42868005468253,124.84559915908342,315.08247666188134,0.6371364328229895,78,98,123,96,-27,-2,18,16,-447.75050925112424,-187.43044573302876,20.82560508144764,-0.6153846153846154,9854,9604,Northwest North Dakota,Mountrail,38,61,North Dakota,ND
38063,38CS005,35,47,60,52,-8,5,17,11,-766.7172246206129,-236.36440543490082,227.69431135259762,1.09231807302951,43,58,76,42,-34,-16,-1,2,-1182.4520826347878,-591.2260413173939,-98.537673552899,-0.1111111111111111,2976,3045,Northeast North Dakota,Nelson,38,63,North Dakota,ND
38065,38CS008,5,10,16,16,0,6,11,2,-103.50723647554092,264.00763432293974,579.0203807216375,0.2875073043585202,6,12,20,13,-7,1,7,2,-480.7745812698236,-53.419397918869294,267.09698959434644,0.4,1879,1872,Southwest North Dakota,Oliver,38,65,North Dakota,ND
38067,38CS005,58,73,90,77,-13,4,19,10,-412.97253721424534,-108.74530455185916,166.5079059522045,0.7302246926701325,70,93,115,84,-31,-9,14,5,-531.3064974357083,-206.61919344721986,132.82662435892706,-0.2631578947368421,6810,6776,Northeast North Dakota,Pembina,38,67,North Dakota,ND
38069,38CS001,30,41,53,53,0,12,23,21,-623.0982594397659,-275.2441384243892,72.6099825909879,1.6516409625500366,35,48,64,58,-6,10,23,4,-252.832514261334,151.6995085568004,480.3817770965346,0.3076923076923077,3971,3955,Benson and Nearby Counties,Pierce,38,69,North Dakota,ND
38071,38CS001,96,118,139,150,11,32,54,20,-92.94286071303587,129.20223475169928,351.3473302164344,0.6166656664131958,118,147,174,126,-48,-21,8,16,-553.6097900914219,-319.8058116062859,-69.14720250946722,-0.64,11547,11570,Benson and Nearby Counties,Ramsey,38,71,North Dakota,ND
38073,38CS003,63,78,97,73,-24,-5,10,3,-575.8625797002671,-172.76233550493416,142.70742082184816,-0.2251272357454489,80,100,122,67,-55,-33,-13,8,-1110.2143831897752,-721.947497395413,-369.7779864708213,-0.24242424242424243,5629,5679,LaMoure and Nearby Counties,Ransom,38,73,North Dakota,ND
38075,38CS004,18,27,39,30,-9,3,12,12,-1086.8687355402346,-480.7967670553392,-4.597363245778458,1.391451448216514,23,35,49,31,-18,-4,8,4,-970.4990350151639,-352.9087400055142,176.4543700027571,-0.3333333333333333,2279,2267,McHenry and Nearby Counties,Renville,38,75,North Dakota,ND
38077,38CS003,109,131,152,136,-16,5,27,20,-262.8705708957832,-107.20754316676813,48.455484562246824,1.0850408915402698,137,165,194,121,-73,-44,-16,3,-459.08274060315017,-283.90643168879024,-114.46865703196995,-0.06818181818181818,16479,16555,LaMoure and Nearby Counties,Richland,38,77,North Dakota,ND
38079,38CS001,79,97,117,159,42,62,80,21,204.7375372990063,394.80437821998873,569.0323157308892,0.33878483084631006,92,117,142,194,52,77,102,13,323.25911497456406,530.4764963685154,737.6938777624667,0.16883116883116883,12458,12065,Benson and Nearby Counties,Rolette,38,79,North Dakota,ND
38081,38CS003,21,30,40,38,-2,8,17,5,-226.69993146650077,105.87866370251564,387.29132115322165,0.4976667117817624,25,36,50,46,-4,10,21,1,-130.51777488946774,234.93199480104195,522.071099557871,0.08333333333333333,3856,3831,LaMoure and Nearby Counties,Sargent,38,81,North Dakota,ND
38083,38CS004,8,16,28,18,-10,2,10,6,-1518.4617665958183,-379.6154416489546,379.6154416489546,0.75,10,19,34,19,-15,0,9,5,-1579.1032009737803,-394.7758002434451,315.82064019475604,0.4166666666666667,1264,1267,McHenry and Nearby Counties,Sheridan,38,83,North Dakota,ND
38085,38CS008,23,33,43,53,10,20,30,6,129.93089645242355,431.6775360704258,733.4241756884279,0.29829996124007935,27,38,53,57,4,19,30,3,25.270718109573025,425.6120944770181,718.2204094299681,0.15789473684210525,3923,3759,Southwest North Dakota,Sioux,38,85,North Dakota,ND
38087,38CS008,2,6,13,6,-7,0,4,6,-2204.6873159816273,-1017.5479919915205,-339.1826639971735,1,3,8,15,6,-9,-2,3,6,-2168.87068108564,-1156.7310299123415,-433.77413621712805,-1,708,692,Southwest North Dakota,Slope,38,87,North Dakota,ND
38089,38CS006,166,215,270,258,-12,43,92,45,-205.04795047519923,-7.188359350576659,168.9264447385515,0.9,198,259,329,266,-63,7,68,28,-274.4544369819814,-63.33563930353417,120.6393129591127,0.509090909090909,33387,33157,Northwest North Dakota,Stark,38,89,North Dakota,ND
38091,38CS005,8,14,21,13,-8,-1,5,6,-951.325245650401,-461.6733586360331,-80.83300206930254,-1.0153211198411256,9,17,27,26,-1,9,17,6,-387.14583645392844,165.91964419454075,608.3720287133161,0.6666666666666666,1813,1808,Northeast North Dakota,Steele,38,91,North Dakota,ND
38093,38CS003,162,206,261,244,-17,38,82,65,-459.8297899666176,-151.31510455939886,95.27247324110299,1.3829787234042554,196,252,327,248,-79,-4,52,15,-436.03952018653195,-90.40691806100344,171.5413317054937,-0.16393932154801721,21412,21569,LaMoure and Nearby Counties,Stutsman,38,93,North Dakota,ND
38095,38CS001,16,24,35,35,-0,11,19,4,-243.80263069434784,400.93346414726165,861.4592461769829,0.3338957450903705,19,30,43,30,-13,0,11,4,-794.5008081319494,-186.9413666192822,327.14739158374385,0.3484848484848485,2142,2140,Benson and Nearby Counties,Towner,38,95,North Dakota,ND
38097,38CS005,66,81,99,87,-12,6,21,14,-385.53546476841535,-126.11083441910456,108.60668827789092,1.0123939018901147,80,102,125,95,-30,-7,15,2,-400.0614677776013,-112.51728781245036,162.52497128465052,-0.1,7986,7999,Northeast North Dakota,Traill,38,97,North Dakota,ND
38099,38CS005,109,131,155,128,-27,-3,19,22,-553.8303287241604,-281.93043923721075,-37.68933161186492,-1.017040858082631,136,164,193,121,-72,-43,-15,11,-792.2540462824313,-515.4423915572445,-248.17596630533995,-0.2558139534883721,10523,10476,Northeast North Dakota,Walsh,38,99,North Dakota,ND
38101,38CS004,322,404,512,638,126,234,316,159,-57.013647839616155,129.38044139095953,270.83639064507526,0.6794871794871795,381,490,634,569,-65,79,188,50,-166.29527468953637,41.91710531070452,199.46760458197323,0.45454545454545453,69562,69184,McHenry and Nearby Counties,Ward,38,101,North Dakota,ND
38103,38CS001,41,54,68,60,-8,6,19,8,-496.29735905066104,-69.13143002269483,332.9070914153909,0.6960684108441915,51,66,84,57,-27,-9,6,5,-817.9349273124235,-357.8465306991853,25.560466478513234,-0.3333333333333333,3926,3912,Benson and Nearby Counties,Wells,38,103,North Dakota,ND
38105,38CS006,174,224,283,193,-90,-31,19,31,-359.4313335874079,-184.17142712743214,-35.646082669825574,-0.6739130434782609,197,261,339,233,-106,-28,36,30,-350.11766521766856,-149.20517694801453,15.43501830496702,-0.5172413793103449,40397,38873,Northwest North Dakota,Williams,38,105,North Dakota,ND
39001,39CS001,239,304,382,347,-35,43,108,30,-284.10981381756636,56.77828715800712,340.8881009755733,0.4918032786885246,290,372,478,515,37,143,225,95,-210.70796058307977,174.3790018618591,472.45810816947437,0.6506849315068494,27475,27526,Adams+Brown,Adams,39,1,Ohio,OH
39003,39CS002,781,966,1210,1178,-32,212,397,172,-240.1163844409285,47.02401653677915,264.5100930193827,0.7303642264695276,927,1178,1504,1359,-145,180,432,215,-354.03674427587134,-33.914390330466645,213.31660004960182,0.8365758754863813,102076,101727,Allen,Allen,39,3,Ohio,OH
39005,39CS003,388,487,613,570,-43,83,182,69,-255.84767619139737,31.966688680763617,258.01684435187775,0.6634615384615384,461,590,758,725,-33,136,264,104,-261.7942781070554,60.19357489322807,306.0317783857291,0.6887417218543046,52555,52331,Ashland,Ashland,39,5,Ohio,OH
39007,39CS004,831,1036,1280,1111,-169,76,280,125,-362.5599673369399,-61.01213116837846,191.17134432758573,0.6868131868131868,984,1258,1623,1543,-80,285,559,229,-317.57173784452186,57.52552909362195,338.9897250159865,0.715625,97358,97348,Ashtabula,Ashtabula,39,7,Ohio,OH
39009,39CS005,314,394,497,494,-3,100,180,25,-53.70221310610578,143.33330900206172,296.4132830162635,0.23148148148148148,367,476,610,648,38,172,281,77,-63.04462037355748,153.7870049980777,328.50836669746434,0.43258426966292135,62791,62099,Athens+Hocking,Athens,39,9,Ohio,OH
39011,39CS006,330,416,524,541,17,126,211,66,-127.22068146603138,154.32478179875366,376.0856027028451,0.5076923076923077,396,506,649,609,-40,103,213,86,-272.9514431184242,36.812174002484824,275.1168651185703,0.688,46266,46180,Auglaize+Mercer,Auglaize,39,11,Ohio,OH
39013,39CS007,588,740,921,879,-42,140,291,98,-253.38108527794304,75.1093931359617,349.394417949335,0.5885938965442609,706,898,1151,1119,-32,220,413,166,-300.43111105772357,82.69442198306027,374.8560908424777,0.6931136680613668,66303,65905,Belmont,Belmont,39,13,Ohio,OH
39015,39CS001,357,451,564,544,-20,93,187,30,-137.72169314444182,173.3559773846121,432.15168648021137,0.2777777777777778,428,548,707,681,-26,133,253,118,-329.95712332591285,34.35860360908499,309.2274324817649,0.7972972972972973,43610,43657,Adams+Brown,Brown,39,15,Ohio,OH
39017,39CS008,2421,2981,3682,3648,-34,667,1227,399,-133.54161952479276,82.55860215142899,255.08451683392076,0.5511060237516097,2853,3618,4623,4220,-403,602,1367,547,-243.423195536366,14.092180153149972,210.12721715633253,0.6893512503930805,389541,390287,Butler,Butler,39,17,Ohio,OH
39019,39CS009,214,271,346,331,-15,60,117,27,-188.53646542446035,148.13579426207596,404.00671162384356,0.39705882352941174,257,333,430,398,-32,65,141,81,-423.5556381200075,-59.94595497496789,224.98466226542618,0.9878048780487805,26732,26691,Carroll+Harrison+Tuscarawas,Carroll,39,19,Ohio,OH
39021,39CS010,276,347,435,432,-3,85,156,36,-120.96903008252727,151.79212481546318,371.89070579788466,0.3956043956043956,331,422,544,502,-42,80,171,77,-307.6237326347953,7.75196302313638,243.02404077532537,0.7777777777777778,38737,38700,Champaign+Logan+Madison+Shelby,Champaign,39,21,Ohio,OH
39023,39CS011,1189,1471,1820,1775,-45,304,586,209,-224.98014376437328,84.12955582607937,333.994336629535,0.6129032258064516,1389,1775,2256,2135,-121,360,746,235,-262.6330328463308,92.15194134958976,376.7539970136628,0.5477855477855478,135505,135646,Clark,Clark,39,23,Ohio,OH
39025,39CS012,1270,1588,1979,1865,-114,278,595,147,-150.3167724040317,75.11521653733921,257.89557677819795,0.4447816533919253,1537,1942,2481,2409,-72,467,872,288,-171.8655573463466,85.44350719343437,278.83700964829427,0.5658153241650294,208480,209495,Clermont,Clermont,39,25,Ohio,OH
39027,39CS013,308,390,490,475,-15,85,167,45,-171.6850336482573,114.36138794221968,348.80223322377003,0.4838709677419355,376,476,614,574,-40,98,198,85,-297.75316013012565,30.953947074703184,269.18028590732257,0.7327586206896551,41972,41998,Clinton+Fayette+Highland,Clinton,39,27,Ohio,OH
39029,39CS014,879,1102,1370,1284,-86,182,405,161,-291.781765690102,25.392867688067977,288.2385748499064,0.71875,1039,1341,1710,1625,-85,284,586,251,-331.562917590878,32.559369976190965,330.5762700158419,0.7675840978593272,101603,101353,Columbiana,Columbiana,39,29,Ohio,OH
39031,39CS015,288,361,454,426,-28,65,138,37,-213.86695207792272,91.91519045559228,331.551222714815,0.4625,346,444,573,550,-23,106,204,98,-330.5307271789817,23.21910066959789,289.5558436443972,0.8305084745762712,36555,36608,Coshocton+Holmes,Coshocton,39,31,Ohio,OH
39033,39CS016,384,482,604,584,-20,102,200,75,-272.5167459349087,77.45212779202669,358.5746657038273,0.6302521008403361,454,587,753,722,-31,135,268,100,-313.67151854234294,83.77339297201071,402.2319625413256,0.6535947712418301,41832,41779,Crawford+Richland,Crawford,39,33,Ohio,OH
39035,39CS017,9489,11780,14552,13820,-732,2040,4331,1496,-212.76864043440875,51.90177782190757,270.70573078316914,0.6088727097319662,11321,14158,17977,15985,-1992,1826,4664,1677,-293.2586799293248,11.94870071117248,238.70227119724223,0.5980744840133028,1256604,1251182,Cuyahoga,Cuyahoga,39,35,Ohio,OH
39037,39CS018,426,536,666,607,-59,71,181,98,-364.1733266130006,-62.60859483318061,192.5794000331721,0.9423076923076923,512,649,835,727,-108,78,215,106,-414.41897225547285,-54.223043098846915,211.17938749747336,0.8091603053435115,51750,51639,Darke+Preble,Darke,39,37,Ohio,OH
39039,39CS019,276,348,435,409,-26,61,133,70,-301.8696616755914,-28.28554872545885,197.99884107821194,0.9333333333333333,332,421,552,486,-66,65,154,65,-343.3264555201685,0,233.3833653745877,0.6914893617021277,38182,38156,Defiance+Williams,Defiance,39,39,Ohio,OH
39041,39CS020,846,1053,1309,1241,-68,188,395,89,-87.78795436397672,55.28630713761893,170.91287171180076,0.3991031390134529,1039,1316,1669,1526,-143,210,487,132,-125.07278007278292,35.468739667976976,161.45097460404136,0.46808510638297873,214881,219912,Delaware,Delaware,39,41,Ohio,OH
39043,39CS021,657,819,1021,1025,4,206,368,114,-175.56318903217743,146.8346671905484,405.3913637652097,0.5229357798165137,779,989,1273,1136,-137,147,357,111,-330.94843248487956,48.04090148974058,328.4129404618098,0.5273188896411645,75187,74936,Erie,Erie,39,43,Ohio,OH
39045,39CS022,993,1232,1528,1439,-89,207,446,136,-169.72432849038069,53.48613991485586,233.53103343106082,0.5375494071146245,1192,1515,1940,1816,-124,301,624,221,-214.53214309449405,49.74658390596963,250.62950804126322,0.6251780541284551,159294,160815,Fairfield,Fairfield,39,45,Ohio,OH
39047,39CS013,252,320,398,336,-62,16,84,31,-386.56713832937874,-62.34953844022238,220.50953428358628,0.47692307692307695,304,387,498,441,-57,54,137,65,-421.98744846759325,-38.04804863232398,249.0417728661206,0.7831325301204819,28870,28911,Clinton+Fayette+Highland,Fayette,39,47,Ohio,OH
39049,39CS023,6815,8408,10367,10063,-304,1654,3248,1033,-121.27194191131429,56.37285856236486,200.95132663232698,0.5506398153081158,8073,10160,12855,11859,-996,1698,3786,1056,-155.24745309263864,48.60821549768296,206.5527625708545,0.48697258756819933,1322977,1321793,Franklin,Franklin,39,49,Ohio,OH
39051,39CS024,298,380,471,450,-21,70,152,47,-191.83458968467872,64.88522886393545,296.35623009375723,0.5465116279069767,351,461,592,545,-47,84,194,103,-353.3872903590033,-44.73256839987384,214.24545917834314,0.9626168224299065,42537,42475,Fulton+Henry,Fulton,39,51,Ohio,OH
39053,39CS025,253,323,403,381,-22,58,128,30,-213.07715510127423,114.73385274683997,401.77336649384483,0.43478260869565216,303,389,506,439,-67,50,136,63,-445.7687331809813,-44.57687331809814,250.3162886323972,0.7411764705882353,29285,29163,Gallia+Meigs,Gallia,39,53,Ohio,OH
39055,39CS026,577,726,903,887,-16,160,310,118,-169.2296333265926,53.63355269485597,242.36055988346087,0.6742857142857143,698,884,1141,1095,-46,211,397,109,-162.3028051666306,106.77127460171764,301.52417302965455,0.4678111587982833,95090,95531,Geauga,Geauga,39,55,Ohio,OH
39057,39CS027,1072,1326,1654,1595,-59,269,523,169,-162.60633710058815,71.31856890376673,252.46773391933425,0.5577557755775577,1290,1634,2088,1913,-175,278,623,255,-255.44151533454678,13.958552750521683,218.6146953118938,0.7183098591549296,168259,168356,Greene,Greene,39,57,Ohio,OH
39059,39CS028,326,407,514,458,-56,51,132,38,-293.3668977198287,40.57201776976354,293.52294394202,0.47800632911392404,386,495,641,656,15,161,270,74,-154.03886979418513,227.14206223888317,511.85288852796594,0.4378698224852071,38450,38302,Guernsey+Monroe+Noble,Guernsey,39,59,Ohio,OH
39061,39CS029,5410,6712,8285,7950,-335,1238,2540,802,-164.84376789062554,63.270437181145795,251.92940055599183,0.5586904195743112,6420,8075,10216,9038,-1178,963,2618,928,-254.76939100067435,4.2337576549740525,204.46025360913976,0.5800002265625885,827875,826689,Hamilton,Hamilton,39,61,Ohio,OH
39063,39CS030,527,652,813,766,-47,114,239,96,-229.07152925084586,28.824100150403527,228.9914623059836,0.6906474820143885,614,791,1016,920,-96,129,306,136,-310.7200423130934,-9.373153614271295,227.7006817295476,0.7906976744186046,74937,74681,Hancock,Hancock,39,63,Ohio,OH
39065,39CS031,211,266,337,340,3,74,129,47,-171.5783465919388,103.21966367051938,319.3966951314184,0.6103896103896104,247,323,422,486,64,163,239,80,-52.22585506237181,270.92162313605377,518.9944346823198,0.49079754601226994,30808,30636,Hardin+Wyandot,Hardin,39,65,Ohio,OH
39067,39CS009,128,165,210,198,-12,33,70,17,-238.79777671035475,131.75049749536814,436.423522953407,0.425,149,200,262,288,26,88,139,46,-138.4732262074681,290.0686035268659,642.2947649523459,0.5168539325842697,14573,14479,Carroll+Harrison+Tuscarawas,Harrison,39,67,Ohio,OH
39069,39CS024,196,249,318,315,-3,66,119,50,-231.54630683882843,69.76913200416676,300.87938176796916,0.704225352112676,232,306,394,370,-24,64,138,45,-250.44216804881205,70.77713444857733,337.552487370138,0.5555555555555556,27519,27551,Fulton+Henry,Henry,39,69,Ohio,OH
39071,39CS013,337,422,530,486,-44,64,149,41,-235.58996375205885,63.747872544674756,299.3378362967336,0.4939759036144578,396,510,657,642,-15,132,246,102,-270.13193730563,70.35887350829816,332.1861568916372,0.7083333333333334,43296,43349,Clinton+Fayette+Highland,Highland,39,71,Ohio,OH
39073,39CS005,216,272,349,328,-21,56,112,42,-269.5729755469201,59.905105677093346,299.5255283854667,0.65625,262,334,429,434,5,100,172,68,-224.33733688435203,113.94912349681373,370.51269687010824,0.6476190476190476,28044,28083,Athens+Hocking,Hocking,39,73,Ohio,OH
39075,39CS015,222,283,363,372,9,89,150,75,-179.2796557015703,38.02901787609067,203.86269940004308,0.8152173913043478,268,345,444,418,-26,73,150,77,-232.94291420585566,-9.037552442516224,164.93533207592108,0.875,44177,44260,Coshocton+Holmes,Holmes,39,75,Ohio,OH
39077,39CS032,417,529,661,652,-9,123,235,79,-180.90387733714945,90.40057470567379,320.51112850193437,0.5895522388059702,501,649,816,733,-83,84,232,107,-325.46786004882017,-39.39874095327823,214.20924157423656,0.7867647058823529,58407,58378,Huron,Huron,39,77,Ohio,OH
39079,39CS033,292,367,466,405,-61,38,113,36,-357.1759624770899,7.364452834579174,283.8996567730268,0.5070422535211268,347,450,586,519,-67,69,172,80,-451.8891155308064,-33.81483177441408,282.814956658736,0.8,32589,32530,Jackson+Pike+Vinton,Jackson,39,79,Ohio,OH
39081,39CS034,620,773,973,867,-106,94,247,91,-362.96463340322526,5.527380204110029,287.51589361712325,0.6594202898550725,731,936,1202,1178,-24,242,447,170,-299.29648744994535,111.05048748464863,427.39014002772393,0.6307999449263391,65130,64835,Jefferson,Jefferson,39,81,Ohio,OH
39083,39CS035,415,519,655,642,-13,123,227,73,-164.77932337397306,95.69066398023988,294.822935723119,0.5488721804511278,492,630,808,816,8,186,324,125,-186.07536052101102,96.21845565402705,316.4871516553948,0.6410256410256411,62702,62878,Knox+Morrow,Knox,39,83,Ohio,OH
39085,39CS036,1740,2167,2678,2476,-202,309,736,246,-231.8991350553675,32.588992880856914,253.52167318901536,0.5920586190917516,2092,2648,3384,3088,-296,440,996,359,-282.40330425654355,34.68639913434812,274.49652880169526,0.6232638888888888,231980,232079,Lake,Lake,39,85,Ohio,OH
39087,39CS037,568,710,883,814,-69,104,246,59,-263.71202941575024,92.6750591464956,385.2193291855999,0.42142857142857143,673,859,1095,1088,-7,229,415,137,-250.58568103544715,159.87435960652664,483.27238485407645,0.5557832197755176,58268,57545,Lawrence,Lawrence,39,87,Ohio,OH
39089,39CS038,1196,1478,1834,1618,-216,140,422,156,-250.05647425922507,-11.08376581672858,178.68373983332134,0.6141732283464567,1436,1813,2306,2179,-127,366,743,247,-207.6325044369849,66.05605675177436,275.32608528470655,0.569781611519673,178640,180150,Licking,Licking,39,89,Ohio,OH
39091,39CS010,344,435,544,473,-71,38,129,43,-297.4353538771367,-13.045410257769154,224.51151053620703,0.5119047619047619,405,528,671,624,-47,96,219,98,-315.1650082130785,-3.2580807189498118,262.8185113286182,0.7777777777777778,45993,46039,Champaign+Logan+Madison+Shelby,Logan,39,91,Ohio,OH
39093,39CS039,2224,2756,3426,3103,-323,346,879,314,-244.14075767835115,12.455183462124497,216.54773585456763,0.6079386142473723,2697,3378,4278,4045,-233,667,1348,497,-231.6267982927865,53.922020828173515,270.0224490060241,0.6347381864623244,313123,315270,Lorain,Lorain,39,93,Ohio,OH
39095,39CS040,3205,3951,4908,4860,-48,909,1655,591,-178.21537989595325,88.68240483047202,296.79323692084853,0.6052228929308523,3853,4844,6166,5498,-668,654,1645,602,-295.78602718707475,11.993056253304216,242.8884984892485,0.6093117408906883,430300,429415,Lucas+Ottawa,Lucas,39,95,Ohio,OH
39097,39CS010,283,359,450,395,-55,36,112,45,-272.56698475612353,-24.531028628051118,182.61987978660275,0.6428571428571429,337,438,558,557,-1,119,220,68,-155.85536824968835,115.11403013373071,343.0849525554327,0.53125,44026,44304,Champaign+Logan+Madison+Shelby,Madison,39,97,Ohio,OH
39099,39CS041,2021,2511,3086,3285,199,774,1264,476,-146.07444147308192,157.00697406304207,415.0410866381251,0.6002522068095839,2396,3026,3834,3624,-210,598,1228,459,-294.8201568033719,61.25103026032239,338.9076789439852,0.6392770060695643,227761,226935,Mahoning,Mahoning,39,99,Ohio,OH
39101,39CS042,527,663,827,709,-118,46,182,111,-420.8487483899121,-119.42880875505037,130.45300648628577,0.9061375449820073,632,803,1028,934,-94,131,302,120,-327.7872636922582,16.8449423060726,278.7837951655015,0.6779661016949152,65311,65302,Marion,Marion,39,101,Ohio,OH
39103,39CS043,1077,1324,1644,1593,-51,269,516,182,-153.4466828080635,57.28324996482096,219.9150056120713,0.6006600660066007,1269,1614,2060,2004,-56,390,735,245,-164.49654862781802,78.95615770376915,267.87720632714746,0.5704315064780181,182252,183013,Medina,Medina,39,103,Ohio,OH
39105,39CS025,194,248,316,299,-17,51,105,22,-210.6192848282671,156.61434000050627,448.24104207041455,0.3793103448275862,234,301,390,380,-10,79,146,49,-267.46376914250095,135.99852668262758,439.72856960716257,0.5568181818181818,22220,22059,Gallia+Meigs,Meigs,39,105,Ohio,OH
39107,39CS006,276,349,439,456,17,107,180,75,-164.62933268154416,90.82997665188643,298.1777827275208,0.6756756756756757,326,422,536,460,-76,38,134,37,-266.9336002669336,2.3622442501498546,229.1376922645359,0.43529411764705883,42277,42333,Auglaize+Mercer,Mercer,39,107,Ohio,OH
39109,39CS044,790,986,1228,1096,-132,110,306,130,-289.72147817284275,-22.09927369739457,194.5288567213156,0.7065217391304348,938,1198,1535,1465,-70,266,527,257,-299.63535741479035,8.699681832030892,247.2999030252571,0.8481848184818482,108601,109199,Miami,Miami,39,109,Ohio,OH
39111,39CS028,126,148,172,163,-9,15,37,27,-320.7883839492485,-107.32280656582722,91.42100686011645,1.300078831289387,152,180,214,235,21,55,83,37,-120.0061878190594,135.00696129644183,345.0177899797958,0.6727272727272727,13403,13333,Guernsey+Monroe+Noble,Monroe,39,111,Ohio,OH
39113,39CS045,4366,5404,6655,6341,-314,937,1975,692,-225.17969163330744,54.8617983792366,287.34146808259754,0.6142931442080379,5254,6595,8330,7364,-966,769,2110,886,-345.58867516994485,-21.830188421813816,228.38668493778806,0.687888198757764,535892,535955,Montgomery,Montgomery,39,113,Ohio,OH
39115,39CS046,125,146,169,188,19,42,63,16,22.853862544225372,229.48593086848382,407.61702425146547,0.37665342383920203,148,178,210,267,57,89,119,36,153.38987048599327,387.1268159884592,606.2552023970211,0.4044943820224719,13846,13691,Morgan+Perry,Morgan,39,115,Ohio,OH
39117,39CS035,219,276,348,320,-28,44,101,26,-184.93887396817678,61.64629132272559,256.85954717802326,0.4482758620689655,259,335,432,416,-16,81,157,58,-210.6837791877405,65.48279623402746,281.8607316160312,0.6170212765957447,35039,35124,Knox+Morrow,Morrow,39,117,Ohio,OH
39119,39CS047,692,858,1061,983,-78,125,291,84,-225.31686270079558,57.00704332448391,287.8160480041017,0.4985207100591716,823,1046,1324,1181,-143,135,358,165,-356.71967210031437,-34.722875285559475,223.4417024625752,0.7783018867924528,86305,86398,Muskingum,Muskingum,39,119,Ohio,OH
39121,39CS028,101,121,143,135,-8,14,34,32,-339.64357882045545,-154.89855530249727,15.903447572596107,1.677431412608929,125,150,182,162,-20,12,37,19,-275.3564777905584,-49.422957552151516,127.0876051341039,0.8636363636363636,14152,14163,Guernsey+Monroe+Noble,Noble,39,121,Ohio,OH
39123,39CS040,335,426,534,506,-28,80,171,54,-244.26925058078075,75.96177914402328,348.67946073756565,0.5625,397,514,661,626,-35,112,229,72,-266.77964200938277,100.93017750004674,391.3847994168478,0.5393334081472337,40283,40127,Lucas+Ottawa,Ottawa,39,123,Ohio,OH
39125,39CS048,150,175,201,204,3,29,54,28,-162.3705476255042,5.631966480958729,168.38440202159475,0.9172432314772412,184,216,252,220,-32,4,36,42,-392.6043172778373,-198.8205523014031,-31.546194298489535,1.3125,18792,18861,Paulding+Putnam+Van Wert,Paulding,39,125,Ohio,OH
39127,39CS046,242,308,385,372,-13,64,130,36,-165.60912031878206,94.53731638992657,317.3752764518963,0.5,288,373,480,491,11,118,203,66,-155.2587557794578,146.65677203509185,386.525203988641,0.532258064516129,35542,35457,Morgan+Perry,Perry,39,127,Ohio,OH
39129,39CS049,424,528,660,627,-33,99,203,83,-237.29747383667262,32.71658407054513,245.47661985430884,0.7345132743362832,508,652,825,766,-59,114,258,104,-275.1975080274733,16.883282701071984,260.00255359650856,0.7050928479499908,58686,59230,Pickaway,Pickaway,39,129,Ohio,OH
39131,39CS033,243,309,389,363,-26,54,120,14,-176.7233014735379,176.7233014735379,468.31674890487545,0.20588235294117646,292,378,482,481,-1,104,189,74,-276.9232899409923,108.92316071012362,424.8003267694819,0.6666666666666666,27161,27083,Jackson+Pike+Vinton,Pike,39,131,Ohio,OH
39133,39CS050,1017,1268,1584,1453,-131,184,436,125,-189.81905086357645,44.09226440126019,230.4654492233936,0.5165289256198347,1205,1546,1972,1947,-25,400,742,250,-169.44611786748982,92.73323905111715,303.1853174425395,0.5807208762747531,161933,162293,Portage,Portage,39,133,Ohio,OH
39135,39CS018,331,409,511,486,-25,77,155,70,-278.6233921551165,20.519345029834984,249.31004211249493,0.756778868630201,388,500,645,631,-14,131,243,92,-259.5328429211713,95.39850022550125,369.36342395001765,0.6388888888888888,40937,40881,Darke+Preble,Preble,39,135,Ohio,OH
39137,39CS048,213,270,344,350,6,80,137,81,-262.4271719037694,-5.248543438075388,195.9456216881478,0.9759036144578314,253,331,426,381,-45,50,128,56,-294.37433316056706,-17.47893121190898,209.74717454290777,0.7368421052631579,34295,34327,Paulding+Putnam+Van Wert,Putnam,39,137,Ohio,OH
39139,39CS016,1039,1292,1602,1455,-147,163,416,141,-277.97034558182935,21.226475539049797,265.3309442381224,0.5875101998298582,1242,1598,2006,1784,-222,186,542,281,-402.09926126313593,-75.91301633544896,208.56102382686504,0.9108613878031353,124373,125143,Crawford+Richland,Richland,39,139,Ohio,OH
39141,39CS051,594,746,933,948,15,202,354,102,-135.95774450287982,155.22427513524434,393.13082747820675,0.4845633039945836,707,908,1160,1146,-14,238,439,154,-218.71222665712384,109.22608227823069,370.58849344399704,0.5992217898832685,76921,76905,Ross,Ross,39,141,Ohio,OH
39143,39CS052,467,585,728,633,-95,48,166,87,-371.59090546571684,-79.62662259979645,161.39703888497195,0.7981651376146789,563,711,914,860,-54,149,297,115,-287.7474292682979,57.89001535575223,309.88184690432075,0.6497175141242938,58774,58732,Sandusky,Sandusky,39,143,Ohio,OH
39145,39CS053,713,891,1104,1092,-12,201,379,66,-126.70025750090171,219.2889072130991,508.4253922792594,0.30275229357798167,850,1086,1385,1314,-71,228,464,142,-290.18859420315357,117.16534789423102,438.6888607202603,0.5358490566037736,73875,73401,Scioto,Scioto,39,145,Ohio,OH
39147,39CS054,413,517,646,609,-37,92,196,76,-246.47916658777376,34.89970500357859,261.7477875268394,0.6666666666666666,489,630,800,774,-26,144,285,129,-282.41977848893583,27.313324805506365,284.0585779772662,0.7771084337349398,55015,54918,Seneca,Seneca,39,147,Ohio,OH
39149,39CS010,318,398,509,518,9,120,200,54,-112.09555107807637,163.1613021247556,363.93688916682106,0.432,381,488,627,597,-30,110,216,104,-279.2841672128444,11.458880415297607,233.55281719179283,0.8188976377952756,48173,47998,Champaign+Logan+Madison+Shelby,Shelby,39,149,Ohio,OH
39151,39CS055,3069,3788,4705,4484,-221,696,1415,643,-277.4842522048418,17.015695206359617,247.91546864813,0.7894416725705069,3688,4634,5879,5406,-473,772,1718,796,-339.3461209749911,-6.418652246837519,246.583223816008,0.796000796000796,373773,373910,Stark,Stark,39,151,Ohio,OH
39153,39CS056,3981,4912,6100,5794,-306,882,1813,651,-212.94497964489474,51.49024732378644,258.5299739818711,0.6167694420508402,4712,5949,7538,7035,-504,1086,2323,805,-243.25646698022354,52.23925656969264,282.2778903039904,0.6100796631975556,539520,537910,Summit,Summit,39,153,Ohio,OH
39155,39CS057,1783,2201,2760,2647,-113,446,864,353,-278.39163610624837,55.546925891184515,305.2094530150031,0.7024882577047674,2118,2690,3408,3260,-148,570,1142,435,-289.52762512972635,67.04902546103965,351.18789558148984,0.6541368175404321,200911,201345,Trumbull,Trumbull,39,155,Ohio,OH
39157,39CS009,753,936,1169,1157,-12,222,404,178,-245.561813522459,56.220730990668244,292.1539365618518,0.7447698744769874,889,1148,1455,1374,-81,226,485,266,-374.9644741008037,-42.66483285894209,236.70881319081406,0.9620284623031444,92848,92582,Carroll+Harrison+Tuscarawas,Tuscarawas,39,157,Ohio,OH
39159,39CS058,296,371,465,412,-53,41,116,27,-153.2360364971145,26.799556664079983,170.46432292402295,0.375,357,464,598,493,-105,29,136,56,-248.8608369426957,-41.7344260711353,123.65755872928979,0.6054230949041608,62688,64695,Union,Union,39,159,Ohio,OH
39161,39CS048,217,275,350,342,-8,67,125,56,-266.95923266600767,45.88361811447007,288.02398461855967,0.7619400222139948,254,332,430,402,-28,70,148,66,-327.09298500606445,13.911450717961275,285.1847397182062,0.7764705882352941,28768,28753,Paulding+Putnam+Van Wert,Van Wert,39,161,Ohio,OH
39163,39CS033,115,136,160,163,3,27,48,10,-68.5630025032794,162.47879046850232,355.0136179449874,0.3550212816713967,141,169,201,226,25,57,85,35,-78.6854287700156,173.10794329403433,393.42714385007804,0.6140350877192983,12810,12709,Jackson+Pike+Vinton,Vinton,39,163,Ohio,OH
39165,39CS059,1316,1623,2019,1888,-131,265,572,208,-167.9199072477007,28.2301569477037,180.35108162291752,0.6293509109219079,1606,2019,2568,2351,-217,332,745,291,-206.55561051037617,16.66426609784617,184.70916410161425,0.6651437259020093,242294,246035,Warren,Warren,39,165,Ohio,OH
39167,39CS060,495,625,781,696,-85,71,201,80,-331.92365895542537,-18.104926852114108,243.41068323397857,0.6896551724137931,589,756,971,877,-94,122,288,88,-306.13596557932794,56.34920245553565,336.4131489882725,0.5415435885783534,59652,59451,Washington,Washington,39,167,Ohio,OH
39169,39CS061,819,1018,1269,1153,-116,134,334,156,-279.7435541244283,-22.112082403217673,183.11889636711192,0.8,988,1248,1611,1494,-117,246,506,208,-278.5084392440465,32.55404703560064,255.33509786738864,0.7197231833910035,116678,116729,Wayne,Wayne,39,169,Ohio,OH
39171,39CS019,289,365,464,368,-96,3,79,51,-477.5010077036477,-155.86568085532193,91.0840072498286,0.5698501872659176,343,442,565,517,-48,76,174,87,-367.3724066054946,-31.283100155225384,236.6634533482268,0.8832714904143475,36955,36761,Defiance+Williams,Williams,39,171,Ohio,OH
39173,39CS062,808,1002,1243,1197,-46,194,389,145,-173.5373520316297,44.97433992442759,221.73712441528386,0.6444444444444445,968,1224,1563,1361,-202,137,393,152,-267.3782995188172,-11.326389417628517,182.16609646685848,0.6255144032921811,132075,132434,Wood,Wood,39,173,Ohio,OH
39175,39CS031,169,216,271,274,3,58,105,34,-170.67994075521824,131.9265242552412,390.28263425508845,0.5483870967741935,198,260,337,304,-33,44,106,49,-377.6008958721235,-23.010414129928304,262.54882522248175,0.8032786885245902,21830,21729,Hardin+Wyandot,Wyandot,39,175,Ohio,OH
40001,40CS001,146,189,243,241,-2,52,95,28,-181.59310114357413,145.2744809148593,405.5579258873156,0.5,177,228,293,345,52,117,168,61,-46.61549407165521,288.44946607875056,551.4020597094685,0.5191583369549471,19825,19414,Adair+Cherokee+Sequoyah,Adair,40,1,Oklahoma,OK
40003,40CS022,34,46,59,66,7,20,32,6,16.934426339754225,293.6003354551097,552.9746252507556,0.2887152050982891,40,55,72,53,-19,-2,13,2,-367.7476550614555,-70.04717239265818,192.62972407981,-0.1111111111111111,5706,5710,Major and Nearby Counties,Alfalfa,40,3,Oklahoma,OK
40005,40CS002,114,151,191,180,-11,29,66,20,-263.76815869036204,76.45453875082958,390.7676425042401,0.5555555555555556,139,183,242,195,-47,12,56,33,-559.3574381429333,-146.83132751252,160.81526346609334,0.8149390243902439,14126,14302,Atoka+Bryan+Coal,Atoka,40,5,Oklahoma,OK
40007,40CS027,36,49,62,56,-6,7,20,10,-372.9907276925139,-59.54773176439981,233.3896476076696,0.9274953670302198,45,60,79,63,-16,3,18,4,-401.23044001604916,-20.06152200080246,280.8613080112344,0.26666666666666666,5052,4985,Oklahoma Panhandle,Beaver,40,7,Oklahoma,OK
40009,40CS003,157,203,259,249,-10,46,92,49,-318.81719421355797,-16.211043773570747,232.35829408784736,0.9423076923076923,187,246,318,301,-17,56,114,46,-285.50943396226415,43.01886792452831,307.9245283018868,0.696969696969697,22207,22083,Beckham+Custer+Roger Mills+Washita,Beckham,40,9,Oklahoma,OK
40011,40CS022,92,110,130,135,5,25,43,17,-162.1909003079389,106.74600010421665,353.2714921486924,0.6626649607794193,109,133,159,162,3,29,53,21,-210.28156468512373,93.19958545601052,372.7983418240421,0.6887096774193548,8804,8584,Major and Nearby Counties,Blaine,40,11,Oklahoma,OK
40013,40CS002,343,433,544,524,-20,91,181,68,-226.67481426687678,59.17730678930949,290.74068118225966,0.6570201643017177,411,531,679,716,37,185,305,110,-155.46991251048613,159.62003337832252,415.01208678363855,0.5804789752158173,46640,46987,Atoka+Bryan+Coal,Bryan,40,13,Oklahoma,OK
40015,40CS004,229,297,377,413,36,116,184,81,-199.19813528412246,154.93188299876192,455.9423985392136,0.6923076923076923,274,353,458,438,-20,85,164,73,-351.9361055997428,45.38670894354556,344.37165410915173,0.7525773195876289,27109,26439,Caddo+Grady,Caddo,40,15,Oklahoma,OK
40017,40CS005,780,976,1219,1086,-133,110,306,157,-224.37092658869923,-36.737742202561925,115.27916790088112,0.8579234972677595,959,1230,1567,1358,-209,128,399,186,-245.63438839985562,-36.374159527633346,132.50142556134466,0.7733921161825726,155154,160828,Canadian,Canadian,40,17,Oklahoma,OK
40019,40CS006,388,487,612,590,-22,103,202,51,-182.31963044536081,129.78262536836087,376.99356849790206,0.4396551724137931,464,592,752,817,65,225,353,153,-182.38719973470953,149.22589069203508,414.619992124189,0.6740088105726872,48080,48249,Carter+Johnston+Love+Marshall,Carter,40,19,Oklahoma,OK
40021,40CS001,324,409,512,514,2,105,190,52,-126.73203257979658,134.20175278180258,349.43097894129727,0.4663770913770914,386,497,646,636,-10,139,250,72,-172.45957321513544,140.91209030992775,374.36346380846476,0.48322147651006714,47391,47547,Adair+Cherokee+Sequoyah,Cherokee,40,21,Oklahoma,OK
40023,40CS007,129,170,220,232,12,62,103,22,-84.07715830882299,336.30863323529195,681.0249823014661,0.34375,156,205,267,295,28,90,139,54,-181.93507192120813,251.91009958321123,594.7877351270265,0.5869565217391305,14273,14291,Choctaw+McCurtain+Pushmataha,Choctaw,40,23,Oklahoma,OK
40025,40CS027,15,23,32,22,-10,-1,7,7,-904.0792344075693,-424.92756599879925,10.66485982735552,-0.7574349875973301,17,27,39,31,-8,4,14,4,-532.3573448677425,0,443.6311207231187,0.5,2265,2254,Oklahoma Panhandle,Cimarron,40,25,Oklahoma,OK
40027,40CS008,1464,1821,2267,2071,-196,250,607,238,-176.83675112270228,4.889495422747528,150.41310294227077,0.6878612716763006,1774,2237,2852,2571,-281,334,797,309,-198.441739686036,8.407123355619216,164.12386214839833,0.6666674424666716,294509,297367,Cleveland,Cleveland,40,27,Oklahoma,OK
40029,40CS002,58,72,90,93,3,21,35,10,-149.40702668094212,240.58093002842017,556.2854664121895,0.4657030545590679,70,89,112,93,-19,4,23,1,-379.0436255522784,56.85654383284176,416.9479881075062,0.05555555555555555,5313,5276,Atoka+Bryan+Coal,Coal,40,29,Oklahoma,OK
40031,40CS009,693,862,1088,1077,-11,216,384,92,-101.94642966687842,122.23673848407266,289.0131792497912,0.4,820,1056,1343,1431,88,375,611,224,-111.70637571794275,123.84480714691159,317.4035785818198,0.5833333333333334,121240,121927,Comanche,Comanche,40,31,Oklahoma,OK
40033,40CS010,49,62,78,84,6,22,35,13,-153.54985244956515,184.0742412232611,469.27775193109494,0.5819492956088606,58,75,94,107,13,32,49,15,-36.435264781900784,309.69975064615664,619.3995012923133,0.46875,5552,5489,Cotton+Jefferson+Stephens,Cotton,40,33,Oklahoma,OK
40035,40CS011,143,167,195,196,1,29,53,19,-151.5088072916997,85.75866647387865,288.1338646856953,0.6179312186895897,172,204,240,225,-15,21,53,27,-297.46051934599996,-42.494359906571425,184.1422262618095,0.9642857142857143,14138,14120,Craig+Mayes,Craig,40,35,Oklahoma,OK
40037,40CS012,580,722,898,801,-97,79,221,100,-329.59782089461214,-35.12587789285387,202.72649526732778,0.7692307692307693,685,878,1115,1072,-43,194,387,188,-320.9379732325969,9.028767911758841,276.41920222153993,0.8281938325991189,71742,71992,Creek,Creek,40,37,Oklahoma,OK
40039,40CS003,201,255,322,341,19,86,140,72,-223.62441215602072,59.014924979911214,286.64392133099733,0.8181818181818182,236,305,397,333,-64,28,97,55,-422.5039966194951,-95.74156868423307,149.1086282656295,0.8461538461538461,28467,28201,Beckham+Custer+Roger Mills+Washita,Custer,40,39,Oklahoma,OK
40041,40CS013,355,449,566,612,46,163,257,88,-123.39854025321387,220.35453616645336,496.5322214950749,0.5365853658536586,428,546,706,751,45,205,323,118,-178.55178735105403,212.64894592117324,501.1915673693857,0.5645933014354066,40843,40912,Delaware+Ottawa,Delaware,40,41,Oklahoma,OK
40043,40CS022,41,53,67,61,-6,8,20,13,-516.1577553526348,-144.30386021358115,182.84032905831364,1.1982867497750864,48,64,82,85,3,21,37,10,-159.35279408925444,248.63556524564535,610.2872965120387,0.45454545454545453,4524,4424,Major and Nearby Counties,Dewey,40,43,Oklahoma,OK
40045,40CS027,30,42,54,44,-10,2,14,4,-454.6515576631548,-61.51544094525171,305.41160132479143,0.3599070127622273,37,51,68,50,-18,-1,13,6,-638.3792260760181,-186.19394093883858,186.19394093883858,-0.1967741935483871,3764,3760,Oklahoma Panhandle,Ellis,40,45,Oklahoma,OK
40047,40CS014,472,591,749,709,-40,118,237,128,-323.249815105435,-19.241060422942557,209.8237639121885,0.920863309352518,557,713,918,862,-56,149,305,92,-238.7611344109514,91.89321175843506,343.4710309672734,0.5257142857142857,62367,62029,Garfield,Garfield,40,47,Oklahoma,OK
40049,40CS015,222,284,362,361,-1,77,139,47,-222.00078528923615,138.7504908057726,425.5015051377026,0.573170731707317,270,348,449,454,5,106,184,72,-260.1036244305384,131.89445534136178,434.66981532351707,0.6486486486486487,25946,25778,Garvin+McClain+Murray,Garvin,40,49,Oklahoma,OK
40051,40CS004,373,473,595,608,13,135,235,92,-172.41603896900563,93.78734567573993,311.89745189839095,0.6571428571428571,449,581,754,750,-4,169,301,114,-212.97532622187265,99.26816052714402,337.5117457922897,0.6333333333333333,55018,55405,Caddo+Grady,Grady,40,51,Oklahoma,OK
40053,40CS016,40,53,67,66,-1,13,26,3,-102.9981041972423,297.5261396168941,650.929884158779,0.21120035794045527,48,65,85,70,-15,5,22,2,-410.98581192362514,72.52690798652209,483.5127199101472,0.14285714285714285,4187,4136,Grant+Kay,Grant,40,53,Oklahoma,OK
40055,40CS031,40,53,67,73,6,20,33,19,-291.73768092353055,12.181970260163634,298.2239949036405,0.9713591943884768,49,64,82,97,15,33,48,3,218.69293006762015,546.7323251690505,821.0097082955232,0.09090909090909091,5519,5487,Southwest Oklahoma,Greer,40,55,Oklahoma,OK
40057,40CS031,17,25,35,39,4,14,22,6,-113.53826732833204,362.61942171887955,759.4174959248894,0.44400583516993924,21,31,43,45,2,14,24,5,-125.78076001134079,371.1563410170715,783.5522754804842,0.3333333333333333,2486,2425,Southwest Oklahoma,Harmon,40,57,Oklahoma,OK
40059,40CS027,21,30,40,51,11,21,30,6,170.76291610983176,528.1005048473545,885.4380935848769,0.2915390528494878,24,35,49,38,-11,3,14,6,-532.7587895406915,-94.01625697776909,250.71001860738423,0.6,3313,3191,Oklahoma Panhandle,Harper,40,59,Oklahoma,OK
40061,40CS017,110,132,154,152,-2,20,42,13,-150.96912390192708,76.35358234863085,295.2569291084273,0.5474945376657062,132,159,188,197,9,38,65,34,-215.62373657966847,34.49979785274696,267.37343335878893,0.8717948717948718,11718,11594,Haskell+Latimer+Pittsburg,Haskell,40,61,Oklahoma,OK
40063,40CS018,135,158,182,183,1,25,48,26,-222.35140547195573,-7.679236660260456,199.5904435717215,0.9704601743913177,161,192,225,229,4,37,68,29,-186.64173962544112,59.725356680141154,291.1611138156881,0.7435897435897436,13328,13395,Hughes+Okfuskee+Pontotoc+Seminole,Hughes,40,63,Oklahoma,OK
40065,40CS031,166,214,272,281,9,67,115,55,-223.5538103538758,58.318385309706734,291.59192654853365,0.7857142857142857,197,260,331,287,-44,26,90,35,-318.93043918538166,-34.31530041868031,222.04017917969608,0.6363636363636364,24692,24770,Southwest Oklahoma,Jackson,40,65,Oklahoma,OK
40067,40CS010,49,62,78,88,10,26,39,1,196.4379640621364,541.3829718278369,831.8629783673741,0.03919022726508537,58,75,94,97,3,22,39,12,-166.0006148170919,184.44512757454658,498.0018444512757,0.5217391304347826,5434,5422,Cotton+Jefferson+Stephens,Jefferson,40,67,Oklahoma,OK
40069,40CS006,90,109,128,125,-3,16,35,19,-257.99186163196333,-38.78792149714808,180.89254894230774,1.0030306624890537,109,132,158,177,19,45,68,34,-146.26590672106417,106.9053138825054,330.43460654592576,0.7555555555555555,10352,10289,Carter+Johnston+Love+Marshall,Johnston,40,69,Oklahoma,OK
40071,40CS016,398,496,616,606,-10,110,208,102,-308.40247593952034,23.405545048981455,292.0185944052332,0.8395203901910311,478,609,774,681,-93,72,203,90,-418.95338876603523,-41.18602401850701,258.6711119606787,0.7258064516129032,43579,43704,Grant+Kay,Kay,40,71,Oklahoma,OK
40073,40CS022,113,133,155,152,-3,19,39,33,-279.56405798299977,-111.53209610805749,43.57433023804331,1.5508919722800527,135,163,194,173,-21,10,38,19,-263.5515018075981,-59.22505658597709,125.03067501484054,0.8636363636363636,15266,15196,Major and Nearby Counties,Kingfisher,40,73,Oklahoma,OK
40075,40CS031,95,115,136,160,24,45,65,27,-37.41962511572767,252.28461441838203,530.4006843711271,0.6013505477808395,115,139,167,140,-27,1,25,20,-558.1132999685814,-225.62027020006482,59.373755315806534,0.6666666666666666,8514,8421,Southwest Oklahoma,Kiowa,40,75,Oklahoma,OK
40077,40CS017,101,121,144,100,-44,-21,-1,10,-677.5136132666303,-388.0264183659222,-139.894537022458,-0.46129148113196367,122,150,179,168,-11,18,46,27,-402.88557961186916,-95.4202688554427,201.44278980593458,1.125,9542,9432,Haskell+Latimer+Pittsburg,Latimer,40,77,Oklahoma,OK
40079,40CS019,417,523,649,630,-19,107,213,59,-193.59269861653104,118.98142808698451,381.85602076666584,0.47580645161290325,500,643,821,798,-23,155,298,104,-262.2575053787311,105.31600609697075,400.71707810033666,0.611764705882353,48411,48426,Le Flore,Le Flore,40,79,Oklahoma,OK
40081,40CS020,252,317,401,382,-19,65,130,50,-245.54522977235908,53.3793977765998,284.69012147519896,0.6756756756756757,298,388,494,485,-9,98,187,69,-231.0778203780735,84.37819193818189,349.35532100720917,0.6448598130841121,33721,33776,Lincoln+Logan,Lincoln,40,81,Oklahoma,OK
40083,40CS020,270,342,430,366,-64,24,96,31,-230.04692272512136,-16.933001672721865,157.35596554436523,0.45588235294117646,327,424,548,509,-39,85,182,84,-242.52711279770057,1.9717651446967528,193.23298418028176,0.8235294117647058,49607,50716,Lincoln+Logan,Logan,40,83,Oklahoma,OK
40085,40CS006,81,99,119,119,-0,20,38,17,-203.3779915536547,39.4890444001444,243.49735460133567,0.7732106560601787,98,121,145,148,3,27,50,25,-215.57311623596274,19.597556021451158,244.9694502681395,0.8620689655172413,10156,10205,Carter+Johnston+Love+Marshall,Love,40,85,Oklahoma,OK
40087,40CS015,265,336,424,389,-35,54,124,62,-278.2831717256396,-24.3730753185774,177.78007879432926,0.8857142857142857,327,421,545,438,-107,17,111,51,-365.0778750965767,-78.56106172964309,138.8682297044571,0.5828761755485894,41849,43278,Garvin+McClain+Murray,McClain,40,87,Oklahoma,OK
40089,40CS007,261,330,413,476,63,146,215,84,-81.26803007067251,239.364269091767,505.753536306798,0.5753424657534246,310,398,511,602,91,204,292,114,-74.50669682928113,291.54794411457834,576.779016106674,0.5560975609756098,31082,30870,Choctaw+McCurtain+Pushmataha,McCurtain,40,89,Oklahoma,OK
40091,40CS021,191,247,311,306,-5,59,115,34,-245.3885865468853,157.30037599159314,509.65321821276183,0.5230769230769231,235,307,395,416,21,109,181,67,-239.82631471019357,218.734098107017,593.7068377190461,0.5982142857142857,19072,19201,McIntosh+Okmulgee,McIntosh,40,91,Oklahoma,OK
40093,40CS022,74,92,109,99,-10,7,25,20,-471.45790966782454,-203.22508714902716,77.78072691828437,1.3209469315932265,91,115,140,120,-20,5,29,14,-442.7107351927908,-117.18813578632698,195.3135596438783,0.7,7724,7680,Major and Nearby Counties,Major,40,93,Oklahoma,OK
40095,40CS006,124,160,204,220,16,60,96,19,-23.073718393812825,311.49519831647314,592.2254387745292,0.31666666666666665,147,195,255,267,12,72,120,34,-141.41316749425508,244.25910749007696,552.7969274775426,0.4563963963963964,15602,15557,Carter+Johnston+Love+Marshall,Marshall,40,95,Oklahoma,OK
40097,40CS011,315,401,503,470,-33,69,155,53,-262.2305532497091,48.75873157461181,310.8369137881503,0.6091954022988506,380,485,631,652,21,167,272,86,-166.17517686448133,206.9206660418599,475.2788878652843,0.5,39378,39145,Craig+Mayes,Mayes,40,97,Oklahoma,OK
40099,40CS015,128,162,209,183,-26,21,55,16,-363.00287647368634,43.21462815162933,337.0740995827087,0.47058823529411764,151,195,258,242,-16,47,91,42,-422.12454190238066,36.39004671572247,356.62245781408024,0.7777777777777778,13884,13740,Garvin+McClain+Murray,Murray,40,99,Oklahoma,OK
40101,40CS023,595,740,928,896,-32,156,301,108,-252.85583799416088,86.69343016942658,348.579833806236,0.6101694915254238,693,882,1128,1150,22,268,457,185,-246.41697001611914,126.23200611255183,411.27445823855953,0.6607142857142857,66441,66148,Muskogee,Muskogee,40,101,Oklahoma,OK
40103,40CS024,104,126,149,123,-26,-3,19,12,-414.63095532660975,-162.18222176406329,72.23445940115846,-0.5328447642676073,128,156,188,178,-10,22,50,23,-301.9713927858577,-9.150648266238111,247.06750318842901,0.8518518518518519,10943,10928,Noble+Osage+Pawnee,Noble,40,103,Oklahoma,OK
40105,40CS025,87,106,127,120,-7,14,33,14,-262.6370233925694,-0.7315268452221276,240.22152997833757,0.8124800078898059,104,129,155,164,9,35,60,21,-129.00480408515213,150.50560476601083,419.2656132767445,0.5833333333333334,9417,9302,Nowata+Washington,Nowata,40,105,Oklahoma,OK
40107,40CS018,138,160,183,174,-9,14,36,28,-395.18197779380966,-151.54827373566408,83.38422660611917,1.4406467979699809,167,197,230,191,-39,-6,24,30,-615.9075989831574,-321.34309512164737,-53.55718252027456,-1.0344827586206897,11338,11203,Hughes+Okfuskee+Pontotoc+Seminole,Okfuskee,40,107,Oklahoma,OK
40109,40CS026,4979,6183,7638,7521,-117,1338,2542,864,-147.68489191522588,71.32573107933881,252.56682137155312,0.5936105131981421,5952,7508,9481,8951,-530,1444,2999,1058,-198.8505647848386,48.284764880672256,243.12725579733572,0.6115608979788493,797468,798388,Oklahoma (county),Oklahoma (county),40,109,Oklahoma,OK
40111,40CS021,334,419,523,538,15,119,204,57,-136.5646168366996,201.35567761891497,477.57019990099093,0.4523809523809524,396,511,660,670,10,159,274,103,-252.9938052957139,152.09504129425636,464.70467081155806,0.6058823529411764,36950,36819,McIntosh+Okmulgee,Okmulgee,40,111,Oklahoma,OK
40113,40CS024,307,382,484,442,-42,60,135,43,-222.2591226470308,44.42569176954172,240.42139075281403,0.5443037974683544,364,468,607,616,9,148,252,99,-196.64618117212962,107.06292086038168,334.4077558710492,0.6449579831932774,45919,45767,Noble+Osage+Pawnee,Osage,40,113,Oklahoma,OK
40115,40CS013,285,357,446,408,-38,51,123,53,-359.63345052158377,-7.904031879595247,276.6411157858337,0.7464788732394366,336,434,562,566,4,132,230,74,-231.02879408658632,191.28722422586733,514.826477614791,0.5323741007194245,30364,30321,Delaware+Ottawa,Ottawa,40,115,Oklahoma,OK
40117,40CS024,133,171,221,211,-10,40,78,26,-275.7821983632205,107.09988285950313,397.7995649067259,0.5652173913043478,159,211,271,258,-13,47,99,31,-280.0359061190232,101.83123858873572,433.1009866227163,0.543859649122807,15686,15712,Noble+Osage+Pawnee,Pawnee,40,117,Oklahoma,OK
40119,40CS028,406,514,646,568,-78,54,162,55,-195.47654296794266,-0.7348742216839949,157.2630834403749,0.5392156862745098,484,630,805,764,-41,134,280,82,-150.1871618252429,64.07822832852705,241.66646112473055,0.5189873417721519,81647,81931,Payne,Payne,40,119,Oklahoma,OK
40121,40CS017,403,504,634,586,-48,82,183,52,-274.5409065950826,80.98956744554938,359.7858580928558,0.5,478,616,785,810,25,194,332,136,-254.4292668118348,132.88516411604158,449.1747659474129,0.6699507389162561,43709,43647,Haskell+Latimer+Pittsburg,Pittsburg,40,121,Oklahoma,OK
40123,40CS018,288,364,458,429,-29,65,141,43,-226.61663527409888,69.243971889308,308.6077928975749,0.5375,344,443,574,599,25,156,255,79,-141.6758863753275,201.8324375744721,461.3312858845077,0.49375,38126,38150,Hughes+Okfuskee+Pontotoc+Seminole,Pontotoc,40,123,Oklahoma,OK
40125,40CS029,580,725,912,850,-62,125,270,79,-233.3352097078255,76.09655899723484,315.9661471406925,0.5163398692810458,700,882,1131,1142,11,260,442,146,-185.09705884201225,155.61863835976584,405.9795490601467,0.5377550466681138,72539,72935,Pottawatomie,Pottawatomie,40,125,Oklahoma,OK
40127,40CS007,105,125,146,159,13,34,54,10,38.5424141062828,266.22491816952146,484.80012207023043,0.2938313261432465,125,150,180,253,73,103,128,45,258.962531358744,536.4223863859697,767.6389322419913,0.4368932038834951,10833,10812,Choctaw+McCurtain+Pushmataha,Pushmataha,40,127,Oklahoma,OK
40129,40CS003,21,30,40,47,7,17,26,11,-149.18885855179153,222.89642256097846,537.7378142717836,0.6320900518938897,24,35,50,52,2,17,28,9,-207.84325768510266,235.85050517458467,560.1449497896386,0.5294117647058824,3447,3392,Beckham+Custer+Roger Mills+Washita,Roger Mills,40,129,Oklahoma,OK
40131,40CS030,622,777,964,929,-35,152,307,114,-188.2077794459808,47.967106766916636,243.68552529876987,0.6627906976744186,747,958,1223,1125,-98,167,378,167,-274.7846363106418,0,218.7706457672128,0.784037558685446,95065,96494,Rogers,Rogers,40,131,Oklahoma,OK
40133,40CS018,217,278,360,353,-7,75,136,41,-243.98388532842017,172.64208327089045,482.38229149219393,0.5157436708860759,263,339,433,428,-5,89,165,62,-284.6119085287181,114.60882222632944,437.211432937479,0.6391752577319587,23633,23558,Hughes+Okfuskee+Pontotoc+Seminole,Seminole,40,133,Oklahoma,OK
40135,40CS001,325,416,520,560,40,144,235,54,-42.39941574614611,272.5676726537964,548.1638750037462,0.3724137931034483,386,500,648,693,45,193,307,108,-159.61043231520105,215.34740867923952,504.1662862019843,0.5482233502538071,39623,39471,Adair+Cherokee+Sequoyah,Sequoyah,40,135,Oklahoma,OK
40137,40CS010,381,482,600,541,-59,59,160,56,-322.07484694242055,8.398301093674592,291.1411045807192,0.6153846153846154,461,594,760,698,-62,104,237,110,-399.31126545299776,-13.929462748360388,294.84029484029486,0.8270676691729323,42866,43074,Cotton+Jefferson+Stephens,Stephens,40,137,Oklahoma,OK
40139,40CS027,146,171,199,159,-40,-12,13,38,-443.71627303674586,-286.95912607250165,-139.56061474791372,-1.6743591429836626,182,214,251,162,-89,-52,-20,25,-544.7779173793315,-367.96403191410985,-214.80497707193837,-0.4716981132075472,21084,20926,Oklahoma Panhandle,Texas,40,139,Oklahoma,OK
40141,40CS031,62,76,92,106,14,30,44,18,-70.53283382647408,211.53489813832584,450.69457112593653,0.5928432319383261,75,94,116,123,7,29,48,18,-155.84047602181766,155.84047602181766,425.01948005950277,0.6206896551724138,7013,7058,Southwest Oklahoma,Tillman,40,141,Oklahoma,OK
40143,40CS032,4176,5154,6339,5987,-352,832,1811,621,-174.83892736707386,38.00455615430229,213.84076620060253,0.6037932142823381,4983,6301,7980,7801,-179,1500,2818,1169,-200.50140842399983,49.221958160901835,245.23985589441466,0.7012600004030389,667815,672464,Tulsa,Tulsa,40,143,Oklahoma,OK
40145,40CS033,434,549,682,648,-34,99,214,64,-143.9969143518353,51.42746941136975,220.4769081478865,0.5378151260504201,537,684,878,907,29,224,370,169,-167.34363642204363,65.14448703572413,240.37718060337826,0.7300250037319003,81668,83660,Wagoner,Wagoner,40,145,Oklahoma,OK
40147,40CS025,441,555,687,598,-89,43,157,70,-363.7069582585476,-61.74214318126869,198.9469058063102,0.6862745098039216,528,679,865,786,-79,107,258,135,-405.718770378264,-53.08469892799716,233.19349886227326,0.9440559440559441,52476,52746,Nowata+Washington,Washington,40,147,Oklahoma,OK
40149,40CS003,103,123,146,138,-8,15,35,20,-302.6993972324099,-58.54292377033376,167.52788499084775,1.0644988286867125,126,153,182,163,-19,10,37,27,-421.505967516551,-155.77394451698623,92.0898907291591,1.173913043478261,10910,10913,Beckham+Custer+Roger Mills+Washita,Washita,40,149,Oklahoma,OK
40151,40CS022,72,89,105,93,-12,4,21,3,-212.18560733862807,16.820677663275895,245.82696266518008,0.21316573557576063,87,109,132,100,-32,-9,13,21,-617.4577439492053,-349.50438336747476,-93.20116889799326,-1.1666666666666667,8616,8584,Major and Nearby Counties,Woods,40,151,Oklahoma,OK
40153,40CS027,146,169,196,215,19,46,69,28,-51.42833699447647,104.10314379757318,244.83365683874135,0.6026798995921988,175,209,246,251,5,42,76,34,-143.34260117392648,39.54278653073834,207.59962928637626,0.7727272727272727,20330,20231,Oklahoma Panhandle,Woodward,40,153,Oklahoma,OK
41001,41CS001,147,188,244,206,-38,18,59,6,-317.6337886953252,86.62739691690686,382.6043363830054,0.15789473684210525,175,232,302,274,-28,42,99,31,-350.6903597300477,65.38294842424618,404.4826945699954,0.5535714285714286,16623,16824,Baker+Harney+Lake+Malheur,Baker,41,1,Oregon,OR
41003,41CS002,405,508,640,504,-136,-4,99,10,-184.5062249130355,-17.692377731386966,112.47297272096002,-0.06060606060606061,486,624,792,741,-51,116,255,23,-77.27359432145103,97.50446786849758,242.04050259121155,0.15488391075639396,94956,95893,Benton,Benton,41,3,Oregon,OR
41005,41CS003,2324,2878,3566,3188,-378,310,864,116,-140.61422964251415,55.21538417295364,212.8923059864398,0.21948931660651888,2748,3467,4398,4005,-393,538,1257,302,-164.61055517303328,55.86036526110554,226.08062660654642,0.41341566253771345,421622,422482,Clackamas,Clackamas,41,5,Oregon,OR
41007,41CS004,277,351,437,348,-89,-3,71,2,-266.2564539957658,-14.621441735077752,201.775895944073,-0.017094017094017096,329,428,542,542,-0,114,213,29,-69.65616012924154,203.81320519743656,441.31553431280224,0.23770491803278687,41036,41705,Clatsop+Lincoln+Tillamook,Clatsop,41,7,Oregon,OR
41009,41CS005,320,394,502,447,-55,53,127,22,-175.53029919505894,70.62218397205487,239.31807826659227,0.2857142857142857,377,488,622,629,7,141,252,58,-96.49232781452658,156.5760158085182,366.0671791282283,0.3815789473684211,52675,53009,Columbia+Washington,Columbia,41,9,Oregon,OR
41011,41CS006,624,788,993,777,-216,-12,153,10,-418.35701067487645,-39.77305208715385,264.5370441145582,-0.042735042735042736,760,959,1214,1139,-75,180,379,98,-266.3017830395798,126.18749615282024,432.4999487042698,0.43555555555555553,64868,64983,Coos+Curry,Coos,41,11,Oregon,OR
41013,41CS018,184,238,305,211,-94,-28,27,4,-471.96188658400735,-151.62467544514257,110.7100804837549,-0.08333333333333333,223,297,390,321,-69,24,98,46,-448.8680718188915,-85.8704137392662,202.96643247462922,0.7301587301587301,24930,25620,Umatilla and Nearby Counties,Crook,41,13,Oregon,OR
41015,41CS006,263,331,416,393,-23,62,130,6,-148.68445605523416,286.6206381787647,634.6599845386933,0.0821917808219178,309,405,526,512,-14,107,203,36,-211.56752301140267,300.12575691927253,706.3523095945128,0.3050847457627119,23446,23657,Coos+Curry,Curry,41,15,Oregon,OR
41017,41CS007,1054,1297,1624,1333,-291,36,279,24,-189.4012378969443,7.2129954134031475,153.2761525348169,0.09142890314341276,1259,1588,2033,1824,-209,236,565,167,-184.43013437256886,33.82240337995283,195.11605312159742,0.48830409356725146,199640,204007,Deschutes,Deschutes,41,17,Oregon,OR
41019,41CS008,1029,1282,1590,1421,-169,139,392,35,-220.010665005003,112.1622998064721,385.0186637587552,0.15418502202643172,1244,1572,2001,2054,53,482,810,244,-170.86851270163208,213.19456070802647,505.9906963890079,0.4855764661153883,111267,111870,Douglas,Douglas,41,19,Oregon,OR
41021,41CS018,10,17,25,14,-11,-3,4,3,-869.3990822371826,-375.9957380737677,68.06727167330548,-0.4577524015087216,12,21,31,37,6,16,25,8,-99.67087845344021,398.68351381376084,847.2024668542417,0.5,2000,2007,Umatilla and Nearby Counties,Gilliam,41,21,Oregon,OR
41023,41CS018,66,81,99,85,-14,4,19,3,-276.8731611409459,16.923151821541147,270.40787765661673,0.20986269412620412,81,101,126,115,-11,14,34,14,-344.1225305623823,0,275.2980244499058,0.7368421052631579,7220,7265,Umatilla and Nearby Counties,Grant,41,23,Oregon,OR
41025,41CS001,59,74,90,78,-12,4,19,4,-263.5881234472197,0.10358293692767277,237.42611868266013,0.27221226529168674,71,90,114,124,10,34,53,30,-265.1152028032131,52.89081352682556,304.12217777924695,0.8823529411764706,7483,7563,Baker+Harney+Lake+Malheur,Harney,41,25,Oregon,OR
41027,41CS009,125,166,213,156,-57,-10,31,12,-346.9085995695065,-110.60853899317598,95.52555640319746,-0.32432432432432434,152,202,266,200,-66,-2,48,17,-345.460501344093,-79.03370891677022,128.94973560104614,-0.21384493670886076,23868,24040,Hood River+Jefferson+Sherman+Wasco,Hood River,41,27,Oregon,OR
41029,41CS010,1620,2011,2505,2242,-263,231,622,68,-178.1278186577032,87.6920399915603,298.15293597130494,0.18707050525232344,1910,2413,3073,2929,-144,516,1019,292,-194.93982034957727,100.14108418370672,325.1008768678193,0.4854533695225566,223053,223684,Jackson,Jackson,41,29,Oregon,OR
41031,41CS009,142,182,234,272,38,90,130,19,92.46118437938634,346.42449028688276,541.5932172090703,0.2111111111111111,172,226,294,327,33,101,155,37,-16.007817150708597,256.12507441133755,472.23060594590356,0.3627450980392157,24594,24988,Hood River+Jefferson+Sherman+Wasco,Jefferson,41,31,Oregon,OR
41033,41CS011,854,1049,1294,1112,-182,63,258,25,-282.5317469010089,51.77818366162691,317.5501500616355,0.131234499862221,1008,1280,1626,1583,-43,302,575,224,-302.39770922836254,88.89054549495023,397.5162547261437,0.6666666666666666,88068,88311,Josephine,Josephine,41,33,Oregon,OR
41035,41CS012,578,717,903,779,-124,62,201,25,-257.7105780963659,63.97377651503212,304.3076936931258,0.18248175182481752,697,886,1126,1074,-52,188,377,150,-288.36376221585544,54.233224272222245,323.9721555209066,0.6944444444444444,69403,70068,Klamath,Klamath,41,35,Oregon,OR
41037,41CS001,71,88,109,98,-11,10,27,7,-258.6037333570771,44.71296925974609,299.4989994578776,0.467826748555261,88,110,136,144,8,34,56,16,-96.881867196153,217.98420119134423,484.4093359807649,0.47058823529411764,8132,8257,Baker+Harney+Lake+Malheur,Lake,41,37,Oregon,OR
41039,41CS013,2543,3156,3924,3372,-552,216,829,76,-196.86123918868464,43.72604548494787,236.04228353003577,0.14009228490074954,3030,3833,4904,4528,-376,695,1498,233,-159.0097159373311,120.5785617776725,330.1555858198176,0.2734741784037559,382838,383153,Lane,Lane,41,39,Oregon,OR
41041,41CS004,429,542,674,592,-82,50,163,14,-228.290500652925,84.41992472061291,354.44478252415064,0.1414141414141414,511,662,847,729,-118,66,218,34,-299.47766096432196,63.96992429405499,362.3650173087851,0.2463768115942029,50462,50805,Clatsop+Lincoln+Tillamook,Lincoln,41,41,Oregon,OR
41043,41CS014,909,1129,1404,1247,-157,118,338,35,-178.5689335579406,77.13360127665402,281.5841106846526,0.17676767676767677,1081,1374,1743,1726,-17,352,645,152,-130.37044461159425,154.19331119053138,380.16360874025503,0.40052770448548813,129127,129707,Linn,Linn,41,43,Oregon,OR
41045,41CS001,204,261,332,326,-6,65,122,42,-183.13979456591576,87.66316909502733,304.91537076531245,0.5915492957746479,245,316,408,392,-16,76,147,46,-195.7033384648467,94.69516377331291,318.9648766431089,0.5476190476190477,31484,31681,Baker+Harney+Lake+Malheur,Malheur,41,45,Oregon,OR
41047,41CS015,1925,2377,2946,2685,-261,308,760,182,-153.43938821650087,43.636977576524345,200.1759765018339,0.406704418344519,2260,2862,3650,3458,-192,596,1198,304,-142.9887784021572,84.1534279823237,257.7198731958662,0.44250363901018924,346495,346985,Marion,Marion,41,47,Oregon,OR
41049,41CS018,62,77,95,96,1,19,34,11,-102.68903020244191,76.43019400059735,231.1240694486766,0.5629475760326839,76,97,120,122,2,25,46,14,-98.07379272924578,89.52794357026588,260.44492674986435,0.5384615384615384,12118,12287,Umatilla and Nearby Counties,Morrow,41,49,Oregon,OR
41051,41CS016,3867,4806,5953,5449,-504,644,1582,389,-131.6939897143245,37.515245558871264,175.8794311927986,0.43634337898164505,4528,5712,7265,6896,-369,1184,2368,422,-98.20553168608362,94.69708240358997,241.710421807196,0.31006629524056317,814069,805199,Multnomah,Multnomah,41,51,Oregon,OR
41053,41CS017,495,618,783,669,-114,51,174,25,-190.1827739501098,35.5737562784378,203.8649879033551,0.22321428571428573,597,765,978,842,-136,77,245,68,-229.3359620583198,10.115283795760245,198.990110671039,0.4533333333333333,87705,88974,Polk,Polk,41,53,Oregon,OR
41055,41CS009,12,20,29,16,-13,-4,4,3,-1015.7453478364666,-433.4381747507626,42.994966864813804,-0.4273374781945228,16,26,39,26,-13,0,10,4,-893.8449573342389,-210.3164605492327,315.474690823849,0.36363636363636365,1864,1902,Hood River+Jefferson+Sherman+Wasco,Sherman,41,55,Oregon,OR
41057,41CS004,208,264,339,303,-36,39,95,3,-170.4892154035306,157.37466037248979,402.179687618585,0.05555555555555555,247,322,417,412,-5,90,165,42,-169.80897993556223,171.4330828254879,443.92145657968445,0.4329896907216495,27450,27708,Clatsop+Lincoln+Tillamook,Tillamook,41,57,Oregon,OR
41059,41CS018,456,577,718,709,-9,132,253,60,-103.99357413589696,108.43645673837193,290.66994653480253,0.40540540540540543,549,700,891,885,-6,186,336,101,-133.889469825515,105.6364164356304,293.8442566058571,0.5,79678,79991,Umatilla and Nearby Counties,Umatilla,41,59,Oregon,OR
41061,41CS018,188,242,301,247,-54,5,59,6,-274.6112714411042,-4.573043654306481,242.37131367824352,0.10526315789473684,225,293,381,374,-7,81,149,49,-213.90833522164846,122.12429486338537,381.63842144807927,0.5632183908045977,26241,26203,Umatilla and Nearby Counties,Union,41,61,Oregon,OR
41063,41CS018,62,79,95,61,-34,-18,-1,7,-674.1036255306886,-405.76620844086557,-124.71454964354436,-0.37336132917117276,79,99,122,103,-19,4,24,9,-372.24348712380976,-66.47205127210889,199.41615381632667,0.47368421052631576,7372,7522,Umatilla and Nearby Counties,Wallowa,41,63,Oregon,OR
41065,41CS009,214,277,346,295,-51,18,81,27,-351.7281872626923,-40.58402160723373,243.50412964340236,0.5094339622641509,261,336,427,374,-53,38,113,28,-303.2659590980957,37.440241863962434,318.42925705300036,0.4,26611,26709,Hood River+Jefferson+Sherman+Wasco,Wasco,41,65,Oregon,OR
41067,41CS005,2345,2882,3557,3194,-363,312,849,131,-98.72868027795012,36.155571330923564,143.4337458241418,0.2563600782778865,2759,3478,4438,4156,-282,678,1397,243,-87.39279883947867,72.48750384647741,192.1376580141931,0.30223927353170954,600737,600793,Columbia+Washington,Washington,41,67,Oregon,OR
41069,41CS018,9,16,24,17,-7,1,8,4,-903.2297106248944,-218.33223487006404,329.58574573380014,0.5606799720249327,11,19,30,21,-9,2,10,2,-757.6409814894532,0,551.0116229014205,0.2857142857142857,1440,1452,Umatilla and Nearby Counties,Wheeler,41,69,Oregon,OR
41071,41CS019,647,806,1000,883,-117,77,236,37,-171.68725718515378,44.550699237146624,221.69541707885082,0.2534246575342466,757,974,1246,1251,5,276,494,102,-89.80432432703086,161.30576011391548,362.40643697799743,0.3511198009242801,107742,108180,Yamhill,Yamhill,41,71,Oregon,OR
42001,42CS001,726,888,1118,996,-122,108,270,81,-234.95148479299579,31.828403112351648,218.80580394145738,0.4764705882352941,851,1078,1381,1234,-147,156,383,172,-306.5472163261254,-15.372999408299659,202.73142969695175,0.7661507936507936,103681,104079,Adams,Adams,42,1,Pennsylvania,PA
42003,42CS002,9260,11478,14166,12850,-1316,1372,3590,1108,-234.08642941493176,25.490881005441455,239.6142814511496,0.5486547255630341,10946,13740,17463,15249,-2214,1508,4303,1390,-290.7578544028979,9.559228639489339,234.99568733921006,0.5250240753290295,1242797,1239640,Allegheny,Allegheny,42,3,Pennsylvania,PA
42005,42CS003,575,719,897,785,-112,66,210,43,-284.84120294361435,42.266759146471806,306.9853093660049,0.3412698412698413,673,869,1116,1101,-15,232,428,185,-307.0873393950868,72.14748788587393,373.17136819267967,0.7489878542510121,65300,65144,Armstrong,Armstrong,42,5,Pennsylvania,PA
42007,42CS004,1502,1852,2307,2109,-198,257,607,243,-316.76119854887617,10.055911065043688,261.4896016592253,0.6883907935285054,1786,2241,2869,2444,-425,203,658,310,-440.8054852862482,-64.15422595977769,208.7710418616316,0.7192575406032483,167066,166786,Beaver,Beaver,42,7,Pennsylvania,PA
42009,42CS005,381,480,608,635,27,155,254,98,-179.09161453963262,143.7777750529445,393.4970685659533,0.6242038216560509,448,584,752,709,-43,126,261,138,-381.29311381476566,-26.33239736289818,259.21611964036964,0.9419904948280682,47573,47470,Bedford+Fulton,Bedford,42,9,Pennsylvania,PA
42011,42CS006,2722,3364,4153,3927,-226,564,1205,575,-224.84476535034855,-3.2277054069766673,176.89228980409078,0.8261494252873564,3245,4056,5173,4822,-351,766,1577,678,-239.74513538226785,20.384510101980794,209.44792922498092,0.7345620756683664,427548,429248,Berks,Berks,42,11,Pennsylvania,PA
42013,42CS007,1061,1319,1639,1613,-26,294,552,193,-214.83253156735387,99.05540145310542,352.08801110559256,0.614655915614382,1251,1592,2034,1874,-160,282,623,302,-379.07219277434655,-15.99980034437177,263.58645439125274,0.84593837535014,122356,121877,Blair,Blair,42,13,Pennsylvania,PA
42015,42CS008,469,581,730,592,-138,11,123,57,-390.4591410641246,-92.08469873852721,132.32170840470954,0.5,545,708,904,841,-63,133,296,106,-282.2814340052696,45.08487854565088,317.2639601360617,0.6424242424242425,59945,59887,Bradford+Sullivan,Bradford,42,15,Pennsylvania,PA
42017,42CS009,4277,5272,6520,6046,-474,774,1769,875,-251.58529244900086,-18.742316364200427,166.77864203487002,0.8495145631067961,5101,6409,8178,6909,-1269,500,1808,589,-287.6402268355222,-13.775279911946551,188.7135958723689,0.4859749206911106,643464,646085,Bucks,Bucks,42,17,Pennsylvania,PA
42019,42CS010,1439,1765,2187,1973,-214,208,534,226,-273.5446136635926,-11.18664783811125,191.44704814056502,0.70625,1706,2156,2766,2421,-345,265,715,332,-348.6920935621074,-34.498479428028936,197.25921595340122,0.7738927738927739,193087,194211,Butler,Butler,42,19,Pennsylvania,PA
42021,42CS011,1267,1564,1930,1844,-86,280,577,280,-331.7552778876999,0,269.15481447415516,0.8408408408408409,1492,1886,2408,2071,-337,184,579,297,-479.3161589820752,-85.04545049362584,213.25619186001637,0.8027027027027027,132459,132282,Cambria,Cambria,42,21,Pennsylvania,PA
42023,42CS035,40,53,67,57,-10,4,17,4,-384.5175480063026,10.198729992758212,339.12896165864225,0.3649776711530577,48,65,83,77,-6,12,29,4,-223.8263107828325,179.061048626266,559.5657769570813,0.26666666666666666,4499,4468,McKean and Nearby Counties,Cameron,42,23,Pennsylvania,PA
42025,42CS012,534,663,827,827,-0,164,293,93,-172.5049895863206,131.6265906569453,370.87182339326625,0.5344827586206896,625,803,1023,996,-27,193,371,143,-260.3512624120895,76.5513855960275,349.0743183178854,0.6682242990654206,64729,65316,Carbon,Carbon,42,25,Pennsylvania,PA
42027,42CS013,645,804,1006,1047,41,242,402,141,-75.75018297145645,76.84801171017321,197.64702913242084,0.5662650602409639,754,977,1243,1222,-21,245,468,127,-93.9489245925826,74.8799263892249,216.42202453428092,0.47299977806136606,158495,157586,Centre,Centre,42,27,Pennsylvania,PA
42029,42CS014,2782,3450,4255,3919,-336,470,1137,555,-200.37322164010934,-19.225575637110705,130.8913167059899,0.8460385513611488,3337,4209,5366,4407,-959,198,1070,351,-243.48355627982423,-28.435221823382264,133.64554256989663,0.4201078703836346,533664,538065,Chester,Chester,42,29,Pennsylvania,PA
42031,42CS015,275,339,430,451,21,112,176,48,-86.70471891770744,205.52229669382504,411.0445933876501,0.42105263157894735,319,413,532,599,67,186,280,116,-131.86502672621523,188.3786096088789,441.4787272333796,0.6203208556149733,37368,37159,Clarion+Jefferson,Clarion,42,31,Pennsylvania,PA
42033,42CS016,661,826,1028,878,-150,52,217,54,-305.36923126887723,-2.9930823942060996,243.9362151277971,0.35294117647058826,790,1016,1288,1231,-57,216,441,206,-328.7884933387413,11.856104333718136,293.3449814358366,0.8000030163182819,80185,80128,Clearfield,Clearfield,42,33,Pennsylvania,PA
42035,42CS017,273,345,436,371,-65,26,98,29,-300.9534793412809,-9.599792004506568,220.95521263705936,0.46774193548387094,329,424,544,491,-53,67,162,74,-339.40189650712233,-18.69247266364954,235.12460257633444,0.7872340425531915,37501,37448,Clinton+Potter+Tioga,Clinton,42,35,Pennsylvania,PA
42037,42CS018,472,591,729,659,-70,68,187,83,-283.68933088593053,-27.80359335700071,192.86425925306153,0.7614678899082569,559,708,907,871,-36,164,312,113,-229.78896492473223,77.88149482348307,306.89935583907186,0.6141304347826086,64740,64842,Columbia,Columbia,42,37,Pennsylvania,PA
42039,42CS019,661,828,1026,921,-105,94,260,90,-279.35440718297843,5.01276813709523,243.54892048944103,0.5882352941176471,784,994,1276,1217,-59,222,433,153,-254.24059037051026,83.32808786017667,335.710282026611,0.6071428571428571,83786,83405,Crawford,Crawford,42,39,Pennsylvania,PA
42041,42CS020,1660,2070,2574,2361,-213,292,701,321,-247.1735159663266,-13.652160121712477,175.8583337712116,0.8106060606060606,1994,2534,3252,2793,-458,259,799,365,-313.7229753427297,-40.38207090021779,165.35696107773143,0.741869918699187,259300,262493,Cumberland+Perry,Cumberland,42,41,Pennsylvania,PA
42043,42CS021,1774,2183,2712,2589,-123,406,815,329,-190.01613902286985,32.37000598398446,204.33040790280063,0.6890059910704105,2115,2640,3332,3175,-157,535,1060,386,-188.91295279612865,51.86664817877865,234.72269038221765,0.6146496815286624,285449,287275,Dauphin,Dauphin,42,43,Pennsylvania,PA
42045,42CS022,3750,4648,5704,5578,-126,930,1828,979,-230.80922777816946,-10.23173850918741,177.2909710454198,0.939992348255771,4436,5614,7095,5923,-1172,308,1487,544,-298.8753751697277,-41.01220769867783,164.24039524680703,0.49454913301008024,574682,574219,Delaware,Delaware,42,45,Pennsylvania,PA
42047,42CS035,260,328,412,317,-95,-11,57,21,-452.5158393411647,-124.8319556803213,140.43595014036146,-0.25455480458419044,308,394,509,468,-41,74,160,57,-318.3028178158681,55.18763796909493,334.37215945981046,0.6129032258064516,30761,30804,McKean and Nearby Counties,Elk,42,47,Pennsylvania,PA
42049,42CS023,1965,2444,3014,2777,-237,334,812,259,-220.32323266597925,33.09290490648277,245.6870564265184,0.5661208947665142,2360,2947,3746,3389,-357,442,1029,358,-265.58451809410604,31.201537790076795,249.37086184961962,0.5783521809369951,270149,269218,Erie,Erie,42,49,Pennsylvania,PA
42051,42CS024,1191,1484,1849,1679,-170,196,488,164,-312.45236506972446,29.441368530350942,303.01243420761176,0.5878136200716846,1406,1781,2274,2307,33,526,901,378,-271.6993597493135,116.40325732493386,411.3439431144622,0.6792458313421077,128391,127144,Fayette+Greene,Fayette,42,51,Pennsylvania,PA
42053,42CS035,55,70,86,87,1,17,32,5,-74.45746422810178,208.56658036950535,463.2882205073518,0.27871671491402655,68,87,108,109,1,22,41,21,-284.88675751388826,14.244337875694413,284.88675751388826,0.8940217391304348,6972,7020,McKean and Nearby Counties,Forest,42,53,Pennsylvania,PA
42055,42CS025,1075,1335,1653,1699,46,364,624,235,-145.50970164924092,99.31614557011682,299.4882219129879,0.6241710875331565,1278,1620,2067,2038,-29,418,760,289,-203.67605298169732,82.89141691115589,301.5455328713941,0.6407982261640798,155866,156228,Franklin,Franklin,42,55,Pennsylvania,PA
42057,42CS005,114,136,159,146,-13,10,32,13,-211.90672066641068,-21.911369996429144,154.51288419712523,0.6704891410081091,138,165,195,237,42,72,99,44,-13.767664917982005,192.74730885174807,378.6107852445051,0.6111111111111112,14539,14527,Bedford+Fulton,Fulton,42,57,Pennsylvania,PA
42059,42CS024,296,370,465,401,-64,32,105,34,-328.46352180068396,-8.379171474507244,238.1360533054957,0.4822937625754527,347,446,572,540,-32,94,193,68,-282.49902987970506,73.376371397326,352.771016333298,0.6181818181818182,35803,35434,Fayette+Greene,Greene,42,59,Pennsylvania,PA
42061,42CS026,314,394,494,489,-5,94,175,75,-217.7551924854975,53.0115637136979,271.8541728907585,0.7281553398058253,372,480,622,593,-29,113,221,101,-296.2908136467996,27.328899029681747,273.40286070944103,0.7890625,44141,43910,Huntingdon+Juniata+Mifflin,Huntingdon,42,61,Pennsylvania,PA
42063,42CS027,599,753,949,935,-14,182,336,116,-187.58974256275715,95.16466571208282,317.2876468173306,0.5948717948717949,706,904,1160,1115,-45,211,409,159,-246.3834168564004,62.7113934240471,301.4970837694572,0.6652719665271967,83224,82920,Indiana,Indiana,42,63,Pennsylvania,PA
42065,42CS015,371,469,587,526,-61,57,155,58,-322.8366520203902,-2.7129130421881524,263.2882107443601,0.6236559139784946,437,566,724,656,-68,90,219,123,-432.5158714171075,-74.72787307206569,217.39017620964566,0.9800952380952381,44233,44160,Clarion+Jefferson,Jefferson,42,65,Pennsylvania,PA
42067,42CS026,158,204,260,295,35,90,137,64,-147.2962617753679,134.59830817404307,370.7802451586847,0.6956521739130435,184,245,319,354,35,109,170,73,-162.95404231444772,154.37751377158204,415.96163432898493,0.6636363636363637,23626,23319,Huntingdon+Juniata+Mifflin,Juniata,42,67,Pennsylvania,PA
42069,42CS028,1798,2224,2784,2524,-260,300,726,267,-294.57999657854157,18.164974649089466,256.6012265045222,0.6480582524271845,2108,2686,3413,2941,-472,255,833,315,-365.003847530552,-27.823949754584067,240.2366195060379,0.6104651162790697,214699,215642,Lackawanna+Wyoming,Lackawanna,42,69,Pennsylvania,PA
42071,42CS029,3452,4270,5331,5188,-143,918,1736,748,-193.8791244161265,37.087838789352155,214.87018859895622,0.743539502092319,4110,5138,6537,5904,-633,766,1794,739,-247.90507616500219,4.787730582204976,190.6510451649734,0.6913002806361085,551663,553498,Lancaster,Lancaster,42,71,Pennsylvania,PA
42073,42CS030,778,986,1230,1217,-13,232,439,140,-214.26067964926247,128.0107880372675,418.308476755661,0.5622489959839357,934,1198,1523,1387,-136,188,453,196,-388.36634820691046,-8.766734722503623,300.40677649112416,0.7567567567567568,85774,85551,Lawrence,Lawrence,42,73,Pennsylvania,PA
42075,42CS031,1048,1306,1599,1523,-76,217,475,156,-194.70224901553937,51.19326374977544,267.79951577956297,0.5767117671176711,1246,1582,2013,1877,-136,296,631,226,-252.58546187161687,48.44677687340244,282.31575012558255,0.6295264623955432,142988,143456,Lebanon,Lebanon,42,75,Pennsylvania,PA
42077,42CS032,2335,2884,3568,3397,-171,513,1062,518,-221.17186435549297,-1.6049043201182276,174.6135900288632,0.8422764227642277,2777,3492,4437,3976,-461,484,1199,472,-248.43624322763327,3.06349645841495,193.69289347074002,0.6714082503556188,373854,375388,Lehigh,Lehigh,42,77,Pennsylvania,PA
42079,42CS033,2883,3543,4363,3970,-393,427,1087,463,-317.0625282918648,-13.331290607927038,231.09421955213523,0.6988715072088657,3445,4337,5525,4602,-923,265,1157,534,-447.05902206989555,-82.5386938481825,191.2350964344971,0.6155638000728187,324050,325908,Luzerne,Luzerne,42,79,Pennsylvania,PA
42081,42CS034,871,1092,1360,1268,-92,176,397,130,-234.03017577288915,48.470905382948686,281.3946800547053,0.5816583920563742,1054,1327,1707,1563,-144,236,509,261,-356.458836823742,-21.995485426616188,218.23920640288577,0.8907849829351536,113883,113660,Lycoming,Lycoming,42,81,Pennsylvania,PA
42083,42CS035,346,434,548,444,-104,10,98,26,-386.9491478127141,-49.11277645315218,214.3102972501186,0.2841614906832298,414,526,671,631,-40,105,217,97,-343.04949203609067,20.002885833008204,300.043287495123,0.7698412698412699,40315,39994,McKean and Nearby Counties,McKean,42,83,Pennsylvania,PA
42085,42CS036,1006,1249,1542,1446,-96,197,440,170,-289.8564759822354,29.415992676265198,294.3233489441866,0.6719367588932806,1211,1512,1924,1842,-82,330,631,244,-296.43358315740994,77.70986159729742,351.87570663618345,0.6446510588990799,110144,110025,Mercer,Mercer,42,85,Pennsylvania,PA
42087,42CS026,377,474,599,614,15,140,237,126,-289.04969307457986,36.45671804544251,289.04969307457986,0.8689655172413793,453,577,741,658,-83,81,205,105,-407.57206017649713,-52.0304757672124,216.9020458545666,0.860655737704918,46082,46127,Huntingdon+Juniata+Mifflin,Mifflin,42,87,Pennsylvania,PA
42089,42CS037,1011,1254,1562,1540,-22,286,529,213,-167.4510870814149,51.950401006983796,224.9879353199715,0.6926847582385042,1191,1512,1935,1808,-127,296,617,202,-194.56193814949597,55.87632017969115,245.530602694357,0.5706214689265536,168622,169124,Monroe,Monroe,42,89,Pennsylvania,PA
42091,42CS038,5357,6639,8224,7627,-597,988,2270,1168,-248.18228080762373,-25.308940312374517,155.00319889089815,0.9100184537684537,6488,8110,10327,8373,-1954,263,1884,715,-310.3487843599514,-52.55517694048594,135.98070670773947,0.4180073237988601,853453,860048,Montgomery,Montgomery,42,91,Pennsylvania,PA
42093,42CS039,152,196,248,217,-31,20,65,28,-390.6916428500808,-49.66419188772214,245.0100133127625,0.717948717948718,180,237,307,253,-54,16,73,48,-563.8136651112657,-176.88271846627944,138.1896238017808,0.9230769230769231,18122,18091,Montour+Northumberland,Montour,42,93,Pennsylvania,PA
42095,42CS040,2103,2606,3240,3032,-208,426,929,417,-240.5078317448282,3.463035734266785,197.04673327978003,0.7722328152649556,2495,3158,4004,3550,-454,392,1055,381,-266.4941958901125,3.5086010230894527,214.9975017830405,0.5870570107858244,311865,313515,Northampton,Northampton,42,95,Pennsylvania,PA
42097,42CS039,789,989,1225,1265,40,276,476,239,-261.45544076126447,48.61231813149139,311.3816053287421,0.8356643356643356,946,1202,1530,1308,-222,106,362,206,-469.024369706287,-109.53394902061817,170.87296047216435,0.8860256030782891,91335,91296,Montour+Northumberland,Northumberland,42,97,Pennsylvania,PA
42099,42CS020,302,382,479,450,-29,68,148,42,-185.70375829034637,67.95633660167495,277.1834421772163,0.4883720930232558,356,462,595,580,-15,118,224,102,-254.7760307101936,33.723556584184465,265.43702601745196,0.7669172932330827,45912,45962,Cumberland+Perry,Perry,42,99,Pennsylvania,PA
42101,42CS041,9494,11742,14492,15527,1035,3786,6033,2461,-107.22861225805362,99.58580579587844,268.59972263132966,0.6386404660211121,11130,13922,17778,16427,-1351,2506,5297,1576,-185.28529264297333,58.83429140375566,235.53655024968836,0.5318934119175777,1596011,1579861,Philadelphia,Philadelphia,42,101,Pennsylvania,PA
42103,42CS042,377,470,597,525,-72,55,148,45,-240.70135987410612,20.57276580120565,212.00235158142414,0.5202485966319166,453,583,755,684,-71,101,231,77,-247.76782679123855,40.164997250859344,257.7253990263474,0.5877862595419847,58330,59754,Pike,Pike,42,103,Pennsylvania,PA
42105,42CS017,157,181,210,188,-22,7,31,15,-268.5934645704099,-57.70143201084729,117.03768068136182,0.739597293071983,191,222,259,298,39,76,107,63,-147.48224004014796,79.88621335508014,270.6913614070213,0.8289473684210527,16373,16273,Clinton+Potter+Tioga,Potter,42,105,Pennsylvania,PA
42107,42CS043,1296,1611,2002,1916,-86,305,620,239,-273.5481895268783,55.54277959936614,320.6753964596738,0.6675977653631285,1554,1944,2484,2133,-351,190,579,261,-427.430173994506,-49.93261570232363,222.2525167449578,0.6770439405154431,142593,143193,Schuylkill,Schuylkill,42,107,Pennsylvania,PA
42109,42CS044,239,303,379,361,-18,58,122,42,-181.18061327242617,48.23443947352444,241.32292999097686,0.6176470588235294,280,370,475,435,-40,64,155,79,-300.36583827425255,-36.58382742525546,191.87586728901212,0.8977272727272727,39806,39635,Snyder+Union,Snyder,42,109,Pennsylvania,PA
42111,42CS045,646,811,1011,950,-61,139,304,103,-266.6846539651127,58.52269151322193,326.7516942821558,0.6130952380952381,761,982,1247,1190,-57,208,429,212,-365.21323052402545,-6.108379622219344,294.62751044504625,0.892635535226749,73818,73669,Somerset,Somerset,42,111,Pennsylvania,PA
42113,42CS008,62,77,95,88,-7,11,26,4,-216.03102510245202,137.5959051369117,440.7047024849376,0.2855825278202995,73,93,116,131,15,38,58,23,-136.43437293483126,255.81444925280863,597.7530964207288,0.6052631578947368,5859,5864,Bradford+Sullivan,Sullivan,42,113,Pennsylvania,PA
42115,42CS046,309,391,487,465,-22,74,156,37,-183.4191124130165,114.92814833669114,369.6337743801688,0.42528735632183906,370,473,603,577,-26,104,207,56,-213.89178512907156,125.05244441163747,393.3941480449429,0.46862745098039216,38633,38384,Susquehanna+Wayne,Susquehanna,42,115,Pennsylvania,PA
42117,42CS017,308,387,490,463,-27,76,155,79,-310.8466416588263,-8.797546462042252,222.87117703840374,0.8876404494382022,369,475,607,596,-11,121,227,103,-278.6135687210159,43.97233000419365,302.9204955844452,0.7803030303030303,40920,40935,Clinton+Potter+Tioga,Tioga,42,117,Pennsylvania,PA
42119,42CS044,238,299,381,390,9,91,152,42,-92.32446063921864,137.08783549459739,307.7482021307288,0.44680851063829785,275,360,465,484,19,124,209,78,-138.80957868298245,106.86693451904742,307.6828224614332,0.6141732283464567,42892,42576,Snyder+Union,Union,42,119,Pennsylvania,PA
42121,42CS047,430,534,668,635,-33,101,205,58,-217.09845739253183,102.52865093771408,350.6241423346709,0.48739495798319327,507,648,834,870,36,222,363,136,-200.0514298884338,173.04448685349524,454.2167715616889,0.5887445887445888,50327,49987,Venango,Venango,42,121,Pennsylvania,PA
42123,42CS035,325,408,514,501,-13,93,176,40,-165.00310515867116,165.00310515867116,423.5598576761737,0.38461538461538464,378,493,626,683,57,190,305,90,-86.55353890708152,261.88665327407415,563.0563045392595,0.46632124352331605,38545,38184,McKean and Nearby Counties,Warren,42,123,Pennsylvania,PA
42125,42CS048,1729,2149,2670,2308,-362,159,579,135,-285.67119372006005,13.789438152215286,255.1046058159828,0.35856636943394093,2066,2620,3318,2991,-327,371,925,354,-325.2964549948375,8.11748951913723,272.69989790466303,0.658605221075367,208856,209424,Washington,Washington,42,125,Pennsylvania,PA
42127,42CS046,405,516,650,594,-56,78,189,29,-199.37386182609515,113.76037998312489,375.40925394431207,0.27102803738317754,489,623,805,833,28,210,344,109,-157.7373784553706,196.56354378769194,457.3508197040357,0.5011520737327189,51160,51383,Susquehanna+Wayne,Wayne,42,127,Pennsylvania,PA
42129,42CS049,3129,3814,4722,4253,-469,438,1124,425,-303.7695112023502,4.587123491310657,237.56202881109965,0.6424795809699668,3670,4622,5880,5235,-646,614,1565,589,-349.5243970754288,6.93669317808668,276.43430140509906,0.6222928308154604,353162,353194,Westmoreland,Westmoreland,42,129,Pennsylvania,PA
42131,42CS028,211,270,342,278,-64,8,67,30,-431.8612530867742,-101.07391029690461,169.9879400447941,0.5,252,327,426,394,-32,67,142,54,-330.39832687824,49.943933132757216,338.08200889866424,0.6708333333333334,26120,26029,Lackawanna+Wyoming,Wyoming,42,131,Pennsylvania,PA
42133,42CS050,2848,3542,4371,4231,-140,690,1383,424,-148.65623378545695,69.929535914314,252.61550996391168,0.5326633165829145,3419,4275,5435,5253,-182,978,1834,684,-189.0110015976813,64.14178388609488,250.9383667543752,0.6263736263736264,455601,458360,York,York,42,133,Pennsylvania,PA
44001,44CS001,364,452,566,495,-71,43,131,63,-318.83951405725185,-47.58798717272415,161.9181263551938,0.7875,430,550,707,594,-113,44,164,66,-352.5029645873278,-44.284292033583895,192.9811037285733,0.6,50433,50808,Bristol+Providence,Bristol,44,1,Rhode Island,RI
44003,44CS002,1248,1546,1920,1691,-229,144,443,205,-307.3360808591791,-42.8379976776416,168.69674292062982,0.7454545454545455,1487,1898,2413,2106,-307,208,619,163,-275.40487935410715,26.36855227858473,267.377120104849,0.441137478942357,169476,170658,Kent,Kent,44,3,Rhode Island,RI
44005,44CS003,568,711,890,719,-171,8,151,38,-295.30369884971327,-42.37795247783496,159.62362099984503,0.2500108211054841,673,863,1122,887,-235,24,214,52,-336.82338513853534,-32.832218568769335,189.95783600502256,0.26,84950,85282,Newport,Newport,44,5,Rhode Island,RI
44007,44CS001,3932,4878,6012,5966,-46,1088,2034,1192,-226.36203112378914,-19.101895467707813,153.92106295295082,1.0033677142976583,4671,5866,7497,6267,-1230,402,1596,626,-281.9284715371191,-34.09353435863247,147.33873957570253,0.5557044917257683,656479,658483,Bristol+Providence,Providence,44,7,Rhode Island,RI
44009,44CS004,856,1046,1303,1163,-140,117,307,87,-210.76048324739983,27.847674509676263,204.4019309010236,0.4615417088821344,1014,1284,1637,1380,-257,96,366,71,-251.43779451893585,19.161545078413035,226.1062319252738,0.28343426294820717,129275,130470,Washington,Washington,44,9,Rhode Island,RI
45001,45CS001,201,255,323,301,-22,46,100,34,-276.824448706891,59.319524722905214,326.5045506623238,0.6071428571428571,237,310,404,418,14,108,181,41,-111.17373211762798,275.8755574770768,576.4563887580711,0.36607142857142855,24275,24286,Abbeville+Edgefield+Greenwood+McCormick,Abbeville,45,1,South Carolina,SC
45003,45CS002,1270,1567,1940,1928,-12,361,658,157,-119.65006220100632,144.38694285125874,354.70351181327595,0.4093879188424717,1532,1939,2471,2501,30,562,969,390,-211.26347580463874,100.86694750422723,339.7222249372024,0.6543624161073825,169544,170522,Aiken,Aiken,45,3,South Carolina,SC
45005,45CS018,79,96,115,119,4,23,40,14,-150.2175889270272,130.99374380404808,387.7519171672036,0.59245348064466,95,117,143,155,12,38,60,17,-63.473928084039485,266.59049795296585,545.8757815227395,0.4473684210526316,8069,7877,Hampton and Nearby Counties,Allendale,45,5,South Carolina,SC
45007,45CS003,1517,1882,2348,2446,98,564,929,295,-115.9154242364234,158.16002596803398,372.7931764499328,0.506872852233677,1813,2284,2893,3032,139,748,1219,504,-176.81364950362467,118.16633930124466,346.2903316285041,0.6528497409326425,204097,206489,Anderson,Anderson,45,7,South Carolina,SC
45009,45CS018,134,155,180,205,25,50,71,31,-54.311141539205984,167.0686425442247,358.9311220831982,0.624829127595125,157,189,223,237,14,48,80,24,-76.1476607956357,181.84516010898082,424.30537358762194,0.5,13370,13198,Hampton and Nearby Counties,Bamberg,45,9,South Carolina,SC
45011,45CS018,167,214,275,296,21,82,129,34,-75.65317545313098,279.33480167309904,552.8501283113418,0.40963855421686746,197,259,340,317,-23,58,120,51,-360.09148073042843,34.016739070350866,335.3078565506014,0.75,20620,20578,Hampton and Nearby Counties,Barnwell,45,11,South Carolina,SC
45013,45CS004,1097,1365,1695,1638,-57,273,541,100,-99.80139191150302,109.9372225449858,280.4352387809376,0.32362459546925565,1337,1682,2156,2109,-47,426,772,184,-120.92195470440046,126.85950255599012,307.6277545486597,0.3898305084745763,188835,191156,Beaufort,Beaufort,45,13,South Carolina,SC
45015,45CS005,1110,1375,1709,1617,-92,242,507,126,-112.92018775797101,60.0721934415255,197.4614427521867,0.43448275862068964,1339,1703,2175,2139,-36,436,800,282,-134.81530573296155,65.26739101815807,219.57815121108885,0.5936842105263158,231721,235952,Berkeley,Berkeley,45,15,South Carolina,SC
45017,45CS006,123,146,171,193,22,47,70,15,59.15264694144694,274.74926255183107,469.48168955475876,0.3159266883355726,152,178,209,235,26,57,83,39,-91.8133129303749,127.12612559590372,310.7527514566535,0.6842105263157895,14186,14159,Calhoun+Richland,Calhoun,45,17,South Carolina,SC
45019,45CS007,2283,2808,3491,3276,-215,468,993,274,-143.08979882821217,56.89077242863301,210.32035945916996,0.48324514991181655,2706,3428,4343,3835,-508,407,1129,378,-214.75249129920283,7.03033498637115,182.09779741423066,0.5442767399912922,410260,412498,Charleston,Charleston,45,19,South Carolina,SC
45021,45CS008,446,557,692,680,-12,123,234,85,-206.732122272719,80.94611691255356,317.5004927846343,0.6159420289855072,537,675,868,935,67,260,398,187,-214.46207064392493,130.19319049485674,376.40099799917135,0.7083333333333334,56334,56071,Cherokee,Cherokee,45,21,South Carolina,SC
45023,45CS009,291,366,461,474,13,108,183,46,-122.76825360738314,230.65550677750772,509.6742649761058,0.40350877192982454,348,447,578,546,-32,99,198,85,-363.2975342401977,43.452930195324804,350.88241132724767,0.7264957264957265,32256,32219,Chester+Fairfield,Chester,45,23,South Carolina,SC
45025,45CS010,340,429,535,597,62,168,257,67,-13.759857050373977,277.9491124175543,523.1497650552184,0.3941176470588235,405,518,670,694,24,176,289,113,-205.70167286692856,145.60904933276964,406.7808362312295,0.6277777777777778,43605,43267,Chesterfield+Marlboro,Chesterfield,45,25,South Carolina,SC
45027,45CS011,252,316,398,501,103,185,249,77,99.10733252640976,411.67661203277896,655.6331228670184,0.41621621621621624,296,387,490,563,73,176,267,70,9.666797571217112,341.56018084967127,634.7863738432569,0.39325842696629215,31481,31034,Clarendon+Williamsburg,Clarendon,45,27,South Carolina,SC
45029,45CS018,369,463,585,558,-27,95,189,59,-268.66356472771076,112.4638177929952,406.2755417771951,0.5462962962962963,443,568,734,729,-5,160,286,122,-330.09465854209276,100.06806577850844,426.39392703803384,0.7011494252873564,38412,38474,Hampton and Nearby Counties,Colleton,45,29,South Carolina,SC
45031,45CS012,545,688,860,879,19,191,334,101,-155.24815480113264,170.39431624514557,441.1319520568769,0.507537688442211,661,830,1059,1099,40,269,438,154,-181.70557085700744,183.2191201100908,452.5512266719242,0.5549567566163676,63382,62766,Darlington,Darlington,45,31,South Carolina,SC
45033,45CS013,233,298,376,461,85,163,228,48,155.22458597806323,483.107642421577,756.5885773923999,0.294478527607362,275,358,462,503,41,145,228,65,-85.53930740132856,284.53823667801606,579.7466572314577,0.4452054794520548,28565,28116,Dillon+Marion,Dillon,45,33,South Carolina,SC
45035,45CS014,828,1022,1279,1252,-27,230,424,103,-96.09419695255117,93.87663856133845,237.31570716628113,0.4111792828685259,977,1247,1605,1589,-16,342,612,229,-150.21777132529408,69.26997820754225,234.9049172489396,0.6147662083081091,162341,163130,Dorchester,Dorchester,45,35,South Carolina,SC
45037,45CS001,144,186,239,275,36,89,131,27,41.35713529315497,286.4963562207382,480.5745330154318,0.30337078651685395,177,230,300,370,70,140,193,56,53.290819953386524,322.04524288377456,525.24045565568,0.4,25969,26083,Abbeville+Edgefield+Greenwood+McCormick,Edgefield,45,37,South Carolina,SC
45039,45CS009,182,231,295,329,34,98,147,41,-39.89740666856654,324.87888287261325,604.4457110287827,0.41836734693877553,211,277,359,392,33,115,181,50,-82.06811653672548,313.78985734630334,632.648627772816,0.42919245505452397,21054,20714,Chester+Fairfield,Fairfield,45,39,South Carolina,SC
45041,45CS015,1084,1345,1683,1751,68,406,667,240,-150.86891632326376,145.43693443473742,374.1934620305804,0.5783132530120482,1317,1661,2107,2061,-46,400,744,275,-235.11896543017036,91.54297049920976,343.5058425012346,0.632183908045977,136967,136548,Florence,Florence,45,41,South Carolina,SC
45043,45CS016,553,681,847,885,38,204,332,91,-100.55244989522501,213.78037324854986,456.0332652350702,0.43333333333333335,655,833,1069,1053,-16,220,398,126,-222.62818854224412,147.21807754464263,426.1493499989068,0.5384615384615384,63430,63851,Georgetown,Georgetown,45,43,South Carolina,SC
45045,45CS017,2995,3684,4613,4546,-67,862,1551,449,-117.3335246395961,93.97604126084205,250.7544732916415,0.4835757998960692,3525,4480,5704,5780,76,1300,2255,881,-151.15388792970174,78.54221765406031,257.8099029662667,0.6444773017218497,527368,532834,Greenville,Greenville,45,45,South Carolina,SC
45047,45CS001,545,675,852,838,-14,163,293,84,-169.0605293738359,136.21399103042364,360.3635965235258,0.4772727272727273,652,825,1045,1014,-31,189,362,131,-233.9691404016374,83.74088332795415,333.59191539523795,0.6267942583732058,69596,69261,Abbeville+Edgefield+Greenwood+McCormick,Greenwood,45,47,South Carolina,SC
45049,45CS018,152,196,249,250,1,54,98,31,-193.60390076007454,148.4296572493905,432.3820450308332,0.5535714285714286,177,236,303,294,-9,58,117,36,-247.1415966828349,120.6906798451136,444.36113942973645,0.5538461538461539,18595,18228,Hampton and Nearby Counties,Hampton,45,49,South Carolina,SC
45051,45CS019,2646,3260,4092,4023,-69,762,1377,353,-142.7087654769671,138.46520427157452,346.332076862418,0.4265862584628685,3232,4068,5130,5256,126,1188,2024,639,-140.92242412269212,151.03739429572715,380.6856980884115,0.5159467938211675,354891,363817,Horry,Horry,45,51,South Carolina,SC
45053,45CS018,170,216,278,269,-9,53,99,24,-134.7792606710884,118.44238058974435,306.3165015252009,0.41379310344827586,208,275,354,387,33,112,179,68,-116.45049920686756,145.9778337635947,368.4281463510723,0.5964912280701754,29381,30142,Hampton and Nearby Counties,Jasper,45,53,South Carolina,SC
45055,45CS020,465,579,725,716,-9,137,251,73,-149.69298570687403,116.76235326313147,324.8365156015712,0.4965986394557823,556,711,907,985,78,274,429,124,-69.65119514258622,227.12346242147677,461.96912256528367,0.4444444444444444,65775,66043,Kershaw+Lee,Kershaw,45,55,South Carolina,SC
45057,45CS021,645,802,999,968,-31,166,323,94,-154.26659287676114,89.43884832918978,282.5650787558747,0.5094888366627497,779,996,1284,1295,11,299,516,174,-163.3787998346673,125.25206979045328,342.7397637745963,0.5576923076923077,97273,99799,Lancaster,Lancaster,45,57,South Carolina,SC
45059,45CS022,603,748,930,851,-79,103,248,79,-280.63017212218233,42.627367917293526,300.1677157509419,0.5486111111111112,728,922,1180,1127,-53,205,399,180,-343.97653699297223,36.89152048401675,323.2435024809547,0.7725321888412017,67562,67766,Laurens,Laurens,45,59,South Carolina,SC
45061,45CS020,156,201,259,267,8,66,111,51,-312.77466282770115,109.10744052129108,436.79345355356827,0.75,188,244,321,296,-25,52,108,53,-478.35274937842246,-6.132727556133622,337.6066519651556,0.8688524590163934,16498,16306,Kershaw+Lee,Lee,45,61,South Carolina,SC
45063,45CS023,1754,2183,2706,2618,-88,435,864,235,-130.94309683981405,81.05422274206998,254.9155305238101,0.47764227642276424,2137,2693,3418,3290,-128,597,1153,405,-178.15629859565726,64.13426329870853,249.88980403002003,0.6076522549536043,296098,299372,Lexington,Lexington,45,63,South Carolina,SC
45065,45CS001,118,139,163,136,-27,-3,18,13,-500.90742792184824,-200.72947923148843,68.91312640243805,-0.543905850271204,150,180,214,180,-34,0,30,19,-545.044359840686,-195.3932610749629,113.12241430655747,0.38921404682274247,9531,9724,Abbeville+Edgefield+Greenwood+McCormick,McCormick,45,65,South Carolina,SC
45067,45CS013,268,339,422,468,46,129,200,80,-140.1601655381164,201.1082902303867,492.510098523396,0.6153846153846154,320,411,534,517,-17,106,197,80,-336.5511458713574,90.20958549129168,406.116614682911,0.6837606837606838,29238,28822,Dillon+Marion,Marion,45,67,South Carolina,SC
45069,45CS010,234,297,374,356,-18,59,122,38,-254.1427852836364,95.21852793856138,380.8741117542455,0.5277777777777778,278,360,468,458,-10,98,180,73,-314.3391185722818,92.78684825326391,405.23235767751993,0.6886792452830188,26465,26405,Chesterfield+Marlboro,Marlboro,45,69,South Carolina,SC
45071,45CS024,289,362,453,488,35,126,199,67,-101.46561443066514,187.07722660653886,418.7041995490415,0.5234375,339,440,567,562,-5,122,223,71,-200.7639525073812,134.36957451281424,400.60576087594893,0.5378787878787878,37845,37955,Newberry+Saluda,Newberry,45,71,South Carolina,SC
45073,45CS025,644,798,1001,869,-132,71,225,75,-315.2434767691223,-6.090190326377635,228.3821372391613,0.5300419538507641,769,966,1248,1193,-55,227,424,205,-328.61225307672436,27.805652183415138,276.9190178811934,0.8102766798418972,78815,79121,Oconee,Oconee,45,73,South Carolina,SC
45075,45CS026,714,890,1104,1155,51,266,441,132,-115.4589987663685,190.29353500382956,440.454698997628,0.4826341541670009,854,1070,1385,1417,32,348,563,190,-190.11578412232387,189.51415189408868,449.1184583775781,0.5234159779614325,84186,83107,Orangeburg,Orangeburg,45,75,South Carolina,SC
45077,45CS027,890,1101,1379,1319,-60,218,429,145,-187.8887689886579,66.87411085408107,260.3051862902346,0.5731225296442688,1056,1354,1720,1697,-23,343,641,296,-241.41507832036785,35.56899273058711,261.12938173806555,0.7935713874992812,130992,132138,Pickens,Pickens,45,77,South Carolina,SC
45079,45CS006,2058,2564,3199,3272,73,708,1214,304,-66.56664182040954,116.3188723851447,262.0053808675289,0.4158686730506156,2458,3100,3951,3987,36,886,1529,429,-94.09219727666458,109.43734652109839,263.16392737745656,0.46228501956030255,416785,418047,Calhoun+Richland,Richland,45,79,South Carolina,SC
45081,45CS024,131,169,213,267,54,98,136,30,150.82457590427836,428.22844098083203,667.5325697642381,0.30612244897959184,156,204,266,285,19,81,129,44,-132.82108667572064,196.57520828006656,451.8573368708014,0.5365853658536586,19055,18822,Newberry+Saluda,Saluda,45,81,South Carolina,SC
45083,45CS028,2222,2760,3451,3356,-95,596,1134,382,-174.22517470621807,78.12296990493593,274.52557648837296,0.5904173106646059,2694,3387,4316,4304,-12,917,1610,803,-243.2997519527902,34.03837727510349,241.0006685754367,0.8156426684825224,328713,334916,Spartanburg+Union,Spartanburg,45,83,South Carolina,SC
45085,45CS029,756,954,1179,1223,44,270,467,127,-94.78234723795303,162.04540469596054,386.7483658743591,0.44876325088339225,913,1152,1458,1514,56,362,601,206,-143.10360208837795,148.77815345409505,376.7139141946637,0.5478723404255319,105526,104854,Sumter,Sumter,45,85,South Carolina,SC
45087,45CS028,254,326,408,409,1,82,155,43,-185.89130092750705,174.6184634158509,495.12070639431136,0.48863636363636365,305,395,504,516,12,121,211,71,-218.23360242646174,184.94373086988284,518.0273901665416,0.5590551181102362,27145,27035,Spartanburg+Union,Union,45,87,South Carolina,SC
45089,45CS011,277,355,441,469,28,114,192,79,-199.1272337209586,136.52209951485895,440.77134986225894,0.6752136752136753,333,429,553,540,-13,111,207,72,-278.4420233017178,127.68064560572599,442.1351586936741,0.5901639344262295,30764,30545,Clarendon+Williamsburg,Williamsburg,45,89,South Carolina,SC
45091,45CS030,1502,1864,2312,2240,-72,376,738,224,-125.05361662077101,64.42796126576886,217.17503926995718,0.5295508274231678,1782,2270,2878,2837,-41,566,1055,370,-142.85706015938996,68.25045543719945,237.93880151274038,0.6055646481178396,284038,287910,York,York,45,91,South Carolina,SC
46003,46CS003,17,26,37,41,4,15,24,11,-306.77545080362506,161.8411085279708,558.3628125777828,0.7090673507276933,21,33,46,46,0,13,25,3,-109.25727812805863,364.1909270935288,801.2200396057633,0.21428571428571427,2737,2746,Douglas and Nearby Counties,Aurora,46,3,South Dakota,SD
46005,46CS001,131,172,220,195,-25,23,64,36,-384.5951767981926,-81.96290653076235,176.5354909893343,1,161,207,273,184,-89,-23,23,13,-533.6046528094747,-188.2387800209808,52.288550005828,-0.2826086956521739,19033,19125,Clark and Nearby Counties,Beadle,46,5,South Dakota,SD
46007,46CS010,22,32,44,32,-12,-0,10,3,-516.6739951033153,-108.61970560122421,241.14111397199653,-0.2592022394538908,28,40,56,50,-6,10,22,4,-293.85116438523886,176.3106986311433,528.93209589343,0.3076923076923077,3385,3403,Southwest Central South Dakota,Bennett,46,7,South Dakota,SD
46009,46CS003,58,72,90,95,5,23,37,21,-283.57890459590834,28.409421640191038,283.0937695880271,0.8946483231999679,71,92,115,106,-9,14,35,8,-243.2622827537623,92.73928668031996,385.2247292874829,0.4,6973,7009,Douglas and Nearby Counties,Bon Homme,46,9,South Dakota,SD
46011,46CS005,127,164,210,221,11,56,94,29,-62.54675321541468,95.55753963466132,226.03701648126233,0.5,151,200,265,203,-62,3,52,5,-193.668205895318,-5.781140474487104,136.001329662309,0.09090909090909091,34534,34595,Miner and Nearby Counties,Brookings,46,11,South Dakota,SD
46013,46CS007,231,293,371,390,19,97,159,58,-122.36011937466475,122.20344828711718,316.475596846124,0.58,274,356,461,372,-89,16,98,38,-333.1855787924318,-56.40543263021483,157.4105096657158,0.5205479452054794,38297,38117,Northeast South Dakota,Brown,46,13,South Dakota,SD
46015,46CS003,33,44,58,48,-10,4,15,3,-286.60543928927984,13.790172154890449,276.6363321685396,0.2946642462471143,39,55,72,49,-23,-6,10,2,-476.6387435802719,-152.524397945687,152.524397945687,-0.13333333333333333,5255,5245,Douglas and Nearby Counties,Brule,46,15,South Dakota,SD
46017,46CS006,13,21,30,31,1,10,18,12,-703.697375869289,-146.40861031423205,360.21754019036536,1.1487388341291507,17,26,39,53,14,27,36,5,467.27455625141965,1142.2266930590258,1609.5012493104455,0.18518518518518517,1947,1926,North Central South Dakota,Buffalo,46,17,South Dakota,SD
46019,46CS008,80,99,117,101,-16,2,21,19,-405.46791365255086,-194.16474895965925,26.24218019845911,1.0577413122538653,101,125,153,141,-12,16,40,22,-326.1136721958121,-57.54947156396684,172.6484146919005,1.0238095238095237,10295,10426,Northwest South Dakota,Butte,46,19,South Dakota,SD
46021,46CS006,7,12,20,16,-4,4,9,1,-412.7904822288708,232.7365920093549,734.8132053057526,0.18825144938918023,8,15,24,26,2,11,18,1,72.50974349678238,725.0974349678238,1232.6656394453005,0.09090909090909091,1376,1379,North Central South Dakota,Campbell,46,21,South Dakota,SD
46023,46CS003,80,97,115,130,15,33,50,16,-14.173837979915769,218.66157840002955,440.91356676270476,0.48505064225905653,96,119,144,117,-27,-2,21,13,-435.23597950763934,-163.21349231536473,87.04719590152787,-0.4482758620689655,9322,9190,Douglas and Nearby Counties,Charles Mix,46,23,South Dakota,SD
46025,46CS001,21,31,41,34,-7,3,13,3,-316.31485605162146,-7.564540117039357,301.18577581754255,0.35238830336983906,24,36,50,31,-19,-5,7,3,-570.7953839085429,-207.56195778492472,103.78097889246236,-0.2727272727272727,3834,3854,Clark and Nearby Counties,Clark,46,25,South Dakota,SD
46027,46CS002,73,90,109,98,-11,8,25,12,-181.6160613043106,-35.77311937744605,103.44059791637925,0.8486170643162457,88,111,137,115,-22,4,27,4,-171.86863066973677,0,152.0376348232287,0.19047619047619047,14882,15128,Clay+Turner+Union+Yankton,Clay,46,27,South Dakota,SD
46029,46CS001,165,210,270,300,30,90,135,68,-161.40180852387837,93.32036235283374,284.2029217109028,0.7514041514041514,198,258,336,280,-56,22,82,17,-256.95366180967534,17.599565877375024,228.7943564058753,0.30357142857142855,28290,28410,Clark and Nearby Counties,Codington,46,29,South Dakota,SD
46031,46CS008,31,44,56,56,0,12,25,14,-425.97261183572846,-48.21362837915364,329.5453550774214,1.056749215948501,40,54,71,57,-14,3,17,7,-541.9267431170465,-103.22414154610411,258.06035386526025,0.5384615384615384,3918,3875,Northwest South Dakota,Corson,46,31,South Dakota,SD
46033,46CS010,72,88,106,91,-15,3,19,11,-370.2687848283964,-113.25296277209091,120.397784551823,0.6796706754852773,88,112,137,96,-41,-16,8,2,-501.8661933303344,-210.0835227894423,70.0278409298141,-0.09523809523809523,8445,8568,Southwest Central South Dakota,Custer,46,33,South Dakota,SD
46035,46CS003,148,192,246,221,-25,29,73,52,-463.8646392111623,-138.55697015398354,126.50853796668063,1.2682926829268293,178,233,304,235,-69,2,57,14,-417.3694410978996,-60.342569797286686,216.22754177361062,0.2,19920,19886,Douglas and Nearby Counties,Davison,46,35,South Dakota,SD
46037,46CS007,51,66,82,93,11,27,42,25,-314.59365600520374,49.30713983689948,376.8178560947921,0.9181736950238941,63,81,104,71,-33,-10,8,6,-720.1412584776244,-295.4425675805639,37.85357897125891,-0.35294117647058826,5422,5416,Northeast South Dakota,Day,46,37,South Dakota,SD
46039,46CS001,31,43,56,40,-16,-3,9,7,-639.0516895583224,-272.0621909300715,49.053620369648264,-0.6379103855091066,39,54,70,41,-29,-13,2,5,-795.1472630271139,-420.9603157202368,-70.16005262003947,-0.3333333333333333,4301,4276,Clark and Nearby Counties,Deuel,46,39,South Dakota,SD
46041,46CS008,33,44,56,82,26,38,49,16,226.65413058119955,487.09563824704395,746.6103078073162,0.4254880594176241,39,53,70,92,22,39,53,11,209.8002129790041,534.0369057647378,801.0553586471066,0.28205128205128205,5322,5243,Northwest South Dakota,Dewey,46,41,South Dakota,SD
46043,46CS003,23,32,43,44,1,12,21,10,-370.26797749331183,81.9129607344079,464.5276007732474,0.7838045453017074,27,38,53,47,-6,9,20,8,-496.2009613893627,35.4429258135259,427.0872560529856,0.7272727272727273,2836,2821,Douglas and Nearby Counties,Douglas,46,43,South Dakota,SD
46045,46CS006,24,33,44,42,-2,9,18,10,-375.1349050995486,-26.812923800357908,246.8686329347203,1.0064278247128577,29,41,54,59,5,18,30,4,24.845749306389497,347.84049028945293,645.9894819661268,0.2222222222222222,3965,4025,North Central South Dakota,Edmunds,46,45,South Dakota,SD
46047,46CS010,90,109,130,109,-21,0,19,4,-430.0143478087024,-67.95558630719906,251.5080267823626,0.01292912506901877,115,140,169,149,-20,9,34,18,-530.1863209603813,-125.57044443798506,223.23634566752898,0.782608695652174,6949,7167,Southwest Central South Dakota,Fall River,46,47,South Dakota,SD
46049,46CS006,17,26,36,38,2,12,21,5,-176.77356519509883,372.58781025529333,876.1690710848197,0.39957370544099546,21,32,46,30,-16,-2,9,5,-983.2899242047349,-327.763308068245,187.29331889614,-0.34523809523809523,2155,2136,North Central South Dakota,Faulk,46,49,South Dakota,SD
46051,46CS007,70,86,106,94,-12,8,24,33,-724.0136961702931,-406.9524850519873,-142.73480912006602,2.315561015472879,87,110,136,96,-40,-14,9,8,-638.2218430317754,-292.5183447228971,13.29628839649532,-0.38095238095238093,7468,7521,Northeast South Dakota,Grant,46,51,South Dakota,SD
46053,46CS010,34,45,58,76,18,31,42,26,-225.40069014155804,142.745457819957,486.3485292507046,0.8446570160488377,39,53,70,75,5,22,36,7,-50.257833154464315,376.9337486584824,728.7385807397326,0.3181818181818182,4020,3979,Southwest Central South Dakota,Gregory,46,53,South Dakota,SD
46055,46CS010,15,22,31,24,-7,2,9,2,-594.6346827140188,-12.743810374256725,463.34872154009435,0.29696323347201947,17,27,40,28,-12,1,11,7,-1032.6320795307865,-326.0943409044589,217.39622726963924,0.7,1865,1840,Southwest Central South Dakota,Haakon,46,55,South Dakota,SD
46057,46CS001,40,53,66,90,24,37,50,28,-73.1903768807325,182.05001275658523,421.33787804157055,0.7490161620573662,49,64,85,53,-32,-11,4,5,-592.7429044402318,-256.32125597415427,-16.020078498384642,-0.3333333333333333,6184,6242,Clark and Nearby Counties,Hamlin,46,57,South Dakota,SD
46059,46CS006,27,37,49,42,-7,5,15,4,-434.036363009727,38.435613106368464,416.4131939992446,0.4388861065351897,33,46,62,58,-4,12,25,3,-225.79886428547428,290.3128255098955,711.2664224992425,0.21428571428571427,3132,3100,North Central South Dakota,Hand,46,59,South Dakota,SD
46061,46CS005,14,21,31,19,-12,-2,5,7,-666.2115833618354,-324.62492655715977,-68.43493395365284,-0.8609064247287542,17,27,39,34,-5,7,17,6,-315.8421265750422,28.58299788009432,314.41297668103755,0.6,3466,3499,Miner and Nearby Counties,Hanson,46,61,South Dakota,SD
46063,46CS008,6,14,26,11,-15,-3,5,6,-1914.0451927337174,-820.3050826001646,-91.14500917779607,-0.6666666666666666,8,17,30,11,-19,-6,3,5,-1810.580580265929,-829.8494326218841,-150.88171502216073,-0.5555555555555556,1317,1326,Northwest South Dakota,Harding,46,63,South Dakota,SD
46065,46CS006,132,155,179,175,-4,20,43,28,-218.8550445122731,-51.3665438487109,105.23520427171943,1.140693695369429,165,196,231,209,-22,13,44,20,-237.34903730006053,-39.55817288334342,135.6280213143203,0.7407407407407407,17671,17695,North Central South Dakota,Hughes,46,65,South Dakota,SD
46067,46CS003,78,95,113,103,-10,8,25,16,-429.4396468815984,-122.50594857221623,144.39291952289855,1.0645445756323781,92,115,141,109,-32,-6,17,6,-512.7513156119282,-161.92146808797733,148.42801241397922,-0.2727272727272727,7393,7411,Douglas and Nearby Counties,Hutchinson,46,67,South Dakota,SD
46069,46CS006,13,21,30,20,-10,-1,7,3,-1202.615061682867,-338.1571277698212,365.9262573177279,-0.2879198392076287,16,26,38,36,-2,10,20,4,-484.18008809387715,484.18008809387715,1291.1469015836724,0.36363636363636365,1261,1239,North Central South Dakota,Hyde,46,69,South Dakota,SD
46071,46CS010,14,21,31,42,11,21,28,13,-92.96440787099375,316.1722737902573,623.0247850361957,0.6303308966159763,16,26,37,70,33,44,54,5,974.5184066013888,1359.7931254903099,1708.4580294621842,0.11363636363636363,2894,2868,Southwest Central South Dakota,Jackson,46,71,South Dakota,SD
46073,46CS005,16,23,32,32,-0,9,16,15,-1059.0489203936688,-423.2445412562609,96.95904167434591,1.5303096597931614,18,27,39,12,-27,-15,-6,2,-1769.30409914204,-1037.1782650142993,-488.0838894184938,-0.13333333333333333,1707,1639,Miner and Nearby Counties,Jerauld,46,73,South Dakota,SD
46075,46CS010,5,11,21,3,-18,-8,-2,3,-2744.599745870394,-1437.6474859321113,-646.9413686694559,-0.375,5,13,23,13,-10,0,8,6,-1806.4637531166204,-677.4239074187327,225.80796913957755,0.75,918,886,Southwest Central South Dakota,Jones,46,75,South Dakota,SD
46077,46CS001,40,53,67,57,-10,4,17,12,-520.83702451404,-176.99337836325967,109.54299342905723,1.094933013459173,47,64,83,72,-11,8,25,4,-288.75190997357123,77.00050932628565,404.25267396299967,0.2761904761904762,5165,5195,Clark and Nearby Counties,Kingsbury,46,77,South Dakota,SD
46079,46CS005,65,80,97,91,-6,11,26,14,-213.4808291144996,-29.318445274477796,128.53502658839798,0.911330283899428,73,93,114,118,4,25,45,1,27.588268088995154,220.70614471196123,404.62793197192894,0.038461538461538464,11250,10874,Miner and Nearby Counties,Lake,46,79,South Dakota,SD
46081,46CS008,159,205,259,248,-11,43,89,36,-218.07408171172688,32.47911855281039,245.91332618556436,0.7058823529411765,188,249,326,305,-21,56,117,36,-218.27772809264678,76.58867652373571,310.37561161243883,0.5538461538461539,25863,26114,Northwest South Dakota,Lawrence,46,81,South Dakota,SD
46083,46CS004,207,261,336,323,-13,62,116,66,-145.37726556941504,-7.360874206046331,92.10293850315462,0.9705882352941176,255,329,425,310,-115,-19,55,14,-191.06954093525488,-48.85931693811245,60.7780291002883,-0.18543859649122807,65210,67541,Lincoln+Minnehaha,Lincoln,46,83,South Dakota,SD
46085,46CS006,21,30,41,51,10,21,30,2,253.92340612858422,624.2362123294677,915.1962743444471,0.09344666200415544,26,37,53,50,-3,13,24,4,-186.33333703042334,239.57143332483002,532.3809629440667,0.26666666666666666,3730,3757,North Central South Dakota,Lyman,46,85,South Dakota,SD
46087,46CS005,49,62,78,80,2,18,31,23,-448.24765046813576,-116.46619121756753,162.92872183554246,1.2541772329302743,59,77,97,74,-23,-3,15,4,-474.51322119785294,-123.0219462364804,193.3202012287549,-0.2222222222222222,5650,5690,Miner and Nearby Counties,McCook,46,87,South Dakota,SD
46089,46CS006,21,30,41,30,-11,0,9,8,-956.1397194858844,-380.1744292144632,31.229349550837348,0.6715527723773987,25,38,52,37,-15,-1,12,4,-786.2136742558125,-206.89833533047698,331.03733652876315,-0.18181818181818182,2398,2417,North Central South Dakota,McPherson,46,89,South Dakota,SD
46091,46CS007,17,26,36,41,5,15,24,6,-32.10943487008941,237.58241510138555,484.7999442419043,0.38676400948783274,18,29,41,53,12,24,35,4,185.8988013400205,464.7470033500513,720.35785519257945,0.16666666666666666,4390,4303,Northeast South Dakota,Marshall,46,91,South Dakota,SD
46093,46CS008,147,193,249,193,-56,0,46,18,-299.34814465461767,-72.76524785662549,113.39251124324123,0.25043478260869567,183,240,313,246,-67,6,63,28,-315.5047079520685,-73.02581351862712,116.17743059781587,0.49122807017543857,29684,30126,Northwest South Dakota,Meade,46,93,South Dakota,SD
46095,46CS010,16,25,35,27,-8,2,11,0,-466.43407925077605,144.66192254872783,653.9085907149813,-0,20,30,44,30,-14,0,10,2,-840.6809253601047,-104.75774770842428,419.0309908336971,0.18181818181818182,1937,1909,Southwest Central South Dakota,Mellette,46,95,South Dakota,SD
46097,46CS005,19,28,39,26,-13,-2,7,8,-1083.78748580912,-522.6018446941705,-47.752456058443656,-1.0378600143566559,23,34,48,40,-8,6,17,7,-649.0462625752713,-43.26975083835142,432.6975083835142,0.7,2285,2311,Miner and Nearby Counties,Miner,46,97,South Dakota,SD
46099,46CS004,1040,1294,1610,1619,9,325,579,267,-157.05122111659065,35.28557359969886,189.8120510880352,0.7694524495677233,1262,1600,2026,1681,-345,80,419,124,-235.31865597760924,-21.81895243531067,148.01776698069372,0.3980748619012284,197248,199368,Lincoln+Minnehaha,Minnehaha,46,99,South Dakota,SD
46101,46CS005,38,50,66,67,1,17,29,15,-259.98259503981933,34.901274192429874,267.7043288494689,0.8488497049721322,47,62,82,71,-11,9,24,11,-348.30448936780755,-31.664044487982505,206.60789028408516,0.7857142857142857,6357,6316,Miner and Nearby Counties,Moody,46,101,South Dakota,SD
46102,46CS010,104,125,146,191,45,66,87,33,101.84081187275208,288.58691206386175,468.15046993992877,0.4997491338813585,127,154,184,194,10,40,67,5,36.768648598961285,257.38054019272903,455.93124262711996,0.12195121951219512,13736,13599,Southwest Central South Dakota,Southwest Central South Dakota,46,102,South Dakota,SD
46103,46CS009,647,816,1012,1003,-9,187,356,129,-150.00398982904852,63.02232097127719,246.6563251806883,0.6498781787726511,792,1016,1293,1252,-41,236,460,130,-153.63420592702823,95.54477624075041,296.0990929414054,0.49242424242424243,110437,111466,Pennington,Pennington,46,103,South Dakota,SD
46105,46CS008,21,31,43,45,2,14,24,11,-371.7862973951208,117.17463359214044,536.2840030097926,0.7995183853805243,25,37,52,34,-18,-3,9,5,-815.6811750537507,-283.71519132304377,141.85759566152188,-0.40064102564102566,2825,2820,Northwest South Dakota,Perkins,46,105,South Dakota,SD
46107,46CS006,20,28,39,34,-5,6,14,5,-477.1905320840246,51.816170581098945,458.7444034004247,0.5873138389497318,24,35,49,32,-17,-3,8,7,-969.9255716835619,-404.13565486815077,40.41356548681508,-0.6363636363636364,2424,2474,North Central South Dakota,Potter,46,107,South Dakota,SD
46109,46CS007,81,97,118,108,-10,11,27,29,-450.73425754872005,-215.3289251886486,-18.357116479201245,1.8217054051551942,96,118,144,121,-23,3,25,10,-324.26988097821413,-68.78452020749997,147.39540044464277,0.47619047619047616,10268,10177,Northeast South Dakota,Roberts,46,109,South Dakota,SD
46111,46CS005,15,23,32,18,-14,-5,3,4,-931.0522137916056,-464.92197314725735,-41.16720892512252,-0.6001938360637772,18,28,41,30,-11,2,12,3,-593.0146670887411,-42.207449614857026,379.8670465337132,0.3333333333333333,2328,2369,Miner and Nearby Counties,Sanborn,46,111,South Dakota,SD
46115,46CS001,46,60,75,95,20,35,49,20,3.4884920095369045,283.5902240646409,548.13074878335,0.5717059821504122,54,72,93,68,-25,-4,14,10,-557.4080525556163,-222.96322102224656,63.70377743492758,-0.5555555555555556,6340,6279,Clark and Nearby Counties,Spink,46,115,South Dakota,SD
46117,46CS006,10,16,25,18,-7,2,8,6,-505.8814450748528,-177.47510268609673,85.24997122490805,0.8205639794420446,12,20,31,34,3,14,22,4,-33.07060574326186,330.7060574326186,595.2709033787135,0.2857142857142857,3004,3024,North Central South Dakota,Stanley,46,117,South Dakota,SD
46119,46CS006,8,17,31,10,-21,-7,2,3,-2001.302931596091,-833.8762214983713,-83.38762214983713,-0.3333333333333333,11,21,38,15,-23,-6,4,6,-1970.6107194427927,-815.4251252866729,-135.9041875477788,-0.6,1439,1472,North Central South Dakota,Sully,46,119,South Dakota,SD
46121,46CS010,59,74,91,118,27,44,59,23,47.46304922772436,266.4931216865526,454.23318379411967,0.5226505486311327,70,89,111,140,29,51,70,15,150.14833202155359,387.479566507235,591.9826710527201,0.29411764705882354,9459,9291,Southwest Central South Dakota,Todd,46,121,South Dakota,SD
46123,46CS010,53,67,84,81,-3,14,28,13,-341.5061998137717,12.568263746619175,331.2352809509707,0.8536926073515883,65,83,106,68,-38,-15,3,3,-735.6019376831529,-322.9471921535793,0,-0.16666666666666666,5573,5574,Southwest Central South Dakota,Tripp,46,123,South Dakota,SD
46125,46CS002,77,95,114,127,13,32,50,37,-337.8098934948926,-63.26987030855755,176.95264997948559,1.1401209315539802,94,117,142,109,-33,-8,15,5,-437.21079429979,-149.37556704066415,114.90428233897242,-0.2631578947368421,8625,8703,Clay+Turner+Union+Yankton,Turner,46,125,South Dakota,SD
46127,46CS002,99,119,139,142,3,23,43,26,-165.0074439642829,-23.057831858698822,118.59666670820422,1.1012126874660293,123,149,179,129,-50,-20,6,3,-314.23856438431966,-136.36767888376136,18.083540025889825,-0.12,16715,16866,Clay+Turner+Union+Yankton,Union,46,127,South Dakota,SD
46129,46CS006,47,60,76,69,-7,9,22,14,-466.9213315799431,-113.50685221649033,185.03537903526765,1.1408437952150765,54,72,91,86,-5,14,32,5,-190.33193095709203,171.29873786138285,513.8962135841485,0.29411764705882354,5304,5254,North Central South Dakota,Walworth,46,129,South Dakota,SD
46135,46CS002,167,214,278,228,-50,14,61,27,-398.52207542015896,-67.28294779820865,175.97078654916112,0.6506968641114983,200,260,343,268,-75,8,68,13,-377.8705954235076,-21.469920194517478,236.16912213969226,0.20634920634920634,23186,23288,Clay+Turner+Union+Yankton,Yankton,46,135,South Dakota,SD
46137,46CS008,7,13,20,23,3,10,16,1,109.2074217534834,453.8702484998496,715.8946197105374,0.09374053935991483,8,16,25,41,16,25,33,6,419.9622034016939,797.9281864632184,1133.8979491845735,0.24,2447,2381,Northwest South Dakota,Ziebach,46,137,South Dakota,SD
47001,47CS001,700,874,1082,928,-154,54,228,69,-346.64052767945526,-23.311400650938484,247.17855156878434,0.43670886075949367,846,1070,1370,1271,-99,200,425,140,-308.42666871625136,78.04187978809372,367.8932911663523,0.5773220419685066,77215,77522,Anderson,Anderson,47,1,Tennessee,TN
47003,47CS002,351,440,554,514,-40,74,163,68,-257.6695502339231,14.314975012995726,226.77306249754056,0.7391304347826086,427,543,694,668,-26,125,241,112,-270.687048533227,25.49026896727237,253.13797874422008,0.7777777777777778,50297,51000,Bedford+Lincoln+Moore,Bedford,47,3,Tennessee,TN
47005,47CS003,170,214,272,264,-8,50,94,34,-317.8645248922222,117.16766078072402,453.55223528022196,0.6181818181818182,202,263,344,331,-13,68,129,56,-435.28280774746656,75.6465415346792,460.4983215923594,0.7368421052631579,15875,15863,Benton+Carroll+Henry,Benton,47,5,Tennessee,TN
47007,47CS004,104,124,146,150,4,26,46,4,3.8389823491892336,175.02578522150984,333.0443724882673,0.1499394702282672,125,151,180,184,4,33,59,37,-217.58212820118942,-26.333691764137903,144.83530470275846,1.088235294117647,14984,15190,Bledsoe+Rhea+Van Buren+White,Bledsoe,47,7,Tennessee,TN
47009,47CS005,1041,1294,1608,1417,-191,123,376,105,-262.2138783449779,15.945438548005413,240.11172880204813,0.47085201793721976,1265,1606,2060,1917,-143,312,652,192,-244.05050277152867,87.03084178214765,335.05053357219265,0.5106382978723404,135462,137308,Blount+Loudon,Blount,47,9,Tennessee,TN
47011,47CS006,781,968,1215,1194,-21,226,413,72,-102.66972767410724,169.27822983861932,376.1064513775969,0.2938775510204082,936,1196,1536,1597,61,402,661,219,-143.9228137175342,165.97733651469193,402.0289403086003,0.5302663438256658,108815,109955,Bradley+Polk,Bradley,47,11,Tennessee,TN
47013,47CS007,400,504,631,548,-83,44,148,41,-377.9955435833737,7.617806198778189,326.1944614316819,0.422680412371134,478,617,778,779,1,162,301,80,-200.0804158013361,207.41585456017145,559.1374957381205,0.45714285714285713,39381,39534,Campbell+Claiborne+Hancock+Scott,Campbell,47,13,Tennessee,TN
47015,47CS008,121,157,203,181,-22,24,60,16,-313.34014756534356,65.9663468558618,362.8149077072399,0.47058823529411764,144,190,249,215,-34,25,71,27,-419.18276540367816,-13.743697226350104,302.3613389797023,0.6,14553,14552,Cannon+DeKalb+Warren,Cannon,47,15,Tennessee,TN
47017,47CS003,282,359,454,459,5,100,177,53,-203.43323007644932,199.19503778318997,525.5358443641608,0.5047619047619047,337,434,562,484,-78,50,147,73,-531.1380409301657,-80.90182080393254,260.4686882839652,0.7934782608695652,28314,28430,Benton+Carroll+Henry,Carroll,47,17,Tennessee,TN
47019,47CS009,518,650,813,786,-27,136,268,87,-243.16278560387033,105.49130488511466,385.7358825092071,0.5612903225806452,622,797,1020,955,-65,158,333,128,-343.65854644750766,53.41842690893902,365.0259172110833,0.6808510638297872,56308,56160,Carter+Johnson+Unicoi,Carter,47,19,Tennessee,TN
47021,47CS010,295,371,464,434,-30,63,139,29,-172.2852176099583,99.28300675828105,321.35573216908307,0.3670886075949367,356,455,584,565,-19,110,209,64,-200.67817323366424,110.95187462438167,349.8602046579686,0.5203252032520326,41095,41459,Cheatham+Dickson,Cheatham,47,21,Tennessee,TN
47023,47CS011,126,166,212,195,-17,29,69,27,-304.53913682224413,13.826975565141618,290.366486867974,0.7201280227596016,156,204,270,263,-7,59,107,41,-274.5821976824976,102.96832413093662,377.5505218134343,0.6307692307692307,17357,17481,Chester+Madison,Chester,47,23,Tennessee,TN
47025,47CS007,285,361,455,409,-46,48,124,24,-262.3227074849038,89.87501755371437,374.6664794270466,0.3380281690140845,337,440,572,598,26,158,261,111,-263.8550736065428,144.2593876861169,465.3528635036029,0.6809815950920245,32044,32234,Campbell+Claiborne+Hancock+Scott,Claiborne,47,25,Tennessee,TN
47027,47CS035,73,90,107,137,30,47,64,19,176.50618036056682,450.54273870159955,711.5299371216306,0.40096569012165445,84,107,132,139,7,32,55,16,-119.1287058817041,211.7843660119184,516.2243921540511,0.48484848484848486,7560,7555,North Central Tennessee,Clay,47,27,Tennessee,TN
47029,47CS012,361,459,576,571,-5,112,210,65,-232.9288082444782,156.39505696414963,482.4953885064191,0.5371900826446281,436,563,736,737,1,174,301,97,-264.16210009557136,211.76972105527327,561.0522479905941,0.5300546448087432,36063,36360,Cocke+Jefferson,Cocke,47,29,Tennessee,TN
47031,47CS013,472,595,744,669,-75,74,197,70,-300.11951070657153,8.276305017761366,262.8761381266453,0.6306306306306306,569,728,935,875,-60,147,306,129,-321.072391976586,30.562152594281056,300.6127287120811,0.7350487012987013,57997,58896,Coffee+Franklin,Coffee,47,31,Tennessee,TN
47033,47CS014,138,161,187,208,21,47,70,27,-48.45459921923971,170.96837439820183,369.1568666978266,0.5762026885915222,167,199,233,212,-21,13,45,23,-315.07010757436296,-71.60684263053703,157.53505378718148,0.8846153846153846,13938,13965,Crockett+Gibson+Haywood,Crockett,47,33,Tennessee,TN
47035,47CS015,590,736,924,865,-59,129,275,64,-240.76054963006192,127.17948578589211,412.84417693574204,0.4155844155844156,712,906,1162,1248,86,342,536,182,-154.22518603262532,257.7110084147461,568.4093269708419,0.5170454545454546,61331,62279,Cumberland+Fentress,Cumberland,47,35,Tennessee,TN
47037,47CS016,3763,4694,5813,5572,-241,878,1809,539,-131.66146735780856,57.13037649098603,214.36127379970856,0.5326107758704866,4485,5626,7177,5938,-1239,312,1453,687,-272.8819126392529,-53.14363025614492,108.54055043515025,0.6358168876554631,711005,705635,Davidson,Davidson,47,37,Tennessee,TN
47039,47CS017,118,141,166,199,33,58,81,22,114.69555908320851,382.2511150507896,623.9141978602177,0.3766331821457834,141,169,199,210,11,41,69,22,-96.5538680979071,166.77486307820317,412.54834550923937,0.5365853658536586,11431,11393,Decatur+Henderson+Lewis+Perry,Decatur,47,39,Tennessee,TN
47041,47CS008,166,219,277,274,-3,55,108,30,-195.6745305015704,148.23828068300787,462.50343573098456,0.4918032786885246,203,267,344,335,-9,68,132,45,-264.2754092343456,112.56174837759164,425.77704821089014,0.6164383561643836,20238,20433,Cannon+DeKalb+Warren,DeKalb,47,41,Tennessee,TN
47043,47CS010,409,511,640,565,-75,54,156,68,-315.33361602201904,-30.861031976988933,194.09384754099096,0.7391304347826086,488,624,802,771,-31,147,283,140,-310.06089133065154,12.688840919699272,259.30552765185433,0.8383233532934131,54438,55167,Cheatham+Dickson,Dickson,47,43,Tennessee,TN
47045,47CS018,325,408,504,533,29,125,208,63,-111.1347559989445,202.65749623336936,474.1204811072616,0.4883720930232558,382,496,640,627,-13,130,245,85,-267.6168277734382,124.25067003766775,437.0619722973344,0.5902777777777778,36712,36620,Dyer+Lake+Lauderdale,Dyer,47,45,Tennessee,TN
47047,47CS019,292,372,466,461,-5,90,169,41,-131.26761233249704,138.40172169839363,365.26639953390486,0.422680412371134,359,460,584,565,-19,105,206,83,-238.81994164064386,51.48494577260328,287.96466260540143,0.6974789915966386,42052,42731,Fayette+Hardeman,Fayette,47,47,Tennessee,TN
47049,47CS015,172,220,278,273,-5,53,101,32,-239.83353871638954,135.7548332356922,446.0515949172744,0.5423728813559322,209,270,350,378,28,108,169,62,-181.09615026637,244.65265527909017,569.3492771223173,0.5636363636363636,18563,18802,Cumberland+Fentress,Fentress,47,49,Tennessee,TN
47051,47CS013,338,434,535,546,11,112,208,51,-112.56272003181321,172.63359805377843,440.7069088527351,0.42857142857142855,412,528,675,650,-25,122,238,81,-245.87670824156243,95.01361958439264,363.9485111153381,0.5827338129496403,42750,43152,Coffee+Franklin,Franklin,47,51,Tennessee,TN
47053,47CS014,466,580,732,724,-8,144,258,87,-227.17316119523502,136.2321955615823,408.81608861067804,0.5594913151364764,546,702,898,919,21,216,373,102,-160.54067830581084,226.6573078423594,536.6532415376735,0.44933920704845814,50208,50517,Crockett+Gibson+Haywood,Gibson,47,53,Tennessee,TN
47055,47CS020,272,345,431,413,-18,68,141,43,-242.36788791037026,99.33110160261074,389.5765804854392,0.5443037974683544,331,424,546,526,-20,102,195,79,-324.5265443181562,75.39505575068274,380.25332465561735,0.6929824561403509,30202,30506,Giles+Marshall,Giles,47,55,Tennessee,TN
47057,47CS021,198,256,326,332,6,76,134,27,-107.34119659300057,249.86786855377815,545.6298354133523,0.34177215189873417,243,315,406,394,-12,79,151,59,-299.4315857125548,84.287568110501,387.93353222858065,0.6555555555555556,23532,23728,Grainger+Hamblen,Grainger,47,57,Tennessee,TN
47059,47CS022,679,848,1055,931,-124,83,252,88,-362.9834224589395,-8.55891116385144,281.0746426208809,0.5517295597484277,809,1040,1346,1286,-60,246,477,167,-321.70052503675083,111.957451444508,439.3975673464519,0.6072727272727273,70102,70563,Greene,Greene,47,59,Tennessee,TN
47061,47CS023,144,168,192,197,5,29,53,17,-110.2530586991158,108.98402254733755,320.5605735006539,0.5497062457036693,172,201,235,246,11,45,74,42,-227.7949661598943,22.0446741445059,235.51060211047104,0.9231884057971014,13523,13609,Grundy+Marion+Sequatchie,Grundy,47,61,Tennessee,TN
47063,47CS021,527,659,830,859,29,200,332,79,-93.2059606390081,225.10820832974008,470.77381915570845,0.3798076923076923,629,800,1021,1111,90,311,482,169,-122.70569152355364,220.28076101573475,485.5484380135562,0.5339665774867228,64502,64463,Grainger+Hamblen,Hamblen,47,63,Tennessee,TN
47065,47CS024,2575,3183,3968,3584,-384,401,1009,257,-209.4200002348032,47.04232124453891,245.79612850271567,0.4500875656742557,3103,3904,4982,4514,-468,610,1411,527,-269.66913608810745,22.36849359266928,239.70891133671407,0.6277548385265905,367329,368822,Hamilton,Hamilton,47,65,Tennessee,TN
47067,47CS007,67,84,101,94,-7,10,27,6,-237.30750636682856,74.86820495104371,372.17840620616056,0.4210110937223417,83,104,128,126,-2,22,43,18,-296.4688051604794,59.145896291367464,370.4011755246881,0.75,6637,6763,Campbell+Claiborne+Hancock+Scott,Hancock,47,67,Tennessee,TN
47069,47CS019,204,257,330,333,3,76,129,50,-222.40606358848305,123.03314155958635,373.83146858489704,0.625,244,316,408,383,-25,67,139,42,-263.7306446749092,98.33357370429128,381.7309331200585,0.5350535540408958,25359,25424,Fayette+Hardeman,Hardeman,47,69,Tennessee,TN
47071,47CS025,275,348,438,404,-34,56,129,36,-315.3328239415195,92.34746986858785,418.94218037944734,0.4864864864864865,325,425,546,530,-16,105,205,71,-323.67777319613197,126.49476193871824,498.5381794055366,0.6120689655172413,26639,26879,Hardin+McNairy,Hardin,47,71,Tennessee,TN
47073,47CS026,508,634,796,767,-29,132,259,55,-177.6936688408811,163.84603611146082,431.4964641335373,0.36423841059602646,615,786,997,1039,42,253,424,155,-198.08478701988093,171.33547332699325,470.2983910710325,0.5961538461538461,56761,57198,Hawkins,Hawkins,47,73,Tennessee,TN
47075,47CS014,148,190,242,230,-12,40,82,40,-352.79913579462414,0,285.01832200122817,0.8695652173913043,173,229,298,286,-12,57,113,41,-299.28742769279273,90.35092156763554,406.57914705435996,0.6307692307692307,17704,17709,Crockett+Gibson+Haywood,Haywood,47,75,Tennessee,TN
47077,47CS017,231,290,362,366,4,76,135,55,-219.83861694738863,90.4331235239013,344.50713723390976,0.6962025316455697,275,352,452,436,-16,84,161,74,-322.3749421054162,37.589526841830875,311.4560795465987,0.7551020408163265,27866,27933,Decatur+Henderson+Lewis+Perry,Henderson,47,77,Tennessee,TN
47079,47CS003,318,402,506,473,-33,71,155,46,-294.810877629903,93.29458152845031,406.7643754640434,0.5348837209302325,377,490,634,567,-67,76,190,71,-428.2932153285521,17.069657132659685,369.3253088702732,0.6698113207547169,32156,32221,Benton+Carroll+Henry,Henry,47,79,Tennessee,TN
47081,47CS027,194,249,316,326,10,77,132,34,-115.14895063188652,206.3085365487967,470.1915484135366,0.425,234,306,392,378,-14,72,144,60,-293.22353674904986,47.517656191608346,332.62359334125847,0.7317073170731707,25011,25254,Hickman+Houston+Humphreys+Stewart,Hickman,47,81,Tennessee,TN
47083,47CS027,86,104,125,128,3,24,42,17,-202.49634577765372,95.4989709965941,357.73484975793207,0.6964631987424653,106,129,158,141,-17,12,35,23,-481.21265589284997,-132.33348037053372,144.36379676785498,1.15,8277,8312,Hickman+Houston+Humphreys+Stewart,Houston,47,83,Tennessee,TN
47085,47CS027,171,220,280,241,-39,21,70,19,-367.7238639775385,12.66921150654741,323.0648934169589,0.4318181818181818,206,269,351,350,-1,81,144,43,-229.7089853107492,198.15985111937502,526.688025343602,0.5,18944,19176,Hickman+Houston+Humphreys+Stewart,Humphreys,47,85,Tennessee,TN
47087,47CS028,114,136,159,170,11,34,56,23,-120.12299671692617,108.27007874288262,336.6631542026914,0.6860956098327746,139,167,199,182,-17,15,43,21,-323.9389843873486,-51.14826069273926,187.54362254004394,0.875,11663,11731,Jackson+Putnam+Smith,Jackson,47,87,Tennessee,TN
47089,47CS012,439,554,694,642,-52,88,203,61,-247.08685385528696,60.1051612651074,310.36119635073635,0.5350877192982456,526,679,872,891,19,212,365,132,-203.64217161273763,144.10768446721812,419.71363101077276,0.5986425339366516,54904,55514,Cocke+Jefferson,Jefferson,47,89,Tennessee,TN
47091,47CS009,171,219,277,258,-19,39,87,33,-347.4560836715825,40.091086577490294,360.8197791974126,0.673469387755102,208,273,350,303,-47,30,95,44,-501.92252036217803,-77.17644464657323,281.41839280054,0.7719298245614035,17959,18140,Carter+Johnson+Unicoi,Johnson,47,91,Tennessee,TN
47093,47CS029,3272,4036,4951,4556,-395,520,1284,287,-170.6179527208625,58.453953430153916,249.61214974392487,0.3806426306096495,3927,4959,6284,5783,-501,824,1856,606,-227.9288990921112,44.881672840827605,257.4416871734535,0.5598153619285103,479352,485722,Knox+Union,Knox,47,93,Tennessee,TN
47095,47CS018,65,81,100,93,-7,12,28,12,-330.907369941421,-6.735542857081179,275.153002433649,0.7634628417995751,82,102,127,137,10,35,55,16,-84.4307374790389,267.36400201695653,548.7997936137529,0.45714285714285713,7000,7106,Dyer+Lake+Lauderdale,Lake,47,95,Tennessee,TN
47097,47CS018,194,252,317,296,-21,44,102,32,-252.63241520163916,57.19979212112585,333.6654540399008,0.5614035087719298,234,303,389,358,-31,55,124,51,-327.00260885150783,15.931917605432783,290.95664526921604,0.6939096630877453,25175,25107,Dyer+Lake+Lauderdale,Lauderdale,47,97,Tennessee,TN
47099,47CS030,388,482,607,595,-12,113,207,62,-200.66993552517903,138.29955015924503,393.3401911882055,0.5081967213114754,464,597,752,694,-58,97,230,102,-357.77505494183083,-11.176977661413021,286.46593746201546,0.7786259541984732,44252,44735,Lawrence+Wayne,Lawrence,47,99,Tennessee,TN
47101,47CS017,123,146,172,171,-1,25,48,15,-151.39192781142225,92.12187326006337,311.7156391216286,0.5530224974070206,155,184,220,224,4,40,69,27,-179.40980026033924,101.40553927758305,327.617896127576,0.6428571428571429,12580,12820,Decatur+Henderson+Lewis+Perry,Lewis,47,101,Tennessee,TN
47103,47CS002,303,380,480,461,-19,81,158,42,-208.3273892008777,132.974929277156,395.5151742602589,0.45652173913043476,363,468,597,550,-47,82,187,94,-398.4196866198095,-33.8840272107563,262.6012108833613,0.8545454545454545,35195,35415,Bedford+Lincoln+Moore,Lincoln,47,103,Tennessee,TN
47105,47CS005,466,584,725,600,-125,16,134,47,-374.75063463650395,-67.50301960332146,189.44395824157957,0.4051724137931034,563,728,939,834,-105,106,271,94,-353.1848519300405,21.254855682850984,313.509121322052,0.6064516129032258,55109,56458,Blount+Loudon,Loudon,47,105,Tennessee,TN
47107,47CS031,472,590,733,708,-25,118,236,61,-193.2490487295937,126.81267425344998,392.89484297462684,0.45185185185185184,566,724,929,948,19,224,382,123,-192.7692977822263,187.20864496158515,480.16237106236264,0.529034704750629,53465,53950,McMinn+Meigs+Monroe,McMinn,47,107,Tennessee,TN
47109,47CS025,258,326,413,404,-9,78,146,35,-204.76169724437466,199.8808849377551,516.2040063334347,0.4117647058823529,301,397,511,464,-47,67,163,50,-375.3344726149413,65.74637851060281,437.02004539400696,0.5464644051600573,25815,25857,Hardin+McNairy,McNairy,47,109,Tennessee,TN
47111,47CS035,186,239,301,301,0,62,115,41,-195.23631977553114,99.99909061673546,352.377747887544,0.6119402985074627,222,293,376,342,-34,49,120,59,-362.8206378620891,-39.01297181312786,238.1741929191454,0.9008158508158508,25200,25632,North Central Tennessee,Macon,47,111,Tennessee,TN
47113,47CS011,704,882,1098,1128,30,246,424,155,-152.14321955149828,111.2798128614076,327.2721053661724,0.6078431372549019,837,1065,1379,1300,-79,235,463,171,-253.1503534748695,64.79353178320994,295.72172865430656,0.6321648216482165,98670,98775,Chester+Madison,Madison,47,113,Tennessee,TN
47115,47CS023,246,315,396,359,-37,44,113,36,-303.9012534713319,33.28145144107673,320.3339701203636,0.5373134328358209,290,380,489,476,-13,96,186,72,-294.5890265154658,81.3973206715279,394.86359815124166,0.6792452830188679,28845,28871,Grundy+Marion+Sequatchie,Marion,47,115,Tennessee,TN
47117,47CS020,250,315,399,369,-30,54,119,31,-212.30359617108752,79.98333680483233,306.19707850719493,0.45588235294117646,299,387,501,466,-35,79,167,67,-292.366561201267,34.379213468056875,286.6366922899241,0.6979166666666666,34507,34905,Giles+Marshall,Marshall,47,117,Tennessee,TN
47119,47CS032,706,879,1095,909,-186,30,203,105,-344.7069602154419,-88.84200005552624,116.14610807259128,0.6176470588235294,858,1092,1404,1199,-205,106,341,143,-333.7048088099603,-34.99059328228541,189.90785011563662,0.6651162790697674,101303,104314,Maury,Maury,47,119,Tennessee,TN
47121,47CS031,131,155,179,156,-23,1,25,17,-378.6171856736789,-146.4847591350239,77.90991985234234,0.6513353007307651,162,194,228,211,-17,17,49,29,-353.5605856807963,-92.23319626455556,153.72199377425926,1.0357142857142858,12750,13010,McMinn+Meigs+Monroe,Meigs,47,121,Tennessee,TN
47123,47CS031,403,514,643,606,-37,92,203,53,-232.60970175759593,102.03312847779057,387.46757649793886,0.4649122807017544,492,627,804,824,20,197,332,127,-229.4639499916492,150.04648761714566,439.42185659306944,0.6195121951219512,46456,46652,McMinn+Meigs+Monroe,Monroe,47,123,Tennessee,TN
47125,47CS033,1017,1270,1572,1493,-79,223,476,112,-104.13864490224087,60.48869484117602,198.35932362331596,0.41025641025641024,1250,1587,2035,1949,-86,362,699,304,-171.97911865751257,25.559997135517563,174.0944287652795,0.7496928784285106,220206,226917,Montgomery,Montgomery,47,125,Tennessee,TN
47127,47CS002,44,58,72,68,-4,10,24,8,-213.66726944990663,45.403584409037556,289.23497627627904,0.5823234260360403,54,70,90,95,5,25,41,17,-181.3584884273763,120.9056589515842,362.7169768547526,0.68,6474,6617,Bedford+Lincoln+Moore,Moore,47,127,Tennessee,TN
47129,47CS034,165,208,268,227,-41,19,62,11,-295.7681806287246,45.502797019803786,290.08033100124914,0.28205128205128205,194,257,333,335,2,78,141,42,-188.5025241666127,169.6522717499514,466.54374731236635,0.5060240963855421,21098,21220,Morgan+Roane,Morgan,47,129,Tennessee,TN
47131,47CS036,264,335,424,455,31,120,191,72,-160.8655038714861,188.10095458785221,466.3336165823836,0.5853658536585366,312,406,525,497,-28,91,185,74,-334.3992765610422,55.73321276017371,363.90509508113416,0.6981132075471698,30622,30502,Obion+Weakley,Obion,47,131,Tennessee,TN
47133,47CS035,213,272,345,343,-2,71,130,42,-234.2263168583719,154.20120746635158,467.92090541513573,0.5454545454545454,257,335,434,404,-30,69,147,55,-372.76784694590754,61.397057144031834,403.6856507220091,0.6470588235294118,22568,22802,North Central Tennessee,Overton,47,133,Tennessee,TN
47135,47CS017,93,112,134,112,-22,0,19,17,-561.8807788483716,-242.15514533137812,30.20372766457932,0.6730957030061545,115,139,166,145,-21,6,30,21,-496.7083218354556,-177.39582922694842,106.43749753616905,0.9545454545454546,8331,8456,Decatur+Henderson+Lewis+Perry,Perry,47,135,Tennessee,TN
47137,47CS035,53,67,82,79,-3,12,26,18,-507.69933924061297,-133.87503456939191,180.92437989058374,1.2811283848617772,65,84,105,80,-25,-4,15,4,-572.3590072531703,-157.89213993190901,217.1016924063749,-0.2,5014,5067,North Central Tennessee,Pickett,47,137,Tennessee,TN
47139,47CS006,167,213,270,246,-24,33,79,13,-254.10391171224444,137.3534657904024,453.266437108328,0.29545454545454547,201,263,345,347,2,84,146,41,-220.33367026728135,242.3106859716905,591.6888843494768,0.4632916241062308,17473,17746,Bradley+Polk,Polk,47,139,Tennessee,TN
47141,47CS028,566,709,883,924,41,215,358,118,-115.35007494165784,145.31113336806249,359.53270111685566,0.5339366515837104,675,863,1095,1043,-52,180,368,91,-176.64022515148196,109.86009810259884,341.92412555527955,0.4252336448598131,80104,81012,Jackson+Putnam+Smith,Putnam,47,141,Tennessee,TN
47143,47CS004,284,358,453,431,-22,73,147,46,-247.66875390963142,98.2668090457024,367.77263163215633,0.5509179575444636,336,434,564,552,-12,118,216,66,-235.78620892354883,157.09010716239,453.29558807147333,0.5196850393700787,32971,33102,Bledsoe+Rhea+Van Buren+White,Rhea,47,143,Tennessee,TN
47145,47CS034,527,656,822,750,-72,94,223,54,-282.4254306119591,89.62330205853522,378.7704803248843,0.42857142857142855,637,814,1036,923,-113,109,286,114,-421.0700380911831,-9.272628013459219,319.1638562232662,0.6705882352941176,53558,53922,Morgan+Roane,Roane,47,145,Tennessee,TN
47147,47CS037,482,600,753,769,16,169,287,73,-94.01422080673453,158.20096752754628,352.73871978407584,0.4124293785310734,575,736,949,959,10,223,384,116,-143.673771250477,144.75605954614917,362.8371511240858,0.48945147679324896,72819,73917,Robertson,Robertson,47,147,Tennessee,TN
47149,47CS038,1538,1890,2352,2287,-65,396,749,235,-105.15480436560921,56.58947319242215,180.10519641427237,0.5292792792792793,1868,2374,2992,2886,-106,512,1018,432,-153.35105399457692,22.658505329558338,167.04591161829106,0.7340701985378193,342467,350862,Rutherford,Rutherford,47,149,Tennessee,TN
47151,47CS007,183,232,291,242,-49,10,59,28,-422.15434637558525,-98.68543162026668,169.95824334601485,0.6363636363636364,217,281,361,377,16,96,160,56,-182.5978539045983,182.5978539045983,474.7544201519556,0.5656565656565656,21888,21906,Campbell+Claiborne+Hancock+Scott,Scott,47,151,Tennessee,TN
47153,47CS023,120,143,167,165,-2,22,45,12,-105.5231834263748,75.52344120596341,250.32707878201427,0.4755408953735615,147,176,209,229,20,53,82,48,-171.89321274593786,30.640501380737593,208.35540938901562,0.9056603773584906,15803,16318,Grundy+Marion+Sequatchie,Sequatchie,47,153,Tennessee,TN
47155,47CS039,755,944,1165,1105,-60,162,350,86,-177.70673865998518,91.89629293718413,321.39359139156903,0.4215686274509804,909,1162,1481,1479,-2,318,570,219,-222.45536174784198,99.12622995775814,353.23154025556454,0.6347826086956522,98589,99368,Sevier,Sevier,47,155,Tennessee,TN
47157,47CS040,5770,7094,8753,9054,301,1960,3284,955,-84.46409633939425,129.75606362135616,300.71129132388114,0.46882681892760536,6830,8617,10981,12568,1587,3951,5738,1620,-3.5348865784707626,251.98228178640232,445.13086264519865,0.4081633689471761,929436,925065,Shelby,Shelby,47,157,Tennessee,TN
47159,47CS028,152,175,203,217,14,42,65,21,-42.450453639535006,125.36105977548436,263.55877670550024,0.49175601835366606,182,212,248,286,38,74,104,39,-4.965731281520756,173.80059485322644,323.02081986292495,0.527027027027027,19989,20138,Jackson+Putnam+Smith,Smith,47,159,Tennessee,TN
47161,47CS027,119,141,162,158,-4,17,39,20,-209.8507097958663,-22.66085211018611,164.52900557549395,0.9661427758163946,144,172,202,208,6,36,64,25,-137.38332961755614,79.53771714700619,281.997360793931,0.6756756756756757,13703,13830,Hickman+Houston+Humphreys+Stewart,Stewart,47,161,Tennessee,TN
47163,47CS041,1449,1792,2227,2145,-82,353,696,184,-201.71964427689116,128.1361393828025,388.1994281893188,0.456575682382134,1739,2189,2753,2690,-63,501,951,319,-240.2354269470513,114.39782235573873,397.34386484714406,0.5847850925832577,158269,159094,Sullivan,Sullivan,47,163,Tennessee,TN
47165,47CS042,1192,1471,1831,1729,-102,258,537,188,-176.88492265159678,42.689000467546194,212.86565161709996,0.5921274527309882,1406,1814,2300,2298,-2,484,892,337,-169.48395422158927,73.47136912584376,277.4168941040788,0.6524691496858741,196772,200078,Sumner,Sumner,47,165,Tennessee,TN
47167,47CS043,405,510,635,598,-37,88,193,64,-198.5413530603035,47.15479934138827,253.45704645996193,0.5844870725604671,486,616,793,804,11,188,318,126,-188.53160858788803,101.64312810825268,314.7658160771696,0.6395939086294417,61075,60998,Tipton,Tipton,47,167,Tennessee,TN
47169,47CS035,62,78,95,107,12,29,45,13,-5.640373066033275,163.8175581433429,324.8025927922503,0.44989382229505015,72,91,114,152,38,61,80,20,150.24466927044386,342.2239688937888,501.23291053834157,0.32786885245901637,11644,11980,North Central Tennessee,Trousdale,47,169,Tennessee,TN
47171,47CS009,189,246,312,291,-21,45,102,26,-316.1918095904795,127.68638431921595,510.7455372768638,0.45614035087719296,227,297,384,375,-9,78,148,34,-242.6274293600349,248.26992771724503,643.244812721953,0.3953488372093023,17856,17723,Carter+Johnson+Unicoi,Unicoi,47,171,Tennessee,TN
47173,47CS029,149,192,243,247,4,55,98,17,-78.85262548359755,229.6091776533875,489.4300892085365,0.29310344827586204,181,234,305,349,44,115,168,48,-19.992086465773966,334.8674483017139,599.7625939732189,0.41379310344827586,19860,20008,Knox+Union,Union,47,173,Tennessee,TN
47175,47CS004,71,88,107,77,-30,-11,6,6,-700.8154121803462,-331.46746959057725,5.76326060008146,-0.39785553536175355,90,115,139,146,7,31,56,36,-460.19419401549186,-79.34382655439515,317.3753062175806,1.125,6144,6302,Bledsoe+Rhea+Van Buren+White,Van Buren,47,175,Tennessee,TN
47177,47CS008,345,436,542,503,-39,67,158,51,-262.99557194300377,46.702876260688804,312.6173779699854,0.5828761755485894,417,529,678,612,-66,83,195,90,-376.4769270668936,-16.88778269444573,253.43736743593183,0.7758620689655172,41111,41450,Cannon+DeKalb+Warren,Warren,47,177,Tennessee,TN
47179,47CS044,1036,1290,1595,1539,-56,248,503,151,-187.18474037442596,88.16672553867889,318.3496997527374,0.5316901408450704,1247,1590,2007,1902,-105,312,655,199,-226.9007694511903,84.65889984454338,340.1273861595752,0.5452054794520548,132703,134067,Washington,Washington,47,179,Tennessee,TN
47181,47CS030,135,176,225,196,-29,20,61,19,-353.63412528379115,11.051066415118473,309.4298596233172,0.5277777777777778,164,213,277,264,-13,51,100,32,-275.05046534967045,116.00352589664239,415.47578617192147,0.5517241379310345,16288,16379,Lawrence+Wayne,Wayne,47,181,Tennessee,TN
47183,47CS036,259,331,420,380,-40,49,121,35,-273.2159221638195,51.00030547057965,313.28759074784637,0.5109761295822677,315,403,521,496,-25,93,181,59,-254.61274174452393,102.99623104478066,369.7261764416316,0.5462962962962963,32941,33011,Obion+Weakley,Weakley,47,183,Tennessee,TN
47185,47CS004,252,318,405,346,-59,28,94,32,-397.9470983024082,-17.492180145160802,271.1287922499924,0.5517241379310345,294,389,502,483,-19,94,189,73,-333.30869073896093,76.04000549177816,420.03050652601274,0.6822429906542056,27441,27617,Bledsoe+Rhea+Van Buren+White,White,47,185,Tennessee,TN
47187,47CS045,1002,1252,1576,1390,-186,138,388,138,-156.48511451914433,0,120.75020177599764,0.6160714285714286,1228,1567,2006,1670,-336,103,442,173,-199.77266154982095,-27.470948450029404,105.56693047225585,0.5635179153094463,248496,254815,Williamson,Williamson,47,187,Tennessee,TN
47189,47CS046,833,1033,1287,1283,-4,250,450,144,-119.73978844959392,85.75957821389834,247.61055577701495,0.5454545454545454,1017,1276,1636,1558,-78,282,541,244,-212.70832057860272,24.764240986332204,196.19882658771454,0.7427718882052042,148322,151428,Wilson,Wilson,47,189,Tennessee,TN
48001,48CS001,450,559,701,612,-89,53,162,76,-341.9202298342923,-47.6471692589441,178.15898070735622,0.7755102040816326,537,690,891,884,-7,194,347,138,-248.60259268215407,95.15478547489346,358.4163586220986,0.6602870813397129,57926,58326,Anderson+Houston,Anderson,48,1,Texas,TX
48003,48CS043,89,108,128,128,-0,20,39,32,-207.8253652394667,-75.39533565790997,46.44029155712232,1.458350995030917,104,128,154,158,4,30,54,35,-167.8844305242778,-27.07813395552868,103.16769037056402,1.1290322580645162,18625,18465,Gaines and Nearby Counties,Andrews,48,3,Texas,TX
48005,48CS002,608,768,949,990,41,222,382,163,-169.4004522841652,82.61743369596583,304.08769713305065,0.7149122807017544,728,934,1190,1257,67,322,529,262,-225.59471916410854,69.95633269824995,308.7329062881445,0.7879717066464055,86422,86483,Angelina,Angelina,48,5,Texas,TX
48007,48CS003,222,283,358,380,22,97,158,23,-5.021472023600918,371.58892974646795,678.1497967873038,0.23469387755102042,267,354,454,429,-25,75,162,46,-290.90983535240315,118.73870830710334,474.95483322841335,0.5,23897,24423,Aransas+Calhoun+Refugio,Aransas,48,7,Texas,TX
48009,48CS004,63,78,96,76,-20,-2,13,5,-351.93616834196354,-99.24964668556278,107.49387103331068,-0.2958054549926621,78,99,122,112,-10,13,34,22,-369.3906017026598,-103.89110672887308,138.52147563849744,1.1578947368421053,8590,8663,Archer+Wichita,Archer,48,9,Texas,TX
48011,48CS034,16,24,35,34,-1,10,18,4,-294.3291964367363,400.0540066126341,880.7808394929677,0.3643057827864212,19,30,43,31,-12,1,12,1,-706.4577483923557,0,597.771940947378,0.1,1847,1840,Eastern Central Panhandle,Armstrong,48,11,Texas,TX
48013,48CS005,276,346,438,485,47,139,209,89,-101.98751178481092,121.26933624828884,291.0464069958932,0.6312056737588653,331,424,549,627,78,203,296,136,-116.43069655166069,134.49752877519424,321.18812841837433,0.6699507389162561,49477,49815,Atascosa+Live Oak+McMullen,Atascosa,48,13,Texas,TX
48015,48CS006,187,241,307,271,-36,30,84,19,-219.19944586273903,43.800070926251216,258.8186009278481,0.41304347826086957,228,296,384,365,-19,69,137,42,-201.05153799620007,88.9900250147115,313.1130509776886,0.5384615384615384,30137,30340,Austin+Waller+Washington,Austin,48,15,Texas,TX
48017,48CS094,37,49,63,59,-4,10,22,14,-306.7082397278553,-61.37609804591076,140.0696487897037,1.0802823761231437,43,59,77,82,5,23,39,19,-204.72325802442055,58.49235943554873,292.4617971777437,0.7916666666666666,6856,6838,Western Central Panhandle,Bailey,48,17,Texas,TX
48019,48CS007,192,219,247,264,17,45,72,15,8.607860580389413,167.90379970925244,322.58246524017744,0.33106751342619883,239,273,316,329,13,56,90,49,-167.59223877238688,32.58737976129745,191.10170560017983,0.875,21367,21481,Bandera+Kendall+Kerr,Bandera,48,19,Texas,TX
48021,48CS008,520,658,825,697,-128,39,177,53,-223.84298914085207,-17.309040861485386,153.30864763029913,0.4435224089635854,646,822,1047,945,-102,124,299,144,-242.5497288747888,-20.20426429066709,152.76394951479995,0.8275862068965517,97059,101464,Bastrop+Caldwell,Bastrop,48,21,Texas,TX
48023,48CS034,39,53,67,57,-10,4,18,4,-469.54088379711146,13.207026317767065,467.5580005435349,0.3649776711530577,47,63,81,81,0,18,34,17,-489.1939690057253,28.776115823866196,489.1939690057253,0.8947368421052632,3474,3475,Eastern Central Panhandle,Baylor,48,23,Texas,TX
48025,48CS009,170,219,279,276,-3,57,106,49,-200.06059044993074,30.74898604417764,219.0865255647657,0.7903225806451613,205,266,342,398,56,132,193,90,-110.07439315631453,135.7745818668197,333.13263479466104,0.6766917293233082,31221,30934,Bee+Goliad+Karnes,Bee,48,25,Texas,TX
48027,48CS010,1643,2051,2546,2385,-161,334,742,202,-117.26529011196477,42.630179825886394,174.4123379921966,0.4896976891793413,2001,2531,3229,3353,124,822,1352,551,-112.86555977808214,71.59776849218225,211.64934442467603,0.6513002364066194,371568,378503,Bell,Bell,48,27,Texas,TX
48029,48CS011,9386,11660,14341,14275,-66,2615,4889,1952,-120.271910065702,39.50667676058285,175.01815331424726,0.6921986686030216,11301,14164,18017,18960,943,4796,7659,3396,-121.0734058265173,69.07128852871246,210.40708628482096,0.6957601171081834,2013837,2026168,Bexar+Wilson,Bexar,48,29,Texas,TX
48031,48CS068,86,105,124,111,-13,6,25,4,-178.1776918507008,18.296334894571913,222.86798964019204,0.2559091452214848,107,130,157,157,-0,27,50,22,-186.5008880994671,42.2904508162057,236.82652457075193,0.7586206896551724,11574,11823,Menard and Nearby Counties,Blanco,48,31,Texas,TX
48033,48CS085,2,6,12,5,-7,-1,3,5,-2247.585601404741,-1123.7928007023704,-374.59760023412343,-0.8333333333333334,3,8,14,9,-5,1,6,9,-2264.3029814665592,-1289.2828364222403,-483.4810636583401,2.25,641,620,Scurry and Nearby Counties,Borden,48,33,Texas,TX
48035,48CS012,165,212,273,274,1,62,109,20,-124.46589641262082,275.13513943842497,583.0244621433291,0.3076923076923077,200,260,341,305,-36,45,105,36,-389.937447534458,48.74218094180725,373.96084378130985,0.6,18318,18464,Bosque+Hamilton+Hill,Bosque,48,35,Texas,TX
48037,48CS013,707,886,1097,1063,-34,178,356,126,-207.0547192971122,66.54176626397054,297.17682020802374,0.6237623762376238,847,1080,1373,1381,8,301,534,228,-237.7667525613757,78.82367364659595,330.46555232247516,0.7091774539966331,92874,92612,Bowie,Bowie,48,37,Texas,TX
48039,48CS014,1636,2022,2502,2443,-59,420,807,239,-95.62275721324312,58.20097395775864,182.1866851465596,0.5063559322033898,1945,2476,3127,3459,332,983,1514,605,-72.14194075351367,99.79745143578468,240.05511301054813,0.6059090152276525,374221,378767,Brazoria,Brazoria,48,39,Texas,TX
48041,48CS015,745,930,1151,1141,-10,211,396,146,-79.99739324733541,33.33224718638976,128.20095071688368,0.6375545851528385,890,1139,1460,1414,-46,275,524,216,-110.77080394574772,24.930297283231415,130.1657301372786,0.7212040133779264,234008,236660,Brazos+Burleson+Grimes+Robertson,Brazos,48,41,Texas,TX
48043,48CS095,58,74,93,81,-12,7,23,12,-302.17518375958207,-63.12697361269367,144.74103521068747,0.8834141586981185,72,92,114,109,-5,17,37,14,-200.69892520444003,31.689303979648425,242.95133051063792,0.7,9492,9467,"West Texas, excluding El Paso",Brewster,48,43,Texas,TX
48045,48CS034,8,15,23,22,-1,7,14,3,-335.7706846244538,350.8945247733021,900.2266922915068,0.37390435380393067,10,18,28,16,-12,-2,6,3,-1067.1409515340151,-355.7136505113384,213.42819030680303,-0.3,1437,1406,Eastern Central Panhandle,Briscoe,48,45,Texas,TX
48047,48CS033,53,68,83,101,18,33,48,28,-171.1995175548013,81.21477526342903,333.6290680816595,0.8546614010846905,65,83,104,97,-7,14,32,20,-385.755616673215,-85.72347037182556,171.4469407436511,1.1764705882352942,7035,6999,Duval and Nearby Counties,Brooks,48,47,Texas,TX
48049,48CS016,334,422,533,584,51,162,250,73,-69.9695407864992,281.1417214446244,559.12454714268,0.4451219512195122,398,516,655,647,-8,131,249,107,-301.5908195160616,62.886009282237,372.07555491990223,0.7379310344827587,37988,38164,Brown+Coleman+Mills,Brown,48,49,Texas,TX
48051,48CS015,151,195,246,211,-35,16,60,20,-371.11751446020315,-26.965850278670526,269.99557591518834,0.5128205128205128,184,239,311,297,-14,58,113,41,-305.97534272272196,94.48829838848818,400.46364111120994,0.616576209859792,17800,17992,Brazos+Burleson+Grimes+Robertson,Burleson,48,51,Texas,TX
48053,48CS017,366,462,580,498,-82,36,132,30,-272.0827350594536,14.569356629689619,247.8004740099708,0.3448275862068966,443,572,738,692,-46,120,249,114,-315.97842062532874,12.812599713441278,266.20639866157603,0.7916666666666666,49419,50731,Burnet+Lampasas+Llano,Burnet,48,53,Texas,TX
48055,48CS008,262,333,417,414,-3,81,152,50,-139.2858119626952,81.3922746624609,267.8068392119681,0.5681818181818182,321,410,533,489,-44,79,168,102,-312.8292116775288,-49.281314168377826,141.41594500491027,1,45705,46671,Bastrop+Caldwell,Caldwell,48,55,Texas,TX
48057,48CS003,125,162,208,216,8,54,91,11,-17.83307498766752,255.6074081565678,475.54866633780057,0.19642857142857142,146,193,251,268,17,75,122,29,-60.68677196945432,232.63262588290823,470.5753443131435,0.37662337662337664,20187,19774,Aransas+Calhoun+Refugio,Calhoun,48,57,Texas,TX
48059,48CS018,122,144,168,196,28,52,74,26,19.814660989665835,226.90133344939235,419.7061664291376,0.49881368195045195,150,177,211,231,20,54,81,36,-113.78367767217559,128.00663738119755,320.37216744571907,0.6666666666666666,13816,14062,Callahan and Nearby Counties,Callahan,48,59,Texas,TX
48061,48CS019,1854,2304,2860,3734,874,1430,1880,1075,-57.21129337964686,101.18713829086795,229.15827014902328,0.7514855863912469,2232,2800,3542,3808,266,1008,1576,740,-112.22654094418803,63.51106806515858,197.78316410682433,0.7240711433311984,421595,422761,Cameron,Cameron,48,61,Texas,TX
48063,48CS055,96,115,136,173,37,58,77,23,129.21244545270193,333.45919664110824,514.1390150000831,0.3972439120537046,113,140,167,232,65,92,119,41,190.60035803747814,405.02576082964106,619.451163621804,0.44565217391304346,12559,12592,Hopkins and Nearby Counties,Camp,48,63,Texas,TX
48065,48CS073,37,49,62,80,18,31,43,12,113.93653034209785,402.60173338991854,640.3260182528298,0.38103556527539,43,57,75,85,10,28,42,13,-52.12820642769746,260.6410321384873,503.90599546774206,0.4642857142857143,5810,5755,Northwest Panhandle,Carson,48,65,Texas,TX
48067,48CS020,257,324,413,455,42,131,198,60,-75.393876283652,297.3869564521829,578.2291456087864,0.45454545454545453,305,397,505,589,84,192,284,111,-94.61559857872186,283.8467957361656,606.2406871895881,0.5721649484536082,28650,28537,Cass+Marion+Morris,Cass,48,67,Texas,TX
48069,48CS094,42,56,71,75,4,19,33,24,-321.17617654319474,-79.96799549956246,147.83973104164576,1.2569545521594614,53,69,89,96,7,27,43,19,-162.85309576384037,108.56873050922692,326.38474609336276,0.7037037037037037,7362,7369,Western Central Panhandle,Castro,48,69,Texas,TX
48071,48CS021,219,273,345,334,-11,61,115,28,-100.0961125867386,84.69671065031729,223.29132807810916,0.4057971014492754,267,342,442,418,-24,76,151,86,-226.3353140531082,-21.60473452325124,133.74359466774575,1,46755,48600,Chambers+Liberty,Chambers,48,71,Texas,TX
48073,48CS022,366,458,575,601,26,143,235,97,-167.80246039472516,108.56417972091926,325.6925391627578,0.6598639455782312,434,556,720,794,74,238,360,148,-145.27536478134357,176.4478114753161,415.7306491482308,0.6179567642956765,50846,51007,Cherokee,Cherokee,48,73,Texas,TX
48075,48CS034,51,65,80,72,-8,7,21,13,-369.36321883078807,-105.91893582163004,143.6213433620441,1.1647841263344045,62,80,100,84,-16,4,22,13,-431.3443565780014,-133.86548997248318,133.86548997248318,0.8125,6741,6723,Eastern Central Panhandle,Childress,48,75,Texas,TX
48077,48CS023,90,109,130,128,-2,19,38,13,-173.94492272773368,66.00656679432916,296.3599967355095,0.6155174522228566,110,135,160,151,-9,16,41,16,-243.65581180025097,0,243.65581180025097,0.7272727272727273,10279,10260,Clay+Cooke+Montague,Clay,48,77,Texas,TX
48079,48CS094,13,21,30,34,4,13,21,10,-297.0517502119237,121.42407930733526,501.8566515975708,0.7921364181207217,16,25,37,46,9,21,30,10,-39.64681297441954,436.11494271861494,792.9362594883908,0.47619047619047616,2593,2522,Western Central Panhandle,Cochran,48,79,Texas,TX
48081,48CS068,30,40,52,55,3,15,25,10,-247.4441751527153,171.67402589392444,560.8552125800902,0.6795958536136002,36,50,65,69,4,19,33,8,-120.62044139542773,331.7062138374263,753.8777587214233,0.4,3296,3316,Menard and Nearby Counties,Coke,48,81,Texas,TX
48083,48CS016,103,123,144,124,-20,1,21,16,-555.9438317031041,-237.44032243693528,81.06318682923364,0.4949729683382591,127,154,185,214,29,60,87,42,-168.91746127626521,226.5176683781335,582.4740044009147,0.7,7744,7726,Brown+Coleman+Mills,Coleman,48,83,Texas,TX
48085,48CS024,3381,4182,5183,4832,-351,650,1451,443,-88.94333932418623,23.12907640151675,112.90685455955914,0.5399148866640919,4173,5262,6685,6213,-472,951,2040,819,-116.9343727172753,11.9547203645435,110.60380488786929,0.6943631407874251,1071379,1104166,Collin,Collin,48,85,Texas,TX
48087,48CS072,19,27,37,43,6,16,24,6,-1.6994366683304571,442.7851385070838,811.652005872573,0.37809482407712214,22,33,45,42,-3,9,20,2,-190.99156453923285,267.388190354926,687.5696323412383,0.2,2675,2618,Northeast Panhandle,Collingsworth,48,87,Texas,TX
48089,48CS064,164,213,275,260,-15,47,96,16,-179.67488264682353,179.67488264682353,463.67711650793166,0.2962962962962963,200,256,337,343,6,87,143,41,-169.73263069412562,223.07717176942225,495.13433125343465,0.44565217391304346,20704,20621,Lavaca and Nearby Counties,Colorado,48,89,Texas,TX
48091,48CS025,961,1188,1492,1357,-135,169,396,137,-199.4003259866925,23.45455038255527,189.83526715880672,0.5842244044371704,1192,1522,1945,1784,-161,262,592,289,-259.69064973988026,-15.866458271154645,174.8483701481242,0.8824448049526367,163721,173322,Comal,Comal,48,91,Texas,TX
48093,48CS026,134,158,183,194,11,36,60,36,-223.21566944352296,1.2959139328257552,211.68499448388803,0.9737819164057074,166,197,230,220,-10,23,54,32,-305.4661161407629,-65.45702488730633,160.3697109739002,1.1428571428571428,13622,13749,Comanche+Erath+Somervell,Comanche,48,93,Texas,TX
48095,48CS068,23,32,44,28,-16,-4,5,4,-726.8958130323654,-298.83085881834694,36.30896298622255,-0.44460398602624085,30,42,60,34,-26,-8,4,8,-1018.6375722471195,-494.33882182580794,-119.83971438201405,-0.6153846153846154,3238,3338,Menard and Nearby Counties,Concho,48,95,Texas,TX
48097,48CS023,292,364,465,424,-41,60,132,39,-230.56359790582198,60.485141237005145,267.8627683353085,0.5064935064935064,343,450,574,520,-54,70,177,85,-329.78190932973894,-36.7610182999709,218.31301512982705,0.8415841584158416,41663,42164,Clay+Cooke+Montague,Cooke,48,97,Texas,TX
48099,48CS027,367,458,576,534,-42,76,167,40,-119.6226234463077,52.51724931789119,185.34212571772426,0.41237113402061853,440,564,724,705,-19,141,265,130,-177.3599419506025,13.084905174088716,160.64694943278914,0.8414327607875995,82259,84066,Coryell,Coryell,48,99,Texas,TX
48101,48CS034,12,19,27,27,-0,8,15,9,-799.6963199172641,-79.29420231998256,565.8420223940009,1.0097961439188368,14,24,35,21,-14,-2,7,6,-1449.2972418061868,-615.9513277676294,72.46486209030934,-0.6,1376,1380,Eastern Central Panhandle,Cottle,48,101,Texas,TX
48103,48CS095,21,32,42,39,-3,7,18,3,-151.96104950232828,100.87213507746762,374.77475170557966,0.3190612402815111,27,39,53,48,-5,9,21,10,-320.6327152247101,-21.375514348314006,235.13065783145407,0.8333333333333334,4683,4678,"West Texas, excluding El Paso",Crane,48,103,Texas,TX
48105,48CS028,21,30,41,56,15,26,35,10,185.87360610913922,591.9273882368806,966.7462640471032,0.39092379417424106,25,36,51,55,4,19,30,3,32.52803849151221,520.4486158641954,878.2570392708298,0.15789473684210525,3159,3074,Crockett+Kinney+Terrell+Val Verde,Crockett,48,105,Texas,TX
48107,48CS029,42,55,68,83,15,28,41,23,-190.60385668172134,113.73364403438734,418.0711447504958,0.8239026462123799,51,65,83,99,16,34,48,20,-78.3571125404029,274.2498938914101,549.4792516895744,0.5882352941176471,5187,5105,Crosby+Floyd+Hale+Swisher,Crosby,48,107,Texas,TX
48109,48CS095,12,20,30,27,-3,7,15,2,-252.35734691016756,289.1877943614717,695.3466503152014,0.24720230180120914,15,26,38,31,-7,5,16,4,-503.87596899224786,45.59963520291837,547.1956224350205,0.4444444444444444,2186,2193,"West Texas, excluding El Paso",Culberson,48,109,Texas,TX
48111,48CS073,25,35,47,68,21,33,43,14,119.92136669905712,327.1251239052212,492.88812967015224,0.41828901904494226,29,43,56,79,23,36,50,4,265.22113393667263,446.6882255775539,642.1143242677338,0.1111111111111111,7142,7164,Northwest Panhandle,Dallam,48,111,Texas,TX
48113,48CS030,10955,13540,16782,17173,391,3634,6218,2301,-87.75260226961232,61.21847204222843,179.9363652360148,0.6113179196724491,12978,16262,20614,20576,-38,4314,7598,3389,-132.3502129431917,35.71866751446479,162.53345236230675,0.7447533328021133,2611957,2589682,Dallas,Dallas,48,113,Texas,TX
48115,48CS043,90,109,131,169,38,60,79,52,-131.56292993795918,73.38485660035232,254.68482161501257,0.8716935843624213,110,134,159,166,7,32,56,31,-193.28664476532117,8.053610198555049,201.7429354738036,0.9393939393939394,12516,12417,Gaines and Nearby Counties,Dawson,48,115,Texas,TX
48117,48CS094,108,128,151,173,22,45,65,60,-248.368122082561,-98.9916389626427,29.312090288572602,1.3409460589264575,131,156,186,216,30,60,85,41,-59.931215309701365,103.51755371675691,239.72486123880546,0.6833333333333333,18493,18354,Western Central Panhandle,Deaf Smith,48,117,Texas,TX
48119,48CS055,43,54,68,79,11,25,36,4,154.15917233514983,472.81785052717083,735.2426443323644,0.16169410132200407,50,65,85,91,6,26,41,17,-204.88702110569142,167.63483545011115,447.0262278669631,0.6538461538461539,5263,5369,Hopkins and Nearby Counties,Delta,48,119,Texas,TX
48121,48CS031,2821,3482,4299,4109,-190,627,1288,405,-78.19303632056499,29.174544643975505,116.06080676723859,0.5465596998615867,3453,4344,5518,5340,-178,996,1887,693,-92.85937261796384,32.31653351317182,127.35167274390368,0.6297138964577657,913125,937601,Denton,Denton,48,121,Texas,TX
48123,48CS064,172,222,286,259,-27,38,87,50,-465.17433024734413,-75.51531335184158,223.5253275214511,1.0204081632653061,206,272,352,289,-63,17,83,38,-507.73525831125477,-105.5164811928387,226.10674541322578,0.6129032258064516,19864,19902,Lavaca and Nearby Counties,DeWitt,48,123,Texas,TX
48125,48CS034,13,21,30,38,8,17,25,7,89.77279458704137,688.8024106772299,1176.699835547067,0.40123261771023183,16,25,37,30,-7,5,14,1,-459.0007171886206,229.5003585943103,745.8761654315085,0.125,1820,1743,Eastern Central Panhandle,Dickens,48,125,Texas,TX
48127,48CS032,56,69,86,91,5,22,35,13,-102.57477110508296,122.20097304834492,302.0215683710871,0.5711395548464453,63,83,104,156,52,73,93,35,200.32700437478826,447.78977448482084,683.4686031610423,0.4794520547945205,8778,8486,Dimmit+La Salle+Maverick,Dimmit,48,127,Texas,TX
48129,48CS034,32,43,55,47,-8,4,15,6,-517.1599994452475,-64.32603871994662,328.1300605753144,0.6535179506019198,38,52,69,64,-5,12,26,12,-520.1726259155612,0,428.37745663634445,0.8571428571428571,3268,3268,Eastern Central Panhandle,Donley,48,129,Texas,TX
48131,48CS033,81,98,117,123,6,25,42,25,-225.01891159540452,1.9698037958758285,209.7138237518079,0.9620473699517136,94,117,142,172,30,55,78,31,-10.2421412903391,245.8113909681384,481.38064064593766,0.5636363636363636,9997,9764,Duval and Nearby Counties,Duval,48,131,Texas,TX
48133,48CS018,167,212,275,230,-45,18,63,18,-423.7603829351432,0,302.6859878108166,0.4337979094076655,199,258,334,383,49,125,184,70,-117.66051672576928,308.1584961865386,638.7285193684619,0.5555555555555556,17840,17848,Callahan and Nearby Counties,Eastland,48,133,Texas,TX
48135,48CS035,846,1051,1293,1393,100,342,547,268,-122.13036206919392,53.77951081892502,202.76329079027138,0.7756890340956689,999,1244,1602,1614,12,370,615,317,-188.64871827901584,32.77083601700374,184.25866288805875,0.8149100257069408,165119,161729,Ector,Ector,48,135,Texas,TX
48137,48CS068,12,19,27,28,1,9,16,2,-91.11118124985761,571.2178886128851,1167.3140514893535,0.20176158023603893,14,23,34,31,-3,8,17,4,-487.9749041477867,278.84280237016384,906.2391077030325,0.4,1490,1434,Menard and Nearby Counties,Edwards,48,137,Texas,TX
48139,48CS036,938,1178,1462,1420,-42,242,482,184,-139.9661116341992,35.61084698657723,184.58805120607548,0.6666666666666666,1139,1456,1858,1822,-36,366,683,283,-158.42473739107987,41.44905396257299,198.58316212847095,0.7182741116751269,193761,201452,Ellis,Ellis,48,139,Texas,TX
48141,48CS037,3903,4832,6004,7370,1366,2538,3467,2091,-100.91444045528456,62.28856841895151,191.5356079841301,0.8233904631062512,4747,5951,7524,7301,-223,1350,2554,1193,-163.2117264885406,18.09429866800895,156.85567189274,0.7995992920226769,862116,867677,El Paso,El Paso,48,141,Texas,TX
48143,48CS026,229,289,367,315,-52,26,86,37,-249.7780627582974,-30.871445958890693,137.51825927142215,0.6607142857142857,270,350,460,462,2,112,192,79,-177.90588028031726,76.24537726299312,261.08265547630975,0.678124078986148,42758,43281,Comanche+Erath+Somervell,Erath,48,143,Texas,TX
48145,48CS038,124,159,203,168,-35,9,44,22,-401.3029634473528,-91.52523727746643,155.24088322831773,0.6470588235294118,149,195,256,245,-11,50,96,38,-284.15564352611756,69.51820025103794,336.2942937143958,0.6666666666666666,17044,17262,Falls+Lee+Milam,Falls,48,145,Texas,TX
48147,48CS039,304,384,482,427,-55,43,123,65,-402.47835513583516,-73.75696637224802,194.45018407229023,0.9285714285714286,362,469,598,597,-1,128,235,103,-285.4835197058738,68.5928687424012,362.1703469598783,0.7463768115942029,35793,36447,Fannin+Lamar+Red River,Fannin,48,147,Texas,TX
48149,48CS064,203,256,326,323,-3,67,120,39,-204.8671183702089,136.5780789134726,395.1008711425457,0.5416666666666666,237,313,402,391,-11,78,154,52,-255.7526169769912,105.46499669154277,413.7472947129755,0.5909090909090909,24601,24653,Lavaca and Nearby Counties,Fayette,48,149,Texas,TX
48151,48CS085,25,35,47,59,12,24,34,12,4.457700837617763,377.81731064413424,697.8398333354338,0.5074525653796153,29,41,57,66,9,25,37,13,-108.05639192953822,324.16917578861467,648.3383515772293,0.52,3699,3702,Scurry and Nearby Counties,Fisher,48,151,Texas,TX
48153,48CS029,39,50,64,93,29,43,54,27,41.376647524875295,350.2555916553775,605.5349543044096,0.6301223360976009,45,60,78,93,15,33,48,15,0,336.19200298837336,616.3520054786845,0.45454545454545453,5430,5354,Crosby+Floyd+Hale+Swisher,Floyd,48,153,Texas,TX
48155,48CS034,11,17,25,27,2,10,16,4,-272.36603626227134,628.1410407537065,1348.5467023664885,0.4108952803412463,13,22,33,25,-8,3,12,8,-1484.9080605990512,-462.5881808719787,370.07054469758293,1,1096,1081,Eastern Central Panhandle,Foard,48,155,Texas,TX
48157,48CS040,2477,3070,3786,3864,78,794,1387,429,-50.839853346731445,52.73513530131934,138.63770480792658,0.5143884892086331,3077,3858,4904,4860,-44,1002,1783,640,-80.11311015838012,42.43899230222533,133.86721585649528,0.5885058715298447,829428,854167,Fort Bend,Fort Bend,48,157,Texas,TX
48159,48CS055,81,97,116,137,21,40,56,14,81.40425862127992,298.9197550816462,488.063665047182,0.35012038543005786,95,119,144,128,-16,9,33,23,-373.21615834572737,-133.97503120103033,95.6964508578788,1.2105263157894737,10432,10450,Hopkins and Nearby Counties,Franklin,48,159,Texas,TX
48161,48CS041,144,187,237,245,8,58,101,31,-141.67042802677446,165.9480067992586,430.54288430696505,0.5081967213114754,174,230,301,256,-45,26,82,46,-461.57307025724276,-101.38892262652229,182.7535330343062,0.8762699564586357,19524,19726,Freestone+Leon+Limestone+Navarro,Freestone,48,161,Texas,TX
48163,48CS042,97,115,136,157,21,42,60,21,-3.070557617308882,134.5381483235776,250.97628411971223,0.5012060401394203,116,140,169,222,53,82,106,57,-21.70870089254419,135.67938057840118,266.2029446948229,0.6951219512195121,18641,18426,Frio+Medina+Uvalde+Zavala,Frio,48,163,Texas,TX
48165,48CS043,86,104,124,147,23,43,61,33,-56.105697608865675,53.020621100253265,157.6000098631588,0.774886313888328,104,128,154,176,22,48,72,40,-82.31691631685153,36.585296140822905,146.34118456329162,0.8163265306122449,21698,21867,Gaines and Nearby Counties,Gaines,48,165,Texas,TX
48167,48CS044,1948,2432,3020,2863,-157,431,915,220,-129.1828058067905,72.26291629170943,238.03952591731107,0.4334979577256985,2341,2956,3787,3693,-94,737,1352,474,-160.22331509433562,74.18137817060165,247.68964730233395,0.5910224438902744,350387,354536,Galveston,Galveston,48,167,Texas,TX
48169,48CS085,24,35,45,53,8,18,29,15,-148.50582723161565,70.97956813635157,289.6240232921809,0.8121418049685095,29,41,54,64,10,23,35,11,-17.085437867737355,205.02525441284826,410.0505088256965,0.4782608695652174,5866,5853,Scurry and Nearby Counties,Garza,48,169,Texas,TX
48171,48CS068,238,304,383,329,-54,25,91,25,-353.7006166270238,0,295.53353229873375,0.4166666666666667,290,374,482,417,-65,43,127,58,-451.9632152160949,-55.11746527025548,253.5403402431752,0.725,26819,27215,Menard and Nearby Counties,Gillespie,48,171,Texas,TX
48173,48CS068,4,9,18,1,-17,-8,-3,1,-1856.101971034211,-928.0509855171055,-412.4671046742691,-0.125,5,11,20,12,-8,1,7,5,-1136.467117125321,-349.6821898847142,174.8410949423571,0.8333333333333334,1164,1144,Menard and Nearby Counties,Glasscock,48,173,Texas,TX
48175,48CS009,53,67,83,64,-19,-3,11,8,-456.37212164250195,-192.7011245975111,57.09245155037482,-0.6420549741261103,65,83,105,98,-7,15,33,19,-364.1477833087261,-56.02273589365017,196.0795756277756,1,7109,7140,Bee+Goliad+Karnes,Goliad,48,175,Texas,TX
48177,48CS064,132,171,218,222,4,51,90,24,-121.31015980991717,163.36031495599818,399.32521433688447,0.4528301886792453,156,207,272,272,-0,65,116,63,-321.2381158442682,10.181873719311197,269.8196535617467,0.9130434782608695,19833,19643,Lavaca and Nearby Counties,Gonzales,48,177,Texas,TX
48179,48CS072,171,215,278,245,-33,30,74,41,-417.94467030592716,-62.084961152804844,186.25488345841453,0.9318181818181818,196,260,339,349,10,89,153,63,-251.7607916214325,123.50529400296689,427.5183253948854,0.6923076923076923,21261,21052,Northeast Panhandle,Gray,48,179,Texas,TX
48181,48CS045,1018,1268,1576,1533,-43,266,515,192,-206.77692426963185,64.67278269709762,284.25227823533857,0.6464646464646465,1226,1556,1969,1971,2,414,745,339,-242.74127312834423,54.37462133567716,292.43463567353257,0.7687074829931972,136379,138852,Grayson,Grayson,48,181,Texas,TX
48183,48CS046,906,1120,1401,1404,3,284,498,175,-166.27676115618291,104.85921874714239,312.3065118722493,0.5794701986754967,1085,1376,1733,1828,95,452,743,325,-185.31012338240294,102.2567267849888,336.56151020571116,0.6900212314225053,124166,124197,Gregg,Gregg,48,183,Texas,TX
48185,48CS015,200,252,320,314,-6,62,114,47,-216.26717455140735,61.15000222942716,273.3405099655392,0.6911764705882353,240,314,402,396,-6,82,156,64,-232.26367978779624,58.02447389416751,305.37451689444697,0.7111111111111111,29436,30160,Brazos+Burleson+Grimes+Robertson,Grimes,48,185,Texas,TX
48187,48CS047,828,1028,1269,1169,-100,142,341,119,-151.98894264926855,15.611738003234615,154.0705077163665,0.5995000253794224,998,1266,1630,1617,-13,352,619,249,-148.44812441204763,58.06499810049564,209.79875167335163,0.6631170212765958,172947,176526,Guadalupe,Guadalupe,48,187,Texas,TX
48189,48CS029,202,258,328,392,64,134,190,129,-239.90926508564064,20.30001473801575,225.14561800344737,0.9555555555555556,237,309,403,395,-8,86,158,76,-260.6044985669466,31.00588918107633,254.40332073073117,0.8172043010752689,32512,32252,Crosby+Floyd+Hale+Swisher,Hale,48,189,Texas,TX
48191,48CS034,24,34,44,47,3,13,23,5,-103.22015093458504,351.17053578120994,769.001052301481,0.3542586394504243,27,40,54,52,-2,12,25,5,-246.60188474297624,246.60188474297624,704.5768135513606,0.3708791208791209,2833,2839,Eastern Central Panhandle,Hall,48,191,Texas,TX
48193,48CS012,91,111,130,105,-25,-6,14,16,-594.4828697072378,-319.3107624346304,-32.797505404583475,-1.009074303873033,110,133,160,157,-3,24,47,4,-85.06350648988983,243.03858997111382,522.5329684378947,0.15384615384615385,8264,8229,Bosque+Hamilton+Hill,Hamilton,48,193,Texas,TX
48195,48CS072,28,39,52,50,-2,11,22,19,-474.1304920004443,-192.9588441718603,69.46802713481824,1.5597961263235296,34,46,63,62,-1,16,28,10,-212.6425671757201,106.32128358786005,347.9605644693602,0.5882352941176471,5263,5173,Northeast Panhandle,Hansford,48,195,Texas,TX
48197,48CS034,33,44,56,68,12,24,35,10,69.56163918493432,479.2782573963878,834.3659931796477,0.409399385364739,39,54,70,46,-24,-8,7,8,-900.6420592805417,-450.32102964027087,-28.14506435251693,-0.5714285714285714,3612,3553,Eastern Central Panhandle,Hardeman,48,197,Texas,TX
48199,48CS048,401,504,628,574,-54,70,173,54,-229.19862164410586,33.939638559053165,252.53212315345485,0.5454545454545454,483,619,794,806,12,187,323,162,-263.752494659012,43.95874910983533,283.0943442673395,0.816126084970306,56571,56872,Hardin,Hardin,48,199,Texas,TX
48201,48CS049,18150,22342,27531,28388,857,6046,10238,3653,-70.9498471606023,60.727871899034724,167.10061918093564,0.5856513063684166,21452,26950,34235,36243,2008,9292,14791,6096,-86.45963595896842,67.59813774162082,183.8779313822596,0.6456948988246698,4728636,4728681,Harris,Harris,48,201,Texas,TX
48203,48CS050,464,578,718,669,-49,92,205,84,-233.1408461930197,13.142099559922194,212.02587290007807,0.6885245901639344,547,702,894,951,57,248,404,159,-147.83832580151454,129.53039803461138,354.6527825517488,0.6259842519685039,68482,69096,Harrison+Upshur,Harrison,48,203,Texas,TX
48205,48CS073,27,37,49,48,-1,11,21,11,-257.2511069162858,0.07194392331925657,219.84963859059746,0.9302026648482028,33,47,62,46,-16,-1,13,6,-408.0197518652608,-129.82446650258296,129.82446650258296,-0.2554347826086957,5387,5392,Northwest Panhandle,Hartley,48,205,Texas,TX
48207,48CS034,44,58,72,71,-1,13,27,15,-359.46934528549707,-34.091410456051456,255.13342050345577,0.9937875616907754,52,68,86,111,25,43,59,20,92.37199742897941,424.9111881733053,720.5015799460394,0.46511627906976744,5458,5413,Eastern Central Panhandle,Haskell,48,207,Texas,TX
48209,48CS051,844,1057,1323,1140,-183,83,296,102,-140.70564877123837,-9.380376584749225,95.80326717213613,0.5469208211143695,1032,1326,1696,1649,-47,324,617,238,-112.3933932996878,33.70028099990638,149.38487133291838,0.6751786634045841,243061,253707,Hays,Hays,48,209,Texas,TX
48211,48CS072,17,25,35,20,-15,-5,3,4,-677.9602512729582,-332.3390409619288,-44.3213657027374,-0.5029475590443554,19,30,43,24,-19,-6,5,7,-791.4412729013806,-395.7206364506903,-60.880097915490815,-0.7,3425,3285,Northeast Panhandle,Hemphill,48,211,Texas,TX
48213,48CS052,750,938,1173,1130,-43,192,380,99,-206.55440583836386,134.45659774840718,408.6026986711054,0.45939922480620154,913,1156,1476,1570,94,414,657,288,-232.58559298070298,150.345052377431,442.1102914732342,0.6768516984258492,82555,83475,Henderson,Henderson,48,213,Texas,TX
48215,48CS053,3176,3894,4806,6443,1637,2549,3267,2012,-51.60682505362635,73.8714249068302,172.62802814819585,0.7893291486857591,3834,4814,6084,6410,326,1596,2576,1202,-99.65112816049584,44.81514038949362,156.3070201097516,0.7342700061087355,872326,879167,Hidalgo,Hidalgo,48,215,Texas,TX
48217,48CS012,306,384,485,451,-34,67,145,40,-246.14290817365872,89.74825821321791,349.18720464068656,0.4819277108433735,357,471,604,673,69,202,316,139,-192.3224423118531,173.0901980806678,486.4384058759084,0.6813725490196079,36101,36397,Bosque+Hamilton+Hill,Hill,48,217,Texas,TX
48219,48CS094,133,171,223,285,62,114,152,91,-160.60815480304078,127.15964063579821,337.5259156876293,0.7982456140350878,156,206,268,294,26,88,138,58,-149.89579202446038,140.30807365784125,374.15486308757664,0.651685393258427,21705,21382,Western Central Panhandle,Hockley,48,219,Texas,TX
48221,48CS054,503,635,799,767,-32,132,264,74,-204.91783499432927,111.96641007697689,366.8830385367147,0.5068493150684932,621,790,1017,991,-26,201,370,128,-241.19163694215385,114.25690783113063,378.8477334318515,0.5805018510900863,62162,63891,Hood,Hood,48,221,Texas,TX
48223,48CS055,277,352,441,448,7,96,171,87,-260.4846236065885,29.2862162705721,273.33801852533963,0.87,336,430,558,524,-34,94,188,67,-271.86835470296364,72.67767898000018,325.70367246592673,0.5877192982456141,36877,37150,Hopkins and Nearby Counties,Hopkins,48,223,Texas,TX
48225,48CS001,183,234,301,308,7,74,125,27,-108.08863267879661,254.00828679517204,529.6343001261034,0.35064935064935066,216,287,365,394,29,107,178,70,-184.5535782106743,166.5483510681695,486.1411328476299,0.6481481481481481,22204,22216,Anderson+Houston,Houston,48,225,Texas,TX
48227,48CS085,235,298,381,414,33,116,179,85,-178.40871763378513,106.25687313443494,322.3696425256,0.7264957264957265,272,356,458,459,1,103,187,70,-201.74978862655652,96.41916038633404,341.9958400975877,0.6422018348623854,35010,34226,Scurry and Nearby Counties,Howard,48,227,Texas,TX
48229,48CS095,11,17,25,35,10,18,24,6,122.19118252487485,408.12893108851745,636.8791299394314,0.33831711164480427,12,20,31,39,8,19,27,6,61.09240863184824,397.1006561070135,641.4702906344064,0.3157894736842105,3450,3274,"West Texas, excluding El Paso",Hudspeth,48,229,Texas,TX
48231,48CS056,671,845,1044,981,-63,136,310,97,-191.4537696157521,46.652277507118605,254.79320792349392,0.5574712643678161,821,1038,1319,1303,-16,266,482,244,-252.59215616348135,20.887428298134033,231.46185079211298,0.8472222222222222,100317,102933,Hunt,Hunt,48,231,Texas,TX
48233,48CS073,160,207,263,274,11,67,114,56,-262.59396137514517,64.11839234465253,338.37024323700706,0.8115942028985508,194,249,325,348,23,99,154,64,-200.23006540198438,170.7199095997431,438.99405325648223,0.64,20587,20501,Northwest Panhandle,Hutchinson,48,233,Texas,TX
48235,48CS068,6,12,19,14,-5,2,8,3,-619.7844039624434,-39.97187523042335,410.9934248944813,0.6052847407081168,7,15,24,24,0,9,17,8,-516.9210887650432,64.6151360956304,581.5362248606735,0.8,1531,1548,Menard and Nearby Counties,Irion,48,235,Texas,TX
48237,48CS057,67,82,99,97,-2,15,30,12,-202.49723980122312,38.945969012951686,257.394586511491,0.695595480440415,81,103,126,108,-18,5,27,10,-322.58374216342327,-57.60423967203987,195.85441488493555,0.5263157894736842,8581,8680,Jack+Palo Pinto+Young,Jack,48,237,Texas,TX
48239,48CS058,112,133,155,158,3,25,46,23,-157.07766909457268,14.514682489713088,185.77768215157246,0.8972536557432548,135,163,193,171,-22,8,36,28,-331.05229108876205,-132.4209164355048,53.299418865290384,1.1666666666666667,14978,15103,Jackson+Matagorda+Wharton,Jackson,48,239,Texas,TX
48241,48CS059,272,345,435,447,12,102,175,53,-147.73434592082174,176.56055975903087,439.599761032689,0.5,322,416,537,606,69,190,284,122,-160.9328340522349,207.80205716452576,491.5959615111151,0.6387434554973822,33303,32964,Jasper+Newton,Jasper,48,241,Texas,TX
48243,48CS095,11,17,26,19,-7,2,8,7,-804.3102091887827,-313.0465012577064,78.00918664762787,1.1974833556430227,13,20,32,28,-4,8,15,5,-460.7754253106501,153.59180843688335,511.97269478961124,0.5555555555555556,2018,1953,"West Texas, excluding El Paso",Jeff Davis,48,243,Texas,TX
48245,48CS060,1680,2068,2548,2570,22,502,890,271,-117.17157823400515,108.67952046599153,291.3175717426058,0.5132575757575758,1972,2476,3169,3184,15,708,1212,474,-180.68321579055836,92.30983464681032,290.66772666611814,0.6328437917222964,255062,254036,Jefferson,Jefferson,48,245,Texas,TX
48247,48CS033,30,41,54,54,-0,13,24,12,-301.3993440886894,21.937172134963536,285.65851817987976,0.8749781785508759,36,50,67,69,2,19,33,5,-62.41493797515538,291.2697105507251,582.5394211014502,0.2631578947368421,4882,4807,Duval and Nearby Counties,Jim Hogg,48,247,Texas,TX
48249,48CS033,261,331,413,429,16,98,168,68,-159.70022084612535,92.13474279584155,307.11580931947185,0.6666666666666666,310,401,515,594,79,193,284,109,-77.62207831076506,216.26051668670868,450.67146959533744,0.558974358974359,39073,38842,Duval and Nearby Counties,Jim Wells,48,249,Texas,TX
48251,48CS061,1047,1302,1627,1556,-71,254,509,175,-163.3759154568647,52.123590178272224,221.80745603887684,0.6108221047245437,1284,1631,2084,2034,-50,403,750,388,-235.12650539027248,8.050439581954091,194.5254550986171,0.8838268792710706,180724,186325,Johnson,Johnson,48,251,Texas,TX
48253,48CS018,119,154,197,221,24,67,102,39,-91.25764441205361,170.34760290250006,383.2821065306252,0.5735294117647058,140,187,246,261,15,74,121,62,-236.84417731818064,60.470853783365264,297.3150311015459,0.8157894736842105,19724,19844,Callahan and Nearby Counties,Jones,48,253,Texas,TX
48255,48CS009,99,118,140,156,16,38,57,24,-63.224643013543755,110.2271416189217,270.0291696872199,0.6381224805630222,116,142,170,175,5,33,59,30,-169.50086233563715,20.340103480276458,196.62100030933908,0.8823529411764706,14817,14749,Bee+Goliad+Karnes,Karnes,48,255,Texas,TX
48257,48CS062,796,990,1234,1078,-156,88,282,132,-235.8263726114337,-36.02277519494214,122.88678538092755,0.743667872786136,996,1270,1624,1469,-155,199,473,261,-266.5567617530901,-39.693813447079584,135.72723307711084,0.9422382671480144,146574,156196,Kaufman,Kaufman,48,257,Texas,TX
48259,48CS007,252,319,406,379,-27,60,127,38,-172.62700118681062,58.427600401689745,236.3662016250176,0.5066666666666667,305,398,509,457,-52,59,152,58,-236.8792424384427,2.152469263411565,202.43973422385758,0.6744186046511628,45184,46458,Bandera+Kendall+Kerr,Kendall,48,259,Texas,TX
48261,48CS063,0,2,6,7,1,5,7,7,-2050.916859533559,-683.638953177853,0,1.4,0,3,7,5,-2,2,5,5,-2053.5386872020536,-880.0880088008801,0,1.6666666666666667,351,341,Kenedy+Kleberg+Willacy,Kenedy,48,261,Texas,TX
48263,48CS085,4,9,17,16,-1,7,12,2,-475.0515463917526,791.7525773195877,1583.5051546391753,0.25,5,11,20,20,0,9,15,8,-1066.0152129254345,133.25190161567932,932.7633113097551,0.8,758,750,Scurry and Nearby Counties,Kent,48,263,Texas,TX
48265,48CS007,500,624,775,699,-76,74,199,51,-289.35567861230993,53.521121191572476,337.06918878096707,0.43405041286397217,589,762,972,863,-109,101,274,92,-378.8829795791994,16.952258594147626,342.8123404594298,0.5786163522012578,52689,53090,Bandera+Kendall+Kerr,Kerr,48,265,Texas,TX
48267,48CS068,37,49,63,51,-12,2,14,5,-482.0986805138975,-92.7399824760591,250.81180991026906,0.4333965614601972,45,62,79,63,-16,1,18,2,-413.42086626983365,-22.967825903879646,367.48521446207434,0.11764705882352941,4308,4354,Menard and Nearby Counties,Kimble,48,267,Texas,TX
48269,48CS034,1,3,8,2,-6,-1,1,2,-3577.9175401816906,-1341.719077568134,-447.2396925227113,-0.5,1,4,9,7,-2,3,6,7,-3464.8700673724734,-1539.9422521655438,-384.98556304138594,1.75,268,260,Eastern Central Panhandle,King,48,269,Texas,TX
48271,48CS028,22,31,42,45,3,14,23,3,1.0936023988396604,402.65441116036794,741.134786361656,0.21805046874014303,26,38,53,53,0,15,27,7,-223.67343678229784,255.62678489405468,639.0669622351367,0.4375,3206,3130,Crockett+Kinney+Terrell+Val Verde,Kinney,48,271,Texas,TX
48273,48CS063,190,242,305,295,-10,53,105,62,-280.18798563574774,-34.99919320918431,167.41280751726478,1.0163934426229508,223,293,376,335,-41,42,112,69,-358.5151768029816,-87.99917976073185,140.30980328516677,1.0615384615384615,30858,30682,Kenedy+Kleberg+Willacy,Kleberg,48,273,Texas,TX
48275,48CS034,28,38,50,66,16,28,38,12,135.68116178693555,570.4258203330967,918.2215471700255,0.4258176188338871,31,45,61,71,10,26,40,10,0,477.2617109335189,894.8657080003479,0.38461538461538464,3404,3352,Eastern Central Panhandle,Knox,48,275,Texas,TX
48277,48CS039,422,529,668,675,7,146,253,97,-216.20424286003956,117.51533999048183,374.250383786014,0.6339869281045751,503,642,813,824,11,182,321,126,-229.86354659091046,111.78774302293519,389.2608908834351,0.6545498704663213,50036,50095,Fannin+Lamar+Red River,Lamar,48,277,Texas,TX
48279,48CS094,107,127,147,194,47,67,87,67,-186.66371664638606,3.599340838146639,186.25187602329797,0.9942300520466273,129,154,186,174,-12,20,45,28,-310.21161647619994,-61.96486721122597,131.67534282385517,1.12,12963,12911,Western Central Panhandle,Lamb,48,279,Texas,TX
48281,48CS017,151,194,248,252,4,58,101,13,-49.99256748008802,248.58182724905652,486.11557328704384,0.21311475409836064,183,241,317,331,14,90,148,54,-180.40348366643772,162.36313529979395,424.17369097071156,0.5869565217391305,21723,22173,Burnet+Lampasas+Llano,Lampasas,48,281,Texas,TX
48283,48CS032,30,40,52,68,16,28,38,19,-49.50122614863403,154.31517008531142,343.5732523025466,0.6855585497237461,33,47,62,86,24,39,53,25,-15.751772074358321,210.0236276581115,420.047255316223,0.6410256410256411,6777,6666,Dimmit+La Salle+Maverick,La Salle,48,283,Texas,TX
48285,48CS064,172,217,278,274,-4,57,102,48,-306.8915346625955,53.11584253775691,318.6950552265415,0.7868852459016393,202,268,343,296,-47,28,94,38,-414.5957528918318,-51.184660850843436,272.984857871165,0.6609195402298851,20333,20514,Lavaca and Nearby Counties,Lavaca,48,285,Texas,TX
48287,48CS038,132,155,180,196,16,41,64,29,-89.82126136313946,79.67769919732044,237.89553093512063,0.6998793258969599,162,191,224,209,-15,18,47,27,-237.89571200758098,-50.91703705275218,113.14897122833817,0.9642857142857143,17491,17676,Falls+Lee+Milam,Lee,48,287,Texas,TX
48289,48CS041,130,170,217,217,0,47,87,22,-165.01847863172176,187.5209984451384,487.55459595735977,0.4489795918367347,157,205,269,274,5,69,117,38,-207.5331498362131,194.66044311414848,496.3841299410783,0.5277777777777778,15998,15925,Freestone+Leon+Limestone+Navarro,Leon,48,289,Texas,TX
48291,48CS021,603,752,935,768,-167,16,165,92,-336.6781650899205,-98.77452440391414,94.94051325928847,0.5822784810126582,749,946,1221,1155,-66,208,406,240,-315.9444842864512,-32.52369691184056,171.49797006529255,1.0169491525423728,92332,96852,Chambers+Liberty,Liberty,48,291,Texas,TX
48293,48CS041,174,225,283,297,14,72,123,28,-75.63180707758501,236.8540577518677,511.38944287335073,0.3783783783783784,204,272,352,400,48,128,196,78,-136.0964581763376,226.07385079125848,533.5342878673699,0.6070130813953488,22292,22117,Freestone+Leon+Limestone+Navarro,Limestone,48,293,Texas,TX
48295,48CS072,15,22,32,34,2,12,19,4,-81.0546350380343,306.4068547471187,597.0029720859836,0.3389273939534457,17,27,39,40,1,13,23,8,-237.51457957798746,169.6532711271339,508.9598133814017,0.5714285714285714,3056,2947,Northeast Panhandle,Lipscomb,48,295,Texas,TX
48297,48CS005,81,99,118,131,13,32,50,17,-45.897914795417805,160.4138903883845,340.93671992421156,0.525633190702696,97,120,146,155,9,35,58,30,-185.10308541781927,43.96747872157228,246.21788084080478,0.8571428571428571,11477,11372,Atascosa+Live Oak+McMullen,Live Oak,48,297,Texas,TX
48299,48CS017,225,283,355,302,-53,19,77,17,-392.6798790101252,11.211416959603863,336.34250878811594,0.3269230769230769,273,352,454,412,-42,60,139,67,-498.3611804073188,-32.00484644817644,329.1927063241005,0.8221168322794339,21407,21872,Burnet+Lampasas+Llano,Llano,48,299,Texas,TX
48301,48CS095,0,0,2,7,5,7,7,7,-2990.6542056074763,0,0,1,0,0,2,4,2,4,4,4,-3421.240199572345,0,0,1,80,58,"West Texas, excluding El Paso",Loving,48,301,Texas,TX
48303,48CS065,1782,2206,2720,3014,294,808,1232,616,-124.04775419311662,73.7279482556854,237.21919225974176,0.7493917274939172,2141,2704,3414,3349,-65,645,1208,519,-186.10941411945421,40.1262597177468,219.4365020516939,0.7340876944837341,311686,314009,Lubbock,Lubbock,48,303,Texas,TX
48305,48CS043,40,53,68,82,14,29,42,16,-47.41233316209258,266.0319984711948,544.6491821452279,0.5602197649537713,51,67,85,85,0,18,34,14,-246.65076160763442,70.47164617360984,352.3582308680492,0.7368421052631579,5666,5676,Gaines and Nearby Counties,Lynn,48,305,Texas,TX
48307,48CS068,72,88,107,109,2,21,37,12,-155.41619143723958,142.05015382204297,387.7832216449286,0.5491475163969438,88,108,132,166,34,58,78,28,79.59714997982434,397.9857498991217,663.3095831652028,0.4827586206896552,7628,7538,Menard and Nearby Counties,McCulloch,48,307,Texas,TX
48309,48CS066,1527,1896,2350,2338,-12,442,811,304,-145.49659393973593,63.299419923156734,233.4712786474831,0.6386554621848739,1836,2326,2958,2940,-18,614,1104,462,-182.73663569899537,57.836478138984475,244.30204466536173,0.7,260666,262810,McLennan,McLennan,48,309,Texas,TX
48311,48CS005,1,5,10,17,7,12,16,3,774.8444593912898,1743.4000336304018,2518.2444930216916,0.25,2,6,12,14,2,8,12,7,-824.1475224065107,164.82950448130214,824.1475224065107,0.875,619,607,Atascosa+Live Oak+McMullen,McMullen,48,311,Texas,TX
48313,48CS067,99,118,138,140,2,22,41,21,-168.59214612749227,9.005762449764653,179.3547767993785,0.9030457607512675,121,146,176,177,1,31,56,30,-212.01639471603968,7.310910162622058,190.08366422817352,0.9375,13610,13678,Madison+Trinity+Walker,Madison,48,313,Texas,TX
48315,48CS020,109,131,152,163,11,32,54,21,-124.21919017487099,138.73803845254798,401.69526707996675,0.6505963629320176,129,156,186,212,26,56,83,40,-144.91847257655127,165.6211115160586,445.10673719940746,0.7142857142857143,9755,9661,Cass+Marion+Morris,Marion,48,315,Texas,TX
48317,48CS043,31,43,55,56,1,13,25,17,-362.9466234406978,-84.66208067118669,175.07015924702387,1.208216426162531,37,51,68,53,-15,2,16,6,-402.5543028981514,-76.67701007583835,191.69252518959587,0.5,5318,5217,Gaines and Nearby Counties,Martin,48,317,Texas,TX
48319,48CS068,30,41,53,39,-14,-2,9,1,-462.16314714987175,-93.01832805299222,251.51683643742888,-0.09681453782428419,36,50,68,67,-1,17,31,8,-228.07545496301694,228.07545496301694,582.8594960165989,0.4444444444444444,4009,3946,Menard and Nearby Counties,Mason,48,319,Texas,TX
48321,48CS058,267,338,428,408,-20,70,141,67,-287.3412619001611,9.908319375867624,244.5703499276657,0.8271604938271605,315,409,526,468,-58,59,153,95,-421.3792878043242,-99.083307387039,159.63421745689618,1.0106382978723405,36333,36333,Jackson+Matagorda+Wharton,Matagorda,48,321,Texas,TX
48323,48CS032,265,337,424,611,187,274,346,216,-60.26831221327191,120.12240922232891,269.23988273970275,0.7883211678832117,316,409,521,614,93,205,298,201,-186.21257186188154,6.89357045300811,167.2552531161092,0.9804878048780488,57941,58025,Dimmit+La Salle+Maverick,Maverick,48,323,Texas,TX
48325,48CS042,302,382,479,447,-32,65,145,57,-208.99318374709335,18.775356204118438,206.64626422157843,0.6785714285714286,366,474,606,587,-19,113,221,120,-268.2037464107851,-13.506663488312917,194.88185890280067,0.9302325581395349,51131,51826,Frio+Medina+Uvalde+Zavala,Medina,48,325,Texas,TX
48327,48CS068,19,26,36,33,-3,7,14,5,-492.74072699496026,101.93941196986212,547.9495161934792,0.599845021270379,22,32,46,38,-8,6,16,7,-757.4243364647219,-50.494955764314795,454.45460187883316,0.7,1991,1980,Menard and Nearby Counties,Menard,48,327,Texas,TX
48329,48CS069,760,944,1181,1106,-75,162,346,200,-193.13733701056543,-26.68321689293396,102.55483755823693,1.0230245944531657,883,1124,1422,1403,-19,280,520,233,-149.79433730662333,27.62965761506539,170.67998171887157,0.768976897689769,170894,168297,Midland,Midland,48,329,Texas,TX
48331,48CS038,197,247,315,256,-59,9,59,19,-377.97787557386965,-48.45870199664995,193.8348079865998,0.38387755102040816,232,305,389,415,26,110,183,74,-191.8141339006365,143.71090156967566,435.12467419707355,0.6548672566371682,24763,25050,Falls+Lee+Milam,Milam,48,331,Texas,TX
48333,48CS016,46,60,76,74,-2,14,28,14,-416.41533705766454,-0.4522394578494155,371.72526892093254,0.8958671108496055,58,75,96,92,-4,17,34,14,-402.3226683678459,67.05377806130765,447.02518707538434,0.7,4506,4474,Brown+Coleman+Mills,Mills,48,333,Texas,TX
48335,48CS085,66,84,100,76,-24,-8,10,16,-545.0138570413419,-322.6529625141408,-78.05597853421948,-1.1082980374974505,82,103,128,109,-19,6,27,27,-507.8605683530183,-231.849389900291,0,1.5,8874,9058,Scurry and Nearby Counties,Mitchell,48,335,Texas,TX
48337,48CS023,191,245,312,325,13,80,134,41,-168.0236283227329,234.03291087809222,558.3785219796531,0.5,231,305,391,368,-23,63,137,55,-383.881247491173,39.32202279038905,403.0507336014877,0.7236842105263158,19997,20345,Clay+Cooke+Montague,Montague,48,337,Texas,TX
48339,48CS070,2769,3444,4285,4026,-259,582,1257,290,-105.47259787115163,56.16883910298016,185.77003401101874,0.4093156590407433,3418,4271,5438,5408,-30,1137,1990,850,-136.3354118668931,44.468988755311194,176.6751373806395,0.7021892978277634,624902,645394,Montgomery,Montgomery,48,339,Texas,TX
48341,48CS073,106,127,150,175,25,48,69,63,-212.9377261056113,-82.67751767862384,33.62623984547201,1.301953362900959,129,158,185,190,5,32,61,35,-141.90701345850056,-14.190701345850057,122.9860783307005,1.0294117647058822,21207,21141,Northwest Panhandle,Moore,48,341,Texas,TX
48343,48CS020,119,155,201,168,-33,13,49,15,-479.48525602934063,-19.957762998099508,339.2819709676916,0.4838709677419355,144,190,249,228,-21,38,84,43,-532.8517377823149,-41.59654471368579,341.09166665222347,0.8958333333333334,12025,12020,Cass+Marion+Morris,Morris,48,343,Texas,TX
48345,48CS034,9,16,23,18,-5,2,9,3,-895.1581232221492,-69.29574894143893,664.8041393080812,0.5293112093468633,11,19,29,31,2,12,20,6,-380.34865293185396,563.4794858249692,1314.7854669249282,0.5,1075,1065,Eastern Central Panhandle,Motley,48,345,Texas,TX
48347,48CS071,390,486,610,635,25,149,245,103,-144.75504603176955,85.36836048027435,263.62120883093405,0.6710168916051269,462,594,759,792,33,198,330,128,-146.99609118758045,108.25593248953847,312.5503422305102,0.6228747336017049,64661,64662,Nacogdoches,Nacogdoches,48,347,Texas,TX
48349,48CS041,396,495,624,527,-97,32,131,74,-391.27808500709875,-96.07529710785236,130.50227857149937,0.8131868131868132,479,610,784,685,-99,75,206,136,-439.6585680006264,-114.0755961209622,130.99992636513764,1.0421608925425718,52459,53473,Freestone+Leon+Limestone+Navarro,Navarro,48,349,Texas,TX
48351,48CS059,97,113,135,174,39,61,77,19,195.30416903563952,402.3125149761863,561.5497041612223,0.31382530641044853,113,135,161,232,71,97,119,45,212.59850567781106,425.1970113556221,605.0880546214622,0.4639175257731959,12391,12230,Jasper+Newton,Newton,48,351,Texas,TX
48353,48CS085,133,156,178,202,24,46,69,32,-68.51190455298494,112.39627891850776,300.0047654815372,0.6988209671341782,161,190,223,214,-9,24,53,51,-410.5347785678038,-184.74065035551172,14.026604934399652,1.7586206896551724,14724,14615,Scurry and Nearby Counties,Nolan,48,353,Texas,TX
48355,48CS074,1929,2410,2980,3260,280,850,1331,510,-77.73414594807849,115.28082184373139,277.99436950334166,0.5892549626880615,2310,2913,3692,4057,365,1144,1747,621,-72.50469070772257,148.12481734429267,318.9215116071525,0.537895293614531,354439,353081,Nueces,Nueces,48,355,Texas,TX
48357,48CS072,45,59,73,93,20,34,48,20,-2.0732060239081957,171.96525838666233,336.05866768805737,0.584602097888465,52,69,86,90,4,21,38,24,-203.9160375715299,-30.587405635729485,142.74122630007093,1.0909090909090908,9920,9808,Northeast Panhandle,Ochiltree,48,357,Texas,TX
48359,48CS073,7,13,20,17,-3,4,10,1,-247.66758231372535,188.86242175251797,625.3924258187612,0.1821528913932106,8,15,24,19,-5,4,11,8,-754.3155553406508,-232.09709395096945,174.0728204632271,1.3333333333333333,1808,1723,Northwest Panhandle,Oldham,48,359,Texas,TX
48361,48CS075,661,830,1035,977,-58,148,316,75,-188.94170154077457,102.99453655418162,342.36804564907277,0.42613636363636365,788,1006,1272,1237,-35,231,449,234,-317.63296663958914,-3.5404008913942686,253.7287305499226,0.9069767441860465,84470,84736,Orange,Orange,48,361,Texas,TX
48363,48CS057,219,280,351,389,38,109,170,49,-46.438056325696756,252.15234203998247,508.50722311396464,0.44545454545454544,261,340,433,457,24,117,196,83,-205.94641175465324,118.68098304505442,394.4397377673867,0.6859504132231405,28554,28648,Jack+Palo Pinto+Young,Palo Pinto,48,363,Texas,TX
48365,48CS076,176,228,292,333,41,106,157,45,-21.223990478682044,321.012855990066,594.2717334030973,0.42452830188679247,214,277,361,369,8,92,155,74,-291.3730402679749,79.4653746185386,357.5941857834237,0.7748903508771929,22616,22651,Panola+Sabine+San Augustine+Shelby,Panola,48,365,Texas,TX
48367,48CS077,872,1086,1344,1222,-122,136,350,109,-185.9733176654806,21.30232512701637,193.77077252329414,0.5532994923857868,1068,1364,1744,1615,-129,252,547,287,-267.253712793784,-22.80102572501642,166.99342784519067,0.9125619249823071,149279,155695,Parker,Parker,48,367,Texas,TX
48369,48CS094,49,64,79,105,26,41,56,36,-121.5002469149441,59.63680157143094,240.77385005780582,0.8807928893011447,60,78,98,103,5,25,43,10,-51.433300091238905,152.77217848882853,336.09879267542277,0.4,9804,9819,Western Central Panhandle,Parmer,48,369,Texas,TX
48371,48CS095,86,104,124,164,40,60,78,28,93.30925788899437,255.08156455529289,397.44119442163554,0.4635067652121289,105,129,156,176,20,47,71,33,-86.28182365394706,92.56287595059457,251.24209186589957,0.7021276595744681,15246,15125,"West Texas, excluding El Paso",Pecos,48,371,Texas,TX
48373,48CS078,454,567,708,719,11,152,265,66,-130.1432861623023,203.31194568497727,470.690795184639,0.4125,552,698,897,963,66,266,411,163,-187.7331854594635,198.27564667279762,479.8270649481702,0.6048258295470191,50759,51696,Polk+San Jacinto+Tyler,Polk,48,373,Texas,TX
48375,48CS079,846,1056,1312,1402,90,346,556,299,-212.89234474256673,47.36600014607347,261.83721156017594,0.8542857142857143,1013,1288,1648,1581,-67,292,568,269,-287.79596541910126,20.12259799865778,256.070763042494,0.8151515151515152,117806,116784,Potter,Potter,48,375,Texas,TX
48377,48CS095,31,42,55,55,-0,13,24,20,-389.9611108926796,-134.54950328728495,72.97242789209832,1.43962805104891,39,53,72,70,-2,17,31,14,-260.82172427611783,48.9040733017721,277.12308204337523,0.7777777777777778,6180,6134,"West Texas, excluding El Paso",Presidio,48,377,Texas,TX
48379,48CS080,113,134,157,170,13,36,57,20,-68.81213726189266,160.51759816319554,357.66070405493815,0.5495123112349366,137,167,198,205,7,38,68,32,-200.58101634400984,48.13944392256236,288.83666353537416,0.8205128205128205,12261,12464,Rains+Van Zandt,Rains,48,379,Texas,TX
48381,48CS081,748,932,1158,1200,42,268,452,206,-139.5749630317838,52.34061113691892,209.44755123245108,0.7410071942446043,900,1149,1460,1480,20,331,580,218,-138.07622333765235,78.76129852173001,252.4195067225178,0.6175637393767706,141000,143471,Randall,Randall,48,381,Texas,TX
48383,48CS068,13,20,28,28,0,8,15,2,-68.30775047691301,219.22900635308315,449.2584118170801,0.22000894321180436,14,23,34,32,-2,9,18,4,-183.4336486099169,152.8613738415974,428.0118467564727,0.36363636363636365,3431,3271,Menard and Nearby Counties,Reagan,48,383,Texas,TX
48385,48CS068,25,35,46,64,18,29,39,12,250.384027992743,699.4250498599557,1148.4660717271681,0.4188842739561812,30,42,55,63,8,21,33,11,-106.6137546550971,355.37918218365695,781.8342008040454,0.5,2856,2814,Menard and Nearby Counties,Real,48,385,Texas,TX
48387,48CS039,127,150,174,213,39,63,86,28,118.5053822085787,364.9384418470273,602.4642824623998,0.44185909655517125,154,182,214,231,17,49,77,29,-103.8577005255993,173.09616754266548,415.4308021023972,0.5918367346938775,11630,11554,Fannin+Lamar+Red River,Red River,48,387,Texas,TX
48389,48CS095,77,95,114,128,14,33,51,28,-115.1312477378952,37.33622324650417,183.174673753321,0.8475471970087308,92,114,139,158,19,44,66,32,-89.51665311005814,82.63075671697675,234.12047736476748,0.7272727272727273,14883,14522,"West Texas, excluding El Paso",Reeves,48,389,Texas,TX
48391,48CS003,51,65,82,100,18,35,49,17,13.935822767962122,320.45573075971436,568.5908943720851,0.48501981892161805,60,77,96,112,16,35,52,13,44.41360166551006,325.69974554707375,577.3768216516307,0.37142857142857144,6759,6755,Aransas+Calhoun+Refugio,Refugio,48,391,Texas,TX
48393,48CS072,4,9,16,12,-4,3,8,7,-1612.4847993514386,-583.7049047426023,145.92622618565056,1.4,5,11,20,1,-19,-10,-4,1,-2497.5284874343097,-1373.6406680888704,-624.3821218585774,-0.1,822,801,Northeast Panhandle,Roberts,48,393,Texas,TX
48395,48CS015,128,153,175,202,27,49,74,23,27.70219791134352,186.110884498745,362.12053626252447,0.468622508840485,156,184,218,267,49,83,111,48,5.907997705727558,206.77991970046455,372.20385546083617,0.5783132530120482,16816,16926,Brazos+Burleson+Grimes+Robertson,Robertson,48,395,Texas,TX
48397,48CS082,456,576,725,632,-93,56,176,54,-161.6545992421773,2.1971403226935413,134.0804881923733,0.5142857142857142,577,739,938,877,-61,138,300,168,-198.66849759839255,-26.015080436280126,114.46635391963255,0.9655172413793104,109233,115318,Rockwall,Rockwall,48,397,Texas,TX
48399,48CS068,98,117,138,137,-1,20,39,20,-254.12981870788857,3.063757642470861,230.58115210625044,0.9132863639147027,118,143,171,190,19,47,72,36,-171.02974156903022,110.66630336819603,362.1806292050052,0.7659574468085106,9973,9940,Menard and Nearby Counties,Runnels,48,399,Texas,TX
48401,48CS083,354,445,560,577,17,132,223,76,-134.72993051740193,127.77097559652003,335.39881094086513,0.5588235294117647,420,541,693,767,74,226,347,151,-146.2952692957938,142.4029227408765,372.24124004465114,0.6593886462882096,52594,52667,Rusk,Rusk,48,401,Texas,TX
48403,48CS076,113,133,155,156,1,23,43,16,-175.0117013211578,81.85189272129232,318.9567487604774,0.6542381236677646,136,161,190,258,68,97,122,52,159.74507348689383,449.28301918188885,698.8846965051605,0.5360824742268041,9986,10016,Panola+Sabine+San Augustine+Shelby,Sabine,48,403,Texas,TX
48405,48CS076,81,98,116,149,33,51,68,28,76.5036262021722,349.0667827122047,609.2407048354172,0.5472587658344992,93,116,141,190,49,74,97,13,454.4557970728628,770.0501005956843,1060.39685983668,0.17567567567567569,7963,7922,Panola+Sabine+San Augustine+Shelby,San Augustine,48,405,Texas,TX
48407,48CS078,212,268,339,323,-16,55,111,24,-173.12283079873188,134.17019386901723,376.5421569872419,0.36923076923076925,251,328,420,484,64,156,233,79,-53.917277417122776,276.77535740789693,553.7304390738508,0.5064102564102564,27726,27820,Polk+San Jacinto+Tyler,San Jacinto,48,407,Texas,TX
48409,48CS084,441,549,685,661,-24,112,220,98,-213.7106833766905,24.504091460062796,213.62316876433306,0.7716535433070866,524,672,864,883,19,211,359,195,-253.0051095172508,23.000464501568253,235.82663759264193,0.8883872976338729,68560,69564,San Patricio,San Patricio,48,409,Texas,TX
48411,48CS068,44,57,72,83,11,26,39,15,-73.21674383270472,233.98079650926556,507.04527681323907,0.5709583485083924,54,69,89,90,1,21,36,14,-223.64228702910574,120.42276993874924,378.4715626646405,0.6666666666666666,5781,5813,Menard and Nearby Counties,San Saba,48,411,Texas,TX
48413,48CS068,16,25,35,25,-10,0,9,3,-603.1441193482431,-128.25577030977323,267.48452055561853,0.29408040197517654,21,31,43,33,-10,2,12,3,-536.8391282363325,-41.13709794914426,370.2338815422983,0.3333333333333333,2493,2431,Menard and Nearby Counties,Schleicher,48,413,Texas,TX
48415,48CS085,120,142,165,201,36,59,81,38,-16.01156960747292,147.64306939241155,305.45289985658604,0.6466107147781985,145,174,203,223,20,49,78,55,-207.84336528100297,-35.63029119102908,136.5827828989448,1.1,16880,16840,Scurry and Nearby Counties,Scurry,48,415,Texas,TX
48417,48CS018,15,23,33,38,5,15,23,6,-33.71828447147733,341.73455122277636,654.6119143013212,0.4005397331553923,18,28,40,42,2,14,24,3,-31.260990191864323,343.87089211050755,656.4807940291508,0.2,3153,3199,Callahan and Nearby Counties,Shackelford,48,417,Texas,TX
48419,48CS076,187,237,302,295,-7,58,108,44,-253.65466147429862,69.63069138510158,318.3117320461787,0.7096774193548387,219,287,375,386,11,99,167,75,-267.3673455000561,100.26275456252105,384.3405591563307,0.7281553398058253,24127,23937,Panola+Sabine+San Augustine+Shelby,Shelby,48,419,Texas,TX
48421,48CS073,12,20,29,27,-2,7,15,12,-586.922986200111,-201.59982541981205,113.6645788549782,1.4832138108072548,15,24,35,33,-2,9,18,1,-107.32012699548362,286.18700532128963,609.9360550909969,0.1,2816,2795,Northwest Panhandle,Sherman,48,421,Texas,TX
48423,48CS086,1481,1824,2235,2318,83,494,837,286,-104.08116976396049,106.30983374856908,282.32305487782634,0.5607843137254902,1764,2230,2845,2978,133,748,1214,531,-168.27147107378667,91.66539280284098,288.61926097945195,0.6959370904325033,234221,236731,Smith,Smith,48,423,Texas,TX
48425,48CS026,66,81,100,99,-1,18,33,8,-120.97619657857817,124.93943454753628,328.0871298256309,0.41555406533888206,80,103,126,123,-3,20,43,17,-212.57844131231403,31.807248076655465,275.66281666434736,0.7391304347826086,9227,9432,Comanche+Erath+Somervell,Somervell,48,425,Texas,TX
48427,48CS087,295,370,472,641,169,271,346,210,-74.96279000229497,111.53000463756081,248.6570595198077,0.7749077490774908,345,456,575,632,57,176,287,126,-104.51727974845164,75.73715923800843,243.9493899056251,0.7039106145251397,65633,66018,Starr,Starr,48,427,Texas,TX
48429,48CS018,69,85,102,123,21,38,54,17,53.27298717455444,280.18851607390826,485.4930422209427,0.44364989694089874,80,102,126,144,18,42,64,24,-65.50724901397943,196.52174704193828,436.71499342652953,0.5714285714285714,9130,9159,Callahan and Nearby Counties,Stephens,48,429,Texas,TX
48431,48CS068,5,12,23,13,-10,1,8,2,-1051.1268590893883,-87.59390492411569,525.5634295446941,0.2857142857142857,7,15,27,16,-11,1,9,3,-1013.5440861512473,-144.79201230732104,434.3760369219631,0.375,1370,1381,Menard and Nearby Counties,Sterling,48,431,Texas,TX
48433,48CS034,8,16,26,25,-1,9,17,8,-860.3149841512188,95.59055379457988,860.3149841512188,0.8,9,19,32,24,-8,5,15,3,-900.8394185491027,163.78898519074593,982.7339111444757,0.375,1255,1221,Eastern Central Panhandle,Stonewall,48,433,Texas,TX
48435,48CS068,16,25,35,38,3,13,22,5,-53.721586407168246,292.61580632405713,582.6733727364572,0.37493945556930497,19,29,42,47,5,18,28,6,-30.0727384360923,360.8728612331076,661.6002455940306,0.3333333333333333,3418,3325,Menard and Nearby Counties,Sutton,48,435,Texas,TX
48437,48CS029,58,73,90,99,9,26,41,12,-44.6475271970794,236.15871183588217,502.9246389171958,0.46460108383340426,70,90,111,96,-15,6,26,13,-400.6820880464962,-99.99196493138943,185.69936344400895,0.8125,7027,7001,Crosby+Floyd+Hale+Swisher,Swisher,48,437,Texas,TX
48439,48CS088,9181,11311,13978,13952,-26,2641,4771,1732,-99.77309451421647,51.5994327160827,172.49764151554686,0.6115819971589318,10997,13814,17477,17744,267,3930,6747,2929,-125.26821646200962,47.13471673086343,179.6955186721015,0.7030728561882837,2113977,2124761,Tarrant,Tarrant,48,439,Texas,TX
48441,48CS089,986,1227,1528,1390,-138,163,404,218,-299.6369097226534,-46.27921941798915,156.59204970341412,0.9296417530460084,1191,1504,1922,1838,-84,334,647,391,-331.4628519252848,-40.11600502147733,178.60343105214253,1.0412801418439717,142613,143334,Taylor,Taylor,48,441,Texas,TX
48443,48CS028,2,6,13,12,-1,6,10,5,-968.935740719973,161.4892901199955,807.4464505999774,0.8333333333333334,3,7,15,20,5,13,17,4,137.5673506821048,1238.106156138943,1788.3755588673623,0.3076923076923077,743,727,Crockett+Kinney+Terrell+Val Verde,Terrell,48,443,Texas,TX
48445,48CS043,90,109,130,155,25,46,65,44,-191.06761693456284,16.721040421675905,207.88660518941555,0.9637711929041712,109,134,159,148,-11,14,39,26,-314.6381130216952,-102.04479341244168,110.54852619681182,1.3,11870,11760,Gaines and Nearby Counties,Terry,48,445,Texas,TX
48447,48CS034,11,18,26,15,-11,-3,4,5,-1347.1014387755174,-668.0085118515459,-56.8248776199717,-0.7842015617750487,14,23,34,23,-11,0,9,5,-1075.6905148747828,-336.15328589836963,268.9226287186957,0.5555555555555556,1453,1487,Eastern Central Panhandle,Throckmorton,48,447,Texas,TX
48449,48CS055,191,243,306,288,-18,45,97,57,-285.97396974898504,-45.7558351598376,152.7100998459578,1.0178571428571428,229,295,384,358,-26,63,129,60,-275.84714605994185,9.616983593025282,221.19062263958148,0.8,31471,31195,Hopkins and Nearby Counties,Titus,48,449,Texas,TX
48451,48CS090,748,930,1158,1222,64,292,474,190,-126.06920674161752,102.05602450511894,284.3060721875445,0.6354515050167224,883,1130,1440,1459,19,329,576,211,-160.94590057570827,98.73468296300273,305.4499662342724,0.6071955016727948,119934,119512,Tom Green,Tom Green,48,451,Texas,TX
48453,48CS091,4037,4972,6186,5943,-243,972,1906,586,-76.90160918445228,35.756326547589374,122.45266487192603,0.5317608734497526,4863,6092,7712,7406,-306,1314,2543,874,-90.51768395680085,33.784985411769846,128.02246912446364,0.593346911065852,1293757,1303834,Travis,Travis,48,453,Texas,TX
48455,48CS067,148,192,246,216,-30,24,68,12,-365.279153480057,104.36547242287342,487.47372744183764,0.2926829268292683,179,234,303,326,23,92,147,48,-181.19552809436664,318.9041294460853,717.5342912536919,0.5106382978723404,13798,13797,Madison+Trinity+Walker,Trinity,48,455,Texas,TX
48457,48CS078,170,219,277,272,-5,53,102,17,-131.48801852785715,215.1622121364935,508.02188976672085,0.288135593220339,204,266,347,410,63,144,206,60,14.723375229792804,419.24187095003197,728.931848241097,0.4166666666666667,20078,20036,Polk+San Jacinto+Tyler,Tyler,48,457,Texas,TX
48459,48CS050,320,401,501,474,-27,73,154,49,-221.69486893347602,69.96287776993327,306.2333462388119,0.5444444444444444,382,493,638,659,21,166,277,137,-278.4614007388629,69.61535018471572,336.07410434000695,0.8058823529411765,41165,41657,Harrison+Upshur,Upshur,48,459,Texas,TX
48461,48CS095,14,21,30,34,4,13,20,2,56.72223756998886,381.3018211098442,646.8669349151805,0.15842728362414432,16,25,35,32,-3,7,16,2,-154.4568839725494,152.92760789361336,428.19730210211736,0.2222222222222222,3344,3270,"West Texas, excluding El Paso",Upton,48,461,Texas,TX
48463,48CS042,158,201,258,281,23,80,123,40,-82.20698568526328,192.86096348448868,400.186499230314,0.49382716049382713,188,247,319,350,31,103,162,72,-166.38707767513526,125.49876904937213,364.3512649820481,0.6923076923076923,24888,24701,Frio+Medina+Uvalde+Zavala,Uvalde,48,463,Texas,TX
48465,48CS028,256,324,414,498,84,174,242,162,-195.8450066018354,30.130001015666988,200.8666734377799,0.9310344827586207,309,399,509,503,-6,104,194,99,-220.74301046164194,10.511571926744855,199.71986660815224,0.868421052631579,47793,47567,Crockett+Kinney+Terrell+Val Verde,Val Verde,48,465,Texas,TX
48467,48CS080,474,590,743,698,-45,108,224,71,-234.34392444598856,75.72509406914753,309.05935059421404,0.5419847328244275,570,736,935,986,51,250,416,174,-201.82211900256132,124.50065782625538,396.5182135111198,0.6653944020356234,59425,61044,Rains+Van Zandt,Van Zandt,48,467,Texas,TX
48469,48CS092,553,697,863,906,43,209,353,129,-113.13794595734012,105.12236558173299,294.4740265858294,0.5944700460829493,648,840,1071,1119,48,279,471,231,-201.2556270626458,52.7451274857057,263.7805802696594,0.8076923076923077,91322,91004,Victoria,Victoria,48,469,Texas,TX
48471,48CS067,379,480,604,579,-25,99,200,93,-186.50778527762614,9.47541669488363,168.97826439209143,0.8230088495575221,460,598,757,712,-45,114,252,105,-192.94599473111487,10.929963047080816,189.08836071449807,0.7191780821917808,75986,77768,Madison+Trinity+Walker,Walker,48,471,Texas,TX
48473,48CS006,240,302,378,395,17,94,155,27,-20.940535423315104,139.25456056504544,268.03885341843335,0.27980025773195877,290,380,488,501,13,122,211,78,-109.37911924567672,73.19987211056826,223.89064331749665,0.6141732283464567,57305,59426,Austin+Waller+Washington,Waller,48,473,Texas,TX
48475,48CS095,76,92,110,115,5,23,39,13,-84.5165179099703,102.12017734203337,262.94091247981436,0.5475690140104431,86,108,132,122,-10,14,36,24,-302.3609461544438,-88.7991031290584,106.55892375487008,1.263157894736842,11656,11261,"West Texas, excluding El Paso",Ward,48,475,Texas,TX
48477,48CS006,253,318,403,416,13,98,163,65,-174.24397996706168,110.5779103637122,328.550427610969,0.6372549019607843,301,386,493,522,29,136,221,76,-131.1201295873757,167.20951700834306,404.2290073676692,0.5467625899280576,35812,35883,Austin+Waller+Washington,Washington,48,477,Texas,TX
48479,48CS093,925,1144,1423,1897,474,753,972,526,-23.2501978695694,101.39855747151304,199.2459319831207,0.6985391766268261,1097,1381,1763,1980,217,599,883,423,-76.96721542909852,65.71055016018113,171.79948668299625,0.7003311258278145,268643,267841,Webb,Webb,48,479,Texas,TX
48481,48CS058,293,368,455,465,10,97,172,77,-193.4810946534796,57.71248162669042,274.13428772677946,0.7403846153846154,344,445,580,569,-11,124,225,116,-304.7050306009111,19.1864639496835,261.53548671412307,0.8721804511278195,41585,41696,Jackson+Matagorda+Wharton,Wharton,48,481,Texas,TX
48483,48CS072,41,53,67,62,-5,9,21,11,-395.4800878394672,-58.77585281185257,238.3161192713368,0.9283623073561853,49,65,85,92,7,27,43,6,20.26453663870442,425.5552694127928,749.7878556320635,0.2222222222222222,4981,4935,Northeast Panhandle,Wheeler,48,483,Texas,TX
48485,48CS004,920,1154,1421,1403,-18,248,483,240,-238.14251148623214,7.845780417182066,224.38931993140704,0.8633093525179856,1102,1398,1793,1775,-18,377,673,306,-249.32163673897784,54.61843939669062,282.40040989472,0.7574303832368348,130006,129993,Archer+Wichita,Wichita,48,485,Texas,TX
48487,48CS034,113,133,155,182,27,49,69,38,-107.03287586902157,101.2640625144997,286.07465479562774,0.7785030493048509,135,162,192,198,6,36,63,37,-243.17977162673867,-7.84450876215286,203.95722781597436,1.0138888888888888,12812,12748,Eastern Central Panhandle,Wilbarger,48,487,Texas,TX
48489,48CS063,126,148,172,222,50,74,96,64,-81.68469014240317,59.14207883836062,190.25665685493365,0.8647139111627646,157,184,218,228,10,44,71,46,-177.43841767648087,-9.857689870915603,123.22112338644504,1.0222222222222221,20316,20289,Kenedy+Kleberg+Willacy,Willacy,48,489,Texas,TX
48491,48CS096,2206,2715,3389,3106,-283,391,900,256,-105.24468264253247,26.35265168643584,125.73142926839498,0.4816561176953683,2711,3429,4401,4068,-333,639,1357,564,-140.38049321494285,11.737499432687528,124.07319400312885,0.7134727712077326,614739,638978,Williamson,Williamson,48,491,Texas,TX
48493,48CS011,281,352,446,382,-64,30,101,37,-241.122153056365,-16.71143635044114,152.90964260653632,0.5606060606060606,338,434,562,641,79,207,303,115,-70.58549986844761,180.13497885983858,368.10191332227885,0.5528846153846154,50265,51073,Bexar+Wilson,Wilson,48,493,Texas,TX
48495,48CS095,47,60,76,75,-1,15,28,15,-242.88247570549868,-0.2630860224686385,203.5117294593414,0.9490567054773165,54,71,92,88,-4,17,34,17,-281.3614769244511,0,227.7688146531271,0.8947368421052632,7746,7464,"West Texas, excluding El Paso",Winkler,48,495,Texas,TX
48497,48CS097,433,545,679,665,-14,120,232,78,-159.45727008898712,72.71667039888663,266.62779146258436,0.6,526,681,865,833,-32,152,307,153,-259.4718928825223,-1.4025507723379584,215.9928189400456,0.8742857142857143,69310,71299,Wise,Wise,48,497,Texas,TX
48499,48CS055,436,540,671,644,-27,104,208,77,-276.17213180506775,71.69853421862335,348.1362161504265,0.6337555886736215,519,670,851,912,61,242,393,155,-205.57891932630372,190.16869730343885,520.3409010699266,0.6300813008130082,45189,45749,Hopkins and Nearby Counties,Wood,48,499,Texas,TX
48501,48CS043,36,47,61,81,20,34,45,22,-28.255044740785692,186.47011731308052,350.67171182486067,0.6444540142044548,41,55,73,79,6,24,38,13,-91.91126186503269,144.43198293076563,328.254506660831,0.5416666666666666,7811,7616,Gaines and Nearby Counties,Yoakum,48,501,Texas,TX
48503,48CS057,167,214,273,272,-1,58,105,30,-208.53310449042027,188.04917635206982,504.03895304367256,0.4838709677419355,199,262,340,323,-17,61,124,39,-312.13671643868986,122.51574953882566,473.6347499216871,0.5652173913043478,17868,17957,Jack+Palo Pinto+Young,Young,48,503,Texas,TX
48505,48CS033,67,82,100,115,15,33,48,22,-62.88066308764252,92.86936279839564,227.38074879088322,0.6710395145189374,81,102,127,141,14,39,60,23,-64.72724657484987,115.07066057751088,266.1009025854939,0.5897435897435898,13936,13904,Duval and Nearby Counties,Zapata,48,505,Texas,TX
48507,48CS042,71,86,104,140,36,54,69,27,113.43052989054934,331.4817396568608,510.3828458514932,0.495446000231894,84,105,128,151,23,46,67,26,-31.409638396537957,209.39758931025304,429.2650580860187,0.5652173913043478,9954,9551,Frio+Medina+Uvalde+Zavala,Zavala,48,507,Texas,TX
49001,49CS001,42,54,68,43,-25,-11,1,5,-515.2214105910404,-277.08047393439887,-66.25570354131399,-0.38740977458101394,50,67,87,90,3,23,40,13,-138.43185547714288,138.43185547714288,373.76600978828577,0.5652173913043478,7043,7224,Beaver+Iron+Millard,Beaver,49,1,Utah,UT
49003,49CS002,279,352,444,417,-27,65,138,29,-116.24508482871182,74.72898310417189,226.26275439874266,0.36026234567901233,338,438,568,511,-57,73,173,77,-225.4813564218016,-6.730786758859749,161.62301704711967,0.797948883161512,57809,59428,Box Elder+Cache+Rich,Box Elder,49,3,Utah,UT
49005,49CS002,413,512,650,529,-121,17,116,31,-136.9664999014427,-12.61533551723814,76.59310849751729,0.32125214776632305,498,640,823,732,-91,92,234,60,-110.34002325543867,23.38331618658303,127.18331819608673,0.44610281923714756,133171,136850,Box Elder+Cache+Rich,Cache,49,5,Utah,UT
49007,49CS003,145,186,237,220,-17,34,75,3,-117.61303226700011,181.8455860487284,422.3510385647885,0.06976744186046512,171,224,291,292,1,68,121,30,-142.2575413359332,186.4064334746711,446.3943538472387,0.4166666666666667,20457,20386,Carbon+Daggett+Duchesne+Uintah,Carbon,49,7,Utah,UT
49009,49CS003,2,6,11,2,-9,-4,0,2,-1380.392156862745,-752.9411764705883,-250.98039215686273,-0.4,3,7,14,6,-8,-1,3,6,-1439.5886889460155,-719.7943444730078,-308.4832904884319,-0.8571428571428571,956,972,Carbon+Daggett+Duchesne+Uintah,Daggett,49,9,Utah,UT
49011,49CS004,1278,1580,1982,1840,-142,260,562,92,-77.43738750602051,55.584196116263385,155.51994871696192,0.28795062695924767,1546,1941,2489,2338,-151,397,792,212,-99.07784008172636,50.445577033492164,158.19460278908366,0.4534764545471184,362693,366732,Davis,Davis,49,11,Utah,UT
49013,49CS003,104,122,143,137,-6,15,33,3,-55.55522040843161,75.26278306210442,185.74247889134782,0.16120075575991272,126,154,180,194,14,40,68,16,-10.121702934344942,123.99086094572553,263.1642762929685,0.3902439024390244,19646,19760,Carbon+Daggett+Duchesne+Uintah,Duchesne,49,13,Utah,UT
49015,49CS010,74,91,109,96,-13,5,22,4,-210.61189646021225,9.000715768137518,219.130056104808,0.2592477650563344,93,117,142,127,-15,10,34,20,-351.82803985709086,-100.52229710202596,140.73121594283634,1,9883,9948,Wayne and Nearby Counties,Emery,49,15,Utah,UT
49017,49CS010,31,44,57,51,-6,7,20,5,-253.37957047871743,57.29712495472845,348.55652692358416,0.46665176999475266,39,54,71,61,-10,7,22,8,-351.3351957351811,-19.51862198528784,273.26070779402977,0.6666666666666666,5081,5123,Wayne and Nearby Counties,Garfield,49,17,Utah,UT
49019,49CS010,59,74,90,61,-29,-13,2,8,-463.48895376444636,-259.9137556262033,-76.6960773017846,-0.5465286558685027,72,90,110,85,-25,-5,13,3,-289.6863886194633,-82.76753960556094,103.45942450695118,-0.1875,9693,9666,Wayne and Nearby Counties,Grand,49,19,Utah,UT
49021,49CS001,237,302,383,337,-46,35,100,16,-129.17984256206688,39.58737110773017,175.01785121312287,0.26229508196721313,291,381,488,447,-41,66,156,65,-176.37521886577008,1.6639171591110384,151.49965733705997,0.7386363636363636,57594,60099,Beaver+Iron+Millard,Iron,49,21,Utah,UT
49023,49CS005,51,65,83,72,-11,7,21,3,-141.73691483395467,40.894968187881794,182.01960506839188,0.25035431732567065,63,81,102,85,-17,4,22,8,-206.4967313288237,-33.03947701261179,115.63816954414126,0.47058823529411764,11884,12107,Juab+Sanpete+Tooele,Juab,49,23,Utah,UT
49025,49CS010,53,67,82,57,-25,-10,4,4,-453.21603791327846,-210.8880334866011,5.931759947794384,-0.31049178249372816,64,83,103,109,6,26,45,13,-88.10041349509548,163.61505363374877,402.7447474061508,0.48148148148148145,7735,7945,Wayne and Nearby Counties,Kane,49,25,Utah,UT
49027,49CS001,68,85,103,111,8,26,43,5,29.728257552865735,196.13867439063796,347.4208715158855,0.1899804088448272,82,104,129,154,25,50,72,31,-45.654210570534964,144.57166680669405,311.9704388986556,0.62,13043,13142,Beaver+Iron+Millard,Millard,49,27,Utah,UT
49029,49CS006,45,59,74,72,-2,13,27,5,-68.1915827039906,75.66074096681453,211.1449239254676,0.3460334962146515,56,74,94,65,-29,-9,9,4,-261.5238054355346,-103.02452941399848,39.624819005384026,-0.26666666666666666,12379,12618,Morgan+Summit+Wasatch,Morgan,49,29,Utah,UT
49031,49CS010,10,16,24,15,-9,-1,5,6,-1230.6143841565126,-548.9505796032997,-71.78591641605108,-0.6208279310095471,12,20,31,23,-8,3,11,4,-810.9706304733478,-67.58088587277899,473.0662011094529,0.5,1447,1480,Wayne and Nearby Counties,Piute,49,31,Utah,UT
49033,49CS002,7,12,19,11,-8,-1,4,7,-713.2468932525006,-359.27256038007334,-123.28967179845509,-1.117289983696378,7,14,23,20,-3,6,13,2,-193.5405830410064,154.83246643280512,425.7892826902141,0.2857142857142857,2508,2583,Box Elder+Cache+Rich,Rich,49,33,Utah,UT
49035,49CS007,4642,5754,7067,6695,-372,942,2053,576,-96.20013824240972,37.099604882723035,149.94127587622015,0.49146900799370985,5514,6942,8830,7949,-881,1007,2435,623,-126.77491403265354,32.36698712711609,152.6980048944883,0.4296553767683124,1182223,1186394,Salt Lake,Salt Lake,49,35,Utah,UT
49037,49CS010,86,103,124,147,23,44,61,43,-165.30389179198127,10.102947289796608,151.7777019327709,0.9721645941161001,105,128,155,160,5,32,55,27,-152.1292926505338,31.046794418476296,193.52501854183524,0.8181818181818182,14624,14494,Wayne and Nearby Counties,San Juan,49,37,Utah,UT
49039,49CS005,123,159,204,208,4,49,85,14,-41.47704360850279,145.16965262975978,294.48700962036986,0.28,149,195,257,282,25,87,133,32,-24.294602204605912,189.53235762458522,348.0503294560565,0.36363636363636365,28932,29019,Juab+Sanpete+Tooele,Sanpete,49,39,Utah,UT
49041,49CS010,137,178,228,198,-30,20,61,5,-194.75265232414787,83.34635620148983,311.1597298188953,0.1388888888888889,169,218,284,230,-54,12,61,14,-311.16297160637885,-9.151852106069965,215.29732079529575,0.30434782608695654,21597,21854,Wayne and Nearby Counties,Sevier,49,41,Utah,UT
49043,49CS006,110,132,155,147,-8,15,37,6,-38.33102614869279,24.398006737723406,87.12703962413973,0.306643749804604,134,164,195,207,12,43,73,13,-2.441887676073903,69.76821931639742,139.53643863279484,0.29545454545454547,42465,43000,Morgan+Summit+Wasatch,Summit,49,43,Utah,UT
49045,49CS005,275,346,438,352,-86,6,77,20,-173.15516411114194,-22.869549976943276,93.11173919184047,0.273972602739726,337,437,558,526,-32,89,189,64,-126.19805116372342,32.82987803426728,164.2150499274049,0.5981308411214953,73460,76150,Juab+Sanpete+Tooele,Tooele,49,45,Utah,UT
49047,49CS003,166,213,266,254,-12,41,88,15,-90.90792398667372,87.37915059717254,245.33376898436904,0.29705882352941176,201,262,337,340,3,78,139,43,-110.74644255893499,96.90313723906812,265.79146214144396,0.5119047619047619,35706,36119,Carbon+Daggett+Duchesne+Uintah,Uintah,49,47,Utah,UT
49049,49CS008,1858,2296,2835,2649,-186,354,791,223,-74.20481977918283,23.676598975998434,103.07031324340772,0.48478260869565215,2235,2848,3591,3248,-343,400,1013,389,-107.39944204724824,1.5400397971950928,91.53703213613878,0.6576505121873142,661413,681801,Utah (county),Utah (county),49,49,Utah,UT
49051,49CS006,107,127,150,166,16,39,59,16,1.2627131679784271,80.11935925868593,147.71077019357804,0.40620653070799717,131,159,189,173,-16,14,42,12,-77.90237554800422,5.554536580962868,83.31804871444301,0.5,35031,36007,Morgan+Summit+Wasatch,Wasatch,49,51,Utah,UT
49053,49CS009,1015,1261,1558,1478,-80,217,463,111,-125.75168895755439,69.77063087935495,231.72406227431046,0.40808823529411764,1256,1600,2029,1889,-140,289,633,249,-204.95660724791836,21.067105974345967,202.323219001125,0.6850081736445373,182312,189869,Washington,Washington,49,53,Utah,UT
49055,49CS010,12,20,28,33,5,13,21,2,144.3225498976572,533.7526311137145,884.2397042081664,0.15073419880218436,14,24,35,33,-2,9,19,5,-274.60627508029785,156.9178714744559,549.2125501605957,0.5,2533,2549,Wayne and Nearby Counties,Wayne,49,55,Utah,UT
49057,49CS011,1231,1524,1909,1773,-136,250,542,110,-112.34716285458668,63.6961154977234,197.27531685155122,0.3548387096774194,1458,1837,2345,2141,-204,304,683,213,-156.5221225971113,34.15301080526826,176.39467119204485,0.5239860326067223,262810,266448,Weber,Weber,49,57,Utah,UT
50001,50CS001,212,270,341,287,-54,18,75,3,-183.64778467028754,46.71741890735385,232.13724360516156,0.05660377358490566,253,328,420,370,-50,42,117,2,-139.8107232946312,107.34028659856523,308.603323970875,0.029411764705882353,37245,37265,Addison+Chittenden,Addison,50,1,Vermont,VT
50003,50CS002,322,405,513,399,-114,-6,77,7,-392.3648314050331,-42.13748705712871,226.8941610768469,-0.05577777777777777,386,497,637,547,-90,50,161,25,-308.39526014846797,67.0133116359122,364.5524152993624,0.25,37022,37306,Bennington+Windham,Bennington,50,3,Vermont,VT
50005,50CS003,209,266,338,268,-70,2,59,4,-294.4339792727431,-7.957675115479543,218.83606567568745,0.05839727195225916,255,326,423,387,-36,61,132,14,-164.63039447500395,154.7525708065037,388.69236135548425,0.18421052631578946,30160,30371,Caledonia+Essex+Orange,Caledonia,50,5,Vermont,VT
50007,50CS001,798,996,1238,1048,-190,52,250,62,-180.30957167905459,-7.512898819960609,134.51666458596137,0.36046511627906974,962,1206,1544,1318,-226,112,356,42,-158.8745178663475,41.1776207037522,186.06952204335795,0.17319661259055197,167712,168781,Addison+Chittenden,Chittenden,50,7,Vermont,VT
50009,50CS003,49,63,78,68,-10,5,19,7,-345.20227252314027,-46.53177813277849,235.54591101367413,0.5419668313561752,60,78,99,87,-12,9,27,5,-287.02580066480243,67.53548250936527,371.445153801509,0.3333333333333333,5946,5923,Caledonia+Essex+Orange,Essex,50,9,Vermont,VT
50011,50CS004,296,372,469,404,-65,32,108,25,-216.37523261814243,16.819840403409184,199.55539221473313,0.373134328358209,353,455,582,481,-101,26,128,24,-248.622527604352,3.9779604416696324,206.95339197786254,0.25397536394176934,49941,50277,Franklin+Grand Isle,Franklin,50,11,Vermont,VT
50013,50CS004,37,49,62,57,-5,8,20,4,-156.26266305788945,67.2616745524014,263.6921530584147,0.3649776711530577,44,60,80,95,15,35,51,5,135.13247205150802,405.397416154524,621.6093714369368,0.14285714285714285,7283,7400,Franklin+Grand Isle,Grand Isle,50,13,Vermont,VT
50015,50CS005,147,172,200,214,14,42,67,3,52.04494992514983,181.73751293073448,296.17212734742685,0.0711396849281894,177,212,250,246,-4,34,69,6,-38.32139515425959,107.29990643192684,241.4247894718354,0.15789473684210525,25864,26095,Lamoille+Orleans,Lamoille,50,15,Vermont,VT
50017,50CS003,186,241,302,240,-62,-1,54,6,-279.43982000325093,-28.744727994456376,197.10670624770086,-0.049586776859504134,222,295,375,295,-80,0,73,3,-281.3571243945949,-10.169534616672106,237.28914105568245,0.027655055225148682,29223,29500,Caledonia+Essex+Orange,Orange,50,17,Vermont,VT
50019,50CS005,215,274,347,277,-70,3,62,7,-338.51392168707775,-17.573727277719808,241.85842165961867,0.10526910900045228,255,333,433,428,-5,95,173,24,-105.56670560561932,258.01156963851884,541.4608996639339,0.23529411764705882,27314,27518,Lamoille+Orleans,Orleans,50,19,Vermont,VT
50021,50CS006,486,609,769,650,-119,41,164,4,-245.67027347282425,73.84078081636471,319.31148461130687,0.037383177570093455,579,745,953,803,-150,58,224,34,-303.85744592449106,39.62281283448946,313.7631491331133,0.2320846146677849,60129,60571,Rutland,Rutland,50,21,Vermont,VT
50023,50CS007,371,466,580,536,-44,70,165,4,-96.67203850098198,132.92405293885022,324.2541291387104,0.0425531914893617,444,567,733,610,-123,43,166,20,-238.75160107960994,38.373772360803834,243.67345449110428,0.18181818181818182,59583,59937,Washington,Washington,50,23,Vermont,VT
50025,50CS002,319,406,511,390,-121,-16,71,1,-322.8784110441766,-44.99125399795903,185.3904319151193,-0.010309278350515464,385,500,637,536,-101,36,151,24,-271.41976967318345,26.05629788862561,275.7624859879544,0.23300970873786409,45342,46054,Bennington+Windham,Windham,50,25,Vermont,VT
50027,50CS008,407,512,641,554,-87,42,147,7,-196.64386337784066,74.26443776503555,292.87383907337966,0.07446808510638298,488,631,802,675,-127,44,187,27,-264.9523143183213,29.247982749425077,275.36115523796957,0.21774193548387097,57363,58124,Windsor,Windsor,50,27,Vermont,VT
51001,51CS001,298,376,472,423,-49,47,125,32,-293.0560760511553,54.236164599226754,336.26422051520586,0.4444444444444444,353,458,594,555,-39,97,202,50,-267.7319823967349,141.30716645307737,456.9933893801651,0.43859649122807015,33188,33261,Accomack+Northampton+Virginia Beach (city),Accomack,51,1,Virginia,VA
51003,51CS002,589,733,911,852,-59,119,263,46,-112.38905457267447,78.06280669652935,232.04971305680647,0.3087248322147651,703,901,1142,1023,-119,122,320,73,-169.33683938007576,43.2161725501235,217.8888862960818,0.3882978723404255,112217,113383,Albemarle+Charlottesville (city),Albemarle,51,3,Virginia,VA
51005,51CS004,138,180,232,211,-21,31,73,25,-365.85325484267844,47.66817652673335,381.3454122138668,0.625,165,218,284,318,34,100,153,49,-100.25633090140488,339.73906152635544,692.8012235047248,0.48514851485148514,15104,15012,Alleghany and Nearby Counties and Independent Cities,Alleghany,51,5,Virginia,VA
51007,51CS005,121,141,165,156,-9,15,35,3,-111.20814296036934,105.19837936659644,291.7557262001874,0.1417278720500592,150,179,209,224,15,45,74,29,-105.91949239057026,120.62006250883448,339.24392580609697,0.6304347826086957,13221,13265,Amelia+Brunswick+Lunenburg+Nottoway,Amelia,51,7,Virginia,VA
51009,51CS006,236,296,375,324,-51,28,88,18,-264.33563922016197,38.309512930458254,268.3581380778599,0.3157894736842105,282,363,465,478,13,115,196,49,-115.12118036517664,211.05549733615717,470.07815315780465,0.4083333333333333,31324,31271,Amherst+Lynchburg (city)+Nelson,Amherst,51,9,Virginia,VA
51011,51CS007,139,164,187,156,-31,-8,17,2,-242.85589380454078,-71.51324026701357,112.06817423747955,-0.10931413069722722,168,202,240,201,-39,-1,33,24,-386.00773036645205,-153.17767078033813,55.143961480921725,-0.5053191489361701,16122,16321,Appomattox+Campbell,Appomattox,51,11,Virginia,VA
51013,51CS008,591,741,936,986,50,245,395,152,-51.43061882581768,46.86964772955457,122.46585374496517,0.6116724964373623,691,871,1114,1017,-97,146,326,75,-73.60646647706075,30.366409761018673,107.39444353509558,0.3826530612244898,238107,233811,Arlington,Arlington,51,13,Virginia,VA
51015,51CS009,487,618,771,715,-56,97,228,50,-164.60082989161933,72.94897694395199,276.27484885156287,0.4,586,753,959,967,8,214,381,97,-114.94984644073725,150.8595853456675,366.1890789587143,0.42920353982300885,77314,77556,Augusta+Rockbridge and Independent Cities,Augusta,51,15,Virginia,VA
51017,51CS004,44,58,72,65,-7,7,21,3,-296.8573234358162,127.6284271979163,528.5316361297748,0.259510621548924,53,70,90,77,-13,7,24,12,-605.9198368055906,-121.18396736111814,290.84152166668355,0.8571428571428571,4184,4126,Alleghany and Nearby Counties and Independent Cities,Bath,51,17,Virginia,VA
51019,51CS010,561,698,871,817,-54,119,256,42,-144.798806750574,116.14070958118955,322.8560894266704,0.28378378378378377,668,855,1094,1067,-27,212,399,126,-191.21793675471426,107.44686416795443,341.08132462618096,0.5373158756137479,79559,80040,Bedford (county)+Bedford (city),Bedford (county),51,19,Virginia,VA
51021,51CS011,55,69,85,80,-5,11,25,4,-166.79537930492955,133.32418572527664,401.85221759440833,0.281136506678001,65,84,105,98,-7,14,33,3,-161.71308056680434,169.79873459514454,485.139241700413,0.16666666666666666,6246,6184,Bland+Smyth+Wythe,Bland,51,21,Virginia,VA
51023,51CS004,238,302,383,321,-62,19,83,20,-292.65137236095154,-3.5689191751335554,224.841908033414,0.35714285714285715,286,372,479,484,5,112,198,56,-150.9049121692027,165.53722000931148,419.7550935950398,0.4745762711864407,33624,33829,Alleghany and Nearby Counties and Independent Cities,Botetourt,51,23,Virginia,VA
51025,51CS005,135,176,223,193,-30,17,58,13,-325.4395313065983,30.238283977384285,340.55867329529013,0.37142857142857144,162,215,285,275,-10,60,113,27,-232.40536940152998,207.28046460136457,540.1854532035562,0.4153846153846154,15874,15920,Amelia+Brunswick+Lunenburg+Nottoway,Brunswick,51,25,Virginia,VA
51027,51CS013,195,249,316,333,17,84,138,29,-70.95977406210828,325.23229778466293,644.5512810641502,0.33919288645690837,229,297,387,395,8,98,166,64,-282.27361924089695,171.07492075205877,513.4763430219879,0.6274509803921569,20293,19874,Buchanan+Dickenson+Russell+Tazewell,Buchanan,51,27,Virginia,VA
51029,51CS044,118,139,162,174,12,35,56,23,-77.94508650715302,85.7152083425006,237.68548213146477,0.6560823800571327,142,171,202,223,21,52,81,21,0,183.1233609043931,354.4323114278576,0.40384615384615385,16879,16928,Prince Edward and Nearby Counties,Buckingham,51,29,Virginia,VA
51031,51CS007,381,482,610,603,-7,121,222,46,-114.42171643818928,161.91752326158863,380.07439960270216,0.35658914728682173,463,589,757,767,10,178,304,105,-171.31032432923345,131.50003865440635,358.562776632323,0.5497382198952879,55584,55513,Appomattox+Campbell,Campbell,51,31,Virginia,VA
51033,51CS036,194,246,310,278,-32,32,84,23,-213.60566672617225,34.92190736667666,236.69292770747518,0.4554901960784314,231,302,394,377,-17,74,146,38,-175.8889554394659,116.72630679164556,345.3819488629512,0.4418604651162791,30926,31270,King and Queen and Nearby Counties,Caroline,51,33,Virginia,VA
51035,51CS014,237,297,376,394,18,97,157,49,-127.58301912862137,196.91269833356358,443.0535712505181,0.48514851485148514,277,359,465,530,65,171,253,70,-17.377863870532043,347.55727741064095,629.9045507922557,0.4046242774566474,29252,29060,Carroll+Galax (city)+Grayson,Carroll,51,35,Virginia,VA
51036,51CS015,61,75,92,89,-3,14,28,5,-143.59707985260067,163.20557377296385,411.5696267079446,0.30028659309223105,73,93,115,115,0,22,42,14,-211.66354315951938,120.95059609115393,423.32708631903876,0.5833333333333334,6753,6614,Charles City+Goochland+Henrico+New Kent,Charles City,51,36,Virginia,VA
51037,51CS044,115,138,160,161,1,23,46,13,-127.99335900545728,102.63627533463685,341.8077479836233,0.5301140547290614,143,171,202,236,34,65,93,32,17.457402120346963,288.0471349857249,532.8871997235907,0.49230769230769234,11550,11456,Prince Edward and Nearby Counties,Charlotte,51,37,Virginia,VA
51041,51CS017,1884,2307,2860,2583,-277,276,699,185,-152.3048989194993,29.97349870604333,169.3337987338118,0.4378704357276506,2261,2878,3661,3334,-327,456,1073,362,-186.34050358249652,25.40945432183169,192.23333447841065,0.5905399076025633,364322,369941,Chesterfield+Colonial Heights (city)+Powhatan,Chesterfield,51,41,Virginia,VA
51043,51CS018,112,132,156,153,-3,21,41,10,-107.33764174379192,93.09491516304244,253.77501495002093,0.4328961559447034,136,162,195,185,-10,23,49,19,-195.39345633704528,26.90443460751054,202.11956498892266,0.7037037037037037,14767,14867,Clarke+Warren,Clarke,51,43,Virginia,VA
51045,51CS019,34,45,58,55,-3,10,21,2,-131.18879572784914,190.01219228280797,471.0630567921331,0.17503898672939103,42,56,74,72,-2,16,30,3,-102.72873194221508,277.3675762439807,555.7624398073825,0.16666666666666666,4914,4867,Craig+Franklin (county)+Roanoke (county)+Salem (city),Craig,51,45,Virginia,VA
51047,51CS020,306,389,491,406,-85,17,100,33,-268.1346322419586,-36.35723827009609,152.2459352560274,0.42039922103213245,369,478,615,557,-58,80,188,56,-213.3059024997516,43.95167653436354,246.87750223557396,0.5384615384615384,52809,53468,Culpeper+Madison+Rappahannock,Culpeper,51,47,Virginia,VA
51049,51CS044,68,85,104,102,-2,17,34,6,-94.37878233516199,139.96560357457824,343.30129633791023,0.3164089004202063,83,105,127,130,3,25,47,13,-103.33402940283696,124.00083528340436,351.33569996964565,0.5,9704,9677,Prince Edward and Nearby Counties,Cumberland,51,49,Virginia,VA
51051,51CS013,135,176,221,195,-26,19,60,16,-358.6018795766505,25.61441996976075,375.67815955649104,0.43243243243243246,161,210,272,230,-42,20,69,24,-478.1323182364802,-28.93387704910622,325.5061168024449,0.5,14055,13825,Buchanan+Dickenson+Russell+Tazewell,Dickenson,51,51,Virginia,VA
51053,51CS022,175,226,286,277,-9,51,102,18,-115.79175795265712,141.26166404575548,359.5751448437412,0.3103448275862069,208,275,359,371,12,96,163,42,-107.6665382789477,193.47730672423216,433.53248358577946,0.42,28033,27910,Dinwiddie+Petersburg (city),Dinwiddie,51,53,Virginia,VA
51057,51CS036,91,109,132,132,0,23,41,7,-73.8092330575506,176.5580886964459,380.56109160711,0.2880861105355117,110,134,162,183,21,49,73,18,28.36711778263696,293.12688375391525,520.0638260150109,0.3673469387755102,10639,10576,King and Queen and Nearby Counties,Essex,51,57,Virginia,VA
51059,51CS023,3478,4305,5313,5343,30,1038,1865,688,-68.78854612960727,36.58131299151036,123.03863329601712,0.6285976643042581,4123,5230,6611,6034,-577,804,1911,423,-87.62517203531768,33.4356902695276,130.42986699635904,0.3829788018886484,1148127,1140996,Fairfax (county)+Fairfax (city)+Falls Church (city),Fairfax (county),51,59,Virginia,VA
51061,51CS024,388,488,607,524,-83,36,136,23,-174.9140364324103,21.43150305015395,186.37164767845408,0.25842696629213485,465,595,771,708,-63,113,243,58,-164.27569161383676,74.63992597076432,251.0615691743891,0.4128166160081054,72790,73687,Fauquier,Fauquier,51,61,Virginia,VA
51063,51CS025,118,139,161,198,37,59,80,12,192.0745186824372,363.59252037334437,522.4054849019623,0.20319499327694268,144,171,201,213,12,42,69,15,-19.2893999389169,173.6045994502521,347.2091989005042,0.35714285714285715,15531,15553,Floyd+Giles+Montgomery,Floyd,51,63,Virginia,VA
51065,51CS044,157,201,256,223,-33,22,66,14,-206.4111586457927,35.13381423758174,228.589378883266,0.35,190,248,320,290,-30,42,100,19,-177.16139538702458,83.15738967146052,292.85863319079573,0.3275862068965517,27324,27658,Prince Edward and Nearby Counties,Fluvanna,51,65,Virginia,VA
51067,51CS019,404,505,627,618,-9,113,214,41,-109.88147374403209,157.7560540293183,379.05274093155646,0.3333333333333333,482,616,785,796,11,180,314,88,-140.60608085609027,168.58149681384768,411.8856030262657,0.4607329842931937,54768,54870,Craig+Franklin (county)+Roanoke (county)+Salem (city),Franklin (county),51,67,Virginia,VA
51069,51CS026,520,651,819,762,-57,111,242,53,-144.0477321803452,75.95244060418202,247.56567062449324,0.381294964028777,629,810,1025,1026,1,216,397,132,-140.3152321005432,89.90449654039381,283.6807953337069,0.5701970443349753,91636,93432,Frederick+Winchester (city),Frederick,51,69,Virginia,VA
51071,51CS025,152,196,250,244,-6,48,92,13,-136.32202091416966,251.11951221031256,566.8126132747055,0.25,183,241,311,300,-11,59,117,31,-253.46594333936105,168.77637130801688,518.6859553948159,0.4661917684305744,16725,16590,Floyd+Giles+Montgomery,Giles,51,71,Virginia,VA
51073,51CS036,288,359,452,417,-35,58,129,13,-149.5553348470717,140.06222826468735,361.0492995267497,0.17333333333333334,346,444,569,497,-72,53,151,56,-328.34840559743043,-7.689658210712656,243.5058433392341,0.6086956521739131,38554,39013,King and Queen and Nearby Counties,Gloucester,51,73,Virginia,VA
51075,51CS015,166,192,218,207,-11,15,41,12,-110.80111919602396,16.661172747957362,140.14026806868932,0.5450544807029778,206,242,280,277,-3,35,71,33,-141.77833351383813,7.876574084102119,149.65490759794025,0.8461538461538461,24769,25392,Charles City+Goochland+Henrico+New Kent,Goochland,51,75,Virginia,VA
51077,51CS014,133,170,218,214,-4,44,81,29,-258.4369268530422,117.29361279260615,407.008836390343,0.5918367346938775,159,209,273,282,9,73,123,41,-208.4636796825272,208.4636796825272,534.5139036859796,0.5466666666666666,15346,15350,Carroll+Galax (city)+Grayson,Grayson,51,77,Virginia,VA
51079,51CS028,122,144,169,154,-15,10,32,2,-101.490266638788,47.48452399930379,177.23676100667404,0.10902049149688187,152,182,215,236,21,54,84,37,-76.5073593504844,81.28906930988968,224.97945359001798,0.6727272727272727,20530,20913,Greene+Louisa+Orange,Greene,51,79,Virginia,VA
51081,51CS049,105,124,147,138,-9,14,33,21,-318.01610007665437,-75.32374332551511,124.46407178569027,1.0708639319379145,126,156,189,161,-28,5,35,16,-384.93223588764056,-96.23305897191014,166.22073822420845,0.5517241379310345,11382,11431,Southampton and Nearby Counties and Independent Cities,Greensville,51,81,Virginia,VA
51083,51CS029,315,401,505,494,-11,93,179,64,-265.63580154740373,102.64408054463303,407.0368711252689,0.6274509803921569,376,487,626,613,-13,126,237,70,-245.84018536744898,165.8680768744234,494.6423006790841,0.5147058823529411,33904,33762,Halifax+Mecklenburg,Halifax,51,83,Virginia,VA
51085,51CS031,664,838,1036,955,-81,117,291,75,-170.41607513377744,45.86655018019002,235.93971824833454,0.46296296296296297,813,1030,1304,1252,-52,222,439,103,-139.33765608759626,106.83750692283478,301.7037327850305,0.4031326593137255,109884,111384,Hanover,Hanover,51,85,Virginia,VA
51087,51CS015,1876,2334,2869,2929,60,596,1053,275,-77.30861631523068,115.16342797597693,279.6261455566466,0.4417673532796912,2209,2790,3541,3588,47,798,1379,364,-95.03615180009741,130.2214063612183,304.2445584984827,0.4315354213399448,333960,333662,Charles City+Goochland+Henrico+New Kent,Henrico,51,87,Virginia,VA
51089,51CS033,477,592,732,732,0,140,255,76,-179.81811161407458,151.42577820132595,423.63727479605325,0.5100671140939598,555,728,939,979,40,251,424,148,-214.70068826423784,204.66608876646458,548.52498838818,0.5736434108527132,50718,50326,Henry+Martinsville (city)+Patrick,Henry,51,89,Virginia,VA
51091,51CS004,18,27,39,25,-14,-2,7,3,-897.0088433317699,-276.57600131186774,210.9069459894841,-0.34450412355624455,23,35,49,33,-16,-2,10,5,-942.7785779756449,-314.2595259918816,224.47108999420115,-0.3333333333333333,2226,2227,Alleghany and Nearby Counties and Independent Cities,Highland,51,91,Virginia,VA
51093,51CS049,247,314,402,352,-50,38,105,27,-239.75635149993673,32.69404793180956,242.87007035058528,0.4153846153846154,302,393,506,476,-30,83,174,55,-217.16062273126477,71.45120371886503,303.7952072403885,0.5392156862745098,38539,39188,Southampton and Nearby Counties and Independent Cities,Isle of Wight,51,93,Virginia,VA
51095,51CS035,532,663,824,762,-62,99,230,35,-148.59147662779898,98.03973715648593,298.9446047826284,0.25925925925925924,629,810,1039,956,-83,146,327,56,-174.53764939020084,112.96935235611706,340.16327209453027,0.2857142857142857,78336,79668,James City +Williamsburg (city),James City,51,95,Virginia,VA
51097,51CS036,67,84,102,93,-9,9,26,7,-287.37478517096895,38.57673195823377,349.71227103610926,0.4699340604156975,85,107,132,102,-30,-5,17,4,-511.16289558746143,-135.30782530256332,195.44463654814703,-0.17786561264822134,6659,6652,King and Queen and Nearby Counties,King and Queen,51,97,Virginia,VA
51099,51CS052,139,162,187,196,9,34,57,16,-33.23226057783162,80.45162540230689,183.1338449972707,0.4589983782497978,170,204,243,201,-42,-3,31,17,-215.41183441584374,-73.02096081893008,51.114672573251056,-0.37777777777777777,26903,27389,Westmoreland and Nearby Counties,King George,51,99,Virginia,VA
51101,51CS036,115,137,159,152,-7,15,37,7,-92.03819140456163,51.82980439351091,201.50785386804378,0.3721103028655859,140,170,201,221,20,51,81,17,16.545144115099053,187.51163330445593,352.9630744554465,0.3333333333333333,17830,18132,King and Queen and Nearby Counties,King William,51,101,Virginia,VA
51103,51CS052,146,189,244,196,-48,7,50,8,-618.2472644053568,-11.040129721524229,463.68544830401754,0.19047619047619047,172,229,302,241,-61,12,69,17,-713.9343043144972,-45.76501950733957,475.9562028763315,0.3469387755102041,10869,10925,Westmoreland and Nearby Counties,Lancaster,51,103,Virginia,VA
51105,51CS037,193,243,309,315,6,72,122,33,-145.6532042527056,209.9990745233094,479.4978868282229,0.44,224,293,376,412,36,119,188,53,-77.50800035230907,300.0309691057126,613.9270057231284,0.4380165289256198,22286,21998,Lee+Norton (city)+Scott+Wise,Lee,51,105,Virginia,VA
51107,51CS038,1038,1290,1620,1543,-77,254,505,162,-67.96357503096928,26.019527679220456,97.55190131537245,0.5500864752680733,1244,1591,2019,1753,-266,162,509,130,-92.816542522296,7.496540536884078,88.79886532830966,0.396947490117103,421991,426864,Loudoun,Loudoun,51,107,Virginia,VA
51109,51CS028,242,313,398,341,-57,28,99,14,-225.37780222939247,44.40941915850098,269.62861631947027,0.2413793103448276,299,390,501,492,-9,102,193,41,-129.4945201223219,157.66797859204863,393.006822047885,0.36607142857142855,37830,38689,Greene+Louisa+Orange,Louisa,51,109,Virginia,VA
51111,51CS005,115,136,159,136,-23,-0,21,6,-295.55323861459243,-64.897408196208,149.28300576372055,-0.1619078738420483,139,168,200,177,-23,9,38,18,-344.1891013771756,-75.46167874286432,167.6926194285874,0.75,11976,11927,Amelia+Brunswick+Lunenburg+Nottoway,Lunenburg,51,111,Virginia,VA
51113,51CS020,111,132,152,121,-31,-11,10,2,-288.708157964467,-116.59184877095562,69.8674861886818,-0.10657812311725567,135,164,194,177,-17,13,42,27,-315.9401688305277,-100.52641735516791,107.7068757376799,1.08,13757,13927,Culpeper+Madison+Rappahannock,Madison,51,113,Virginia,VA
51115,51CS036,90,107,128,119,-9,12,29,10,-269.8130532938911,29.712212676464652,272.21247608707915,0.586395266137412,107,132,163,178,15,46,71,15,0,362.8790354441123,655.5234188667835,0.32608695652173914,8564,8543,King and Queen and Nearby Counties,Mathews,51,115,Virginia,VA
51117,51CS029,306,389,489,443,-46,54,137,51,-383.7672220799611,11.862974407417655,340.2696492527628,0.6710526315789473,365,473,599,557,-42,84,192,49,-301.1203179777672,115.68837683009717,472.66965390582556,0.44344799344799346,30347,30254,Halifax+Mecklenburg,Mecklenburg,51,117,Virginia,VA
51119,51CS036,118,140,161,162,1,22,44,5,-46.75063076838915,194.54841683852155,436.31150107544516,0.20939142587990725,145,172,205,212,7,40,67,24,-158.02254919807427,148.72710512759932,399.7040950304232,0.6,10630,10758,King and Queen and Nearby Counties,Middlesex,51,119,Virginia,VA
51121,51CS025,436,545,681,604,-77,59,168,54,-158.356719253782,6.04184354268531,137.81445120865186,0.5294117647058824,505,652,848,799,-49,147,294,74,-124.7161724809456,74.01854139113033,223.12027442627704,0.4417949814656401,99307,98624,Floyd+Giles+Montgomery,Montgomery,51,121,Virginia,VA
51125,51CS006,132,156,180,186,6,30,54,2,32.11104204160611,225.98122007223836,426.5365766556512,0.06533051789379708,160,191,223,206,-17,15,46,24,-277.3729623376001,-60.8867478302049,148.8342724738342,0.96,14758,14782,Amherst+Lynchburg (city)+Nelson,Nelson,51,125,Virginia,VA
51127,51CS015,137,160,187,178,-9,18,41,12,-107.11494544757355,29.43906646135294,148.95045597914944,0.5306549610852243,173,204,243,245,2,41,72,20,-75.90817773938366,88.31422340870122,218.682838916784,0.46511627906976744,23156,23779,Charles City+Goochland+Henrico+New Kent,New Kent,51,127,Virginia,VA
51131,51CS001,117,142,169,194,25,52,77,23,24.280600014428394,284.0419065650327,535.6856722859309,0.44429015418601325,133,166,206,213,7,47,80,20,-107.79389064702143,223.02184271797546,495.60409492883434,0.4166666666666667,12154,12106,Accomack+Northampton+Virginia Beach (city),Northampton,51,131,Virginia,VA
51133,51CS052,116,152,198,177,-21,25,61,12,-332.9876390952154,131.17694873447877,494.940718109706,0.36363636363636365,144,187,247,245,-2,58,101,28,-249.97309317399865,249.97309317399865,608.26786005673,0.45161290322580644,11892,12001,Westmoreland and Nearby Counties,Northumberland,51,133,Virginia,VA
51135,51CS005,138,178,230,184,-46,6,46,21,-516.961458294263,-111.87971858607185,192.89606652771008,0.5384615384615384,165,218,280,262,-18,44,97,29,-301.66218750500906,96.17285467747365,436.30418405347183,0.5370370370370371,15552,15597,Amelia+Brunswick+Lunenburg+Nottoway,Nottoway,51,135,Virginia,VA
51137,51CS028,274,346,432,379,-53,33,105,12,-213.52383742035343,68.93160008958372,305.26851468244223,0.1875,330,428,550,472,-78,44,142,52,-350.79910985231635,-21.57933778407175,242.90242093195752,0.615406162464986,36558,37072,Greene+Louisa+Orange,Orange,51,137,Virginia,VA
51139,51CS042,197,251,320,319,-1,68,122,36,-187.02250553292467,161.74919397442133,434.95369192184205,0.4931506849315068,235,307,394,358,-36,51,123,53,-374.10087062520034,-8.406761137644951,294.2366398175733,0.7464788732394366,23740,23790,Page+Shenandoah,Page,51,139,Virginia,VA
51141,51CS033,170,217,272,273,1,56,103,32,-212.07758913050174,163.9247065743009,485.28543342100295,0.5423728813559322,202,259,336,362,26,103,160,47,-119.63031108143242,318.2564095278013,642.1959692257418,0.44761904761904764,17569,17596,Henry+Martinsville (city)+Patrick,Patrick,51,141,Virginia,VA
51143,51CS021,498,617,765,694,-71,77,196,55,-250.74782803375643,43.78136679954477,280.5987599425369,0.4700854700854701,597,756,976,895,-81,139,298,105,-310.0551329452322,56.64628973744166,321.5509976272424,0.5982954545454545,60300,60022,Danville (city)+Pittsylvania,Pittsylvania,51,143,Virginia,VA
51145,51CS017,171,198,226,245,19,47,74,10,35.1606615512089,145.4863316970047,252.56712919145343,0.21339369577364084,213,252,288,315,27,63,102,30,-9.666979277084494,106.33677204792941,232.00750265002782,0.47619047619047616,30404,31033,Chesterfield+Colonial Heights (city)+Powhatan,Powhatan,51,145,Virginia,VA
51147,51CS044,152,195,248,222,-26,27,70,17,-234.5105888613151,54.53734624681747,289.0479351081326,0.4146341463414634,179,238,307,273,-34,35,94,25,-269.15470027552243,45.61944072466481,315.0022382038103,0.4807692307692308,22003,21920,Prince Edward and Nearby Counties,Prince Edward,51,147,Virginia,VA
51149,51CS034,183,230,292,243,-49,13,60,12,-172.83479362730725,2.8333572725788074,136.14281694741157,0.27906976744186046,215,282,368,364,-4,82,149,48,-121.32625564467686,78.08702332558452,235.42654793683695,0.5454545454545454,42353,42901,Hopewell (city)+Prince George,Prince George,51,149,Virginia,VA
51153,51CS045,1415,1756,2192,2300,108,544,885,324,-53.9142685219708,54.72454076565361,139.89038644012862,0.5864258196399088,1716,2174,2757,2644,-113,470,928,274,-79.93281967125937,40.47754206321363,135.09379663597548,0.5102420856610801,481320,484219,Prince William,Prince William,51,153,Virginia,VA
51155,51CS046,309,386,481,452,-29,66,143,47,-269.8527571510117,65.68784220123312,340.86664061180426,0.573170731707317,371,475,611,580,-31,105,209,60,-269.5565831234622,133.2972114346791,441.5099858741981,0.49586776859504134,33796,33759,Pulaski+Radford (city),Pulaski,51,155,Virginia,VA
51157,51CS020,46,58,74,63,-11,5,17,5,-261.8084340427204,-6.100672631234877,195.77387585151686,0.44624842329841435,54,72,92,96,4,24,42,5,-13.5260418574637,256.9947952918103,500.4635487261569,0.2,7331,7393,Culpeper+Madison+Rappahannock,Rappahannock,51,157,Virginia,VA
51159,51CS052,90,110,130,106,-24,-4,16,4,-374.01682099075913,-109.50016321001499,155.01649457072898,-0.242418105769232,112,138,168,132,-36,-6,20,10,-510.94907402050745,-177.72141705061128,111.07588565663205,-0.37037037037037035,8951,9003,Westmoreland and Nearby Counties,Richmond (county),51,159,Virginia,VA
51161,51CS019,714,880,1106,1003,-103,122,289,92,-242.57471288198713,37.94117304051594,245.31145323245036,0.5364477084183326,846,1074,1369,1352,-17,278,506,113,-134.84936818465633,170.76090368740063,406.77317087474427,0.3717105263157895,96465,96626,Craig+Franklin (county)+Roanoke (county)+Salem (city),Roanoke (county),51,161,Virginia,VA
51163,51CS009,176,222,280,271,-9,49,95,21,-159.0306492923228,148.42860600616797,392.2756015877296,0.38181818181818183,208,270,352,347,-5,77,139,63,-300.6209556661399,61.84707390633297,335.7412583486647,0.7682926829268293,22637,22636,Augusta+Rockbridge and Independent Cities,Rockbridge,51,163,Virginia,VA
51165,51CS032,510,642,794,788,-6,146,278,76,-117.71983616126461,100.49254306449416,290.13632790477516,0.4779874213836478,607,785,998,1018,20,233,411,145,-148.27775388858407,104.38753873756319,315.5943713764623,0.5930495148879225,83588,84301,Harrisonburg (city)+Rockingham,Rockingham,51,165,Virginia,VA
51167,51CS013,228,293,369,341,-28,48,113,23,-236.7010754524966,116.02993894730226,417.7077802102881,0.36507936507936506,276,352,453,463,10,111,187,59,-191.78385705162455,203.31825824025438,500.8667092418571,0.5042735042735043,25855,25576,Buchanan+Dickenson+Russell+Tazewell,Russell,51,167,Virginia,VA
51169,51CS037,213,270,339,302,-37,32,89,37,-412.2909599519458,-27.857497294050393,289.7179718581241,0.6981132075471698,247,325,424,392,-32,67,145,56,-410.49243543296063,51.31155442912008,415.3903565375582,0.6588235294117647,21538,21438,Lee+Norton (city)+Scott+Wise,Scott,51,169,Virginia,VA
51171,51CS042,340,426,536,544,8,118,204,62,-146.58982137664546,152.0190740202249,385.6126690102311,0.5,399,524,663,639,-24,115,240,103,-284.35846587059604,26.857942467116505,306.6281764995801,0.7744360902255639,44205,44680,Page+Shenandoah,Shenandoah,51,171,Virginia,VA
51173,51CS011,298,376,476,441,-35,65,143,46,-326.70953763596617,76.58829383199702,391.0033948265111,0.5679012345679012,355,463,591,604,13,141,249,77,-216.84700780070406,216.84700780070406,582.7763334643922,0.5167785234899329,29770,29514,Bland+Smyth+Wythe,Smyth,51,173,Virginia,VA
51175,51CS049,135,159,183,194,11,35,59,33,-149.4886753004473,15.557856710139212,175.10283765370642,0.9341835865548276,165,197,230,258,28,61,93,29,-5.556269381830305,177.80062021856975,355.6012404371395,0.47540983606557374,17933,17998,Southampton and Nearby Counties and Independent Cities,Southampton,51,175,Virginia,VA
51177,51CS027,682,845,1050,982,-68,137,300,71,-119.08342915180482,56.482258886231534,196.0191120892626,0.41642586859305125,822,1049,1334,1227,-107,178,405,115,-155.01798723632868,43.99159097247165,202.5358882788159,0.4904073467903255,140221,143209,Fredericksburg (city)+Spotsylvania,Spotsylvania,51,177,Virginia,VA
51179,51CS050,570,711,892,751,-141,40,181,36,-134.99248267998348,3.049816044732753,110.59395432212145,0.288,695,888,1138,1028,-110,140,333,87,-122.84936652385933,33.35417969564311,153.3980544694016,0.45789473684210524,157387,160400,Stafford,Stafford,51,179,Virginia,VA
51181,51CS049,50,64,80,74,-6,10,24,6,-216.0971461778591,71.22429437273362,328.30137276010595,0.4558970378562178,62,79,100,101,1,22,39,2,-15.308465581466551,306.16931162933105,566.4132265142624,0.08695652173913043,6524,6532,Southampton and Nearby Counties and Independent Cities,Surry,51,181,Virginia,VA
51183,51CS049,95,113,133,125,-8,12,30,17,-279.9457746127746,-60.54812031508727,140.14827862666402,0.9827560711606448,113,140,167,176,9,36,63,20,-102.19506482999425,148.6473670254462,399.9543219028407,0.5405405405405406,10815,10764,Southampton and Nearby Counties and Independent Cities,Sussex,51,183,Virginia,VA
51185,51CS013,410,513,639,609,-30,96,199,31,-181.68086392571203,193.27751481458728,499.6967133014059,0.2672413793103448,485,620,795,790,-5,170,305,94,-247.71195721831515,188.81628238246134,527.6852395059515,0.5222222222222223,40356,39986,Buchanan+Dickenson+Russell+Tazewell,Tazewell,51,185,Virginia,VA
51187,51CS018,271,342,433,351,-82,9,80,29,-327.1350813693256,-58.94325790438299,150.45266580093744,0.4027777777777778,327,424,546,532,-14,108,205,77,-222.4713366972276,75.78693887487972,313.0489523525273,0.6470588235294118,40717,40904,Clarke+Warren,Warren,51,187,Virginia,VA
51191,51CS012,453,573,721,687,-34,114,234,65,-220.73723853162352,109.25378472777325,376.8140738570139,0.48148148148148145,551,707,894,888,-6,181,337,111,-218.113379825677,130.43944116016564,421.3193949473349,0.5663265306122449,53820,53665,Bristol (city)+Washington,Washington,51,191,Virginia,VA
51193,51CS052,161,209,264,230,-34,21,69,16,-325.4865566085667,32.51613952133533,344.6710789261545,0.41025641025641024,193,254,329,257,-72,3,64,28,-534.8529098783989,-133.71322746959973,192.54704755622362,0.4117647058823529,18452,18697,Westmoreland and Nearby Counties,Westmoreland,51,193,Virginia,VA
51195,51CS037,324,406,512,490,-22,84,166,43,-215.72574144784414,134.3104155055755,407.9057063502664,0.44329896907216493,382,490,629,659,30,169,277,73,-120.44445404057882,268.89924623012945,571.6910016205145,0.4183415435139573,36185,35701,Lee+Norton (city)+Scott+Wise,Wise,51,195,Virginia,VA
51197,51CS011,263,334,420,398,-22,64,135,39,-258.7397357035642,105.95402772463726,406.863466462607,0.527027027027027,315,404,521,505,-16,101,190,75,-322.7866061293984,92.22474460839955,407.9171396140749,0.6637168141592921,28314,28192,Bland+Smyth+Wythe,Wythe,51,197,Virginia,VA
51199,51CS053,314,399,502,453,-49,54,139,21,-120.16527725366439,56.56853280129708,202.27535971372896,0.2625,383,493,630,628,-2,135,245,63,-91.80269599802037,101.68914018242256,257.118166252917,0.43448275862068964,70004,70804,York,York,51,199,Virginia,VA
51510,51CS003,491,616,778,705,-73,89,214,87,-121.0720989203049,1.5129284463643227,96.07095634413449,0.725,578,729,940,798,-142,69,220,58,-128.77675892243477,7.080951502858197,104.3474762375739,0.4142857142857143,158633,155346,Alexandria (city),Alexandria (city),51,510,Virginia,VA
51520,51CS012,177,225,281,249,-32,24,72,20,-363.0313642010738,27.89866391554842,362.68263090212946,0.425531914893617,203,268,348,306,-42,38,103,38,-468.277264041306,0,380.76795032358666,0.6333333333333333,17205,17084,Bristol (city)+Washington,Bristol (city),51,520,Virginia,VA
51530,51CS009,57,72,89,89,0,17,32,10,-178.84927287359935,120.96414730456462,405.076615303822,0.5465956105244024,69,89,114,112,-2,23,43,17,-287.71440559528804,90.85718071430149,394.4715929345916,0.68,6598,6604,Augusta+Rockbridge and Independent Cities,Buena Vista (city),51,530,Virginia,VA
51540,51CS002,188,242,302,259,-43,17,71,26,-178.1787516996784,-23.240706743436316,116.20353371718157,0.5531914893617021,222,289,370,329,-41,40,107,23,-140.12203795836473,37.132886130821525,183.58935760562042,0.359375,46470,45782,Albemarle+Charlottesville (city),Charlottesville (city),51,540,Virginia,VA
51550,51CS016,1292,1592,1958,1810,-148,218,518,138,-137.70907853720885,38.52002196845003,183.01825437759814,0.4487816743517069,1547,1946,2492,2391,-101,446,844,237,-134.68127473177523,83.05544448853931,241.7969055373782,0.48318093021322583,249221,251037,Chesapeake (city),Chesapeake (city),51,550,Virginia,VA
51570,51CS017,177,226,287,229,-58,3,52,13,-473.312206073933,-66.5231491319653,259.4402816146647,0.23636363636363636,212,275,358,320,-38,45,108,38,-416.7341676839354,38.332972060283154,383.32972060283157,0.59375,18039,18261,Chesterfield+Colonial Heights (city)+Powhatan,Colonial Heights (city),51,570,Virginia,VA
51580,51CS004,85,104,126,88,-38,-16,3,1,-815.7314019663681,-366.19690140264015,48.75802219464688,-0.0507570167708263,107,134,166,117,-49,-17,10,25,-1294.2531081021996,-734.5760883823294,-261.4741076503776,-0.9615384615384616,5706,5718,Alleghany and Nearby Counties and Independent Cities,Covington (city),51,580,Virginia,VA
51590,51CS021,480,605,758,669,-89,64,189,69,-450.80484954211914,-14.25695286344463,342.30943825130544,0.6106194690265486,580,733,933,890,-43,157,310,109,-359.86923528280585,113.60554615964932,475.84156365411434,0.5940098598241863,42085,42251,Danville (city)+Pittsylvania,Danville (city),51,590,Virginia,VA
51595,51CS049,39,53,67,110,43,57,71,21,474.5214029813823,770.5238608722013,1049.114409475325,0.36596605648945346,46,63,82,95,13,32,49,3,176.23798001901903,511.0901420551552,810.6947080874876,0.09090909090909091,5666,5674,Southampton and Nearby Counties and Independent Cities,Emporia (city),51,595,Virginia,VA
51600,51CS023,169,216,273,217,-56,2,48,15,-354.6668840550802,-67.4366610527265,164.84517146222035,0.2564289888953828,200,262,342,233,-109,-29,33,19,-527.9419078369276,-197.90091039572454,57.721098865419656,-0.3114754098360656,24023,24255,Fairfax (county)+Fairfax (city)+Falls Church (city),Fairfax (city),51,600,Virginia,VA
51610,51CS023,72,90,111,84,-27,-6,12,10,-303.56819284958834,-128.1426101430571,13.88464047126879,-0.6459862786899695,88,113,141,99,-42,-14,11,3,-310.33695900205373,-117.10828641586933,55.10978184276204,-0.14285714285714285,14622,14516,Fairfax (county)+Fairfax (city)+Falls Church (city),Falls Church (city),51,610,Virginia,VA
51620,51CS049,103,123,145,132,-13,9,29,20,-482.54783255270337,-154.9599187187925,136.22933802246195,1.1285989489490744,127,155,187,180,-7,25,53,18,-304.4958816932001,85.25884687409604,426.2942343704801,0.6206896551724138,8131,8210,Southampton and Nearby Counties and Independent Cities,Franklin (city),51,620,Virginia,VA
51630,51CS027,142,168,192,202,10,34,60,8,6.700923841969015,111.76656963558091,220.1537583078595,0.2278977771803115,174,206,244,257,13,51,83,11,7.063955285163045,141.2791057032609,254.47898914799856,0.21568627450980393,28217,28313,Fredericksburg (city)+Spotsylvania,Fredericksburg (city),51,630,Virginia,VA
51640,51CS014,140,165,192,123,-69,-42,-17,19,-1583.8002338574702,-1107.927641717025,-646.9260680809687,-0.4496802870436941,180,215,256,173,-83,-42,-7,24,-1605.5167757121824,-990.318758850505,-465.1497200661463,-0.5581395348837209,6634,6665,Carroll+Galax (city)+Grayson,Galax (city),51,640,Virginia,VA
51650,51CS030,896,1106,1376,1250,-126,144,354,73,-174.48882035654205,61.80086327624323,246.45833631369896,0.35096153846153844,1072,1353,1716,1624,-92,271,552,179,-196.9760740176735,66.83311381016398,271.0373343757845,0.557632398753894,136891,137656,Hampton (city)+Poquoson (city),Hampton (city),51,650,Virginia,VA
51660,51CS032,201,255,327,292,-35,37,91,37,-166.5960821371095,0,124.86035302434303,0.6981132075471698,235,305,396,368,-28,63,133,40,-132.2239111382777,44.68993322822024,180.79992551677788,0.5333333333333333,51898,51466,Harrisonburg (city)+Rockingham,Harrisonburg (city),51,660,Virginia,VA
51670,51CS034,206,267,333,273,-60,6,67,19,-414.1312320880443,-68.06202297275065,251.30593097631012,0.3275862068965517,251,324,420,426,6,102,175,62,-242.48564004438,173.04952010303657,489.2975180913355,0.5794392523364486,22920,23115,Hopewell (city)+Prince George,Hopewell (city),51,670,Virginia,VA
51678,51CS009,62,79,98,67,-31,-12,5,4,-571.2267127189431,-261.1561340129128,21.951785675202164,-0.26289767054042457,77,100,126,72,-54,-28,-5,14,-914.5752016744797,-564.8846833871786,-255.54307105610462,-0.4827586206896552,7318,7435,Augusta+Rockbridge and Independent Cities,Lexington (city),51,678,Virginia,VA
51680,51CS006,529,668,832,779,-53,111,250,56,-164.93146769671773,83.22230021394014,293.5477498455343,0.4057971014492754,643,811,1039,976,-63,165,333,116,-226.80409108244672,62.03405226368903,274.78553150681023,0.5903346110017611,79306,78989,Amherst+Lynchburg (city)+Nelson,Lynchburg (city),51,680,Virginia,VA
51683,51CS039,171,218,276,251,-25,33,80,45,-197.8316046782857,-33.91398937342041,99.05711062819863,1,206,267,347,288,-59,21,82,27,-201.3536742167791,-14.04793075931017,128.77269862700987,0.47791353383458646,42460,42711,Manassas (city)+Manassas Park (city),Manassas (city),51,683,Virginia,VA
51685,51CS039,20,30,39,33,-6,3,13,2,-58.83571794642663,9.750662065014495,78.33704207645556,0.26619334233819364,22,34,47,49,2,15,27,1,5.87470718256387,82.24590055589417,152.7423867466606,0.0625,17261,17022,Manassas (city)+Manassas Park (city),Manassas Park (city),51,685,Virginia,VA
51690,51CS033,213,274,344,261,-83,-14,48,31,-1030.7676389529033,-401.8323253035847,153.50897820586383,-0.47331002331002336,257,336,436,295,-141,-41,38,57,-1466.6952608265667,-725.7568066700507,-140.70795231358125,-0.8028169014084507,13289,13503,Henry+Martinsville (city)+Patrick,Martinsville (city),51,690,Virginia,VA
51700,51CS040,1089,1365,1694,1599,-95,234,510,94,-122.70906798836113,90.87156582052661,270.05082114021496,0.32136846042358225,1295,1635,2114,1974,-140,339,679,201,-184.5429703368146,74.68307890463464,258.68486751025625,0.5062972292191436,184876,184781,Newport News (city),Newport News (city),51,700,Virginia,VA
51710,51CS041,1324,1646,2053,1896,-157,250,572,123,-141.08080366716612,63.726911851085575,226.2431313227077,0.38080495356037153,1573,1982,2527,2450,-77,468,877,216,-124.44050878330204,106.81497596928484,280.81933244887125,0.4173916939874387,238204,235454,Norfolk (city),Norfolk (city),51,710,Virginia,VA
51720,51CS037,36,49,62,58,-4,9,22,1,-176.79092587659653,273.8260312888764,671.4292287878233,0.08361501447420801,47,62,82,95,13,33,48,13,0,545.2717554910569,955.588751498076,0.3939393939393939,3722,3668,Lee+Norton (city)+Scott+Wise,Norton (city),51,720,Virginia,VA
51730,51CS022,385,485,601,522,-79,37,137,38,-425.44727595816,-3.6347481927224266,360.0218084891563,0.4318181818181818,468,597,773,668,-105,71,200,73,-532.6237002090884,-5.98285538005154,379.9113166332728,0.6134453781512605,33015,33429,Dinwiddie+Petersburg (city),Petersburg (city),51,730,Virginia,VA
51735,51CS030,88,106,126,110,-16,4,22,3,-181.7244844941726,9.096695725699009,184.04917072978068,0.1674186636691602,107,132,160,137,-23,5,30,12,-278.7368574742126,-55.74737149484253,143.3503838438808,0.48,12434,12557,Hampton (city)+Poquoson (city),Poquoson (city),51,735,Virginia,VA
51740,51CS043,709,879,1105,1065,-40,186,356,85,-153.85226848759373,124.31263293797574,333.6132589884982,0.40476190476190477,831,1054,1352,1345,-7,290,514,151,-161.65039398238866,142.5425408378206,370.9682397933388,0.483974358974359,97496,97866,Portsmouth (city),Portsmouth (city),51,740,Virginia,VA
51750,51CS046,82,101,123,103,-20,2,21,3,-164.37660552773536,-8.215067884286135,129.92783080030344,0.163768838841554,100,126,152,140,-12,14,40,16,-170.32450366375105,-12.166035975982219,145.99243171178662,0.6956521739130435,16426,16439,Pulaski+Radford (city),Radford (city),51,750,Virginia,VA
51760,51CS047,1263,1580,1958,1732,-226,152,469,138,-192.22298429314088,7.3911611648008035,174.774564543379,0.4867740008958344,1530,1937,2448,2299,-149,362,769,224,-164.72972443735455,60.896603194093025,240.4974546433384,0.5022421524663677,227299,226614,Richmond (city),Richmond (city),51,760,Virginia,VA
51770,51CS048,842,1050,1313,1284,-29,234,442,107,-163.79448186864764,153.5008926001659,403.43646361031824,0.42209237185272785,1004,1271,1635,1468,-167,197,464,117,-286.984570518391,80.79804906377365,350.4615378141182,0.4254545454545455,99674,99012,Roanoke (city),Roanoke (city),51,770,Virginia,VA
51775,51CS019,235,295,374,348,-26,53,113,25,-241.42170559964234,132.54525013313696,416.8074740793823,0.38461538461538464,280,363,466,395,-71,32,115,51,-480.8233113913907,-74.8823189871838,252.23517974630332,0.6939096630877453,25350,25373,Craig+Franklin (county)+Roanoke (county)+Salem (city),Salem (city),51,775,Virginia,VA
51790,51CS009,261,328,414,345,-69,16,84,36,-491.33548298561846,-91.20458751279925,224.7374579482051,0.5217391304347826,306,398,516,423,-93,25,117,43,-529.5688086567627,-70.08998938104213,288.14773412206205,0.5180722891566265,25657,25681,Augusta+Rockbridge and Independent Cities,Staunton (city),51,790,Virginia,VA
51800,51CS051,540,680,843,838,-5,158,298,83,-111.88364679271774,95.24714539675176,273.16881299788395,0.4853801169590643,653,836,1069,1062,-7,226,409,140,-153.2186798108601,89.60766041301578,280.3365236525801,0.5668016194331984,94491,95974,Suffolk (city),Suffolk (city),51,800,Virginia,VA
51810,51CS001,2171,2734,3385,3056,-329,322,885,163,-128.9381128830839,41.79581141114091,189.24724138636964,0.3340177960301164,2636,3350,4230,4058,-172,708,1422,403,-125.5677676275649,66.4963221610322,222.56067891762217,0.4809069212410501,457941,457920,Accomack+Northampton+Virginia Beach (city),Virginia Beach (city),51,810,Virginia,VA
51820,51CS009,186,236,298,225,-73,-12,39,15,-472.96553345787,-142.42712087083584,128.99060003396454,-0.2830188679245283,219,291,371,317,-54,26,98,28,-364.2747868353905,-8.884750898424159,310.96628144484555,0.45901639344262296,22327,22510,Augusta+Rockbridge and Independent Cities,Waynesboro (city),51,820,Virginia,VA
51830,51CS035,54,68,85,84,-1,16,30,1,-13.424652371628532,115.039867002617,223.96240213290008,0.05745207008058617,64,83,105,84,-21,1,20,1,-141.30776590548706,0,122.03852510019337,0.05,15398,15569,James City +Williamsburg (city),Williamsburg (city),51,830,Virginia,VA
51840,51CS026,172,219,276,269,-7,50,97,25,-137.01848024858387,107.04568769420612,308.2915805593137,0.43859649122807015,204,271,350,325,-25,54,121,41,-234.73065250379364,46.23482549317147,284.5220030349014,0.6119402985074627,28025,28117,Frederick+Winchester (city),Winchester (city),51,840,Virginia,VA
53001,53CS001,85,103,123,110,-13,7,25,18,-183.24025896024924,-62.99863200661882,42.8139997125759,1.0528163656330083,101,126,153,155,2,30,54,18,-77.5995861355406,55.77470253491981,174.59906880496635,0.5806451612903226,20512,20619,Adams+Grant,Adams,53,1,Washington,WA
53003,53CS002,167,215,275,266,-9,51,99,22,-166.64399376091325,155.6417333032684,413.25563670178167,0.39285714285714285,200,264,341,290,-51,26,90,29,-357.439726260743,-13.403989734777863,272.54779127381653,0.5087719298245614,22359,22381,Asotin+Columbia+Garfield+Whitman,Asotin,53,3,Washington,WA
53005,53CS003,1010,1248,1566,1520,-46,272,510,149,-113.11825326048813,71.56815716019612,209.31512847176379,0.49337748344370863,1194,1521,1935,1904,-31,383,710,227,-123.10524084803313,74.4213042910024,230.44366049851735,0.5341176470588235,207075,209617,Benton,Benton,53,5,Washington,WA
53007,53CS004,495,612,768,653,-115,42,158,40,-235.67541940748006,2.280729865233678,179.41741606504937,0.3555625790139064,588,751,959,832,-127,81,244,73,-251.51180133101875,10.052932353975269,214.94425989343364,0.4899328859060403,78922,79579,Chelan+Kittitas,Chelan,53,7,Washington,WA
53009,53CS005,724,906,1143,917,-226,11,193,4,-356.6547628147639,10.852350965891535,293.01347607907144,0.019230769230769232,880,1125,1422,1255,-167,130,375,75,-310.02828797322184,70.4464194940186,384.25319724010143,0.3401378033730975,77403,78074,Clallam+Jefferson,Clallam,53,9,Washington,WA
53011,53CS006,2599,3188,3932,3577,-355,388,978,137,-117.26259638690468,59.95434639419909,200.5073588555103,0.23600362039290165,3113,3950,5005,4646,-359,696,1533,409,-150.45879722013797,56.3204273169581,220.2177682377685,0.4608463868652987,503383,510472,Clark,Clark,53,11,Washington,WA
53013,53CS002,35,48,61,52,-9,4,17,7,-478.82756254368024,-81.16106627902569,316.50542998562906,0.6426453611950453,43,59,77,74,-3,15,31,5,-198.5881622837639,248.23520285470485,645.4115274222326,0.29411764705882354,3969,4028,Asotin+Columbia+Garfield+Whitman,Columbia,53,13,Washington,WA
53015,53CS007,824,1027,1278,1084,-194,57,260,25,-237.11442260858098,34.623141790894785,254.3177961859318,0.1366120218579235,984,1243,1585,1588,3,345,604,229,-202.89581959232387,104.09515733175395,336.6042544408698,0.6189189189189189,110908,111436,Cowlitz+Klickitat+Skamania+Wahkiakum,Cowlitz,53,15,Washington,WA
53017,53CS008,205,264,332,283,-49,19,78,13,-172.73054589653313,16.702389611268313,180.9425541220734,0.25,254,323,416,387,-29,64,133,42,-162.86567118529697,50.46541924051456,208.7433250403102,0.5454545454545454,43108,43594,Douglas+Okanogan,Douglas,53,17,Washington,WA
53019,53CS009,52,66,81,85,4,19,33,4,6.4152085084297505,251.6838228176645,482.6847338014311,0.199500111449105,61,80,102,133,31,53,72,12,261.7387835460439,564.8047434414632,826.5435269875072,0.22641509433962265,7261,7259,Ferry+Lincoln+Pend Oreille+Stevens,Ferry,53,19,Washington,WA
53021,53CS010,282,359,451,454,3,95,172,69,-81.80485660472544,32.177401992781576,127.47201558678854,0.69,345,442,571,554,-17,112,209,95,-114.17600434956206,17.3302863744871,116.21486157008997,0.7692433779176502,96962,98094,Franklin,Franklin,53,21,Washington,WA
53023,53CS002,14,21,30,24,-6,3,10,3,-492.77687290770587,-19.66551652893822,367.4255932355083,0.4454448502080292,17,26,38,32,-6,6,15,3,-384.92381716118683,128.30793905372894,513.2317562149158,0.3333333333333333,2294,2338,Asotin+Columbia+Garfield+Whitman,Garfield,53,23,Washington,WA
53025,53CS001,484,606,752,710,-42,104,226,82,-150.0346952714102,26.597609153674654,174.09344173314318,0.6456692913385826,579,738,942,912,-30,174,333,120,-149.80868317951166,53.913154892993205,212.65744430013984,0.6217616580310881,99257,100161,Adams+Grant,Grant,53,25,Washington,WA
53027,53CS011,608,751,945,800,-145,49,192,28,-273.9329381405051,33.24236752933029,259.60706070524606,0.2028985507246377,733,928,1197,1133,-64,205,400,116,-234.77394884979128,116.05043847615343,370.3834499904649,0.5021645021645021,75807,76691,Grays Harbor+Pacific,Grays Harbor,53,27,Washington,WA
53029,53CS012,542,685,848,704,-144,19,162,30,-240.72057120135537,-15.213595422090831,182.63229777155397,0.2222222222222222,656,832,1064,907,-157,75,251,41,-226.75914329075476,38.91878279599022,240.43795077346306,0.24924242424242424,86764,87361,Island,Island,53,29,Washington,WA
53031,53CS005,270,339,434,350,-84,11,80,4,-319.9632365473159,25.451621088991036,276.51368340253816,0.0625,327,418,544,448,-96,30,121,18,-340.05721064841424,35.795495857727815,307.2446727788304,0.2,33004,33524,Clallam+Jefferson,Jefferson,53,31,Washington,WA
53033,53CS013,9047,11176,13774,12136,-1638,960,3089,973,-138.1886759079893,-0.6616330360432315,112.00653340568641,0.5024529124018142,10630,13367,16977,15083,-1894,1716,4453,734,-116.54751407039072,43.542642552501924,164.91886718701426,0.26871704735744906,2267118,2255260,King,King,53,33,Washington,WA
53035,53CS014,1555,1950,2400,2012,-388,62,457,41,-187.2452689380531,8.944490302295442,181.52952147658627,0.11097071448453684,1867,2340,2973,2649,-324,308,782,192,-188.11680861388467,42.439210308903114,214.94640380058607,0.40764331210191085,275030,274510,Kitsap,Kitsap,53,35,Washington,WA
53037,53CS004,207,263,332,302,-30,39,95,29,-156.7751123199755,26.572052935589067,175.50840963956566,0.5178571428571429,247,325,414,384,-30,59,137,30,-132.25678757447483,63.924113994329495,235.85793784114676,0.39473684210526316,45160,45366,Chelan+Kittitas,Kittitas,53,37,Washington,WA
53039,53CS007,154,179,207,177,-30,-2,23,2,-169.62509220378774,-22.289240316774343,112.26305971533618,-0.06450767034738851,191,225,264,296,32,71,105,26,26.008765315144057,195.06573986358043,342.4487433160634,0.36619718309859156,22767,23069,Cowlitz+Klickitat+Skamania+Wahkiakum,Klickitat,53,39,Washington,WA
53041,53CS015,653,806,997,863,-134,58,210,31,-240.5068507731628,38.591774420156305,260.8949580139999,0.21830985915492956,790,993,1269,1132,-137,139,342,145,-335.2456734584296,-7.13288666932829,234.19644564294552,0.7056002841581814,82401,84117,Lewis,Lewis,53,41,Washington,WA
53043,53CS009,76,94,113,102,-11,8,26,3,-158.35615958361194,53.27668632635625,246.89822620143354,0.21382901532996645,94,117,143,144,1,27,50,20,-169.84758414159924,62.57542573637867,268.18039601305145,0.7142857142857143,10955,11186,Ferry+Lincoln+Pend Oreille+Stevens,Lincoln,53,43,Washington,WA
53045,53CS016,470,591,747,623,-124,32,153,13,-247.95643750455446,34.375573240324954,253.29369756028916,0.12093284873658705,575,729,934,875,-59,146,300,75,-198.93575677302601,105.36694316213988,334.2061352128715,0.42134831460674155,66326,67384,Mason,Mason,53,45,Washington,WA
53047,53CS008,299,380,481,413,-68,33,114,33,-287.25535339118437,0,230.25911553375488,0.46156103286384975,364,466,594,563,-31,96,199,76,-251.65212794078772,48.1687079625224,289.01224777513437,0.672566371681416,42213,42559,Douglas+Okanogan,Okanogan,53,47,Washington,WA
53049,53CS011,232,295,373,268,-105,-27,36,2,-549.1682549526455,-148.83999433295998,175.01530368116968,-0.03603896103896104,283,364,474,413,-61,49,130,30,-381.0992899757276,79.57018142350356,418.9998237590278,0.4,23381,23878,Grays Harbor+Pacific,Pacific,53,49,Washington,WA
53051,53CS009,113,134,157,144,-13,10,31,5,-159.56796469434474,44.15573989697602,233.69154363282948,0.2745596263215244,139,168,200,236,36,68,97,23,94.01838179900557,325.44824468886543,535.181557932801,0.3382352941176471,13560,13827,Ferry+Lincoln+Pend Oreille+Stevens,Pend Oreille,53,51,Washington,WA
53053,53CS017,4710,5826,7161,6198,-963,372,1488,304,-165.20590759332896,8.928639922792248,154.36119457761632,0.3137254901960784,5646,7032,8854,8226,-628,1194,2580,627,-135.6496571878161,61.22418101174986,211.06941838649158,0.41020647944836086,920633,925288,Pierce,Pierce,53,53,Washington,WA
53055,53CS018,102,123,146,124,-22,1,22,5,-184.05395573067216,-29.096739256703565,114.79210461198147,0.19110157718323517,126,154,184,159,-25,5,33,6,-168.02870038608208,-5.4202806576155504,146.34757775561988,0.25,17827,18449,San Juan+Skagit,San Juan,53,55,Washington,WA
53057,53CS018,845,1047,1310,1128,-182,81,283,43,-207.99115078751925,35.119590001891716,221.80793685405297,0.2388888888888889,1000,1270,1629,1535,-94,265,535,96,-145.62744315915438,129.42959712804148,336.3637814120462,0.3127035830618892,129842,130573,San Juan+Skagit,Skagit,53,57,Washington,WA
53059,53CS007,63,79,95,86,-9,7,23,4,-133.060181024056,30.589731601227683,186.46627337681016,0.293023977637188,77,98,121,105,-16,7,28,6,-181.47899205772208,8.230339775860413,181.0674750689291,0.3333333333333333,12057,12150,Cowlitz+Klickitat+Skamania+Wahkiakum,Skamania,53,59,Washington,WA
53061,53CS019,3758,4660,5755,5226,-529,566,1468,366,-129.55490989594477,29.03130420132655,159.56357720629353,0.4354552403601155,4502,5646,7206,6384,-822,738,1882,348,-140.52865878946807,46.88290581570891,184.17598378127596,0.30633826554926596,828761,832926,Snohomish,Snohomish,53,61,Washington,WA
53063,53CS020,3210,3978,4925,4498,-427,520,1288,289,-159.61368173638968,51.47031546186365,222.64810703578888,0.3958904109589041,3838,4826,6151,5866,-285,1040,2028,641,-169.83601897255673,73.26763088336097,254.41015659924486,0.5416139538735693,538563,545261,Spokane,Spokane,53,63,Washington,WA
53065,53CS009,318,403,506,432,-74,29,114,21,-245.04758055528322,20.624730609597748,239.89139790288374,0.2916666666666667,388,492,636,631,-5,139,243,101,-224.09871618919428,80.33727561499417,300.3134210818399,0.6778523489932886,46546,47301,Ferry+Lincoln+Pend Oreille+Stevens,Stevens,53,65,Washington,WA
53067,53CS021,1628,2023,2525,2101,-424,78,473,57,-195.609130798356,8.540107581633007,169.17546447425386,0.15000103878835727,1973,2474,3125,2910,-215,436,937,201,-139.82904930021078,78.95201005658227,247.3213710772469,0.3551236749116608,295078,297649,Thurston,Thurston,53,67,Washington,WA
53069,53CS007,31,43,56,41,-15,-2,10,5,-536.3001053779286,-181.90303026129538,128.1944104657589,-0.43038041311038483,39,54,71,68,-3,14,29,7,-219.21511853600836,153.45058297520583,483.3693363718975,0.4375,4454,4562,Cowlitz+Klickitat+Skamania+Wahkiakum,Wahkiakum,53,69,Washington,WA
53071,53CS022,395,494,624,541,-83,46,146,37,-230.89966687912641,18.279556961264174,209.73386408187315,0.40217391304347827,467,600,771,711,-60,111,244,63,-196.2779007839148,76.59625396445455,288.8317076576307,0.4666666666666667,62365,62666,Walla Walla,Walla Walla,53,71,Washington,WA
53073,53CS023,1181,1450,1810,1570,-240,120,389,56,-156.07279180191773,33.73407185181606,175.57530209124886,0.22535302500323875,1392,1772,2260,2082,-178,310,690,129,-134.33457280780198,79.39343850412263,245.4635152429113,0.3241206030150754,227663,228608,Whatcom,Whatcom,53,73,Washington,WA
53075,53CS002,174,223,283,270,-13,47,96,25,-94.72810894771213,54.84258939078071,176.99199303388318,0.46296296296296297,204,266,344,396,52,130,192,44,16.61084014025191,179.68959145429733,309.3377211024269,0.3384615384615385,48138,47860,Asotin+Columbia+Garfield+Whitman,Whitman,53,75,Washington,WA
53077,53CS024,1378,1734,2161,2127,-34,394,749,303,-158.30792311025203,42.46255791783583,209.26299261165505,0.7079439252336449,1659,2098,2659,2537,-122,440,878,308,-167.91768694899264,51.34560128773987,222.62125151486597,0.6105060506050606,255755,256108,Yakima,Yakima,53,77,Washington,WA
54001,54CS001,117,154,197,211,14,57,94,12,15.007174904668656,346.3194208769685,631.0709447091425,0.20689655172413793,142,186,245,266,21,80,124,35,-90.53333836296325,291.0000161666676,575.8566986587052,0.43209876543209874,15593,15464,Barbour+Pocahontas+Randolph+Tucker,Barbour,54,1,West Virginia,WV
54003,54CS002,765,948,1173,1158,-15,210,393,65,-78.37300811626227,141.96235074151193,321.32443802320125,0.2765957446808511,934,1178,1508,1515,7,336,581,186,-142.58867868056697,119.85253360192866,314.56312805821807,0.5269121813031161,122568,125571,Berkeley+Morgan,Berkeley,54,3,West Virginia,WV
54005,54CS003,213,268,337,298,-39,30,85,14,-294.4586635418915,91.58469271331215,394.0917080391008,0.2641509433962264,249,320,419,396,-23,76,147,35,-271.6345450823268,191.8521334776124,524.0838768168924,0.3977272727272727,21619,21371,Boone+Lincoln+Logan,Boone,54,5,West Virginia,WV
54007,54CS004,120,142,166,153,-13,11,33,3,-153.19355010688133,74.0309888601366,285.5848699673605,0.16513162601305584,145,170,199,209,10,38,64,22,-98.22885761401015,134.50424486565709,342.78203009702275,0.5641025641025641,12591,12267,Braxton+Gilmer+Lewis+Upshur,Braxton,54,7,West Virginia,WV
54009,54CS005,214,272,347,350,3,78,136,37,-182.50746468950248,220.08253094910592,531.4187942429631,0.45121951219512196,251,329,421,427,6,98,176,57,-229.85419094235522,184.78474173797184,536.5517927781839,0.5533980582524272,22355,22188,Brooke+Hancock,Brooke,54,9,West Virginia,WV
54011,54CS006,885,1110,1390,1171,-219,61,286,95,-402.5585307584445,-43.5267611568997,244.64600167892735,0.46568627450980393,1074,1359,1728,1559,-169,200,485,154,-345.5305153798191,49.18583848823048,353.9776485114934,0.5347222222222222,93735,93523,Cabell,Cabell,54,11,West Virginia,WV
54013,54CS011,55,70,86,86,-0,16,31,8,-157.9686436467801,154.01105328036155,434.79278051478923,0.47227280903810664,66,84,105,125,20,41,59,4,258.1175891493515,598.7680751426963,890.0606522391431,0.0975609756097561,6325,6179,Jackson and Nearby Counties,Calhoun,54,13,West Virginia,WV
54015,54CS007,86,104,123,112,-11,8,26,4,-215.69866554533075,65.58601693861198,322.41116181525535,0.26691139958302573,103,128,154,155,1,27,52,20,-240.24403736427004,88.51096113420475,404.62153661350743,0.6896551724137931,8067,7909,Clay+Fayette+Nicholas+Webster,Clay,54,15,West Virginia,WV
54017,54CS021,45,58,73,78,5,20,33,3,27.855094363722106,253.28288362822838,453.66314075223386,0.15284819040112962,52,69,89,94,5,25,42,12,-90.41080409108888,167.90577902630793,388.1206661338881,0.46153846153846156,7878,7742,Tyler and Nearby Counties,Doddridge,54,17,West Virginia,WV
54019,54CS007,401,506,632,574,-58,68,173,39,-286.5196974599787,85.66052810659157,395.9584066444343,0.4216339410939691,475,604,779,787,8,183,312,82,-185.29699981193144,252.5640618219309,575.3959467844186,0.42487046632124353,40625,39990,Clay+Fayette+Nicholas+Webster,Fayette,54,19,West Virginia,WV
54021,54CS004,60,75,93,80,-13,5,20,2,-239.9751968139281,51.275248563335765,289.57106750836994,0.1589362365945011,73,94,117,90,-27,-4,17,13,-542.2151182000717,-230.4414252350305,54.22151182000717,-0.65,7452,7377,Braxton+Gilmer+Lewis+Upshur,Gilmer,54,21,West Virginia,WV
54023,54CS009,101,121,143,143,-0,22,42,22,-240.2835976620009,-2.9056810869866507,216.14362046057832,0.9248288931752209,123,150,178,176,-2,26,53,27,-264.60157007558144,-9.10848778229196,236.82068233959097,0.9310344827586207,11035,10979,Hardy and Nearby Counties,Grant,54,23,West Virginia,WV
54025,54CS008,325,408,507,472,-35,64,147,41,-275.5540224617821,83.39134890290774,384.68791819993487,0.4823529411764706,384,496,638,641,3,145,257,78,-229.73981965424156,205.23423889112246,548.3123695747898,0.5016129032258064,33097,32646,Greenbrier+Monroe+Summers,Greenbrier,54,25,West Virginia,WV
54027,54CS009,182,232,299,268,-31,36,86,23,-280.36448103636786,67.49515284208856,327.0918945424292,0.45098039215686275,215,283,369,349,-20,66,134,46,-283.654668348777,85.95596010569001,378.20622446503603,0.5897435897435898,23113,23268,Hardy and Nearby Counties,Hampshire,54,27,West Virginia,WV
54029,54CS005,284,362,457,452,-5,90,168,63,-282.0315411835643,111.90083191706444,435.16990189969505,0.6494845360824743,342,437,558,522,-36,85,180,84,-417.98830068162573,3.483235839013548,334.5648023372511,0.8076923076923077,28954,28709,Brooke+Hancock,Hancock,54,29,West Virginia,WV
54031,54CS009,116,137,160,171,11,34,55,2,80.12086920534612,268.44017704087514,449.4494932598679,0.05793235163231856,139,168,198,207,9,39,68,36,-190.5209925908503,21.168999176761144,225.80265788545222,0.9230769230769231,14171,14172,Hardy and Nearby Counties,Hardy,54,31,West Virginia,WV
54033,54CS010,582,719,898,724,-174,5,142,27,-365.90130742682516,-40.03893938517857,209.47645105609317,0.1631553965240251,693,874,1117,1082,-35,208,389,149,-282.23348633007384,90.42506485731391,367.83077230093795,0.647838333427853,65936,65247,Harrison+Taylor,Harrison,54,33,West Virginia,WV
54035,54CS011,233,295,371,347,-24,52,114,28,-224.10910039565633,103.33560825159948,370.28592956823144,0.4375,272,359,458,452,-6,93,180,62,-245.1549230398309,111.76180315051114,425.41589586323596,0.6078431372549019,27870,27738,Jackson and Nearby Counties,Jackson,54,35,West Virginia,WV
54037,54CS012,342,426,534,505,-29,79,163,36,-135.2907367539185,89.36254501410902,264.0351475358732,0.391304347826087,411,522,678,604,-74,82,193,66,-240.31796443276966,26.597132800485035,218.1822861665593,0.5546218487394958,57742,58277,Jefferson,Jefferson,54,37,West Virginia,WV
54039,54CS013,1727,2141,2652,2484,-168,343,757,189,-238.5789999558017,102.90201930596123,379.56813030357966,0.4410741128030848,2058,2610,3299,3092,-207,482,1034,303,-286.2148986579353,100.41643837665703,410.27688383669323,0.5166244163938811,179588,178258,Kanawha,Kanawha,54,39,West Virginia,WV
54041,54CS004,164,208,264,214,-50,6,50,8,-413.86122192337626,-14.258784562390225,299.4344758101948,0.17206290471785385,197,256,328,344,16,88,147,59,-254.3015025226857,168.54867027666378,520.4309819068917,0.6483516483516484,16832,16909,Braxton+Gilmer+Lewis+Upshur,Lewis,54,41,West Virginia,WV
54043,54CS003,189,241,305,271,-34,30,82,11,-265.5920027296956,112.13884559698258,419.0451598624086,0.23404255319148937,224,293,379,378,-1,85,154,46,-233.1722694504018,193.48337252267385,535.8001085243276,0.4946236559139785,20332,20157,Boone+Lincoln+Logan,Lincoln,54,43,West Virginia,WV
54045,54CS003,359,456,570,518,-52,62,159,56,-400.6966845647267,22.260926920262595,382.33141985550986,0.6292134831460674,424,550,710,700,-10,150,276,77,-271.9493611534404,226.624467627867,622.0450904544211,0.4723926380368098,32344,31991,Boone+Lincoln+Logan,Logan,54,45,West Virginia,WV
54047,54CS014,224,283,359,309,-50,26,85,1,-328.5032996983228,160.71590004810312,540.0054241616265,0.0186932215234102,261,338,437,420,-17,82,159,60,-417.48795599207045,119.28227314059156,536.770229132662,0.6521739130434783,18666,18444,McDowell+Mercer,McDowell,54,47,West Virginia,WV
54049,54CS015,478,594,742,608,-134,14,130,18,-325.07211798993086,-8.5517163561968,239.4480579735104,0.15384615384615385,568,725,931,868,-63,143,300,118,-323.077266337937,44.623931814632186,324.95147147415145,0.6742857142857143,56129,56024,Marion,Marion,54,49,West Virginia,WV
54051,54CS016,258,328,415,398,-17,70,140,58,-296.19059683046146,47.32739230313633,323.40384740476486,0.7160493827160493,305,395,515,501,-14,106,196,76,-298.7105468002649,99.45967152062094,398.00445220168467,0.6608695652173913,30426,30163,Marshall+Ohio,Marshall,54,51,West Virginia,WV
54053,54CS011,231,291,372,332,-40,41,101,22,-291.8557412390117,89.36759199905273,371.5810404171141,0.369774011299435,270,352,461,483,22,131,213,54,-127.05460783883917,305.72515011220673,631.3025826992322,0.4,25513,25186,Jackson and Nearby Counties,Mason,54,53,West Virginia,WV
54055,54CS014,598,746,937,884,-53,138,286,50,-208.5257865681044,177.98515245386216,477.424945871979,0.29673851789236405,711,906,1154,1150,-4,244,439,149,-258.7479408892118,159.76269463593934,490.4461133744549,0.5752895752895753,59331,59150,McDowell+Mercer,Mercer,54,55,West Virginia,WV
54057,54CS009,219,280,352,353,1,73,134,70,-308.2720695094114,13.393428074268419,285.72646558439294,0.9090909090909091,257,339,440,429,-11,90,172,69,-298.4000322661711,78.18341456755574,383.47103335515436,0.696969696969697,26879,26860,Hardy and Nearby Counties,Mineral,54,57,West Virginia,WV
54059,54CS017,233,295,374,337,-37,42,104,25,-317.96711882364986,87.1845325806782,405.1516514043281,0.4166666666666667,273,356,455,488,33,132,215,89,-242.73291252404303,184.21694254056837,546.3657789938502,0.664179104477612,23399,23071,Mingo+Wayne,Mingo,54,59,West Virginia,WV
54061,54CS018,475,594,752,671,-81,77,196,33,-129.03433723504472,49.80272665212252,184.55305865064943,0.29333912768647286,565,725,929,827,-102,102,262,99,-189.14897656977016,2.821715214864796,153.36022192790165,0.66,106018,106318,Monongalia+Preston,Monongalia,54,61,West Virginia,WV
54063,54CS008,121,142,165,183,18,41,62,16,16.81758431864699,238.32663496995363,444.40916245090125,0.3885858443092458,145,173,203,227,24,54,82,18,48.65505928145938,291.93035568875626,519.3927578295785,0.3333333333333333,12471,12332,Greenbrier+Monroe+Summers,Monroe,54,63,West Virginia,WV
54065,54CS002,145,184,234,203,-31,18,58,3,-237.5079132921478,108.27566635377326,384.2039773843568,0.08333333333333333,171,225,295,281,-14,56,110,48,-360.58740852033145,46.52740755101051,360.878204817525,0.7741935483870968,17178,17194,Berkeley+Morgan,Morgan,54,65,West Virginia,WV
54067,54CS007,220,278,352,291,-61,13,71,6,-328.0765035777103,34.27664962752197,318.52800832432894,0.10909090909090909,259,335,436,427,-9,92,168,70,-324.6683750570439,90.4139778639869,402.75317412139617,0.7,24506,24333,Clay+Fayette+Nicholas+Webster,Nicholas,54,67,West Virginia,WV
54069,54CS016,398,493,614,600,-14,107,202,47,-173.9311077543098,170.93966364059935,441.5941310715483,0.3983050847457627,467,598,766,715,-51,117,248,73,-296.674804745841,105.14451396550146,418.3078902195688,0.5,42120,41847,Marshall+Ohio,Ohio,54,69,West Virginia,WV
54071,54CS009,59,74,91,100,9,26,41,3,110.13970024082886,441.3503383966706,725.2451711016776,0.11535595779044418,70,89,111,114,3,25,44,10,-113.99104356086309,244.2665219161352,553.6707830099064,0.38461538461538464,6255,6141,Hardy and Nearby Counties,Pendleton,54,71,West Virginia,WV
54073,54CS021,67,83,101,88,-13,5,21,3,-254.26220866464345,30.95083435006488,277.2711896809495,0.227543216493056,80,101,126,123,-3,22,43,19,-289.16929547844376,39.43217665615142,315.45741324921136,0.7916666666666666,7610,7608,Tyler and Nearby Counties,Pleasants,54,73,West Virginia,WV
54075,54CS001,68,85,101,99,-2,14,31,6,-123.27530219625051,126.21887567404556,375.7130535443416,0.3574629871059303,81,102,125,136,11,34,55,14,-38.25615685024309,255.04104566828727,522.8341436199888,0.4117647058823529,7909,7842,Barbour+Pocahontas+Randolph+Tucker,Pocahontas,54,75,West Virginia,WV
54077,54CS018,248,318,405,343,-62,25,95,36,-345.11166962729123,-38.71727043243451,207.66535959214872,0.6206896551724138,300,385,500,481,-19,96,181,78,-282.53970180410334,52.430047757462475,300.01638438992416,0.7155963302752294,34093,34331,Monongalia+Preston,Preston,54,77,West Virginia,WV
54079,54CS019,420,526,658,595,-63,68,175,54,-245.4307580962611,30.39065749270526,253.70959237875655,0.5294117647058824,495,641,827,733,-94,92,238,62,-272.43237109345023,52.37405403911251,307.3484071195251,0.4696969696969697,57254,57280,Putnam,Putnam,54,79,West Virginia,WV
54081,54CS020,737,911,1141,1019,-122,108,282,28,-242.7071702809747,129.4006905863244,410.9280680431964,0.16470588235294117,874,1108,1418,1351,-67,243,477,140,-280.4809179211374,139.4619094659771,456.2977037867406,0.5109489051094891,74188,73855,Raleigh+Wyoming,Raleigh,54,81,West Virginia,WV
54083,54CS001,233,297,376,323,-53,26,90,4,-244.57833479341355,94.39865553429996,369.0129261795362,0.06896551724137931,279,361,462,472,10,111,193,55,-161.97631478415894,201.3468063909634,496.1760586063026,0.4761994002998501,27966,27813,Barbour+Pocahontas+Randolph+Tucker,Randolph,54,83,West Virginia,WV
54085,54CS021,73,90,108,113,5,23,40,4,18.129251847621664,270.69938202126366,500.30859127002896,0.16523633319579079,86,107,132,146,14,39,60,16,-23.840803037715656,274.16923493373,524.4976668297444,0.41025641025641024,8594,8389,Tyler and Nearby Counties,Ritchie,54,85,West Virginia,WV
54087,54CS011,137,177,226,170,-56,-7,33,5,-525.8156382862504,-103.43914195795092,241.35799790188548,-0.11627906976744186,162,216,278,228,-50,12,66,22,-517.6310590617637,-71.89320264746719,316.6895576620926,0.46808510638297873,13921,13910,Jackson and Nearby Counties,Roane,54,87,West Virginia,WV
54089,54CS008,132,153,177,187,10,34,55,10,2.3755664879788956,240.7032051504221,454.3762605029576,0.2934270965475238,157,187,219,255,36,68,98,23,108.74109787223624,377.86481886105247,629.7746981017541,0.3382352941176471,12005,11909,Greenbrier+Monroe+Summers,Summers,54,89,West Virginia,WV
54091,54CS010,134,159,185,209,24,50,75,10,100.53923016012611,284.19111638409663,467.54726688145854,0.20200872681829915,161,191,226,257,31,66,96,35,-24.209441934536155,187.6231749926552,369.19398950167636,0.5303030303030303,16680,16522,Harrison+Taylor,Taylor,54,91,West Virginia,WV
54093,54CS001,62,77,94,101,7,24,39,5,40.35841335721896,332.0762316035945,609.2081589376511,0.21081162337322185,73,93,114,115,1,22,42,24,-344.8705800209466,-29.923694578823998,269.31325120941597,1.0434782608695652,6764,6684,Barbour+Pocahontas+Randolph+Tucker,Tucker,54,93,West Virginia,WV
54095,54CS021,71,86,104,86,-18,0,15,6,-340.4135893285982,-79.41671437599452,134.7193580283005,0.28503408427856564,80,101,123,142,19,41,62,21,-25.082333268758187,244.70569042690946,501.6466653751644,0.5121951219512195,8316,8173,Tyler and Nearby Counties,Tyler,54,95,West Virginia,WV
54097,54CS004,172,223,280,255,-25,32,83,3,-141.06454981368105,145.84213706227277,402.3231367235111,0.06521739130434782,202,269,350,345,-5,76,143,61,-277.42943414203546,63.05214412318988,344.89522835384844,0.7349397590361446,23861,23790,Braxton+Gilmer+Lewis+Upshur,Upshur,54,97,West Virginia,WV
54099,54CS017,342,429,534,527,-7,98,185,29,-111.0519624214212,212.8495946410573,481.3794093295215,0.27102803738317754,402,517,667,704,37,187,302,88,-132.3080182550475,256.8332119068569,555.1748216976503,0.4607329842931937,38901,38546,Mingo+Wayne,Wayne,54,99,West Virginia,WV
54101,54CS007,90,109,127,103,-24,-6,13,4,-399.850174696669,-137.714409710084,124.42135527650055,-0.2467336189963595,109,133,160,151,-9,18,42,26,-423.69461706076993,-96.84448389960455,193.6889677992091,1.0833333333333333,8299,8261,Clay+Fayette+Nicholas+Webster,Webster,54,101,West Virginia,WV
54103,54CS021,136,176,223,195,-28,19,59,14,-348.33091436865016,41.46796599626787,373.2116939664109,0.3944444444444445,161,212,274,317,43,105,156,49,-42.60288361666792,394.34074091461235,753.4724871047057,0.46226415094339623,14469,14201,Tyler and Nearby Counties,Wetzel,54,103,West Virginia,WV
54105,54CS011,34,45,59,53,-6,8,19,4,-232.67020253279472,86.30791209569823,331.1705236193348,0.36132627885989754,39,53,69,86,17,33,47,13,78.73240822753665,393.6620411376833,669.2254699340616,0.3939393939393939,5258,5080,Jackson and Nearby Counties,Wirt,54,105,West Virginia,WV
54107,54CS022,742,926,1157,1004,-153,78,262,74,-324.8503098082952,5.720454498054946,268.86136140858247,0.4417949814656401,886,1134,1450,1338,-112,204,452,167,-333.4797274082572,44.216985895379025,340.5902967617033,0.65748031496063,83909,83678,Wood,Wood,54,107,West Virginia,WV
54109,54CS020,207,267,336,319,-17,52,112,23,-226.7417486276416,164.3877677550402,504.5003906965026,0.3709677419354839,248,320,412,408,-4,88,160,58,-293.9627982966752,142.2400636919396,483.6162165525947,0.6105263157894737,21169,21091,Raleigh+Wyoming,Wyoming,54,109,West Virginia,WV
55001,55CS001,180,229,294,241,-53,12,61,16,-401.5511686769734,-23.2614724794771,261.6915653941174,0.3333333333333333,214,281,362,322,-40,41,108,30,-335.8032193134823,52.76907732069007,374.18073009216596,0.46875,20635,20846,Adams+Juneau+Monroe+Vernon,Adams,55,1,Wisconsin,WI
55003,55CS002,128,166,214,163,-51,-3,35,11,-467.6591006334323,-105.51534905508544,180.88345552300362,-0.19642857142857142,154,204,267,206,-61,2,52,18,-491.6695371562211,-99.45275087862879,211.3370956170862,0.318609022556391,15922,16088,Ashland+Bayfield+Douglas+Price,Ashland,55,3,Wisconsin,WI
55005,55CS003,366,460,579,503,-76,43,137,55,-338.9869130790709,-31.004900586500394,211.8668206744194,0.6470588235294118,434,570,727,618,-109,48,184,51,-342.768445748847,-6.42289404901025,284.8553510736045,0.4594594594594595,46444,46708,Barron+Sawyer+Washburn,Barron,55,5,Wisconsin,WI
55007,55CS002,123,146,170,163,-7,17,40,17,-180.43752414177092,-2.5573769466004315,169.18897206942643,0.852308863949751,150,182,218,190,-28,8,40,13,-251.42994392652318,-30.662188283722337,165.57581673210063,0.5,16084,16307,Ashland+Bayfield+Douglas+Price,Bayfield,55,7,Wisconsin,WI
55009,55CS004,1434,1774,2204,2060,-144,286,626,216,-161.1198325646678,31.10507878679003,183.5199648420612,0.5901683401142175,1714,2168,2752,2375,-377,207,661,196,-212.71618096770953,4.082131874816477,172.61851287008037,0.4409454398218443,268123,269467,Brown,Brown,55,9,Wisconsin,WI
55011,55CS005,94,112,132,109,-23,-3,15,11,-311.0687013710293,-124.87526543001843,38.64791184352396,-0.5712662170780983,111,136,163,143,-20,7,32,6,-195.4207653353627,7.516183282129335,195.4207653353627,0.2857142857142857,13273,13305,Buffalo+Jackson+Pepin+Trempealeau,Buffalo,55,11,Wisconsin,WI
55013,55CS006,134,176,223,170,-53,-6,36,27,-584.3133177279747,-241.0292435627896,65.73524824439716,-0.574468085106383,164,217,284,230,-54,13,66,23,-460.7909097705016,-59.8041414367945,257.1578081782164,0.4791666666666667,16430,16721,Burnett+Polk,Burnett,55,13,Wisconsin,WI
55015,55CS007,250,317,396,353,-43,36,103,34,-177.33770476082015,4.6031850684184334,158.92496448714633,0.5666666666666667,299,386,497,404,-93,18,105,57,-285.6473169402613,-74.2435545529503,91.47186657100661,0.6994128274616079,52138,52530,Calumet+Winnebago,Calumet,55,15,Wisconsin,WI
55017,55CS008,420,533,654,584,-70,51,164,56,-228.8053149914613,-9.075974414576013,196.0410473548419,0.5714285714285714,507,646,827,674,-153,28,167,64,-325.02469256739676,-53.908725788649086,154.23885433974598,0.5059367579052618,66109,66780,Chippewa+Rusk,Chippewa,55,17,Wisconsin,WI
55019,55CS009,226,288,356,332,-24,44,106,52,-263.2764225736597,-27.695087187235735,186.94183851384125,0.8666666666666667,265,348,450,389,-61,41,124,45,-305.3662247102848,-11.517820828299287,227.4769613589109,0.6,34663,34729,Clark+Taylor,Clark,55,19,Wisconsin,WI
55021,55CS010,382,478,594,528,-66,50,146,40,-218.03859922278986,20.5599810676841,217.93579931745145,0.449438202247191,457,582,744,631,-113,49,174,50,-278.7598421130241,-1.7096586452807367,211.99767201481134,0.43290854572713644,58366,58491,Columbia,Columbia,55,21,Wisconsin,WI
55023,55CS011,129,150,176,165,-11,15,36,11,-163.6314781668786,26.44979031962606,186.17937238651123,0.5418313492784734,154,185,219,197,-22,12,43,11,-205.26722968288547,6.220219081299559,199.3580215556506,0.44,16090,16077,Crawford+Grant+Richland,Crawford,55,23,Wisconsin,WI
55025,55CS012,2366,2922,3593,3366,-227,444,1000,216,-94.91411993428075,48.93473918091866,167.9414549920193,0.38366018020746573,2802,3576,4541,3768,-773,192,966,147,-163.17755552461804,7.98281241355418,145.3049255098273,0.20247972299957312,560338,563711,Dane,Dane,55,25,Wisconsin,WI
55027,55CS013,647,814,1018,1019,1,205,372,126,-168.61972691867484,106.48248142746054,331.64575386362867,0.5740348692403487,781,994,1261,1111,-150,116,330,112,-293.5427454476869,5.038879857007787,244.2177104029773,0.5333333333333333,89029,89306,Dodge,Dodge,55,27,Wisconsin,WI
55029,55CS014,239,307,389,325,-64,18,86,25,-358.745849888899,-28.200122955893242,245.9453580653259,0.4098360655737705,292,377,482,381,-101,4,89,22,-405.53823454864295,-59.347058714435555,221.0677937112723,0.20853548966756513,29787,30330,Door+Kewaunee+Manitowoc,Door,55,29,Wisconsin,WI
55031,55CS002,286,362,459,466,7,104,180,53,-125.01315195354282,138.60153803544964,345.2808903412524,0.49074074074074076,339,439,565,498,-67,59,159,36,-232.96052110780644,52.02031053863639,278.19557375009896,0.3673469387755102,44155,44214,Ashland+Bayfield+Douglas+Price,Douglas,55,31,Wisconsin,WI
55033,55CS015,237,302,379,306,-73,4,69,23,-253.63653993122335,-50.17276687863866,121.47090928512519,0.3194444444444444,284,367,474,414,-60,47,130,33,-204.3644792718577,30.74801407636763,213.0398118148329,0.42857142857142855,45443,45531,Dunn+Eau Claire,Dunn,55,33,Wisconsin,WI
55035,55CS015,597,739,913,846,-67,107,249,81,-168.10034358571014,29.521168073140586,190.80893441120284,0.5644667832167832,707,900,1149,998,-151,98,291,68,-205.9053626672736,27.73611049627658,209.71320156591491,0.3655913978494624,105687,106360,Dunn+Eau Claire,Eau Claire,55,35,Wisconsin,WI
55037,55CS016,49,62,78,63,-15,1,14,13,-746.8065280191946,-309.4190474793821,17.803506540427747,0.8055808606285583,62,80,103,67,-36,-13,5,7,-937.3084171567402,-435.95740332871634,-43.595740332871635,-0.3888888888888889,4523,4588,Florence+Forest+Marinette+Oconto,Florence,55,37,Wisconsin,WI
55039,55CS017,667,834,1046,999,-47,165,332,108,-179.0874289267608,65.79428584482994,258.5600005130159,0.5714285714285714,802,1029,1319,1182,-137,153,380,106,-233.12818255636583,45.05355501706084,262.79642782823873,0.4818181818181818,103960,104320,Fond du Lac,Fond du Lac,55,39,Wisconsin,WI
55041,55CS016,90,109,129,99,-30,-10,9,21,-669.7362523174427,-411.01286629579204,-163.06962135837668,-1.3042616639529792,114,137,166,152,-14,15,38,15,-313.72690433583205,0,248.81788964565987,0.6669960474308301,9152,9244,Florence+Forest+Marinette+Oconto,Forest,55,41,Wisconsin,WI
55043,55CS011,341,427,535,503,-32,76,162,51,-192.05881632625204,57.81421322283324,256.6951067093796,0.5425531914893617,404,520,672,578,-94,58,174,35,-247.7712427921384,44.15915214427883,266.87487600238074,0.32407407407407407,51890,52084,Crawford+Grant+Richland,Grant,55,43,Wisconsin,WI
55045,55CS018,235,298,377,340,-37,42,105,14,-165.69603797538971,90.8812745016829,295.52643012065084,0.2413793103448276,279,360,464,397,-67,37,118,29,-259.8098962968303,21.628295217217925,240.6147842915494,0.38666666666666666,36971,36989,Green+Iowa+Lafayette,Green,55,45,Wisconsin,WI
55047,55CS019,156,203,256,221,-35,18,65,19,-341.2161458647292,-6.312972171410346,290.39671988487595,0.5,189,250,322,286,-36,36,97,31,-349.3066831059902,26.048223945263995,344.0970383169372,0.5636363636363636,19008,19195,Green Lake+Marquette+Waushara,Green Lake,55,47,Wisconsin,WI
55049,55CS018,134,175,226,197,-29,22,63,5,-172.29547829942675,86.14773914971337,293.9158159225515,0.13513513513513514,160,213,279,212,-67,-1,52,12,-332.7109626156417,-54.74990524054863,168.67182345261307,-0.10389805097451274,23680,23744,Green+Iowa+Lafayette,Iowa,55,49,Wisconsin,WI
55051,55CS020,65,81,99,93,-6,12,28,19,-487.550869485829,-129.91990919742656,178.94319286983026,1.2755353068426074,80,100,123,109,-14,8,29,2,-260.0997994557621,105.33636738083824,438.3613442541031,0.1111111111111111,6069,6171,Iron+Oneida+Vilas,Iron,55,51,Wisconsin,WI
55053,55CS005,141,180,233,224,-9,44,83,18,-153.97882593125405,148.27590645231874,370.68976613079684,0.36,165,220,285,236,-49,16,71,15,-303.0557131230424,4.735245517547537,265.4105112585392,0.30612244897959184,21042,21118,Buffalo+Jackson+Pepin+Trempealeau,Jackson,55,53,Wisconsin,WI
55055,55CS021,484,603,748,713,-35,110,229,83,-166.9993121235644,38.179351628587966,206.45130880643862,0.6217315677252834,576,740,937,892,-45,152,316,85,-153.1250145645869,78.88793522358573,272.1633765213706,0.47619421254158556,84863,84931,Jefferson,Jefferson,55,55,Wisconsin,WI
55057,55CS001,201,255,324,257,-67,2,56,18,-381.48814390842193,-71.76731690223104,170.44737764279876,0.27908653846153847,238,307,401,382,-19,75,144,37,-209.36172197839363,141.81364412083704,399.3173663402517,0.45121951219512196,26753,26796,Adams+Juneau+Monroe+Vernon,Juneau,55,57,Wisconsin,WI
55059,55CS022,1000,1251,1545,1488,-57,237,488,229,-202.9825802649912,5.67584985012209,183.7911129592659,0.8327272727272728,1203,1524,1957,1708,-249,184,505,180,-254.26330333197845,2.666165361747415,192.58601129688822,0.5844155844155844,169138,168782,Kenosha,Kenosha,55,59,Wisconsin,WI
55061,55CS014,135,160,186,191,5,31,56,26,-121.63350711295803,27.363510083198513,176.36052727935507,0.8253231523081658,162,195,231,206,-25,11,44,15,-194.96245573183938,-19.471905691070102,141.17131626025824,0.5357142857142857,20527,20542,Door+Kewaunee+Manitowoc,Kewaunee,55,61,Wisconsin,WI
55063,55CS023,715,890,1108,1004,-104,114,289,68,-171.50764356578165,45.841671144834145,220.28916101229532,0.40597376675220986,855,1085,1388,1140,-248,55,285,68,-262.2949912659972,-10.788909623344294,180.17479070984962,0.306999306999307,120414,120494,La Crosse,La Crosse,55,63,Wisconsin,WI
55065,55CS018,101,122,141,142,1,20,41,4,-24.89785724148824,117.75655209743836,266.0459588946594,0.1820993293086212,124,151,179,165,-14,14,41,14,-167.08541620305851,0,161.11807991009212,0.6086956521739131,16633,16758,Green+Iowa+Lafayette,Lafayette,55,65,Wisconsin,WI
55067,55CS024,153,198,256,256,0,58,103,35,-216.37076676390467,142.18650387342308,420.37748971272913,0.5645161290322581,185,242,314,306,-8,64,121,18,-133.38349464755976,235.98618283799033,528.6603509011933,0.2517605633802817,19411,19493,Langlade+Lincoln+Menominee+Shawano,Langlade,55,67,Wisconsin,WI
55069,55CS024,225,288,365,372,7,84,147,68,-259.07122823225706,67.8974553925653,335.24368600079123,0.7727272727272727,273,350,455,437,-18,87,164,50,-238.4572168740626,129.74877976971052,399.76651064181084,0.5154639175257731,28278,28517,Langlade+Lincoln+Menominee+Shawano,Lincoln,55,69,Wisconsin,WI
55071,55CS014,600,756,945,844,-101,88,244,56,-232.90508287804906,47.455986323448386,278.87806962888965,0.3916083916083916,723,919,1167,949,-218,30,226,71,-354.80270198736457,-50.32662439537087,190.44331158394593,0.3622448979591837,80917,81468,Door+Kewaunee+Manitowoc,Manitowoc,55,71,Wisconsin,WI
55073,55CS025,844,1052,1307,1209,-98,158,365,156,-221.5665376579443,1.3082062841445248,182.27674225747043,0.7591285815770779,1002,1284,1612,1444,-168,160,442,190,-259.7088987155267,-21.42453163341174,183.0889635519694,0.7378668597110367,137593,137693,Marathon,Marathon,55,73,Wisconsin,WI
55075,55CS016,380,478,602,538,-64,60,158,63,-366.18761230573074,-8.646696866723275,273.9561790606823,0.659703947368421,459,583,744,615,-129,32,156,44,-413.26236667631866,-28.657315227482364,267.58768093661644,0.3464566929133858,41634,41874,Florence+Forest+Marinette+Oconto,Marinette,55,75,Wisconsin,WI
55077,55CS019,131,171,220,210,-10,39,79,24,-261.55837183118905,115.3933993372893,423.49377556785134,0.5217391304347826,159,210,272,250,-22,40,91,25,-298.5090409220683,95.1676007190441,418.73744316379407,0.4716981132075472,15599,15762,Green Lake+Marquette+Waushara,Marquette,55,77,Wisconsin,WI
55078,55CS024,30,41,54,59,5,18,29,14,-258.3523007533663,108.57677228333147,429.63971119044226,0.7480779310189206,37,51,67,65,-2,14,28,2,-93.36977348103912,280.1093204431173,606.9035276267542,0.13333333333333333,4302,4284,Langlade+Lincoln+Menominee+Shawano,Menominee,55,78,Wisconsin,WI
55079,55CS026,5699,7107,8787,8848,61,1741,3149,898,-107.06632030523188,107.80162199738487,287.8226580197081,0.47880568585643213,6843,8590,10932,9500,-1432,910,2657,274,-183.5657976242575,68.42164173300579,256.3498569237308,0.16621172290355438,938390,929530,Milwaukee,Milwaukee,55,79,Wisconsin,WI
55081,55CS001,288,363,462,419,-43,56,131,27,-181.44085863875287,75.11470236293837,269.5063717539219,0.36486486486486486,341,440,561,547,-14,107,206,41,-119.03258968023518,142.8391076162822,357.314191931033,0.34310224089635855,46329,46206,Adams+Juneau+Monroe+Vernon,Monroe,55,81,Wisconsin,WI
55083,55CS016,257,323,414,396,-18,73,139,49,-206.5149163039866,73.97549240739818,277.56221213692515,0.5975609756097561,305,398,513,414,-99,16,109,34,-338.33325295445377,-45.789462805865924,190.78942835777468,0.3757020757020757,38932,39310,Florence+Forest+Marinette+Oconto,Oconto,55,83,Wisconsin,WI
55085,55CS020,327,415,519,499,-20,84,172,46,-210.87805949583637,121.41464031578458,402.58538631023305,0.4742268041237113,395,511,656,531,-125,20,136,45,-445.0523918293616,-65.44888115137671,238.36482515331386,0.4109674728940784,37557,38198,Iron+Oneida+Vilas,Oneida,55,85,Wisconsin,WI
55087,55CS027,1020,1272,1595,1498,-97,226,478,164,-164.4244455366992,39.0586805489477,197.8133176188642,0.5888708388128208,1220,1562,1960,1674,-286,112,454,140,-222.57507724583147,-14.364737442526085,164.12365470697068,0.47863387722661177,190483,191441,Outagamie,Outagamie,55,87,Wisconsin,WI
55089,55CS028,561,695,871,781,-90,86,220,85,-229.88006788644614,1.3132251807280557,177.35106065732387,0.648854961832061,666,854,1097,906,-191,52,240,71,-283.66746666185463,-20.571304834256633,182.9763429994406,0.4176470588235294,91378,92362,Ozaukee,Ozaukee,55,89,Wisconsin,WI
55091,55CS005,45,58,72,61,-11,3,16,2,-205.14317780491345,23.73644032350029,225.68904455445352,0.18435180765770562,52,70,89,81,-8,11,29,10,-244.57283260065276,13.587379588925154,258.1602121895779,0.6666666666666666,7328,7360,Buffalo+Jackson+Pepin+Trempealeau,Pepin,55,91,Wisconsin,WI
55093,55CS029,192,244,310,287,-23,43,95,25,-136.11745250437303,51.04404468913989,198.504618235544,0.45454545454545453,228,298,385,371,-14,73,143,30,-103.6933404656795,101.10688526132014,265.69948917509714,0.36585365853658536,42316,42529,Pierce+St. Croix,Pierce,55,93,Wisconsin,WI
55095,55CS006,319,400,499,423,-76,23,104,29,-281.004186121248,-16.049739331056525,200.75548946596524,0.38666666666666666,381,497,638,580,-58,83,199,83,-310.8949618246298,0,255.79128195496827,0.7410714285714286,44861,45369,Burnett+Polk,Polk,55,95,Wisconsin,WI
55097,55CS030,361,448,564,520,-44,72,159,45,-151.63948844495673,45.977161010823494,194.12579093458808,0.4838709677419355,423,548,701,717,16,169,294,76,-85.16089198937618,131.99938258353308,309.48887497139117,0.4257736488607118,70470,70455,Portage,Portage,55,97,Wisconsin,WI
55099,55CS002,145,169,194,177,-17,8,32,1,-155.39582310641143,64.29739889859043,269.81686464520516,0.046267241876911454,178,212,246,213,-33,1,35,18,-363.47724188057634,-121.0404135547463,121.0404135547463,0.4864864864864865,13921,14045,Ashland+Bayfield+Douglas+Price,Price,55,99,Wisconsin,WI
55101,55CS031,1287,1608,1995,1934,-61,326,647,267,-199.68247622903124,36.20633044530659,231.26413253342469,0.728514316344307,1550,1966,2491,2230,-261,264,680,217,-242.89843398327366,23.860855673976097,235.1563478337388,0.5411471321695761,197203,196975,Racine,Racine,55,101,Wisconsin,WI
55103,55CS011,141,164,192,191,-1,27,50,11,-80.31658053527944,108.16675211240329,268.0920040558919,0.3898744632210631,173,204,235,227,-8,24,54,24,-185.81918921861578,-2.9034248315408715,174.2054898924523,0.8275862068965517,17273,17221,Crawford+Grant+Richland,Richland,55,103,Wisconsin,WI
55105,55CS032,1063,1315,1635,1564,-71,249,501,139,-154.02985120230156,80.66309751132192,265.63824612251227,0.4877253028661479,1271,1608,2050,1771,-279,163,500,127,-247.17943489016403,21.91468946200198,227.1214066186927,0.4103403278003967,163644,164273,Rock,Rock,55,105,Wisconsin,WI
55107,55CS008,135,157,183,163,-20,6,28,17,-309.64261576296235,-93.53311316475785,94.6912923240009,0.8185681530340585,164,193,226,234,8,41,70,28,-141.90106735435012,92.00567958137415,297.60298664590607,0.6666666666666666,14152,14130,Chippewa+Rusk,Rusk,55,107,Wisconsin,WI
55109,55CS029,432,542,679,628,-51,86,196,41,-118.23616609710056,57.77011372822504,199.05013630136202,0.36283185840707965,517,662,848,812,-36,150,295,90,-132.8243198518552,63.7767567542638,216.1557681398643,0.5294117647058824,93474,94862,Pierce+St. Croix,St. Croix,55,109,Wisconsin,WI
55111,55CS033,443,555,698,631,-67,76,188,44,-203.3680383229055,58.60222626144058,263.80158415501603,0.4074074074074074,523,671,865,753,-112,82,230,67,-272.4502735442603,22.831028509295557,248.17327989604263,0.5018796992481203,65527,65700,Sauk,Sauk,55,111,Wisconsin,WI
55113,55CS003,152,195,247,217,-30,22,65,16,-308.4132709895275,40.22781795515576,328.5271799671054,0.41025641025641024,183,240,316,278,-38,38,95,34,-394.41451387019816,21.896711387658467,333.92484866179166,0.6296296296296297,17898,18268,Barron+Sawyer+Washburn,Sawyer,55,113,Wisconsin,WI
55115,55CS024,320,405,513,477,-36,72,157,63,-290.93565834243606,26.448696212948732,276.2419382241312,0.7,385,496,643,505,-138,9,120,39,-433.4743267119987,-73.42873970276658,198.25759719746978,0.32099309036715895,40834,40856,Langlade+Lincoln+Menominee+Shawano,Shawano,55,115,Wisconsin,WI
55117,55CS034,778,974,1207,1137,-70,164,359,127,-201.15257846398862,37.26938636515525,236.9414001653226,0.6287128712871287,929,1179,1504,1251,-253,72,322,102,-301.5927655661781,-25.47236195660288,186.8397749516821,0.42677824267782427,117523,117775,Sheboygan,Sheboygan,55,117,Wisconsin,WI
55119,55CS009,134,155,181,175,-6,20,41,24,-179.55900023120125,-26.365661372424807,102.11907444461355,1.04793581718069,161,191,225,226,1,35,65,29,-140.5678354854297,30.121679032592077,180.73007419555245,0.7837837837837838,19964,19919,Clark+Taylor,Taylor,55,119,Wisconsin,WI
55121,55CS005,205,257,322,269,-53,12,64,33,-337.48843315264423,-82.36208130395732,121.77822021370817,0.6470588235294118,237,312,397,303,-94,-9,66,16,-358.10065106744145,-81.34953454507985,162.6990690901597,-0.18823529411764706,30597,30732,Buffalo+Jackson+Pepin+Trempealeau,Trempealeau,55,121,Wisconsin,WI
55123,55CS001,197,252,318,318,-0,66,121,22,-86.26365658260494,171.74664658980174,386.62512147090575,0.30985915492957744,235,306,401,355,-46,49,120,33,-255.8072702692857,51.80906739631103,281.7118039674412,0.5,30743,30883,Adams+Juneau+Monroe+Vernon,Vernon,55,123,Wisconsin,WI
55125,55CS020,216,279,357,282,-75,3,66,29,-542.9003078646411,-135.7250769661603,193.14722491338193,0.42028985507246375,267,347,452,365,-87,18,98,42,-550.19665106959,-102.32250775412754,238.9656899841185,0.6,22988,23455,Iron+Oneida+Vilas,Vilas,55,125,Wisconsin,WI
55127,55CS035,667,833,1041,998,-43,165,331,116,-179.97014863858362,55.39282213122234,243.05013792271026,0.6137566137566137,802,1018,1320,1095,-225,77,293,95,-299.7979022108983,-16.860997468508575,185.47097215359435,0.46913866263473636,106151,106755,Walworth,Walworth,55,127,Wisconsin,WI
55129,55CS003,140,181,229,203,-26,22,63,13,-283.77968671045977,65.48762001010611,363.82011116725613,0.34210526315789475,172,222,292,278,-14,56,106,25,-233.42145998000026,182.31381637362378,484.1776762709353,0.3968253968253968,16492,16729,Barron+Sawyer+Washburn,Washburn,55,129,Wisconsin,WI
55131,55CS036,819,1015,1267,1188,-79,173,369,117,-172.12394174578858,49.153190911596944,221.18935910218624,0.5416666666666666,989,1252,1595,1387,-208,135,398,129,-245.78734380553135,4.376035794757235,196.2652053948619,0.5098814229249012,136715,137110,Washington,Washington,55,131,Wisconsin,WI
55133,55CS037,2444,3025,3715,3670,-45,645,1226,421,-137.52043152988418,66.05462991893225,237.45754795634014,0.5925407579089161,2960,3715,4712,4148,-564,433,1188,329,-218.69106032363047,25.457656451374042,210.28269013993142,0.4320422085872643,406936,408522,Waukesha,Waukesha,55,133,Wisconsin,WI
55135,55CS038,490,613,765,716,-49,103,226,118,-388.6831216707013,-34.90120817156852,251.2886988352933,0.9255044291338583,580,744,943,759,-184,16,179,71,-494.2736539624069,-107.5772070388768,209.43634631622763,0.3977622245935597,51574,51591,Waupaca,Waupaca,55,135,Wisconsin,WI
55137,55CS019,192,246,315,289,-26,43,97,25,-249.53026199997961,88.06950423528693,352.52265445291215,0.44642857142857145,233,305,393,331,-62,26,98,41,-416.2333704629999,-60.528362161366935,230.00777621319435,0.6119402985074627,24526,24782,Green Lake+Marquette+Waushara,Waushara,55,137,Wisconsin,WI
55139,55CS007,1050,1304,1637,1525,-112,221,475,172,-198.55975343623484,34.252518635365284,211.80639074521798,0.6370370370370371,1259,1604,2038,1730,-308,126,471,137,-259.31332175699026,-6.117941531172673,194.637939856022,0.4261285578839419,171666,171626,Calumet+Winnebago,Winnebago,55,139,Wisconsin,WI
55141,55CS039,578,719,890,824,-66,105,246,52,-191.6919613294012,86.06246463751177,315.183478983793,0.3586206896551724,689,879,1116,1051,-65,172,362,122,-252.65595033282173,67.50092180946346,324.0044246854246,0.5754716981132075,73900,74073,Wood,Wood,55,141,Wisconsin,WI
56001,56CS006,132,156,179,213,34,57,81,10,76.16407191497439,150.18165037096583,229.34483588539524,0.17608295604173574,160,191,226,267,41,76,107,34,18.651320774407278,111.90792464644367,194.50663093310447,0.4473684210526316,37388,37531,"Southeast Wyoming, excluding Laramie",Albany,56,1,Wyoming,WY
56003,56CS001,102,123,145,127,-18,4,25,14,-330.05282870682913,-98.92082321054076,115.0902929897264,0.7930218795701429,126,152,184,190,6,38,64,32,-223.98466566519676,47.38137158302239,275.67343466485755,0.8421052631578947,11525,11608,Big Horn+Hot Springs+Park+Washakie,Big Horn,56,3,Wyoming,WY
56005,56CS005,169,216,277,276,-1,60,107,39,-102.38597927053183,53.685532201777,173.83886617718267,0.609375,199,262,339,367,28,105,168,86,-124.82456065687893,40.85558402206201,176.32409946363606,0.8037383177570093,46940,46505,Northeast Wyoming,Campbell,56,5,Wyoming,WY
56007,56CS006,94,112,132,137,5,25,43,17,-95.4613558854736,67.46494105545695,216.50354948375102,0.6536025945416016,115,140,166,162,-4,22,47,31,-239.62330259705854,-61.52952135159849,109.72764641035033,1.1923076923076923,14563,14627,"Southeast Wyoming, excluding Laramie",Carbon,56,7,Wyoming,WY
56009,56CS006,85,103,124,127,3,24,42,3,-1.263996440152202,185.4367962035897,343.4143899790635,0.11974449556497341,103,128,151,163,12,35,60,36,-175.44394017848984,-7.310164174103743,175.44394017848984,1,13739,13680,"Southeast Wyoming, excluding Laramie",Converse,56,9,Wyoming,WY
56011,56CS005,41,53,67,99,32,46,58,10,356.5725791450896,588.5931076979617,792.7167398559136,0.21948971924066127,50,67,86,82,-4,15,32,13,-233.03566073891724,27.415960086931438,260.4516208258487,0.7647058823529411,7250,7295,Northeast Wyoming,Crook,56,11,Wyoming,WY
56013,56CS002,282,358,452,486,34,128,204,64,-91.90573460392572,195.73933493015798,428.1797951597206,0.49230769230769234,339,438,567,579,12,141,240,91,-201.20666767354788,127.18499852942345,379.39285061326984,0.6148648648648649,39236,39313,Fremont+Lincoln+Sublette+Teton,Fremont,56,13,Wyoming,WY
56015,56CS006,103,122,142,160,18,38,57,19,-12.113729177362309,183.8438449694727,363.7649709326345,0.49580221529165974,124,152,181,188,7,36,64,31,-191.50909834457676,39.89772882178682,263.325010223793,0.8378378378378378,12612,12532,"Southeast Wyoming, excluding Laramie",Goshen,56,15,Wyoming,WY
56017,56CS001,55,71,88,80,-8,9,25,5,-339.1460399735052,101.55962658362729,520.7674557477291,0.35142063334750123,70,91,114,87,-27,-4,17,10,-804.2349126707754,-304.30510209164476,152.15255104582238,-0.45454545454545453,4589,4601,Big Horn+Hot Springs+Park+Washakie,Hot Springs,56,17,Wyoming,WY
56019,56CS005,68,86,103,84,-19,-2,16,5,-335.99196779300047,-91.93449445391461,152.12297888517148,-0.2786034294136601,87,108,133,110,-23,2,23,4,-313.98695597398944,-23.25829303511033,220.95378383354813,0.19047619047619047,8489,8599,Northeast Wyoming,Johnson,56,19,Wyoming,WY
56021,56CS003,588,735,925,821,-104,86,233,63,-199.28876333050965,27.438740237065083,202.92737888368555,0.4666666666666667,710,904,1162,1259,97,355,549,173,-75.36858398587006,180.48792480826776,372.8761523511466,0.484593837535014,100588,100838,Laramie,Laramie,56,21,Wyoming,WY
56023,56CS002,103,124,146,155,9,31,52,10,-8.153791726750951,126.63989037321016,256.4412138768765,0.3240936249715916,130,157,188,172,-16,15,42,15,-154.35828757737366,0,134.44108918029318,0.625,19762,20083,Fremont+Lincoln+Sublette+Teton,Lincoln,56,23,Wyoming,WY
56025,56CS004,490,618,767,761,-6,143,271,95,-151.41108960950342,71.92214053692395,263.78943419844705,0.6070349501878164,584,748,961,934,-27,186,350,131,-198.42243389188246,69.04924937711823,275.06710070048354,0.6421568627450981,80087,79653,Natrona,Natrona,56,25,Wyoming,WY
56027,56CS006,15,23,32,33,1,10,18,2,-52.65676223085311,394.96429387040524,801.8925266897312,0.18515196524301647,19,29,41,36,-5,7,17,5,-410.1477386333535,82.0295477266707,492.17728636002425,0.5,2424,2438,"Southeast Wyoming, excluding Laramie",Niobrara,56,27,Wyoming,WY
56029,56CS001,195,250,313,303,-10,53,108,14,-97.18101933216168,157.9191564147627,380.62565905096653,0.23333333333333334,235,305,393,440,47,135,205,103,-186.5716148181024,106.51724664012983,339.6901568632889,0.7573529411764706,29635,30042,Big Horn+Hot Springs+Park+Washakie,Park,56,29,Wyoming,WY
56031,56CS006,73,89,108,96,-12,7,23,4,-218.85610281507152,44.710792081134464,263.0129376364698,0.3085752097657056,90,112,135,171,36,59,81,25,126.03712052179756,391.3481367800106,644.5734017553116,0.423728813559322,8609,8688,"Southeast Wyoming, excluding Laramie",Platte,56,31,Wyoming,WY
56033,56CS005,220,281,354,300,-54,19,80,18,-278.66005046144335,3.8702784786311577,240.15077959906318,0.3157894736842105,268,344,448,384,-64,40,116,43,-339.28969968133816,-9.508352162952027,231.36990263183267,0.5733333333333334,31006,31551,Northeast Wyoming,Sheridan,56,33,Wyoming,WY
56035,56CS002,41,53,67,67,-0,14,26,5,-73.1350656196302,126.68714698898712,282.1044234623561,0.32884954907627023,49,68,87,78,-9,10,29,16,-287.33017589395604,-68.95924221454945,149.41169146485714,1.0666666666666667,8887,8701,Fremont+Lincoln+Sublette+Teton,Sublette,56,35,Wyoming,WY
56037,56CS007,196,252,313,357,44,106,161,22,62.5414265387476,237.3731416357011,395.1481040402689,0.20754716981132076,231,303,392,414,22,111,183,82,-143.9078989446754,69.55548448992644,242.36488647265736,0.7256637168141593,42212,41693,Sweetwater+Uinta,Sweetwater,56,37,Wyoming,WY
56039,56CS002,65,81,98,79,-19,-2,14,5,-122.35937709037748,-33.73030048958,46.66893328400044,-0.2543486689773421,79,101,124,89,-35,-12,10,2,-157.16758524748585,-59.46881603958924,33.982180594050995,-0.1,23376,23542,Fremont+Lincoln+Sublette+Teton,Teton,56,39,Wyoming,WY
56041,56CS007,113,135,157,154,-3,19,41,3,-35.43066999939823,94.98328259913713,220.56708880513406,0.1386720413697019,142,169,202,186,-16,17,44,23,-189.2587567559917,-29.116731808614105,101.90856133014937,0.92,20425,20607,Sweetwater+Uinta,Uinta,56,41,Wyoming,WY
56043,56CS001,58,72,89,87,-2,15,29,21,-355.79976907769054,-86.28096201487675,131.90092941692492,1.226835348670453,71,89,111,113,2,24,42,18,-207.8422563874959,77.94084614531096,311.7633845812438,0.72,7687,7698,Big Horn+Hot Springs+Park+Washakie,Washakie,56,43,Wyoming,WY
56045,56CS005,43,55,69,68,-1,13,25,5,-106.7532569298592,146.67330255536407,356.6553089859776,0.34340139351078863,50,68,86,106,20,38,56,11,133.2477915412328,399.7433746236984,666.238957706164,0.2894736842105263,6813,6754,Northeast Wyoming,Weston,56,45,Wyoming,WY
